time,subj_course_id,sec_code,sec_id,prof,available,waitlist,total,enrolled_ct
1746530278430,AAS 10,A01,886199,Childs; Dennis R.,0,3,0,0
1746530279465,ANAR 104,A01,886940,Shtienberg; Gilad,27,0,30,3
1746530280498,ANAR 120,A00,886953,Staff,12,0,20,8
1746530281526,ANBI 148,A01,886955,Wilder; Linnea Lorene,30,0,40,10
1746530283591,ANSC 122,A00,886957,Staff,25,0,30,5
1746530284623,ANSC 150,A00,886958,Sloane; Julia Kathryn,3,0,15,12
1746530285655,ANSC 156,A00,886959,Jenkins; Janis A.,0,1,15,15
1746530286686,ANSC 180,A00,886960,Staff,11,0,17,6
1746530287721,ANSC 188,A00,886961,Jassal; Aftab,9,0,25,16
1746530288752,ANSC 190,A00,886962,Jassal; Aftab,14,0,25,11
1746530289786,ANSC 191,A00,886963,Staff,18,0,20,2
1746530290815,ANTH 3,A01,891689,Staff,17,0,20,3
1746530291847,ANTH 5,A00,886933,Semendeferi; Ekaterini,16,0,20,4
1746530292879,ANTH 10,A00,886934,Staff,0,12,30,30
1746530293908,ANTH 21,A01,886936,Staff,40,0,60,20
1746530294939,ANTH 23,A01,886938,Staff,92,0,100,8
1746530295969,ANTH 105,A00,886964,Stewart; Alexander B,84,0,100,16
1746530297000,ANTH 108,A00,886965,Pedersen; David,9,0,20,11
1746530298042,AWP 10,001,886147,Staff,0,0,0,0
1746530298042,AWP 10,002,886148,Staff,0,0,0,0
1746530298042,AWP 10,003,886149,Staff,0,0,0,0
1746530298042,AWP 10,004,886150,Staff,0,0,0,0
1746530298042,AWP 10,005,886151,Staff,0,0,0,0
1746530298042,AWP 10,006,886152,Staff,0,0,0,0
1746530298042,AWP 10,007,886153,Staff,0,0,0,0
1746530298042,AWP 10,008,886154,Staff,0,0,0,0
1746530298042,AWP 10,009,886155,Staff,0,0,0,0
1746530298042,AWP 10,010,886156,Staff,0,0,0,0
1746530298042,AWP 10,011,886158,Staff,0,0,0,0
1746530298042,AWP 10,012,886160,Staff,0,0,0,0
1746530298042,AWP 10,013,886161,Staff,0,0,0,0
1746530298042,AWP 10,014,886162,Staff,0,0,0,0
1746530298042,AWP 10,015,886163,Staff,0,0,0,0
1746530298042,AWP 10,016,886164,Staff,0,0,0,0
1746530298042,AWP 10,017,886165,Staff,0,0,0,0
1746530298042,AWP 10,018,886166,Staff,0,0,0,0
1746530298042,AWP 10,019,886168,Staff,0,0,0,0
1746530298042,AWP 10,020,886170,Staff,0,0,0,0
1746530298042,AWP 10,021,886172,Staff,0,0,0,0
1746530299080,AWP 10R,001,886173,Staff,0,1,0,0
1746530299080,AWP 10R,002,886174,Staff,0,1,0,0
1746530299080,AWP 10R,003,886175,Staff,0,0,0,0
1746530299080,AWP 10R,004,886176,Staff,0,0,0,0
1746530299080,AWP 10R,005,886177,Staff,0,0,0,0
1746530299080,AWP 10R,006,886178,Staff,0,0,0,0
1746530299080,AWP 10R,007,886179,Staff,0,0,0,0
1746530299080,AWP 10R,008,886181,Staff,0,0,0,0
1746530299080,AWP 10R,009,886182,Staff,0,0,0,0
1746530299080,AWP 10R,010,886183,Staff,0,0,0,0
1746530299080,AWP 10R,011,886184,Staff,0,0,0,0
1746530299080,AWP 10R,012,886185,Staff,0,0,0,0
1746530299080,AWP 10R,013,886186,Staff,0,0,0,0
1746530299080,AWP 10R,014,886187,Staff,0,0,0,0
1746530299080,AWP 10R,015,886188,Staff,0,0,0,0
1746530299080,AWP 10R,016,886189,Staff,0,0,0,0
1746530300111,AWP 102R,A00,886190,Staff,0,0,0,0
1746530300111,AWP 102R,B00,886191,Staff,0,0,0,0
1746530301139,BENG 100,A01,886193,Staff,17,0,30,13
1746530302172,BENG 122A,A01,886195,Hasty; Jeff M,13,0,30,17
1746530303203,BENG 166A,A00,886196,Sah; Robert Lie-Yuan,0,1,30,30
1746530304235,BENG 190,A00,958050,Khojah; Reem I,24,0,25,1
1746530305269,BIBC 102,A01,894320,Staff,0,0,46,46
1746530305269,BIBC 102,A02,894321,Staff,1,0,46,45
1746530305269,BIBC 102,A03,894344,Staff,7,0,46,39
1746530305269,BIBC 102,A04,894345,Staff,26,0,47,21
1746530306304,BICD 100R,A01,894365,Smith; Laurie,0,3,58,58
1746530306304,BICD 100R,A02,894366,Smith; Laurie,0,5,58,58
1746530306304,BICD 100R,A03,894367,Smith; Laurie,2,0,59,57
1746530306304,BICD 100R,A04,959869,Smith; Laurie,41,0,59,18
1746530307339,BICD 136,A01,894383,Gustafson-Brown; Cindy,14,0,50,36
1746530308369,BIEB 102,A01,894494,Butler; Shannon Rhey,51,0,130,79
1746530310442,BIEB 150,A01,894617,Wills; Christopher,3,0,20,17
1746530310442,BIEB 150,A02,894631,Wills; Christopher,3,0,20,17
1746530310442,BIEB 150,A03,894937,Wills; Christopher,4,0,20,16
1746530310442,BIEB 150,A04,894946,Wills; Christopher,5,0,20,15
1746530311473,BIEB 194,A00,906141,Kurle; Carolyn M.,6,0,20,14
1746530312507,BILD 1,A01,894154,Staff,2,0,19,17
1746530312507,BILD 1,A02,894155,Staff,14,0,19,5
1746530312507,BILD 1,A03,894160,Staff,13,0,19,6
1746530312507,BILD 1,A04,894161,Staff,15,0,18,3
1746530313541,BILD 2,A01,894168,Staff,0,0,50,50
1746530313541,BILD 2,A02,894169,Staff,0,0,50,50
1746530313541,BILD 2,A03,894179,Staff,4,0,50,46
1746530313541,BILD 2,A04,894203,Staff,27,0,50,23
1746530314571,BILD 3,A01,894213,Staff,22,0,31,9
1746530314571,BILD 3,A02,894214,Staff,26,0,31,5
1746530314571,BILD 3,A03,894235,Staff,28,0,31,3
1746530314571,BILD 3,A04,894236,Staff,28,0,32,4
1746530315604,BILD 4,A01,894253,Reuther; Keefe,5,0,24,19
1746530315604,BILD 4,A02,894258,Reuther; Keefe,16,0,24,8
1746530316636,BILD 5,A01,894276,Reuther; Keefe,35,0,50,15
1746530316636,BILD 5,A02,894277,Reuther; Keefe,45,0,50,5
1746530316636,BILD 5,A03,894290,Reuther; Keefe,44,0,50,6
1746530316636,BILD 5,A04,894291,Reuther; Keefe,48,0,50,2
1746530317663,BILD 24,A01,894297,Pirino; Giorgia,40,0,60,20
1746530318700,BIMM 100,B01,958915,Staff,72,0,100,28
1746530319732,BIMM 101,A01,895017,McDonnell; Lisa Marie,0,5,24,24
1746530319732,BIMM 101,A02,895018,McDonnell; Lisa Marie,0,5,24,24
1746530319732,BIMM 101,B01,895020,McDonnell; Lisa Marie,0,6,24,24
1746530319732,BIMM 101,B02,895021,McDonnell; Lisa Marie,0,4,24,24
1746530320764,BIMM 110,A01,895023,Staff,1,0,25,24
1746530320764,BIMM 110,A02,895024,Staff,9,0,25,16
1746530320764,BIMM 110,A03,895025,Staff,18,0,25,7
1746530320764,BIMM 110,A04,895031,Staff,20,0,25,5
1746530321802,BIMM 120,A01,895114,Gustafson-Brown; Cindy,13,0,28,15
1746530321802,BIMM 120,A02,895126,Gustafson-Brown; Cindy,20,0,27,7
1746530322837,BIPN 100,A01,895130,Yang; Mingyu,1,0,38,37
1746530322837,BIPN 100,A02,895131,Yang; Mingyu,32,0,38,6
1746530322837,BIPN 100,A03,895132,Yang; Mingyu,32,0,38,6
1746530322837,BIPN 100,A04,895133,Yang; Mingyu,27,0,36,9
1746530323870,BIPN 120,A01,895135,Cooke; James Edward,0,3,13,13
1746530323870,BIPN 120,A02,895136,Cooke; James Edward,0,1,13,13
1746530323870,BIPN 120,A03,895137,Cooke; James Edward,0,3,13,13
1746530323870,BIPN 120,A04,895156,Cooke; James Edward,0,2,11,11
1746530324908,BIPN 134,A01,895235,Cooke; James Edward,0,2,25,25
1746530324908,BIPN 134,A02,895237,Cooke; James Edward,0,0,25,25
1746530324908,BIPN 134,A03,895240,Cooke; James Edward,3,0,25,22
1746530324908,BIPN 134,A04,895270,Cooke; James Edward,20,0,25,5
1746530325946,BIPN 189,A00,892103,Staff,0,13,14,14
1746530328004,BISP 194,A00,958008,Staff,0,2,0,0
1746530329033,CAT 124,A01,922009,Staff,0,5,20,20
1746530330070,CAT 125R,A00,886390,Morales; Celeste Georgianna,0,2,20,20
1746530330070,CAT 125R,B00,886391,Irwin; Matthew Joseph,0,3,20,20
1746530330070,CAT 125R,C00,886392,Smith; Lauryn Alissa,0,2,20,20
1746530330070,CAT 125R,D00,886393,Vanderschuit; Maya Alysia,0,2,20,20
1746530330070,CAT 125R,E00,886394,Marchisotto; Jennifer Anne,0,4,20,20
1746530331108,CENG 15,A01,886218,Drews; Aaron,3,0,8,5
1746530332136,CENG 113,A00,886219,Opatkiewicz; Justin Paul,15,0,25,10
1746530333165,CGS 101,A00,887044,Staff,7,0,20,13
1746530334197,CGS 105,A01,887046,Staff,14,0,25,11
1746530335234,CGS 112,A00,887047,Cuong; Marisol,12,0,15,3
1746530336263,CGS 113,A00,887048,Staff,23,0,30,7
1746530337290,CGS 120,A00,887049,Staff,10,0,17,7
1746530338323,CHEM 6A,A01,886336,Lam; Tin Yiu,38,0,50,12
1746530338323,CHEM 6A,A02,886338,Lam; Tin Yiu,37,0,50,13
1746530339363,CHEM 6B,A01,886341,Hopkins; Patrycja Anna,16,0,50,34
1746530339363,CHEM 6B,A02,886343,Hopkins; Patrycja Anna,42,0,50,8
1746530340397,CHEM 6C,A01,886346,Albizati; Kim F.,0,2,50,50
1746530340397,CHEM 6C,A02,886348,Albizati; Kim F.,23,0,50,27
1746530341429,CHEM 40A,A01,886352,Klosterman; Jeremy K,65,0,100,35
1746530342458,CHEM 40B,A01,886356,Klosterman; Jeremy K,0,23,100,100
1746530343489,CHEM 41B,A01,886360,Theodorakis; Emmanuel,25,0,50,25
1746530343489,CHEM 41B,A02,886362,Theodorakis; Emmanuel,47,0,50,3
1746530344520,CHIN 165A,A00,886382,Xu; Li,18,0,20,2
1746530345549,CLAS 120,A00,886387,Myerston Santana; Jacobo,33,0,40,7
1746530346578,COGS 9,A01,886967,Shannon; Kyle Michael,42,0,60,18
1746530347621,COGS 11,A01,886969,Staff,11,0,30,19
1746530348655,COGS 14A,A01,886971,Staff,6,0,60,54
1746530349686,COGS 14B,A01,886973,Hoffman; Drew Ellen,4,0,60,56
1746530350719,COGS 18,A01,886975,Morgan; Eric,35,0,60,25
1746530351750,COGS 20,A01,886977,Staff,4,0,8,4
1746530351750,COGS 20,A02,886978,Staff,5,0,7,2
1746530352781,COGS 100,A01,907783,Staff,0,2,30,30
1746530353808,COGS 101B,A01,886980,Staff,0,3,48,48
1746530354842,COGS 101C,A01,886982,Delgado; Tania,0,5,44,44
1746530355872,COGS 102A,A01,886984,Johnson; Christine M.,4,0,30,26
1746530356906,COGS 118B,A01,886986,Staff,0,3,88,88
1746530357938,COGS 150,A01,886988,Bergen; Benjamin,23,0,50,27
1746530358970,COGS 153,A00,886989,Delgado; Tania,0,2,41,41
1746530360006,COGS 186,A01,886991,Staff,0,0,32,32
1746530361033,COGS 187A,A01,886993,Boyle; Mary E. T.,7,0,30,23
1746530362062,COGS 189,A00,886994,Staff,0,1,30,30
1746530363090,COMM 10,A01,886996,Staff,0,0,20,21
1746530363090,COMM 10,A02,886997,Staff,12,0,20,8
1746530363090,COMM 10,A03,959845,Staff,19,0,20,1
1746530364122,COMM 20,A01,886999,Leuning; Grant Maurstad,24,0,40,16
1746530366184,COMM 100A,A01,887002,Staff,0,0,20,25
1746530366184,COMM 100A,A02,887003,Staff,7,0,20,13
1746530367219,COMM 100B,A01,887005,Staff,0,8,20,24
1746530368248,COMM 106D,A00,887006,Staff,14,0,40,26
1746530369277,COMM 110G,A00,887007,Whitworth-Smith; Andrew C,12,0,40,28
1746530370312,COMM 111B,A00,887008,Staff,31,0,40,9
1746530371340,COMM 113T,A00,887009,Abuelhiga; Soraya Jill,28,0,40,12
1746530371340,COMM 113T,B00,906733,Staff,40,0,40,0
1746530372367,COMM 145,A00,887010,Staff,12,0,40,28
1746530373398,COMM 146,A00,887054,Staff,31,0,40,9
1746530374426,COMM 190,A00,887012,Staff,8,0,23,15
1746530375462,CSE 8A,A50,887015,Cao; Yingjun,57,0,85,28
1746530376494,CSE 11,A01,887017,Cao; Yingjun,12,0,70,58
1746530377522,CSE 20,A01,887019,Staff,30,0,50,20
1746530378556,CSE 21,A01,887021,Staff,78,0,100,22
1746530378556,CSE 21,B01,892583,Braun; Oliver,45,0,50,5
1746530379586,CSE 30,A01,887025,Eldon; John,143,0,200,57
1746530380622,CSE 100,A01,887027,Staff,26,0,50,24
1746530380622,CSE 100,A02,887028,Staff,40,0,50,10
1746530381656,CSE 101,A01,887030,Braun; Oliver,75,0,100,25
1746530381656,CSE 101,B01,887032,Jones; Miles E,0,3,50,50
1746530381656,CSE 101,B02,887033,Jones; Miles E,0,1,50,50
1746530382684,CSE 105,A01,908084,Jones; Miles E,32,0,50,18
1746530382684,CSE 105,A02,908087,Jones; Miles E,33,0,50,17
1746530383712,CSE 135,A01,887035,Powell; Thomas Allan,0,4,50,50
1746530384741,CSE 142,A01,887037,Staff,8,0,60,52
1746530385769,CSE 142L,A01,887039,Staff,34,0,60,26
1746530386798,CSE 151A,A01,887041,Solares; Edwin A,48,0,100,52
1746530387834,CSE 175,A01,887043,Kumar; Rakesh,30,0,30,0
1746530388867,CSS 1,A01,886389,Staff,0,1,40,40
1746530389902,DSC 30,A01,908097,Liao; Soohyun Nam,47,0,75,28
1746530390934,DSC 40A,A01,908099,Shannon; Kyle Michael,30,0,50,20
1746530391965,DSC 40B,A01,908112,Staff,16,0,50,34
1746530392990,DSC 80,A01,908116,Staff,19,0,60,41
1746530394020,DSC 197,001,956863,Eldridge; Justin Matthew,9999,0,9999,0
1746530395056,ECE 5,A01,886400,Morris; Karcher William,2,0,6,4
1746530395056,ECE 5,A02,886401,Morris; Karcher William,3,0,6,3
1746530396081,ECE 148,A01,886403,Silberman; Jack,0,14,14,14
1746530397116,ECON 1,A01,887265,Crane; Meredith Helen,12,0,70,58
1746530397116,ECON 1,B01,887268,Staff,43,0,50,7
1746530398146,ECON 2,A01,887273,Crane; Meredith Helen,56,0,70,14
1746530399174,ECON 3,A01,887279,Rondina; Giacomo,32,0,70,38
1746530400206,ECON 4,A01,887282,Anderson; John Charles,0,2,10,10
1746530401236,ECON 5,A01,887285,Staff,33,0,45,12
1746530401236,ECON 5,B01,887292,Staff,41,0,45,4
1746530402265,ECON 100A,A01,887337,Newhouse; Herbert S,54,0,70,16
1746530402265,ECON 100A,B01,887349,Staff,45,0,50,5
1746530403293,ECON 100B,A01,887361,Du; Songzi,29,0,70,41
1746530404324,ECON 100C,A01,887445,Newhouse; Herbert S,59,0,70,11
1746530405358,ECON 105,A00,887488,Vespa; Emanuel Ignacio,23,0,35,12
1746530406386,ECON 109,A01,887506,Shishkin; Denis,28,0,35,7
1746530407418,ECON 110A,A01,887568,Alon; Titan Michael,0,3,35,35
1746530407418,ECON 110A,B01,907601,Alon; Titan Michael,20,0,35,15
1746530408449,ECON 110B,A01,887598,Levkoff; Steven B.,0,23,70,70
1746530409479,ECON 112,A00,887599,Rondina; Giacomo,19,0,35,16
1746530410505,ECON 120A,A01,887603,Dai; Yinlin,36,0,70,34
1746530411532,ECON 120C,A01,887608,Sun; Yixiao,0,1,35,35
1746530411532,ECON 120C,B01,887614,Sun; Yixiao,0,0,35,35
1746530412563,ECON 138,A00,887621,Bharadwaj; Prashant,0,20,20,20
1746530413611,ECON 144,A00,958007,Squires; Dale E,13,0,35,22
1746530414642,ECON 171,A01,907666,Staff,18,0,35,17
1746530415675,ECON 175,A00,887626,Wu; Pak Yeung,23,0,35,12
1746530416704,ECON 190,A00,887640,Vespa; Emanuel Ignacio,23,0,35,12
1746530417747,EDS 25,A01,888197,Staff,0,0,0,0
1746530417747,EDS 25,A02,888209,Staff,0,0,0,0
1746530417747,EDS 25,A03,888210,Staff,0,0,0,0
1746530417747,EDS 25,A04,888212,Staff,0,0,0,0
1746530417747,EDS 25,A05,888213,Staff,0,0,0,0
1746530417747,EDS 25,A06,888214,Staff,0,0,0,0
1746530417747,EDS 25,A07,888235,Staff,0,2,0,0
1746530417747,EDS 25,A08,888236,Staff,0,0,0,0
1746530417747,EDS 25,A09,888240,Staff,0,0,0,0
1746530417747,EDS 25,A10,888244,Staff,0,0,0,0
1746530417747,EDS 25,B01,888273,Staff,0,0,0,0
1746530417747,EDS 25,B02,888285,Staff,0,0,0,0
1746530417747,EDS 25,B03,888423,Staff,0,0,0,1
1746530417747,EDS 25,B04,888432,Staff,0,0,0,0
1746530417747,EDS 25,B05,888433,Staff,0,0,0,0
1746530417747,EDS 25,B06,888467,Staff,0,0,0,0
1746530417747,EDS 25,B07,888468,Staff,0,0,0,0
1746530417747,EDS 25,B08,888479,Staff,0,0,0,0
1746530417747,EDS 25,B09,888484,Staff,0,0,0,0
1746530417747,EDS 25,B10,888487,Staff,0,0,0,0
1746530418778,EDS 38,A01,907700,Choi; Bailey Miyeon,30,0,30,0
1746530419807,EDS 112,A01,888601,Chapman; Thandeka K,14,0,40,26
1746530420838,EDS 115,A00,888697,Mendez; Kathrina Mendoza,10,0,30,20
1746530421871,EDS 116,A01,888893,Staff,35,0,40,5
1746530423931,EDS 124AR,A00,889133,Staff,29,0,50,21
1746530423931,EDS 124AR,B00,907471,Simon; Elizabeth A,37,0,50,13
1746530424959,EDS 124BR,A00,889134,Simon; Elizabeth A,45,0,100,55
1746530425988,EDS 125,A00,889135,Staff,25,0,30,5
1746530427016,EDS 126,A01,889138,Staff,36,0,40,4
1746530428041,EDS 164R,A01,889142,Wishard Guerra; Alison G.,33,0,50,17
1746530429071,ENG 30,A01,886396,Staff,0,0,0,0
1746530429071,ENG 30,B01,886398,Staff,0,0,0,0
1746530430099,ENVR 102,A00,906150,Montejo; Carolina,23,0,25,2
1746530431132,ETHN 103A,A00,887236,Man; Simeon S,0,3,0,0
1746530432166,ETHN 113,A00,887239,Staff,16,0,30,14
1746530433198,ETHN 116,A00,887240,Staff,16,0,25,9
1746530434224,ETHN 117,A00,887241,Choi; Esther Min,28,0,30,2
1746530435252,ETHN 118,A00,887243,Staff,24,0,30,6
1746530436283,ETHN 127,A00,887248,Cuong; Marisol,11,0,15,4
1746530437313,ETHN 139,A00,887250,Staff,7,0,10,3
1746530438340,ETHN 142,A00,887252,Staff,10,0,30,20
1746530439368,ETHN 161,A00,887253,Browne; Errol Tsekani,24,0,30,6
1746530440396,ETHN 163FR,A00,887255,Burelle; Julie Sara Veronique,0,0,5,5
1746530441425,GLBH 20,A00,889149,Elwardani; Nile Regina,8,0,42,34
1746530443478,GLBH 111,A01,889152,Burgos; Jose L.,17,0,17,0
1746530444510,GLBH 150,A00,889181,Sloane; Julia Kathryn,0,5,15,15
1746530446565,HDS 60,A01,886406,Warstadt; Melissa Fawn,73,0,80,7
1746530447592,HIAF 111,A00,889324,Gyamfi; Bright,25,0,32,7
1746530448623,HIEA 131,A00,889328,Staff,16,0,32,16
1746530449655,HIEA 144,A00,889333,Henry; Todd A.,26,0,32,6
1746530450682,HIEA 154,A00,889336,Henry; Todd A.,24,0,32,8
1746530451713,HIEU 106,A00,889339,Staff,22,0,32,10
1746530453769,HIEU 114,A00,889340,Staff,3,0,32,29
1746530454796,HIEU 135GS,A00,889342,Patterson; Patrick H.,0,0,1,24
1746530455829,HIEU 137,A00,889343,Edington; Claire Ellen,9,0,25,16
1746530456857,HIEU 148,A00,889345,Staff,14,0,32,18
1746530457887,HIEU 154,A00,889346,Biess; Frank Peter,21,0,32,11
1746530458919,HILA 102,A00,889351,Staff,12,0,32,20
1746530459946,HILD 2A,A01,889221,Lewandoski; Julia Mavis,1,10,32,31
1746530460976,HILD 7B,A01,889225,Man; Simeon S,0,13,32,32
1746530462006,HILD 7C,A01,889288,Alvarez; Luis A,0,14,32,32
1746530463039,HILD 30,A01,889323,Staff,0,5,32,32
1746530465099,HISC 119,A00,889383,Golan; Tal,21,0,32,11
1746530466130,HIUS 103,A00,889384,Man; Simeon S,0,0,32,32
1746530467159,HIUS 117,A00,919797,Kwak; Nancy,18,0,32,14
1746530468191,HIUS 142A,A00,919788,Staff,22,0,32,10
1746530470247,HIUS 149,A00,889386,Gyamfi; Bright,27,0,32,5
1746530471277,HIUS 155,A00,889387,Alvarez; Luis A,14,0,32,18
1746530472312,HUM 3,A01,886499,Caldwell; Michael Alan,19,0,50,31
1746530473340,HUM 3GS,A00,886500,Rodriguez; Bretton Sigfred,0,0,0,28
1746530474369,HUM 3R,A01,886502,Markman; Kristina,0,36,50,50
1746530475402,HUM 4,A01,886504,Crum; Matthew Stephen,24,0,50,26
1746530475402,HUM 4,B01,886506,West; Geoffrey Scott,17,0,50,33
1746530476431,HUM 4GS,A00,886507,Staff,0,0,0,19
1746530477463,HUM 5,A01,886509,Staff,32,0,50,18
1746530478493,HUM 5R,A01,886511,Zavodny; Tatiana Sophia,0,39,50,50
1746530479526,JAPN 180,A00,886407,Staff,18,0,40,22
1746530480557,LATI 50,A01,886409,Martin-Cabrera; Luis,4,0,22,18
1746530480557,LATI 50,A02,886410,Martin-Cabrera; Luis,19,0,22,3
1746530480557,LATI 50,A03,886411,Martin-Cabrera; Luis,21,0,22,1
1746530480557,LATI 50,A04,886412,Martin-Cabrera; Luis,9,0,22,13
1746530481586,LAWS 101,A00,907664,Staff,28,0,60,32
1746530482612,LIAB 1A,A00,889388,Saab; Dima,17,0,20,3
1746530483642,LIAB 1AX,A00,889389,El Cheddadi; Youniss,17,0,20,3
1746530484667,LIFR 1C,A00,889391,Van Moer; Vinciane G,8,0,20,12
1746530485695,LIFR 1CX,A00,889392,Van Moer; Vinciane G,7,0,20,13
1746530486727,LIFR 1D,A00,889393,Van Moer; Vinciane G,7,0,20,13
1746530487757,LIFR 1DX,A00,889394,Van Moer; Vinciane G,8,0,20,12
1746530488787,LIGN 7,A00,886923,Staff,24,0,50,26
1746530489820,LIGN 17,A00,886924,Kehler; Andrew Scott,125,0,150,25
1746530490845,LTAM 110,A00,889395,Staff,15,0,30,15
1746530491874,LTAM 110GS,A00,958010,Rodriguez; Bretton Sigfred,0,0,0,28
1746530492906,LTCH 101,A00,889397,Staff,23,0,25,2
1746530493938,LTCS 130,A00,889398,Staff,23,0,25,2
1746530494970,LTEA 138,A00,889399,Staff,24,0,40,16
1746530496001,LTEN 149,A00,889400,Wesling; Megan E.,0,3,25,25
1746530497027,LTEN 169,A00,889401,Staff,20,0,25,5
1746530498054,LTEN 180,A00,889402,Staff,10,0,15,5
1746530499084,LTEN 181,A00,889403,Staff,21,0,25,4
1746530500115,LTWL 100,A00,889404,Myerston Santana; Jacobo,3,0,25,22
1746530501144,LTWL 180GS,A00,889405,Staff,0,0,20,20
1746530502174,LTWL 181,A00,889406,Staff,17,0,25,8
1746530503202,LTWL 184,A00,889475,Mukherjee; Silpa,22,0,25,3
1746530504230,LTWR 102C,A00,889486,Staff,29,0,30,1
1746530505262,LTWR 115W,A00,889491,Staff,0,2,15,15
1746530506291,MAE 8,A01,886905,Staff,0,2,0,0
1746530507321,MAE 11,A00,886906,Bandaru; Prabhakar,0,7,50,50
1746530508351,MAE 20,A00,886907,Evdokimenko; Ekaterina,44,0,70,26
1746530509378,MAE 30B,A00,886909,Ghazinejad; Maziar,26,0,45,19
1746530510410,MAE 101B,A00,886910,Saintillan; David,29,0,45,16
1746530511440,MAE 105,A00,886911,Bandaru; Prabhakar,18,0,50,32
1746530512472,MAE 107,B00,958024,Staff,9,0,50,41
1746530513504,MAE 143B,A00,886913,Bewley; Thomas R,7,0,40,33
1746530514534,MAE 148,A01,886915,Silberman; Jack,0,3,14,14
1746530515564,MAE 160,A00,886916,Evdokimenko; Ekaterina,31,0,60,29
1746530516594,MATH 3C,A01,889681,Staff,0,3,30,30
1746530516594,MATH 3C,A02,960048,Staff,25,0,30,5
1746530517623,MATH 10A,A01,889760,Staff,26,0,30,4
1746530517623,MATH 10A,A02,889783,Staff,29,0,30,1
1746530518660,MATH 10B,A01,889785,Verstraete; Jacques Allan,2,0,35,33
1746530518660,MATH 10B,A02,889795,Verstraete; Jacques Allan,4,0,35,31
1746530518660,MATH 10B,B01,889797,Verstraete; Jacques Allan,3,0,35,32
1746530518660,MATH 10B,B02,889828,Verstraete; Jacques Allan,3,0,35,32
1746530519692,MATH 10C,A01,889849,Habib; Yousaf,9,0,30,21
1746530519692,MATH 10C,A02,889852,Habib; Yousaf,14,0,30,16
1746530519692,MATH 10C,A03,889853,Habib; Yousaf,22,0,30,8
1746530519692,MATH 10C,A04,889858,Habib; Yousaf,20,0,30,10
1746530519692,MATH 10C,B01,889861,Staff,1,0,30,29
1746530519692,MATH 10C,B02,889862,Staff,24,0,30,6
1746530519692,MATH 10C,B03,889863,Staff,27,0,30,3
1746530519692,MATH 10C,B04,889967,Staff,23,0,30,7
1746530520719,MATH 18,A01,889974,Staff,7,0,30,23
1746530520719,MATH 18,A02,889977,Staff,20,0,30,10
1746530520719,MATH 18,B01,889984,Hardiman; Liam,22,0,30,8
1746530520719,MATH 18,B02,889985,Hardiman; Liam,25,0,30,5
1746530521749,MATH 20A,A01,889990,Suk; Andrew Hoon,29,0,35,6
1746530522777,MATH 20B,A01,889993,Ohm; Ko Woon,22,0,30,8
1746530522777,MATH 20B,A02,889994,Ohm; Ko Woon,30,0,30,0
1746530522777,MATH 20B,B01,889996,Ohm; Ko Woon,21,0,30,9
1746530522777,MATH 20B,B02,889997,Ohm; Ko Woon,23,0,30,7
1746530523812,MATH 20C,A01,889999,Hammock; Frances H,17,0,30,13
1746530523812,MATH 20C,A02,890003,Hammock; Frances H,23,0,30,7
1746530523812,MATH 20C,B01,890006,Hammock; Frances H,3,0,30,27
1746530523812,MATH 20C,B02,890007,Hammock; Frances H,11,0,30,19
1746530524844,MATH 20D,A01,890011,Cheng; Hsiao-Bing,1,1,30,29
1746530524844,MATH 20D,A02,890012,Cheng; Hsiao-Bing,14,0,30,16
1746530524844,MATH 20D,B01,890016,Cheng; Hsiao-Bing,13,0,30,17
1746530524844,MATH 20D,B02,890017,Cheng; Hsiao-Bing,13,0,30,17
1746530525870,MATH 20E,A01,890026,Harel; Guershon,1,0,30,29
1746530525870,MATH 20E,A02,890029,Harel; Guershon,23,0,30,7
1746530525870,MATH 20E,B01,890033,Harel; Guershon,7,0,30,23
1746530525870,MATH 20E,B02,890101,Harel; Guershon,21,0,30,9
1746530526900,MATH 102,A01,890104,Staff,17,0,30,13
1746530526900,MATH 102,A02,890105,Staff,27,0,30,3
1746530527932,MATH 103B,A01,890116,Salehi Golsefidy; Alireza,3,0,30,27
1746530527932,MATH 103B,B01,890118,Staff,0,3,34,34
1746530528964,MATH 109,A01,890121,Aliabadi Sr.; Mohsen,1,0,30,29
1746530528964,MATH 109,B01,890124,Upadrashta; Pranav Kumar,18,0,30,12
1746530529994,MATH 120A,A01,890126,Eggers; John Dietrich,13,0,30,17
1746530531026,MATH 142B,A01,890128,Ioana; Adrian,19,0,30,11
1746530531026,MATH 142B,A02,890129,Ioana; Adrian,13,0,30,17
1746530532054,MATH 154,A01,890174,Staff,0,0,30,30
1746530532054,MATH 154,A02,890182,Staff,0,0,30,30
1746530533085,MATH 168A,A01,890197,Dumitriu; Ioana,21,0,35,14
1746530534111,MATH 170A,A01,890240,Nie; Jiawang,1,0,30,29
1746530534111,MATH 170A,A02,890241,Nie; Jiawang,11,0,30,19
1746530534111,MATH 170A,A03,890249,Nie; Jiawang,23,0,30,7
1746530535139,MATH 170B,A01,957891,Nag; Panchali,13,0,35,22
1746530537202,MATH 181A,A01,908025,Staff,0,4,35,35
1746530537202,MATH 181A,A02,960115,Staff,27,0,35,8
1746530538232,MATH 181B,A01,959874,Staff,26,0,30,4
1746530539258,MATH 193B,A01,890265,Staff,0,4,35,35
1746530540286,MGT 4,A01,890311,Anderson; John Charles,42,0,88,46
1746530541312,MGT 5,A00,907740,Staff,13,0,98,85
1746530542339,MGT 12,A00,890312,Lindenberger; Wade Douglas,67,0,98,31
1746530543365,MGT 16,A00,957883,Staff,78,0,98,20
1746530545421,MGT 45,A00,890314,Pecore; Joseph P.,47,0,98,51
1746530546452,MGT 71,A00,890315,Staff,0,11,98,98
1746530547481,MGT 100,A00,890316,Yavorsky; Daniel Ryan,44,0,98,54
1746530548509,MGT 103,A00,890317,Ehrich; Kristine R,73,0,98,25
1746530549541,MGT 105,A00,890356,Bates; Kenneth Walter,0,7,98,98
1746530550570,MGT 112,A00,890360,Ehrich; Kristine R,55,0,98,43
1746530551596,MGT 127R,A00,907732,Zhu; Kevin Xiaoguo,23,0,98,75
1746530552621,MGT 131B,A00,890361,Anderson; John Charles,61,0,98,37
1746530553651,MGT 137,A00,890362,Lindenberger; Wade Douglas,65,0,98,33
1746530554681,MGT 160,A00,890369,Johnson; Erik Barry,9,0,98,89
1746530556742,MGT 164,A00,890372,Zimmermann; Carsten,0,39,98,98
1746530557775,MGT 180,A00,890374,Bliss; Barbara Ann,12,0,98,86
1746530558806,MMW 15,A01,886414,Chang; Edmond Yi-Teh,0,12,28,28
1746530558806,MMW 15,A02,886415,Chang; Edmond Yi-Teh,0,8,28,28
1746530558806,MMW 15,A03,886416,Chang; Edmond Yi-Teh,0,8,28,28
1746530558806,MMW 15,A04,886417,Chang; Edmond Yi-Teh,0,8,28,28
1746530558806,MMW 15,B01,886419,Chang; Edmond Yi-Teh,0,7,28,28
1746530558806,MMW 15,B02,886420,Chang; Edmond Yi-Teh,0,8,28,28
1746530558806,MMW 15,B03,886421,Chang; Edmond Yi-Teh,0,7,28,28
1746530558806,MMW 15,B04,886422,Chang; Edmond Yi-Teh,0,8,28,28
1746530558806,MMW 15,C01,886424,Staff,0,9,28,28
1746530558806,MMW 15,C02,886425,Staff,0,8,28,28
1746530558806,MMW 15,C03,886426,Staff,0,8,28,28
1746530558806,MMW 15,C04,886427,Staff,0,7,28,28
1746530558806,MMW 15,C05,958038,Staff,0,7,28,28
1746530558806,MMW 15,C06,958039,Staff,0,8,28,28
1746530559838,MMW 15GS,A00,906910,Patterson; Patrick H.,4,0,28,24
1746530560870,MMW 122R,A01,886429,Rahimi; Babak,0,13,28,28
1746530560870,MMW 122R,A02,886430,Rahimi; Babak,0,12,28,28
1746530560870,MMW 122R,A03,958040,Rahimi; Babak,0,11,28,28
1746530561908,MUS 1A,A01,890937,Staff,3,0,25,22
1746530561908,MUS 1A,A02,891035,Staff,6,0,25,19
1746530561908,MUS 1A,C01,958912,Staff,24,0,25,1
1746530561908,MUS 1A,C02,958913,Staff,25,0,25,0
1746530563967,MUS 2AK,A00,957092,Ohnishi; Takae,15,0,15,0
1746530565005,MUS 4,A01,891044,Staff,2,0,25,23
1746530565005,MUS 4,A02,891045,Staff,23,0,25,2
1746530565005,MUS 4,B01,891048,Staff,17,0,25,8
1746530565005,MUS 4,B02,891050,Staff,25,0,25,0
1746530566034,MUS 5,A01,957506,Dubnov; Shlomo,0,0,25,25
1746530566034,MUS 5,A02,957622,Dubnov; Shlomo,14,0,25,11
1746530566034,MUS 5,A03,957623,Dubnov; Shlomo,20,0,25,5
1746530567060,MUS 6,A01,891053,Freitas Caetano; Marcelo,24,0,25,1
1746530567060,MUS 6,A02,891054,Freitas Caetano; Marcelo,23,0,25,2
1746530568089,MUS 7,A01,891081,Staff,0,0,25,25
1746530568089,MUS 7,A02,891082,Staff,4,0,25,21
1746530569120,MUS 8GS,A00,891118,Borgo; David Garcia,0,0,25,25
1746530570146,MUS 11,A01,891140,Staff,11,0,25,14
1746530570146,MUS 11,A02,891141,Staff,22,0,25,3
1746530571174,MUS 13,A01,891143,Staff,8,0,25,17
1746530571174,MUS 13,A02,891144,Staff,24,0,25,1
1746530572207,MUS 15,A01,891146,Staff,9,0,25,16
1746530572207,MUS 15,A02,891148,Staff,21,0,25,4
1746530572207,MUS 15,B01,891150,Staff,18,0,25,7
1746530572207,MUS 15,B02,891151,Staff,25,0,25,0
1746530573233,MUS 20,A01,891153,Staff,5,0,20,15
1746530573233,MUS 20,A02,891155,Staff,14,0,20,6
1746530574264,MUS 80,A00,891156,Staff,19,0,25,6
1746530574264,MUS 80,B00,891157,Staff,23,0,25,2
1746530575292,MUS 130,A00,891158,Ohnishi; Takae,35,0,35,0
1746530576320,MUS 150GS,A01,891160,Borgo; David Garcia,0,0,25,25
1746530577348,MUS 170,A01,891162,Freitas Caetano; Marcelo,20,0,25,5
1746530577348,MUS 170,A02,891164,Freitas Caetano; Marcelo,21,0,25,4
1746530578374,NANO 11,A00,886220,Vazquez Mena; Oscar,13,0,15,2
1746530579402,NANO 15,A01,886222,Drews; Aaron,4,0,7,3
1746530580432,NANO 104,A00,886224,Sirbuly; Donald,18,0,25,7
1746530581461,PH 40,A00,886528,Staff,23,0,40,17
1746530582494,PH 45,A01,886799,Staff,35,0,40,5
1746530583522,PH 110,A00,886802,Staff,0,7,40,40
1746530584553,PH 172,A00,906716,Staff,19,0,35,16
1746530585582,PH 191,A00,886803,Staff,6,0,40,34
1746530586612,PHIL 1,A00,889500,Staff,19,0,30,11
1746530587642,PHIL 10,A01,889549,Grush; Rick Scott,15,0,22,7
1746530587642,PHIL 10,A02,889551,Grush; Rick Scott,22,0,22,0
1746530588671,PHIL 28,A01,889559,Lamey; Andy M.,0,1,31,31
1746530588671,PHIL 28,A02,889561,Lamey; Andy M.,0,1,30,30
1746530588671,PHIL 28,A03,889572,Lamey; Andy M.,0,0,30,30
1746530589696,PHIL 35,A00,907839,Staff,13,0,15,2
1746530590727,PHIL 60,A00,889574,Staff,74,0,90,16
1746530591753,PHIL 101,A00,958004,Staff,13,0,15,2
1746530593809,PHIL 136,A00,889582,Fulkerson; Matthew Todd,26,0,45,19
1746530594838,PHIL 163,A01,889601,Staff,21,0,30,9
1746530594838,PHIL 163,B01,889606,Brandt; Reuven A,0,3,0,0
1746530595865,PHIL 164,A00,889610,Staff,16,0,30,14
1746530596894,PHIL 165,A00,889613,Staff,23,0,30,7
1746530597919,PHYS 1A,A00,886431,Staff,26,0,70,44
1746530598948,PHYS 1AL,001,886432,Tsai; Philbert S,0,2,30,30
1746530598948,PHYS 1AL,002,886436,Tsai; Philbert S,11,0,30,19
1746530599975,PHYS 1B,A00,886439,Staff,185,0,240,55
1746530601002,PHYS 1BL,001,886441,Tsai; Philbert S,0,4,30,30
1746530601002,PHYS 1BL,002,886444,Tsai; Philbert S,2,0,30,28
1746530602034,PHYS 1C,A00,896092,Arnold; Kam S,78,0,146,68
1746530603066,PHYS 1CL,001,886448,Tsai; Philbert S,0,0,30,30
1746530603066,PHYS 1CL,002,886449,Tsai; Philbert S,0,0,30,30
1746530603066,PHYS 1CL,003,886450,Tsai; Philbert S,15,0,30,15
1746530603066,PHYS 1CL,004,886451,Tsai; Philbert S,15,0,30,15
1746530604097,PHYS 2B,A01,886457,Staff,69,0,115,46
1746530605125,PHYS 2C,A01,886460,Shotwell; Brian,0,8,65,65
1746530606155,PHYS 2CL,A01,886467,Staff,0,4,28,28
1746530606155,PHYS 2CL,A02,886468,Staff,0,3,28,28
1746530607181,PHYS 2D,A01,886470,Staff,10,0,50,40
1746530608212,PHYS 4B,A01,886475,Grinstein; Benjamin,22,0,40,18
1746530609239,POLI 5,A00,891173,Desposato; Scott,7,0,25,18
1746530610267,POLI 5D,A01,891175,Staff,5,0,5,0
1746530610267,POLI 5D,B01,891178,Staff,5,0,5,0
1746530611293,POLI 11,A00,891179,Ferree; Karen E,2,0,35,33
1746530612320,POLI 12,A00,891180,Staff,16,0,30,14
1746530613348,POLI 27,A01,891182,Staff,12,0,75,63
1746530614374,POLI 30,A00,891183,Staff,9,0,50,41
1746530615406,POLI 100B,A00,891244,Staff,5,1,35,30
1746530616434,POLI 100I,A00,891247,Staff,7,0,30,23
1746530617460,POLI 104J,A00,891248,Nichter; Maysa,14,0,30,16
1746530618487,POLI 104U,A00,891250,Nichter; Maysa,2,0,30,28
1746530620541,POLI 110B,A00,891255,Wiens; David,20,0,25,5
1746530621570,POLI 112A,A00,891256,Wiens; David,6,0,25,19
1746530622596,POLI 114BR,A00,891261,Staff,19,0,30,11
1746530623623,POLI 117R,A00,891262,Forman; Fonna,0,6,50,50
1746530624652,POLI 118,A00,891264,Ingham; Sean,17,0,25,8
1746530625680,POLI 124A,A00,891265,Staff,18,0,20,2
1746530626709,POLI 125D,A00,891266,Nichter; Simeon C,2,0,25,23
1746530627738,POLI 126,A00,891268,Nichter; Simeon C,7,0,25,18
1746530628767,POLI 126AA,A00,891272,Staff,18,0,25,7
1746530629794,POLI 130AA,A00,891273,Staff,15,0,20,5
1746530630836,POLI 134AA,A00,891274,Staff,4,0,20,16
1746530632896,POLI 138,A00,891278,Staff,21,0,25,4
1746530633927,POLI 142K,A00,891280,Staff,11,0,25,14
1746530634956,POLI 142M,A00,891281,Gartzke; Erik,17,0,30,13
1746530635984,POLI 142P,A00,891284,Staff,20,0,30,10
1746530637013,POLI 143,A00,891285,Gartzke; Erik,12,0,30,18
1746530638043,POLI 153,A00,891286,Staff,19,0,20,1
1746530640101,POLI 175,A00,891290,Staff,15,0,20,5
1746530641131,PSYC 1,A00,890674,Steiner; Eric Tomas,0,11,45,45
1746530642161,PSYC 2,A00,890676,Albright; Thomas D,21,0,35,14
1746530643192,PSYC 3,A00,890679,Staff,17,0,20,3
1746530644221,PSYC 6,A00,959858,Staff,20,0,20,0
1746530645252,PSYC 60,A01,890684,Rickard; Timothy C.,0,5,45,45
1746530646280,PSYC 70,A01,890689,Geller; Emma Harlan,7,0,30,23
1746530647310,PSYC 71,A01,959860,Staff,21,0,25,4
1746530648338,PSYC 100,A00,890690,Lacefield; Katharine I,0,50,180,180
1746530649366,PSYC 102,A00,890695,Staff,18,0,40,22
1746530650393,PSYC 105,A00,890699,Geller; Emma Harlan,71,0,100,29
1746530651420,PSYC 106,A00,890701,Gorman; Michael R.,5,0,30,25
1746530652451,PSYC 108,A00,890704,Adrian; Julia Anna,0,28,50,50
1746530653480,PSYC 118,A01,890712,Staff,11,0,30,19
1746530654507,PSYC 124,A00,890716,Chapman; Eddie Nathaniel,25,0,60,35
1746530655532,PSYC 131,A00,890717,Anagnostaras; Stephan,0,7,80,80
1746530656560,PSYC 137,A00,890719,Winkielman; Piotr,0,11,30,30
1746530657588,PSYC 144,A00,890721,Adrian; Julia Anna,0,9,45,45
1746530658618,PSYC 162,A00,890805,Staff,2,0,75,73
1746530659648,PSYC 169,A00,890810,Staff,0,15,30,30
1746530660684,PSYC 172,A00,890814,Gorman; Michael R.,9,0,30,21
1746530661714,PSYC 181,A00,890818,Anagnostaras; Stephan,8,0,200,192
1746530662740,PSYC 184,A00,959861,Staff,170,0,175,5
1746530663771,PSYC 189,A00,890823,Staff,0,1,30,30
1746530664800,PSYC 191,A00,890884,Rickard; Timothy C.,0,11,35,35
1746530665831,PSYC 193,A00,890913,Staff,19,0,30,11
1746530665831,PSYC 193,B00,890914,Chapman; Eddie Nathaniel,24,0,30,6
1746530666862,PSYC 193L,A01,890918,Lowe; Angela Beth,20,0,30,10
1746530666862,PSYC 193L,B01,890921,Hurwitz; Ethan Scott,20,0,30,10
1746530666862,PSYC 193L,C01,890928,Staff,30,0,30,0
1746530667887,RELI 149,A00,886806,Rahimi; Babak,23,0,40,17
1746530668913,SE 9,A01,886814,Staff,7,0,20,13
1746530669946,SE 101B,A01,886816,Chadha; Mayank,4,0,35,31
1746530670974,SE 110B,A00,886818,Zhu; Qiang,4,0,75,71
1746530671999,SE 125,A01,886830,Staff,10,0,30,20
1746530673028,SE 130B,A01,886835,Staff,14,0,40,26
1746530674052,SE 131A,A01,886838,Krysl; Petr,34,0,55,21
1746530675078,SE 154,A00,886840,Staff,30,0,50,20
1746530676107,SE 164GS,A01,886849,Staff,6,0,20,14
1746530677155,SE 167GS,A01,886853,Staff,6,0,20,14
1746530678184,SIO 25,A01,890107,Staff,19,0,30,11
1746530679214,SIO 45,A00,890109,Cook; Geoffrey W,117,0,200,83
1746530680238,SIO 109R,A00,890110,Forman; Fonna,0,16,20,20
1746530681264,SIO 187,A01,890114,Kacev; David,15,0,40,25
1746530682294,SOCI 1,A01,890431,Thorpe; Charles Robert,15,0,30,15
1746530682294,SOCI 1,A02,890518,Thorpe; Charles Robert,30,0,30,0
1746530683323,SOCI 2,A01,957978,Staff,25,0,25,0
1746530683323,SOCI 2,A02,957979,Staff,23,0,25,2
1746530684349,SOCI 20,A01,890523,Calderon-Zaks; Michael Aar,23,0,30,7
1746530684349,SOCI 20,A02,890526,Calderon-Zaks; Michael Aar,29,0,30,1
1746530685379,SOCI 30,A01,890533,Pardo Guerra; Juan Pablo,37,0,40,3
1746530686406,SOCI 40,A01,890535,Staff,27,0,45,18
1746530687433,SOCI 104Q,A00,890559,Staff,18,0,30,12
1746530688458,SOCI 106,A00,890560,Arnal; Maud Marie Leonie,20,0,30,10
1746530689492,SOCI 110,A00,890567,Holkenbrink-Monk; Charlene,19,0,30,11
1746530690523,SOCI 112,A00,890568,Victoria Torres; Pablo,1,0,55,54
1746530691552,SOCI 115,A00,890597,Arnal; Maud Marie Leonie,28,0,45,17
1746530693607,SOCI 121,A00,890604,Pardo Guerra; Juan Pablo,38,0,45,7
1746530694635,SOCI 126,A01,890608,Staff,8,0,10,2
1746530695664,SOCI 127,A00,890609,Staff,18,0,30,12
1746530696690,SOCI 131,A00,890610,Thorpe; Charles Robert,37,0,45,8
1746530697718,SOCI 135,A00,890615,Payne; Christine Anna,14,0,45,31
1746530698743,SOCI 139,A00,890620,Staff,38,0,45,7
1746530699770,SOCI 148E,A00,890622,Calderon-Zaks; Michael Aar,36,0,45,9
1746530700799,SOCI 150,A00,890623,Kohler; Kristopher M.,31,0,45,14
1746530701825,SOCI 157,A00,890625,Jules-Rosette; Bennetta W.,18,0,20,2
1746530702854,SOCI 160,A00,890627,Payne; Christine Anna,21,0,45,24
1746530703886,SYN 1,A00,886855,Fish; Gwendolyn Anne,0,0,0,0
1746530703886,SYN 1,B00,906086,Fish; Gwendolyn Anne,0,1,0,2
1746530704915,SYN 2R,A00,886860,Staff,0,17,15,15
1746530704915,SYN 2R,B00,906106,Atkinson; Arthur Laird,0,16,15,15
1746530705953,SYN 100,A01,886866,Browne; Emily,0,28,20,20
1746530705953,SYN 100,B01,906128,Rock; Martin,0,5,20,20
1746530705953,SYN 100,C01,906140,Deavenport; James Cary,0,3,20,20
1746530705953,SYN 100,D01,907816,Deavenport; James Cary,0,5,20,20
1746530706986,TDAC 1,A00,890286,Walsh; Kim C.,9,0,20,11
1746530708013,TDAC 101,A00,890296,Basso; Beatrice,16,0,20,4
1746530709041,TDDE 131,A00,890297,Staff,47,0,50,3
1746530710067,TDDM 1,A00,890287,Weinberg; Sadie,25,0,30,5
1746530711094,TDGE 11,A00,890288,Fulton; Julia,137,0,200,63
1746530711094,TDGE 11,B00,890289,Castro; Robert Jess,184,0,200,16
1746530712122,TDGE 25,B00,957359,Walsh; Kim C.,3,0,20,17
1746530713151,TDGE 40,A01,890292,Power; Jade Yukana,27,0,30,3
1746530714178,TDGE 124,A00,890298,Havis; Allan,0,0,50,50
1746530715204,TDGE 131R,A00,890299,Burelle; Julie Sara Veronique,15,0,42,27
1746530716230,TDHT 101,A00,890300,Staff,10,0,20,10
1746530717260,TDHT 109,A01,890302,Anderson; Mysia Anyse,31,0,40,9
1746530718290,TDMV 1,A00,890293,Arcidiacono; Kristin,18,0,30,12
1746530719321,TDMV 2,A00,890294,Weinberg; Sadie,23,0,30,7
1746530720351,TDMV 3,A00,957878,Arcidiacono; Kristin,28,0,30,2
1746530722415,TDMV 138,A00,890304,Jun; Grace Shin Hae,25,0,40,15
1746530723441,TDMV 140,A00,890305,Corrales; Joseph Bernales,25,0,30,5
1746530724466,TDMV 142,A00,890307,Caligagan; Tony,32,0,40,8
1746530725493,TDMV 144,A00,890308,Camaya; Michelle Ann,25,0,30,5
1746530726524,TDPW 1,A00,890295,Stein; Deborah Isobel,3,0,20,17
1746530727552,USP 2,A01,890272,Lerner; Amy M,6,0,20,14
1746530728579,USP 3,A01,890274,Staff,12,0,30,18
1746530729611,USP 15,A01,890276,Sun; Feiyang,17,0,30,13
1746530730638,USP 25,A00,890277,Shenkman; Michael Thomas,19,0,25,6
1746530731668,USP 138,A00,890278,Staff,13,0,25,12
1746530732698,USP 143,A00,890279,Staff,21,0,70,49
1746530733729,USP 144,A00,890280,Chowdhury; Muhammed Zohir,16,0,30,14
1746530734753,USP 150,A00,890281,Boomhower; Matthew Charles,4,0,30,26
1746530735783,USP 151,A00,890282,Staff,16,0,20,4
1746530736813,USP 162,A00,890283,Andrews; Abigail Leslie,16,0,20,4
1746530737845,USP 168,A00,920477,Kwak; Nancy,1,0,5,4
1746530738873,USP 181,A00,890284,Staff,3,0,20,17
1746530739901,USP 191A,A00,890285,Staff,13,0,20,7
1746530740932,VIS 101,A00,886512,Staff,25,0,75,50
1746530741962,VIS 103,A00,886513,Cruz; Edwin Teddy,61,0,75,14
1746530742991,VIS 108,A00,886514,Staff,3,0,15,12
1746530744017,VIS 127P,A00,886515,Shen; Kuiyi,80,0,146,66
1746530745044,VIS 149,A00,886516,Yoldas; Pinar,0,0,15,15
1746530746075,VIS 164,A00,886526,Erdmann; Dean,19,0,22,3
1746530747102,VIS 194S,A00,886527,Staff,61,0,75,14
1746530748133,WCWP 10A,C00,886484,Martiniuk; Jill,12,0,15,3
1746530749163,WCWP 10B,A00,886490,Uriarte; Emma,0,0,15,15
1746530749163,WCWP 10B,B00,886491,Dhir; Simrita,11,0,15,4
1746530749163,WCWP 10B,C00,886492,Ornelas; Tricia,0,0,15,15
1746530750213,WCWP 100,A00,886494,Young; Mark T,0,7,15,15
1746530752369,AAS 10,A01,886199,Childs; Dennis R.,0,3,0,0
1746530753396,ANAR 104,A01,886940,Shtienberg; Gilad,27,0,30,3
1746530754423,ANAR 120,A00,886953,Staff,12,0,20,8
1746530755451,ANBI 148,A01,886955,Wilder; Linnea Lorene,30,0,40,10
1746530757506,ANSC 122,A00,886957,Staff,25,0,30,5
1746530758536,ANSC 150,A00,886958,Sloane; Julia Kathryn,3,0,15,12
1746530759565,ANSC 156,A00,886959,Jenkins; Janis A.,0,1,15,15
1746530760596,ANSC 180,A00,886960,Staff,11,0,17,6
1746530761624,ANSC 188,A00,886961,Jassal; Aftab,9,0,25,16
1746530762652,ANSC 190,A00,886962,Jassal; Aftab,14,0,25,11
1746530763684,ANSC 191,A00,886963,Staff,18,0,20,2
1746530764711,ANTH 3,A01,891689,Staff,17,0,20,3
1746530765739,ANTH 5,A00,886933,Semendeferi; Ekaterini,16,0,20,4
1746530766769,ANTH 10,A00,886934,Staff,0,12,30,30
1746530767797,ANTH 21,A01,886936,Staff,40,0,60,20
1746530768827,ANTH 23,A01,886938,Staff,92,0,100,8
1746530769858,ANTH 105,A00,886964,Stewart; Alexander B,84,0,100,16
1746530770883,ANTH 108,A00,886965,Pedersen; David,9,0,20,11
1746530771912,AWP 10,001,886147,Staff,0,0,0,0
1746530771912,AWP 10,002,886148,Staff,0,0,0,0
1746530771912,AWP 10,003,886149,Staff,0,0,0,0
1746530771912,AWP 10,004,886150,Staff,0,0,0,0
1746530771912,AWP 10,005,886151,Staff,0,0,0,0
1746530771912,AWP 10,006,886152,Staff,0,0,0,0
1746530771912,AWP 10,007,886153,Staff,0,0,0,0
1746530771912,AWP 10,008,886154,Staff,0,0,0,0
1746530771912,AWP 10,009,886155,Staff,0,0,0,0
1746530771912,AWP 10,010,886156,Staff,0,0,0,0
1746530771912,AWP 10,011,886158,Staff,0,0,0,0
1746530771912,AWP 10,012,886160,Staff,0,0,0,0
1746530771912,AWP 10,013,886161,Staff,0,0,0,0
1746530771912,AWP 10,014,886162,Staff,0,0,0,0
1746530771912,AWP 10,015,886163,Staff,0,0,0,0
1746530771912,AWP 10,016,886164,Staff,0,0,0,0
1746530771912,AWP 10,017,886165,Staff,0,0,0,0
1746530771912,AWP 10,018,886166,Staff,0,0,0,0
1746530771912,AWP 10,019,886168,Staff,0,0,0,0
1746530771912,AWP 10,020,886170,Staff,0,0,0,0
1746530771912,AWP 10,021,886172,Staff,0,0,0,0
1746530772945,AWP 10R,001,886173,Staff,0,1,0,0
1746530772945,AWP 10R,002,886174,Staff,0,1,0,0
1746530772945,AWP 10R,003,886175,Staff,0,0,0,0
1746530772945,AWP 10R,004,886176,Staff,0,0,0,0
1746530772945,AWP 10R,005,886177,Staff,0,0,0,0
1746530772945,AWP 10R,006,886178,Staff,0,0,0,0
1746530772945,AWP 10R,007,886179,Staff,0,0,0,0
1746530772945,AWP 10R,008,886181,Staff,0,0,0,0
1746530772945,AWP 10R,009,886182,Staff,0,0,0,0
1746530772945,AWP 10R,010,886183,Staff,0,0,0,0
1746530772945,AWP 10R,011,886184,Staff,0,0,0,0
1746530772945,AWP 10R,012,886185,Staff,0,0,0,0
1746530772945,AWP 10R,013,886186,Staff,0,0,0,0
1746530772945,AWP 10R,014,886187,Staff,0,0,0,0
1746530772945,AWP 10R,015,886188,Staff,0,0,0,0
1746530772945,AWP 10R,016,886189,Staff,0,0,0,0
1746530773971,AWP 102R,A00,886190,Staff,0,0,0,0
1746530773971,AWP 102R,B00,886191,Staff,0,0,0,0
1746530774998,BENG 100,A01,886193,Staff,17,0,30,13
1746530776027,BENG 122A,A01,886195,Hasty; Jeff M,13,0,30,17
1746530777054,BENG 166A,A00,886196,Sah; Robert Lie-Yuan,0,1,30,30
1746530778080,BENG 190,A00,958050,Khojah; Reem I,24,0,25,1
1746530779110,BIBC 102,A01,894320,Staff,0,0,46,46
1746530779110,BIBC 102,A02,894321,Staff,1,0,46,45
1746530779110,BIBC 102,A03,894344,Staff,7,0,46,39
1746530779110,BIBC 102,A04,894345,Staff,26,0,47,21
1746530780143,BICD 100R,A01,894365,Smith; Laurie,0,3,58,58
1746530780143,BICD 100R,A02,894366,Smith; Laurie,0,5,58,58
1746530780143,BICD 100R,A03,894367,Smith; Laurie,2,0,59,57
1746530780143,BICD 100R,A04,959869,Smith; Laurie,41,0,59,18
1746530781173,BICD 136,A01,894383,Gustafson-Brown; Cindy,14,0,50,36
1746530782202,BIEB 102,A01,894494,Butler; Shannon Rhey,51,0,130,79
1746530784263,BIEB 150,A01,894617,Wills; Christopher,3,0,20,17
1746530784263,BIEB 150,A02,894631,Wills; Christopher,3,0,20,17
1746530784263,BIEB 150,A03,894937,Wills; Christopher,4,0,20,16
1746530784263,BIEB 150,A04,894946,Wills; Christopher,5,0,20,15
1746530785290,BIEB 194,A00,906141,Kurle; Carolyn M.,6,0,20,14
1746530786318,BILD 1,A01,894154,Staff,2,0,19,17
1746530786318,BILD 1,A02,894155,Staff,14,0,19,5
1746530786318,BILD 1,A03,894160,Staff,13,0,19,6
1746530786318,BILD 1,A04,894161,Staff,15,0,18,3
1746530787345,BILD 2,A01,894168,Staff,0,0,50,50
1746530787345,BILD 2,A02,894169,Staff,0,0,50,50
1746530787345,BILD 2,A03,894179,Staff,4,0,50,46
1746530787345,BILD 2,A04,894203,Staff,27,0,50,23
1746530788372,BILD 3,A01,894213,Staff,22,0,31,9
1746530788372,BILD 3,A02,894214,Staff,26,0,31,5
1746530788372,BILD 3,A03,894235,Staff,28,0,31,3
1746530788372,BILD 3,A04,894236,Staff,28,0,32,4
1746530789400,BILD 4,A01,894253,Reuther; Keefe,5,0,24,19
1746530789400,BILD 4,A02,894258,Reuther; Keefe,16,0,24,8
1746530790427,BILD 5,A01,894276,Reuther; Keefe,35,0,50,15
1746530790427,BILD 5,A02,894277,Reuther; Keefe,45,0,50,5
1746530790427,BILD 5,A03,894290,Reuther; Keefe,44,0,50,6
1746530790427,BILD 5,A04,894291,Reuther; Keefe,48,0,50,2
1746530791456,BILD 24,A01,894297,Pirino; Giorgia,40,0,60,20
1746530792483,BIMM 100,B01,958915,Staff,72,0,100,28
1746530793516,BIMM 101,A01,895017,McDonnell; Lisa Marie,0,5,24,24
1746530793516,BIMM 101,A02,895018,McDonnell; Lisa Marie,0,5,24,24
1746530793516,BIMM 101,B01,895020,McDonnell; Lisa Marie,0,6,24,24
1746530793516,BIMM 101,B02,895021,McDonnell; Lisa Marie,0,4,24,24
1746530794546,BIMM 110,A01,895023,Staff,1,0,25,24
1746530794546,BIMM 110,A02,895024,Staff,9,0,25,16
1746530794546,BIMM 110,A03,895025,Staff,18,0,25,7
1746530794546,BIMM 110,A04,895031,Staff,20,0,25,5
1746530795580,BIMM 120,A01,895114,Gustafson-Brown; Cindy,13,0,28,15
1746530795580,BIMM 120,A02,895126,Gustafson-Brown; Cindy,20,0,27,7
1746530796609,BIPN 100,A01,895130,Yang; Mingyu,1,0,38,37
1746530796609,BIPN 100,A02,895131,Yang; Mingyu,32,0,38,6
1746530796609,BIPN 100,A03,895132,Yang; Mingyu,32,0,38,6
1746530796609,BIPN 100,A04,895133,Yang; Mingyu,27,0,36,9
1746530797639,BIPN 120,A01,895135,Cooke; James Edward,0,3,13,13
1746530797639,BIPN 120,A02,895136,Cooke; James Edward,0,1,13,13
1746530797639,BIPN 120,A03,895137,Cooke; James Edward,0,3,13,13
1746530797639,BIPN 120,A04,895156,Cooke; James Edward,0,2,11,11
1746530798667,BIPN 134,A01,895235,Cooke; James Edward,0,2,25,25
1746530798667,BIPN 134,A02,895237,Cooke; James Edward,0,0,25,25
1746530798667,BIPN 134,A03,895240,Cooke; James Edward,3,0,25,22
1746530798667,BIPN 134,A04,895270,Cooke; James Edward,20,0,25,5
1746530799698,BIPN 189,A00,892103,Staff,0,13,14,14
1746530801750,BISP 194,A00,958008,Staff,0,2,0,0
1746530802779,CAT 124,A01,922009,Staff,0,5,20,20
1746530803813,CAT 125R,A00,886390,Morales; Celeste Georgianna,0,2,20,20
1746530803813,CAT 125R,B00,886391,Irwin; Matthew Joseph,0,3,20,20
1746530803813,CAT 125R,C00,886392,Smith; Lauryn Alissa,0,2,20,20
1746530803813,CAT 125R,D00,886393,Vanderschuit; Maya Alysia,0,2,20,20
1746530803813,CAT 125R,E00,886394,Marchisotto; Jennifer Anne,0,4,20,20
1746530804844,CENG 15,A01,886218,Drews; Aaron,3,0,8,5
1746530805872,CENG 113,A00,886219,Opatkiewicz; Justin Paul,15,0,25,10
1746530806898,CGS 101,A00,887044,Staff,7,0,20,13
1746530807927,CGS 105,A01,887046,Staff,14,0,25,11
1746530808955,CGS 112,A00,887047,Cuong; Marisol,12,0,15,3
1746530809986,CGS 113,A00,887048,Staff,23,0,30,7
1746530811014,CGS 120,A00,887049,Staff,10,0,17,7
1746530812047,CHEM 6A,A01,886336,Lam; Tin Yiu,38,0,50,12
1746530812047,CHEM 6A,A02,886338,Lam; Tin Yiu,37,0,50,13
1746530813078,CHEM 6B,A01,886341,Hopkins; Patrycja Anna,16,0,50,34
1746530813078,CHEM 6B,A02,886343,Hopkins; Patrycja Anna,42,0,50,8
1746530814104,CHEM 6C,A01,886346,Albizati; Kim F.,0,2,50,50
1746530814104,CHEM 6C,A02,886348,Albizati; Kim F.,23,0,50,27
1746530815133,CHEM 40A,A01,886352,Klosterman; Jeremy K,65,0,100,35
1746530816165,CHEM 40B,A01,886356,Klosterman; Jeremy K,0,23,100,100
1746530817195,CHEM 41B,A01,886360,Theodorakis; Emmanuel,25,0,50,25
1746530817195,CHEM 41B,A02,886362,Theodorakis; Emmanuel,47,0,50,3
1746530818224,CHIN 165A,A00,886382,Xu; Li,18,0,20,2
1746530819254,CLAS 120,A00,886387,Myerston Santana; Jacobo,33,0,40,7
1746530820284,COGS 9,A01,886967,Shannon; Kyle Michael,42,0,60,18
1746530821312,COGS 11,A01,886969,Staff,11,0,30,19
1746530822340,COGS 14A,A01,886971,Staff,6,0,60,54
1746530823369,COGS 14B,A01,886973,Hoffman; Drew Ellen,4,0,60,56
1746530824397,COGS 18,A01,886975,Morgan; Eric,35,0,60,25
1746530825427,COGS 20,A01,886977,Staff,4,0,8,4
1746530825427,COGS 20,A02,886978,Staff,5,0,7,2
1746530826457,COGS 100,A01,907783,Staff,0,2,30,30
1746530827487,COGS 101B,A01,886980,Staff,0,3,48,48
1746530828515,COGS 101C,A01,886982,Delgado; Tania,0,5,44,44
1746530829543,COGS 102A,A01,886984,Johnson; Christine M.,4,0,30,26
1746530830574,COGS 118B,A01,886986,Staff,0,3,88,88
1746530831600,COGS 150,A01,886988,Bergen; Benjamin,23,0,50,27
1746530832627,COGS 153,A00,886989,Delgado; Tania,0,2,41,41
1746530833653,COGS 186,A01,886991,Staff,0,0,32,32
1746530834685,COGS 187A,A01,886993,Boyle; Mary E. T.,7,0,30,23
1746530835712,COGS 189,A00,886994,Staff,0,1,30,30
1746530836740,COMM 10,A01,886996,Staff,0,0,20,21
1746530836740,COMM 10,A02,886997,Staff,12,0,20,8
1746530836740,COMM 10,A03,959845,Staff,19,0,20,1
1746530837765,COMM 20,A01,886999,Leuning; Grant Maurstad,24,0,40,16
1746530839817,COMM 100A,A01,887002,Staff,0,0,20,25
1746530839817,COMM 100A,A02,887003,Staff,7,0,20,13
1746530840847,COMM 100B,A01,887005,Staff,0,8,20,24
1746530841877,COMM 106D,A00,887006,Staff,14,0,40,26
1746530842906,COMM 110G,A00,887007,Whitworth-Smith; Andrew C,12,0,40,28
1746530843934,COMM 111B,A00,887008,Staff,31,0,40,9
1746530844963,COMM 113T,A00,887009,Abuelhiga; Soraya Jill,28,0,40,12
1746530844963,COMM 113T,B00,906733,Staff,40,0,40,0
1746530845990,COMM 145,A00,887010,Staff,12,0,40,28
1746530847018,COMM 146,A00,887054,Staff,31,0,40,9
1746530848049,COMM 190,A00,887012,Staff,8,0,23,15
1746530849080,CSE 8A,A50,887015,Cao; Yingjun,57,0,85,28
1746530850105,CSE 11,A01,887017,Cao; Yingjun,12,0,70,58
1746530851135,CSE 20,A01,887019,Staff,30,0,50,20
1746530852169,CSE 21,A01,887021,Staff,78,0,100,22
1746530852169,CSE 21,B01,892583,Braun; Oliver,45,0,50,5
1746530853195,CSE 30,A01,887025,Eldon; John,143,0,200,57
1746530854224,CSE 100,A01,887027,Staff,26,0,50,24
1746530854224,CSE 100,A02,887028,Staff,40,0,50,10
1746530855255,CSE 101,A01,887030,Braun; Oliver,75,0,100,25
1746530855255,CSE 101,B01,887032,Jones; Miles E,0,3,50,50
1746530855255,CSE 101,B02,887033,Jones; Miles E,0,1,50,50
1746530856285,CSE 105,A01,908084,Jones; Miles E,32,0,50,18
1746530856285,CSE 105,A02,908087,Jones; Miles E,33,0,50,17
1746530857310,CSE 135,A01,887035,Powell; Thomas Allan,0,4,50,50
1746530858338,CSE 142,A01,887037,Staff,8,0,60,52
1746530859366,CSE 142L,A01,887039,Staff,34,0,60,26
1746530860391,CSE 151A,A01,887041,Solares; Edwin A,48,0,100,52
1746530861419,CSE 175,A01,887043,Kumar; Rakesh,30,0,30,0
1746530862446,CSS 1,A01,886389,Staff,0,1,40,40
1746530863474,DSC 30,A01,908097,Liao; Soohyun Nam,47,0,75,28
1746530864502,DSC 40A,A01,908099,Shannon; Kyle Michael,30,0,50,20
1746530865528,DSC 40B,A01,908112,Staff,16,0,50,34
1746530866559,DSC 80,A01,908116,Staff,19,0,60,41
1746530867588,DSC 197,001,956863,Eldridge; Justin Matthew,9999,0,9999,0
1746530868618,ECE 5,A01,886400,Morris; Karcher William,2,0,6,4
1746530868618,ECE 5,A02,886401,Morris; Karcher William,3,0,6,3
1746530869650,ECE 148,A01,886403,Silberman; Jack,0,14,14,14
1746530870679,ECON 1,A01,887265,Crane; Meredith Helen,12,0,70,58
1746530870679,ECON 1,B01,887268,Staff,43,0,50,7
1746530871748,ECON 2,A01,887273,Crane; Meredith Helen,56,0,70,14
1746530872775,ECON 3,A01,887279,Rondina; Giacomo,32,0,70,38
1746530873800,ECON 4,A01,887282,Anderson; John Charles,0,2,10,10
1746530874830,ECON 5,A01,887285,Staff,33,0,45,12
1746530874830,ECON 5,B01,887292,Staff,41,0,45,4
1746530875858,ECON 100A,A01,887337,Newhouse; Herbert S,54,0,70,16
1746530875858,ECON 100A,B01,887349,Staff,45,0,50,5
1746530876886,ECON 100B,A01,887361,Du; Songzi,29,0,70,41
1746530877914,ECON 100C,A01,887445,Newhouse; Herbert S,59,0,70,11
1746530878942,ECON 105,A00,887488,Vespa; Emanuel Ignacio,23,0,35,12
1746530879973,ECON 109,A01,887506,Shishkin; Denis,28,0,35,7
1746530881002,ECON 110A,A01,887568,Alon; Titan Michael,0,3,35,35
1746530881002,ECON 110A,B01,907601,Alon; Titan Michael,20,0,35,15
1746530882033,ECON 110B,A01,887598,Levkoff; Steven B.,0,23,70,70
1746530883063,ECON 112,A00,887599,Rondina; Giacomo,19,0,35,16
1746530884090,ECON 120A,A01,887603,Dai; Yinlin,36,0,70,34
1746530885119,ECON 120C,A01,887608,Sun; Yixiao,0,1,35,35
1746530885119,ECON 120C,B01,887614,Sun; Yixiao,0,0,35,35
1746530886145,ECON 138,A00,887621,Bharadwaj; Prashant,0,20,20,20
1746530898070,ECON 144,A00,958007,Squires; Dale E,13,0,35,22
1746530899103,ECON 171,A01,907666,Staff,18,0,35,17
1746530900224,ECON 175,A00,887626,Wu; Pak Yeung,23,0,35,12
1746530901262,ECON 190,A00,887640,Vespa; Emanuel Ignacio,23,0,35,12
1746530902292,EDS 25,A01,888197,Staff,0,0,0,0
1746530902292,EDS 25,A02,888209,Staff,0,0,0,0
1746530902292,EDS 25,A03,888210,Staff,0,0,0,0
1746530902292,EDS 25,A04,888212,Staff,0,0,0,0
1746530902292,EDS 25,A05,888213,Staff,0,0,0,0
1746530902292,EDS 25,A06,888214,Staff,0,0,0,0
1746530902292,EDS 25,A07,888235,Staff,0,2,0,0
1746530902292,EDS 25,A08,888236,Staff,0,0,0,0
1746530902292,EDS 25,A09,888240,Staff,0,0,0,0
1746530902292,EDS 25,A10,888244,Staff,0,0,0,0
1746530902292,EDS 25,B01,888273,Staff,0,0,0,0
1746530902292,EDS 25,B02,888285,Staff,0,0,0,0
1746530902292,EDS 25,B03,888423,Staff,0,0,0,1
1746530902292,EDS 25,B04,888432,Staff,0,0,0,0
1746530902292,EDS 25,B05,888433,Staff,0,0,0,0
1746530902292,EDS 25,B06,888467,Staff,0,0,0,0
1746530902292,EDS 25,B07,888468,Staff,0,0,0,0
1746530902292,EDS 25,B08,888479,Staff,0,0,0,0
1746530902292,EDS 25,B09,888484,Staff,0,0,0,0
1746530902292,EDS 25,B10,888487,Staff,0,0,0,0
1746530903324,EDS 38,A01,907700,Choi; Bailey Miyeon,30,0,30,0
1746530904357,EDS 112,A01,888601,Chapman; Thandeka K,14,0,40,26
1746530905387,EDS 115,A00,888697,Mendez; Kathrina Mendoza,10,0,30,20
1746530906418,EDS 116,A01,888893,Staff,35,0,40,5
1746530919611,EDS 124AR,A00,889133,Staff,29,0,50,21
1746530919611,EDS 124AR,B00,907471,Simon; Elizabeth A,37,0,50,13
1746530920639,EDS 124BR,A00,889134,Simon; Elizabeth A,45,0,100,55
1746530921672,EDS 125,A00,889135,Staff,25,0,30,5
1746530922706,EDS 126,A01,889138,Staff,36,0,40,4
1746530923737,EDS 164R,A01,889142,Wishard Guerra; Alison G.,33,0,50,17
1746530924768,ENG 30,A01,886396,Staff,0,0,0,0
1746530924768,ENG 30,B01,886398,Staff,0,0,0,0
1746530925800,ENVR 102,A00,906150,Montejo; Carolina,23,0,25,2
1746530926827,ETHN 103A,A00,887236,Man; Simeon S,0,3,0,0
1746530927855,ETHN 113,A00,887239,Staff,16,0,30,14
1746530928885,ETHN 116,A00,887240,Staff,16,0,25,9
1746530940919,ETHN 117,A00,887241,Choi; Esther Min,28,0,30,2
1746530941950,ETHN 118,A00,887243,Staff,24,0,30,6
1746530942981,ETHN 127,A00,887248,Cuong; Marisol,11,0,15,4
1746530944012,ETHN 139,A00,887250,Staff,7,0,10,3
1746530945046,ETHN 142,A00,887252,Staff,10,0,30,20
1746530946073,ETHN 161,A00,887253,Browne; Errol Tsekani,24,0,30,6
1746530947102,ETHN 163FR,A00,887255,Burelle; Julie Sara Veronique,0,0,5,5
1746530948133,GLBH 20,A00,889149,Elwardani; Nile Regina,8,0,42,34
1746530950189,GLBH 111,A01,889152,Burgos; Jose L.,17,0,17,0
1746530951220,GLBH 150,A00,889181,Sloane; Julia Kathryn,0,5,15,15
1746530963712,HDS 60,A01,886406,Warstadt; Melissa Fawn,73,0,80,7
1746530964744,HIAF 111,A00,889324,Gyamfi; Bright,25,0,32,7
1746530965773,HIEA 131,A00,889328,Staff,16,0,32,16
1746530966804,HIEA 144,A00,889333,Henry; Todd A.,26,0,32,6
1746530967833,HIEA 154,A00,889336,Henry; Todd A.,24,0,32,8
1746530968861,HIEU 106,A00,889339,Staff,22,0,32,10
1746530970921,HIEU 114,A00,889340,Staff,3,0,32,29
1746530971950,HIEU 135GS,A00,889342,Patterson; Patrick H.,0,0,1,24
1746530984240,HIEU 137,A00,889343,Edington; Claire Ellen,9,0,25,16
1746530985269,HIEU 148,A00,889345,Staff,14,0,32,18
1746530986294,HIEU 154,A00,889346,Biess; Frank Peter,21,0,32,11
1746530987330,HILA 102,A00,889351,Staff,12,0,32,20
1746530988356,HILD 2A,A01,889221,Lewandoski; Julia Mavis,1,10,32,31
1746530989389,HILD 7B,A01,889225,Man; Simeon S,0,13,32,32
1746530990417,HILD 7C,A01,889288,Alvarez; Luis A,0,14,32,32
1746530991448,HILD 30,A01,889323,Staff,0,5,32,32
1746530993508,HISC 119,A00,889383,Golan; Tal,21,0,32,11
1746531005736,HIUS 103,A00,889384,Man; Simeon S,0,0,32,32
1746531006766,HIUS 117,A00,919797,Kwak; Nancy,18,0,32,14
1746531007796,HIUS 142A,A00,919788,Staff,22,0,32,10
1746531009855,HIUS 149,A00,889386,Gyamfi; Bright,27,0,32,5
1746531010885,HIUS 155,A00,889387,Alvarez; Luis A,14,0,32,18
1746531011925,HUM 3,A01,886499,Caldwell; Michael Alan,19,0,50,31
1746531012956,HUM 3GS,A00,886500,Rodriguez; Bretton Sigfred,0,0,0,28
1746531013983,HUM 3R,A01,886502,Markman; Kristina,0,36,50,50
1746531015016,HUM 4,A01,886504,Crum; Matthew Stephen,24,0,50,26
1746531015016,HUM 4,B01,886506,West; Geoffrey Scott,17,0,50,33
1746531027517,HUM 4GS,A00,886507,Staff,0,0,0,19
1746531028545,HUM 5,A01,886509,Staff,32,0,50,18
1746531029574,HUM 5R,A01,886511,Zavodny; Tatiana Sophia,0,39,50,50
1746531030602,JAPN 180,A00,886407,Staff,18,0,40,22
1746531031633,LATI 50,A01,886409,Martin-Cabrera; Luis,4,0,22,18
1746531031633,LATI 50,A02,886410,Martin-Cabrera; Luis,19,0,22,3
1746531031633,LATI 50,A03,886411,Martin-Cabrera; Luis,21,0,22,1
1746531031633,LATI 50,A04,886412,Martin-Cabrera; Luis,9,0,22,13
1746531032661,LAWS 101,A00,907664,Staff,28,0,60,32
1746531033696,LIAB 1A,A00,889388,Saab; Dima,17,0,20,3
1746531034725,LIAB 1AX,A00,889389,El Cheddadi; Youniss,17,0,20,3
1746531035753,LIFR 1C,A00,889391,Van Moer; Vinciane G,8,0,20,12
1746531036785,LIFR 1CX,A00,889392,Van Moer; Vinciane G,7,0,20,13
1746531041172,LIFR 1D,A00,889393,Van Moer; Vinciane G,7,0,20,13
1746531042202,LIFR 1DX,A00,889394,Van Moer; Vinciane G,8,0,20,12
1746531043230,LIGN 7,A00,886923,Staff,24,0,50,26
1746531044258,LIGN 17,A00,886924,Kehler; Andrew Scott,125,0,150,25
1746531045291,LTAM 110,A00,889395,Staff,15,0,30,15
1746531046319,LTAM 110GS,A00,958010,Rodriguez; Bretton Sigfred,0,0,0,28
1746531047351,LTCH 101,A00,889397,Staff,23,0,25,2
1746531048381,LTCS 130,A00,889398,Staff,23,0,25,2
1746531049409,LTEA 138,A00,889399,Staff,24,0,40,16
1746531050436,LTEN 149,A00,889400,Wesling; Megan E.,0,3,25,25
1746531051465,LTEN 169,A00,889401,Staff,20,0,25,5
1746531052496,LTEN 180,A00,889402,Staff,10,0,15,5
1746531053527,LTEN 181,A00,889403,Staff,21,0,25,4
1746531054555,LTWL 100,A00,889404,Myerston Santana; Jacobo,3,0,25,22
1746531055583,LTWL 180GS,A00,889405,Staff,0,0,20,20
1746531056613,LTWL 181,A00,889406,Staff,17,0,25,8
1746531057648,LTWL 184,A00,889475,Mukherjee; Silpa,22,0,25,3
1746531058680,LTWR 102C,A00,889486,Staff,29,0,30,1
1746531059709,LTWR 115W,A00,889491,Staff,0,2,15,15
1746531060736,MAE 8,A01,886905,Staff,0,2,0,0
1746531061769,MAE 11,A00,886906,Bandaru; Prabhakar,0,7,50,50
1746531062798,MAE 20,A00,886907,Evdokimenko; Ekaterina,44,0,70,26
1746531063825,MAE 30B,A00,886909,Ghazinejad; Maziar,26,0,45,19
1746531064854,MAE 101B,A00,886910,Saintillan; David,29,0,45,16
1746531065884,MAE 105,A00,886911,Bandaru; Prabhakar,18,0,50,32
1746531066916,MAE 107,B00,958024,Staff,9,0,50,41
1746531067942,MAE 143B,A00,886913,Bewley; Thomas R,7,0,40,33
1746531068972,MAE 148,A01,886915,Silberman; Jack,0,3,14,14
1746531070002,MAE 160,A00,886916,Evdokimenko; Ekaterina,31,0,60,29
1746531071035,MATH 3C,A01,889681,Staff,0,3,30,30
1746531071035,MATH 3C,A02,960048,Staff,25,0,30,5
1746531072066,MATH 10A,A01,889760,Staff,26,0,30,4
1746531072066,MATH 10A,A02,889783,Staff,29,0,30,1
1746531073099,MATH 10B,A01,889785,Verstraete; Jacques Allan,2,0,35,33
1746531073099,MATH 10B,A02,889795,Verstraete; Jacques Allan,4,0,35,31
1746531073099,MATH 10B,B01,889797,Verstraete; Jacques Allan,3,0,35,32
1746531073099,MATH 10B,B02,889828,Verstraete; Jacques Allan,3,0,35,32
1746531074132,MATH 10C,A01,889849,Habib; Yousaf,9,0,30,21
1746531074132,MATH 10C,A02,889852,Habib; Yousaf,14,0,30,16
1746531074132,MATH 10C,A03,889853,Habib; Yousaf,22,0,30,8
1746531074132,MATH 10C,A04,889858,Habib; Yousaf,20,0,30,10
1746531074132,MATH 10C,B01,889861,Staff,1,0,30,29
1746531074132,MATH 10C,B02,889862,Staff,24,0,30,6
1746531074132,MATH 10C,B03,889863,Staff,27,0,30,3
1746531074132,MATH 10C,B04,889967,Staff,23,0,30,7
1746531075162,MATH 18,A01,889974,Staff,7,0,30,23
1746531075162,MATH 18,A02,889977,Staff,20,0,30,10
1746531075162,MATH 18,B01,889984,Hardiman; Liam,22,0,30,8
1746531075162,MATH 18,B02,889985,Hardiman; Liam,25,0,30,5
1746531076188,MATH 20A,A01,889990,Suk; Andrew Hoon,29,0,35,6
1746531077229,MATH 20B,A01,889993,Ohm; Ko Woon,22,0,30,8
1746531077229,MATH 20B,A02,889994,Ohm; Ko Woon,30,0,30,0
1746531077229,MATH 20B,B01,889996,Ohm; Ko Woon,21,0,30,9
1746531077229,MATH 20B,B02,889997,Ohm; Ko Woon,23,0,30,7
1746531078260,MATH 20C,A01,889999,Hammock; Frances H,17,0,30,13
1746531078260,MATH 20C,A02,890003,Hammock; Frances H,23,0,30,7
1746531078260,MATH 20C,B01,890006,Hammock; Frances H,3,0,30,27
1746531078260,MATH 20C,B02,890007,Hammock; Frances H,11,0,30,19
1746531079288,MATH 20D,A01,890011,Cheng; Hsiao-Bing,1,1,30,29
1746531079288,MATH 20D,A02,890012,Cheng; Hsiao-Bing,14,0,30,16
1746531079288,MATH 20D,B01,890016,Cheng; Hsiao-Bing,13,0,30,17
1746531079288,MATH 20D,B02,890017,Cheng; Hsiao-Bing,13,0,30,17
1746531080319,MATH 20E,A01,890026,Harel; Guershon,1,0,30,29
1746531080319,MATH 20E,A02,890029,Harel; Guershon,23,0,30,7
1746531080319,MATH 20E,B01,890033,Harel; Guershon,7,0,30,23
1746531080319,MATH 20E,B02,890101,Harel; Guershon,21,0,30,9
1746531081346,MATH 102,A01,890104,Staff,17,0,30,13
1746531081346,MATH 102,A02,890105,Staff,27,0,30,3
1746531082378,MATH 103B,A01,890116,Salehi Golsefidy; Alireza,3,0,30,27
1746531082378,MATH 103B,B01,890118,Staff,0,3,34,34
1746531083413,MATH 109,A01,890121,Aliabadi Sr.; Mohsen,1,0,30,29
1746531083413,MATH 109,B01,890124,Upadrashta; Pranav Kumar,18,0,30,12
1746531084441,MATH 120A,A01,890126,Eggers; John Dietrich,13,0,30,17
1746531085471,MATH 142B,A01,890128,Ioana; Adrian,19,0,30,11
1746531085471,MATH 142B,A02,890129,Ioana; Adrian,13,0,30,17
1746531086501,MATH 154,A01,890174,Staff,0,0,30,30
1746531086501,MATH 154,A02,890182,Staff,0,0,30,30
1746531087526,MATH 168A,A01,890197,Dumitriu; Ioana,21,0,35,14
1746531088553,MATH 170A,A01,890240,Nie; Jiawang,1,0,30,29
1746531088553,MATH 170A,A02,890241,Nie; Jiawang,11,0,30,19
1746531088553,MATH 170A,A03,890249,Nie; Jiawang,23,0,30,7
1746531089582,MATH 170B,A01,957891,Nag; Panchali,13,0,35,22
1746531091634,MATH 181A,A01,908025,Staff,0,4,35,35
1746531091634,MATH 181A,A02,960115,Staff,27,0,35,8
1746531092661,MATH 181B,A01,959874,Staff,26,0,30,4
1746531093690,MATH 193B,A01,890265,Staff,0,4,35,35
1746531094721,MGT 4,A01,890311,Anderson; John Charles,42,0,88,46
1746531095750,MGT 5,A00,907740,Staff,13,0,98,85
1746531096780,MGT 12,A00,890312,Lindenberger; Wade Douglas,67,0,98,31
1746531097806,MGT 16,A00,957883,Staff,78,0,98,20
1746531099861,MGT 45,A00,890314,Pecore; Joseph P.,47,0,98,51
1746531100889,MGT 71,A00,890315,Staff,0,11,98,98
1746531101919,MGT 100,A00,890316,Yavorsky; Daniel Ryan,44,0,98,54
1746531102948,MGT 103,A00,890317,Ehrich; Kristine R,73,0,98,25
1746531103979,MGT 105,A00,890356,Bates; Kenneth Walter,0,7,98,98
1746531105008,MGT 112,A00,890360,Ehrich; Kristine R,55,0,98,43
1746531106039,MGT 127R,A00,907732,Zhu; Kevin Xiaoguo,23,0,98,75
1746531107069,MGT 131B,A00,890361,Anderson; John Charles,61,0,98,37
1746531108098,MGT 137,A00,890362,Lindenberger; Wade Douglas,65,0,98,33
1746531109126,MGT 160,A00,890369,Johnson; Erik Barry,9,0,98,89
1746531111181,MGT 164,A00,890372,Zimmermann; Carsten,0,39,98,98
1746531112215,MGT 180,A00,890374,Bliss; Barbara Ann,12,0,98,86
1746531113250,MMW 15,A01,886414,Chang; Edmond Yi-Teh,0,12,28,28
1746531113250,MMW 15,A02,886415,Chang; Edmond Yi-Teh,0,8,28,28
1746531113250,MMW 15,A03,886416,Chang; Edmond Yi-Teh,0,8,28,28
1746531113250,MMW 15,A04,886417,Chang; Edmond Yi-Teh,0,8,28,28
1746531113250,MMW 15,B01,886419,Chang; Edmond Yi-Teh,0,7,28,28
1746531113250,MMW 15,B02,886420,Chang; Edmond Yi-Teh,0,8,28,28
1746531113250,MMW 15,B03,886421,Chang; Edmond Yi-Teh,0,7,28,28
1746531113250,MMW 15,B04,886422,Chang; Edmond Yi-Teh,0,8,28,28
1746531113250,MMW 15,C01,886424,Staff,0,9,28,28
1746531113250,MMW 15,C02,886425,Staff,0,8,28,28
1746531113250,MMW 15,C03,886426,Staff,0,8,28,28
1746531113250,MMW 15,C04,886427,Staff,0,7,28,28
1746531113250,MMW 15,C05,958038,Staff,0,7,28,28
1746531113250,MMW 15,C06,958039,Staff,0,8,28,28
1746531114276,MMW 15GS,A00,906910,Patterson; Patrick H.,4,0,28,24
1746531115303,MMW 122R,A01,886429,Rahimi; Babak,0,13,28,28
1746531115303,MMW 122R,A02,886430,Rahimi; Babak,0,12,28,28
1746531115303,MMW 122R,A03,958040,Rahimi; Babak,0,11,28,28
1746531116336,MUS 1A,A01,890937,Staff,3,0,25,22
1746531116336,MUS 1A,A02,891035,Staff,6,0,25,19
1746531116336,MUS 1A,C01,958912,Staff,24,0,25,1
1746531116336,MUS 1A,C02,958913,Staff,25,0,25,0
1746531118393,MUS 2AK,A00,957092,Ohnishi; Takae,15,0,15,0
1746531119423,MUS 4,A01,891044,Staff,2,0,25,23
1746531119423,MUS 4,A02,891045,Staff,23,0,25,2
1746531119423,MUS 4,B01,891048,Staff,17,0,25,8
1746531119423,MUS 4,B02,891050,Staff,25,0,25,0
1746531120456,MUS 5,A01,957506,Dubnov; Shlomo,0,0,25,25
1746531120456,MUS 5,A02,957622,Dubnov; Shlomo,14,0,25,11
1746531120456,MUS 5,A03,957623,Dubnov; Shlomo,20,0,25,5
1746531121487,MUS 6,A01,891053,Freitas Caetano; Marcelo,24,0,25,1
1746531121487,MUS 6,A02,891054,Freitas Caetano; Marcelo,23,0,25,2
1746531122520,MUS 7,A01,891081,Staff,0,0,25,25
1746531122520,MUS 7,A02,891082,Staff,4,0,25,21
1746531123553,MUS 8GS,A00,891118,Borgo; David Garcia,0,0,25,25
1746531124585,MUS 11,A01,891140,Staff,11,0,25,14
1746531124585,MUS 11,A02,891141,Staff,22,0,25,3
1746531125615,MUS 13,A01,891143,Staff,8,0,25,17
1746531125615,MUS 13,A02,891144,Staff,24,0,25,1
1746531126648,MUS 15,A01,891146,Staff,9,0,25,16
1746531126648,MUS 15,A02,891148,Staff,21,0,25,4
1746531126648,MUS 15,B01,891150,Staff,18,0,25,7
1746531126648,MUS 15,B02,891151,Staff,25,0,25,0
1746531127679,MUS 20,A01,891153,Staff,5,0,20,15
1746531127679,MUS 20,A02,891155,Staff,14,0,20,6
1746531128709,MUS 80,A00,891156,Staff,19,0,25,6
1746531128709,MUS 80,B00,891157,Staff,23,0,25,2
1746531129736,MUS 130,A00,891158,Ohnishi; Takae,35,0,35,0
1746531130767,MUS 150GS,A01,891160,Borgo; David Garcia,0,0,25,25
1746531131795,MUS 170,A01,891162,Freitas Caetano; Marcelo,20,0,25,5
1746531131795,MUS 170,A02,891164,Freitas Caetano; Marcelo,21,0,25,4
1746531132825,NANO 11,A00,886220,Vazquez Mena; Oscar,13,0,15,2
1746531133886,NANO 15,A01,886222,Drews; Aaron,4,0,7,3
1746531134914,NANO 104,A00,886224,Sirbuly; Donald,18,0,25,7
1746531135940,PH 40,A00,886528,Staff,23,0,40,17
1746531136970,PH 45,A01,886799,Staff,35,0,40,5
1746531137997,PH 110,A00,886802,Staff,0,7,40,40
1746531139022,PH 172,A00,906716,Staff,19,0,35,16
1746531140052,PH 191,A00,886803,Staff,6,0,40,34
1746531141079,PHIL 1,A00,889500,Staff,19,0,30,11
1746531142109,PHIL 10,A01,889549,Grush; Rick Scott,15,0,22,7
1746531142109,PHIL 10,A02,889551,Grush; Rick Scott,22,0,22,0
1746531143142,PHIL 28,A01,889559,Lamey; Andy M.,0,1,31,31
1746531143142,PHIL 28,A02,889561,Lamey; Andy M.,0,1,30,30
1746531143142,PHIL 28,A03,889572,Lamey; Andy M.,0,0,30,30
1746531144168,PHIL 35,A00,907839,Staff,13,0,15,2
1746531145197,PHIL 60,A00,889574,Staff,74,0,90,16
1746531146223,PHIL 101,A00,958004,Staff,13,0,15,2
1746531148275,PHIL 136,A00,889582,Fulkerson; Matthew Todd,26,0,45,19
1746531149302,PHIL 163,A01,889601,Staff,21,0,30,9
1746531149302,PHIL 163,B01,889606,Brandt; Reuven A,0,3,0,0
1746531150330,PHIL 164,A00,889610,Staff,16,0,30,14
1746531151358,PHIL 165,A00,889613,Staff,23,0,30,7
1746531152398,PHYS 1A,A00,886431,Staff,26,0,70,44
1746531153425,PHYS 1AL,001,886432,Tsai; Philbert S,0,2,30,30
1746531153425,PHYS 1AL,002,886436,Tsai; Philbert S,11,0,30,19
1746531154449,PHYS 1B,A00,886439,Staff,185,0,240,55
1746531155478,PHYS 1BL,001,886441,Tsai; Philbert S,0,4,30,30
1746531155478,PHYS 1BL,002,886444,Tsai; Philbert S,2,0,30,28
1746531156511,PHYS 1C,A00,896092,Arnold; Kam S,78,0,146,68
1746531157538,PHYS 1CL,001,886448,Tsai; Philbert S,0,0,30,30
1746531157538,PHYS 1CL,002,886449,Tsai; Philbert S,0,0,30,30
1746531157538,PHYS 1CL,003,886450,Tsai; Philbert S,15,0,30,15
1746531157538,PHYS 1CL,004,886451,Tsai; Philbert S,15,0,30,15
1746531158569,PHYS 2B,A01,886457,Staff,69,0,115,46
1746531159602,PHYS 2C,A01,886460,Shotwell; Brian,0,8,65,65
1746531160629,PHYS 2CL,A01,886467,Staff,0,4,28,28
1746531160629,PHYS 2CL,A02,886468,Staff,0,3,28,28
1746531161657,PHYS 2D,A01,886470,Staff,10,0,50,40
1746531162682,PHYS 4B,A01,886475,Grinstein; Benjamin,22,0,40,18
1746531163708,POLI 5,A00,891173,Desposato; Scott,7,0,25,18
1746531164736,POLI 5D,A01,891175,Staff,5,0,5,0
1746531164736,POLI 5D,B01,891178,Staff,5,0,5,0
1746531165766,POLI 11,A00,891179,Ferree; Karen E,2,0,35,33
1746531166797,POLI 12,A00,891180,Staff,16,0,30,14
1746531167827,POLI 27,A01,891182,Staff,12,0,75,63
1746531168855,POLI 30,A00,891183,Staff,9,0,50,41
1746531169880,POLI 100B,A00,891244,Staff,5,1,35,30
1746531170906,POLI 100I,A00,891247,Staff,7,0,30,23
1746531171937,POLI 104J,A00,891248,Nichter; Maysa,14,0,30,16
1746531172963,POLI 104U,A00,891250,Nichter; Maysa,2,0,30,28
1746531175017,POLI 110B,A00,891255,Wiens; David,20,0,25,5
1746531176044,POLI 112A,A00,891256,Wiens; David,6,0,25,19
1746531177069,POLI 114BR,A00,891261,Staff,19,0,30,11
1746531178099,POLI 117R,A00,891262,Forman; Fonna,0,6,50,50
1746531179124,POLI 118,A00,891264,Ingham; Sean,17,0,25,8
1746531180154,POLI 124A,A00,891265,Staff,18,0,20,2
1746531181180,POLI 125D,A00,891266,Nichter; Simeon C,2,0,25,23
1746531182209,POLI 126,A00,891268,Nichter; Simeon C,7,0,25,18
1746531183235,POLI 126AA,A00,891272,Staff,18,0,25,7
1746531184262,POLI 130AA,A00,891273,Staff,15,0,20,5
1746531185288,POLI 134AA,A00,891274,Staff,4,0,20,16
1746531187343,POLI 138,A00,891278,Staff,21,0,25,4
1746531188369,POLI 142K,A00,891280,Staff,11,0,25,14
1746531189399,POLI 142M,A00,891281,Gartzke; Erik,17,0,30,13
1746531190425,POLI 142P,A00,891284,Staff,20,0,30,10
1746531191453,POLI 143,A00,891285,Gartzke; Erik,12,0,30,18
1746531192480,POLI 153,A00,891286,Staff,19,0,20,1
1746531194566,POLI 175,A00,891290,Staff,15,0,20,5
1746531195599,PSYC 1,A00,890674,Steiner; Eric Tomas,0,11,45,45
1746531196628,PSYC 2,A00,890676,Albright; Thomas D,21,0,35,14
1746531197659,PSYC 3,A00,890679,Staff,17,0,20,3
1746531198690,PSYC 6,A00,959858,Staff,20,0,20,0
1746531199718,PSYC 60,A01,890684,Rickard; Timothy C.,0,5,45,45
1746531200749,PSYC 70,A01,890689,Geller; Emma Harlan,7,0,30,23
1746531201778,PSYC 71,A01,959860,Staff,21,0,25,4
1746531202807,PSYC 100,A00,890690,Lacefield; Katharine I,0,50,180,180
1746531203832,PSYC 102,A00,890695,Staff,18,0,40,22
1746531204860,PSYC 105,A00,890699,Geller; Emma Harlan,71,0,100,29
1746531205888,PSYC 106,A00,890701,Gorman; Michael R.,5,0,30,25
1746531206918,PSYC 108,A00,890704,Adrian; Julia Anna,0,28,50,50
1746531207947,PSYC 118,A01,890712,Staff,11,0,30,19
1746531208978,PSYC 124,A00,890716,Chapman; Eddie Nathaniel,25,0,60,35
1746531210006,PSYC 131,A00,890717,Anagnostaras; Stephan,0,7,80,80
1746531211035,PSYC 137,A00,890719,Winkielman; Piotr,0,11,30,30
1746531212063,PSYC 144,A00,890721,Adrian; Julia Anna,0,9,45,45
1746531213092,PSYC 162,A00,890805,Staff,2,0,75,73
1746531214120,PSYC 169,A00,890810,Staff,0,15,30,30
1746531215151,PSYC 172,A00,890814,Gorman; Michael R.,9,0,30,21
1746531216177,PSYC 181,A00,890818,Anagnostaras; Stephan,8,0,200,192
1746531217206,PSYC 184,A00,959861,Staff,170,0,175,5
1746531218234,PSYC 189,A00,890823,Staff,0,1,30,30
1746531219266,PSYC 191,A00,890884,Rickard; Timothy C.,0,11,35,35
1746531220296,PSYC 193,A00,890913,Staff,19,0,30,11
1746531220296,PSYC 193,B00,890914,Chapman; Eddie Nathaniel,24,0,30,6
1746531221323,PSYC 193L,A01,890918,Lowe; Angela Beth,20,0,30,10
1746531221323,PSYC 193L,B01,890921,Hurwitz; Ethan Scott,20,0,30,10
1746531221323,PSYC 193L,C01,890928,Staff,30,0,30,0
1746531222350,RELI 149,A00,886806,Rahimi; Babak,23,0,40,17
1746531223376,SE 9,A01,886814,Staff,7,0,20,13
1746531224403,SE 101B,A01,886816,Chadha; Mayank,4,0,35,31
1746531225433,SE 110B,A00,886818,Zhu; Qiang,4,0,75,71
1746531226460,SE 125,A01,886830,Staff,10,0,30,20
1746531227492,SE 130B,A01,886835,Staff,14,0,40,26
1746531228520,SE 131A,A01,886838,Krysl; Petr,34,0,55,21
1746531229549,SE 154,A00,886840,Staff,30,0,50,20
1746531230576,SE 164GS,A01,886849,Staff,6,0,20,14
1746531231643,SE 167GS,A01,886853,Staff,6,0,20,14
1746531232673,SIO 25,A01,890107,Staff,19,0,30,11
1746531233701,SIO 45,A00,890109,Cook; Geoffrey W,117,0,200,83
1746531234742,SIO 109R,A00,890110,Forman; Fonna,0,16,20,20
1746531235770,SIO 187,A01,890114,Kacev; David,15,0,40,25
1746531236800,SOCI 1,A01,890431,Thorpe; Charles Robert,15,0,30,15
1746531236800,SOCI 1,A02,890518,Thorpe; Charles Robert,30,0,30,0
1746531237828,SOCI 2,A01,957978,Staff,25,0,25,0
1746531237828,SOCI 2,A02,957979,Staff,23,0,25,2
1746531238858,SOCI 20,A01,890523,Calderon-Zaks; Michael Aar,23,0,30,7
1746531238858,SOCI 20,A02,890526,Calderon-Zaks; Michael Aar,29,0,30,1
1746531239887,SOCI 30,A01,890533,Pardo Guerra; Juan Pablo,37,0,40,3
1746531240911,SOCI 40,A01,890535,Staff,27,0,45,18
1746531241943,SOCI 104Q,A00,890559,Staff,18,0,30,12
1746531242970,SOCI 106,A00,890560,Arnal; Maud Marie Leonie,20,0,30,10
1746531243998,SOCI 110,A00,890567,Holkenbrink-Monk; Charlene,19,0,30,11
1746531245028,SOCI 112,A00,890568,Victoria Torres; Pablo,1,0,55,54
1746531246061,SOCI 115,A00,890597,Arnal; Maud Marie Leonie,28,0,45,17
1746531248118,SOCI 121,A00,890604,Pardo Guerra; Juan Pablo,38,0,45,7
1746531249147,SOCI 126,A01,890608,Staff,8,0,10,2
1746531250176,SOCI 127,A00,890609,Staff,18,0,30,12
1746531251204,SOCI 131,A00,890610,Thorpe; Charles Robert,37,0,45,8
1746531252234,SOCI 135,A00,890615,Payne; Christine Anna,14,0,45,31
1746531253262,SOCI 139,A00,890620,Staff,38,0,45,7
1746531254289,SOCI 148E,A00,890622,Calderon-Zaks; Michael Aar,36,0,45,9
1746531255314,SOCI 150,A00,890623,Kohler; Kristopher M.,31,0,45,14
1746531256345,SOCI 157,A00,890625,Jules-Rosette; Bennetta W.,18,0,20,2
1746531257371,SOCI 160,A00,890627,Payne; Christine Anna,21,0,45,24
1746531258399,SYN 1,A00,886855,Fish; Gwendolyn Anne,0,0,0,0
1746531258399,SYN 1,B00,906086,Fish; Gwendolyn Anne,0,1,0,2
1746531259427,SYN 2R,A00,886860,Staff,0,17,15,15
1746531259427,SYN 2R,B00,906106,Atkinson; Arthur Laird,0,16,15,15
1746531260463,SYN 100,A01,886866,Browne; Emily,0,28,20,20
1746531260463,SYN 100,B01,906128,Rock; Martin,0,5,20,20
1746531260463,SYN 100,C01,906140,Deavenport; James Cary,0,3,20,20
1746531260463,SYN 100,D01,907816,Deavenport; James Cary,0,5,20,20
1746531261490,TDAC 1,A00,890286,Walsh; Kim C.,9,0,20,11
1746531262516,TDAC 101,A00,890296,Basso; Beatrice,16,0,20,4
1746531263545,TDDE 131,A00,890297,Staff,47,0,50,3
1746531264577,TDDM 1,A00,890287,Weinberg; Sadie,25,0,30,5
1746531265605,TDGE 11,A00,890288,Fulton; Julia,137,0,200,63
1746531265605,TDGE 11,B00,890289,Castro; Robert Jess,184,0,200,16
1746531266631,TDGE 25,B00,957359,Walsh; Kim C.,3,0,20,17
1746531267659,TDGE 40,A01,890292,Power; Jade Yukana,27,0,30,3
1746531268686,TDGE 124,A00,890298,Havis; Allan,0,0,50,50
1746531269716,TDGE 131R,A00,890299,Burelle; Julie Sara Veronique,15,0,42,27
1746531270745,TDHT 101,A00,890300,Staff,10,0,20,10
1746531271771,TDHT 109,A01,890302,Anderson; Mysia Anyse,31,0,40,9
1746531272799,TDMV 1,A00,890293,Arcidiacono; Kristin,18,0,30,12
1746531273831,TDMV 2,A00,890294,Weinberg; Sadie,23,0,30,7
1746531274858,TDMV 3,A00,957878,Arcidiacono; Kristin,28,0,30,2
1746531276915,TDMV 138,A00,890304,Jun; Grace Shin Hae,25,0,40,15
1746531277943,TDMV 140,A00,890305,Corrales; Joseph Bernales,25,0,30,5
1746531278972,TDMV 142,A00,890307,Caligagan; Tony,32,0,40,8
1746531280000,TDMV 144,A00,890308,Camaya; Michelle Ann,25,0,30,5
1746531281026,TDPW 1,A00,890295,Stein; Deborah Isobel,3,0,20,17
1746531282057,USP 2,A01,890272,Lerner; Amy M,6,0,20,14
1746531283099,USP 3,A01,890274,Staff,12,0,30,18
1746531284125,USP 15,A01,890276,Sun; Feiyang,17,0,30,13
1746531285155,USP 25,A00,890277,Shenkman; Michael Thomas,19,0,25,6
1746531286183,USP 138,A00,890278,Staff,13,0,25,12
1746531287210,USP 143,A00,890279,Staff,21,0,70,49
1746531288242,USP 144,A00,890280,Chowdhury; Muhammed Zohir,16,0,30,14
1746531289270,USP 150,A00,890281,Boomhower; Matthew Charles,4,0,30,26
1746531290296,USP 151,A00,890282,Staff,16,0,20,4
1746531291330,USP 162,A00,890283,Andrews; Abigail Leslie,16,0,20,4
1746531292357,USP 168,A00,920477,Kwak; Nancy,1,0,5,4
1746531293384,USP 181,A00,890284,Staff,3,0,20,17
1746531294412,USP 191A,A00,890285,Staff,13,0,20,7
1746531295441,VIS 101,A00,886512,Staff,25,0,75,50
1746531296466,VIS 103,A00,886513,Cruz; Edwin Teddy,61,0,75,14
1746531297494,VIS 108,A00,886514,Staff,3,0,15,12
1746531298523,VIS 127P,A00,886515,Shen; Kuiyi,80,0,146,66
1746531299548,VIS 149,A00,886516,Yoldas; Pinar,0,0,15,15
1746531300580,VIS 164,A00,886526,Erdmann; Dean,19,0,22,3
1746531301610,VIS 194S,A00,886527,Staff,61,0,75,14
1746531302638,WCWP 10A,C00,886484,Martiniuk; Jill,12,0,15,3
1746531303668,WCWP 10B,A00,886490,Uriarte; Emma,0,0,15,15
1746531303668,WCWP 10B,B00,886491,Dhir; Simrita,11,0,15,4
1746531303668,WCWP 10B,C00,886492,Ornelas; Tricia,0,0,15,15
1746531304698,WCWP 100,A00,886494,Young; Mark T,0,7,15,15
1746531306873,AAS 10,A01,886199,Childs; Dennis R.,0,3,0,0
1746531307899,ANAR 104,A01,886940,Shtienberg; Gilad,27,0,30,3
1746531308926,ANAR 120,A00,886953,Staff,12,0,20,8
1746531309957,ANBI 148,A01,886955,Wilder; Linnea Lorene,30,0,40,10
1746531312010,ANSC 122,A00,886957,Staff,25,0,30,5
1746531313042,ANSC 150,A00,886958,Sloane; Julia Kathryn,3,0,15,12
1746531314070,ANSC 156,A00,886959,Jenkins; Janis A.,0,1,15,15
1746531315100,ANSC 180,A00,886960,Staff,11,0,17,6
1746531316131,ANSC 188,A00,886961,Jassal; Aftab,9,0,25,16
1746531317163,ANSC 190,A00,886962,Jassal; Aftab,14,0,25,11
1746531318189,ANSC 191,A00,886963,Staff,18,0,20,2
1746531319222,ANTH 3,A01,891689,Staff,17,0,20,3
1746531320249,ANTH 5,A00,886933,Semendeferi; Ekaterini,16,0,20,4
1746531321275,ANTH 10,A00,886934,Staff,0,12,30,30
1746531322301,ANTH 21,A01,886936,Staff,40,0,60,20
1746531323329,ANTH 23,A01,886938,Staff,92,0,100,8
1746531324360,ANTH 105,A00,886964,Stewart; Alexander B,84,0,100,16
1746531325389,ANTH 108,A00,886965,Pedersen; David,9,0,20,11
1746531326419,AWP 10,001,886147,Staff,0,0,0,0
1746531326419,AWP 10,002,886148,Staff,0,0,0,0
1746531326419,AWP 10,003,886149,Staff,0,0,0,0
1746531326419,AWP 10,004,886150,Staff,0,0,0,0
1746531326419,AWP 10,005,886151,Staff,0,0,0,0
1746531326419,AWP 10,006,886152,Staff,0,0,0,0
1746531326419,AWP 10,007,886153,Staff,0,0,0,0
1746531326419,AWP 10,008,886154,Staff,0,0,0,0
1746531326419,AWP 10,009,886155,Staff,0,0,0,0
1746531326419,AWP 10,010,886156,Staff,0,0,0,0
1746531326419,AWP 10,011,886158,Staff,0,0,0,0
1746531326419,AWP 10,012,886160,Staff,0,0,0,0
1746531326419,AWP 10,013,886161,Staff,0,0,0,0
1746531326419,AWP 10,014,886162,Staff,0,0,0,0
1746531326419,AWP 10,015,886163,Staff,0,0,0,0
1746531326419,AWP 10,016,886164,Staff,0,0,0,0
1746531326419,AWP 10,017,886165,Staff,0,0,0,0
1746531326419,AWP 10,018,886166,Staff,0,0,0,0
1746531326419,AWP 10,019,886168,Staff,0,0,0,0
1746531326419,AWP 10,020,886170,Staff,0,0,0,0
1746531326419,AWP 10,021,886172,Staff,0,0,0,0
1746531327453,AWP 10R,001,886173,Staff,0,1,0,0
1746531327453,AWP 10R,002,886174,Staff,0,1,0,0
1746531327453,AWP 10R,003,886175,Staff,0,0,0,0
1746531327453,AWP 10R,004,886176,Staff,0,0,0,0
1746531327453,AWP 10R,005,886177,Staff,0,0,0,0
1746531327453,AWP 10R,006,886178,Staff,0,0,0,0
1746531327453,AWP 10R,007,886179,Staff,0,0,0,0
1746531327453,AWP 10R,008,886181,Staff,0,0,0,0
1746531327453,AWP 10R,009,886182,Staff,0,0,0,0
1746531327453,AWP 10R,010,886183,Staff,0,0,0,0
1746531327453,AWP 10R,011,886184,Staff,0,0,0,0
1746531327453,AWP 10R,012,886185,Staff,0,0,0,0
1746531327453,AWP 10R,013,886186,Staff,0,0,0,0
1746531327453,AWP 10R,014,886187,Staff,0,0,0,0
1746531327453,AWP 10R,015,886188,Staff,0,0,0,0
1746531327453,AWP 10R,016,886189,Staff,0,0,0,0
1746531328479,AWP 102R,A00,886190,Staff,0,0,0,0
1746531328479,AWP 102R,B00,886191,Staff,0,0,0,0
1746531329509,BENG 100,A01,886193,Staff,17,0,30,13
1746531330539,BENG 122A,A01,886195,Hasty; Jeff M,13,0,30,17
1746531331570,BENG 166A,A00,886196,Sah; Robert Lie-Yuan,0,1,30,30
1746531332602,BENG 190,A00,958050,Khojah; Reem I,24,0,25,1
1746531333633,BIBC 102,A01,894320,Staff,0,0,46,46
1746531333633,BIBC 102,A02,894321,Staff,1,0,46,45
1746531333633,BIBC 102,A03,894344,Staff,7,0,46,39
1746531333633,BIBC 102,A04,894345,Staff,26,0,47,21
1746531334665,BICD 100R,A01,894365,Smith; Laurie,0,3,58,58
1746531334665,BICD 100R,A02,894366,Smith; Laurie,0,5,58,58
1746531334665,BICD 100R,A03,894367,Smith; Laurie,2,0,59,57
1746531334665,BICD 100R,A04,959869,Smith; Laurie,41,0,59,18
1746531335749,BICD 136,A01,894383,Gustafson-Brown; Cindy,14,0,50,36
1746531336782,BIEB 102,A01,894494,Butler; Shannon Rhey,51,0,130,79
1746531338842,BIEB 150,A01,894617,Wills; Christopher,3,0,20,17
1746531338842,BIEB 150,A02,894631,Wills; Christopher,3,0,20,17
1746531338842,BIEB 150,A03,894937,Wills; Christopher,4,0,20,16
1746531338842,BIEB 150,A04,894946,Wills; Christopher,5,0,20,15
1746531339873,BIEB 194,A00,906141,Kurle; Carolyn M.,6,0,20,14
1746531340901,BILD 1,A01,894154,Staff,2,0,19,17
1746531340901,BILD 1,A02,894155,Staff,14,0,19,5
1746531340901,BILD 1,A03,894160,Staff,13,0,19,6
1746531340901,BILD 1,A04,894161,Staff,15,0,18,3
1746531341929,BILD 2,A01,894168,Staff,0,0,50,50
1746531341929,BILD 2,A02,894169,Staff,0,0,50,50
1746531341929,BILD 2,A03,894179,Staff,4,0,50,46
1746531341929,BILD 2,A04,894203,Staff,27,0,50,23
1746531342961,BILD 3,A01,894213,Staff,22,0,31,9
1746531342961,BILD 3,A02,894214,Staff,26,0,31,5
1746531342961,BILD 3,A03,894235,Staff,28,0,31,3
1746531342961,BILD 3,A04,894236,Staff,28,0,32,4
1746531343991,BILD 4,A01,894253,Reuther; Keefe,5,0,24,19
1746531343991,BILD 4,A02,894258,Reuther; Keefe,16,0,24,8
1746531345020,BILD 5,A01,894276,Reuther; Keefe,35,0,50,15
1746531345020,BILD 5,A02,894277,Reuther; Keefe,45,0,50,5
1746531345020,BILD 5,A03,894290,Reuther; Keefe,44,0,50,6
1746531345020,BILD 5,A04,894291,Reuther; Keefe,48,0,50,2
1746531346052,BILD 24,A01,894297,Pirino; Giorgia,40,0,60,20
1746531347084,BIMM 100,B01,958915,Staff,72,0,100,28
1746531348111,BIMM 101,A01,895017,McDonnell; Lisa Marie,0,5,24,24
1746531348111,BIMM 101,A02,895018,McDonnell; Lisa Marie,0,5,24,24
1746531348111,BIMM 101,B01,895020,McDonnell; Lisa Marie,0,6,24,24
1746531348111,BIMM 101,B02,895021,McDonnell; Lisa Marie,0,4,24,24
1746531349142,BIMM 110,A01,895023,Staff,1,0,25,24
1746531349142,BIMM 110,A02,895024,Staff,9,0,25,16
1746531349142,BIMM 110,A03,895025,Staff,18,0,25,7
1746531349142,BIMM 110,A04,895031,Staff,20,0,25,5
1746531350171,BIMM 120,A01,895114,Gustafson-Brown; Cindy,13,0,28,15
1746531350171,BIMM 120,A02,895126,Gustafson-Brown; Cindy,20,0,27,7
1746531351204,BIPN 100,A01,895130,Yang; Mingyu,1,0,38,37
1746531351204,BIPN 100,A02,895131,Yang; Mingyu,32,0,38,6
1746531351204,BIPN 100,A03,895132,Yang; Mingyu,32,0,38,6
1746531351204,BIPN 100,A04,895133,Yang; Mingyu,27,0,36,9
1746531352236,BIPN 120,A01,895135,Cooke; James Edward,0,3,13,13
1746531352236,BIPN 120,A02,895136,Cooke; James Edward,0,1,13,13
1746531352236,BIPN 120,A03,895137,Cooke; James Edward,0,3,13,13
1746531352236,BIPN 120,A04,895156,Cooke; James Edward,0,2,11,11
1746531353268,BIPN 134,A01,895235,Cooke; James Edward,0,2,25,25
1746531353268,BIPN 134,A02,895237,Cooke; James Edward,0,0,25,25
1746531353268,BIPN 134,A03,895240,Cooke; James Edward,3,0,25,22
1746531353268,BIPN 134,A04,895270,Cooke; James Edward,20,0,25,5
1746531354299,BIPN 189,A00,892103,Staff,0,13,14,14
1746531356357,BISP 194,A00,958008,Staff,0,2,0,0
1746531357384,CAT 124,A01,922009,Staff,0,5,20,20
1746531358410,CAT 125R,A00,886390,Morales; Celeste Georgianna,0,2,20,20
1746531358410,CAT 125R,B00,886391,Irwin; Matthew Joseph,0,3,20,20
1746531358410,CAT 125R,C00,886392,Smith; Lauryn Alissa,0,2,20,20
1746531358410,CAT 125R,D00,886393,Vanderschuit; Maya Alysia,0,2,20,20
1746531358410,CAT 125R,E00,886394,Marchisotto; Jennifer Anne,0,4,20,20
1746531359438,CENG 15,A01,886218,Drews; Aaron,3,0,8,5
1746531360467,CENG 113,A00,886219,Opatkiewicz; Justin Paul,15,0,25,10
1746531361495,CGS 101,A00,887044,Staff,7,0,20,13
1746531362521,CGS 105,A01,887046,Staff,14,0,25,11
1746531363547,CGS 112,A00,887047,Cuong; Marisol,12,0,15,3
1746531364573,CGS 113,A00,887048,Staff,23,0,30,7
1746531365599,CGS 120,A00,887049,Staff,10,0,17,7
1746531366626,CHEM 6A,A01,886336,Lam; Tin Yiu,38,0,50,12
1746531366626,CHEM 6A,A02,886338,Lam; Tin Yiu,37,0,50,13
1746531367653,CHEM 6B,A01,886341,Hopkins; Patrycja Anna,16,0,50,34
1746531367653,CHEM 6B,A02,886343,Hopkins; Patrycja Anna,42,0,50,8
1746531368683,CHEM 6C,A01,886346,Albizati; Kim F.,0,2,50,50
1746531368683,CHEM 6C,A02,886348,Albizati; Kim F.,23,0,50,27
1746531369716,CHEM 40A,A01,886352,Klosterman; Jeremy K,65,0,100,35
1746531370750,CHEM 40B,A01,886356,Klosterman; Jeremy K,0,23,100,100
1746531371778,CHEM 41B,A01,886360,Theodorakis; Emmanuel,25,0,50,25
1746531371778,CHEM 41B,A02,886362,Theodorakis; Emmanuel,47,0,50,3
1746531372806,CHIN 165A,A00,886382,Xu; Li,18,0,20,2
1746531373831,CLAS 120,A00,886387,Myerston Santana; Jacobo,33,0,40,7
1746531374863,COGS 9,A01,886967,Shannon; Kyle Michael,42,0,60,18
1746531375894,COGS 11,A01,886969,Staff,11,0,30,19
1746531376921,COGS 14A,A01,886971,Staff,6,0,60,54
1746531377948,COGS 14B,A01,886973,Hoffman; Drew Ellen,4,0,60,56
1746531378977,COGS 18,A01,886975,Morgan; Eric,35,0,60,25
1746531380009,COGS 20,A01,886977,Staff,4,0,8,4
1746531380009,COGS 20,A02,886978,Staff,5,0,7,2
1746531381036,COGS 100,A01,907783,Staff,0,2,30,30
1746531382067,COGS 101B,A01,886980,Staff,0,3,48,48
1746531383093,COGS 101C,A01,886982,Delgado; Tania,0,5,44,44
1746531384121,COGS 102A,A01,886984,Johnson; Christine M.,4,0,30,26
1746531385148,COGS 118B,A01,886986,Staff,0,3,88,88
1746531386175,COGS 150,A01,886988,Bergen; Benjamin,23,0,50,27
1746531387201,COGS 153,A00,886989,Delgado; Tania,0,2,41,41
1746531388230,COGS 186,A01,886991,Staff,0,0,32,32
1746531389259,COGS 187A,A01,886993,Boyle; Mary E. T.,7,0,30,23
1746531390284,COGS 189,A00,886994,Staff,0,1,30,30
1746531391310,COMM 10,A01,886996,Staff,0,0,20,21
1746531391310,COMM 10,A02,886997,Staff,12,0,20,8
1746531391310,COMM 10,A03,959845,Staff,19,0,20,1
1746531392340,COMM 20,A01,886999,Leuning; Grant Maurstad,24,0,40,16
1746531394394,COMM 100A,A01,887002,Staff,0,0,20,25
1746531394394,COMM 100A,A02,887003,Staff,7,0,20,13
1746531395423,COMM 100B,A01,887005,Staff,0,8,20,24
1746531396452,COMM 106D,A00,887006,Staff,14,0,40,26
1746531397478,COMM 110G,A00,887007,Whitworth-Smith; Andrew C,12,0,40,28
1746531398506,COMM 111B,A00,887008,Staff,31,0,40,9
1746531399533,COMM 113T,A00,887009,Abuelhiga; Soraya Jill,28,0,40,12
1746531399533,COMM 113T,B00,906733,Staff,40,0,40,0
1746531400562,COMM 145,A00,887010,Staff,12,0,40,28
1746531401593,COMM 146,A00,887054,Staff,31,0,40,9
1746531402623,COMM 190,A00,887012,Staff,8,0,23,15
1746531403652,CSE 8A,A50,887015,Cao; Yingjun,57,0,85,28
1746531404680,CSE 11,A01,887017,Cao; Yingjun,12,0,70,58
1746531405709,CSE 20,A01,887019,Staff,30,0,50,20
1746531406740,CSE 21,A01,887021,Staff,78,0,100,22
1746531406740,CSE 21,B01,892583,Braun; Oliver,45,0,50,5
1746531407768,CSE 30,A01,887025,Eldon; John,143,0,200,57
1746531408798,CSE 100,A01,887027,Staff,26,0,50,24
1746531408798,CSE 100,A02,887028,Staff,40,0,50,10
1746531409827,CSE 101,A01,887030,Braun; Oliver,75,0,100,25
1746531409827,CSE 101,B01,887032,Jones; Miles E,0,3,50,50
1746531409827,CSE 101,B02,887033,Jones; Miles E,0,1,50,50
1746531410858,CSE 105,A01,908084,Jones; Miles E,32,0,50,18
1746531410858,CSE 105,A02,908087,Jones; Miles E,33,0,50,17
1746531411885,CSE 135,A01,887035,Powell; Thomas Allan,0,4,50,50
1746531412915,CSE 142,A01,887037,Staff,8,0,60,52
1746531413943,CSE 142L,A01,887039,Staff,34,0,60,26
1746531414972,CSE 151A,A01,887041,Solares; Edwin A,48,0,100,52
1746531415997,CSE 175,A01,887043,Kumar; Rakesh,30,0,30,0
1746531417024,CSS 1,A01,886389,Staff,0,1,40,40
1746531418056,DSC 30,A01,908097,Liao; Soohyun Nam,47,0,75,28
1746531419083,DSC 40A,A01,908099,Shannon; Kyle Michael,30,0,50,20
1746531420107,DSC 40B,A01,908112,Staff,16,0,50,34
1746531421136,DSC 80,A01,908116,Staff,19,0,60,41
1746531422163,DSC 197,001,956863,Eldridge; Justin Matthew,9999,0,9999,0
1746531423188,ECE 5,A01,886400,Morris; Karcher William,2,0,6,4
1746531423188,ECE 5,A02,886401,Morris; Karcher William,3,0,6,3
1746531435249,ECE 148,A01,886403,Silberman; Jack,0,14,14,14
1746531436281,ECON 1,A01,887265,Crane; Meredith Helen,12,0,70,58
1746531436281,ECON 1,B01,887268,Staff,43,0,50,7
1746531437309,ECON 2,A01,887273,Crane; Meredith Helen,56,0,70,14
1746531438340,ECON 3,A01,887279,Rondina; Giacomo,32,0,70,38
1746531439367,ECON 4,A01,887282,Anderson; John Charles,0,2,10,10
1746531440404,ECON 5,A01,887285,Staff,33,0,45,12
1746531440404,ECON 5,B01,887292,Staff,41,0,45,4
1746531441430,ECON 100A,A01,887337,Newhouse; Herbert S,54,0,70,16
1746531441430,ECON 100A,B01,887349,Staff,45,0,50,5
1746531442458,ECON 100B,A01,887361,Du; Songzi,29,0,70,41
1746531443485,ECON 100C,A01,887445,Newhouse; Herbert S,59,0,70,11
1746531444513,ECON 105,A00,887488,Vespa; Emanuel Ignacio,23,0,35,12
1746531451687,ECON 109,A01,887506,Shishkin; Denis,28,0,35,7
1746531452717,ECON 110A,A01,887568,Alon; Titan Michael,0,3,35,35
1746531452717,ECON 110A,B01,907601,Alon; Titan Michael,20,0,35,15
1746531453752,ECON 110B,A01,887598,Levkoff; Steven B.,0,23,70,70
1746531454778,ECON 112,A00,887599,Rondina; Giacomo,19,0,35,16
1746531455807,ECON 120A,A01,887603,Dai; Yinlin,36,0,70,34
1746531456838,ECON 120C,A01,887608,Sun; Yixiao,0,1,35,35
1746531456838,ECON 120C,B01,887614,Sun; Yixiao,0,0,35,35
1746531457867,ECON 138,A00,887621,Bharadwaj; Prashant,0,20,20,20
1746531458893,ECON 144,A00,958007,Squires; Dale E,13,0,35,22
1746531459919,ECON 171,A01,907666,Staff,18,0,35,17
1746531460948,ECON 175,A00,887626,Wu; Pak Yeung,23,0,35,12
1746531461976,ECON 190,A00,887640,Vespa; Emanuel Ignacio,23,0,35,12
1746531463011,EDS 25,A01,888197,Staff,0,0,0,0
1746531463011,EDS 25,A02,888209,Staff,0,0,0,0
1746531463011,EDS 25,A03,888210,Staff,0,0,0,0
1746531463011,EDS 25,A04,888212,Staff,0,0,0,0
1746531463011,EDS 25,A05,888213,Staff,0,0,0,0
1746531463011,EDS 25,A06,888214,Staff,0,0,0,0
1746531463011,EDS 25,A07,888235,Staff,0,2,0,0
1746531463011,EDS 25,A08,888236,Staff,0,0,0,0
1746531463011,EDS 25,A09,888240,Staff,0,0,0,0
1746531463011,EDS 25,A10,888244,Staff,0,0,0,0
1746531463011,EDS 25,B01,888273,Staff,0,0,0,0
1746531463011,EDS 25,B02,888285,Staff,0,0,0,0
1746531463011,EDS 25,B03,888423,Staff,0,0,0,1
1746531463011,EDS 25,B04,888432,Staff,0,0,0,0
1746531463011,EDS 25,B05,888433,Staff,0,0,0,0
1746531463011,EDS 25,B06,888467,Staff,0,0,0,0
1746531463011,EDS 25,B07,888468,Staff,0,0,0,0
1746531463011,EDS 25,B08,888479,Staff,0,0,0,0
1746531463011,EDS 25,B09,888484,Staff,0,0,0,0
1746531463011,EDS 25,B10,888487,Staff,0,0,0,0
1746531464041,EDS 38,A01,907700,Choi; Bailey Miyeon,30,0,30,0
1746531465066,EDS 112,A01,888601,Chapman; Thandeka K,14,0,40,26
1746531466097,EDS 115,A00,888697,Mendez; Kathrina Mendoza,10,0,30,20
1746531467125,EDS 116,A01,888893,Staff,35,0,40,5
1746531469176,EDS 124AR,A00,889133,Staff,29,0,50,21
1746531469176,EDS 124AR,B00,907471,Simon; Elizabeth A,37,0,50,13
1746531470201,EDS 124BR,A00,889134,Simon; Elizabeth A,45,0,100,55
1746531471229,EDS 125,A00,889135,Staff,25,0,30,5
1746531472256,EDS 126,A01,889138,Staff,36,0,40,4
1746531473285,EDS 164R,A01,889142,Wishard Guerra; Alison G.,33,0,50,17
1746531474314,ENG 30,A01,886396,Staff,0,0,0,0
1746531474314,ENG 30,B01,886398,Staff,0,0,0,0
1746531475341,ENVR 102,A00,906150,Montejo; Carolina,23,0,25,2
1746531476370,ETHN 103A,A00,887236,Man; Simeon S,0,3,0,0
1746531477397,ETHN 113,A00,887239,Staff,16,0,30,14
1746531478426,ETHN 116,A00,887240,Staff,16,0,25,9
1746531479453,ETHN 117,A00,887241,Choi; Esther Min,28,0,30,2
1746531480484,ETHN 118,A00,887243,Staff,24,0,30,6
1746531481514,ETHN 127,A00,887248,Cuong; Marisol,11,0,15,4
1746531482541,ETHN 139,A00,887250,Staff,7,0,10,3
1746531483570,ETHN 142,A00,887252,Staff,10,0,30,20
1746531484600,ETHN 161,A00,887253,Browne; Errol Tsekani,24,0,30,6
1746531485630,ETHN 163FR,A00,887255,Burelle; Julie Sara Veronique,0,0,5,5
1746531486659,GLBH 20,A00,889149,Elwardani; Nile Regina,8,0,42,34
1746531488720,GLBH 111,A01,889152,Burgos; Jose L.,17,0,17,0
1746531489777,GLBH 150,A00,889181,Sloane; Julia Kathryn,0,5,15,15
1746531491835,HDS 60,A01,886406,Warstadt; Melissa Fawn,73,0,80,7
1746531492864,HIAF 111,A00,889324,Gyamfi; Bright,25,0,32,7
1746531493890,HIEA 131,A00,889328,Staff,16,0,32,16
1746531494916,HIEA 144,A00,889333,Henry; Todd A.,26,0,32,6
1746531495945,HIEA 154,A00,889336,Henry; Todd A.,24,0,32,8
1746531496970,HIEU 106,A00,889339,Staff,22,0,32,10
1746531499022,HIEU 114,A00,889340,Staff,3,0,32,29
1746531500049,HIEU 135GS,A00,889342,Patterson; Patrick H.,0,0,1,24
1746531501075,HIEU 137,A00,889343,Edington; Claire Ellen,9,0,25,16
1746531502102,HIEU 148,A00,889345,Staff,14,0,32,18
1746531503128,HIEU 154,A00,889346,Biess; Frank Peter,21,0,32,11
1746531504160,HILA 102,A00,889351,Staff,12,0,32,20
1746531505189,HILD 2A,A01,889221,Lewandoski; Julia Mavis,1,10,32,31
1746531506216,HILD 7B,A01,889225,Man; Simeon S,0,13,32,32
1746531507243,HILD 7C,A01,889288,Alvarez; Luis A,0,14,32,32
1746531508269,HILD 30,A01,889323,Staff,0,5,32,32
1746531510329,HISC 119,A00,889383,Golan; Tal,21,0,32,11
1746531511357,HIUS 103,A00,889384,Man; Simeon S,0,0,32,32
1746531512383,HIUS 117,A00,919797,Kwak; Nancy,18,0,32,14
1746531513409,HIUS 142A,A00,919788,Staff,22,0,32,10
1746531515462,HIUS 149,A00,889386,Gyamfi; Bright,27,0,32,5
1746531516487,HIUS 155,A00,889387,Alvarez; Luis A,14,0,32,18
1746531517519,HUM 3,A01,886499,Caldwell; Michael Alan,19,0,50,31
1746531518547,HUM 3GS,A00,886500,Rodriguez; Bretton Sigfred,0,0,0,28
1746531519574,HUM 3R,A01,886502,Markman; Kristina,0,36,50,50
1746531520604,HUM 4,A01,886504,Crum; Matthew Stephen,24,0,50,26
1746531520604,HUM 4,B01,886506,West; Geoffrey Scott,17,0,50,33
1746531521632,HUM 4GS,A00,886507,Staff,0,0,0,19
1746531522659,HUM 5,A01,886509,Staff,32,0,50,18
1746531523689,HUM 5R,A01,886511,Zavodny; Tatiana Sophia,0,39,50,50
1746531524718,JAPN 180,A00,886407,Staff,18,0,40,22
1746531525746,LATI 50,A01,886409,Martin-Cabrera; Luis,4,0,22,18
1746531525746,LATI 50,A02,886410,Martin-Cabrera; Luis,19,0,22,3
1746531525746,LATI 50,A03,886411,Martin-Cabrera; Luis,21,0,22,1
1746531525746,LATI 50,A04,886412,Martin-Cabrera; Luis,9,0,22,13
1746531526774,LAWS 101,A00,907664,Staff,28,0,60,32
1746531527802,LIAB 1A,A00,889388,Saab; Dima,17,0,20,3
1746531528831,LIAB 1AX,A00,889389,El Cheddadi; Youniss,17,0,20,3
1746531529858,LIFR 1C,A00,889391,Van Moer; Vinciane G,8,0,20,12
1746531530888,LIFR 1CX,A00,889392,Van Moer; Vinciane G,7,0,20,13
1746531531918,LIFR 1D,A00,889393,Van Moer; Vinciane G,7,0,20,13
1746531532943,LIFR 1DX,A00,889394,Van Moer; Vinciane G,8,0,20,12
1746531533968,LIGN 7,A00,886923,Staff,24,0,50,26
1746531534995,LIGN 17,A00,886924,Kehler; Andrew Scott,125,0,150,25
1746531536024,LTAM 110,A00,889395,Staff,15,0,30,15
1746531537053,LTAM 110GS,A00,958010,Rodriguez; Bretton Sigfred,0,0,0,28
1746531538083,LTCH 101,A00,889397,Staff,23,0,25,2
1746531539113,LTCS 130,A00,889398,Staff,23,0,25,2
1746531540145,LTEA 138,A00,889399,Staff,24,0,40,16
1746531541170,LTEN 149,A00,889400,Wesling; Megan E.,0,3,25,25
1746531542203,LTEN 169,A00,889401,Staff,20,0,25,5
1746531543234,LTEN 180,A00,889402,Staff,10,0,15,5
1746531544261,LTEN 181,A00,889403,Staff,21,0,25,4
1746531545289,LTWL 100,A00,889404,Myerston Santana; Jacobo,3,0,25,22
1746531546316,LTWL 180GS,A00,889405,Staff,0,0,20,20
1746531547345,LTWL 181,A00,889406,Staff,17,0,25,8
1746531548374,LTWL 184,A00,889475,Mukherjee; Silpa,22,0,25,3
1746531549400,LTWR 102C,A00,889486,Staff,29,0,30,1
1746531550426,LTWR 115W,A00,889491,Staff,0,2,15,15
1746531551457,MAE 8,A01,886905,Staff,0,2,0,0
1746531552484,MAE 11,A00,886906,Bandaru; Prabhakar,0,7,50,50
1746531553513,MAE 20,A00,886907,Evdokimenko; Ekaterina,44,0,70,26
1746531554543,MAE 30B,A00,886909,Ghazinejad; Maziar,26,0,45,19
1746531555573,MAE 101B,A00,886910,Saintillan; David,29,0,45,16
1746531556603,MAE 105,A00,886911,Bandaru; Prabhakar,18,0,50,32
1746531557635,MAE 107,B00,958024,Staff,9,0,50,41
1746531558667,MAE 143B,A00,886913,Bewley; Thomas R,7,0,40,33
1746531559697,MAE 148,A01,886915,Silberman; Jack,0,3,14,14
1746531560725,MAE 160,A00,886916,Evdokimenko; Ekaterina,31,0,60,29
1746531561757,MATH 3C,A01,889681,Staff,0,3,30,30
1746531561757,MATH 3C,A02,960048,Staff,25,0,30,5
1746531562787,MATH 10A,A01,889760,Staff,26,0,30,4
1746531562787,MATH 10A,A02,889783,Staff,29,0,30,1
1746531563818,MATH 10B,A01,889785,Verstraete; Jacques Allan,2,0,35,33
1746531563818,MATH 10B,A02,889795,Verstraete; Jacques Allan,4,0,35,31
1746531563818,MATH 10B,B01,889797,Verstraete; Jacques Allan,3,0,35,32
1746531563818,MATH 10B,B02,889828,Verstraete; Jacques Allan,3,0,35,32
1746531564844,MATH 10C,A01,889849,Habib; Yousaf,9,0,30,21
1746531564844,MATH 10C,A02,889852,Habib; Yousaf,14,0,30,16
1746531564844,MATH 10C,A03,889853,Habib; Yousaf,22,0,30,8
1746531564844,MATH 10C,A04,889858,Habib; Yousaf,20,0,30,10
1746531564844,MATH 10C,B01,889861,Staff,1,0,30,29
1746531564844,MATH 10C,B02,889862,Staff,24,0,30,6
1746531564844,MATH 10C,B03,889863,Staff,27,0,30,3
1746531564844,MATH 10C,B04,889967,Staff,23,0,30,7
1746531565874,MATH 18,A01,889974,Staff,7,0,30,23
1746531565874,MATH 18,A02,889977,Staff,20,0,30,10
1746531565874,MATH 18,B01,889984,Hardiman; Liam,22,0,30,8
1746531565874,MATH 18,B02,889985,Hardiman; Liam,25,0,30,5
1746531566905,MATH 20A,A01,889990,Suk; Andrew Hoon,29,0,35,6
1746531567938,MATH 20B,A01,889993,Ohm; Ko Woon,22,0,30,8
1746531567938,MATH 20B,A02,889994,Ohm; Ko Woon,30,0,30,0
1746531567938,MATH 20B,B01,889996,Ohm; Ko Woon,21,0,30,9
1746531567938,MATH 20B,B02,889997,Ohm; Ko Woon,23,0,30,7
1746531568970,MATH 20C,A01,889999,Hammock; Frances H,17,0,30,13
1746531568970,MATH 20C,A02,890003,Hammock; Frances H,23,0,30,7
1746531568970,MATH 20C,B01,890006,Hammock; Frances H,3,0,30,27
1746531568970,MATH 20C,B02,890007,Hammock; Frances H,11,0,30,19
1746531570003,MATH 20D,A01,890011,Cheng; Hsiao-Bing,1,1,30,29
1746531570003,MATH 20D,A02,890012,Cheng; Hsiao-Bing,14,0,30,16
1746531570003,MATH 20D,B01,890016,Cheng; Hsiao-Bing,13,0,30,17
1746531570003,MATH 20D,B02,890017,Cheng; Hsiao-Bing,13,0,30,17
1746531571031,MATH 20E,A01,890026,Harel; Guershon,1,0,30,29
1746531571031,MATH 20E,A02,890029,Harel; Guershon,23,0,30,7
1746531571031,MATH 20E,B01,890033,Harel; Guershon,7,0,30,23
1746531571031,MATH 20E,B02,890101,Harel; Guershon,21,0,30,9
1746531572058,MATH 102,A01,890104,Staff,17,0,30,13
1746531572058,MATH 102,A02,890105,Staff,27,0,30,3
1746531573091,MATH 103B,A01,890116,Salehi Golsefidy; Alireza,3,0,30,27
1746531573091,MATH 103B,B01,890118,Staff,0,3,34,34
1746531574124,MATH 109,A01,890121,Aliabadi Sr.; Mohsen,1,0,30,29
1746531574124,MATH 109,B01,890124,Upadrashta; Pranav Kumar,18,0,30,12
1746531575157,MATH 120A,A01,890126,Eggers; John Dietrich,13,0,30,17
1746531576183,MATH 142B,A01,890128,Ioana; Adrian,19,0,30,11
1746531576183,MATH 142B,A02,890129,Ioana; Adrian,13,0,30,17
1746531577207,MATH 154,A01,890174,Staff,0,0,30,30
1746531577207,MATH 154,A02,890182,Staff,0,0,30,30
1746531578259,MATH 168A,A01,890197,Dumitriu; Ioana,21,0,35,14
1746531579291,MATH 170A,A01,890240,Nie; Jiawang,1,0,30,29
1746531579291,MATH 170A,A02,890241,Nie; Jiawang,11,0,30,19
1746531579291,MATH 170A,A03,890249,Nie; Jiawang,23,0,30,7
1746531580322,MATH 170B,A01,957891,Nag; Panchali,13,0,35,22
1746531582381,MATH 181A,A01,908025,Staff,0,4,35,35
1746531582381,MATH 181A,A02,960115,Staff,27,0,35,8
1746531583408,MATH 181B,A01,959874,Staff,26,0,30,4
1746531584437,MATH 193B,A01,890265,Staff,0,4,35,35
1746531585463,MGT 4,A01,890311,Anderson; John Charles,42,0,88,46
1746531586491,MGT 5,A00,907740,Staff,13,0,98,85
1746531587521,MGT 12,A00,890312,Lindenberger; Wade Douglas,67,0,98,31
1746531588549,MGT 16,A00,957883,Staff,78,0,98,20
1746531590602,MGT 45,A00,890314,Pecore; Joseph P.,47,0,98,51
1746531591628,MGT 71,A00,890315,Staff,0,11,98,98
1746531592656,MGT 100,A00,890316,Yavorsky; Daniel Ryan,44,0,98,54
1746531593684,MGT 103,A00,890317,Ehrich; Kristine R,73,0,98,25
1746531594712,MGT 105,A00,890356,Bates; Kenneth Walter,0,7,98,98
1746531595742,MGT 112,A00,890360,Ehrich; Kristine R,55,0,98,43
1746531596774,MGT 127R,A00,907732,Zhu; Kevin Xiaoguo,23,0,98,75
1746531597800,MGT 131B,A00,890361,Anderson; John Charles,61,0,98,37
1746531598827,MGT 137,A00,890362,Lindenberger; Wade Douglas,65,0,98,33
1746531599853,MGT 160,A00,890369,Johnson; Erik Barry,9,0,98,89
1746531601914,MGT 164,A00,890372,Zimmermann; Carsten,0,39,98,98
1746531602941,MGT 180,A00,890374,Bliss; Barbara Ann,12,0,98,86
1746531603969,MMW 15,A01,886414,Chang; Edmond Yi-Teh,0,12,28,28
1746531603969,MMW 15,A02,886415,Chang; Edmond Yi-Teh,0,8,28,28
1746531603969,MMW 15,A03,886416,Chang; Edmond Yi-Teh,0,8,28,28
1746531603969,MMW 15,A04,886417,Chang; Edmond Yi-Teh,0,8,28,28
1746531603969,MMW 15,B01,886419,Chang; Edmond Yi-Teh,0,7,28,28
1746531603969,MMW 15,B02,886420,Chang; Edmond Yi-Teh,0,8,28,28
1746531603969,MMW 15,B03,886421,Chang; Edmond Yi-Teh,0,7,28,28
1746531603969,MMW 15,B04,886422,Chang; Edmond Yi-Teh,0,8,28,28
1746531603969,MMW 15,C01,886424,Staff,0,9,28,28
1746531603969,MMW 15,C02,886425,Staff,0,8,28,28
1746531603969,MMW 15,C03,886426,Staff,0,8,28,28
1746531603969,MMW 15,C04,886427,Staff,0,7,28,28
1746531603969,MMW 15,C05,958038,Staff,0,7,28,28
1746531603969,MMW 15,C06,958039,Staff,0,8,28,28
1746531604995,MMW 15GS,A00,906910,Patterson; Patrick H.,4,0,28,24
1746531606021,MMW 122R,A01,886429,Rahimi; Babak,0,13,28,28
1746531606021,MMW 122R,A02,886430,Rahimi; Babak,0,12,28,28
1746531606021,MMW 122R,A03,958040,Rahimi; Babak,0,11,28,28
1746531607049,MUS 1A,A01,890937,Staff,3,0,25,22
1746531607049,MUS 1A,A02,891035,Staff,6,0,25,19
1746531607049,MUS 1A,C01,958912,Staff,24,0,25,1
1746531607049,MUS 1A,C02,958913,Staff,25,0,25,0
1746531609103,MUS 2AK,A00,957092,Ohnishi; Takae,15,0,15,0
1746531610133,MUS 4,A01,891044,Staff,2,0,25,23
1746531610133,MUS 4,A02,891045,Staff,23,0,25,2
1746531610133,MUS 4,B01,891048,Staff,17,0,25,8
1746531610133,MUS 4,B02,891050,Staff,25,0,25,0
1746531611161,MUS 5,A01,957506,Dubnov; Shlomo,0,0,25,25
1746531611161,MUS 5,A02,957622,Dubnov; Shlomo,14,0,25,11
1746531611161,MUS 5,A03,957623,Dubnov; Shlomo,20,0,25,5
1746531612188,MUS 6,A01,891053,Freitas Caetano; Marcelo,24,0,25,1
1746531612188,MUS 6,A02,891054,Freitas Caetano; Marcelo,23,0,25,2
1746531613213,MUS 7,A01,891081,Staff,0,0,25,25
1746531613213,MUS 7,A02,891082,Staff,4,0,25,21
1746531614240,MUS 8GS,A00,891118,Borgo; David Garcia,0,0,25,25
1746531615266,MUS 11,A01,891140,Staff,11,0,25,14
1746531615266,MUS 11,A02,891141,Staff,22,0,25,3
1746531616290,MUS 13,A01,891143,Staff,8,0,25,17
1746531616290,MUS 13,A02,891144,Staff,24,0,25,1
1746531617317,MUS 15,A01,891146,Staff,9,0,25,16
1746531617317,MUS 15,A02,891148,Staff,21,0,25,4
1746531617317,MUS 15,B01,891150,Staff,18,0,25,7
1746531617317,MUS 15,B02,891151,Staff,25,0,25,0
1746531618344,MUS 20,A01,891153,Staff,5,0,20,15
1746531618344,MUS 20,A02,891155,Staff,14,0,20,6
1746531619374,MUS 80,A00,891156,Staff,19,0,25,6
1746531619374,MUS 80,B00,891157,Staff,23,0,25,2
1746531620406,MUS 130,A00,891158,Ohnishi; Takae,35,0,35,0
1746531621435,MUS 150GS,A01,891160,Borgo; David Garcia,0,0,25,25
1746531622465,MUS 170,A01,891162,Freitas Caetano; Marcelo,20,0,25,5
1746531622465,MUS 170,A02,891164,Freitas Caetano; Marcelo,21,0,25,4
1746531623491,NANO 11,A00,886220,Vazquez Mena; Oscar,13,0,15,2
1746531624522,NANO 15,A01,886222,Drews; Aaron,4,0,7,3
1746531625549,NANO 104,A00,886224,Sirbuly; Donald,18,0,25,7
1746531626579,PH 40,A00,886528,Staff,23,0,40,17
1746531627607,PH 45,A01,886799,Staff,35,0,40,5
1746531628631,PH 110,A00,886802,Staff,0,7,40,40
1746531629658,PH 172,A00,906716,Staff,19,0,35,16
1746531630686,PH 191,A00,886803,Staff,6,0,40,34
1746531631714,PHIL 1,A00,889500,Staff,19,0,30,11
1746531632744,PHIL 10,A01,889549,Grush; Rick Scott,15,0,22,7
1746531632744,PHIL 10,A02,889551,Grush; Rick Scott,22,0,22,0
1746531633776,PHIL 28,A01,889559,Lamey; Andy M.,0,1,31,31
1746531633776,PHIL 28,A02,889561,Lamey; Andy M.,0,1,30,30
1746531633776,PHIL 28,A03,889572,Lamey; Andy M.,0,0,30,30
1746531634806,PHIL 35,A00,907839,Staff,13,0,15,2
1746531635834,PHIL 60,A00,889574,Staff,74,0,90,16
1746531636863,PHIL 101,A00,958004,Staff,13,0,15,2
1746531638925,PHIL 136,A00,889582,Fulkerson; Matthew Todd,26,0,45,19
1746531639954,PHIL 163,A01,889601,Staff,21,0,30,9
1746531639954,PHIL 163,B01,889606,Brandt; Reuven A,0,3,0,0
1746531640978,PHIL 164,A00,889610,Staff,16,0,30,14
1746531642009,PHIL 165,A00,889613,Staff,23,0,30,7
1746531643039,PHYS 1A,A00,886431,Staff,26,0,70,44
1746531644066,PHYS 1AL,001,886432,Tsai; Philbert S,0,2,30,30
1746531644066,PHYS 1AL,002,886436,Tsai; Philbert S,11,0,30,19
1746531645097,PHYS 1B,A00,886439,Staff,185,0,240,55
1746531646126,PHYS 1BL,001,886441,Tsai; Philbert S,0,4,30,30
1746531646126,PHYS 1BL,002,886444,Tsai; Philbert S,2,0,30,28
1746531647153,PHYS 1C,A00,896092,Arnold; Kam S,78,0,146,68
1746531648183,PHYS 1CL,001,886448,Tsai; Philbert S,0,0,30,30
1746531648183,PHYS 1CL,002,886449,Tsai; Philbert S,0,0,30,30
1746531648183,PHYS 1CL,003,886450,Tsai; Philbert S,15,0,30,15
1746531648183,PHYS 1CL,004,886451,Tsai; Philbert S,15,0,30,15
1746531649212,PHYS 2B,A01,886457,Staff,69,0,115,46
1746531650245,PHYS 2C,A01,886460,Shotwell; Brian,0,8,65,65
1746531651270,PHYS 2CL,A01,886467,Staff,0,4,28,28
1746531651270,PHYS 2CL,A02,886468,Staff,0,3,28,28
1746531652297,PHYS 2D,A01,886470,Staff,10,0,50,40
1746531653331,PHYS 4B,A01,886475,Grinstein; Benjamin,22,0,40,18
1746531654356,POLI 5,A00,891173,Desposato; Scott,7,0,25,18
1746531655381,POLI 5D,A01,891175,Staff,5,0,5,0
1746531655381,POLI 5D,B01,891178,Staff,5,0,5,0
1746531656412,POLI 11,A00,891179,Ferree; Karen E,2,0,35,33
1746531657458,POLI 12,A00,891180,Staff,16,0,30,14
1746531658491,POLI 27,A01,891182,Staff,12,0,75,63
1746531659518,POLI 30,A00,891183,Staff,9,0,50,41
1746531660549,POLI 100B,A00,891244,Staff,5,1,35,30
1746531661574,POLI 100I,A00,891247,Staff,7,0,30,23
1746531662601,POLI 104J,A00,891248,Nichter; Maysa,14,0,30,16
1746531663627,POLI 104U,A00,891250,Nichter; Maysa,2,0,30,28
1746531665681,POLI 110B,A00,891255,Wiens; David,20,0,25,5
1746531666707,POLI 112A,A00,891256,Wiens; David,6,0,25,19
1746531667735,POLI 114BR,A00,891261,Staff,19,0,30,11
1746531668769,POLI 117R,A00,891262,Forman; Fonna,0,6,50,50
1746531669793,POLI 118,A00,891264,Ingham; Sean,17,0,25,8
1746531670820,POLI 124A,A00,891265,Staff,18,0,20,2
1746531671844,POLI 125D,A00,891266,Nichter; Simeon C,2,0,25,23
1746531672874,POLI 126,A00,891268,Nichter; Simeon C,7,0,25,18
1746531673900,POLI 126AA,A00,891272,Staff,18,0,25,7
1746531674928,POLI 130AA,A00,891273,Staff,15,0,20,5
1746531675957,POLI 134AA,A00,891274,Staff,4,0,20,16
1746531678011,POLI 138,A00,891278,Staff,21,0,25,4
1746531679040,POLI 142K,A00,891280,Staff,11,0,25,14
1746531680073,POLI 142M,A00,891281,Gartzke; Erik,17,0,30,13
1746531681103,POLI 142P,A00,891284,Staff,20,0,30,10
1746531682129,POLI 143,A00,891285,Gartzke; Erik,12,0,30,18
1746531683157,POLI 153,A00,891286,Staff,19,0,20,1
1746531685213,POLI 175,A00,891290,Staff,15,0,20,5
1746531686241,PSYC 1,A00,890674,Steiner; Eric Tomas,0,11,45,45
1746531687271,PSYC 2,A00,890676,Albright; Thomas D,21,0,35,14
1746531688297,PSYC 3,A00,890679,Staff,17,0,20,3
1746531689324,PSYC 6,A00,959858,Staff,20,0,20,0
1746531690352,PSYC 60,A01,890684,Rickard; Timothy C.,0,5,45,45
1746531691377,PSYC 70,A01,890689,Geller; Emma Harlan,7,0,30,23
1746531692414,PSYC 71,A01,959860,Staff,21,0,25,4
1746531693446,PSYC 100,A00,890690,Lacefield; Katharine I,0,50,180,180
1746531694472,PSYC 102,A00,890695,Staff,18,0,40,22
1746531695500,PSYC 105,A00,890699,Geller; Emma Harlan,71,0,100,29
1746531696528,PSYC 106,A00,890701,Gorman; Michael R.,5,0,30,25
1746531697559,PSYC 108,A00,890704,Adrian; Julia Anna,0,28,50,50
1746531698592,PSYC 118,A01,890712,Staff,11,0,30,19
1746531699620,PSYC 124,A00,890716,Chapman; Eddie Nathaniel,25,0,60,35
1746531700649,PSYC 131,A00,890717,Anagnostaras; Stephan,0,7,80,80
1746531701679,PSYC 137,A00,890719,Winkielman; Piotr,0,11,30,30
1746531702708,PSYC 144,A00,890721,Adrian; Julia Anna,0,9,45,45
1746531703735,PSYC 162,A00,890805,Staff,2,0,75,73
1746531704763,PSYC 169,A00,890810,Staff,0,15,30,30
1746531705791,PSYC 172,A00,890814,Gorman; Michael R.,9,0,30,21
1746531706818,PSYC 181,A00,890818,Anagnostaras; Stephan,8,0,200,192
1746531707845,PSYC 184,A00,959861,Staff,170,0,175,5
1746531708871,PSYC 189,A00,890823,Staff,0,1,30,30
1746531709898,PSYC 191,A00,890884,Rickard; Timothy C.,0,11,35,35
1746531710930,PSYC 193,A00,890913,Staff,19,0,30,11
1746531710930,PSYC 193,B00,890914,Chapman; Eddie Nathaniel,24,0,30,6
1746531711958,PSYC 193L,A01,890918,Lowe; Angela Beth,20,0,30,10
1746531711958,PSYC 193L,B01,890921,Hurwitz; Ethan Scott,20,0,30,10
1746531711958,PSYC 193L,C01,890928,Staff,30,0,30,0
1746531712992,RELI 149,A00,886806,Rahimi; Babak,23,0,40,17
1746531714023,SE 9,A01,886814,Staff,7,0,20,13
1746531715054,SE 101B,A01,886816,Chadha; Mayank,4,0,35,31
1746531716084,SE 110B,A00,886818,Zhu; Qiang,4,0,75,71
1746531717111,SE 125,A01,886830,Staff,10,0,30,20
1746531718141,SE 130B,A01,886835,Staff,14,0,40,26
1746531719173,SE 131A,A01,886838,Krysl; Petr,34,0,55,21
1746531720203,SE 154,A00,886840,Staff,30,0,50,20
1746531721229,SE 164GS,A01,886849,Staff,6,0,20,14
1746531722257,SE 167GS,A01,886853,Staff,6,0,20,14
1746531723285,SIO 25,A01,890107,Staff,19,0,30,11
1746531724313,SIO 45,A00,890109,Cook; Geoffrey W,117,0,200,83
1746531725339,SIO 109R,A00,890110,Forman; Fonna,0,16,20,20
1746531726366,SIO 187,A01,890114,Kacev; David,15,0,40,25
1746531727393,SOCI 1,A01,890431,Thorpe; Charles Robert,15,0,30,15
1746531727393,SOCI 1,A02,890518,Thorpe; Charles Robert,30,0,30,0
1746531728421,SOCI 2,A01,957978,Staff,25,0,25,0
1746531728421,SOCI 2,A02,957979,Staff,23,0,25,2
1746531729448,SOCI 20,A01,890523,Calderon-Zaks; Michael Aar,23,0,30,7
1746531729448,SOCI 20,A02,890526,Calderon-Zaks; Michael Aar,29,0,30,1
1746531730478,SOCI 30,A01,890533,Pardo Guerra; Juan Pablo,37,0,40,3
1746531731505,SOCI 40,A01,890535,Staff,27,0,45,18
1746531732534,SOCI 104Q,A00,890559,Staff,18,0,30,12
1746531733563,SOCI 106,A00,890560,Arnal; Maud Marie Leonie,20,0,30,10
1746531734588,SOCI 110,A00,890567,Holkenbrink-Monk; Charlene,19,0,30,11
1746531735616,SOCI 112,A00,890568,Victoria Torres; Pablo,1,0,55,54
1746531736644,SOCI 115,A00,890597,Arnal; Maud Marie Leonie,28,0,45,17
1746531738702,SOCI 121,A00,890604,Pardo Guerra; Juan Pablo,38,0,45,7
1746531739730,SOCI 126,A01,890608,Staff,8,0,10,2
1746531740759,SOCI 127,A00,890609,Staff,18,0,30,12
1746531741789,SOCI 131,A00,890610,Thorpe; Charles Robert,37,0,45,8
1746531742820,SOCI 135,A00,890615,Payne; Christine Anna,14,0,45,31
1746531743852,SOCI 139,A00,890620,Staff,38,0,45,7
1746531744880,SOCI 148E,A00,890622,Calderon-Zaks; Michael Aar,36,0,45,9
1746531745913,SOCI 150,A00,890623,Kohler; Kristopher M.,31,0,45,14
1746531746939,SOCI 157,A00,890625,Jules-Rosette; Bennetta W.,18,0,20,2
1746531747971,SOCI 160,A00,890627,Payne; Christine Anna,21,0,45,24
1746531749000,SYN 1,A00,886855,Fish; Gwendolyn Anne,0,0,0,0
1746531749000,SYN 1,B00,906086,Fish; Gwendolyn Anne,0,1,0,2
1746531750026,SYN 2R,A00,886860,Staff,0,17,15,15
1746531750026,SYN 2R,B00,906106,Atkinson; Arthur Laird,0,16,15,15
1746531751059,SYN 100,A01,886866,Browne; Emily,0,28,20,20
1746531751059,SYN 100,B01,906128,Rock; Martin,0,5,20,20
1746531751059,SYN 100,C01,906140,Deavenport; James Cary,0,3,20,20
1746531751059,SYN 100,D01,907816,Deavenport; James Cary,0,5,20,20
1746531752087,TDAC 1,A00,890286,Walsh; Kim C.,9,0,20,11
1746531753119,TDAC 101,A00,890296,Basso; Beatrice,16,0,20,4
1746531754145,TDDE 131,A00,890297,Staff,47,0,50,3
1746531755172,TDDM 1,A00,890287,Weinberg; Sadie,25,0,30,5
1746531756201,TDGE 11,A00,890288,Fulton; Julia,137,0,200,63
1746531756201,TDGE 11,B00,890289,Castro; Robert Jess,184,0,200,16
1746531757229,TDGE 25,B00,957359,Walsh; Kim C.,3,0,20,17
1746531758257,TDGE 40,A01,890292,Power; Jade Yukana,27,0,30,3
1746531759310,TDGE 124,A00,890298,Havis; Allan,0,0,50,50
1746531760336,TDGE 131R,A00,890299,Burelle; Julie Sara Veronique,15,0,42,27
1746531761367,TDHT 101,A00,890300,Staff,10,0,20,10
1746531762406,TDHT 109,A01,890302,Anderson; Mysia Anyse,31,0,40,9
1746531763432,TDMV 1,A00,890293,Arcidiacono; Kristin,18,0,30,12
1746531764458,TDMV 2,A00,890294,Weinberg; Sadie,23,0,30,7
1746531765486,TDMV 3,A00,957878,Arcidiacono; Kristin,28,0,30,2
1746531767543,TDMV 138,A00,890304,Jun; Grace Shin Hae,25,0,40,15
1746531768569,TDMV 140,A00,890305,Corrales; Joseph Bernales,25,0,30,5
1746531769594,TDMV 142,A00,890307,Caligagan; Tony,32,0,40,8
1746531770621,TDMV 144,A00,890308,Camaya; Michelle Ann,25,0,30,5
1746531771650,TDPW 1,A00,890295,Stein; Deborah Isobel,3,0,20,17
1746531772676,USP 2,A01,890272,Lerner; Amy M,6,0,20,14
1746531773705,USP 3,A01,890274,Staff,12,0,30,18
1746531774730,USP 15,A01,890276,Sun; Feiyang,17,0,30,13
1746531775759,USP 25,A00,890277,Shenkman; Michael Thomas,19,0,25,6
1746531776783,USP 138,A00,890278,Staff,13,0,25,12
1746531777810,USP 143,A00,890279,Staff,21,0,70,49
1746531778839,USP 144,A00,890280,Chowdhury; Muhammed Zohir,16,0,30,14
1746531779865,USP 150,A00,890281,Boomhower; Matthew Charles,4,0,30,26
1746531780891,USP 151,A00,890282,Staff,16,0,20,4
1746531781919,USP 162,A00,890283,Andrews; Abigail Leslie,16,0,20,4
1746531782948,USP 168,A00,920477,Kwak; Nancy,1,0,5,4
1746531783974,USP 181,A00,890284,Staff,3,0,20,17
1746531785005,USP 191A,A00,890285,Staff,13,0,20,7
1746531786033,VIS 101,A00,886512,Staff,25,0,75,50
1746531787063,VIS 103,A00,886513,Cruz; Edwin Teddy,61,0,75,14
1746531788090,VIS 108,A00,886514,Staff,3,0,15,12
1746531789120,VIS 127P,A00,886515,Shen; Kuiyi,80,0,146,66
1746531790147,VIS 149,A00,886516,Yoldas; Pinar,0,0,15,15
1746531791175,VIS 164,A00,886526,Erdmann; Dean,19,0,22,3
1746531792205,VIS 194S,A00,886527,Staff,61,0,75,14
1746531793231,WCWP 10A,C00,886484,Martiniuk; Jill,12,0,15,3
1746531794256,WCWP 10B,A00,886490,Uriarte; Emma,0,0,15,15
1746531794256,WCWP 10B,B00,886491,Dhir; Simrita,11,0,15,4
1746531794256,WCWP 10B,C00,886492,Ornelas; Tricia,0,0,15,15
1746531795284,WCWP 100,A00,886494,Young; Mark T,0,7,15,15
1746531797462,AAS 10,A01,886199,Childs; Dennis R.,0,3,0,0
1746531798489,ANAR 104,A01,886940,Shtienberg; Gilad,27,0,30,3
1746531799515,ANAR 120,A00,886953,Staff,12,0,20,8
1746531800545,ANBI 148,A01,886955,Wilder; Linnea Lorene,30,0,40,10
1746531802601,ANSC 122,A00,886957,Staff,25,0,30,5
1746531803625,ANSC 150,A00,886958,Sloane; Julia Kathryn,3,0,15,12
1746531804653,ANSC 156,A00,886959,Jenkins; Janis A.,0,1,15,15
1746531805681,ANSC 180,A00,886960,Staff,11,0,17,6
1746531806708,ANSC 188,A00,886961,Jassal; Aftab,9,0,25,16
1746531807737,ANSC 190,A00,886962,Jassal; Aftab,14,0,25,11
1746531808764,ANSC 191,A00,886963,Staff,18,0,20,2
1746531809793,ANTH 3,A01,891689,Staff,17,0,20,3
1746531810823,ANTH 5,A00,886933,Semendeferi; Ekaterini,16,0,20,4
1746531811850,ANTH 10,A00,886934,Staff,0,12,30,30
1746531812877,ANTH 21,A01,886936,Staff,40,0,60,20
1746531813907,ANTH 23,A01,886938,Staff,92,0,100,8
1746531814936,ANTH 105,A00,886964,Stewart; Alexander B,84,0,100,16
1746531815966,ANTH 108,A00,886965,Pedersen; David,9,0,20,11
1746531816994,AWP 10,001,886147,Staff,0,0,0,0
1746531816994,AWP 10,002,886148,Staff,0,0,0,0
1746531816994,AWP 10,003,886149,Staff,0,0,0,0
1746531816994,AWP 10,004,886150,Staff,0,0,0,0
1746531816994,AWP 10,005,886151,Staff,0,0,0,0
1746531816994,AWP 10,006,886152,Staff,0,0,0,0
1746531816994,AWP 10,007,886153,Staff,0,0,0,0
1746531816994,AWP 10,008,886154,Staff,0,0,0,0
1746531816994,AWP 10,009,886155,Staff,0,0,0,0
1746531816994,AWP 10,010,886156,Staff,0,0,0,0
1746531816994,AWP 10,011,886158,Staff,0,0,0,0
1746531816994,AWP 10,012,886160,Staff,0,0,0,0
1746531816994,AWP 10,013,886161,Staff,0,0,0,0
1746531816994,AWP 10,014,886162,Staff,0,0,0,0
1746531816994,AWP 10,015,886163,Staff,0,0,0,0
1746531816994,AWP 10,016,886164,Staff,0,0,0,0
1746531816994,AWP 10,017,886165,Staff,0,0,0,0
1746531816994,AWP 10,018,886166,Staff,0,0,0,0
1746531816994,AWP 10,019,886168,Staff,0,0,0,0
1746531816994,AWP 10,020,886170,Staff,0,0,0,0
1746531816994,AWP 10,021,886172,Staff,0,0,0,0
1746531818025,AWP 10R,001,886173,Staff,0,1,0,0
1746531818025,AWP 10R,002,886174,Staff,0,1,0,0
1746531818025,AWP 10R,003,886175,Staff,0,0,0,0
1746531818025,AWP 10R,004,886176,Staff,0,0,0,0
1746531818025,AWP 10R,005,886177,Staff,0,0,0,0
1746531818025,AWP 10R,006,886178,Staff,0,0,0,0
1746531818025,AWP 10R,007,886179,Staff,0,0,0,0
1746531818025,AWP 10R,008,886181,Staff,0,0,0,0
1746531818025,AWP 10R,009,886182,Staff,0,0,0,0
1746531818025,AWP 10R,010,886183,Staff,0,0,0,0
1746531818025,AWP 10R,011,886184,Staff,0,0,0,0
1746531818025,AWP 10R,012,886185,Staff,0,0,0,0
1746531818025,AWP 10R,013,886186,Staff,0,0,0,0
1746531818025,AWP 10R,014,886187,Staff,0,0,0,0
1746531818025,AWP 10R,015,886188,Staff,0,0,0,0
1746531818025,AWP 10R,016,886189,Staff,0,0,0,0
1746531819053,AWP 102R,A00,886190,Staff,0,0,0,0
1746531819053,AWP 102R,B00,886191,Staff,0,0,0,0
1746531820084,BENG 100,A01,886193,Staff,17,0,30,13
1746531821114,BENG 122A,A01,886195,Hasty; Jeff M,13,0,30,17
1746531822140,BENG 166A,A00,886196,Sah; Robert Lie-Yuan,0,1,30,30
1746531823170,BENG 190,A00,958050,Khojah; Reem I,24,0,25,1
1746531824196,BIBC 102,A01,894320,Staff,0,0,46,46
1746531824196,BIBC 102,A02,894321,Staff,1,0,46,45
1746531824196,BIBC 102,A03,894344,Staff,7,0,46,39
1746531824196,BIBC 102,A04,894345,Staff,26,0,47,21
1746531825226,BICD 100R,A01,894365,Smith; Laurie,0,3,58,58
1746531825226,BICD 100R,A02,894366,Smith; Laurie,0,5,58,58
1746531825226,BICD 100R,A03,894367,Smith; Laurie,2,0,59,57
1746531825226,BICD 100R,A04,959869,Smith; Laurie,41,0,59,18
1746531826253,BICD 136,A01,894383,Gustafson-Brown; Cindy,14,0,50,36
1746531827286,BIEB 102,A01,894494,Butler; Shannon Rhey,51,0,130,79
1746531829351,BIEB 150,A01,894617,Wills; Christopher,3,0,20,17
1746531829351,BIEB 150,A02,894631,Wills; Christopher,3,0,20,17
1746531829351,BIEB 150,A03,894937,Wills; Christopher,4,0,20,16
1746531829351,BIEB 150,A04,894946,Wills; Christopher,5,0,20,15
1746531830376,BIEB 194,A00,906141,Kurle; Carolyn M.,6,0,20,14
1746531831405,BILD 1,A01,894154,Staff,2,0,19,17
1746531831405,BILD 1,A02,894155,Staff,14,0,19,5
1746531831405,BILD 1,A03,894160,Staff,13,0,19,6
1746531831405,BILD 1,A04,894161,Staff,15,0,18,3
1746531832437,BILD 2,A01,894168,Staff,0,0,50,50
1746531832437,BILD 2,A02,894169,Staff,0,0,50,50
1746531832437,BILD 2,A03,894179,Staff,4,0,50,46
1746531832437,BILD 2,A04,894203,Staff,27,0,50,23
1746531833467,BILD 3,A01,894213,Staff,22,0,31,9
1746531833467,BILD 3,A02,894214,Staff,26,0,31,5
1746531833467,BILD 3,A03,894235,Staff,28,0,31,3
1746531833467,BILD 3,A04,894236,Staff,28,0,32,4
1746531834498,BILD 4,A01,894253,Reuther; Keefe,5,0,24,19
1746531834498,BILD 4,A02,894258,Reuther; Keefe,16,0,24,8
1746531835529,BILD 5,A01,894276,Reuther; Keefe,35,0,50,15
1746531835529,BILD 5,A02,894277,Reuther; Keefe,45,0,50,5
1746531835529,BILD 5,A03,894290,Reuther; Keefe,44,0,50,6
1746531835529,BILD 5,A04,894291,Reuther; Keefe,48,0,50,2
1746531836554,BILD 24,A01,894297,Pirino; Giorgia,40,0,60,20
1746531837581,BIMM 100,B01,958915,Staff,72,0,100,28
1746531838611,BIMM 101,A01,895017,McDonnell; Lisa Marie,0,5,24,24
1746531838611,BIMM 101,A02,895018,McDonnell; Lisa Marie,0,5,24,24
1746531838611,BIMM 101,B01,895020,McDonnell; Lisa Marie,0,6,24,24
1746531838611,BIMM 101,B02,895021,McDonnell; Lisa Marie,0,4,24,24
1746531839638,BIMM 110,A01,895023,Staff,1,0,25,24
1746531839638,BIMM 110,A02,895024,Staff,9,0,25,16
1746531839638,BIMM 110,A03,895025,Staff,18,0,25,7
1746531839638,BIMM 110,A04,895031,Staff,20,0,25,5
1746531840666,BIMM 120,A01,895114,Gustafson-Brown; Cindy,13,0,28,15
1746531840666,BIMM 120,A02,895126,Gustafson-Brown; Cindy,20,0,27,7
1746531841693,BIPN 100,A01,895130,Yang; Mingyu,1,0,38,37
1746531841693,BIPN 100,A02,895131,Yang; Mingyu,32,0,38,6
1746531841693,BIPN 100,A03,895132,Yang; Mingyu,32,0,38,6
1746531841693,BIPN 100,A04,895133,Yang; Mingyu,27,0,36,9
1746531842724,BIPN 120,A01,895135,Cooke; James Edward,0,3,13,13
1746531842724,BIPN 120,A02,895136,Cooke; James Edward,0,1,13,13
1746531842724,BIPN 120,A03,895137,Cooke; James Edward,0,3,13,13
1746531842724,BIPN 120,A04,895156,Cooke; James Edward,0,2,11,11
1746531843757,BIPN 134,A01,895235,Cooke; James Edward,0,2,25,25
1746531843757,BIPN 134,A02,895237,Cooke; James Edward,0,0,25,25
1746531843757,BIPN 134,A03,895240,Cooke; James Edward,3,0,25,22
1746531843757,BIPN 134,A04,895270,Cooke; James Edward,20,0,25,5
1746531844789,BIPN 189,A00,892103,Staff,0,13,14,14
1746531846844,BISP 194,A00,958008,Staff,0,2,0,0
1746531847871,CAT 124,A01,922009,Staff,0,5,20,20
1746531848898,CAT 125R,A00,886390,Morales; Celeste Georgianna,0,2,20,20
1746531848898,CAT 125R,B00,886391,Irwin; Matthew Joseph,0,3,20,20
1746531848898,CAT 125R,C00,886392,Smith; Lauryn Alissa,0,2,20,20
1746531848898,CAT 125R,D00,886393,Vanderschuit; Maya Alysia,0,2,20,20
1746531848898,CAT 125R,E00,886394,Marchisotto; Jennifer Anne,0,4,20,20
1746531849946,CENG 15,A01,886218,Drews; Aaron,3,0,8,5
1746531850972,CENG 113,A00,886219,Opatkiewicz; Justin Paul,15,0,25,10
1746531851999,CGS 101,A00,887044,Staff,7,0,20,13
1746531853026,CGS 105,A01,887046,Staff,14,0,25,11
1746531854056,CGS 112,A00,887047,Cuong; Marisol,12,0,15,3
1746531855082,CGS 113,A00,887048,Staff,23,0,30,7
1746531856109,CGS 120,A00,887049,Staff,10,0,17,7
1746531857138,CHEM 6A,A01,886336,Lam; Tin Yiu,38,0,50,12
1746531857138,CHEM 6A,A02,886338,Lam; Tin Yiu,37,0,50,13
1746531858167,CHEM 6B,A01,886341,Hopkins; Patrycja Anna,16,0,50,34
1746531858167,CHEM 6B,A02,886343,Hopkins; Patrycja Anna,42,0,50,8
1746531859198,CHEM 6C,A01,886346,Albizati; Kim F.,0,2,50,50
1746531859198,CHEM 6C,A02,886348,Albizati; Kim F.,23,0,50,27
1746531860225,CHEM 40A,A01,886352,Klosterman; Jeremy K,65,0,100,35
1746531861252,CHEM 40B,A01,886356,Klosterman; Jeremy K,0,23,100,100
1746531862283,CHEM 41B,A01,886360,Theodorakis; Emmanuel,25,0,50,25
1746531862283,CHEM 41B,A02,886362,Theodorakis; Emmanuel,47,0,50,3
1746531863309,CHIN 165A,A00,886382,Xu; Li,18,0,20,2
1746531864333,CLAS 120,A00,886387,Myerston Santana; Jacobo,33,0,40,7
1746531865359,COGS 9,A01,886967,Shannon; Kyle Michael,42,0,60,18
1746531866386,COGS 11,A01,886969,Staff,11,0,30,19
1746531867415,COGS 14A,A01,886971,Staff,6,0,60,54
1746531868442,COGS 14B,A01,886973,Hoffman; Drew Ellen,4,0,60,56
1746531869472,COGS 18,A01,886975,Morgan; Eric,35,0,60,25
1746531870496,COGS 20,A01,886977,Staff,4,0,8,4
1746531870496,COGS 20,A02,886978,Staff,5,0,7,2
1746531871523,COGS 100,A01,907783,Staff,0,2,30,30
1746531872551,COGS 101B,A01,886980,Staff,0,3,48,48
1746531873574,COGS 101C,A01,886982,Delgado; Tania,0,5,44,44
1746531874603,COGS 102A,A01,886984,Johnson; Christine M.,4,0,30,26
1746531875629,COGS 118B,A01,886986,Staff,0,3,88,88
1746531876653,COGS 150,A01,886988,Bergen; Benjamin,23,0,50,27
1746531877684,COGS 153,A00,886989,Delgado; Tania,0,2,41,41
1746531878712,COGS 186,A01,886991,Staff,0,0,32,32
1746531879736,COGS 187A,A01,886993,Boyle; Mary E. T.,7,0,30,23
1746531880764,COGS 189,A00,886994,Staff,0,1,30,30
1746531881810,COMM 10,A01,886996,Staff,0,0,20,21
1746531881810,COMM 10,A02,886997,Staff,12,0,20,8
1746531881810,COMM 10,A03,959845,Staff,19,0,20,1
1746531882837,COMM 20,A01,886999,Leuning; Grant Maurstad,24,0,40,16
1746531884892,COMM 100A,A01,887002,Staff,0,0,20,25
1746531884892,COMM 100A,A02,887003,Staff,7,0,20,13
1746531885917,COMM 100B,A01,887005,Staff,0,8,20,24
1746531886942,COMM 106D,A00,887006,Staff,14,0,40,26
1746531887968,COMM 110G,A00,887007,Whitworth-Smith; Andrew C,12,0,40,28
1746531888993,COMM 111B,A00,887008,Staff,31,0,40,9
1746531890026,COMM 113T,A00,887009,Abuelhiga; Soraya Jill,28,0,40,12
1746531890026,COMM 113T,B00,906733,Staff,40,0,40,0
1746531891052,COMM 145,A00,887010,Staff,12,0,40,28
1746531892079,COMM 146,A00,887054,Staff,31,0,40,9
1746531893106,COMM 190,A00,887012,Staff,8,0,23,15
1746531894132,CSE 8A,A50,887015,Cao; Yingjun,57,0,85,28
1746531895157,CSE 11,A01,887017,Cao; Yingjun,12,0,70,58
1746531896182,CSE 20,A01,887019,Staff,30,0,50,20
1746531897208,CSE 21,A01,887021,Staff,78,0,100,22
1746531897208,CSE 21,B01,892583,Braun; Oliver,45,0,50,5
1746531898234,CSE 30,A01,887025,Eldon; John,143,0,200,57
1746531899265,CSE 100,A01,887027,Staff,26,0,50,24
1746531899265,CSE 100,A02,887028,Staff,40,0,50,10
1746531900293,CSE 101,A01,887030,Braun; Oliver,75,0,100,25
1746531900293,CSE 101,B01,887032,Jones; Miles E,0,3,50,50
1746531900293,CSE 101,B02,887033,Jones; Miles E,0,1,50,50
1746531901325,CSE 105,A01,908084,Jones; Miles E,32,0,50,18
1746531901325,CSE 105,A02,908087,Jones; Miles E,33,0,50,17
1746531902350,CSE 135,A01,887035,Powell; Thomas Allan,0,4,50,50
1746531903378,CSE 142,A01,887037,Staff,8,0,60,52
1746531904407,CSE 142L,A01,887039,Staff,34,0,60,26
1746531905435,CSE 151A,A01,887041,Solares; Edwin A,48,0,100,52
1746531906464,CSE 175,A01,887043,Kumar; Rakesh,30,0,30,0
1746531907489,CSS 1,A01,886389,Staff,0,1,40,40
1746531908517,DSC 30,A01,908097,Liao; Soohyun Nam,47,0,75,28
1746531909547,DSC 40A,A01,908099,Shannon; Kyle Michael,30,0,50,20
1746531910574,DSC 40B,A01,908112,Staff,16,0,50,34
1746531911606,DSC 80,A01,908116,Staff,19,0,60,41
1746531912636,DSC 197,001,956863,Eldridge; Justin Matthew,9999,0,9999,0
1746531913668,ECE 5,A01,886400,Morris; Karcher William,2,0,6,4
1746531913668,ECE 5,A02,886401,Morris; Karcher William,3,0,6,3
1746531914694,ECE 148,A01,886403,Silberman; Jack,0,14,14,14
1746531915719,ECON 1,A01,887265,Crane; Meredith Helen,12,0,70,58
1746531915719,ECON 1,B01,887268,Staff,43,0,50,7
1746531916749,ECON 2,A01,887273,Crane; Meredith Helen,56,0,70,14
1746531917775,ECON 3,A01,887279,Rondina; Giacomo,32,0,70,38
1746531918807,ECON 4,A01,887282,Anderson; John Charles,0,2,10,10
1746531919833,ECON 5,A01,887285,Staff,33,0,45,12
1746531919833,ECON 5,B01,887292,Staff,41,0,45,4
1746531920866,ECON 100A,A01,887337,Newhouse; Herbert S,54,0,70,16
1746531920866,ECON 100A,B01,887349,Staff,45,0,50,5
1746531921892,ECON 100B,A01,887361,Du; Songzi,29,0,70,41
1746531922920,ECON 100C,A01,887445,Newhouse; Herbert S,59,0,70,11
1746531923948,ECON 105,A00,887488,Vespa; Emanuel Ignacio,23,0,35,12
1746531924980,ECON 109,A01,887506,Shishkin; Denis,28,0,35,7
1746531926014,ECON 110A,A01,887568,Alon; Titan Michael,0,3,35,35
1746531926014,ECON 110A,B01,907601,Alon; Titan Michael,20,0,35,15
1746531927038,ECON 110B,A01,887598,Levkoff; Steven B.,0,23,70,70
1746531928067,ECON 112,A00,887599,Rondina; Giacomo,19,0,35,16
1746531929101,ECON 120A,A01,887603,Dai; Yinlin,36,0,70,34
1746531930128,ECON 120C,A01,887608,Sun; Yixiao,0,1,35,35
1746531930128,ECON 120C,B01,887614,Sun; Yixiao,0,0,35,35
1746531931153,ECON 138,A00,887621,Bharadwaj; Prashant,0,20,20,20
1746531932183,ECON 144,A00,958007,Squires; Dale E,13,0,35,22
1746531933208,ECON 171,A01,907666,Staff,18,0,35,17
1746531934234,ECON 175,A00,887626,Wu; Pak Yeung,23,0,35,12
1746531935262,ECON 190,A00,887640,Vespa; Emanuel Ignacio,23,0,35,12
1746531936295,EDS 25,A01,888197,Staff,0,0,0,0
1746531936295,EDS 25,A02,888209,Staff,0,0,0,0
1746531936295,EDS 25,A03,888210,Staff,0,0,0,0
1746531936295,EDS 25,A04,888212,Staff,0,0,0,0
1746531936295,EDS 25,A05,888213,Staff,0,0,0,0
1746531936295,EDS 25,A06,888214,Staff,0,0,0,0
1746531936295,EDS 25,A07,888235,Staff,0,2,0,0
1746531936295,EDS 25,A08,888236,Staff,0,0,0,0
1746531936295,EDS 25,A09,888240,Staff,0,0,0,0
1746531936295,EDS 25,A10,888244,Staff,0,0,0,0
1746531936295,EDS 25,B01,888273,Staff,0,0,0,0
1746531936295,EDS 25,B02,888285,Staff,0,0,0,0
1746531936295,EDS 25,B03,888423,Staff,0,0,0,1
1746531936295,EDS 25,B04,888432,Staff,0,0,0,0
1746531936295,EDS 25,B05,888433,Staff,0,0,0,0
1746531936295,EDS 25,B06,888467,Staff,0,0,0,0
1746531936295,EDS 25,B07,888468,Staff,0,0,0,0
1746531936295,EDS 25,B08,888479,Staff,0,0,0,0
1746531936295,EDS 25,B09,888484,Staff,0,0,0,0
1746531936295,EDS 25,B10,888487,Staff,0,0,0,0
1746531937325,EDS 38,A01,907700,Choi; Bailey Miyeon,30,0,30,0
1746531938354,EDS 112,A01,888601,Chapman; Thandeka K,14,0,40,26
1746531939381,EDS 115,A00,888697,Mendez; Kathrina Mendoza,10,0,30,20
1746531940410,EDS 116,A01,888893,Staff,35,0,40,5
1746531942468,EDS 124AR,A00,889133,Staff,29,0,50,21
1746531942468,EDS 124AR,B00,907471,Simon; Elizabeth A,37,0,50,13
1746531943494,EDS 124BR,A00,889134,Simon; Elizabeth A,45,0,100,55
1746531944521,EDS 125,A00,889135,Staff,25,0,30,5
1746531945548,EDS 126,A01,889138,Staff,36,0,40,4
1746531946573,EDS 164R,A01,889142,Wishard Guerra; Alison G.,33,0,50,17
1746531947601,ENG 30,A01,886396,Staff,0,0,0,0
1746531947601,ENG 30,B01,886398,Staff,0,0,0,0
1746531948628,ENVR 102,A00,906150,Montejo; Carolina,23,0,25,2
1746531949659,ETHN 103A,A00,887236,Man; Simeon S,0,3,0,0
1746531950686,ETHN 113,A00,887239,Staff,16,0,30,14
1746531951714,ETHN 116,A00,887240,Staff,16,0,25,9
1746531952741,ETHN 117,A00,887241,Choi; Esther Min,28,0,30,2
1746531953777,ETHN 118,A00,887243,Staff,24,0,30,6
1746531954813,ETHN 127,A00,887248,Cuong; Marisol,11,0,15,4
1746531955837,ETHN 139,A00,887250,Staff,7,0,10,3
1746531956863,ETHN 142,A00,887252,Staff,10,0,30,20
1746531957892,ETHN 161,A00,887253,Browne; Errol Tsekani,24,0,30,6
1746531958918,ETHN 163FR,A00,887255,Burelle; Julie Sara Veronique,0,0,5,5
1746531959946,GLBH 20,A00,889149,Elwardani; Nile Regina,8,0,42,34
1746531962002,GLBH 111,A01,889152,Burgos; Jose L.,17,0,17,0
1746531963028,GLBH 150,A00,889181,Sloane; Julia Kathryn,0,5,15,15
1746531965083,HDS 60,A01,886406,Warstadt; Melissa Fawn,73,0,80,7
1746531966113,HIAF 111,A00,889324,Gyamfi; Bright,25,0,32,7
1746531967144,HIEA 131,A00,889328,Staff,16,0,32,16
1746531968171,HIEA 144,A00,889333,Henry; Todd A.,26,0,32,6
1746531969197,HIEA 154,A00,889336,Henry; Todd A.,24,0,32,8
1746531970223,HIEU 106,A00,889339,Staff,22,0,32,10
1746531972276,HIEU 114,A00,889340,Staff,3,0,32,29
1746531973304,HIEU 135GS,A00,889342,Patterson; Patrick H.,0,0,1,24
1746531974332,HIEU 137,A00,889343,Edington; Claire Ellen,9,0,25,16
1746531975358,HIEU 148,A00,889345,Staff,14,0,32,18
1746531976387,HIEU 154,A00,889346,Biess; Frank Peter,21,0,32,11
1746531977415,HILA 102,A00,889351,Staff,12,0,32,20
1746531978445,HILD 2A,A01,889221,Lewandoski; Julia Mavis,1,10,32,31
1746531979473,HILD 7B,A01,889225,Man; Simeon S,0,13,32,32
1746531980500,HILD 7C,A01,889288,Alvarez; Luis A,0,14,32,32
1746531981531,HILD 30,A01,889323,Staff,0,5,32,32
1746531983586,HISC 119,A00,889383,Golan; Tal,21,0,32,11
1746531984613,HIUS 103,A00,889384,Man; Simeon S,0,0,32,32
1746531985644,HIUS 117,A00,919797,Kwak; Nancy,18,0,32,14
1746531986674,HIUS 142A,A00,919788,Staff,22,0,32,10
1746531988735,HIUS 149,A00,889386,Gyamfi; Bright,27,0,32,5
1746531989765,HIUS 155,A00,889387,Alvarez; Luis A,14,0,32,18
1746531990795,HUM 3,A01,886499,Caldwell; Michael Alan,19,0,50,31
1746531991824,HUM 3GS,A00,886500,Rodriguez; Bretton Sigfred,0,0,0,28
1746531992853,HUM 3R,A01,886502,Markman; Kristina,0,36,50,50
1746531993881,HUM 4,A01,886504,Crum; Matthew Stephen,24,0,50,26
1746531993881,HUM 4,B01,886506,West; Geoffrey Scott,17,0,50,33
1746531994906,HUM 4GS,A00,886507,Staff,0,0,0,19
1746531995932,HUM 5,A01,886509,Staff,32,0,50,18
1746531996959,HUM 5R,A01,886511,Zavodny; Tatiana Sophia,0,39,50,50
1746531997985,JAPN 180,A00,886407,Staff,18,0,40,22
1746531999013,LATI 50,A01,886409,Martin-Cabrera; Luis,4,0,22,18
1746531999013,LATI 50,A02,886410,Martin-Cabrera; Luis,19,0,22,3
1746531999013,LATI 50,A03,886411,Martin-Cabrera; Luis,21,0,22,1
1746531999013,LATI 50,A04,886412,Martin-Cabrera; Luis,9,0,22,13
1746532000040,LAWS 101,A00,907664,Staff,28,0,60,32
1746532001067,LIAB 1A,A00,889388,Saab; Dima,17,0,20,3
1746532002095,LIAB 1AX,A00,889389,El Cheddadi; Youniss,17,0,20,3
1746532003121,LIFR 1C,A00,889391,Van Moer; Vinciane G,8,0,20,12
1746532004153,LIFR 1CX,A00,889392,Van Moer; Vinciane G,7,0,20,13
1746532005181,LIFR 1D,A00,889393,Van Moer; Vinciane G,7,0,20,13
1746532006206,LIFR 1DX,A00,889394,Van Moer; Vinciane G,8,0,20,12
1746532007235,LIGN 7,A00,886923,Staff,24,0,50,26
1746532008261,LIGN 17,A00,886924,Kehler; Andrew Scott,125,0,150,25
1746532009290,LTAM 110,A00,889395,Staff,15,0,30,15
1746532010319,LTAM 110GS,A00,958010,Rodriguez; Bretton Sigfred,0,0,0,28
1746532011346,LTCH 101,A00,889397,Staff,23,0,25,2
1746532012372,LTCS 130,A00,889398,Staff,23,0,25,2
1746532013400,LTEA 138,A00,889399,Staff,24,0,40,16
1746532014431,LTEN 149,A00,889400,Wesling; Megan E.,0,3,25,25
1746532015459,LTEN 169,A00,889401,Staff,20,0,25,5
1746532016488,LTEN 180,A00,889402,Staff,10,0,15,5
1746532017518,LTEN 181,A00,889403,Staff,21,0,25,4
1746532018547,LTWL 100,A00,889404,Myerston Santana; Jacobo,3,0,25,22
1746532019572,LTWL 180GS,A00,889405,Staff,0,0,20,20
1746532020601,LTWL 181,A00,889406,Staff,17,0,25,8
1746532021627,LTWL 184,A00,889475,Mukherjee; Silpa,22,0,25,3
1746532022659,LTWR 102C,A00,889486,Staff,29,0,30,1
1746532023688,LTWR 115W,A00,889491,Staff,0,2,15,15
1746532024719,MAE 8,A01,886905,Staff,0,2,0,0
1746532025748,MAE 11,A00,886906,Bandaru; Prabhakar,0,7,50,50
1746532026775,MAE 20,A00,886907,Evdokimenko; Ekaterina,44,0,70,26
1746532027803,MAE 30B,A00,886909,Ghazinejad; Maziar,26,0,45,19
1746532028833,MAE 101B,A00,886910,Saintillan; David,29,0,45,16
1746532029859,MAE 105,A00,886911,Bandaru; Prabhakar,18,0,50,32
1746532030887,MAE 107,B00,958024,Staff,9,0,50,41
1746532031940,MAE 143B,A00,886913,Bewley; Thomas R,7,0,40,33
1746532032968,MAE 148,A01,886915,Silberman; Jack,0,3,14,14
1746532034000,MAE 160,A00,886916,Evdokimenko; Ekaterina,31,0,60,29
1746532035028,MATH 3C,A01,889681,Staff,0,3,30,30
1746532035028,MATH 3C,A02,960048,Staff,25,0,30,5
1746532036059,MATH 10A,A01,889760,Staff,26,0,30,4
1746532036059,MATH 10A,A02,889783,Staff,29,0,30,1
1746532037087,MATH 10B,A01,889785,Verstraete; Jacques Allan,2,0,35,33
1746532037087,MATH 10B,A02,889795,Verstraete; Jacques Allan,4,0,35,31
1746532037087,MATH 10B,B01,889797,Verstraete; Jacques Allan,3,0,35,32
1746532037087,MATH 10B,B02,889828,Verstraete; Jacques Allan,3,0,35,32
1746532038116,MATH 10C,A01,889849,Habib; Yousaf,9,0,30,21
1746532038116,MATH 10C,A02,889852,Habib; Yousaf,14,0,30,16
1746532038116,MATH 10C,A03,889853,Habib; Yousaf,22,0,30,8
1746532038116,MATH 10C,A04,889858,Habib; Yousaf,20,0,30,10
1746532038116,MATH 10C,B01,889861,Staff,1,0,30,29
1746532038116,MATH 10C,B02,889862,Staff,24,0,30,6
1746532038116,MATH 10C,B03,889863,Staff,27,0,30,3
1746532038116,MATH 10C,B04,889967,Staff,23,0,30,7
1746532039149,MATH 18,A01,889974,Staff,7,0,30,23
1746532039149,MATH 18,A02,889977,Staff,20,0,30,10
1746532039149,MATH 18,B01,889984,Hardiman; Liam,22,0,30,8
1746532039149,MATH 18,B02,889985,Hardiman; Liam,25,0,30,5
1746532040174,MATH 20A,A01,889990,Suk; Andrew Hoon,29,0,35,6
1746532041208,MATH 20B,A01,889993,Ohm; Ko Woon,22,0,30,8
1746532041208,MATH 20B,A02,889994,Ohm; Ko Woon,30,0,30,0
1746532041208,MATH 20B,B01,889996,Ohm; Ko Woon,21,0,30,9
1746532041208,MATH 20B,B02,889997,Ohm; Ko Woon,23,0,30,7
1746532042241,MATH 20C,A01,889999,Hammock; Frances H,17,0,30,13
1746532042241,MATH 20C,A02,890003,Hammock; Frances H,23,0,30,7
1746532042241,MATH 20C,B01,890006,Hammock; Frances H,3,0,30,27
1746532042241,MATH 20C,B02,890007,Hammock; Frances H,11,0,30,19
1746532043266,MATH 20D,A01,890011,Cheng; Hsiao-Bing,1,1,30,29
1746532043266,MATH 20D,A02,890012,Cheng; Hsiao-Bing,14,0,30,16
1746532043266,MATH 20D,B01,890016,Cheng; Hsiao-Bing,13,0,30,17
1746532043266,MATH 20D,B02,890017,Cheng; Hsiao-Bing,13,0,30,17
1746532044294,MATH 20E,A01,890026,Harel; Guershon,1,0,30,29
1746532044294,MATH 20E,A02,890029,Harel; Guershon,23,0,30,7
1746532044294,MATH 20E,B01,890033,Harel; Guershon,7,0,30,23
1746532044294,MATH 20E,B02,890101,Harel; Guershon,21,0,30,9
1746532045320,MATH 102,A01,890104,Staff,17,0,30,13
1746532045320,MATH 102,A02,890105,Staff,27,0,30,3
1746532046366,MATH 103B,A01,890116,Salehi Golsefidy; Alireza,3,0,30,27
1746532046366,MATH 103B,B01,890118,Staff,0,3,34,34
1746532047399,MATH 109,A01,890121,Aliabadi Sr.; Mohsen,1,0,30,29
1746532047399,MATH 109,B01,890124,Upadrashta; Pranav Kumar,18,0,30,12
1746532048425,MATH 120A,A01,890126,Eggers; John Dietrich,13,0,30,17
1746532049452,MATH 142B,A01,890128,Ioana; Adrian,19,0,30,11
1746532049452,MATH 142B,A02,890129,Ioana; Adrian,13,0,30,17
1746532050480,MATH 154,A01,890174,Staff,0,0,30,30
1746532050480,MATH 154,A02,890182,Staff,0,0,30,30
1746532051505,MATH 168A,A01,890197,Dumitriu; Ioana,21,0,35,14
1746532052535,MATH 170A,A01,890240,Nie; Jiawang,1,0,30,29
1746532052535,MATH 170A,A02,890241,Nie; Jiawang,11,0,30,19
1746532052535,MATH 170A,A03,890249,Nie; Jiawang,23,0,30,7
1746532053562,MATH 170B,A01,957891,Nag; Panchali,13,0,35,22
1746532055621,MATH 181A,A01,908025,Staff,0,4,35,35
1746532055621,MATH 181A,A02,960115,Staff,27,0,35,8
1746532056648,MATH 181B,A01,959874,Staff,26,0,30,4
1746532057676,MATH 193B,A01,890265,Staff,0,4,35,35
1746532058704,MGT 4,A01,890311,Anderson; John Charles,42,0,88,46
1746532059731,MGT 5,A00,907740,Staff,13,0,98,85
1746532060758,MGT 12,A00,890312,Lindenberger; Wade Douglas,67,0,98,31
1746532061785,MGT 16,A00,957883,Staff,78,0,98,20
1746532063839,MGT 45,A00,890314,Pecore; Joseph P.,47,0,98,51
1746532064863,MGT 71,A00,890315,Staff,0,11,98,98
1746532065889,MGT 100,A00,890316,Yavorsky; Daniel Ryan,44,0,98,54
1746532066916,MGT 103,A00,890317,Ehrich; Kristine R,73,0,98,25
1746532067944,MGT 105,A00,890356,Bates; Kenneth Walter,0,7,98,98
1746532068974,MGT 112,A00,890360,Ehrich; Kristine R,55,0,98,43
1746532070003,MGT 127R,A00,907732,Zhu; Kevin Xiaoguo,23,0,98,75
1746532071031,MGT 131B,A00,890361,Anderson; John Charles,61,0,98,37
1746532072059,MGT 137,A00,890362,Lindenberger; Wade Douglas,65,0,98,33
1746532073087,MGT 160,A00,890369,Johnson; Erik Barry,9,0,98,89
1746532075142,MGT 164,A00,890372,Zimmermann; Carsten,0,39,98,98
1746532076170,MGT 180,A00,890374,Bliss; Barbara Ann,12,0,98,86
1746532077198,MMW 15,A01,886414,Chang; Edmond Yi-Teh,0,12,28,28
1746532077198,MMW 15,A02,886415,Chang; Edmond Yi-Teh,0,8,28,28
1746532077198,MMW 15,A03,886416,Chang; Edmond Yi-Teh,0,8,28,28
1746532077198,MMW 15,A04,886417,Chang; Edmond Yi-Teh,0,8,28,28
1746532077198,MMW 15,B01,886419,Chang; Edmond Yi-Teh,0,7,28,28
1746532077198,MMW 15,B02,886420,Chang; Edmond Yi-Teh,0,8,28,28
1746532077198,MMW 15,B03,886421,Chang; Edmond Yi-Teh,0,7,28,28
1746532077198,MMW 15,B04,886422,Chang; Edmond Yi-Teh,0,8,28,28
1746532077198,MMW 15,C01,886424,Staff,0,9,28,28
1746532077198,MMW 15,C02,886425,Staff,0,8,28,28
1746532077198,MMW 15,C03,886426,Staff,0,8,28,28
1746532077198,MMW 15,C04,886427,Staff,0,7,28,28
1746532077198,MMW 15,C05,958038,Staff,0,7,28,28
1746532077198,MMW 15,C06,958039,Staff,0,8,28,28
1746532078227,MMW 15GS,A00,906910,Patterson; Patrick H.,4,0,28,24
1746532079254,MMW 122R,A01,886429,Rahimi; Babak,0,13,28,28
1746532079254,MMW 122R,A02,886430,Rahimi; Babak,0,12,28,28
1746532079254,MMW 122R,A03,958040,Rahimi; Babak,0,11,28,28
1746532080282,MUS 1A,A01,890937,Staff,3,0,25,22
1746532080282,MUS 1A,A02,891035,Staff,6,0,25,19
1746532080282,MUS 1A,C01,958912,Staff,24,0,25,1
1746532080282,MUS 1A,C02,958913,Staff,25,0,25,0
1746532082335,MUS 2AK,A00,957092,Ohnishi; Takae,15,0,15,0
1746532083365,MUS 4,A01,891044,Staff,2,0,25,23
1746532083365,MUS 4,A02,891045,Staff,23,0,25,2
1746532083365,MUS 4,B01,891048,Staff,17,0,25,8
1746532083365,MUS 4,B02,891050,Staff,25,0,25,0
1746532084392,MUS 5,A01,957506,Dubnov; Shlomo,0,0,25,25
1746532084392,MUS 5,A02,957622,Dubnov; Shlomo,14,0,25,11
1746532084392,MUS 5,A03,957623,Dubnov; Shlomo,20,0,25,5
1746532085422,MUS 6,A01,891053,Freitas Caetano; Marcelo,24,0,25,1
1746532085422,MUS 6,A02,891054,Freitas Caetano; Marcelo,23,0,25,2
1746532086450,MUS 7,A01,891081,Staff,0,0,25,25
1746532086450,MUS 7,A02,891082,Staff,4,0,25,21
1746532087476,MUS 8GS,A00,891118,Borgo; David Garcia,0,0,25,25
1746532088505,MUS 11,A01,891140,Staff,11,0,25,14
1746532088505,MUS 11,A02,891141,Staff,22,0,25,3
1746532089533,MUS 13,A01,891143,Staff,8,0,25,17
1746532089533,MUS 13,A02,891144,Staff,24,0,25,1
1746532090564,MUS 15,A01,891146,Staff,9,0,25,16
1746532090564,MUS 15,A02,891148,Staff,21,0,25,4
1746532090564,MUS 15,B01,891150,Staff,18,0,25,7
1746532090564,MUS 15,B02,891151,Staff,25,0,25,0
1746532091594,MUS 20,A01,891153,Staff,5,0,20,15
1746532091594,MUS 20,A02,891155,Staff,14,0,20,6
1746532092620,MUS 80,A00,891156,Staff,19,0,25,6
1746532092620,MUS 80,B00,891157,Staff,23,0,25,2
1746532093650,MUS 130,A00,891158,Ohnishi; Takae,35,0,35,0
1746532094679,MUS 150GS,A01,891160,Borgo; David Garcia,0,0,25,25
1746532095711,MUS 170,A01,891162,Freitas Caetano; Marcelo,20,0,25,5
1746532095711,MUS 170,A02,891164,Freitas Caetano; Marcelo,21,0,25,4
1746532096743,NANO 11,A00,886220,Vazquez Mena; Oscar,13,0,15,2
1746532097772,NANO 15,A01,886222,Drews; Aaron,4,0,7,3
1746532098804,NANO 104,A00,886224,Sirbuly; Donald,18,0,25,7
1746532099833,PH 40,A00,886528,Staff,23,0,40,17
1746532100865,PH 45,A01,886799,Staff,35,0,40,5
1746532101892,PH 110,A00,886802,Staff,0,7,40,40
1746532102927,PH 172,A00,906716,Staff,19,0,35,16
1746532103956,PH 191,A00,886803,Staff,6,0,40,34
1746532104995,PHIL 1,A00,889500,Staff,19,0,30,11
1746532106026,PHIL 10,A01,889549,Grush; Rick Scott,15,0,22,7
1746532106026,PHIL 10,A02,889551,Grush; Rick Scott,22,0,22,0
1746532107057,PHIL 28,A01,889559,Lamey; Andy M.,0,1,31,31
1746532107057,PHIL 28,A02,889561,Lamey; Andy M.,0,1,30,30
1746532107057,PHIL 28,A03,889572,Lamey; Andy M.,0,0,30,30
1746532108084,PHIL 35,A00,907839,Staff,13,0,15,2
1746532109111,PHIL 60,A00,889574,Staff,74,0,90,16
1746532110140,PHIL 101,A00,958004,Staff,13,0,15,2
1746532112192,PHIL 136,A00,889582,Fulkerson; Matthew Todd,26,0,45,19
1746532113224,PHIL 163,A01,889601,Staff,21,0,30,9
1746532113224,PHIL 163,B01,889606,Brandt; Reuven A,0,3,0,0
1746532114249,PHIL 164,A00,889610,Staff,16,0,30,14
1746532115276,PHIL 165,A00,889613,Staff,23,0,30,7
1746532116316,PHYS 1A,A00,886431,Staff,26,0,70,44
1746532117342,PHYS 1AL,001,886432,Tsai; Philbert S,0,2,30,30
1746532117342,PHYS 1AL,002,886436,Tsai; Philbert S,11,0,30,19
1746532118366,PHYS 1B,A00,886439,Staff,185,0,240,55
1746532119393,PHYS 1BL,001,886441,Tsai; Philbert S,0,4,30,30
1746532119393,PHYS 1BL,002,886444,Tsai; Philbert S,2,0,30,28
1746532120419,PHYS 1C,A00,896092,Arnold; Kam S,78,0,146,68
1746532121447,PHYS 1CL,001,886448,Tsai; Philbert S,0,0,30,30
1746532121447,PHYS 1CL,002,886449,Tsai; Philbert S,0,0,30,30
1746532121447,PHYS 1CL,003,886450,Tsai; Philbert S,15,0,30,15
1746532121447,PHYS 1CL,004,886451,Tsai; Philbert S,15,0,30,15
1746532122473,PHYS 2B,A01,886457,Staff,69,0,115,46
1746532123502,PHYS 2C,A01,886460,Shotwell; Brian,0,8,65,65
1746532124533,PHYS 2CL,A01,886467,Staff,0,4,28,28
1746532124533,PHYS 2CL,A02,886468,Staff,0,3,28,28
1746532125565,PHYS 2D,A01,886470,Staff,10,0,50,40
1746532126594,PHYS 4B,A01,886475,Grinstein; Benjamin,22,0,40,18
1746532127625,POLI 5,A00,891173,Desposato; Scott,7,0,25,18
1746532128654,POLI 5D,A01,891175,Staff,5,0,5,0
1746532128654,POLI 5D,B01,891178,Staff,5,0,5,0
1746532129685,POLI 11,A00,891179,Ferree; Karen E,2,0,35,33
1746532130714,POLI 12,A00,891180,Staff,16,0,30,14
1746532131743,POLI 27,A01,891182,Staff,12,0,75,63
1746532132769,POLI 30,A00,891183,Staff,9,0,50,41
1746532133794,POLI 100B,A00,891244,Staff,5,1,35,30
1746532134821,POLI 100I,A00,891247,Staff,7,0,30,23
1746532135847,POLI 104J,A00,891248,Nichter; Maysa,14,0,30,16
1746532136877,POLI 104U,A00,891250,Nichter; Maysa,2,0,30,28
1746532138932,POLI 110B,A00,891255,Wiens; David,20,0,25,5
1746532139959,POLI 112A,A00,891256,Wiens; David,6,0,25,19
1746532140985,POLI 114BR,A00,891261,Staff,19,0,30,11
1746532142013,POLI 117R,A00,891262,Forman; Fonna,0,6,50,50
1746532143039,POLI 118,A00,891264,Ingham; Sean,17,0,25,8
1746532144067,POLI 124A,A00,891265,Staff,18,0,20,2
1746532145093,POLI 125D,A00,891266,Nichter; Simeon C,2,0,25,23
1746532146123,POLI 126,A00,891268,Nichter; Simeon C,7,0,25,18
1746532147147,POLI 126AA,A00,891272,Staff,18,0,25,7
1746532148174,POLI 130AA,A00,891273,Staff,15,0,20,5
1746532149203,POLI 134AA,A00,891274,Staff,4,0,20,16
1746532151258,POLI 138,A00,891278,Staff,21,0,25,4
1746532152288,POLI 142K,A00,891280,Staff,11,0,25,14
1746532153320,POLI 142M,A00,891281,Gartzke; Erik,17,0,30,13
1746532154351,POLI 142P,A00,891284,Staff,20,0,30,10
1746532155380,POLI 143,A00,891285,Gartzke; Erik,12,0,30,18
1746532156407,POLI 153,A00,891286,Staff,19,0,20,1
1746532158462,POLI 175,A00,891290,Staff,15,0,20,5
1746532159488,PSYC 1,A00,890674,Steiner; Eric Tomas,0,11,45,45
1746532160516,PSYC 2,A00,890676,Albright; Thomas D,21,0,35,14
1746532161547,PSYC 3,A00,890679,Staff,17,0,20,3
1746532162575,PSYC 6,A00,959858,Staff,20,0,20,0
1746532163602,PSYC 60,A01,890684,Rickard; Timothy C.,0,5,45,45
1746532164633,PSYC 70,A01,890689,Geller; Emma Harlan,7,0,30,23
1746532165660,PSYC 71,A01,959860,Staff,21,0,25,4
1746532166685,PSYC 100,A00,890690,Lacefield; Katharine I,0,50,180,180
1746532167716,PSYC 102,A00,890695,Staff,18,0,40,22
1746532168747,PSYC 105,A00,890699,Geller; Emma Harlan,71,0,100,29
1746532169775,PSYC 106,A00,890701,Gorman; Michael R.,5,0,30,25
1746532170802,PSYC 108,A00,890704,Adrian; Julia Anna,0,28,50,50
1746532171830,PSYC 118,A01,890712,Staff,11,0,30,19
1746532172858,PSYC 124,A00,890716,Chapman; Eddie Nathaniel,25,0,60,35
1746532173882,PSYC 131,A00,890717,Anagnostaras; Stephan,0,7,80,80
1746532174908,PSYC 137,A00,890719,Winkielman; Piotr,0,11,30,30
1746532175936,PSYC 144,A00,890721,Adrian; Julia Anna,0,9,45,45
1746532176966,PSYC 162,A00,890805,Staff,2,0,75,73
1746532177992,PSYC 169,A00,890810,Staff,0,15,30,30
1746532179018,PSYC 172,A00,890814,Gorman; Michael R.,9,0,30,21
1746532180052,PSYC 181,A00,890818,Anagnostaras; Stephan,8,0,200,192
1746532181078,PSYC 184,A00,959861,Staff,170,0,175,5
1746532182106,PSYC 189,A00,890823,Staff,0,1,30,30
1746532183132,PSYC 191,A00,890884,Rickard; Timothy C.,0,11,35,35
1746532184163,PSYC 193,A00,890913,Staff,19,0,30,11
1746532184163,PSYC 193,B00,890914,Chapman; Eddie Nathaniel,24,0,30,6
1746532185196,PSYC 193L,A01,890918,Lowe; Angela Beth,20,0,30,10
1746532185196,PSYC 193L,B01,890921,Hurwitz; Ethan Scott,20,0,30,10
1746532185196,PSYC 193L,C01,890928,Staff,30,0,30,0
1746532186221,RELI 149,A00,886806,Rahimi; Babak,23,0,40,17
1746532187253,SE 9,A01,886814,Staff,7,0,20,13
1746532188281,SE 101B,A01,886816,Chadha; Mayank,4,0,35,31
1746532189306,SE 110B,A00,886818,Zhu; Qiang,4,0,75,71
1746532190333,SE 125,A01,886830,Staff,10,0,30,20
1746532191381,SE 130B,A01,886835,Staff,14,0,40,26
1746532192406,SE 131A,A01,886838,Krysl; Petr,34,0,55,21
1746532193435,SE 154,A00,886840,Staff,30,0,50,20
1746532194459,SE 164GS,A01,886849,Staff,6,0,20,14
1746532195487,SE 167GS,A01,886853,Staff,6,0,20,14
1746532196513,SIO 25,A01,890107,Staff,19,0,30,11
1746532197541,SIO 45,A00,890109,Cook; Geoffrey W,117,0,200,83
1746532198569,SIO 109R,A00,890110,Forman; Fonna,0,16,20,20
1746532199599,SIO 187,A01,890114,Kacev; David,15,0,40,25
1746532200625,SOCI 1,A01,890431,Thorpe; Charles Robert,15,0,30,15
1746532200625,SOCI 1,A02,890518,Thorpe; Charles Robert,30,0,30,0
1746532201660,SOCI 2,A01,957978,Staff,25,0,25,0
1746532201660,SOCI 2,A02,957979,Staff,23,0,25,2
1746532202692,SOCI 20,A01,890523,Calderon-Zaks; Michael Aar,23,0,30,7
1746532202692,SOCI 20,A02,890526,Calderon-Zaks; Michael Aar,29,0,30,1
1746532203723,SOCI 30,A01,890533,Pardo Guerra; Juan Pablo,37,0,40,3
1746532204753,SOCI 40,A01,890535,Staff,27,0,45,18
1746532205780,SOCI 104Q,A00,890559,Staff,18,0,30,12
1746532206806,SOCI 106,A00,890560,Arnal; Maud Marie Leonie,20,0,30,10
1746532207833,SOCI 110,A00,890567,Holkenbrink-Monk; Charlene,19,0,30,11
1746532208858,SOCI 112,A00,890568,Victoria Torres; Pablo,1,0,55,54
1746532209897,SOCI 115,A00,890597,Arnal; Maud Marie Leonie,28,0,45,17
1746532211950,SOCI 121,A00,890604,Pardo Guerra; Juan Pablo,38,0,45,7
1746532212978,SOCI 126,A01,890608,Staff,8,0,10,2
1746532214004,SOCI 127,A00,890609,Staff,18,0,30,12
1746532215032,SOCI 131,A00,890610,Thorpe; Charles Robert,37,0,45,8
1746532216058,SOCI 135,A00,890615,Payne; Christine Anna,14,0,45,31
1746532217083,SOCI 139,A00,890620,Staff,38,0,45,7
1746532218113,SOCI 148E,A00,890622,Calderon-Zaks; Michael Aar,36,0,45,9
1746532219138,SOCI 150,A00,890623,Kohler; Kristopher M.,31,0,45,14
1746532220167,SOCI 157,A00,890625,Jules-Rosette; Bennetta W.,18,0,20,2
1746532221194,SOCI 160,A00,890627,Payne; Christine Anna,21,0,45,24
1746532222224,SYN 1,A00,886855,Fish; Gwendolyn Anne,0,0,0,0
1746532222224,SYN 1,B00,906086,Fish; Gwendolyn Anne,0,1,0,2
1746532223251,SYN 2R,A00,886860,Staff,0,17,15,15
1746532223251,SYN 2R,B00,906106,Atkinson; Arthur Laird,0,16,15,15
1746532224281,SYN 100,A01,886866,Browne; Emily,0,28,20,20
1746532224281,SYN 100,B01,906128,Rock; Martin,0,5,20,20
1746532224281,SYN 100,C01,906140,Deavenport; James Cary,0,3,20,20
1746532224281,SYN 100,D01,907816,Deavenport; James Cary,0,5,20,20
1746532225313,TDAC 1,A00,890286,Walsh; Kim C.,9,0,20,11
1746532226342,TDAC 101,A00,890296,Basso; Beatrice,16,0,20,4
1746532227370,TDDE 131,A00,890297,Staff,47,0,50,3
1746532228398,TDDM 1,A00,890287,Weinberg; Sadie,25,0,30,5
1746532229425,TDGE 11,A00,890288,Fulton; Julia,137,0,200,63
1746532229425,TDGE 11,B00,890289,Castro; Robert Jess,184,0,200,16
1746532230453,TDGE 25,B00,957359,Walsh; Kim C.,3,0,20,17
1746532231482,TDGE 40,A01,890292,Power; Jade Yukana,27,0,30,3
1746532232509,TDGE 124,A00,890298,Havis; Allan,0,0,50,50
1746532233536,TDGE 131R,A00,890299,Burelle; Julie Sara Veronique,15,0,42,27
1746532234561,TDHT 101,A00,890300,Staff,10,0,20,10
1746532235591,TDHT 109,A01,890302,Anderson; Mysia Anyse,31,0,40,9
1746532236622,TDMV 1,A00,890293,Arcidiacono; Kristin,18,0,30,12
1746532237649,TDMV 2,A00,890294,Weinberg; Sadie,23,0,30,7
1746532238678,TDMV 3,A00,957878,Arcidiacono; Kristin,28,0,30,2
1746532240734,TDMV 138,A00,890304,Jun; Grace Shin Hae,25,0,40,15
1746532241763,TDMV 140,A00,890305,Corrales; Joseph Bernales,25,0,30,5
1746532242790,TDMV 142,A00,890307,Caligagan; Tony,32,0,40,8
1746532243825,TDMV 144,A00,890308,Camaya; Michelle Ann,25,0,30,5
1746532244855,TDPW 1,A00,890295,Stein; Deborah Isobel,3,0,20,17
1746532245880,USP 2,A01,890272,Lerner; Amy M,6,0,20,14
1746532246912,USP 3,A01,890274,Staff,12,0,30,18
1746532247939,USP 15,A01,890276,Sun; Feiyang,17,0,30,13
1746532248971,USP 25,A00,890277,Shenkman; Michael Thomas,19,0,25,6
1746532250001,USP 138,A00,890278,Staff,13,0,25,12
1746532251027,USP 143,A00,890279,Staff,21,0,70,49
1746532252055,USP 144,A00,890280,Chowdhury; Muhammed Zohir,16,0,30,14
1746532253086,USP 150,A00,890281,Boomhower; Matthew Charles,4,0,30,26
1746532254117,USP 151,A00,890282,Staff,16,0,20,4
1746532255149,USP 162,A00,890283,Andrews; Abigail Leslie,16,0,20,4
1746532256173,USP 168,A00,920477,Kwak; Nancy,1,0,5,4
1746532257203,USP 181,A00,890284,Staff,3,0,20,17
1746532258231,USP 191A,A00,890285,Staff,13,0,20,7
1746532259258,VIS 101,A00,886512,Staff,25,0,75,50
1746532260287,VIS 103,A00,886513,Cruz; Edwin Teddy,61,0,75,14
1746532261322,VIS 108,A00,886514,Staff,3,0,15,12
1746532262348,VIS 127P,A00,886515,Shen; Kuiyi,80,0,146,66
1746532263381,VIS 149,A00,886516,Yoldas; Pinar,0,0,15,15
1746532264406,VIS 164,A00,886526,Erdmann; Dean,19,0,22,3
1746532265432,VIS 194S,A00,886527,Staff,61,0,75,14
1746532266462,WCWP 10A,C00,886484,Martiniuk; Jill,12,0,15,3
1746532267491,WCWP 10B,A00,886490,Uriarte; Emma,0,0,15,15
1746532267491,WCWP 10B,B00,886491,Dhir; Simrita,11,0,15,4
1746532267491,WCWP 10B,C00,886492,Ornelas; Tricia,0,0,15,15
1746532268521,WCWP 100,A00,886494,Young; Mark T,0,7,15,15
1746532270711,AAS 10,A01,886199,Childs; Dennis R.,0,3,0,0
1746532271741,ANAR 104,A01,886940,Shtienberg; Gilad,27,0,30,3
1746532272768,ANAR 120,A00,886953,Staff,12,0,20,8
1746532273797,ANBI 148,A01,886955,Wilder; Linnea Lorene,30,0,40,10
1746532275849,ANSC 122,A00,886957,Staff,25,0,30,5
1746532276878,ANSC 150,A00,886958,Sloane; Julia Kathryn,3,0,15,12
1746532277909,ANSC 156,A00,886959,Jenkins; Janis A.,0,1,15,15
1746532278938,ANSC 180,A00,886960,Staff,11,0,17,6
1746532279962,ANSC 188,A00,886961,Jassal; Aftab,9,0,25,16
1746532280993,ANSC 190,A00,886962,Jassal; Aftab,14,0,25,11
1746532282021,ANSC 191,A00,886963,Staff,18,0,20,2
1746532283050,ANTH 3,A01,891689,Staff,17,0,20,3
1746532284077,ANTH 5,A00,886933,Semendeferi; Ekaterini,16,0,20,4
1746532285102,ANTH 10,A00,886934,Staff,0,12,30,30
1746532286132,ANTH 21,A01,886936,Staff,40,0,60,20
1746532287159,ANTH 23,A01,886938,Staff,92,0,100,8
1746532288190,ANTH 105,A00,886964,Stewart; Alexander B,84,0,100,16
1746532289215,ANTH 108,A00,886965,Pedersen; David,9,0,20,11
1746532290243,AWP 10,001,886147,Staff,0,0,0,0
1746532290243,AWP 10,002,886148,Staff,0,0,0,0
1746532290243,AWP 10,003,886149,Staff,0,0,0,0
1746532290243,AWP 10,004,886150,Staff,0,0,0,0
1746532290243,AWP 10,005,886151,Staff,0,0,0,0
1746532290243,AWP 10,006,886152,Staff,0,0,0,0
1746532290243,AWP 10,007,886153,Staff,0,0,0,0
1746532290243,AWP 10,008,886154,Staff,0,0,0,0
1746532290243,AWP 10,009,886155,Staff,0,0,0,0
1746532290243,AWP 10,010,886156,Staff,0,0,0,0
1746532290243,AWP 10,011,886158,Staff,0,0,0,0
1746532290243,AWP 10,012,886160,Staff,0,0,0,0
1746532290243,AWP 10,013,886161,Staff,0,0,0,0
1746532290243,AWP 10,014,886162,Staff,0,0,0,0
1746532290243,AWP 10,015,886163,Staff,0,0,0,0
1746532290243,AWP 10,016,886164,Staff,0,0,0,0
1746532290243,AWP 10,017,886165,Staff,0,0,0,0
1746532290243,AWP 10,018,886166,Staff,0,0,0,0
1746532290243,AWP 10,019,886168,Staff,0,0,0,0
1746532290243,AWP 10,020,886170,Staff,0,0,0,0
1746532290243,AWP 10,021,886172,Staff,0,0,0,0
1746532291277,AWP 10R,001,886173,Staff,0,1,0,0
1746532291277,AWP 10R,002,886174,Staff,0,1,0,0
1746532291277,AWP 10R,003,886175,Staff,0,0,0,0
1746532291277,AWP 10R,004,886176,Staff,0,0,0,0
1746532291277,AWP 10R,005,886177,Staff,0,0,0,0
1746532291277,AWP 10R,006,886178,Staff,0,0,0,0
1746532291277,AWP 10R,007,886179,Staff,0,0,0,0
1746532291277,AWP 10R,008,886181,Staff,0,0,0,0
1746532291277,AWP 10R,009,886182,Staff,0,0,0,0
1746532291277,AWP 10R,010,886183,Staff,0,0,0,0
1746532291277,AWP 10R,011,886184,Staff,0,0,0,0
1746532291277,AWP 10R,012,886185,Staff,0,0,0,0
1746532291277,AWP 10R,013,886186,Staff,0,0,0,0
1746532291277,AWP 10R,014,886187,Staff,0,0,0,0
1746532291277,AWP 10R,015,886188,Staff,0,0,0,0
1746532291277,AWP 10R,016,886189,Staff,0,0,0,0
1746532292303,AWP 102R,A00,886190,Staff,0,0,0,0
1746532292303,AWP 102R,B00,886191,Staff,0,0,0,0
1746532293330,BENG 100,A01,886193,Staff,17,0,30,13
1746532294360,BENG 122A,A01,886195,Hasty; Jeff M,13,0,30,17
1746532295384,BENG 166A,A00,886196,Sah; Robert Lie-Yuan,0,1,30,30
1746532296417,BENG 190,A00,958050,Khojah; Reem I,24,0,25,1
1746532297446,BIBC 102,A01,894320,Staff,0,0,46,46
1746532297446,BIBC 102,A02,894321,Staff,1,0,46,45
1746532297446,BIBC 102,A03,894344,Staff,7,0,46,39
1746532297446,BIBC 102,A04,894345,Staff,26,0,47,21
1746532298477,BICD 100R,A01,894365,Smith; Laurie,0,3,58,58
1746532298477,BICD 100R,A02,894366,Smith; Laurie,0,5,58,58
1746532298477,BICD 100R,A03,894367,Smith; Laurie,2,0,59,57
1746532298477,BICD 100R,A04,959869,Smith; Laurie,41,0,59,18
1746532299502,BICD 136,A01,894383,Gustafson-Brown; Cindy,14,0,50,36
1746532300536,BIEB 102,A01,894494,Butler; Shannon Rhey,51,0,130,79
1746532302596,BIEB 150,A01,894617,Wills; Christopher,3,0,20,17
1746532302596,BIEB 150,A02,894631,Wills; Christopher,3,0,20,17
1746532302596,BIEB 150,A03,894937,Wills; Christopher,4,0,20,16
1746532302596,BIEB 150,A04,894946,Wills; Christopher,5,0,20,15
1746532303626,BIEB 194,A00,906141,Kurle; Carolyn M.,6,0,20,14
1746532304655,BILD 1,A01,894154,Staff,2,0,19,17
1746532304655,BILD 1,A02,894155,Staff,14,0,19,5
1746532304655,BILD 1,A03,894160,Staff,13,0,19,6
1746532304655,BILD 1,A04,894161,Staff,15,0,18,3
1746532305682,BILD 2,A01,894168,Staff,0,0,50,50
1746532305682,BILD 2,A02,894169,Staff,0,0,50,50
1746532305682,BILD 2,A03,894179,Staff,4,0,50,46
1746532305682,BILD 2,A04,894203,Staff,27,0,50,23
1746532306710,BILD 3,A01,894213,Staff,22,0,31,9
1746532306710,BILD 3,A02,894214,Staff,26,0,31,5
1746532306710,BILD 3,A03,894235,Staff,28,0,31,3
1746532306710,BILD 3,A04,894236,Staff,28,0,32,4
1746532307737,BILD 4,A01,894253,Reuther; Keefe,5,0,24,19
1746532307737,BILD 4,A02,894258,Reuther; Keefe,16,0,24,8
1746532308764,BILD 5,A01,894276,Reuther; Keefe,35,0,50,15
1746532308764,BILD 5,A02,894277,Reuther; Keefe,45,0,50,5
1746532308764,BILD 5,A03,894290,Reuther; Keefe,44,0,50,6
1746532308764,BILD 5,A04,894291,Reuther; Keefe,48,0,50,2
1746532309792,BILD 24,A01,894297,Pirino; Giorgia,40,0,60,20
1746532310819,BIMM 100,B01,958915,Staff,72,0,100,28
1746532311883,BIMM 101,A01,895017,McDonnell; Lisa Marie,0,5,24,24
1746532311883,BIMM 101,A02,895018,McDonnell; Lisa Marie,0,5,24,24
1746532311883,BIMM 101,B01,895020,McDonnell; Lisa Marie,0,6,24,24
1746532311883,BIMM 101,B02,895021,McDonnell; Lisa Marie,0,4,24,24
1746532312910,BIMM 110,A01,895023,Staff,1,0,25,24
1746532312910,BIMM 110,A02,895024,Staff,9,0,25,16
1746532312910,BIMM 110,A03,895025,Staff,18,0,25,7
1746532312910,BIMM 110,A04,895031,Staff,20,0,25,5
1746532313943,BIMM 120,A01,895114,Gustafson-Brown; Cindy,13,0,28,15
1746532313943,BIMM 120,A02,895126,Gustafson-Brown; Cindy,20,0,27,7
1746532314974,BIPN 100,A01,895130,Yang; Mingyu,1,0,38,37
1746532314974,BIPN 100,A02,895131,Yang; Mingyu,32,0,38,6
1746532314974,BIPN 100,A03,895132,Yang; Mingyu,32,0,38,6
1746532314974,BIPN 100,A04,895133,Yang; Mingyu,27,0,36,9
1746532316008,BIPN 120,A01,895135,Cooke; James Edward,0,3,13,13
1746532316008,BIPN 120,A02,895136,Cooke; James Edward,0,1,13,13
1746532316008,BIPN 120,A03,895137,Cooke; James Edward,0,3,13,13
1746532316008,BIPN 120,A04,895156,Cooke; James Edward,0,2,11,11
1746532317037,BIPN 134,A01,895235,Cooke; James Edward,0,2,25,25
1746532317037,BIPN 134,A02,895237,Cooke; James Edward,0,0,25,25
1746532317037,BIPN 134,A03,895240,Cooke; James Edward,3,0,25,22
1746532317037,BIPN 134,A04,895270,Cooke; James Edward,20,0,25,5
1746532318063,BIPN 189,A00,892103,Staff,0,13,14,14
1746532320121,BISP 194,A00,958008,Staff,0,2,0,0
1746532321148,CAT 124,A01,922009,Staff,0,5,20,20
1746532322184,CAT 125R,A00,886390,Morales; Celeste Georgianna,0,2,20,20
1746532322184,CAT 125R,B00,886391,Irwin; Matthew Joseph,0,3,20,20
1746532322184,CAT 125R,C00,886392,Smith; Lauryn Alissa,0,2,20,20
1746532322184,CAT 125R,D00,886393,Vanderschuit; Maya Alysia,0,2,20,20
1746532322184,CAT 125R,E00,886394,Marchisotto; Jennifer Anne,0,4,20,20
1746532323213,CENG 15,A01,886218,Drews; Aaron,3,0,8,5
1746532324241,CENG 113,A00,886219,Opatkiewicz; Justin Paul,15,0,25,10
1746532325267,CGS 101,A00,887044,Staff,7,0,20,13
1746532326296,CGS 105,A01,887046,Staff,14,0,25,11
1746532327322,CGS 112,A00,887047,Cuong; Marisol,12,0,15,3
1746532328347,CGS 113,A00,887048,Staff,23,0,30,7
1746532329374,CGS 120,A00,887049,Staff,10,0,17,7
1746532330402,CHEM 6A,A01,886336,Lam; Tin Yiu,38,0,50,12
1746532330402,CHEM 6A,A02,886338,Lam; Tin Yiu,37,0,50,13
1746532331432,CHEM 6B,A01,886341,Hopkins; Patrycja Anna,16,0,50,34
1746532331432,CHEM 6B,A02,886343,Hopkins; Patrycja Anna,42,0,50,8
1746532332457,CHEM 6C,A01,886346,Albizati; Kim F.,0,2,50,50
1746532332457,CHEM 6C,A02,886348,Albizati; Kim F.,23,0,50,27
1746532333486,CHEM 40A,A01,886352,Klosterman; Jeremy K,65,0,100,35
1746532334514,CHEM 40B,A01,886356,Klosterman; Jeremy K,0,23,100,100
1746532335540,CHEM 41B,A01,886360,Theodorakis; Emmanuel,25,0,50,25
1746532335540,CHEM 41B,A02,886362,Theodorakis; Emmanuel,47,0,50,3
1746532336567,CHIN 165A,A00,886382,Xu; Li,18,0,20,2
1746532337595,CLAS 120,A00,886387,Myerston Santana; Jacobo,33,0,40,7
1746532338623,COGS 9,A01,886967,Shannon; Kyle Michael,42,0,60,18
1746532339652,COGS 11,A01,886969,Staff,11,0,30,19
1746532340678,COGS 14A,A01,886971,Staff,6,0,60,54
1746532341704,COGS 14B,A01,886973,Hoffman; Drew Ellen,4,0,60,56
1746532342731,COGS 18,A01,886975,Morgan; Eric,35,0,60,25
1746532343759,COGS 20,A01,886977,Staff,4,0,8,4
1746532343759,COGS 20,A02,886978,Staff,5,0,7,2
1746532344788,COGS 100,A01,907783,Staff,0,2,30,30
1746532345814,COGS 101B,A01,886980,Staff,0,3,48,48
1746532346841,COGS 101C,A01,886982,Delgado; Tania,0,5,44,44
1746532347869,COGS 102A,A01,886984,Johnson; Christine M.,4,0,30,26
1746532348896,COGS 118B,A01,886986,Staff,0,3,88,88
1746532349922,COGS 150,A01,886988,Bergen; Benjamin,23,0,50,27
1746532350947,COGS 153,A00,886989,Delgado; Tania,0,2,41,41
1746532351977,COGS 186,A01,886991,Staff,0,0,32,32
1746532353004,COGS 187A,A01,886993,Boyle; Mary E. T.,7,0,30,23
1746532354028,COGS 189,A00,886994,Staff,0,1,30,30
1746532355054,COMM 10,A01,886996,Staff,0,0,20,21
1746532355054,COMM 10,A02,886997,Staff,12,0,20,8
1746532355054,COMM 10,A03,959845,Staff,19,0,20,1
1746532356083,COMM 20,A01,886999,Leuning; Grant Maurstad,24,0,40,16
1746532358135,COMM 100A,A01,887002,Staff,0,0,20,25
1746532358135,COMM 100A,A02,887003,Staff,7,0,20,13
1746532359163,COMM 100B,A01,887005,Staff,0,8,20,24
1746532360189,COMM 106D,A00,887006,Staff,14,0,40,26
1746532361216,COMM 110G,A00,887007,Whitworth-Smith; Andrew C,12,0,40,28
1746532362245,COMM 111B,A00,887008,Staff,31,0,40,9
1746532363276,COMM 113T,A00,887009,Abuelhiga; Soraya Jill,28,0,40,12
1746532363276,COMM 113T,B00,906733,Staff,40,0,40,0
1746532364303,COMM 145,A00,887010,Staff,12,0,40,28
1746532365330,COMM 146,A00,887054,Staff,31,0,40,9
1746532366356,COMM 190,A00,887012,Staff,8,0,23,15
1746532367385,CSE 8A,A50,887015,Cao; Yingjun,57,0,85,28
1746532368415,CSE 11,A01,887017,Cao; Yingjun,12,0,70,58
1746532369441,CSE 20,A01,887019,Staff,30,0,50,20
1746532370466,CSE 21,A01,887021,Staff,78,0,100,22
1746532370466,CSE 21,B01,892583,Braun; Oliver,45,0,50,5
1746532371497,CSE 30,A01,887025,Eldon; John,143,0,200,57
1746532372523,CSE 100,A01,887027,Staff,26,0,50,24
1746532372523,CSE 100,A02,887028,Staff,40,0,50,10
1746532373551,CSE 101,A01,887030,Braun; Oliver,75,0,100,25
1746532373551,CSE 101,B01,887032,Jones; Miles E,0,3,50,50
1746532373551,CSE 101,B02,887033,Jones; Miles E,0,1,50,50
1746532374578,CSE 105,A01,908084,Jones; Miles E,32,0,50,18
1746532374578,CSE 105,A02,908087,Jones; Miles E,33,0,50,17
1746532375605,CSE 135,A01,887035,Powell; Thomas Allan,0,4,50,50
1746532376632,CSE 142,A01,887037,Staff,8,0,60,52
1746532377662,CSE 142L,A01,887039,Staff,34,0,60,26
1746532378689,CSE 151A,A01,887041,Solares; Edwin A,48,0,100,52
1746532379717,CSE 175,A01,887043,Kumar; Rakesh,30,0,30,0
1746532380744,CSS 1,A01,886389,Staff,0,1,40,40
1746532381769,DSC 30,A01,908097,Liao; Soohyun Nam,47,0,75,28
1746532382797,DSC 40A,A01,908099,Shannon; Kyle Michael,30,0,50,20
1746532383823,DSC 40B,A01,908112,Staff,16,0,50,34
1746532384853,DSC 80,A01,908116,Staff,19,0,60,41
1746532385879,DSC 197,001,956863,Eldridge; Justin Matthew,9999,0,9999,0
1746532386907,ECE 5,A01,886400,Morris; Karcher William,2,0,6,4
1746532386907,ECE 5,A02,886401,Morris; Karcher William,3,0,6,3
1746532387935,ECE 148,A01,886403,Silberman; Jack,0,14,14,14
1746532388965,ECON 1,A01,887265,Crane; Meredith Helen,12,0,70,58
1746532388965,ECON 1,B01,887268,Staff,43,0,50,7
1746532389991,ECON 2,A01,887273,Crane; Meredith Helen,56,0,70,14
1746532391017,ECON 3,A01,887279,Rondina; Giacomo,32,0,70,38
1746532392085,ECON 4,A01,887282,Anderson; John Charles,0,2,10,10
1746532393113,ECON 5,A01,887285,Staff,33,0,45,12
1746532393113,ECON 5,B01,887292,Staff,41,0,45,4
1746532394141,ECON 100A,A01,887337,Newhouse; Herbert S,54,0,70,16
1746532394141,ECON 100A,B01,887349,Staff,45,0,50,5
1746532395167,ECON 100B,A01,887361,Du; Songzi,29,0,70,41
1746532396195,ECON 100C,A01,887445,Newhouse; Herbert S,59,0,70,11
1746532397221,ECON 105,A00,887488,Vespa; Emanuel Ignacio,23,0,35,12
1746532398250,ECON 109,A01,887506,Shishkin; Denis,28,0,35,7
1746532399276,ECON 110A,A01,887568,Alon; Titan Michael,0,3,35,35
1746532399276,ECON 110A,B01,907601,Alon; Titan Michael,20,0,35,15
1746532400302,ECON 110B,A01,887598,Levkoff; Steven B.,0,23,70,70
1746532401328,ECON 112,A00,887599,Rondina; Giacomo,19,0,35,16
1746532402353,ECON 120A,A01,887603,Dai; Yinlin,36,0,70,34
1746532403381,ECON 120C,A01,887608,Sun; Yixiao,0,1,35,35
1746532403381,ECON 120C,B01,887614,Sun; Yixiao,0,0,35,35
1746532404411,ECON 138,A00,887621,Bharadwaj; Prashant,0,20,20,20
1746532405435,ECON 144,A00,958007,Squires; Dale E,13,0,35,22
1746532406461,ECON 171,A01,907666,Staff,18,0,35,17
1746532407489,ECON 175,A00,887626,Wu; Pak Yeung,23,0,35,12
1746532408515,ECON 190,A00,887640,Vespa; Emanuel Ignacio,23,0,35,12
1746532409546,EDS 25,A01,888197,Staff,0,0,0,0
1746532409546,EDS 25,A02,888209,Staff,0,0,0,0
1746532409546,EDS 25,A03,888210,Staff,0,0,0,0
1746532409546,EDS 25,A04,888212,Staff,0,0,0,0
1746532409546,EDS 25,A05,888213,Staff,0,0,0,0
1746532409546,EDS 25,A06,888214,Staff,0,0,0,0
1746532409546,EDS 25,A07,888235,Staff,0,2,0,0
1746532409546,EDS 25,A08,888236,Staff,0,0,0,0
1746532409546,EDS 25,A09,888240,Staff,0,0,0,0
1746532409546,EDS 25,A10,888244,Staff,0,0,0,0
1746532409546,EDS 25,B01,888273,Staff,0,0,0,0
1746532409546,EDS 25,B02,888285,Staff,0,0,0,0
1746532409546,EDS 25,B03,888423,Staff,0,0,0,1
1746532409546,EDS 25,B04,888432,Staff,0,0,0,0
1746532409546,EDS 25,B05,888433,Staff,0,0,0,0
1746532409546,EDS 25,B06,888467,Staff,0,0,0,0
1746532409546,EDS 25,B07,888468,Staff,0,0,0,0
1746532409546,EDS 25,B08,888479,Staff,0,0,0,0
1746532409546,EDS 25,B09,888484,Staff,0,0,0,0
1746532409546,EDS 25,B10,888487,Staff,0,0,0,0
1746532410572,EDS 38,A01,907700,Choi; Bailey Miyeon,30,0,30,0
1746532411599,EDS 112,A01,888601,Chapman; Thandeka K,14,0,40,26
1746532412631,EDS 115,A00,888697,Mendez; Kathrina Mendoza,10,0,30,20
1746532413656,EDS 116,A01,888893,Staff,35,0,40,5
1746532415711,EDS 124AR,A00,889133,Staff,29,0,50,21
1746532415711,EDS 124AR,B00,907471,Simon; Elizabeth A,37,0,50,13
1746532416736,EDS 124BR,A00,889134,Simon; Elizabeth A,45,0,100,55
1746532417765,EDS 125,A00,889135,Staff,25,0,30,5
1746532418791,EDS 126,A01,889138,Staff,36,0,40,4
1746532419820,EDS 164R,A01,889142,Wishard Guerra; Alison G.,33,0,50,17
1746532420846,ENG 30,A01,886396,Staff,0,0,0,0
1746532420846,ENG 30,B01,886398,Staff,0,0,0,0
1746532421873,ENVR 102,A00,906150,Montejo; Carolina,23,0,25,2
1746532422899,ETHN 103A,A00,887236,Man; Simeon S,0,3,0,0
1746532423928,ETHN 113,A00,887239,Staff,16,0,30,14
1746532424958,ETHN 116,A00,887240,Staff,16,0,25,9
1746532425985,ETHN 117,A00,887241,Choi; Esther Min,28,0,30,2
1746532427011,ETHN 118,A00,887243,Staff,24,0,30,6
1746532428041,ETHN 127,A00,887248,Cuong; Marisol,11,0,15,4
1746532429069,ETHN 139,A00,887250,Staff,7,0,10,3
1746532430094,ETHN 142,A00,887252,Staff,10,0,30,20
1746532431122,ETHN 161,A00,887253,Browne; Errol Tsekani,24,0,30,6
1746532432147,ETHN 163FR,A00,887255,Burelle; Julie Sara Veronique,0,0,5,5
1746532433172,GLBH 20,A00,889149,Elwardani; Nile Regina,8,0,42,34
1746532435227,GLBH 111,A01,889152,Burgos; Jose L.,17,0,17,0
1746532436258,GLBH 150,A00,889181,Sloane; Julia Kathryn,0,5,15,15
1746532438308,HDS 60,A01,886406,Warstadt; Melissa Fawn,73,0,80,7
1746532439335,HIAF 111,A00,889324,Gyamfi; Bright,25,0,32,7
1746532440362,HIEA 131,A00,889328,Staff,16,0,32,16
1746532441388,HIEA 144,A00,889333,Henry; Todd A.,26,0,32,6
1746532442427,HIEA 154,A00,889336,Henry; Todd A.,24,0,32,8
1746532443453,HIEU 106,A00,889339,Staff,22,0,32,10
1746532445503,HIEU 114,A00,889340,Staff,3,0,32,29
1746532446533,HIEU 135GS,A00,889342,Patterson; Patrick H.,0,0,1,24
1746532447563,HIEU 137,A00,889343,Edington; Claire Ellen,9,0,25,16
1746532448587,HIEU 148,A00,889345,Staff,14,0,32,18
1746532449618,HIEU 154,A00,889346,Biess; Frank Peter,21,0,32,11
1746532450646,HILA 102,A00,889351,Staff,12,0,32,20
1746532451672,HILD 2A,A01,889221,Lewandoski; Julia Mavis,1,10,32,31
1746532452702,HILD 7B,A01,889225,Man; Simeon S,0,13,32,32
1746532453735,HILD 7C,A01,889288,Alvarez; Luis A,0,14,32,32
1746532454762,HILD 30,A01,889323,Staff,0,5,32,32
1746532456819,HISC 119,A00,889383,Golan; Tal,21,0,32,11
1746532457845,HIUS 103,A00,889384,Man; Simeon S,0,0,32,32
1746532458871,HIUS 117,A00,919797,Kwak; Nancy,18,0,32,14
1746532459899,HIUS 142A,A00,919788,Staff,22,0,32,10
1746532461952,HIUS 149,A00,889386,Gyamfi; Bright,27,0,32,5
1746532462980,HIUS 155,A00,889387,Alvarez; Luis A,14,0,32,18
1746532464008,HUM 3,A01,886499,Caldwell; Michael Alan,19,0,50,31
1746532465035,HUM 3GS,A00,886500,Rodriguez; Bretton Sigfred,0,0,0,28
1746532466067,HUM 3R,A01,886502,Markman; Kristina,0,36,50,50
1746532467094,HUM 4,A01,886504,Crum; Matthew Stephen,24,0,50,26
1746532467094,HUM 4,B01,886506,West; Geoffrey Scott,17,0,50,33
1746532468122,HUM 4GS,A00,886507,Staff,0,0,0,19
1746532469148,HUM 5,A01,886509,Staff,32,0,50,18
1746532470174,HUM 5R,A01,886511,Zavodny; Tatiana Sophia,0,39,50,50
1746532471199,JAPN 180,A00,886407,Staff,18,0,40,22
1746532472228,LATI 50,A01,886409,Martin-Cabrera; Luis,4,0,22,18
1746532472228,LATI 50,A02,886410,Martin-Cabrera; Luis,19,0,22,3
1746532472228,LATI 50,A03,886411,Martin-Cabrera; Luis,21,0,22,1
1746532472228,LATI 50,A04,886412,Martin-Cabrera; Luis,9,0,22,13
1746532473255,LAWS 101,A00,907664,Staff,28,0,60,32
1746532474280,LIAB 1A,A00,889388,Saab; Dima,17,0,20,3
1746532475307,LIAB 1AX,A00,889389,El Cheddadi; Youniss,17,0,20,3
1746532476332,LIFR 1C,A00,889391,Van Moer; Vinciane G,8,0,20,12
1746532477357,LIFR 1CX,A00,889392,Van Moer; Vinciane G,7,0,20,13
1746532478387,LIFR 1D,A00,889393,Van Moer; Vinciane G,7,0,20,13
1746532479413,LIFR 1DX,A00,889394,Van Moer; Vinciane G,8,0,20,12
1746532480442,LIGN 7,A00,886923,Staff,24,0,50,26
1746532481469,LIGN 17,A00,886924,Kehler; Andrew Scott,125,0,150,25
1746532482496,LTAM 110,A00,889395,Staff,15,0,30,15
1746532483524,LTAM 110GS,A00,958010,Rodriguez; Bretton Sigfred,0,0,0,28
1746532484552,LTCH 101,A00,889397,Staff,23,0,25,2
1746532485620,LTCS 130,A00,889398,Staff,23,0,25,2
1746532486649,LTEA 138,A00,889399,Staff,24,0,40,16
1746532487680,LTEN 149,A00,889400,Wesling; Megan E.,0,3,25,25
1746532488708,LTEN 169,A00,889401,Staff,20,0,25,5
1746532489735,LTEN 180,A00,889402,Staff,10,0,15,5
1746532490762,LTEN 181,A00,889403,Staff,21,0,25,4
1746532491793,LTWL 100,A00,889404,Myerston Santana; Jacobo,3,0,25,22
1746532492818,LTWL 180GS,A00,889405,Staff,0,0,20,20
1746532493845,LTWL 181,A00,889406,Staff,17,0,25,8
1746532494876,LTWL 184,A00,889475,Mukherjee; Silpa,22,0,25,3
1746532495903,LTWR 102C,A00,889486,Staff,29,0,30,1
1746532496933,LTWR 115W,A00,889491,Staff,0,2,15,15
1746532497959,MAE 8,A01,886905,Staff,0,2,0,0
1746532498990,MAE 11,A00,886906,Bandaru; Prabhakar,0,7,50,50
1746532500022,MAE 20,A00,886907,Evdokimenko; Ekaterina,44,0,70,26
1746532501050,MAE 30B,A00,886909,Ghazinejad; Maziar,26,0,45,19
1746532502076,MAE 101B,A00,886910,Saintillan; David,29,0,45,16
1746532503106,MAE 105,A00,886911,Bandaru; Prabhakar,18,0,50,32
1746532504139,MAE 107,B00,958024,Staff,9,0,50,41
1746532505165,MAE 143B,A00,886913,Bewley; Thomas R,7,0,40,33
1746532506197,MAE 148,A01,886915,Silberman; Jack,0,3,14,14
1746532507226,MAE 160,A00,886916,Evdokimenko; Ekaterina,31,0,60,29
1746532508257,MATH 3C,A01,889681,Staff,0,3,30,30
1746532508257,MATH 3C,A02,960048,Staff,25,0,30,5
1746532509284,MATH 10A,A01,889760,Staff,26,0,30,4
1746532509284,MATH 10A,A02,889783,Staff,29,0,30,1
1746532510319,MATH 10B,A01,889785,Verstraete; Jacques Allan,2,0,35,33
1746532510319,MATH 10B,A02,889795,Verstraete; Jacques Allan,4,0,35,31
1746532510319,MATH 10B,B01,889797,Verstraete; Jacques Allan,3,0,35,32
1746532510319,MATH 10B,B02,889828,Verstraete; Jacques Allan,3,0,35,32
1746532511348,MATH 10C,A01,889849,Habib; Yousaf,9,0,30,21
1746532511348,MATH 10C,A02,889852,Habib; Yousaf,14,0,30,16
1746532511348,MATH 10C,A03,889853,Habib; Yousaf,22,0,30,8
1746532511348,MATH 10C,A04,889858,Habib; Yousaf,20,0,30,10
1746532511348,MATH 10C,B01,889861,Staff,1,0,30,29
1746532511348,MATH 10C,B02,889862,Staff,24,0,30,6
1746532511348,MATH 10C,B03,889863,Staff,27,0,30,3
1746532511348,MATH 10C,B04,889967,Staff,23,0,30,7
1746532512377,MATH 18,A01,889974,Staff,7,0,30,23
1746532512377,MATH 18,A02,889977,Staff,20,0,30,10
1746532512377,MATH 18,B01,889984,Hardiman; Liam,22,0,30,8
1746532512377,MATH 18,B02,889985,Hardiman; Liam,25,0,30,5
1746532513407,MATH 20A,A01,889990,Suk; Andrew Hoon,29,0,35,6
1746532514435,MATH 20B,A01,889993,Ohm; Ko Woon,22,0,30,8
1746532514435,MATH 20B,A02,889994,Ohm; Ko Woon,30,0,30,0
1746532514435,MATH 20B,B01,889996,Ohm; Ko Woon,21,0,30,9
1746532514435,MATH 20B,B02,889997,Ohm; Ko Woon,23,0,30,7
1746532515463,MATH 20C,A01,889999,Hammock; Frances H,17,0,30,13
1746532515463,MATH 20C,A02,890003,Hammock; Frances H,23,0,30,7
1746532515463,MATH 20C,B01,890006,Hammock; Frances H,3,0,30,27
1746532515463,MATH 20C,B02,890007,Hammock; Frances H,11,0,30,19
1746532516493,MATH 20D,A01,890011,Cheng; Hsiao-Bing,1,1,30,29
1746532516493,MATH 20D,A02,890012,Cheng; Hsiao-Bing,14,0,30,16
1746532516493,MATH 20D,B01,890016,Cheng; Hsiao-Bing,13,0,30,17
1746532516493,MATH 20D,B02,890017,Cheng; Hsiao-Bing,13,0,30,17
1746532517524,MATH 20E,A01,890026,Harel; Guershon,1,0,30,29
1746532517524,MATH 20E,A02,890029,Harel; Guershon,23,0,30,7
1746532517524,MATH 20E,B01,890033,Harel; Guershon,7,0,30,23
1746532517524,MATH 20E,B02,890101,Harel; Guershon,21,0,30,9
1746532518552,MATH 102,A01,890104,Staff,17,0,30,13
1746532518552,MATH 102,A02,890105,Staff,27,0,30,3
1746532519584,MATH 103B,A01,890116,Salehi Golsefidy; Alireza,3,0,30,27
1746532519584,MATH 103B,B01,890118,Staff,0,3,34,34
1746532520615,MATH 109,A01,890121,Aliabadi Sr.; Mohsen,1,0,30,29
1746532520615,MATH 109,B01,890124,Upadrashta; Pranav Kumar,18,0,30,12
1746532521643,MATH 120A,A01,890126,Eggers; John Dietrich,13,0,30,17
1746532522674,MATH 142B,A01,890128,Ioana; Adrian,19,0,30,11
1746532522674,MATH 142B,A02,890129,Ioana; Adrian,13,0,30,17
1746532523704,MATH 154,A01,890174,Staff,0,0,30,30
1746532523704,MATH 154,A02,890182,Staff,0,0,30,30
1746532524732,MATH 168A,A01,890197,Dumitriu; Ioana,21,0,35,14
1746532525757,MATH 170A,A01,890240,Nie; Jiawang,1,0,30,29
1746532525757,MATH 170A,A02,890241,Nie; Jiawang,11,0,30,19
1746532525757,MATH 170A,A03,890249,Nie; Jiawang,23,0,30,7
1746532526785,MATH 170B,A01,957891,Nag; Panchali,13,0,35,22
1746532528838,MATH 181A,A01,908025,Staff,0,4,35,35
1746532528838,MATH 181A,A02,960115,Staff,27,0,35,8
1746532529866,MATH 181B,A01,959874,Staff,26,0,30,4
1746532530893,MATH 193B,A01,890265,Staff,0,4,35,35
1746532531920,MGT 4,A01,890311,Anderson; John Charles,42,0,88,46
1746532532949,MGT 5,A00,907740,Staff,13,0,98,85
1746532533980,MGT 12,A00,890312,Lindenberger; Wade Douglas,67,0,98,31
1746532535010,MGT 16,A00,957883,Staff,78,0,98,20
1746532537073,MGT 45,A00,890314,Pecore; Joseph P.,47,0,98,51
1746532538101,MGT 71,A00,890315,Staff,0,11,98,98
1746532539127,MGT 100,A00,890316,Yavorsky; Daniel Ryan,44,0,98,54
1746532540153,MGT 103,A00,890317,Ehrich; Kristine R,73,0,98,25
1746532541182,MGT 105,A00,890356,Bates; Kenneth Walter,0,7,98,98
1746532542211,MGT 112,A00,890360,Ehrich; Kristine R,55,0,98,43
1746532543241,MGT 127R,A00,907732,Zhu; Kevin Xiaoguo,23,0,98,75
1746532544268,MGT 131B,A00,890361,Anderson; John Charles,61,0,98,37
1746532545296,MGT 137,A00,890362,Lindenberger; Wade Douglas,65,0,98,33
1746532546323,MGT 160,A00,890369,Johnson; Erik Barry,9,0,98,89
1746532548378,MGT 164,A00,890372,Zimmermann; Carsten,0,39,98,98
1746532549404,MGT 180,A00,890374,Bliss; Barbara Ann,12,0,98,86
1746532550433,MMW 15,A01,886414,Chang; Edmond Yi-Teh,0,12,28,28
1746532550433,MMW 15,A02,886415,Chang; Edmond Yi-Teh,0,8,28,28
1746532550433,MMW 15,A03,886416,Chang; Edmond Yi-Teh,0,8,28,28
1746532550433,MMW 15,A04,886417,Chang; Edmond Yi-Teh,0,8,28,28
1746532550433,MMW 15,B01,886419,Chang; Edmond Yi-Teh,0,7,28,28
1746532550433,MMW 15,B02,886420,Chang; Edmond Yi-Teh,0,8,28,28
1746532550433,MMW 15,B03,886421,Chang; Edmond Yi-Teh,0,7,28,28
1746532550433,MMW 15,B04,886422,Chang; Edmond Yi-Teh,0,8,28,28
1746532550433,MMW 15,C01,886424,Staff,0,9,28,28
1746532550433,MMW 15,C02,886425,Staff,0,8,28,28
1746532550433,MMW 15,C03,886426,Staff,0,8,28,28
1746532550433,MMW 15,C04,886427,Staff,0,7,28,28
1746532550433,MMW 15,C05,958038,Staff,0,7,28,28
1746532550433,MMW 15,C06,958039,Staff,0,8,28,28
1746532551460,MMW 15GS,A00,906910,Patterson; Patrick H.,4,0,28,24
1746532552491,MMW 122R,A01,886429,Rahimi; Babak,0,13,28,28
1746532552491,MMW 122R,A02,886430,Rahimi; Babak,0,12,28,28
1746532552491,MMW 122R,A03,958040,Rahimi; Babak,0,11,28,28
1746532553519,MUS 1A,A01,890937,Staff,3,0,25,22
1746532553519,MUS 1A,A02,891035,Staff,6,0,25,19
1746532553519,MUS 1A,C01,958912,Staff,24,0,25,1
1746532553519,MUS 1A,C02,958913,Staff,25,0,25,0
1746532555573,MUS 2AK,A00,957092,Ohnishi; Takae,15,0,15,0
1746532556602,MUS 4,A01,891044,Staff,2,0,25,23
1746532556602,MUS 4,A02,891045,Staff,23,0,25,2
1746532556602,MUS 4,B01,891048,Staff,17,0,25,8
1746532556602,MUS 4,B02,891050,Staff,25,0,25,0
1746532557632,MUS 5,A01,957506,Dubnov; Shlomo,0,0,25,25
1746532557632,MUS 5,A02,957622,Dubnov; Shlomo,14,0,25,11
1746532557632,MUS 5,A03,957623,Dubnov; Shlomo,20,0,25,5
1746532558662,MUS 6,A01,891053,Freitas Caetano; Marcelo,24,0,25,1
1746532558662,MUS 6,A02,891054,Freitas Caetano; Marcelo,23,0,25,2
1746532559691,MUS 7,A01,891081,Staff,0,0,25,25
1746532559691,MUS 7,A02,891082,Staff,4,0,25,21
1746532560719,MUS 8GS,A00,891118,Borgo; David Garcia,0,0,25,25
1746532561745,MUS 11,A01,891140,Staff,11,0,25,14
1746532561745,MUS 11,A02,891141,Staff,22,0,25,3
1746532562776,MUS 13,A01,891143,Staff,8,0,25,17
1746532562776,MUS 13,A02,891144,Staff,24,0,25,1
1746532563810,MUS 15,A01,891146,Staff,9,0,25,16
1746532563810,MUS 15,A02,891148,Staff,21,0,25,4
1746532563810,MUS 15,B01,891150,Staff,18,0,25,7
1746532563810,MUS 15,B02,891151,Staff,25,0,25,0
1746532564837,MUS 20,A01,891153,Staff,5,0,20,15
1746532564837,MUS 20,A02,891155,Staff,14,0,20,6
1746532565862,MUS 80,A00,891156,Staff,19,0,25,6
1746532565862,MUS 80,B00,891157,Staff,23,0,25,2
1746532566886,MUS 130,A00,891158,Ohnishi; Takae,35,0,35,0
1746532567913,MUS 150GS,A01,891160,Borgo; David Garcia,0,0,25,25
1746532568943,MUS 170,A01,891162,Freitas Caetano; Marcelo,20,0,25,5
1746532568943,MUS 170,A02,891164,Freitas Caetano; Marcelo,21,0,25,4
1746532569975,NANO 11,A00,886220,Vazquez Mena; Oscar,13,0,15,2
1746532571001,NANO 15,A01,886222,Drews; Aaron,4,0,7,3
1746532572026,NANO 104,A00,886224,Sirbuly; Donald,18,0,25,7
1746532573052,PH 40,A00,886528,Staff,23,0,40,17
1746532574085,PH 45,A01,886799,Staff,35,0,40,5
1746532575109,PH 110,A00,886802,Staff,0,7,40,40
1746532576137,PH 172,A00,906716,Staff,19,0,35,16
1746532577167,PH 191,A00,886803,Staff,6,0,40,34
1746532578193,PHIL 1,A00,889500,Staff,19,0,30,11
1746532579224,PHIL 10,A01,889549,Grush; Rick Scott,15,0,22,7
1746532579224,PHIL 10,A02,889551,Grush; Rick Scott,22,0,22,0
1746532580252,PHIL 28,A01,889559,Lamey; Andy M.,0,1,31,31
1746532580252,PHIL 28,A02,889561,Lamey; Andy M.,0,1,30,30
1746532580252,PHIL 28,A03,889572,Lamey; Andy M.,0,0,30,30
1746532581277,PHIL 35,A00,907839,Staff,13,0,15,2
1746532582304,PHIL 60,A00,889574,Staff,74,0,90,16
1746532583330,PHIL 101,A00,958004,Staff,13,0,15,2
1746532585381,PHIL 136,A00,889582,Fulkerson; Matthew Todd,26,0,45,19
1746532586412,PHIL 163,A01,889601,Staff,21,0,30,9
1746532586412,PHIL 163,B01,889606,Brandt; Reuven A,0,3,0,0
1746532587441,PHIL 164,A00,889610,Staff,16,0,30,14
1746532588470,PHIL 165,A00,889613,Staff,23,0,30,7
1746532589495,PHYS 1A,A00,886431,Staff,26,0,70,44
1746532590523,PHYS 1AL,001,886432,Tsai; Philbert S,0,2,30,30
1746532590523,PHYS 1AL,002,886436,Tsai; Philbert S,11,0,30,19
1746532591550,PHYS 1B,A00,886439,Staff,185,0,240,55
1746532592581,PHYS 1BL,001,886441,Tsai; Philbert S,0,4,30,30
1746532592581,PHYS 1BL,002,886444,Tsai; Philbert S,2,0,30,28
1746532593608,PHYS 1C,A00,896092,Arnold; Kam S,78,0,146,68
1746532594636,PHYS 1CL,001,886448,Tsai; Philbert S,0,0,30,30
1746532594636,PHYS 1CL,002,886449,Tsai; Philbert S,0,0,30,30
1746532594636,PHYS 1CL,003,886450,Tsai; Philbert S,15,0,30,15
1746532594636,PHYS 1CL,004,886451,Tsai; Philbert S,15,0,30,15
1746532595663,PHYS 2B,A01,886457,Staff,69,0,115,46
1746532596692,PHYS 2C,A01,886460,Shotwell; Brian,0,8,65,65
1746532597723,PHYS 2CL,A01,886467,Staff,0,4,28,28
1746532597723,PHYS 2CL,A02,886468,Staff,0,3,28,28
1746532598752,PHYS 2D,A01,886470,Staff,10,0,50,40
1746532599780,PHYS 4B,A01,886475,Grinstein; Benjamin,22,0,40,18
1746532600810,POLI 5,A00,891173,Desposato; Scott,7,0,25,18
1746532601838,POLI 5D,A01,891175,Staff,5,0,5,0
1746532601838,POLI 5D,B01,891178,Staff,5,0,5,0
1746532602865,POLI 11,A00,891179,Ferree; Karen E,2,0,35,33
1746532603891,POLI 12,A00,891180,Staff,16,0,30,14
1746532604916,POLI 27,A01,891182,Staff,12,0,75,63
1746532605945,POLI 30,A00,891183,Staff,9,0,50,41
1746532606971,POLI 100B,A00,891244,Staff,5,1,35,30
1746532608001,POLI 100I,A00,891247,Staff,7,0,30,23
1746532609027,POLI 104J,A00,891248,Nichter; Maysa,14,0,30,16
1746532610059,POLI 104U,A00,891250,Nichter; Maysa,2,0,30,28
1746532612114,POLI 110B,A00,891255,Wiens; David,20,0,25,5
1746532613140,POLI 112A,A00,891256,Wiens; David,6,0,25,19
1746532614168,POLI 114BR,A00,891261,Staff,19,0,30,11
1746532615193,POLI 117R,A00,891262,Forman; Fonna,0,6,50,50
1746532616222,POLI 118,A00,891264,Ingham; Sean,17,0,25,8
1746532617248,POLI 124A,A00,891265,Staff,18,0,20,2
1746532618274,POLI 125D,A00,891266,Nichter; Simeon C,2,0,25,23
1746532619303,POLI 126,A00,891268,Nichter; Simeon C,7,0,25,18
1746532620331,POLI 126AA,A00,891272,Staff,18,0,25,7
1746532621355,POLI 130AA,A00,891273,Staff,15,0,20,5
1746532622382,POLI 134AA,A00,891274,Staff,4,0,20,16
1746532624435,POLI 138,A00,891278,Staff,21,0,25,4
1746532625459,POLI 142K,A00,891280,Staff,11,0,25,14
1746532626486,POLI 142M,A00,891281,Gartzke; Erik,17,0,30,13
1746532627512,POLI 142P,A00,891284,Staff,20,0,30,10
1746532628537,POLI 143,A00,891285,Gartzke; Erik,12,0,30,18
1746532629563,POLI 153,A00,891286,Staff,19,0,20,1
1746532631617,POLI 175,A00,891290,Staff,15,0,20,5
1746532632647,PSYC 1,A00,890674,Steiner; Eric Tomas,0,11,45,45
1746532633674,PSYC 2,A00,890676,Albright; Thomas D,21,0,35,14
1746532634699,PSYC 3,A00,890679,Staff,17,0,20,3
1746532635727,PSYC 6,A00,959858,Staff,20,0,20,0
1746532636754,PSYC 60,A01,890684,Rickard; Timothy C.,0,5,45,45
1746532637780,PSYC 70,A01,890689,Geller; Emma Harlan,7,0,30,23
1746532638808,PSYC 71,A01,959860,Staff,21,0,25,4
1746532639833,PSYC 100,A00,890690,Lacefield; Katharine I,0,50,180,180
1746532640863,PSYC 102,A00,890695,Staff,18,0,40,22
1746532641889,PSYC 105,A00,890699,Geller; Emma Harlan,71,0,100,29
1746532642919,PSYC 106,A00,890701,Gorman; Michael R.,5,0,30,25
1746532643945,PSYC 108,A00,890704,Adrian; Julia Anna,0,28,50,50
1746532644973,PSYC 118,A01,890712,Staff,11,0,30,19
1746532645997,PSYC 124,A00,890716,Chapman; Eddie Nathaniel,25,0,60,35
1746532647026,PSYC 131,A00,890717,Anagnostaras; Stephan,0,7,80,80
1746532648054,PSYC 137,A00,890719,Winkielman; Piotr,0,11,30,30
1746532649081,PSYC 144,A00,890721,Adrian; Julia Anna,0,9,45,45
1746532650108,PSYC 162,A00,890805,Staff,2,0,75,73
1746532651139,PSYC 169,A00,890810,Staff,0,15,30,30
1746532652169,PSYC 172,A00,890814,Gorman; Michael R.,9,0,30,21
1746532653193,PSYC 181,A00,890818,Anagnostaras; Stephan,8,0,200,192
1746532654217,PSYC 184,A00,959861,Staff,170,0,175,5
1746532655245,PSYC 189,A00,890823,Staff,0,1,30,30
1746532656274,PSYC 191,A00,890884,Rickard; Timothy C.,0,11,35,35
1746532657299,PSYC 193,A00,890913,Staff,19,0,30,11
1746532657299,PSYC 193,B00,890914,Chapman; Eddie Nathaniel,24,0,30,6
1746532658330,PSYC 193L,A01,890918,Lowe; Angela Beth,20,0,30,10
1746532658330,PSYC 193L,B01,890921,Hurwitz; Ethan Scott,20,0,30,10
1746532658330,PSYC 193L,C01,890928,Staff,30,0,30,0
1746532659359,RELI 149,A00,886806,Rahimi; Babak,23,0,40,17
1746532660385,SE 9,A01,886814,Staff,7,0,20,13
1746532661417,SE 101B,A01,886816,Chadha; Mayank,4,0,35,31
1746532662444,SE 110B,A00,886818,Zhu; Qiang,4,0,75,71
1746532663472,SE 125,A01,886830,Staff,10,0,30,20
1746532664502,SE 130B,A01,886835,Staff,14,0,40,26
1746532665528,SE 131A,A01,886838,Krysl; Petr,34,0,55,21
1746532666553,SE 154,A00,886840,Staff,30,0,50,20
1746532667581,SE 164GS,A01,886849,Staff,6,0,20,14
1746532668607,SE 167GS,A01,886853,Staff,6,0,20,14
1746532669633,SIO 25,A01,890107,Staff,19,0,30,11
1746532670663,SIO 45,A00,890109,Cook; Geoffrey W,117,0,200,83
1746532671689,SIO 109R,A00,890110,Forman; Fonna,0,16,20,20
1746532672719,SIO 187,A01,890114,Kacev; David,15,0,40,25
1746532673748,SOCI 1,A01,890431,Thorpe; Charles Robert,15,0,30,15
1746532673748,SOCI 1,A02,890518,Thorpe; Charles Robert,30,0,30,0
1746532674776,SOCI 2,A01,957978,Staff,25,0,25,0
1746532674776,SOCI 2,A02,957979,Staff,23,0,25,2
1746532675803,SOCI 20,A01,890523,Calderon-Zaks; Michael Aar,23,0,30,7
1746532675803,SOCI 20,A02,890526,Calderon-Zaks; Michael Aar,29,0,30,1
1746532676834,SOCI 30,A01,890533,Pardo Guerra; Juan Pablo,37,0,40,3
1746532677864,SOCI 40,A01,890535,Staff,27,0,45,18
1746532678891,SOCI 104Q,A00,890559,Staff,18,0,30,12
1746532679921,SOCI 106,A00,890560,Arnal; Maud Marie Leonie,20,0,30,10
1746532680951,SOCI 110,A00,890567,Holkenbrink-Monk; Charlene,19,0,30,11
1746532681975,SOCI 112,A00,890568,Victoria Torres; Pablo,1,0,55,54
1746532683002,SOCI 115,A00,890597,Arnal; Maud Marie Leonie,28,0,45,17
1746532685055,SOCI 121,A00,890604,Pardo Guerra; Juan Pablo,38,0,45,7
1746532686082,SOCI 126,A01,890608,Staff,8,0,10,2
1746532687110,SOCI 127,A00,890609,Staff,18,0,30,12
1746532688138,SOCI 131,A00,890610,Thorpe; Charles Robert,37,0,45,8
1746532689167,SOCI 135,A00,890615,Payne; Christine Anna,14,0,45,31
1746532690192,SOCI 139,A00,890620,Staff,38,0,45,7
1746532691219,SOCI 148E,A00,890622,Calderon-Zaks; Michael Aar,36,0,45,9
1746532692244,SOCI 150,A00,890623,Kohler; Kristopher M.,31,0,45,14
1746532693273,SOCI 157,A00,890625,Jules-Rosette; Bennetta W.,18,0,20,2
1746532694298,SOCI 160,A00,890627,Payne; Christine Anna,21,0,45,24
1746532695325,SYN 1,A00,886855,Fish; Gwendolyn Anne,0,0,0,0
1746532695325,SYN 1,B00,906086,Fish; Gwendolyn Anne,0,1,0,2
1746532696355,SYN 2R,A00,886860,Staff,0,17,15,15
1746532696355,SYN 2R,B00,906106,Atkinson; Arthur Laird,0,16,15,15
1746532697394,SYN 100,A01,886866,Browne; Emily,0,28,20,20
1746532697394,SYN 100,B01,906128,Rock; Martin,0,5,20,20
1746532697394,SYN 100,C01,906140,Deavenport; James Cary,0,3,20,20
1746532697394,SYN 100,D01,907816,Deavenport; James Cary,0,5,20,20
1746532698419,TDAC 1,A00,890286,Walsh; Kim C.,9,0,20,11
1746532699444,TDAC 101,A00,890296,Basso; Beatrice,16,0,20,4
1746532700470,TDDE 131,A00,890297,Staff,47,0,50,3
1746532701498,TDDM 1,A00,890287,Weinberg; Sadie,25,0,30,5
1746532702528,TDGE 11,A00,890288,Fulton; Julia,137,0,200,63
1746532702528,TDGE 11,B00,890289,Castro; Robert Jess,184,0,200,16
1746532703558,TDGE 25,B00,957359,Walsh; Kim C.,3,0,20,17
1746532704585,TDGE 40,A01,890292,Power; Jade Yukana,27,0,30,3
1746532705611,TDGE 124,A00,890298,Havis; Allan,0,0,50,50
1746532706636,TDGE 131R,A00,890299,Burelle; Julie Sara Veronique,15,0,42,27
1746532707677,TDHT 101,A00,890300,Staff,10,0,20,10
1746532708702,TDHT 109,A01,890302,Anderson; Mysia Anyse,31,0,40,9
1746532709731,TDMV 1,A00,890293,Arcidiacono; Kristin,18,0,30,12
1746532710760,TDMV 2,A00,890294,Weinberg; Sadie,23,0,30,7
1746532711785,TDMV 3,A00,957878,Arcidiacono; Kristin,28,0,30,2
1746532713838,TDMV 138,A00,890304,Jun; Grace Shin Hae,25,0,40,15
1746532714867,TDMV 140,A00,890305,Corrales; Joseph Bernales,25,0,30,5
1746532715892,TDMV 142,A00,890307,Caligagan; Tony,32,0,40,8
1746532716922,TDMV 144,A00,890308,Camaya; Michelle Ann,25,0,30,5
1746532717947,TDPW 1,A00,890295,Stein; Deborah Isobel,3,0,20,17
1746532718971,USP 2,A01,890272,Lerner; Amy M,6,0,20,14
1746532720004,USP 3,A01,890274,Staff,12,0,30,18
1746532721031,USP 15,A01,890276,Sun; Feiyang,17,0,30,13
1746532722059,USP 25,A00,890277,Shenkman; Michael Thomas,19,0,25,6
1746532723086,USP 138,A00,890278,Staff,13,0,25,12
1746532724111,USP 143,A00,890279,Staff,21,0,70,49
1746532725137,USP 144,A00,890280,Chowdhury; Muhammed Zohir,16,0,30,14
1746532726165,USP 150,A00,890281,Boomhower; Matthew Charles,4,0,30,26
1746532727194,USP 151,A00,890282,Staff,16,0,20,4
1746532728222,USP 162,A00,890283,Andrews; Abigail Leslie,16,0,20,4
1746532729247,USP 168,A00,920477,Kwak; Nancy,1,0,5,4
1746532730275,USP 181,A00,890284,Staff,3,0,20,17
1746532731305,USP 191A,A00,890285,Staff,13,0,20,7
1746532732333,VIS 101,A00,886512,Staff,25,0,75,50
1746532733362,VIS 103,A00,886513,Cruz; Edwin Teddy,61,0,75,14
1746532734389,VIS 108,A00,886514,Staff,3,0,15,12
1746532735414,VIS 127P,A00,886515,Shen; Kuiyi,80,0,146,66
1746532736444,VIS 149,A00,886516,Yoldas; Pinar,0,0,15,15
1746532737473,VIS 164,A00,886526,Erdmann; Dean,19,0,22,3
1746532738503,VIS 194S,A00,886527,Staff,61,0,75,14
1746532739532,WCWP 10A,C00,886484,Martiniuk; Jill,12,0,15,3
1746532740566,WCWP 10B,A00,886490,Uriarte; Emma,0,0,15,15
1746532740566,WCWP 10B,B00,886491,Dhir; Simrita,11,0,15,4
1746532740566,WCWP 10B,C00,886492,Ornelas; Tricia,0,0,15,15
1746532741592,WCWP 100,A00,886494,Young; Mark T,0,7,15,15
1746532743692,AAS 10,A01,886199,Childs; Dennis R.,0,3,0,0
1746532744718,ANAR 104,A01,886940,Shtienberg; Gilad,27,0,30,3
1746532745746,ANAR 120,A00,886953,Staff,12,0,20,8
1746532746775,ANBI 148,A01,886955,Wilder; Linnea Lorene,30,0,40,10
1746532748828,ANSC 122,A00,886957,Staff,25,0,30,5
1746532749857,ANSC 150,A00,886958,Sloane; Julia Kathryn,3,0,15,12
1746532750883,ANSC 156,A00,886959,Jenkins; Janis A.,0,1,15,15
1746532751910,ANSC 180,A00,886960,Staff,11,0,17,6
1746532752942,ANSC 188,A00,886961,Jassal; Aftab,9,0,25,16
1746532753972,ANSC 190,A00,886962,Jassal; Aftab,14,0,25,11
1746532755002,ANSC 191,A00,886963,Staff,18,0,20,2
1746532756030,ANTH 3,A01,891689,Staff,17,0,20,3
1746532757060,ANTH 5,A00,886933,Semendeferi; Ekaterini,16,0,20,4
1746532758091,ANTH 10,A00,886934,Staff,0,12,30,30
1746532759120,ANTH 21,A01,886936,Staff,40,0,60,20
1746532760149,ANTH 23,A01,886938,Staff,92,0,100,8
1746532761174,ANTH 105,A00,886964,Stewart; Alexander B,84,0,100,16
1746532762200,ANTH 108,A00,886965,Pedersen; David,9,0,20,11
1746532763234,AWP 10,001,886147,Staff,0,0,0,0
1746532763234,AWP 10,002,886148,Staff,0,0,0,0
1746532763234,AWP 10,003,886149,Staff,0,0,0,0
1746532763234,AWP 10,004,886150,Staff,0,0,0,0
1746532763234,AWP 10,005,886151,Staff,0,0,0,0
1746532763234,AWP 10,006,886152,Staff,0,0,0,0
1746532763234,AWP 10,007,886153,Staff,0,0,0,0
1746532763234,AWP 10,008,886154,Staff,0,0,0,0
1746532763234,AWP 10,009,886155,Staff,0,0,0,0
1746532763234,AWP 10,010,886156,Staff,0,0,0,0
1746532763234,AWP 10,011,886158,Staff,0,0,0,0
1746532763234,AWP 10,012,886160,Staff,0,0,0,0
1746532763234,AWP 10,013,886161,Staff,0,0,0,0
1746532763234,AWP 10,014,886162,Staff,0,0,0,0
1746532763234,AWP 10,015,886163,Staff,0,0,0,0
1746532763234,AWP 10,016,886164,Staff,0,0,0,0
1746532763234,AWP 10,017,886165,Staff,0,0,0,0
1746532763234,AWP 10,018,886166,Staff,0,0,0,0
1746532763234,AWP 10,019,886168,Staff,0,0,0,0
1746532763234,AWP 10,020,886170,Staff,0,0,0,0
1746532763234,AWP 10,021,886172,Staff,0,0,0,0
1746532764259,AWP 10R,001,886173,Staff,0,1,0,0
1746532764259,AWP 10R,002,886174,Staff,0,1,0,0
1746532764259,AWP 10R,003,886175,Staff,0,0,0,0
1746532764259,AWP 10R,004,886176,Staff,0,0,0,0
1746532764259,AWP 10R,005,886177,Staff,0,0,0,0
1746532764259,AWP 10R,006,886178,Staff,0,0,0,0
1746532764259,AWP 10R,007,886179,Staff,0,0,0,0
1746532764259,AWP 10R,008,886181,Staff,0,0,0,0
1746532764259,AWP 10R,009,886182,Staff,0,0,0,0
1746532764259,AWP 10R,010,886183,Staff,0,0,0,0
1746532764259,AWP 10R,011,886184,Staff,0,0,0,0
1746532764259,AWP 10R,012,886185,Staff,0,0,0,0
1746532764259,AWP 10R,013,886186,Staff,0,0,0,0
1746532764259,AWP 10R,014,886187,Staff,0,0,0,0
1746532764259,AWP 10R,015,886188,Staff,0,0,0,0
1746532764259,AWP 10R,016,886189,Staff,0,0,0,0
1746532765285,AWP 102R,A00,886190,Staff,0,0,0,0
1746532765285,AWP 102R,B00,886191,Staff,0,0,0,0
1746532766313,BENG 100,A01,886193,Staff,17,0,30,13
1746532767340,BENG 122A,A01,886195,Hasty; Jeff M,13,0,30,17
1746532768368,BENG 166A,A00,886196,Sah; Robert Lie-Yuan,0,1,30,30
1746532769396,BENG 190,A00,958050,Khojah; Reem I,24,0,25,1
1746532770421,BIBC 102,A01,894320,Staff,0,0,46,46
1746532770421,BIBC 102,A02,894321,Staff,1,0,46,45
1746532770421,BIBC 102,A03,894344,Staff,7,0,46,39
1746532770421,BIBC 102,A04,894345,Staff,26,0,47,21
1746532771447,BICD 100R,A01,894365,Smith; Laurie,0,3,58,58
1746532771447,BICD 100R,A02,894366,Smith; Laurie,0,5,58,58
1746532771447,BICD 100R,A03,894367,Smith; Laurie,2,0,59,57
1746532771447,BICD 100R,A04,959869,Smith; Laurie,41,0,59,18
1746532772477,BICD 136,A01,894383,Gustafson-Brown; Cindy,14,0,50,36
1746532773508,BIEB 102,A01,894494,Butler; Shannon Rhey,51,0,130,79
1746532775564,BIEB 150,A01,894617,Wills; Christopher,3,0,20,17
1746532775564,BIEB 150,A02,894631,Wills; Christopher,3,0,20,17
1746532775564,BIEB 150,A03,894937,Wills; Christopher,4,0,20,16
1746532775564,BIEB 150,A04,894946,Wills; Christopher,5,0,20,15
1746532776589,BIEB 194,A00,906141,Kurle; Carolyn M.,6,0,20,14
1746532777619,BILD 1,A01,894154,Staff,2,0,19,17
1746532777619,BILD 1,A02,894155,Staff,14,0,19,5
1746532777619,BILD 1,A03,894160,Staff,13,0,19,6
1746532777619,BILD 1,A04,894161,Staff,15,0,18,3
1746532778646,BILD 2,A01,894168,Staff,0,0,50,50
1746532778646,BILD 2,A02,894169,Staff,0,0,50,50
1746532778646,BILD 2,A03,894179,Staff,4,0,50,46
1746532778646,BILD 2,A04,894203,Staff,27,0,50,23
1746532779673,BILD 3,A01,894213,Staff,22,0,31,9
1746532779673,BILD 3,A02,894214,Staff,26,0,31,5
1746532779673,BILD 3,A03,894235,Staff,28,0,31,3
1746532779673,BILD 3,A04,894236,Staff,28,0,32,4
1746532780699,BILD 4,A01,894253,Reuther; Keefe,5,0,24,19
1746532780699,BILD 4,A02,894258,Reuther; Keefe,16,0,24,8
1746532781726,BILD 5,A01,894276,Reuther; Keefe,35,0,50,15
1746532781726,BILD 5,A02,894277,Reuther; Keefe,45,0,50,5
1746532781726,BILD 5,A03,894290,Reuther; Keefe,44,0,50,6
1746532781726,BILD 5,A04,894291,Reuther; Keefe,48,0,50,2
1746532782755,BILD 24,A01,894297,Pirino; Giorgia,40,0,60,20
1746532783785,BIMM 100,B01,958915,Staff,72,0,100,28
1746532784817,BIMM 101,A01,895017,McDonnell; Lisa Marie,0,5,24,24
1746532784817,BIMM 101,A02,895018,McDonnell; Lisa Marie,0,5,24,24
1746532784817,BIMM 101,B01,895020,McDonnell; Lisa Marie,0,6,24,24
1746532784817,BIMM 101,B02,895021,McDonnell; Lisa Marie,0,4,24,24
1746532785843,BIMM 110,A01,895023,Staff,1,0,25,24
1746532785843,BIMM 110,A02,895024,Staff,9,0,25,16
1746532785843,BIMM 110,A03,895025,Staff,18,0,25,7
1746532785843,BIMM 110,A04,895031,Staff,20,0,25,5
1746532786869,BIMM 120,A01,895114,Gustafson-Brown; Cindy,13,0,28,15
1746532786869,BIMM 120,A02,895126,Gustafson-Brown; Cindy,20,0,27,7
1746532787894,BIPN 100,A01,895130,Yang; Mingyu,1,0,38,37
1746532787894,BIPN 100,A02,895131,Yang; Mingyu,32,0,38,6
1746532787894,BIPN 100,A03,895132,Yang; Mingyu,32,0,38,6
1746532787894,BIPN 100,A04,895133,Yang; Mingyu,27,0,36,9
1746532788922,BIPN 120,A01,895135,Cooke; James Edward,0,3,13,13
1746532788922,BIPN 120,A02,895136,Cooke; James Edward,0,1,13,13
1746532788922,BIPN 120,A03,895137,Cooke; James Edward,0,3,13,13
1746532788922,BIPN 120,A04,895156,Cooke; James Edward,0,2,11,11
1746532789948,BIPN 134,A01,895235,Cooke; James Edward,0,2,25,25
1746532789948,BIPN 134,A02,895237,Cooke; James Edward,0,0,25,25
1746532789948,BIPN 134,A03,895240,Cooke; James Edward,3,0,25,22
1746532789948,BIPN 134,A04,895270,Cooke; James Edward,20,0,25,5
1746532790978,BIPN 189,A00,892103,Staff,0,13,14,14
1746532793035,BISP 194,A00,958008,Staff,0,2,0,0
1746532794066,CAT 124,A01,922009,Staff,0,5,20,20
1746532795093,CAT 125R,A00,886390,Morales; Celeste Georgianna,0,2,20,20
1746532795093,CAT 125R,B00,886391,Irwin; Matthew Joseph,0,3,20,20
1746532795093,CAT 125R,C00,886392,Smith; Lauryn Alissa,0,2,20,20
1746532795093,CAT 125R,D00,886393,Vanderschuit; Maya Alysia,0,2,20,20
1746532795093,CAT 125R,E00,886394,Marchisotto; Jennifer Anne,0,4,20,20
1746532796120,CENG 15,A01,886218,Drews; Aaron,3,0,8,5
1746532797146,CENG 113,A00,886219,Opatkiewicz; Justin Paul,15,0,25,10
1746532798172,CGS 101,A00,887044,Staff,7,0,20,13
1746532799202,CGS 105,A01,887046,Staff,14,0,25,11
1746532800230,CGS 112,A00,887047,Cuong; Marisol,12,0,15,3
1746532801256,CGS 113,A00,887048,Staff,23,0,30,7
1746532802280,CGS 120,A00,887049,Staff,10,0,17,7
1746532803306,CHEM 6A,A01,886336,Lam; Tin Yiu,38,0,50,12
1746532803306,CHEM 6A,A02,886338,Lam; Tin Yiu,37,0,50,13
1746532804331,CHEM 6B,A01,886341,Hopkins; Patrycja Anna,16,0,50,34
1746532804331,CHEM 6B,A02,886343,Hopkins; Patrycja Anna,42,0,50,8
1746532805358,CHEM 6C,A01,886346,Albizati; Kim F.,0,2,50,50
1746532805358,CHEM 6C,A02,886348,Albizati; Kim F.,23,0,50,27
1746532806385,CHEM 40A,A01,886352,Klosterman; Jeremy K,65,0,100,35
1746532807414,CHEM 40B,A01,886356,Klosterman; Jeremy K,0,23,100,100
1746532808440,CHEM 41B,A01,886360,Theodorakis; Emmanuel,25,0,50,25
1746532808440,CHEM 41B,A02,886362,Theodorakis; Emmanuel,47,0,50,3
1746532809466,CHIN 165A,A00,886382,Xu; Li,18,0,20,2
1746532810491,CLAS 120,A00,886387,Myerston Santana; Jacobo,33,0,40,7
1746532811518,COGS 9,A01,886967,Shannon; Kyle Michael,42,0,60,18
1746532812547,COGS 11,A01,886969,Staff,11,0,30,19
1746532813573,COGS 14A,A01,886971,Staff,6,0,60,54
1746532814604,COGS 14B,A01,886973,Hoffman; Drew Ellen,4,0,60,56
1746532815636,COGS 18,A01,886975,Morgan; Eric,35,0,60,25
1746532816665,COGS 20,A01,886977,Staff,4,0,8,4
1746532816665,COGS 20,A02,886978,Staff,5,0,7,2
1746532817690,COGS 100,A01,907783,Staff,0,2,30,30
1746532818717,COGS 101B,A01,886980,Staff,0,3,48,48
1746532819748,COGS 101C,A01,886982,Delgado; Tania,0,5,44,44
1746532820773,COGS 102A,A01,886984,Johnson; Christine M.,4,0,30,26
1746532821801,COGS 118B,A01,886986,Staff,0,3,88,88
1746532822826,COGS 150,A01,886988,Bergen; Benjamin,23,0,50,27
1746532823861,COGS 153,A00,886989,Delgado; Tania,0,2,41,41
1746532824887,COGS 186,A01,886991,Staff,0,0,32,32
1746532825916,COGS 187A,A01,886993,Boyle; Mary E. T.,7,0,30,23
1746532826944,COGS 189,A00,886994,Staff,0,1,30,30
1746532828009,COMM 10,A01,886996,Staff,0,0,20,21
1746532828009,COMM 10,A02,886997,Staff,12,0,20,8
1746532828009,COMM 10,A03,959845,Staff,19,0,20,1
1746532829035,COMM 20,A01,886999,Leuning; Grant Maurstad,24,0,40,16
1746532831087,COMM 100A,A01,887002,Staff,0,0,20,25
1746532831087,COMM 100A,A02,887003,Staff,7,0,20,13
1746532832113,COMM 100B,A01,887005,Staff,0,8,20,24
1746532833139,COMM 106D,A00,887006,Staff,14,0,40,26
1746532834165,COMM 110G,A00,887007,Whitworth-Smith; Andrew C,12,0,40,28
1746532835195,COMM 111B,A00,887008,Staff,31,0,40,9
1746532836221,COMM 113T,A00,887009,Abuelhiga; Soraya Jill,28,0,40,12
1746532836221,COMM 113T,B00,906733,Staff,40,0,40,0
1746532837248,COMM 145,A00,887010,Staff,12,0,40,28
1746532838274,COMM 146,A00,887054,Staff,31,0,40,9
1746532839302,COMM 190,A00,887012,Staff,8,0,23,15
1746532840329,CSE 8A,A50,887015,Cao; Yingjun,57,0,85,28
1746532841358,CSE 11,A01,887017,Cao; Yingjun,12,0,70,58
1746532842384,CSE 20,A01,887019,Staff,30,0,50,20
1746532843411,CSE 21,A01,887021,Staff,78,0,100,22
1746532843411,CSE 21,B01,892583,Braun; Oliver,45,0,50,5
1746532844436,CSE 30,A01,887025,Eldon; John,143,0,200,57
1746532845466,CSE 100,A01,887027,Staff,26,0,50,24
1746532845466,CSE 100,A02,887028,Staff,40,0,50,10
1746532846496,CSE 101,A01,887030,Braun; Oliver,75,0,100,25
1746532846496,CSE 101,B01,887032,Jones; Miles E,0,3,50,50
1746532846496,CSE 101,B02,887033,Jones; Miles E,0,1,50,50
1746532847526,CSE 105,A01,908084,Jones; Miles E,32,0,50,18
1746532847526,CSE 105,A02,908087,Jones; Miles E,33,0,50,17
1746532848558,CSE 135,A01,887035,Powell; Thomas Allan,0,4,50,50
1746532849583,CSE 142,A01,887037,Staff,8,0,60,52
1746532850607,CSE 142L,A01,887039,Staff,34,0,60,26
1746532851636,CSE 151A,A01,887041,Solares; Edwin A,48,0,100,52
1746532852664,CSE 175,A01,887043,Kumar; Rakesh,30,0,30,0
1746532853693,CSS 1,A01,886389,Staff,0,1,40,40
1746532854719,DSC 30,A01,908097,Liao; Soohyun Nam,47,0,75,28
1746532855745,DSC 40A,A01,908099,Shannon; Kyle Michael,30,0,50,20
1746532856771,DSC 40B,A01,908112,Staff,16,0,50,34
1746532857796,DSC 80,A01,908116,Staff,19,0,60,41
1746532858831,DSC 197,001,956863,Eldridge; Justin Matthew,9999,0,9999,0
1746532859864,ECE 5,A01,886400,Morris; Karcher William,2,0,6,4
1746532859864,ECE 5,A02,886401,Morris; Karcher William,3,0,6,3
1746532860889,ECE 148,A01,886403,Silberman; Jack,0,14,14,14
1746532861915,ECON 1,A01,887265,Crane; Meredith Helen,12,0,70,58
1746532861915,ECON 1,B01,887268,Staff,43,0,50,7
1746532862955,ECON 2,A01,887273,Crane; Meredith Helen,56,0,70,14
1746532863983,ECON 3,A01,887279,Rondina; Giacomo,32,0,70,38
1746532865009,ECON 4,A01,887282,Anderson; John Charles,0,2,10,10
1746532866036,ECON 5,A01,887285,Staff,33,0,45,12
1746532866036,ECON 5,B01,887292,Staff,41,0,45,4
1746532867063,ECON 100A,A01,887337,Newhouse; Herbert S,54,0,70,16
1746532867063,ECON 100A,B01,887349,Staff,45,0,50,5
1746532868092,ECON 100B,A01,887361,Du; Songzi,29,0,70,41
1746532869119,ECON 100C,A01,887445,Newhouse; Herbert S,59,0,70,11
1746532870150,ECON 105,A00,887488,Vespa; Emanuel Ignacio,23,0,35,12
1746532871180,ECON 109,A01,887506,Shishkin; Denis,28,0,35,7
1746532872211,ECON 110A,A01,887568,Alon; Titan Michael,0,3,35,35
1746532872211,ECON 110A,B01,907601,Alon; Titan Michael,20,0,35,15
1746532873237,ECON 110B,A01,887598,Levkoff; Steven B.,0,23,70,70
1746532874265,ECON 112,A00,887599,Rondina; Giacomo,19,0,35,16
1746532875291,ECON 120A,A01,887603,Dai; Yinlin,36,0,70,34
1746532876317,ECON 120C,A01,887608,Sun; Yixiao,0,1,35,35
1746532876317,ECON 120C,B01,887614,Sun; Yixiao,0,0,35,35
1746532877343,ECON 138,A00,887621,Bharadwaj; Prashant,0,20,20,20
1746532878368,ECON 144,A00,958007,Squires; Dale E,13,0,35,22
1746532879395,ECON 171,A01,907666,Staff,18,0,35,17
1746532880422,ECON 175,A00,887626,Wu; Pak Yeung,23,0,35,12
1746532881452,ECON 190,A00,887640,Vespa; Emanuel Ignacio,23,0,35,12
1746532882494,EDS 25,A01,888197,Staff,0,0,0,0
1746532882494,EDS 25,A02,888209,Staff,0,0,0,0
1746532882494,EDS 25,A03,888210,Staff,0,0,0,0
1746532882494,EDS 25,A04,888212,Staff,0,0,0,0
1746532882494,EDS 25,A05,888213,Staff,0,0,0,0
1746532882494,EDS 25,A06,888214,Staff,0,0,0,0
1746532882494,EDS 25,A07,888235,Staff,0,2,0,0
1746532882494,EDS 25,A08,888236,Staff,0,0,0,0
1746532882494,EDS 25,A09,888240,Staff,0,0,0,0
1746532882494,EDS 25,A10,888244,Staff,0,0,0,0
1746532882494,EDS 25,B01,888273,Staff,0,0,0,0
1746532882494,EDS 25,B02,888285,Staff,0,0,0,0
1746532882494,EDS 25,B03,888423,Staff,0,0,0,1
1746532882494,EDS 25,B04,888432,Staff,0,0,0,0
1746532882494,EDS 25,B05,888433,Staff,0,0,0,0
1746532882494,EDS 25,B06,888467,Staff,0,0,0,0
1746532882494,EDS 25,B07,888468,Staff,0,0,0,0
1746532882494,EDS 25,B08,888479,Staff,0,0,0,0
1746532882494,EDS 25,B09,888484,Staff,0,0,0,0
1746532882494,EDS 25,B10,888487,Staff,0,0,0,0
1746532883521,EDS 38,A01,907700,Choi; Bailey Miyeon,30,0,30,0
1746532884547,EDS 112,A01,888601,Chapman; Thandeka K,14,0,40,26
1746532885579,EDS 115,A00,888697,Mendez; Kathrina Mendoza,10,0,30,20
1746532886608,EDS 116,A01,888893,Staff,35,0,40,5
1746532888661,EDS 124AR,A00,889133,Staff,29,0,50,21
1746532888661,EDS 124AR,B00,907471,Simon; Elizabeth A,37,0,50,13
1746532889686,EDS 124BR,A00,889134,Simon; Elizabeth A,45,0,100,55
1746532890715,EDS 125,A00,889135,Staff,25,0,30,5
1746532891755,EDS 126,A01,889138,Staff,36,0,40,4
1746532892784,EDS 164R,A01,889142,Wishard Guerra; Alison G.,33,0,50,17
1746532893810,ENG 30,A01,886396,Staff,0,0,0,0
1746532893810,ENG 30,B01,886398,Staff,0,0,0,0
1746532894837,ENVR 102,A00,906150,Montejo; Carolina,23,0,25,2
1746532895862,ETHN 103A,A00,887236,Man; Simeon S,0,3,0,0
1746532896890,ETHN 113,A00,887239,Staff,16,0,30,14
1746532897915,ETHN 116,A00,887240,Staff,16,0,25,9
1746532898945,ETHN 117,A00,887241,Choi; Esther Min,28,0,30,2
1746532899976,ETHN 118,A00,887243,Staff,24,0,30,6
1746532901001,ETHN 127,A00,887248,Cuong; Marisol,11,0,15,4
1746532902028,ETHN 139,A00,887250,Staff,7,0,10,3
1746532903057,ETHN 142,A00,887252,Staff,10,0,30,20
1746532904086,ETHN 161,A00,887253,Browne; Errol Tsekani,24,0,30,6
1746532905111,ETHN 163FR,A00,887255,Burelle; Julie Sara Veronique,0,0,5,5
1746532906153,GLBH 20,A00,889149,Elwardani; Nile Regina,8,0,42,34
1746532908208,GLBH 111,A01,889152,Burgos; Jose L.,17,0,17,0
1746532909233,GLBH 150,A00,889181,Sloane; Julia Kathryn,0,5,15,15
1746532911285,HDS 60,A01,886406,Warstadt; Melissa Fawn,73,0,80,7
1746532912310,HIAF 111,A00,889324,Gyamfi; Bright,25,0,32,7
1746532913334,HIEA 131,A00,889328,Staff,16,0,32,16
1746532914358,HIEA 144,A00,889333,Henry; Todd A.,26,0,32,6
1746532915386,HIEA 154,A00,889336,Henry; Todd A.,24,0,32,8
1746532916414,HIEU 106,A00,889339,Staff,22,0,32,10
1746532918468,HIEU 114,A00,889340,Staff,3,0,32,29
1746532919496,HIEU 135GS,A00,889342,Patterson; Patrick H.,0,0,1,24
1746532920523,HIEU 137,A00,889343,Edington; Claire Ellen,9,0,25,16
1746532921547,HIEU 148,A00,889345,Staff,14,0,32,18
1746532922575,HIEU 154,A00,889346,Biess; Frank Peter,21,0,32,11
1746532923603,HILA 102,A00,889351,Staff,12,0,32,20
1746532924632,HILD 2A,A01,889221,Lewandoski; Julia Mavis,1,10,32,31
1746532925659,HILD 7B,A01,889225,Man; Simeon S,0,13,32,32
1746532926687,HILD 7C,A01,889288,Alvarez; Luis A,0,14,32,32
1746532927715,HILD 30,A01,889323,Staff,0,5,32,32
1746532929771,HISC 119,A00,889383,Golan; Tal,21,0,32,11
1746532930799,HIUS 103,A00,889384,Man; Simeon S,0,0,32,32
1746532931825,HIUS 117,A00,919797,Kwak; Nancy,18,0,32,14
1746532932851,HIUS 142A,A00,919788,Staff,22,0,32,10
1746532934907,HIUS 149,A00,889386,Gyamfi; Bright,27,0,32,5
1746532935932,HIUS 155,A00,889387,Alvarez; Luis A,14,0,32,18
1746532936960,HUM 3,A01,886499,Caldwell; Michael Alan,19,0,50,31
1746532937988,HUM 3GS,A00,886500,Rodriguez; Bretton Sigfred,0,0,0,28
1746532939014,HUM 3R,A01,886502,Markman; Kristina,0,36,50,50
1746532940042,HUM 4,A01,886504,Crum; Matthew Stephen,24,0,50,26
1746532940042,HUM 4,B01,886506,West; Geoffrey Scott,17,0,50,33
1746532941068,HUM 4GS,A00,886507,Staff,0,0,0,19
1746532942093,HUM 5,A01,886509,Staff,32,0,50,18
1746532943120,HUM 5R,A01,886511,Zavodny; Tatiana Sophia,0,39,50,50
1746532944148,JAPN 180,A00,886407,Staff,18,0,40,22
1746532945177,LATI 50,A01,886409,Martin-Cabrera; Luis,4,0,22,18
1746532945177,LATI 50,A02,886410,Martin-Cabrera; Luis,19,0,22,3
1746532945177,LATI 50,A03,886411,Martin-Cabrera; Luis,21,0,22,1
1746532945177,LATI 50,A04,886412,Martin-Cabrera; Luis,9,0,22,13
1746532946204,LAWS 101,A00,907664,Staff,28,0,60,32
1746532947231,LIAB 1A,A00,889388,Saab; Dima,17,0,20,3
1746532948257,LIAB 1AX,A00,889389,El Cheddadi; Youniss,17,0,20,3
1746532949284,LIFR 1C,A00,889391,Van Moer; Vinciane G,8,0,20,12
1746532950313,LIFR 1CX,A00,889392,Van Moer; Vinciane G,7,0,20,13
1746532951341,LIFR 1D,A00,889393,Van Moer; Vinciane G,7,0,20,13
1746532952371,LIFR 1DX,A00,889394,Van Moer; Vinciane G,8,0,20,12
1746532953402,LIGN 7,A00,886923,Staff,24,0,50,26
1746532954427,LIGN 17,A00,886924,Kehler; Andrew Scott,125,0,150,25
1746532955454,LTAM 110,A00,889395,Staff,15,0,30,15
1746532956481,LTAM 110GS,A00,958010,Rodriguez; Bretton Sigfred,0,0,0,28
1746532957505,LTCH 101,A00,889397,Staff,23,0,25,2
1746532958533,LTCS 130,A00,889398,Staff,23,0,25,2
1746532959558,LTEA 138,A00,889399,Staff,24,0,40,16
1746532960585,LTEN 149,A00,889400,Wesling; Megan E.,0,3,25,25
1746532961610,LTEN 169,A00,889401,Staff,20,0,25,5
1746532962636,LTEN 180,A00,889402,Staff,10,0,15,5
1746532963666,LTEN 181,A00,889403,Staff,21,0,25,4
1746532964694,LTWL 100,A00,889404,Myerston Santana; Jacobo,3,0,25,22
1746532965722,LTWL 180GS,A00,889405,Staff,0,0,20,20
1746532966752,LTWL 181,A00,889406,Staff,17,0,25,8
1746532967776,LTWL 184,A00,889475,Mukherjee; Silpa,22,0,25,3
1746532968803,LTWR 102C,A00,889486,Staff,29,0,30,1
1746532969831,LTWR 115W,A00,889491,Staff,0,2,15,15
1746532970862,MAE 8,A01,886905,Staff,0,2,0,0
1746532971889,MAE 11,A00,886906,Bandaru; Prabhakar,0,7,50,50
1746532972916,MAE 20,A00,886907,Evdokimenko; Ekaterina,44,0,70,26
1746532973944,MAE 30B,A00,886909,Ghazinejad; Maziar,26,0,45,19
1746532974985,MAE 101B,A00,886910,Saintillan; David,29,0,45,16
1746532976012,MAE 105,A00,886911,Bandaru; Prabhakar,18,0,50,32
1746532977043,MAE 107,B00,958024,Staff,9,0,50,41
1746532978068,MAE 143B,A00,886913,Bewley; Thomas R,7,0,40,33
1746532979095,MAE 148,A01,886915,Silberman; Jack,0,3,14,14
1746532980123,MAE 160,A00,886916,Evdokimenko; Ekaterina,31,0,60,29
1746532981154,MATH 3C,A01,889681,Staff,0,3,30,30
1746532981154,MATH 3C,A02,960048,Staff,25,0,30,5
1746532982181,MATH 10A,A01,889760,Staff,26,0,30,4
1746532982181,MATH 10A,A02,889783,Staff,29,0,30,1
1746532983216,MATH 10B,A01,889785,Verstraete; Jacques Allan,2,0,35,33
1746532983216,MATH 10B,A02,889795,Verstraete; Jacques Allan,4,0,35,31
1746532983216,MATH 10B,B01,889797,Verstraete; Jacques Allan,3,0,35,32
1746532983216,MATH 10B,B02,889828,Verstraete; Jacques Allan,3,0,35,32
1746532984252,MATH 10C,A01,889849,Habib; Yousaf,9,0,30,21
1746532984252,MATH 10C,A02,889852,Habib; Yousaf,14,0,30,16
1746532984252,MATH 10C,A03,889853,Habib; Yousaf,22,0,30,8
1746532984252,MATH 10C,A04,889858,Habib; Yousaf,20,0,30,10
1746532984252,MATH 10C,B01,889861,Staff,1,0,30,29
1746532984252,MATH 10C,B02,889862,Staff,24,0,30,6
1746532984252,MATH 10C,B03,889863,Staff,27,0,30,3
1746532984252,MATH 10C,B04,889967,Staff,23,0,30,7
1746532985278,MATH 18,A01,889974,Staff,7,0,30,23
1746532985278,MATH 18,A02,889977,Staff,20,0,30,10
1746532985278,MATH 18,B01,889984,Hardiman; Liam,22,0,30,8
1746532985278,MATH 18,B02,889985,Hardiman; Liam,25,0,30,5
1746532986307,MATH 20A,A01,889990,Suk; Andrew Hoon,29,0,35,6
1746532987335,MATH 20B,A01,889993,Ohm; Ko Woon,22,0,30,8
1746532987335,MATH 20B,A02,889994,Ohm; Ko Woon,30,0,30,0
1746532987335,MATH 20B,B01,889996,Ohm; Ko Woon,21,0,30,9
1746532987335,MATH 20B,B02,889997,Ohm; Ko Woon,23,0,30,7
1746532988364,MATH 20C,A01,889999,Hammock; Frances H,17,0,30,13
1746532988364,MATH 20C,A02,890003,Hammock; Frances H,23,0,30,7
1746532988364,MATH 20C,B01,890006,Hammock; Frances H,3,0,30,27
1746532988364,MATH 20C,B02,890007,Hammock; Frances H,11,0,30,19
1746532989394,MATH 20D,A01,890011,Cheng; Hsiao-Bing,1,1,30,29
1746532989394,MATH 20D,A02,890012,Cheng; Hsiao-Bing,14,0,30,16
1746532989394,MATH 20D,B01,890016,Cheng; Hsiao-Bing,13,0,30,17
1746532989394,MATH 20D,B02,890017,Cheng; Hsiao-Bing,13,0,30,17
1746532990427,MATH 20E,A01,890026,Harel; Guershon,1,0,30,29
1746532990427,MATH 20E,A02,890029,Harel; Guershon,23,0,30,7
1746532990427,MATH 20E,B01,890033,Harel; Guershon,7,0,30,23
1746532990427,MATH 20E,B02,890101,Harel; Guershon,21,0,30,9
1746532991456,MATH 102,A01,890104,Staff,17,0,30,13
1746532991456,MATH 102,A02,890105,Staff,27,0,30,3
1746532992484,MATH 103B,A01,890116,Salehi Golsefidy; Alireza,3,0,30,27
1746532992484,MATH 103B,B01,890118,Staff,0,3,34,34
1746532993513,MATH 109,A01,890121,Aliabadi Sr.; Mohsen,1,0,30,29
1746532993513,MATH 109,B01,890124,Upadrashta; Pranav Kumar,18,0,30,12
1746532994543,MATH 120A,A01,890126,Eggers; John Dietrich,13,0,30,17
1746532995570,MATH 142B,A01,890128,Ioana; Adrian,19,0,30,11
1746532995570,MATH 142B,A02,890129,Ioana; Adrian,13,0,30,17
1746532996596,MATH 154,A01,890174,Staff,0,0,30,30
1746532996596,MATH 154,A02,890182,Staff,0,0,30,30
1746532997624,MATH 168A,A01,890197,Dumitriu; Ioana,21,0,35,14
1746532998650,MATH 170A,A01,890240,Nie; Jiawang,1,0,30,29
1746532998650,MATH 170A,A02,890241,Nie; Jiawang,11,0,30,19
1746532998650,MATH 170A,A03,890249,Nie; Jiawang,23,0,30,7
1746532999680,MATH 170B,A01,957891,Nag; Panchali,13,0,35,22
1746533001737,MATH 181A,A01,908025,Staff,0,4,35,35
1746533001737,MATH 181A,A02,960115,Staff,27,0,35,8
1746533002764,MATH 181B,A01,959874,Staff,26,0,30,4
1746533003790,MATH 193B,A01,890265,Staff,0,4,35,35
1746533004822,MGT 4,A01,890311,Anderson; John Charles,42,0,88,46
1746533005852,MGT 5,A00,907740,Staff,13,0,98,85
1746533006880,MGT 12,A00,890312,Lindenberger; Wade Douglas,67,0,98,31
1746533007909,MGT 16,A00,957883,Staff,78,0,98,20
1746533009968,MGT 45,A00,890314,Pecore; Joseph P.,47,0,98,51
1746533010995,MGT 71,A00,890315,Staff,0,11,98,98
1746533012021,MGT 100,A00,890316,Yavorsky; Daniel Ryan,44,0,98,54
1746533013048,MGT 103,A00,890317,Ehrich; Kristine R,73,0,98,25
1746533014080,MGT 105,A00,890356,Bates; Kenneth Walter,0,7,98,98
1746533015109,MGT 112,A00,890360,Ehrich; Kristine R,55,0,98,43
1746533016140,MGT 127R,A00,907732,Zhu; Kevin Xiaoguo,23,0,98,75
1746533017166,MGT 131B,A00,890361,Anderson; John Charles,61,0,98,37
1746533018197,MGT 137,A00,890362,Lindenberger; Wade Douglas,65,0,98,33
1746533019226,MGT 160,A00,890369,Johnson; Erik Barry,9,0,98,89
1746533021282,MGT 164,A00,890372,Zimmermann; Carsten,0,39,98,98
1746533022313,MGT 180,A00,890374,Bliss; Barbara Ann,12,0,98,86
1746533023345,MMW 15,A01,886414,Chang; Edmond Yi-Teh,0,12,28,28
1746533023345,MMW 15,A02,886415,Chang; Edmond Yi-Teh,0,8,28,28
1746533023345,MMW 15,A03,886416,Chang; Edmond Yi-Teh,0,8,28,28
1746533023345,MMW 15,A04,886417,Chang; Edmond Yi-Teh,0,8,28,28
1746533023345,MMW 15,B01,886419,Chang; Edmond Yi-Teh,0,7,28,28
1746533023345,MMW 15,B02,886420,Chang; Edmond Yi-Teh,0,8,28,28
1746533023345,MMW 15,B03,886421,Chang; Edmond Yi-Teh,0,7,28,28
1746533023345,MMW 15,B04,886422,Chang; Edmond Yi-Teh,0,8,28,28
1746533023345,MMW 15,C01,886424,Staff,0,9,28,28
1746533023345,MMW 15,C02,886425,Staff,0,8,28,28
1746533023345,MMW 15,C03,886426,Staff,0,8,28,28
1746533023345,MMW 15,C04,886427,Staff,0,7,28,28
1746533023345,MMW 15,C05,958038,Staff,0,7,28,28
1746533023345,MMW 15,C06,958039,Staff,0,8,28,28
1746533024415,MMW 15GS,A00,906910,Patterson; Patrick H.,4,0,28,24
1746533025441,MMW 122R,A01,886429,Rahimi; Babak,0,13,28,28
1746533025441,MMW 122R,A02,886430,Rahimi; Babak,0,12,28,28
1746533025441,MMW 122R,A03,958040,Rahimi; Babak,0,11,28,28
1746533026473,MUS 1A,A01,890937,Staff,3,0,25,22
1746533026473,MUS 1A,A02,891035,Staff,6,0,25,19
1746533026473,MUS 1A,C01,958912,Staff,24,0,25,1
1746533026473,MUS 1A,C02,958913,Staff,25,0,25,0
1746533028527,MUS 2AK,A00,957092,Ohnishi; Takae,15,0,15,0
1746533029554,MUS 4,A01,891044,Staff,2,0,25,23
1746533029554,MUS 4,A02,891045,Staff,23,0,25,2
1746533029554,MUS 4,B01,891048,Staff,17,0,25,8
1746533029554,MUS 4,B02,891050,Staff,25,0,25,0
1746533030582,MUS 5,A01,957506,Dubnov; Shlomo,0,0,25,25
1746533030582,MUS 5,A02,957622,Dubnov; Shlomo,14,0,25,11
1746533030582,MUS 5,A03,957623,Dubnov; Shlomo,20,0,25,5
1746533031612,MUS 6,A01,891053,Freitas Caetano; Marcelo,24,0,25,1
1746533031612,MUS 6,A02,891054,Freitas Caetano; Marcelo,23,0,25,2
1746533032644,MUS 7,A01,891081,Staff,0,0,25,25
1746533032644,MUS 7,A02,891082,Staff,4,0,25,21
1746533033671,MUS 8GS,A00,891118,Borgo; David Garcia,0,0,25,25
1746533034697,MUS 11,A01,891140,Staff,11,0,25,14
1746533034697,MUS 11,A02,891141,Staff,22,0,25,3
1746533035727,MUS 13,A01,891143,Staff,8,0,25,17
1746533035727,MUS 13,A02,891144,Staff,24,0,25,1
1746533036753,MUS 15,A01,891146,Staff,9,0,25,16
1746533036753,MUS 15,A02,891148,Staff,21,0,25,4
1746533036753,MUS 15,B01,891150,Staff,18,0,25,7
1746533036753,MUS 15,B02,891151,Staff,25,0,25,0
1746533037780,MUS 20,A01,891153,Staff,5,0,20,15
1746533037780,MUS 20,A02,891155,Staff,14,0,20,6
1746533038807,MUS 80,A00,891156,Staff,19,0,25,6
1746533038807,MUS 80,B00,891157,Staff,23,0,25,2
1746533039834,MUS 130,A00,891158,Ohnishi; Takae,35,0,35,0
1746533040862,MUS 150GS,A01,891160,Borgo; David Garcia,0,0,25,25
1746533041890,MUS 170,A01,891162,Freitas Caetano; Marcelo,20,0,25,5
1746533041890,MUS 170,A02,891164,Freitas Caetano; Marcelo,21,0,25,4
1746533042923,NANO 11,A00,886220,Vazquez Mena; Oscar,13,0,15,2
1746533043954,NANO 15,A01,886222,Drews; Aaron,4,0,7,3
1746533045006,NANO 104,A00,886224,Sirbuly; Donald,18,0,25,7
1746533046035,PH 40,A00,886528,Staff,23,0,40,17
1746533047063,PH 45,A01,886799,Staff,35,0,40,5
1746533048092,PH 110,A00,886802,Staff,0,7,40,40
1746533049120,PH 172,A00,906716,Staff,19,0,35,16
1746533050150,PH 191,A00,886803,Staff,6,0,40,34
1746533051181,PHIL 1,A00,889500,Staff,19,0,30,11
1746533052212,PHIL 10,A01,889549,Grush; Rick Scott,15,0,22,7
1746533052212,PHIL 10,A02,889551,Grush; Rick Scott,22,0,22,0
1746533053237,PHIL 28,A01,889559,Lamey; Andy M.,0,1,31,31
1746533053237,PHIL 28,A02,889561,Lamey; Andy M.,0,1,30,30
1746533053237,PHIL 28,A03,889572,Lamey; Andy M.,0,0,30,30
1746533054267,PHIL 35,A00,907839,Staff,13,0,15,2
1746533055297,PHIL 60,A00,889574,Staff,74,0,90,16
1746533056325,PHIL 101,A00,958004,Staff,13,0,15,2
1746533058381,PHIL 136,A00,889582,Fulkerson; Matthew Todd,26,0,45,19
1746533059413,PHIL 163,A01,889601,Staff,21,0,30,9
1746533059413,PHIL 163,B01,889606,Brandt; Reuven A,0,3,0,0
1746533060441,PHIL 164,A00,889610,Staff,16,0,30,14
1746533061469,PHIL 165,A00,889613,Staff,23,0,30,7
1746533062501,PHYS 1A,A00,886431,Staff,26,0,70,44
1746533063530,PHYS 1AL,001,886432,Tsai; Philbert S,0,2,30,30
1746533063530,PHYS 1AL,002,886436,Tsai; Philbert S,11,0,30,19
1746533064563,PHYS 1B,A00,886439,Staff,185,0,240,55
1746533065593,PHYS 1BL,001,886441,Tsai; Philbert S,0,4,30,30
1746533065593,PHYS 1BL,002,886444,Tsai; Philbert S,2,0,30,28
1746533066623,PHYS 1C,A00,896092,Arnold; Kam S,78,0,146,68
1746533067655,PHYS 1CL,001,886448,Tsai; Philbert S,0,0,30,30
1746533067655,PHYS 1CL,002,886449,Tsai; Philbert S,0,0,30,30
1746533067655,PHYS 1CL,003,886450,Tsai; Philbert S,15,0,30,15
1746533067655,PHYS 1CL,004,886451,Tsai; Philbert S,15,0,30,15
1746533068686,PHYS 2B,A01,886457,Staff,69,0,115,46
1746533069712,PHYS 2C,A01,886460,Shotwell; Brian,0,8,65,65
1746533070740,PHYS 2CL,A01,886467,Staff,0,4,28,28
1746533070740,PHYS 2CL,A02,886468,Staff,0,3,28,28
1746533071792,PHYS 2D,A01,886470,Staff,10,0,50,40
1746533072820,PHYS 4B,A01,886475,Grinstein; Benjamin,22,0,40,18
1746533073848,POLI 5,A00,891173,Desposato; Scott,7,0,25,18
1746533074878,POLI 5D,A01,891175,Staff,5,0,5,0
1746533074878,POLI 5D,B01,891178,Staff,5,0,5,0
1746533075904,POLI 11,A00,891179,Ferree; Karen E,2,0,35,33
1746533076930,POLI 12,A00,891180,Staff,16,0,30,14
1746533077959,POLI 27,A01,891182,Staff,12,0,75,63
1746533078983,POLI 30,A00,891183,Staff,9,0,50,41
1746533080011,POLI 100B,A00,891244,Staff,5,1,35,30
1746533081038,POLI 100I,A00,891247,Staff,7,0,30,23
1746533082064,POLI 104J,A00,891248,Nichter; Maysa,14,0,30,16
1746533083092,POLI 104U,A00,891250,Nichter; Maysa,2,0,30,28
1746533085155,POLI 110B,A00,891255,Wiens; David,20,0,25,5
1746533086181,POLI 112A,A00,891256,Wiens; David,6,0,25,19
1746533087209,POLI 114BR,A00,891261,Staff,19,0,30,11
1746533088239,POLI 117R,A00,891262,Forman; Fonna,0,6,50,50
1746533089268,POLI 118,A00,891264,Ingham; Sean,17,0,25,8
1746533090294,POLI 124A,A00,891265,Staff,18,0,20,2
1746533091327,POLI 125D,A00,891266,Nichter; Simeon C,2,0,25,23
1746533092356,POLI 126,A00,891268,Nichter; Simeon C,7,0,25,18
1746533093388,POLI 126AA,A00,891272,Staff,18,0,25,7
1746533094415,POLI 130AA,A00,891273,Staff,15,0,20,5
1746533095445,POLI 134AA,A00,891274,Staff,4,0,20,16
1746533097498,POLI 138,A00,891278,Staff,21,0,25,4
1746533098528,POLI 142K,A00,891280,Staff,11,0,25,14
1746533099556,POLI 142M,A00,891281,Gartzke; Erik,17,0,30,13
1746533100581,POLI 142P,A00,891284,Staff,20,0,30,10
1746533101611,POLI 143,A00,891285,Gartzke; Erik,12,0,30,18
1746533102642,POLI 153,A00,891286,Staff,19,0,20,1
1746533104697,POLI 175,A00,891290,Staff,15,0,20,5
1746533105728,PSYC 1,A00,890674,Steiner; Eric Tomas,0,11,45,45
1746533106760,PSYC 2,A00,890676,Albright; Thomas D,21,0,35,14
1746533107789,PSYC 3,A00,890679,Staff,17,0,20,3
1746533108816,PSYC 6,A00,959858,Staff,20,0,20,0
1746533109843,PSYC 60,A01,890684,Rickard; Timothy C.,0,5,45,45
1746533110874,PSYC 70,A01,890689,Geller; Emma Harlan,7,0,30,23
1746533111901,PSYC 71,A01,959860,Staff,21,0,25,4
1746533112929,PSYC 100,A00,890690,Lacefield; Katharine I,0,50,180,180
1746533113959,PSYC 102,A00,890695,Staff,18,0,40,22
1746533114992,PSYC 105,A00,890699,Geller; Emma Harlan,71,0,100,29
1746533116020,PSYC 106,A00,890701,Gorman; Michael R.,5,0,30,25
1746533117048,PSYC 108,A00,890704,Adrian; Julia Anna,0,28,50,50
1746533118074,PSYC 118,A01,890712,Staff,11,0,30,19
1746533119103,PSYC 124,A00,890716,Chapman; Eddie Nathaniel,25,0,60,35
1746533120131,PSYC 131,A00,890717,Anagnostaras; Stephan,0,7,80,80
1746533121161,PSYC 137,A00,890719,Winkielman; Piotr,0,11,30,30
1746533122191,PSYC 144,A00,890721,Adrian; Julia Anna,0,9,45,45
1746533123217,PSYC 162,A00,890805,Staff,2,0,75,73
1746533124245,PSYC 169,A00,890810,Staff,0,15,30,30
1746533125273,PSYC 172,A00,890814,Gorman; Michael R.,9,0,30,21
1746533126300,PSYC 181,A00,890818,Anagnostaras; Stephan,8,0,200,192
1746533127327,PSYC 184,A00,959861,Staff,170,0,175,5
1746533128352,PSYC 189,A00,890823,Staff,0,1,30,30
1746533129435,PSYC 191,A00,890884,Rickard; Timothy C.,0,11,35,35
1746533130465,PSYC 193,A00,890913,Staff,19,0,30,11
1746533130465,PSYC 193,B00,890914,Chapman; Eddie Nathaniel,24,0,30,6
1746533131495,PSYC 193L,A01,890918,Lowe; Angela Beth,20,0,30,10
1746533131495,PSYC 193L,B01,890921,Hurwitz; Ethan Scott,20,0,30,10
1746533131495,PSYC 193L,C01,890928,Staff,30,0,30,0
1746533132526,RELI 149,A00,886806,Rahimi; Babak,23,0,40,17
1746533133555,SE 9,A01,886814,Staff,7,0,20,13
1746533134583,SE 101B,A01,886816,Chadha; Mayank,4,0,35,31
1746533135612,SE 110B,A00,886818,Zhu; Qiang,4,0,75,71
1746533136639,SE 125,A01,886830,Staff,10,0,30,20
1746533137670,SE 130B,A01,886835,Staff,14,0,40,26
1746533138697,SE 131A,A01,886838,Krysl; Petr,34,0,55,21
1746533139726,SE 154,A00,886840,Staff,30,0,50,20
1746533140757,SE 164GS,A01,886849,Staff,6,0,20,14
1746533141786,SE 167GS,A01,886853,Staff,6,0,20,14
1746533142824,SIO 25,A01,890107,Staff,19,0,30,11
1746533143861,SIO 45,A00,890109,Cook; Geoffrey W,117,0,200,83
1746533144893,SIO 109R,A00,890110,Forman; Fonna,0,16,20,20
1746533145938,SIO 187,A01,890114,Kacev; David,15,0,40,25
1746533146973,SOCI 1,A01,890431,Thorpe; Charles Robert,15,0,30,15
1746533146973,SOCI 1,A02,890518,Thorpe; Charles Robert,30,0,30,0
1746533148003,SOCI 2,A01,957978,Staff,25,0,25,0
1746533148003,SOCI 2,A02,957979,Staff,23,0,25,2
1746533149029,SOCI 20,A01,890523,Calderon-Zaks; Michael Aar,23,0,30,7
1746533149029,SOCI 20,A02,890526,Calderon-Zaks; Michael Aar,29,0,30,1
1746533150054,SOCI 30,A01,890533,Pardo Guerra; Juan Pablo,37,0,40,3
1746533151080,SOCI 40,A01,890535,Staff,27,0,45,18
1746533152105,SOCI 104Q,A00,890559,Staff,18,0,30,12
1746533153131,SOCI 106,A00,890560,Arnal; Maud Marie Leonie,20,0,30,10
1746533154159,SOCI 110,A00,890567,Holkenbrink-Monk; Charlene,19,0,30,11
1746533155188,SOCI 112,A00,890568,Victoria Torres; Pablo,1,0,55,54
1746533156231,SOCI 115,A00,890597,Arnal; Maud Marie Leonie,28,0,45,17
1746533158288,SOCI 121,A00,890604,Pardo Guerra; Juan Pablo,38,0,45,7
1746533159319,SOCI 126,A01,890608,Staff,8,0,10,2
1746533160346,SOCI 127,A00,890609,Staff,18,0,30,12
1746533161372,SOCI 131,A00,890610,Thorpe; Charles Robert,37,0,45,8
1746533162413,SOCI 135,A00,890615,Payne; Christine Anna,14,0,45,31
1746533163442,SOCI 139,A00,890620,Staff,38,0,45,7
1746533164473,SOCI 148E,A00,890622,Calderon-Zaks; Michael Aar,36,0,45,9
1746533165502,SOCI 150,A00,890623,Kohler; Kristopher M.,31,0,45,14
1746533166530,SOCI 157,A00,890625,Jules-Rosette; Bennetta W.,18,0,20,2
1746533167557,SOCI 160,A00,890627,Payne; Christine Anna,21,0,45,24
1746533168584,SYN 1,A00,886855,Fish; Gwendolyn Anne,0,0,0,0
1746533168584,SYN 1,B00,906086,Fish; Gwendolyn Anne,0,1,0,2
1746533169617,SYN 2R,A00,886860,Staff,0,17,15,15
1746533169617,SYN 2R,B00,906106,Atkinson; Arthur Laird,0,16,15,15
1746533170645,SYN 100,A01,886866,Browne; Emily,0,28,20,20
1746533170645,SYN 100,B01,906128,Rock; Martin,0,5,20,20
1746533170645,SYN 100,C01,906140,Deavenport; James Cary,0,3,20,20
1746533170645,SYN 100,D01,907816,Deavenport; James Cary,0,5,20,20
1746533171688,TDAC 1,A00,890286,Walsh; Kim C.,9,0,20,11
1746533172715,TDAC 101,A00,890296,Basso; Beatrice,16,0,20,4
1746533173744,TDDE 131,A00,890297,Staff,47,0,50,3
1746533174771,TDDM 1,A00,890287,Weinberg; Sadie,25,0,30,5
1746533175798,TDGE 11,A00,890288,Fulton; Julia,137,0,200,63
1746533175798,TDGE 11,B00,890289,Castro; Robert Jess,184,0,200,16
1746533176827,TDGE 25,B00,957359,Walsh; Kim C.,3,0,20,17
1746533177854,TDGE 40,A01,890292,Power; Jade Yukana,27,0,30,3
1746533178880,TDGE 124,A00,890298,Havis; Allan,0,0,50,50
1746533179907,TDGE 131R,A00,890299,Burelle; Julie Sara Veronique,15,0,42,27
1746533180933,TDHT 101,A00,890300,Staff,10,0,20,10
1746533181964,TDHT 109,A01,890302,Anderson; Mysia Anyse,31,0,40,9
1746533182991,TDMV 1,A00,890293,Arcidiacono; Kristin,18,0,30,12
1746533184019,TDMV 2,A00,890294,Weinberg; Sadie,23,0,30,7
1746533185046,TDMV 3,A00,957878,Arcidiacono; Kristin,28,0,30,2
1746533187103,TDMV 138,A00,890304,Jun; Grace Shin Hae,25,0,40,15
1746533188130,TDMV 140,A00,890305,Corrales; Joseph Bernales,25,0,30,5
1746533189159,TDMV 142,A00,890307,Caligagan; Tony,32,0,40,8
1746533190186,TDMV 144,A00,890308,Camaya; Michelle Ann,25,0,30,5
1746533191213,TDPW 1,A00,890295,Stein; Deborah Isobel,3,0,20,17
1746533192246,USP 2,A01,890272,Lerner; Amy M,6,0,20,14
1746533193272,USP 3,A01,890274,Staff,12,0,30,18
1746533194302,USP 15,A01,890276,Sun; Feiyang,17,0,30,13
1746533195328,USP 25,A00,890277,Shenkman; Michael Thomas,19,0,25,6
1746533196355,USP 138,A00,890278,Staff,13,0,25,12
1746533197380,USP 143,A00,890279,Staff,21,0,70,49
1746533198407,USP 144,A00,890280,Chowdhury; Muhammed Zohir,16,0,30,14
1746533199435,USP 150,A00,890281,Boomhower; Matthew Charles,4,0,30,26
1746533200461,USP 151,A00,890282,Staff,16,0,20,4
1746533201487,USP 162,A00,890283,Andrews; Abigail Leslie,16,0,20,4
1746533202520,USP 168,A00,920477,Kwak; Nancy,1,0,5,4
1746533203547,USP 181,A00,890284,Staff,3,0,20,17
1746533204573,USP 191A,A00,890285,Staff,13,0,20,7
1746533205604,VIS 101,A00,886512,Staff,25,0,75,50
1746533206632,VIS 103,A00,886513,Cruz; Edwin Teddy,61,0,75,14
1746533207660,VIS 108,A00,886514,Staff,3,0,15,12
1746533208686,VIS 127P,A00,886515,Shen; Kuiyi,80,0,146,66
1746533209712,VIS 149,A00,886516,Yoldas; Pinar,0,0,15,15
1746533210746,VIS 164,A00,886526,Erdmann; Dean,19,0,22,3
1746533211772,VIS 194S,A00,886527,Staff,61,0,75,14
1746533212800,WCWP 10A,C00,886484,Martiniuk; Jill,12,0,15,3
1746533213829,WCWP 10B,A00,886490,Uriarte; Emma,0,0,15,15
1746533213829,WCWP 10B,B00,886491,Dhir; Simrita,11,0,15,4
1746533213829,WCWP 10B,C00,886492,Ornelas; Tricia,0,0,15,15
1746533214860,WCWP 100,A00,886494,Young; Mark T,0,7,15,15
1746533217142,AAS 10,A01,886199,Childs; Dennis R.,0,3,0,0
1746533218170,ANAR 104,A01,886940,Shtienberg; Gilad,27,0,30,3
1746533219200,ANAR 120,A00,886953,Staff,12,0,20,8
1746533220228,ANBI 148,A01,886955,Wilder; Linnea Lorene,30,0,40,10
1746533222287,ANSC 122,A00,886957,Staff,25,0,30,5
1746533223318,ANSC 150,A00,886958,Sloane; Julia Kathryn,3,0,15,12
1746533224348,ANSC 156,A00,886959,Jenkins; Janis A.,0,1,15,15
1746533225374,ANSC 180,A00,886960,Staff,11,0,17,6
1746533226407,ANSC 188,A00,886961,Jassal; Aftab,9,0,25,16
1746533227434,ANSC 190,A00,886962,Jassal; Aftab,14,0,25,11
1746533228460,ANSC 191,A00,886963,Staff,18,0,20,2
1746533229487,ANTH 3,A01,891689,Staff,17,0,20,3
1746533230511,ANTH 5,A00,886933,Semendeferi; Ekaterini,16,0,20,4
1746533231539,ANTH 10,A00,886934,Staff,0,12,30,30
1746533232565,ANTH 21,A01,886936,Staff,40,0,60,20
1746533233593,ANTH 23,A01,886938,Staff,92,0,100,8
1746533234621,ANTH 105,A00,886964,Stewart; Alexander B,84,0,100,16
1746533235647,ANTH 108,A00,886965,Pedersen; David,9,0,20,11
1746533236684,AWP 10,001,886147,Staff,0,0,0,0
1746533236684,AWP 10,002,886148,Staff,0,0,0,0
1746533236684,AWP 10,003,886149,Staff,0,0,0,0
1746533236684,AWP 10,004,886150,Staff,0,0,0,0
1746533236684,AWP 10,005,886151,Staff,0,0,0,0
1746533236684,AWP 10,006,886152,Staff,0,0,0,0
1746533236684,AWP 10,007,886153,Staff,0,0,0,0
1746533236684,AWP 10,008,886154,Staff,0,0,0,0
1746533236684,AWP 10,009,886155,Staff,0,0,0,0
1746533236684,AWP 10,010,886156,Staff,0,0,0,0
1746533236684,AWP 10,011,886158,Staff,0,0,0,0
1746533236684,AWP 10,012,886160,Staff,0,0,0,0
1746533236684,AWP 10,013,886161,Staff,0,0,0,0
1746533236684,AWP 10,014,886162,Staff,0,0,0,0
1746533236684,AWP 10,015,886163,Staff,0,0,0,0
1746533236684,AWP 10,016,886164,Staff,0,0,0,0
1746533236684,AWP 10,017,886165,Staff,0,0,0,0
1746533236684,AWP 10,018,886166,Staff,0,0,0,0
1746533236684,AWP 10,019,886168,Staff,0,0,0,0
1746533236684,AWP 10,020,886170,Staff,0,0,0,0
1746533236684,AWP 10,021,886172,Staff,0,0,0,0
1746533237711,AWP 10R,001,886173,Staff,0,1,0,0
1746533237711,AWP 10R,002,886174,Staff,0,1,0,0
1746533237711,AWP 10R,003,886175,Staff,0,0,0,0
1746533237711,AWP 10R,004,886176,Staff,0,0,0,0
1746533237711,AWP 10R,005,886177,Staff,0,0,0,0
1746533237711,AWP 10R,006,886178,Staff,0,0,0,0
1746533237711,AWP 10R,007,886179,Staff,0,0,0,0
1746533237711,AWP 10R,008,886181,Staff,0,0,0,0
1746533237711,AWP 10R,009,886182,Staff,0,0,0,0
1746533237711,AWP 10R,010,886183,Staff,0,0,0,0
1746533237711,AWP 10R,011,886184,Staff,0,0,0,0
1746533237711,AWP 10R,012,886185,Staff,0,0,0,0
1746533237711,AWP 10R,013,886186,Staff,0,0,0,0
1746533237711,AWP 10R,014,886187,Staff,0,0,0,0
1746533237711,AWP 10R,015,886188,Staff,0,0,0,0
1746533237711,AWP 10R,016,886189,Staff,0,0,0,0
1746533238740,AWP 102R,A00,886190,Staff,0,0,0,0
1746533238740,AWP 102R,B00,886191,Staff,0,0,0,0
1746533239770,BENG 100,A01,886193,Staff,17,0,30,13
1746533240797,BENG 122A,A01,886195,Hasty; Jeff M,13,0,30,17
1746533241822,BENG 166A,A00,886196,Sah; Robert Lie-Yuan,0,1,30,30
1746533242850,BENG 190,A00,958050,Khojah; Reem I,24,0,25,1
1746533243884,BIBC 102,A01,894320,Staff,0,0,46,46
1746533243884,BIBC 102,A02,894321,Staff,1,0,46,45
1746533243884,BIBC 102,A03,894344,Staff,7,0,46,39
1746533243884,BIBC 102,A04,894345,Staff,26,0,47,21
1746533244914,BICD 100R,A01,894365,Smith; Laurie,0,3,58,58
1746533244914,BICD 100R,A02,894366,Smith; Laurie,0,5,58,58
1746533244914,BICD 100R,A03,894367,Smith; Laurie,2,0,59,57
1746533244914,BICD 100R,A04,959869,Smith; Laurie,41,0,59,18
1746533245940,BICD 136,A01,894383,Gustafson-Brown; Cindy,14,0,50,36
1746533246971,BIEB 102,A01,894494,Butler; Shannon Rhey,51,0,130,79
1746533249028,BIEB 150,A01,894617,Wills; Christopher,3,0,20,17
1746533249028,BIEB 150,A02,894631,Wills; Christopher,3,0,20,17
1746533249028,BIEB 150,A03,894937,Wills; Christopher,4,0,20,16
1746533249028,BIEB 150,A04,894946,Wills; Christopher,5,0,20,15
1746533250054,BIEB 194,A00,906141,Kurle; Carolyn M.,6,0,20,14
1746533251082,BILD 1,A01,894154,Staff,2,0,19,17
1746533251082,BILD 1,A02,894155,Staff,14,0,19,5
1746533251082,BILD 1,A03,894160,Staff,13,0,19,6
1746533251082,BILD 1,A04,894161,Staff,15,0,18,3
1746533252109,BILD 2,A01,894168,Staff,0,0,50,50
1746533252109,BILD 2,A02,894169,Staff,0,0,50,50
1746533252109,BILD 2,A03,894179,Staff,4,0,50,46
1746533252109,BILD 2,A04,894203,Staff,27,0,50,23
1746533253138,BILD 3,A01,894213,Staff,22,0,31,9
1746533253138,BILD 3,A02,894214,Staff,26,0,31,5
1746533253138,BILD 3,A03,894235,Staff,28,0,31,3
1746533253138,BILD 3,A04,894236,Staff,28,0,32,4
1746533254170,BILD 4,A01,894253,Reuther; Keefe,5,0,24,19
1746533254170,BILD 4,A02,894258,Reuther; Keefe,16,0,24,8
1746533255198,BILD 5,A01,894276,Reuther; Keefe,35,0,50,15
1746533255198,BILD 5,A02,894277,Reuther; Keefe,45,0,50,5
1746533255198,BILD 5,A03,894290,Reuther; Keefe,44,0,50,6
1746533255198,BILD 5,A04,894291,Reuther; Keefe,48,0,50,2
1746533256225,BILD 24,A01,894297,Pirino; Giorgia,40,0,60,20
1746533257259,BIMM 100,B01,958915,Staff,72,0,100,28
1746533258286,BIMM 101,A01,895017,McDonnell; Lisa Marie,0,5,24,24
1746533258286,BIMM 101,A02,895018,McDonnell; Lisa Marie,0,5,24,24
1746533258286,BIMM 101,B01,895020,McDonnell; Lisa Marie,0,6,24,24
1746533258286,BIMM 101,B02,895021,McDonnell; Lisa Marie,0,4,24,24
1746533259312,BIMM 110,A01,895023,Staff,1,0,25,24
1746533259312,BIMM 110,A02,895024,Staff,9,0,25,16
1746533259312,BIMM 110,A03,895025,Staff,18,0,25,7
1746533259312,BIMM 110,A04,895031,Staff,20,0,25,5
1746533260340,BIMM 120,A01,895114,Gustafson-Brown; Cindy,13,0,28,15
1746533260340,BIMM 120,A02,895126,Gustafson-Brown; Cindy,20,0,27,7
1746533261368,BIPN 100,A01,895130,Yang; Mingyu,1,0,38,37
1746533261368,BIPN 100,A02,895131,Yang; Mingyu,32,0,38,6
1746533261368,BIPN 100,A03,895132,Yang; Mingyu,32,0,38,6
1746533261368,BIPN 100,A04,895133,Yang; Mingyu,27,0,36,9
1746533262405,BIPN 120,A01,895135,Cooke; James Edward,0,3,13,13
1746533262405,BIPN 120,A02,895136,Cooke; James Edward,0,1,13,13
1746533262405,BIPN 120,A03,895137,Cooke; James Edward,0,3,13,13
1746533262405,BIPN 120,A04,895156,Cooke; James Edward,0,2,11,11
1746533263439,BIPN 134,A01,895235,Cooke; James Edward,0,2,25,25
1746533263439,BIPN 134,A02,895237,Cooke; James Edward,0,0,25,25
1746533263439,BIPN 134,A03,895240,Cooke; James Edward,3,0,25,22
1746533263439,BIPN 134,A04,895270,Cooke; James Edward,20,0,25,5
1746533264465,BIPN 189,A00,892103,Staff,0,13,14,14
1746533266524,BISP 194,A00,958008,Staff,0,2,0,0
1746533267549,CAT 124,A01,922009,Staff,0,5,20,20
1746533268580,CAT 125R,A00,886390,Morales; Celeste Georgianna,0,2,20,20
1746533268580,CAT 125R,B00,886391,Irwin; Matthew Joseph,0,3,20,20
1746533268580,CAT 125R,C00,886392,Smith; Lauryn Alissa,0,2,20,20
1746533268580,CAT 125R,D00,886393,Vanderschuit; Maya Alysia,0,2,20,20
1746533268580,CAT 125R,E00,886394,Marchisotto; Jennifer Anne,0,4,20,20
1746533269612,CENG 15,A01,886218,Drews; Aaron,3,0,8,5
1746533270644,CENG 113,A00,886219,Opatkiewicz; Justin Paul,15,0,25,10
1746533271669,CGS 101,A00,887044,Staff,7,0,20,13
1746533272697,CGS 105,A01,887046,Staff,14,0,25,11
1746533273729,CGS 112,A00,887047,Cuong; Marisol,12,0,15,3
1746533274755,CGS 113,A00,887048,Staff,23,0,30,7
1746533275781,CGS 120,A00,887049,Staff,10,0,17,7
1746533276807,CHEM 6A,A01,886336,Lam; Tin Yiu,38,0,50,12
1746533276807,CHEM 6A,A02,886338,Lam; Tin Yiu,37,0,50,13
1746533277835,CHEM 6B,A01,886341,Hopkins; Patrycja Anna,16,0,50,34
1746533277835,CHEM 6B,A02,886343,Hopkins; Patrycja Anna,42,0,50,8
1746533278865,CHEM 6C,A01,886346,Albizati; Kim F.,0,2,50,50
1746533278865,CHEM 6C,A02,886348,Albizati; Kim F.,23,0,50,27
1746533279892,CHEM 40A,A01,886352,Klosterman; Jeremy K,65,0,100,35
1746533280917,CHEM 40B,A01,886356,Klosterman; Jeremy K,0,23,100,100
1746533281948,CHEM 41B,A01,886360,Theodorakis; Emmanuel,25,0,50,25
1746533281948,CHEM 41B,A02,886362,Theodorakis; Emmanuel,47,0,50,3
1746533282974,CHIN 165A,A00,886382,Xu; Li,18,0,20,2
1746533284005,CLAS 120,A00,886387,Myerston Santana; Jacobo,33,0,40,7
1746533285034,COGS 9,A01,886967,Shannon; Kyle Michael,42,0,60,18
1746533286063,COGS 11,A01,886969,Staff,11,0,30,19
1746533287090,COGS 14A,A01,886971,Staff,6,0,60,54
1746533288118,COGS 14B,A01,886973,Hoffman; Drew Ellen,4,0,60,56
1746533289145,COGS 18,A01,886975,Morgan; Eric,35,0,60,25
1746533290175,COGS 20,A01,886977,Staff,4,0,8,4
1746533290175,COGS 20,A02,886978,Staff,5,0,7,2
1746533291201,COGS 100,A01,907783,Staff,0,2,30,30
1746533292228,COGS 101B,A01,886980,Staff,0,3,48,48
1746533293256,COGS 101C,A01,886982,Delgado; Tania,0,5,44,44
1746533294285,COGS 102A,A01,886984,Johnson; Christine M.,4,0,30,26
1746533295314,COGS 118B,A01,886986,Staff,0,3,88,88
1746533296344,COGS 150,A01,886988,Bergen; Benjamin,23,0,50,27
1746533297373,COGS 153,A00,886989,Delgado; Tania,0,2,41,41
1746533298399,COGS 186,A01,886991,Staff,0,0,32,32
1746533299424,COGS 187A,A01,886993,Boyle; Mary E. T.,7,0,30,23
1746533300450,COGS 189,A00,886994,Staff,0,1,30,30
1746533301475,COMM 10,A01,886996,Staff,0,0,20,21
1746533301475,COMM 10,A02,886997,Staff,12,0,20,8
1746533301475,COMM 10,A03,959845,Staff,19,0,20,1
1746533302544,COMM 20,A01,886999,Leuning; Grant Maurstad,24,0,40,16
1746533304597,COMM 100A,A01,887002,Staff,0,0,20,25
1746533304597,COMM 100A,A02,887003,Staff,7,0,20,13
1746533305625,COMM 100B,A01,887005,Staff,0,8,20,24
1746533306651,COMM 106D,A00,887006,Staff,14,0,40,26
1746533307683,COMM 110G,A00,887007,Whitworth-Smith; Andrew C,12,0,40,28
1746533308708,COMM 111B,A00,887008,Staff,31,0,40,9
1746533309736,COMM 113T,A00,887009,Abuelhiga; Soraya Jill,28,0,40,12
1746533309736,COMM 113T,B00,906733,Staff,40,0,40,0
1746533310762,COMM 145,A00,887010,Staff,12,0,40,28
1746533311790,COMM 146,A00,887054,Staff,31,0,40,9
1746533312817,COMM 190,A00,887012,Staff,8,0,23,15
1746533313844,CSE 8A,A50,887015,Cao; Yingjun,57,0,85,28
1746533314870,CSE 11,A01,887017,Cao; Yingjun,12,0,70,58
1746533315896,CSE 20,A01,887019,Staff,30,0,50,20
1746533316924,CSE 21,A01,887021,Staff,78,0,100,22
1746533316924,CSE 21,B01,892583,Braun; Oliver,45,0,50,5
1746533317953,CSE 30,A01,887025,Eldon; John,143,0,200,57
1746533318981,CSE 100,A01,887027,Staff,26,0,50,24
1746533318981,CSE 100,A02,887028,Staff,40,0,50,10
1746533320008,CSE 101,A01,887030,Braun; Oliver,75,0,100,25
1746533320008,CSE 101,B01,887032,Jones; Miles E,0,3,50,50
1746533320008,CSE 101,B02,887033,Jones; Miles E,0,1,50,50
1746533321351,CSE 105,A01,908084,Jones; Miles E,32,0,50,18
1746533321351,CSE 105,A02,908087,Jones; Miles E,33,0,50,17
1746533322377,CSE 135,A01,887035,Powell; Thomas Allan,0,4,50,50
1746533323404,CSE 142,A01,887037,Staff,8,0,60,52
1746533324428,CSE 142L,A01,887039,Staff,34,0,60,26
1746533325458,CSE 151A,A01,887041,Solares; Edwin A,48,0,100,52
1746533326488,CSE 175,A01,887043,Kumar; Rakesh,30,0,30,0
1746533327516,CSS 1,A01,886389,Staff,0,1,40,40
1746533328548,DSC 30,A01,908097,Liao; Soohyun Nam,47,0,75,28
1746533329573,DSC 40A,A01,908099,Shannon; Kyle Michael,30,0,50,20
1746533330599,DSC 40B,A01,908112,Staff,16,0,50,34
1746533331629,DSC 80,A01,908116,Staff,19,0,60,41
1746533332659,DSC 197,001,956863,Eldridge; Justin Matthew,9999,0,9999,0
1746533333685,ECE 5,A01,886400,Morris; Karcher William,2,0,6,4
1746533333685,ECE 5,A02,886401,Morris; Karcher William,3,0,6,3
1746533334709,ECE 148,A01,886403,Silberman; Jack,0,14,14,14
1746533335740,ECON 1,A01,887265,Crane; Meredith Helen,12,0,70,58
1746533335740,ECON 1,B01,887268,Staff,43,0,50,7
1746533336766,ECON 2,A01,887273,Crane; Meredith Helen,56,0,70,14
1746533337792,ECON 3,A01,887279,Rondina; Giacomo,32,0,70,38
1746533338820,ECON 4,A01,887282,Anderson; John Charles,0,2,10,10
1746533339845,ECON 5,A01,887285,Staff,33,0,45,12
1746533339845,ECON 5,B01,887292,Staff,41,0,45,4
1746533340873,ECON 100A,A01,887337,Newhouse; Herbert S,54,0,70,16
1746533340873,ECON 100A,B01,887349,Staff,45,0,50,5
1746533341899,ECON 100B,A01,887361,Du; Songzi,29,0,70,41
1746533342931,ECON 100C,A01,887445,Newhouse; Herbert S,59,0,70,11
1746533343958,ECON 105,A00,887488,Vespa; Emanuel Ignacio,23,0,35,12
1746533344984,ECON 109,A01,887506,Shishkin; Denis,28,0,35,7
1746533346016,ECON 110A,A01,887568,Alon; Titan Michael,0,3,35,35
1746533346016,ECON 110A,B01,907601,Alon; Titan Michael,20,0,35,15
1746533347042,ECON 110B,A01,887598,Levkoff; Steven B.,0,23,70,70
1746533348083,ECON 112,A00,887599,Rondina; Giacomo,19,0,35,16
1746533349114,ECON 120A,A01,887603,Dai; Yinlin,36,0,70,34
1746533350148,ECON 120C,A01,887608,Sun; Yixiao,0,1,35,35
1746533350148,ECON 120C,B01,887614,Sun; Yixiao,0,0,35,35
1746533351180,ECON 138,A00,887621,Bharadwaj; Prashant,0,20,20,20
1746533352207,ECON 144,A00,958007,Squires; Dale E,13,0,35,22
1746533353233,ECON 171,A01,907666,Staff,18,0,35,17
1746533354264,ECON 175,A00,887626,Wu; Pak Yeung,23,0,35,12
1746533355290,ECON 190,A00,887640,Vespa; Emanuel Ignacio,23,0,35,12
1746533356332,EDS 25,A01,888197,Staff,0,0,0,0
1746533356332,EDS 25,A02,888209,Staff,0,0,0,0
1746533356332,EDS 25,A03,888210,Staff,0,0,0,0
1746533356332,EDS 25,A04,888212,Staff,0,0,0,0
1746533356332,EDS 25,A05,888213,Staff,0,0,0,0
1746533356332,EDS 25,A06,888214,Staff,0,0,0,0
1746533356332,EDS 25,A07,888235,Staff,0,2,0,0
1746533356332,EDS 25,A08,888236,Staff,0,0,0,0
1746533356332,EDS 25,A09,888240,Staff,0,0,0,0
1746533356332,EDS 25,A10,888244,Staff,0,0,0,0
1746533356332,EDS 25,B01,888273,Staff,0,0,0,0
1746533356332,EDS 25,B02,888285,Staff,0,0,0,0
1746533356332,EDS 25,B03,888423,Staff,0,0,0,1
1746533356332,EDS 25,B04,888432,Staff,0,0,0,0
1746533356332,EDS 25,B05,888433,Staff,0,0,0,0
1746533356332,EDS 25,B06,888467,Staff,0,0,0,0
1746533356332,EDS 25,B07,888468,Staff,0,0,0,0
1746533356332,EDS 25,B08,888479,Staff,0,0,0,0
1746533356332,EDS 25,B09,888484,Staff,0,0,0,0
1746533356332,EDS 25,B10,888487,Staff,0,0,0,0
1746533357361,EDS 38,A01,907700,Choi; Bailey Miyeon,30,0,30,0
1746533358388,EDS 112,A01,888601,Chapman; Thandeka K,14,0,40,26
1746533359417,EDS 115,A00,888697,Mendez; Kathrina Mendoza,10,0,30,20
1746533360444,EDS 116,A01,888893,Staff,35,0,40,5
1746533362497,EDS 124AR,A00,889133,Staff,29,0,50,21
1746533362497,EDS 124AR,B00,907471,Simon; Elizabeth A,37,0,50,13
1746533363523,EDS 124BR,A00,889134,Simon; Elizabeth A,45,0,100,55
1746533364550,EDS 125,A00,889135,Staff,25,0,30,5
1746533365576,EDS 126,A01,889138,Staff,36,0,40,4
1746533366603,EDS 164R,A01,889142,Wishard Guerra; Alison G.,33,0,50,17
1746533367631,ENG 30,A01,886396,Staff,0,0,0,0
1746533367631,ENG 30,B01,886398,Staff,0,0,0,0
1746533368661,ENVR 102,A00,906150,Montejo; Carolina,23,0,25,2
1746533369687,ETHN 103A,A00,887236,Man; Simeon S,0,3,0,0
1746533370713,ETHN 113,A00,887239,Staff,16,0,30,14
1746533371738,ETHN 116,A00,887240,Staff,16,0,25,9
1746533372766,ETHN 117,A00,887241,Choi; Esther Min,28,0,30,2
1746533373791,ETHN 118,A00,887243,Staff,24,0,30,6
1746533374828,ETHN 127,A00,887248,Cuong; Marisol,11,0,15,4
1746533375856,ETHN 139,A00,887250,Staff,7,0,10,3
1746533376883,ETHN 142,A00,887252,Staff,10,0,30,20
1746533377912,ETHN 161,A00,887253,Browne; Errol Tsekani,24,0,30,6
1746533378940,ETHN 163FR,A00,887255,Burelle; Julie Sara Veronique,0,0,5,5
1746533379974,GLBH 20,A00,889149,Elwardani; Nile Regina,8,0,42,34
1746533382027,GLBH 111,A01,889152,Burgos; Jose L.,17,0,17,0
1746533383058,GLBH 150,A00,889181,Sloane; Julia Kathryn,0,5,15,15
1746533385120,HDS 60,A01,886406,Warstadt; Melissa Fawn,73,0,80,7
1746533386152,HIAF 111,A00,889324,Gyamfi; Bright,25,0,32,7
1746533387180,HIEA 131,A00,889328,Staff,16,0,32,16
1746533388212,HIEA 144,A00,889333,Henry; Todd A.,26,0,32,6
1746533389243,HIEA 154,A00,889336,Henry; Todd A.,24,0,32,8
1746533390269,HIEU 106,A00,889339,Staff,22,0,32,10
1746533392323,HIEU 114,A00,889340,Staff,3,0,32,29
1746533393352,HIEU 135GS,A00,889342,Patterson; Patrick H.,0,0,1,24
1746533394378,HIEU 137,A00,889343,Edington; Claire Ellen,9,0,25,16
1746533395407,HIEU 148,A00,889345,Staff,14,0,32,18
1746533396436,HIEU 154,A00,889346,Biess; Frank Peter,21,0,32,11
1746533397464,HILA 102,A00,889351,Staff,12,0,32,20
1746533398491,HILD 2A,A01,889221,Lewandoski; Julia Mavis,1,10,32,31
1746533399522,HILD 7B,A01,889225,Man; Simeon S,0,13,32,32
1746533400555,HILD 7C,A01,889288,Alvarez; Luis A,0,14,32,32
1746533401583,HILD 30,A01,889323,Staff,0,5,32,32
1746533403638,HISC 119,A00,889383,Golan; Tal,21,0,32,11
1746533404667,HIUS 103,A00,889384,Man; Simeon S,0,0,32,32
1746533405697,HIUS 117,A00,919797,Kwak; Nancy,18,0,32,14
1746533406754,HIUS 142A,A00,919788,Staff,22,0,32,10
1746533408807,HIUS 149,A00,889386,Gyamfi; Bright,27,0,32,5
1746533409835,HIUS 155,A00,889387,Alvarez; Luis A,14,0,32,18
1746533410867,HUM 3,A01,886499,Caldwell; Michael Alan,19,0,50,31
1746533411891,HUM 3GS,A00,886500,Rodriguez; Bretton Sigfred,0,0,0,28
1746533412920,HUM 3R,A01,886502,Markman; Kristina,0,36,50,50
1746533413947,HUM 4,A01,886504,Crum; Matthew Stephen,24,0,50,26
1746533413947,HUM 4,B01,886506,West; Geoffrey Scott,17,0,50,33
1746533414976,HUM 4GS,A00,886507,Staff,0,0,0,19
1746533416007,HUM 5,A01,886509,Staff,32,0,50,18
1746533417036,HUM 5R,A01,886511,Zavodny; Tatiana Sophia,0,39,50,50
1746533418061,JAPN 180,A00,886407,Staff,18,0,40,22
1746533419090,LATI 50,A01,886409,Martin-Cabrera; Luis,4,0,22,18
1746533419090,LATI 50,A02,886410,Martin-Cabrera; Luis,19,0,22,3
1746533419090,LATI 50,A03,886411,Martin-Cabrera; Luis,21,0,22,1
1746533419090,LATI 50,A04,886412,Martin-Cabrera; Luis,9,0,22,13
1746533420116,LAWS 101,A00,907664,Staff,28,0,60,32
1746533421145,LIAB 1A,A00,889388,Saab; Dima,17,0,20,3
1746533422171,LIAB 1AX,A00,889389,El Cheddadi; Youniss,17,0,20,3
1746533423198,LIFR 1C,A00,889391,Van Moer; Vinciane G,8,0,20,12
1746533424224,LIFR 1CX,A00,889392,Van Moer; Vinciane G,7,0,20,13
1746533425254,LIFR 1D,A00,889393,Van Moer; Vinciane G,7,0,20,13
1746533426281,LIFR 1DX,A00,889394,Van Moer; Vinciane G,8,0,20,12
1746533427305,LIGN 7,A00,886923,Staff,24,0,50,26
1746533428331,LIGN 17,A00,886924,Kehler; Andrew Scott,125,0,150,25
1746533429360,LTAM 110,A00,889395,Staff,15,0,30,15
1746533430383,LTAM 110GS,A00,958010,Rodriguez; Bretton Sigfred,0,0,0,28
1746533431411,LTCH 101,A00,889397,Staff,23,0,25,2
1746533432438,LTCS 130,A00,889398,Staff,23,0,25,2
1746533433467,LTEA 138,A00,889399,Staff,24,0,40,16
1746533434497,LTEN 149,A00,889400,Wesling; Megan E.,0,3,25,25
1746533435526,LTEN 169,A00,889401,Staff,20,0,25,5
1746533436552,LTEN 180,A00,889402,Staff,10,0,15,5
1746533437577,LTEN 181,A00,889403,Staff,21,0,25,4
1746533438603,LTWL 100,A00,889404,Myerston Santana; Jacobo,3,0,25,22
1746533439627,LTWL 180GS,A00,889405,Staff,0,0,20,20
1746533440652,LTWL 181,A00,889406,Staff,17,0,25,8
1746533441683,LTWL 184,A00,889475,Mukherjee; Silpa,22,0,25,3
1746533442707,LTWR 102C,A00,889486,Staff,29,0,30,1
1746533443733,LTWR 115W,A00,889491,Staff,0,2,15,15
1746533444763,MAE 8,A01,886905,Staff,0,2,0,0
1746533445796,MAE 11,A00,886906,Bandaru; Prabhakar,0,7,50,50
1746533446823,MAE 20,A00,886907,Evdokimenko; Ekaterina,44,0,70,26
1746533447852,MAE 30B,A00,886909,Ghazinejad; Maziar,26,0,45,19
1746533448902,MAE 101B,A00,886910,Saintillan; David,29,0,45,16
1746533449932,MAE 105,A00,886911,Bandaru; Prabhakar,18,0,50,32
1746533450962,MAE 107,B00,958024,Staff,9,0,50,41
1746533451993,MAE 143B,A00,886913,Bewley; Thomas R,7,0,40,33
1746533453019,MAE 148,A01,886915,Silberman; Jack,0,3,14,14
1746533454045,MAE 160,A00,886916,Evdokimenko; Ekaterina,31,0,60,29
1746533455078,MATH 3C,A01,889681,Staff,0,3,30,30
1746533455078,MATH 3C,A02,960048,Staff,25,0,30,5
1746533456106,MATH 10A,A01,889760,Staff,26,0,30,4
1746533456106,MATH 10A,A02,889783,Staff,29,0,30,1
1746533457135,MATH 10B,A01,889785,Verstraete; Jacques Allan,2,0,35,33
1746533457135,MATH 10B,A02,889795,Verstraete; Jacques Allan,4,0,35,31
1746533457135,MATH 10B,B01,889797,Verstraete; Jacques Allan,3,0,35,32
1746533457135,MATH 10B,B02,889828,Verstraete; Jacques Allan,3,0,35,32
1746533458164,MATH 10C,A01,889849,Habib; Yousaf,9,0,30,21
1746533458164,MATH 10C,A02,889852,Habib; Yousaf,14,0,30,16
1746533458164,MATH 10C,A03,889853,Habib; Yousaf,22,0,30,8
1746533458164,MATH 10C,A04,889858,Habib; Yousaf,20,0,30,10
1746533458164,MATH 10C,B01,889861,Staff,1,0,30,29
1746533458164,MATH 10C,B02,889862,Staff,24,0,30,6
1746533458164,MATH 10C,B03,889863,Staff,27,0,30,3
1746533458164,MATH 10C,B04,889967,Staff,23,0,30,7
1746533459196,MATH 18,A01,889974,Staff,7,0,30,23
1746533459196,MATH 18,A02,889977,Staff,20,0,30,10
1746533459196,MATH 18,B01,889984,Hardiman; Liam,22,0,30,8
1746533459196,MATH 18,B02,889985,Hardiman; Liam,25,0,30,5
1746533460223,MATH 20A,A01,889990,Suk; Andrew Hoon,29,0,35,6
1746533461249,MATH 20B,A01,889993,Ohm; Ko Woon,22,0,30,8
1746533461249,MATH 20B,A02,889994,Ohm; Ko Woon,30,0,30,0
1746533461249,MATH 20B,B01,889996,Ohm; Ko Woon,21,0,30,9
1746533461249,MATH 20B,B02,889997,Ohm; Ko Woon,23,0,30,7
1746533462285,MATH 20C,A01,889999,Hammock; Frances H,17,0,30,13
1746533462285,MATH 20C,A02,890003,Hammock; Frances H,23,0,30,7
1746533462285,MATH 20C,B01,890006,Hammock; Frances H,3,0,30,27
1746533462285,MATH 20C,B02,890007,Hammock; Frances H,11,0,30,19
1746533463318,MATH 20D,A01,890011,Cheng; Hsiao-Bing,1,1,30,29
1746533463318,MATH 20D,A02,890012,Cheng; Hsiao-Bing,14,0,30,16
1746533463318,MATH 20D,B01,890016,Cheng; Hsiao-Bing,13,0,30,17
1746533463318,MATH 20D,B02,890017,Cheng; Hsiao-Bing,13,0,30,17
1746533464345,MATH 20E,A01,890026,Harel; Guershon,1,0,30,29
1746533464345,MATH 20E,A02,890029,Harel; Guershon,23,0,30,7
1746533464345,MATH 20E,B01,890033,Harel; Guershon,7,0,30,23
1746533464345,MATH 20E,B02,890101,Harel; Guershon,21,0,30,9
1746533465371,MATH 102,A01,890104,Staff,17,0,30,13
1746533465371,MATH 102,A02,890105,Staff,27,0,30,3
1746533466398,MATH 103B,A01,890116,Salehi Golsefidy; Alireza,3,0,30,27
1746533466398,MATH 103B,B01,890118,Staff,0,3,34,34
1746533467432,MATH 109,A01,890121,Aliabadi Sr.; Mohsen,1,0,30,29
1746533467432,MATH 109,B01,890124,Upadrashta; Pranav Kumar,18,0,30,12
1746533468461,MATH 120A,A01,890126,Eggers; John Dietrich,13,0,30,17
1746533469488,MATH 142B,A01,890128,Ioana; Adrian,19,0,30,11
1746533469488,MATH 142B,A02,890129,Ioana; Adrian,13,0,30,17
1746533470516,MATH 154,A01,890174,Staff,0,0,30,30
1746533470516,MATH 154,A02,890182,Staff,0,0,30,30
1746533471543,MATH 168A,A01,890197,Dumitriu; Ioana,21,0,35,14
1746533472570,MATH 170A,A01,890240,Nie; Jiawang,1,0,30,29
1746533472570,MATH 170A,A02,890241,Nie; Jiawang,11,0,30,19
1746533472570,MATH 170A,A03,890249,Nie; Jiawang,23,0,30,7
1746533473594,MATH 170B,A01,957891,Nag; Panchali,13,0,35,22
1746533475652,MATH 181A,A01,908025,Staff,0,4,35,35
1746533475652,MATH 181A,A02,960115,Staff,27,0,35,8
1746533476678,MATH 181B,A01,959874,Staff,26,0,30,4
1746533477706,MATH 193B,A01,890265,Staff,0,4,35,35
1746533478734,MGT 4,A01,890311,Anderson; John Charles,42,0,88,46
1746533479763,MGT 5,A00,907740,Staff,13,0,98,85
1746533480790,MGT 12,A00,890312,Lindenberger; Wade Douglas,67,0,98,31
1746533481817,MGT 16,A00,957883,Staff,78,0,98,20
1746533483876,MGT 45,A00,890314,Pecore; Joseph P.,47,0,98,51
1746533484937,MGT 71,A00,890315,Staff,0,11,98,98
1746533485964,MGT 100,A00,890316,Yavorsky; Daniel Ryan,44,0,98,54
1746533486993,MGT 103,A00,890317,Ehrich; Kristine R,73,0,98,25
1746533488023,MGT 105,A00,890356,Bates; Kenneth Walter,0,7,98,98
1746533489048,MGT 112,A00,890360,Ehrich; Kristine R,55,0,98,43
1746533490074,MGT 127R,A00,907732,Zhu; Kevin Xiaoguo,23,0,98,75
1746533491104,MGT 131B,A00,890361,Anderson; John Charles,61,0,98,37
1746533492129,MGT 137,A00,890362,Lindenberger; Wade Douglas,65,0,98,33
1746533493157,MGT 160,A00,890369,Johnson; Erik Barry,9,0,98,89
1746533495208,MGT 164,A00,890372,Zimmermann; Carsten,0,39,98,98
1746533496239,MGT 180,A00,890374,Bliss; Barbara Ann,12,0,98,86
1746533497270,MMW 15,A01,886414,Chang; Edmond Yi-Teh,0,12,28,28
1746533497270,MMW 15,A02,886415,Chang; Edmond Yi-Teh,0,8,28,28
1746533497270,MMW 15,A03,886416,Chang; Edmond Yi-Teh,0,8,28,28
1746533497270,MMW 15,A04,886417,Chang; Edmond Yi-Teh,0,8,28,28
1746533497270,MMW 15,B01,886419,Chang; Edmond Yi-Teh,0,7,28,28
1746533497270,MMW 15,B02,886420,Chang; Edmond Yi-Teh,0,8,28,28
1746533497270,MMW 15,B03,886421,Chang; Edmond Yi-Teh,0,7,28,28
1746533497270,MMW 15,B04,886422,Chang; Edmond Yi-Teh,0,8,28,28
1746533497270,MMW 15,C01,886424,Staff,0,9,28,28
1746533497270,MMW 15,C02,886425,Staff,0,8,28,28
1746533497270,MMW 15,C03,886426,Staff,0,8,28,28
1746533497270,MMW 15,C04,886427,Staff,0,7,28,28
1746533497270,MMW 15,C05,958038,Staff,0,7,28,28
1746533497270,MMW 15,C06,958039,Staff,0,8,28,28
1746533498301,MMW 15GS,A00,906910,Patterson; Patrick H.,4,0,28,24
1746533499333,MMW 122R,A01,886429,Rahimi; Babak,0,13,28,28
1746533499333,MMW 122R,A02,886430,Rahimi; Babak,0,12,28,28
1746533499333,MMW 122R,A03,958040,Rahimi; Babak,0,11,28,28
1746533500363,MUS 1A,A01,890937,Staff,3,0,25,22
1746533500363,MUS 1A,A02,891035,Staff,6,0,25,19
1746533500363,MUS 1A,C01,958912,Staff,24,0,25,1
1746533500363,MUS 1A,C02,958913,Staff,25,0,25,0
1746533502416,MUS 2AK,A00,957092,Ohnishi; Takae,15,0,15,0
1746533503445,MUS 4,A01,891044,Staff,2,0,25,23
1746533503445,MUS 4,A02,891045,Staff,23,0,25,2
1746533503445,MUS 4,B01,891048,Staff,17,0,25,8
1746533503445,MUS 4,B02,891050,Staff,25,0,25,0
1746533504474,MUS 5,A01,957506,Dubnov; Shlomo,0,0,25,25
1746533504474,MUS 5,A02,957622,Dubnov; Shlomo,14,0,25,11
1746533504474,MUS 5,A03,957623,Dubnov; Shlomo,20,0,25,5
1746533505503,MUS 6,A01,891053,Freitas Caetano; Marcelo,24,0,25,1
1746533505503,MUS 6,A02,891054,Freitas Caetano; Marcelo,23,0,25,2
1746533506532,MUS 7,A01,891081,Staff,0,0,25,25
1746533506532,MUS 7,A02,891082,Staff,4,0,25,21
1746533507566,MUS 8GS,A00,891118,Borgo; David Garcia,0,0,25,25
1746533508596,MUS 11,A01,891140,Staff,11,0,25,14
1746533508596,MUS 11,A02,891141,Staff,22,0,25,3
1746533509625,MUS 13,A01,891143,Staff,8,0,25,17
1746533509625,MUS 13,A02,891144,Staff,24,0,25,1
1746533510656,MUS 15,A01,891146,Staff,9,0,25,16
1746533510656,MUS 15,A02,891148,Staff,21,0,25,4
1746533510656,MUS 15,B01,891150,Staff,18,0,25,7
1746533510656,MUS 15,B02,891151,Staff,25,0,25,0
1746533511686,MUS 20,A01,891153,Staff,5,0,20,15
1746533511686,MUS 20,A02,891155,Staff,14,0,20,6
1746533512713,MUS 80,A00,891156,Staff,19,0,25,6
1746533512713,MUS 80,B00,891157,Staff,23,0,25,2
1746533513739,MUS 130,A00,891158,Ohnishi; Takae,35,0,35,0
1746533514764,MUS 150GS,A01,891160,Borgo; David Garcia,0,0,25,25
1746533515795,MUS 170,A01,891162,Freitas Caetano; Marcelo,20,0,25,5
1746533515795,MUS 170,A02,891164,Freitas Caetano; Marcelo,21,0,25,4
1746533516823,NANO 11,A00,886220,Vazquez Mena; Oscar,13,0,15,2
1746533517850,NANO 15,A01,886222,Drews; Aaron,4,0,7,3
1746533518877,NANO 104,A00,886224,Sirbuly; Donald,18,0,25,7
1746533519903,PH 40,A00,886528,Staff,23,0,40,17
1746533520931,PH 45,A01,886799,Staff,35,0,40,5
1746533521959,PH 110,A00,886802,Staff,0,7,40,40
1746533522989,PH 172,A00,906716,Staff,19,0,35,16
1746533524017,PH 191,A00,886803,Staff,6,0,40,34
1746533525047,PHIL 1,A00,889500,Staff,19,0,30,11
1746533526076,PHIL 10,A01,889549,Grush; Rick Scott,15,0,22,7
1746533526076,PHIL 10,A02,889551,Grush; Rick Scott,22,0,22,0
1746533527106,PHIL 28,A01,889559,Lamey; Andy M.,0,1,31,31
1746533527106,PHIL 28,A02,889561,Lamey; Andy M.,0,1,30,30
1746533527106,PHIL 28,A03,889572,Lamey; Andy M.,0,0,30,30
1746533528131,PHIL 35,A00,907839,Staff,13,0,15,2
1746533529157,PHIL 60,A00,889574,Staff,74,0,90,16
1746533530181,PHIL 101,A00,958004,Staff,13,0,15,2
1746533532247,PHIL 136,A00,889582,Fulkerson; Matthew Todd,26,0,45,19
1746533533273,PHIL 163,A01,889601,Staff,21,0,30,9
1746533533273,PHIL 163,B01,889606,Brandt; Reuven A,0,3,0,0
1746533534303,PHIL 164,A00,889610,Staff,16,0,30,14
1746533535328,PHIL 165,A00,889613,Staff,23,0,30,7
1746533536354,PHYS 1A,A00,886431,Staff,26,0,70,44
1746533537381,PHYS 1AL,001,886432,Tsai; Philbert S,0,2,30,30
1746533537381,PHYS 1AL,002,886436,Tsai; Philbert S,11,0,30,19
1746533538407,PHYS 1B,A00,886439,Staff,185,0,240,55
1746533539436,PHYS 1BL,001,886441,Tsai; Philbert S,0,4,30,30
1746533539436,PHYS 1BL,002,886444,Tsai; Philbert S,2,0,30,28
1746533540462,PHYS 1C,A00,896092,Arnold; Kam S,78,0,146,68
1746533541488,PHYS 1CL,001,886448,Tsai; Philbert S,0,0,30,30
1746533541488,PHYS 1CL,002,886449,Tsai; Philbert S,0,0,30,30
1746533541488,PHYS 1CL,003,886450,Tsai; Philbert S,15,0,30,15
1746533541488,PHYS 1CL,004,886451,Tsai; Philbert S,15,0,30,15
1746533542515,PHYS 2B,A01,886457,Staff,69,0,115,46
1746533543542,PHYS 2C,A01,886460,Shotwell; Brian,0,8,65,65
1746533544567,PHYS 2CL,A01,886467,Staff,0,4,28,28
1746533544567,PHYS 2CL,A02,886468,Staff,0,3,28,28
1746533545599,PHYS 2D,A01,886470,Staff,10,0,50,40
1746533546627,PHYS 4B,A01,886475,Grinstein; Benjamin,22,0,40,18
1746533547660,POLI 5,A00,891173,Desposato; Scott,7,0,25,18
1746533548686,POLI 5D,A01,891175,Staff,5,0,5,0
1746533548686,POLI 5D,B01,891178,Staff,5,0,5,0
1746533549715,POLI 11,A00,891179,Ferree; Karen E,2,0,35,33
1746533550742,POLI 12,A00,891180,Staff,16,0,30,14
1746533551772,POLI 27,A01,891182,Staff,12,0,75,63
1746533552799,POLI 30,A00,891183,Staff,9,0,50,41
1746533553829,POLI 100B,A00,891244,Staff,5,1,35,30
1746533554857,POLI 100I,A00,891247,Staff,7,0,30,23
1746533555887,POLI 104J,A00,891248,Nichter; Maysa,14,0,30,16
1746533556911,POLI 104U,A00,891250,Nichter; Maysa,2,0,30,28
1746533558966,POLI 110B,A00,891255,Wiens; David,20,0,25,5
1746533559995,POLI 112A,A00,891256,Wiens; David,6,0,25,19
1746533561021,POLI 114BR,A00,891261,Staff,19,0,30,11
1746533562047,POLI 117R,A00,891262,Forman; Fonna,0,6,50,50
1746533563077,POLI 118,A00,891264,Ingham; Sean,17,0,25,8
1746533564102,POLI 124A,A00,891265,Staff,18,0,20,2
1746533565129,POLI 125D,A00,891266,Nichter; Simeon C,2,0,25,23
1746533566156,POLI 126,A00,891268,Nichter; Simeon C,7,0,25,18
1746533567182,POLI 126AA,A00,891272,Staff,18,0,25,7
1746533568207,POLI 130AA,A00,891273,Staff,15,0,20,5
1746533569233,POLI 134AA,A00,891274,Staff,4,0,20,16
1746533571286,POLI 138,A00,891278,Staff,21,0,25,4
1746533572315,POLI 142K,A00,891280,Staff,11,0,25,14
1746533573345,POLI 142M,A00,891281,Gartzke; Erik,17,0,30,13
1746533574375,POLI 142P,A00,891284,Staff,20,0,30,10
1746533575401,POLI 143,A00,891285,Gartzke; Erik,12,0,30,18
1746533576430,POLI 153,A00,891286,Staff,19,0,20,1
1746533578485,POLI 175,A00,891290,Staff,15,0,20,5
1746533579517,PSYC 1,A00,890674,Steiner; Eric Tomas,0,11,45,45
1746533580547,PSYC 2,A00,890676,Albright; Thomas D,21,0,35,14
1746533581574,PSYC 3,A00,890679,Staff,17,0,20,3
1746533582603,PSYC 6,A00,959858,Staff,20,0,20,0
1746533583636,PSYC 60,A01,890684,Rickard; Timothy C.,0,5,45,45
1746533584664,PSYC 70,A01,890689,Geller; Emma Harlan,7,0,30,23
1746533585694,PSYC 71,A01,959860,Staff,21,0,25,4
1746533586720,PSYC 100,A00,890690,Lacefield; Katharine I,0,50,180,180
1746533587748,PSYC 102,A00,890695,Staff,18,0,40,22
1746533588774,PSYC 105,A00,890699,Geller; Emma Harlan,71,0,100,29
1746533589808,PSYC 106,A00,890701,Gorman; Michael R.,5,0,30,25
1746533590840,PSYC 108,A00,890704,Adrian; Julia Anna,0,28,50,50
1746533591870,PSYC 118,A01,890712,Staff,11,0,30,19
1746533592899,PSYC 124,A00,890716,Chapman; Eddie Nathaniel,25,0,60,35
1746533593926,PSYC 131,A00,890717,Anagnostaras; Stephan,0,7,80,80
1746533594957,PSYC 137,A00,890719,Winkielman; Piotr,0,11,30,30
1746533595982,PSYC 144,A00,890721,Adrian; Julia Anna,0,9,45,45
1746533597009,PSYC 162,A00,890805,Staff,2,0,75,73
1746533598035,PSYC 169,A00,890810,Staff,0,15,30,30
1746533599065,PSYC 172,A00,890814,Gorman; Michael R.,9,0,30,21
1746533600149,PSYC 181,A00,890818,Anagnostaras; Stephan,8,0,200,192
1746533601175,PSYC 184,A00,959861,Staff,170,0,175,5
1746533602204,PSYC 189,A00,890823,Staff,0,1,30,30
1746533603231,PSYC 191,A00,890884,Rickard; Timothy C.,0,11,35,35
1746533604262,PSYC 193,A00,890913,Staff,19,0,30,11
1746533604262,PSYC 193,B00,890914,Chapman; Eddie Nathaniel,24,0,30,6
1746533605290,PSYC 193L,A01,890918,Lowe; Angela Beth,20,0,30,10
1746533605290,PSYC 193L,B01,890921,Hurwitz; Ethan Scott,20,0,30,10
1746533605290,PSYC 193L,C01,890928,Staff,30,0,30,0
1746533606317,RELI 149,A00,886806,Rahimi; Babak,23,0,40,17
1746533607345,SE 9,A01,886814,Staff,7,0,20,13
1746533608372,SE 101B,A01,886816,Chadha; Mayank,4,0,35,31
1746533609398,SE 110B,A00,886818,Zhu; Qiang,4,0,75,71
1746533610423,SE 125,A01,886830,Staff,10,0,30,20
1746533611452,SE 130B,A01,886835,Staff,14,0,40,26
1746533612477,SE 131A,A01,886838,Krysl; Petr,34,0,55,21
1746533613503,SE 154,A00,886840,Staff,30,0,50,20
1746533614528,SE 164GS,A01,886849,Staff,6,0,20,14
1746533615553,SE 167GS,A01,886853,Staff,6,0,20,14
1746533616579,SIO 25,A01,890107,Staff,19,0,30,11
1746533617608,SIO 45,A00,890109,Cook; Geoffrey W,117,0,200,83
1746533618636,SIO 109R,A00,890110,Forman; Fonna,0,16,20,20
1746533619664,SIO 187,A01,890114,Kacev; David,15,0,40,25
1746533620698,SOCI 1,A01,890431,Thorpe; Charles Robert,15,0,30,15
1746533620698,SOCI 1,A02,890518,Thorpe; Charles Robert,30,0,30,0
1746533621724,SOCI 2,A01,957978,Staff,25,0,25,0
1746533621724,SOCI 2,A02,957979,Staff,23,0,25,2
1746533622753,SOCI 20,A01,890523,Calderon-Zaks; Michael Aar,23,0,30,7
1746533622753,SOCI 20,A02,890526,Calderon-Zaks; Michael Aar,29,0,30,1
1746533623780,SOCI 30,A01,890533,Pardo Guerra; Juan Pablo,37,0,40,3
1746533624804,SOCI 40,A01,890535,Staff,27,0,45,18
1746533625830,SOCI 104Q,A00,890559,Staff,18,0,30,12
1746533626857,SOCI 106,A00,890560,Arnal; Maud Marie Leonie,20,0,30,10
1746533627883,SOCI 110,A00,890567,Holkenbrink-Monk; Charlene,19,0,30,11
1746533628912,SOCI 112,A00,890568,Victoria Torres; Pablo,1,0,55,54
1746533629941,SOCI 115,A00,890597,Arnal; Maud Marie Leonie,28,0,45,17
1746533631992,SOCI 121,A00,890604,Pardo Guerra; Juan Pablo,38,0,45,7
1746533633019,SOCI 126,A01,890608,Staff,8,0,10,2
1746533634047,SOCI 127,A00,890609,Staff,18,0,30,12
1746533635114,SOCI 131,A00,890610,Thorpe; Charles Robert,37,0,45,8
1746533636140,SOCI 135,A00,890615,Payne; Christine Anna,14,0,45,31
1746533637166,SOCI 139,A00,890620,Staff,38,0,45,7
1746533638198,SOCI 148E,A00,890622,Calderon-Zaks; Michael Aar,36,0,45,9
1746533639227,SOCI 150,A00,890623,Kohler; Kristopher M.,31,0,45,14
1746533640259,SOCI 157,A00,890625,Jules-Rosette; Bennetta W.,18,0,20,2
1746533641290,SOCI 160,A00,890627,Payne; Christine Anna,21,0,45,24
1746533642317,SYN 1,A00,886855,Fish; Gwendolyn Anne,0,0,0,0
1746533642317,SYN 1,B00,906086,Fish; Gwendolyn Anne,0,1,0,2
1746533643344,SYN 2R,A00,886860,Staff,0,17,15,15
1746533643344,SYN 2R,B00,906106,Atkinson; Arthur Laird,0,16,15,15
1746533644385,SYN 100,A01,886866,Browne; Emily,0,28,20,20
1746533644385,SYN 100,B01,906128,Rock; Martin,0,5,20,20
1746533644385,SYN 100,C01,906140,Deavenport; James Cary,0,3,20,20
1746533644385,SYN 100,D01,907816,Deavenport; James Cary,0,5,20,20
1746533645413,TDAC 1,A00,890286,Walsh; Kim C.,9,0,20,11
1746533646444,TDAC 101,A00,890296,Basso; Beatrice,16,0,20,4
1746533647470,TDDE 131,A00,890297,Staff,47,0,50,3
1746533648500,TDDM 1,A00,890287,Weinberg; Sadie,25,0,30,5
1746533649530,TDGE 11,A00,890288,Fulton; Julia,137,0,200,63
1746533649530,TDGE 11,B00,890289,Castro; Robert Jess,184,0,200,16
1746533650556,TDGE 25,B00,957359,Walsh; Kim C.,3,0,20,17
1746533651584,TDGE 40,A01,890292,Power; Jade Yukana,27,0,30,3
1746533652611,TDGE 124,A00,890298,Havis; Allan,0,0,50,50
1746533653642,TDGE 131R,A00,890299,Burelle; Julie Sara Veronique,15,0,42,27
1746533654670,TDHT 101,A00,890300,Staff,10,0,20,10
1746533655696,TDHT 109,A01,890302,Anderson; Mysia Anyse,31,0,40,9
1746533656724,TDMV 1,A00,890293,Arcidiacono; Kristin,18,0,30,12
1746533657750,TDMV 2,A00,890294,Weinberg; Sadie,23,0,30,7
1746533658777,TDMV 3,A00,957878,Arcidiacono; Kristin,28,0,30,2
1746533660830,TDMV 138,A00,890304,Jun; Grace Shin Hae,25,0,40,15
1746533661860,TDMV 140,A00,890305,Corrales; Joseph Bernales,25,0,30,5
1746533662887,TDMV 142,A00,890307,Caligagan; Tony,32,0,40,8
1746533663912,TDMV 144,A00,890308,Camaya; Michelle Ann,25,0,30,5
1746533664940,TDPW 1,A00,890295,Stein; Deborah Isobel,3,0,20,17
1746533665966,USP 2,A01,890272,Lerner; Amy M,6,0,20,14
1746533666989,USP 3,A01,890274,Staff,12,0,30,18
1746533668014,USP 15,A01,890276,Sun; Feiyang,17,0,30,13
1746533669046,USP 25,A00,890277,Shenkman; Michael Thomas,19,0,25,6
1746533670071,USP 138,A00,890278,Staff,13,0,25,12
1746533671098,USP 143,A00,890279,Staff,21,0,70,49
1746533672123,USP 144,A00,890280,Chowdhury; Muhammed Zohir,16,0,30,14
1746533673150,USP 150,A00,890281,Boomhower; Matthew Charles,4,0,30,26
1746533674173,USP 151,A00,890282,Staff,16,0,20,4
1746533675200,USP 162,A00,890283,Andrews; Abigail Leslie,16,0,20,4
1746533676226,USP 168,A00,920477,Kwak; Nancy,1,0,5,4
1746533677253,USP 181,A00,890284,Staff,3,0,20,17
1746533678278,USP 191A,A00,890285,Staff,13,0,20,7
1746533679305,VIS 101,A00,886512,Staff,25,0,75,50
1746533680337,VIS 103,A00,886513,Cruz; Edwin Teddy,61,0,75,14
1746533681366,VIS 108,A00,886514,Staff,3,0,15,12
1746533682405,VIS 127P,A00,886515,Shen; Kuiyi,80,0,146,66
1746533683433,VIS 149,A00,886516,Yoldas; Pinar,0,0,15,15
1746533684461,VIS 164,A00,886526,Erdmann; Dean,19,0,22,3
1746533685490,VIS 194S,A00,886527,Staff,61,0,75,14
1746533686521,WCWP 10A,C00,886484,Martiniuk; Jill,12,0,15,3
1746533687552,WCWP 10B,A00,886490,Uriarte; Emma,0,0,15,15
1746533687552,WCWP 10B,B00,886491,Dhir; Simrita,11,0,15,4
1746533687552,WCWP 10B,C00,886492,Ornelas; Tricia,0,0,15,15
1746533688580,WCWP 100,A00,886494,Young; Mark T,0,7,15,15
1746533690845,AAS 10,A01,886199,Childs; Dennis R.,0,3,0,0
1746533691873,ANAR 104,A01,886940,Shtienberg; Gilad,27,0,30,3
1746533692900,ANAR 120,A00,886953,Staff,12,0,20,8
1746533693933,ANBI 148,A01,886955,Wilder; Linnea Lorene,30,0,40,10
1746533695986,ANSC 122,A00,886957,Staff,25,0,30,5
1746533697016,ANSC 150,A00,886958,Sloane; Julia Kathryn,3,0,15,12
1746533698042,ANSC 156,A00,886959,Jenkins; Janis A.,0,1,15,15
1746533699068,ANSC 180,A00,886960,Staff,11,0,17,6
1746533700097,ANSC 188,A00,886961,Jassal; Aftab,9,0,25,16
1746533701126,ANSC 190,A00,886962,Jassal; Aftab,14,0,25,11
1746533702154,ANSC 191,A00,886963,Staff,18,0,20,2
1746533703184,ANTH 3,A01,891689,Staff,17,0,20,3
1746533704210,ANTH 5,A00,886933,Semendeferi; Ekaterini,16,0,20,4
1746533705237,ANTH 10,A00,886934,Staff,0,12,30,30
1746533706266,ANTH 21,A01,886936,Staff,40,0,60,20
1746533707294,ANTH 23,A01,886938,Staff,92,0,100,8
1746533708322,ANTH 105,A00,886964,Stewart; Alexander B,84,0,100,16
1746533709350,ANTH 108,A00,886965,Pedersen; David,9,0,20,11
1746533710391,AWP 10,001,886147,Staff,0,0,0,0
1746533710391,AWP 10,002,886148,Staff,0,0,0,0
1746533710391,AWP 10,003,886149,Staff,0,0,0,0
1746533710391,AWP 10,004,886150,Staff,0,0,0,0
1746533710391,AWP 10,005,886151,Staff,0,0,0,0
1746533710391,AWP 10,006,886152,Staff,0,0,0,0
1746533710391,AWP 10,007,886153,Staff,0,0,0,0
1746533710391,AWP 10,008,886154,Staff,0,0,0,0
1746533710391,AWP 10,009,886155,Staff,0,0,0,0
1746533710391,AWP 10,010,886156,Staff,0,0,0,0
1746533710391,AWP 10,011,886158,Staff,0,0,0,0
1746533710391,AWP 10,012,886160,Staff,0,0,0,0
1746533710391,AWP 10,013,886161,Staff,0,0,0,0
1746533710391,AWP 10,014,886162,Staff,0,0,0,0
1746533710391,AWP 10,015,886163,Staff,0,0,0,0
1746533710391,AWP 10,016,886164,Staff,0,0,0,0
1746533710391,AWP 10,017,886165,Staff,0,0,0,0
1746533710391,AWP 10,018,886166,Staff,0,0,0,0
1746533710391,AWP 10,019,886168,Staff,0,0,0,0
1746533710391,AWP 10,020,886170,Staff,0,0,0,0
1746533710391,AWP 10,021,886172,Staff,0,0,0,0
1746533711427,AWP 10R,001,886173,Staff,0,1,0,0
1746533711427,AWP 10R,002,886174,Staff,0,1,0,0
1746533711427,AWP 10R,003,886175,Staff,0,0,0,0
1746533711427,AWP 10R,004,886176,Staff,0,0,0,0
1746533711427,AWP 10R,005,886177,Staff,0,0,0,0
1746533711427,AWP 10R,006,886178,Staff,0,0,0,0
1746533711427,AWP 10R,007,886179,Staff,0,0,0,0
1746533711427,AWP 10R,008,886181,Staff,0,0,0,0
1746533711427,AWP 10R,009,886182,Staff,0,0,0,0
1746533711427,AWP 10R,010,886183,Staff,0,0,0,0
1746533711427,AWP 10R,011,886184,Staff,0,0,0,0
1746533711427,AWP 10R,012,886185,Staff,0,0,0,0
1746533711427,AWP 10R,013,886186,Staff,0,0,0,0
1746533711427,AWP 10R,014,886187,Staff,0,0,0,0
1746533711427,AWP 10R,015,886188,Staff,0,0,0,0
1746533711427,AWP 10R,016,886189,Staff,0,0,0,0
1746533712452,AWP 102R,A00,886190,Staff,0,0,0,0
1746533712452,AWP 102R,B00,886191,Staff,0,0,0,0
1746533713478,BENG 100,A01,886193,Staff,17,0,30,13
1746533714508,BENG 122A,A01,886195,Hasty; Jeff M,13,0,30,17
1746533715537,BENG 166A,A00,886196,Sah; Robert Lie-Yuan,0,1,30,30
1746533716565,BENG 190,A00,958050,Khojah; Reem I,24,0,25,1
1746533717592,BIBC 102,A01,894320,Staff,0,0,46,46
1746533717592,BIBC 102,A02,894321,Staff,1,0,46,45
1746533717592,BIBC 102,A03,894344,Staff,7,0,46,39
1746533717592,BIBC 102,A04,894345,Staff,26,0,47,21
1746533718622,BICD 100R,A01,894365,Smith; Laurie,0,3,58,58
1746533718622,BICD 100R,A02,894366,Smith; Laurie,0,5,58,58
1746533718622,BICD 100R,A03,894367,Smith; Laurie,2,0,59,57
1746533718622,BICD 100R,A04,959869,Smith; Laurie,41,0,59,18
1746533719652,BICD 136,A01,894383,Gustafson-Brown; Cindy,14,0,50,36
1746533720679,BIEB 102,A01,894494,Butler; Shannon Rhey,51,0,130,79
1746533722734,BIEB 150,A01,894617,Wills; Christopher,3,0,20,17
1746533722734,BIEB 150,A02,894631,Wills; Christopher,3,0,20,17
1746533722734,BIEB 150,A03,894937,Wills; Christopher,4,0,20,16
1746533722734,BIEB 150,A04,894946,Wills; Christopher,5,0,20,15
1746533723764,BIEB 194,A00,906141,Kurle; Carolyn M.,6,0,20,14
1746533724791,BILD 1,A01,894154,Staff,2,0,19,17
1746533724791,BILD 1,A02,894155,Staff,14,0,19,5
1746533724791,BILD 1,A03,894160,Staff,13,0,19,6
1746533724791,BILD 1,A04,894161,Staff,15,0,18,3
1746533725821,BILD 2,A01,894168,Staff,0,0,50,50
1746533725821,BILD 2,A02,894169,Staff,0,0,50,50
1746533725821,BILD 2,A03,894179,Staff,4,0,50,46
1746533725821,BILD 2,A04,894203,Staff,27,0,50,23
1746533726849,BILD 3,A01,894213,Staff,22,0,31,9
1746533726849,BILD 3,A02,894214,Staff,26,0,31,5
1746533726849,BILD 3,A03,894235,Staff,28,0,31,3
1746533726849,BILD 3,A04,894236,Staff,28,0,32,4
1746533727878,BILD 4,A01,894253,Reuther; Keefe,5,0,24,19
1746533727878,BILD 4,A02,894258,Reuther; Keefe,16,0,24,8
1746533728904,BILD 5,A01,894276,Reuther; Keefe,35,0,50,15
1746533728904,BILD 5,A02,894277,Reuther; Keefe,45,0,50,5
1746533728904,BILD 5,A03,894290,Reuther; Keefe,44,0,50,6
1746533728904,BILD 5,A04,894291,Reuther; Keefe,48,0,50,2
1746533729934,BILD 24,A01,894297,Pirino; Giorgia,40,0,60,20
1746533730962,BIMM 100,B01,958915,Staff,72,0,100,28
1746533731990,BIMM 101,A01,895017,McDonnell; Lisa Marie,0,5,24,24
1746533731990,BIMM 101,A02,895018,McDonnell; Lisa Marie,0,5,24,24
1746533731990,BIMM 101,B01,895020,McDonnell; Lisa Marie,0,6,24,24
1746533731990,BIMM 101,B02,895021,McDonnell; Lisa Marie,0,4,24,24
1746533733019,BIMM 110,A01,895023,Staff,1,0,25,24
1746533733019,BIMM 110,A02,895024,Staff,9,0,25,16
1746533733019,BIMM 110,A03,895025,Staff,18,0,25,7
1746533733019,BIMM 110,A04,895031,Staff,20,0,25,5
1746533734048,BIMM 120,A01,895114,Gustafson-Brown; Cindy,13,0,28,15
1746533734048,BIMM 120,A02,895126,Gustafson-Brown; Cindy,20,0,27,7
1746533735074,BIPN 100,A01,895130,Yang; Mingyu,1,0,38,37
1746533735074,BIPN 100,A02,895131,Yang; Mingyu,32,0,38,6
1746533735074,BIPN 100,A03,895132,Yang; Mingyu,32,0,38,6
1746533735074,BIPN 100,A04,895133,Yang; Mingyu,27,0,36,9
1746533736100,BIPN 120,A01,895135,Cooke; James Edward,0,3,13,13
1746533736100,BIPN 120,A02,895136,Cooke; James Edward,0,1,13,13
1746533736100,BIPN 120,A03,895137,Cooke; James Edward,0,3,13,13
1746533736100,BIPN 120,A04,895156,Cooke; James Edward,0,2,11,11
1746533737128,BIPN 134,A01,895235,Cooke; James Edward,0,2,25,25
1746533737128,BIPN 134,A02,895237,Cooke; James Edward,0,0,25,25
1746533737128,BIPN 134,A03,895240,Cooke; James Edward,3,0,25,22
1746533737128,BIPN 134,A04,895270,Cooke; James Edward,20,0,25,5
1746533738160,BIPN 189,A00,892103,Staff,0,13,14,14
1746533740208,BISP 194,A00,958008,Staff,0,2,0,0
1746533741237,CAT 124,A01,922009,Staff,0,5,20,20
1746533742320,CAT 125R,A00,886390,Morales; Celeste Georgianna,0,2,20,20
1746533742320,CAT 125R,B00,886391,Irwin; Matthew Joseph,0,3,20,20
1746533742320,CAT 125R,C00,886392,Smith; Lauryn Alissa,0,2,20,20
1746533742320,CAT 125R,D00,886393,Vanderschuit; Maya Alysia,0,2,20,20
1746533742320,CAT 125R,E00,886394,Marchisotto; Jennifer Anne,0,4,20,20
1746533743346,CENG 15,A01,886218,Drews; Aaron,3,0,8,5
1746533744376,CENG 113,A00,886219,Opatkiewicz; Justin Paul,15,0,25,10
1746533745404,CGS 101,A00,887044,Staff,7,0,20,13
1746533746433,CGS 105,A01,887046,Staff,14,0,25,11
1746533747459,CGS 112,A00,887047,Cuong; Marisol,12,0,15,3
1746533748482,CGS 113,A00,887048,Staff,23,0,30,7
1746533749510,CGS 120,A00,887049,Staff,10,0,17,7
1746533750538,CHEM 6A,A01,886336,Lam; Tin Yiu,38,0,50,12
1746533750538,CHEM 6A,A02,886338,Lam; Tin Yiu,37,0,50,13
1746533751569,CHEM 6B,A01,886341,Hopkins; Patrycja Anna,16,0,50,34
1746533751569,CHEM 6B,A02,886343,Hopkins; Patrycja Anna,42,0,50,8
1746533752599,CHEM 6C,A01,886346,Albizati; Kim F.,0,2,50,50
1746533752599,CHEM 6C,A02,886348,Albizati; Kim F.,23,0,50,27
1746533753629,CHEM 40A,A01,886352,Klosterman; Jeremy K,65,0,100,35
1746533754659,CHEM 40B,A01,886356,Klosterman; Jeremy K,0,23,100,100
1746533755684,CHEM 41B,A01,886360,Theodorakis; Emmanuel,25,0,50,25
1746533755684,CHEM 41B,A02,886362,Theodorakis; Emmanuel,47,0,50,3
1746533756710,CHIN 165A,A00,886382,Xu; Li,18,0,20,2
1746533757735,CLAS 120,A00,886387,Myerston Santana; Jacobo,33,0,40,7
1746533758761,COGS 9,A01,886967,Shannon; Kyle Michael,42,0,60,18
1746533759794,COGS 11,A01,886969,Staff,11,0,30,19
1746533760821,COGS 14A,A01,886971,Staff,6,0,60,54
1746533761852,COGS 14B,A01,886973,Hoffman; Drew Ellen,4,0,60,56
1746533762882,COGS 18,A01,886975,Morgan; Eric,35,0,60,25
1746533763914,COGS 20,A01,886977,Staff,4,0,8,4
1746533763914,COGS 20,A02,886978,Staff,5,0,7,2
1746533764944,COGS 100,A01,907783,Staff,0,2,30,30
1746533765975,COGS 101B,A01,886980,Staff,0,3,48,48
1746533767002,COGS 101C,A01,886982,Delgado; Tania,0,5,44,44
1746533768030,COGS 102A,A01,886984,Johnson; Christine M.,4,0,30,26
1746533769060,COGS 118B,A01,886986,Staff,0,3,88,88
1746533770088,COGS 150,A01,886988,Bergen; Benjamin,23,0,50,27
1746533771115,COGS 153,A00,886989,Delgado; Tania,0,2,41,41
1746533772140,COGS 186,A01,886991,Staff,0,0,32,32
1746533773166,COGS 187A,A01,886993,Boyle; Mary E. T.,7,0,30,23
1746533774193,COGS 189,A00,886994,Staff,0,1,30,30
1746533775222,COMM 10,A01,886996,Staff,0,0,20,21
1746533775222,COMM 10,A02,886997,Staff,12,0,20,8
1746533775222,COMM 10,A03,959845,Staff,19,0,20,1
1746533776253,COMM 20,A01,886999,Leuning; Grant Maurstad,24,0,40,16
1746533778311,COMM 100A,A01,887002,Staff,0,0,20,25
1746533778311,COMM 100A,A02,887003,Staff,7,0,20,13
1746533779340,COMM 100B,A01,887005,Staff,0,8,20,24
1746533780369,COMM 106D,A00,887006,Staff,14,0,40,26
1746533781397,COMM 110G,A00,887007,Whitworth-Smith; Andrew C,12,0,40,28
1746533782424,COMM 111B,A00,887008,Staff,31,0,40,9
1746533783452,COMM 113T,A00,887009,Abuelhiga; Soraya Jill,28,0,40,12
1746533783452,COMM 113T,B00,906733,Staff,40,0,40,0
1746533784485,COMM 145,A00,887010,Staff,12,0,40,28
1746533785510,COMM 146,A00,887054,Staff,31,0,40,9
1746533786536,COMM 190,A00,887012,Staff,8,0,23,15
1746533787562,CSE 8A,A50,887015,Cao; Yingjun,57,0,85,28
1746533788591,CSE 11,A01,887017,Cao; Yingjun,12,0,70,58
1746533789622,CSE 20,A01,887019,Staff,30,0,50,20
1746533790652,CSE 21,A01,887021,Staff,78,0,100,22
1746533790652,CSE 21,B01,892583,Braun; Oliver,45,0,50,5
1746533791678,CSE 30,A01,887025,Eldon; John,143,0,200,57
1746533792707,CSE 100,A01,887027,Staff,26,0,50,24
1746533792707,CSE 100,A02,887028,Staff,40,0,50,10
1746533793742,CSE 101,A01,887030,Braun; Oliver,75,0,100,25
1746533793742,CSE 101,B01,887032,Jones; Miles E,0,3,50,50
1746533793742,CSE 101,B02,887033,Jones; Miles E,0,1,50,50
1746533794776,CSE 105,A01,908084,Jones; Miles E,32,0,50,18
1746533794776,CSE 105,A02,908087,Jones; Miles E,33,0,50,17
1746533795803,CSE 135,A01,887035,Powell; Thomas Allan,0,4,50,50
1746533796834,CSE 142,A01,887037,Staff,8,0,60,52
1746533797860,CSE 142L,A01,887039,Staff,34,0,60,26
1746533798890,CSE 151A,A01,887041,Solares; Edwin A,48,0,100,52
1746533799917,CSE 175,A01,887043,Kumar; Rakesh,30,0,30,0
1746533800943,CSS 1,A01,886389,Staff,0,1,40,40
1746533801969,DSC 30,A01,908097,Liao; Soohyun Nam,47,0,75,28
1746533802998,DSC 40A,A01,908099,Shannon; Kyle Michael,30,0,50,20
1746533804025,DSC 40B,A01,908112,Staff,16,0,50,34
1746533805050,DSC 80,A01,908116,Staff,19,0,60,41
1746533806076,DSC 197,001,956863,Eldridge; Justin Matthew,9999,0,9999,0
1746533807105,ECE 5,A01,886400,Morris; Karcher William,2,0,6,4
1746533807105,ECE 5,A02,886401,Morris; Karcher William,3,0,6,3
1746533808135,ECE 148,A01,886403,Silberman; Jack,0,14,14,14
1746533809167,ECON 1,A01,887265,Crane; Meredith Helen,12,0,70,58
1746533809167,ECON 1,B01,887268,Staff,43,0,50,7
1746533810195,ECON 2,A01,887273,Crane; Meredith Helen,56,0,70,14
1746533811223,ECON 3,A01,887279,Rondina; Giacomo,32,0,70,38
1746533812253,ECON 4,A01,887282,Anderson; John Charles,0,2,10,10
1746533813281,ECON 5,A01,887285,Staff,33,0,45,12
1746533813281,ECON 5,B01,887292,Staff,41,0,45,4
1746533814314,ECON 100A,A01,887337,Newhouse; Herbert S,54,0,70,16
1746533814314,ECON 100A,B01,887349,Staff,45,0,50,5
1746533815346,ECON 100B,A01,887361,Du; Songzi,29,0,70,41
1746533816372,ECON 100C,A01,887445,Newhouse; Herbert S,59,0,70,11
1746533817400,ECON 105,A00,887488,Vespa; Emanuel Ignacio,23,0,35,12
1746533818427,ECON 109,A01,887506,Shishkin; Denis,28,0,35,7
1746533819465,ECON 110A,A01,887568,Alon; Titan Michael,0,3,35,35
1746533819465,ECON 110A,B01,907601,Alon; Titan Michael,20,0,35,15
1746533820492,ECON 110B,A01,887598,Levkoff; Steven B.,0,23,70,70
1746533821516,ECON 112,A00,887599,Rondina; Giacomo,19,0,35,16
1746533822545,ECON 120A,A01,887603,Dai; Yinlin,36,0,70,34
1746533823574,ECON 120C,A01,887608,Sun; Yixiao,0,1,35,35
1746533823574,ECON 120C,B01,887614,Sun; Yixiao,0,0,35,35
1746533824601,ECON 138,A00,887621,Bharadwaj; Prashant,0,20,20,20
1746533825628,ECON 144,A00,958007,Squires; Dale E,13,0,35,22
1746533826658,ECON 171,A01,907666,Staff,18,0,35,17
1746533827685,ECON 175,A00,887626,Wu; Pak Yeung,23,0,35,12
1746533828711,ECON 190,A00,887640,Vespa; Emanuel Ignacio,23,0,35,12
1746533829756,EDS 25,A01,888197,Staff,0,0,0,0
1746533829756,EDS 25,A02,888209,Staff,0,0,0,0
1746533829756,EDS 25,A03,888210,Staff,0,0,0,0
1746533829756,EDS 25,A04,888212,Staff,0,0,0,0
1746533829756,EDS 25,A05,888213,Staff,0,0,0,0
1746533829756,EDS 25,A06,888214,Staff,0,0,0,0
1746533829756,EDS 25,A07,888235,Staff,0,2,0,0
1746533829756,EDS 25,A08,888236,Staff,0,0,0,0
1746533829756,EDS 25,A09,888240,Staff,0,0,0,0
1746533829756,EDS 25,A10,888244,Staff,0,0,0,0
1746533829756,EDS 25,B01,888273,Staff,0,0,0,0
1746533829756,EDS 25,B02,888285,Staff,0,0,0,0
1746533829756,EDS 25,B03,888423,Staff,0,0,0,1
1746533829756,EDS 25,B04,888432,Staff,0,0,0,0
1746533829756,EDS 25,B05,888433,Staff,0,0,0,0
1746533829756,EDS 25,B06,888467,Staff,0,0,0,0
1746533829756,EDS 25,B07,888468,Staff,0,0,0,0
1746533829756,EDS 25,B08,888479,Staff,0,0,0,0
1746533829756,EDS 25,B09,888484,Staff,0,0,0,0
1746533829756,EDS 25,B10,888487,Staff,0,0,0,0
1746533830785,EDS 38,A01,907700,Choi; Bailey Miyeon,30,0,30,0
1746533831812,EDS 112,A01,888601,Chapman; Thandeka K,14,0,40,26
1746533832843,EDS 115,A00,888697,Mendez; Kathrina Mendoza,10,0,30,20
1746533833870,EDS 116,A01,888893,Staff,35,0,40,5
1746533835922,EDS 124AR,A00,889133,Staff,29,0,50,21
1746533835922,EDS 124AR,B00,907471,Simon; Elizabeth A,37,0,50,13
1746533836948,EDS 124BR,A00,889134,Simon; Elizabeth A,45,0,100,55
1746533837974,EDS 125,A00,889135,Staff,25,0,30,5
1746533838999,EDS 126,A01,889138,Staff,36,0,40,4
1746533840029,EDS 164R,A01,889142,Wishard Guerra; Alison G.,33,0,50,17
1746533841057,ENG 30,A01,886396,Staff,0,0,0,0
1746533841057,ENG 30,B01,886398,Staff,0,0,0,0
1746533842083,ENVR 102,A00,906150,Montejo; Carolina,23,0,25,2
1746533843115,ETHN 103A,A00,887236,Man; Simeon S,0,3,0,0
1746533844145,ETHN 113,A00,887239,Staff,16,0,30,14
1746533845171,ETHN 116,A00,887240,Staff,16,0,25,9
1746533846251,ETHN 117,A00,887241,Choi; Esther Min,28,0,30,2
1746533847279,ETHN 118,A00,887243,Staff,24,0,30,6
1746533848305,ETHN 127,A00,887248,Cuong; Marisol,11,0,15,4
1746533849329,ETHN 139,A00,887250,Staff,7,0,10,3
1746533850355,ETHN 142,A00,887252,Staff,10,0,30,20
1746533851381,ETHN 161,A00,887253,Browne; Errol Tsekani,24,0,30,6
1746533852409,ETHN 163FR,A00,887255,Burelle; Julie Sara Veronique,0,0,5,5
1746533853435,GLBH 20,A00,889149,Elwardani; Nile Regina,8,0,42,34
1746533855484,GLBH 111,A01,889152,Burgos; Jose L.,17,0,17,0
1746533856515,GLBH 150,A00,889181,Sloane; Julia Kathryn,0,5,15,15
1746533858568,HDS 60,A01,886406,Warstadt; Melissa Fawn,73,0,80,7
1746533859598,HIAF 111,A00,889324,Gyamfi; Bright,25,0,32,7
1746533860625,HIEA 131,A00,889328,Staff,16,0,32,16
1746533861652,HIEA 144,A00,889333,Henry; Todd A.,26,0,32,6
1746533862678,HIEA 154,A00,889336,Henry; Todd A.,24,0,32,8
1746533863703,HIEU 106,A00,889339,Staff,22,0,32,10
1746533865755,HIEU 114,A00,889340,Staff,3,0,32,29
1746533866783,HIEU 135GS,A00,889342,Patterson; Patrick H.,0,0,1,24
1746533867812,HIEU 137,A00,889343,Edington; Claire Ellen,9,0,25,16
1746533868837,HIEU 148,A00,889345,Staff,14,0,32,18
1746533869862,HIEU 154,A00,889346,Biess; Frank Peter,21,0,32,11
1746533870888,HILA 102,A00,889351,Staff,12,0,32,20
1746533871914,HILD 2A,A01,889221,Lewandoski; Julia Mavis,1,10,32,31
1746533872944,HILD 7B,A01,889225,Man; Simeon S,0,13,32,32
1746533873974,HILD 7C,A01,889288,Alvarez; Luis A,0,14,32,32
1746533874998,HILD 30,A01,889323,Staff,0,5,32,32
1746533877051,HISC 119,A00,889383,Golan; Tal,21,0,32,11
1746533878076,HIUS 103,A00,889384,Man; Simeon S,0,0,32,32
1746533879105,HIUS 117,A00,919797,Kwak; Nancy,18,0,32,14
1746533880131,HIUS 142A,A00,919788,Staff,22,0,32,10
1746533882186,HIUS 149,A00,889386,Gyamfi; Bright,27,0,32,5
1746533883212,HIUS 155,A00,889387,Alvarez; Luis A,14,0,32,18
1746533884241,HUM 3,A01,886499,Caldwell; Michael Alan,19,0,50,31
1746533885265,HUM 3GS,A00,886500,Rodriguez; Bretton Sigfred,0,0,0,28
1746533886294,HUM 3R,A01,886502,Markman; Kristina,0,36,50,50
1746533887320,HUM 4,A01,886504,Crum; Matthew Stephen,24,0,50,26
1746533887320,HUM 4,B01,886506,West; Geoffrey Scott,17,0,50,33
1746533888347,HUM 4GS,A00,886507,Staff,0,0,0,19
1746533889372,HUM 5,A01,886509,Staff,32,0,50,18
1746533890397,HUM 5R,A01,886511,Zavodny; Tatiana Sophia,0,39,50,50
1746533891425,JAPN 180,A00,886407,Staff,18,0,40,22
1746533892452,LATI 50,A01,886409,Martin-Cabrera; Luis,4,0,22,18
1746533892452,LATI 50,A02,886410,Martin-Cabrera; Luis,19,0,22,3
1746533892452,LATI 50,A03,886411,Martin-Cabrera; Luis,21,0,22,1
1746533892452,LATI 50,A04,886412,Martin-Cabrera; Luis,9,0,22,13
1746533893482,LAWS 101,A00,907664,Staff,28,0,60,32
1746533894506,LIAB 1A,A00,889388,Saab; Dima,17,0,20,3
1746533895534,LIAB 1AX,A00,889389,El Cheddadi; Youniss,17,0,20,3
1746533896566,LIFR 1C,A00,889391,Van Moer; Vinciane G,8,0,20,12
1746533897597,LIFR 1CX,A00,889392,Van Moer; Vinciane G,7,0,20,13
1746533898623,LIFR 1D,A00,889393,Van Moer; Vinciane G,7,0,20,13
1746533899652,LIFR 1DX,A00,889394,Van Moer; Vinciane G,8,0,20,12
1746533900681,LIGN 7,A00,886923,Staff,24,0,50,26
1746533901706,LIGN 17,A00,886924,Kehler; Andrew Scott,125,0,150,25
1746533902734,LTAM 110,A00,889395,Staff,15,0,30,15
1746533903757,LTAM 110GS,A00,958010,Rodriguez; Bretton Sigfred,0,0,0,28
1746533904785,LTCH 101,A00,889397,Staff,23,0,25,2
1746533905811,LTCS 130,A00,889398,Staff,23,0,25,2
1746533906836,LTEA 138,A00,889399,Staff,24,0,40,16
1746533907862,LTEN 149,A00,889400,Wesling; Megan E.,0,3,25,25
1746533908887,LTEN 169,A00,889401,Staff,20,0,25,5
1746533909916,LTEN 180,A00,889402,Staff,10,0,15,5
1746533910942,LTEN 181,A00,889403,Staff,21,0,25,4
1746533911969,LTWL 100,A00,889404,Myerston Santana; Jacobo,3,0,25,22
1746533912997,LTWL 180GS,A00,889405,Staff,0,0,20,20
1746533914026,LTWL 181,A00,889406,Staff,17,0,25,8
1746533915054,LTWL 184,A00,889475,Mukherjee; Silpa,22,0,25,3
1746533916080,LTWR 102C,A00,889486,Staff,29,0,30,1
1746533917106,LTWR 115W,A00,889491,Staff,0,2,15,15
1746533918133,MAE 8,A01,886905,Staff,0,2,0,0
1746533919165,MAE 11,A00,886906,Bandaru; Prabhakar,0,7,50,50
1746533920195,MAE 20,A00,886907,Evdokimenko; Ekaterina,44,0,70,26
1746533921222,MAE 30B,A00,886909,Ghazinejad; Maziar,26,0,45,19
1746533922251,MAE 101B,A00,886910,Saintillan; David,29,0,45,16
1746533923278,MAE 105,A00,886911,Bandaru; Prabhakar,18,0,50,32
1746533924305,MAE 107,B00,958024,Staff,9,0,50,41
1746533925337,MAE 143B,A00,886913,Bewley; Thomas R,7,0,40,33
1746533926363,MAE 148,A01,886915,Silberman; Jack,0,3,14,14
1746533927392,MAE 160,A00,886916,Evdokimenko; Ekaterina,31,0,60,29
1746533928420,MATH 3C,A01,889681,Staff,0,3,30,30
1746533928420,MATH 3C,A02,960048,Staff,25,0,30,5
1746533929452,MATH 10A,A01,889760,Staff,26,0,30,4
1746533929452,MATH 10A,A02,889783,Staff,29,0,30,1
1746533930479,MATH 10B,A01,889785,Verstraete; Jacques Allan,2,0,35,33
1746533930479,MATH 10B,A02,889795,Verstraete; Jacques Allan,4,0,35,31
1746533930479,MATH 10B,B01,889797,Verstraete; Jacques Allan,3,0,35,32
1746533930479,MATH 10B,B02,889828,Verstraete; Jacques Allan,3,0,35,32
1746533931513,MATH 10C,A01,889849,Habib; Yousaf,9,0,30,21
1746533931513,MATH 10C,A02,889852,Habib; Yousaf,14,0,30,16
1746533931513,MATH 10C,A03,889853,Habib; Yousaf,22,0,30,8
1746533931513,MATH 10C,A04,889858,Habib; Yousaf,20,0,30,10
1746533931513,MATH 10C,B01,889861,Staff,1,0,30,29
1746533931513,MATH 10C,B02,889862,Staff,24,0,30,6
1746533931513,MATH 10C,B03,889863,Staff,27,0,30,3
1746533931513,MATH 10C,B04,889967,Staff,23,0,30,7
1746533932548,MATH 18,A01,889974,Staff,7,0,30,23
1746533932548,MATH 18,A02,889977,Staff,20,0,30,10
1746533932548,MATH 18,B01,889984,Hardiman; Liam,22,0,30,8
1746533932548,MATH 18,B02,889985,Hardiman; Liam,25,0,30,5
1746533933577,MATH 20A,A01,889990,Suk; Andrew Hoon,29,0,35,6
1746533934605,MATH 20B,A01,889993,Ohm; Ko Woon,22,0,30,8
1746533934605,MATH 20B,A02,889994,Ohm; Ko Woon,30,0,30,0
1746533934605,MATH 20B,B01,889996,Ohm; Ko Woon,21,0,30,9
1746533934605,MATH 20B,B02,889997,Ohm; Ko Woon,23,0,30,7
1746533935632,MATH 20C,A01,889999,Hammock; Frances H,17,0,30,13
1746533935632,MATH 20C,A02,890003,Hammock; Frances H,23,0,30,7
1746533935632,MATH 20C,B01,890006,Hammock; Frances H,3,0,30,27
1746533935632,MATH 20C,B02,890007,Hammock; Frances H,11,0,30,19
1746533936665,MATH 20D,A01,890011,Cheng; Hsiao-Bing,1,1,30,29
1746533936665,MATH 20D,A02,890012,Cheng; Hsiao-Bing,14,0,30,16
1746533936665,MATH 20D,B01,890016,Cheng; Hsiao-Bing,13,0,30,17
1746533936665,MATH 20D,B02,890017,Cheng; Hsiao-Bing,13,0,30,17
1746533937700,MATH 20E,A01,890026,Harel; Guershon,1,0,30,29
1746533937700,MATH 20E,A02,890029,Harel; Guershon,23,0,30,7
1746533937700,MATH 20E,B01,890033,Harel; Guershon,7,0,30,23
1746533937700,MATH 20E,B02,890101,Harel; Guershon,21,0,30,9
1746533938729,MATH 102,A01,890104,Staff,17,0,30,13
1746533938729,MATH 102,A02,890105,Staff,27,0,30,3
1746533939758,MATH 103B,A01,890116,Salehi Golsefidy; Alireza,3,0,30,27
1746533939758,MATH 103B,B01,890118,Staff,0,3,34,34
1746533940786,MATH 109,A01,890121,Aliabadi Sr.; Mohsen,1,0,30,29
1746533940786,MATH 109,B01,890124,Upadrashta; Pranav Kumar,18,0,30,12
1746533941812,MATH 120A,A01,890126,Eggers; John Dietrich,13,0,30,17
1746533942838,MATH 142B,A01,890128,Ioana; Adrian,19,0,30,11
1746533942838,MATH 142B,A02,890129,Ioana; Adrian,13,0,30,17
1746533943863,MATH 154,A01,890174,Staff,0,0,30,30
1746533943863,MATH 154,A02,890182,Staff,0,0,30,30
1746533944887,MATH 168A,A01,890197,Dumitriu; Ioana,21,0,35,14
1746533945916,MATH 170A,A01,890240,Nie; Jiawang,1,0,30,29
1746533945916,MATH 170A,A02,890241,Nie; Jiawang,11,0,30,19
1746533945916,MATH 170A,A03,890249,Nie; Jiawang,23,0,30,7
1746533946947,MATH 170B,A01,957891,Nag; Panchali,13,0,35,22
1746533949010,MATH 181A,A01,908025,Staff,0,4,35,35
1746533949010,MATH 181A,A02,960115,Staff,27,0,35,8
1746533950094,MATH 181B,A01,959874,Staff,26,0,30,4
1746533951123,MATH 193B,A01,890265,Staff,0,4,35,35
1746533952153,MGT 4,A01,890311,Anderson; John Charles,42,0,88,46
1746533953182,MGT 5,A00,907740,Staff,13,0,98,85
1746533954209,MGT 12,A00,890312,Lindenberger; Wade Douglas,67,0,98,31
1746533955233,MGT 16,A00,957883,Staff,78,0,98,20
1746533957294,MGT 45,A00,890314,Pecore; Joseph P.,47,0,98,51
1746533958323,MGT 71,A00,890315,Staff,0,11,98,98
1746533959350,MGT 100,A00,890316,Yavorsky; Daniel Ryan,44,0,98,54
1746533960380,MGT 103,A00,890317,Ehrich; Kristine R,73,0,98,25
1746533961408,MGT 105,A00,890356,Bates; Kenneth Walter,0,7,98,98
1746533962433,MGT 112,A00,890360,Ehrich; Kristine R,55,0,98,43
1746533963459,MGT 127R,A00,907732,Zhu; Kevin Xiaoguo,23,0,98,75
1746533964486,MGT 131B,A00,890361,Anderson; John Charles,61,0,98,37
1746533965513,MGT 137,A00,890362,Lindenberger; Wade Douglas,65,0,98,33
1746533966543,MGT 160,A00,890369,Johnson; Erik Barry,9,0,98,89
1746533968601,MGT 164,A00,890372,Zimmermann; Carsten,0,39,98,98
1746533969630,MGT 180,A00,890374,Bliss; Barbara Ann,12,0,98,86
1746533970663,MMW 15,A01,886414,Chang; Edmond Yi-Teh,0,12,28,28
1746533970663,MMW 15,A02,886415,Chang; Edmond Yi-Teh,0,8,28,28
1746533970663,MMW 15,A03,886416,Chang; Edmond Yi-Teh,0,8,28,28
1746533970663,MMW 15,A04,886417,Chang; Edmond Yi-Teh,0,8,28,28
1746533970663,MMW 15,B01,886419,Chang; Edmond Yi-Teh,0,7,28,28
1746533970663,MMW 15,B02,886420,Chang; Edmond Yi-Teh,0,8,28,28
1746533970663,MMW 15,B03,886421,Chang; Edmond Yi-Teh,0,7,28,28
1746533970663,MMW 15,B04,886422,Chang; Edmond Yi-Teh,0,8,28,28
1746533970663,MMW 15,C01,886424,Staff,0,9,28,28
1746533970663,MMW 15,C02,886425,Staff,0,8,28,28
1746533970663,MMW 15,C03,886426,Staff,0,8,28,28
1746533970663,MMW 15,C04,886427,Staff,0,7,28,28
1746533970663,MMW 15,C05,958038,Staff,0,7,28,28
1746533970663,MMW 15,C06,958039,Staff,0,8,28,28
1746533971690,MMW 15GS,A00,906910,Patterson; Patrick H.,4,0,28,24
1746533972715,MMW 122R,A01,886429,Rahimi; Babak,0,13,28,28
1746533972715,MMW 122R,A02,886430,Rahimi; Babak,0,12,28,28
1746533972715,MMW 122R,A03,958040,Rahimi; Babak,0,11,28,28
1746533973743,MUS 1A,A01,890937,Staff,3,0,25,22
1746533973743,MUS 1A,A02,891035,Staff,6,0,25,19
1746533973743,MUS 1A,C01,958912,Staff,24,0,25,1
1746533973743,MUS 1A,C02,958913,Staff,25,0,25,0
1746533975801,MUS 2AK,A00,957092,Ohnishi; Takae,15,0,15,0
1746533976830,MUS 4,A01,891044,Staff,2,0,25,23
1746533976830,MUS 4,A02,891045,Staff,23,0,25,2
1746533976830,MUS 4,B01,891048,Staff,17,0,25,8
1746533976830,MUS 4,B02,891050,Staff,25,0,25,0
1746533977859,MUS 5,A01,957506,Dubnov; Shlomo,0,0,25,25
1746533977859,MUS 5,A02,957622,Dubnov; Shlomo,14,0,25,11
1746533977859,MUS 5,A03,957623,Dubnov; Shlomo,20,0,25,5
1746533978885,MUS 6,A01,891053,Freitas Caetano; Marcelo,24,0,25,1
1746533978885,MUS 6,A02,891054,Freitas Caetano; Marcelo,23,0,25,2
1746533979916,MUS 7,A01,891081,Staff,0,0,25,25
1746533979916,MUS 7,A02,891082,Staff,4,0,25,21
1746533980946,MUS 8GS,A00,891118,Borgo; David Garcia,0,0,25,25
1746533981974,MUS 11,A01,891140,Staff,11,0,25,14
1746533981974,MUS 11,A02,891141,Staff,22,0,25,3
1746533983000,MUS 13,A01,891143,Staff,8,0,25,17
1746533983000,MUS 13,A02,891144,Staff,24,0,25,1
1746533984031,MUS 15,A01,891146,Staff,9,0,25,16
1746533984031,MUS 15,A02,891148,Staff,21,0,25,4
1746533984031,MUS 15,B01,891150,Staff,18,0,25,7
1746533984031,MUS 15,B02,891151,Staff,25,0,25,0
1746533985060,MUS 20,A01,891153,Staff,5,0,20,15
1746533985060,MUS 20,A02,891155,Staff,14,0,20,6
1746533986087,MUS 80,A00,891156,Staff,19,0,25,6
1746533986087,MUS 80,B00,891157,Staff,23,0,25,2
1746533987115,MUS 130,A00,891158,Ohnishi; Takae,35,0,35,0
1746533988140,MUS 150GS,A01,891160,Borgo; David Garcia,0,0,25,25
1746533989170,MUS 170,A01,891162,Freitas Caetano; Marcelo,20,0,25,5
1746533989170,MUS 170,A02,891164,Freitas Caetano; Marcelo,21,0,25,4
1746533990204,NANO 11,A00,886220,Vazquez Mena; Oscar,13,0,15,2
1746533991235,NANO 15,A01,886222,Drews; Aaron,4,0,7,3
1746533992260,NANO 104,A00,886224,Sirbuly; Donald,18,0,25,7
1746533993291,PH 40,A00,886528,Staff,23,0,40,17
1746533994321,PH 45,A01,886799,Staff,35,0,40,5
1746533995353,PH 110,A00,886802,Staff,0,7,40,40
1746533996378,PH 172,A00,906716,Staff,19,0,35,16
1746533997404,PH 191,A00,886803,Staff,6,0,40,34
1746533998430,PHIL 1,A00,889500,Staff,19,0,30,11
1746533999462,PHIL 10,A01,889549,Grush; Rick Scott,15,0,22,7
1746533999462,PHIL 10,A02,889551,Grush; Rick Scott,22,0,22,0
1746534000489,PHIL 28,A01,889559,Lamey; Andy M.,0,1,31,31
1746534000489,PHIL 28,A02,889561,Lamey; Andy M.,0,1,30,30
1746534000489,PHIL 28,A03,889572,Lamey; Andy M.,0,0,30,30
1746534001516,PHIL 35,A00,907839,Staff,13,0,15,2
1746534002543,PHIL 60,A00,889574,Staff,74,0,90,16
1746534003569,PHIL 101,A00,958004,Staff,13,0,15,2
1746534005622,PHIL 136,A00,889582,Fulkerson; Matthew Todd,26,0,45,19
1746534006651,PHIL 163,A01,889601,Staff,21,0,30,9
1746534006651,PHIL 163,B01,889606,Brandt; Reuven A,0,3,0,0
1746534007678,PHIL 164,A00,889610,Staff,16,0,30,14
1746534008703,PHIL 165,A00,889613,Staff,23,0,30,7
1746534009731,PHYS 1A,A00,886431,Staff,26,0,70,44
1746534010763,PHYS 1AL,001,886432,Tsai; Philbert S,0,2,30,30
1746534010763,PHYS 1AL,002,886436,Tsai; Philbert S,11,0,30,19
1746534011790,PHYS 1B,A00,886439,Staff,185,0,240,55
1746534012822,PHYS 1BL,001,886441,Tsai; Philbert S,0,4,30,30
1746534012822,PHYS 1BL,002,886444,Tsai; Philbert S,2,0,30,28
1746534013853,PHYS 1C,A00,896092,Arnold; Kam S,78,0,146,68
1746534014880,PHYS 1CL,001,886448,Tsai; Philbert S,0,0,30,30
1746534014880,PHYS 1CL,002,886449,Tsai; Philbert S,0,0,30,30
1746534014880,PHYS 1CL,003,886450,Tsai; Philbert S,15,0,30,15
1746534014880,PHYS 1CL,004,886451,Tsai; Philbert S,15,0,30,15
1746534015907,PHYS 2B,A01,886457,Staff,69,0,115,46
1746534016938,PHYS 2C,A01,886460,Shotwell; Brian,0,8,65,65
1746534017963,PHYS 2CL,A01,886467,Staff,0,4,28,28
1746534017963,PHYS 2CL,A02,886468,Staff,0,3,28,28
1746534018996,PHYS 2D,A01,886470,Staff,10,0,50,40
1746534020028,PHYS 4B,A01,886475,Grinstein; Benjamin,22,0,40,18
1746534021055,POLI 5,A00,891173,Desposato; Scott,7,0,25,18
1746534022083,POLI 5D,A01,891175,Staff,5,0,5,0
1746534022083,POLI 5D,B01,891178,Staff,5,0,5,0
1746534023112,POLI 11,A00,891179,Ferree; Karen E,2,0,35,33
1746534024139,POLI 12,A00,891180,Staff,16,0,30,14
1746534025166,POLI 27,A01,891182,Staff,12,0,75,63
1746534026192,POLI 30,A00,891183,Staff,9,0,50,41
1746534027222,POLI 100B,A00,891244,Staff,5,1,35,30
1746534028249,POLI 100I,A00,891247,Staff,7,0,30,23
1746534029275,POLI 104J,A00,891248,Nichter; Maysa,14,0,30,16
1746534030303,POLI 104U,A00,891250,Nichter; Maysa,2,0,30,28
1746534032354,POLI 110B,A00,891255,Wiens; David,20,0,25,5
1746534033380,POLI 112A,A00,891256,Wiens; David,6,0,25,19
1746534034405,POLI 114BR,A00,891261,Staff,19,0,30,11
1746534035430,POLI 117R,A00,891262,Forman; Fonna,0,6,50,50
1746534036458,POLI 118,A00,891264,Ingham; Sean,17,0,25,8
1746534037484,POLI 124A,A00,891265,Staff,18,0,20,2
1746534038510,POLI 125D,A00,891266,Nichter; Simeon C,2,0,25,23
1746534039537,POLI 126,A00,891268,Nichter; Simeon C,7,0,25,18
1746534040564,POLI 126AA,A00,891272,Staff,18,0,25,7
1746534041589,POLI 130AA,A00,891273,Staff,15,0,20,5
1746534042618,POLI 134AA,A00,891274,Staff,4,0,20,16
1746534044676,POLI 138,A00,891278,Staff,21,0,25,4
1746534045704,POLI 142K,A00,891280,Staff,11,0,25,14
1746534046731,POLI 142M,A00,891281,Gartzke; Erik,17,0,30,13
1746534047758,POLI 142P,A00,891284,Staff,20,0,30,10
1746534048782,POLI 143,A00,891285,Gartzke; Erik,12,0,30,18
1746534049809,POLI 153,A00,891286,Staff,19,0,20,1
1746534051861,POLI 175,A00,891290,Staff,15,0,20,5
1746534052889,PSYC 1,A00,890674,Steiner; Eric Tomas,0,11,45,45
1746534053976,PSYC 2,A00,890676,Albright; Thomas D,21,0,35,14
1746534055007,PSYC 3,A00,890679,Staff,17,0,20,3
1746534056035,PSYC 6,A00,959858,Staff,20,0,20,0
1746534057066,PSYC 60,A01,890684,Rickard; Timothy C.,0,5,45,45
1746534058097,PSYC 70,A01,890689,Geller; Emma Harlan,7,0,30,23
1746534059128,PSYC 71,A01,959860,Staff,21,0,25,4
1746534060160,PSYC 100,A00,890690,Lacefield; Katharine I,0,50,180,180
1746534061185,PSYC 102,A00,890695,Staff,18,0,40,22
1746534062211,PSYC 105,A00,890699,Geller; Emma Harlan,71,0,100,29
1746534063256,PSYC 106,A00,890701,Gorman; Michael R.,5,0,30,25
1746534064282,PSYC 108,A00,890704,Adrian; Julia Anna,0,28,50,50
1746534065313,PSYC 118,A01,890712,Staff,11,0,30,19
1746534066340,PSYC 124,A00,890716,Chapman; Eddie Nathaniel,25,0,60,35
1746534067365,PSYC 131,A00,890717,Anagnostaras; Stephan,0,7,80,80
1746534068396,PSYC 137,A00,890719,Winkielman; Piotr,0,11,30,30
1746534069420,PSYC 144,A00,890721,Adrian; Julia Anna,0,9,45,45
1746534070447,PSYC 162,A00,890805,Staff,2,0,75,73
1746534071474,PSYC 169,A00,890810,Staff,0,15,30,30
1746534072505,PSYC 172,A00,890814,Gorman; Michael R.,9,0,30,21
1746534073530,PSYC 181,A00,890818,Anagnostaras; Stephan,8,0,200,192
1746534074558,PSYC 184,A00,959861,Staff,170,0,175,5
1746534075584,PSYC 189,A00,890823,Staff,0,1,30,30
1746534076609,PSYC 191,A00,890884,Rickard; Timothy C.,0,11,35,35
1746534077641,PSYC 193,A00,890913,Staff,19,0,30,11
1746534077641,PSYC 193,B00,890914,Chapman; Eddie Nathaniel,24,0,30,6
1746534078674,PSYC 193L,A01,890918,Lowe; Angela Beth,20,0,30,10
1746534078674,PSYC 193L,B01,890921,Hurwitz; Ethan Scott,20,0,30,10
1746534078674,PSYC 193L,C01,890928,Staff,30,0,30,0
1746534079702,RELI 149,A00,886806,Rahimi; Babak,23,0,40,17
1746534080729,SE 9,A01,886814,Staff,7,0,20,13
1746534081764,SE 101B,A01,886816,Chadha; Mayank,4,0,35,31
1746534082798,SE 110B,A00,886818,Zhu; Qiang,4,0,75,71
1746534083824,SE 125,A01,886830,Staff,10,0,30,20
1746534084852,SE 130B,A01,886835,Staff,14,0,40,26
1746534085882,SE 131A,A01,886838,Krysl; Petr,34,0,55,21
1746534086910,SE 154,A00,886840,Staff,30,0,50,20
1746534087940,SE 164GS,A01,886849,Staff,6,0,20,14
1746534088966,SE 167GS,A01,886853,Staff,6,0,20,14
1746534089999,SIO 25,A01,890107,Staff,19,0,30,11
1746534091025,SIO 45,A00,890109,Cook; Geoffrey W,117,0,200,83
1746534092055,SIO 109R,A00,890110,Forman; Fonna,0,16,20,20
1746534093084,SIO 187,A01,890114,Kacev; David,15,0,40,25
1746534094119,SOCI 1,A01,890431,Thorpe; Charles Robert,15,0,30,15
1746534094119,SOCI 1,A02,890518,Thorpe; Charles Robert,30,0,30,0
1746534095147,SOCI 2,A01,957978,Staff,25,0,25,0
1746534095147,SOCI 2,A02,957979,Staff,23,0,25,2
1746534096175,SOCI 20,A01,890523,Calderon-Zaks; Michael Aar,23,0,30,7
1746534096175,SOCI 20,A02,890526,Calderon-Zaks; Michael Aar,29,0,30,1
1746534097207,SOCI 30,A01,890533,Pardo Guerra; Juan Pablo,37,0,40,3
1746534098233,SOCI 40,A01,890535,Staff,27,0,45,18
1746534099264,SOCI 104Q,A00,890559,Staff,18,0,30,12
1746534100294,SOCI 106,A00,890560,Arnal; Maud Marie Leonie,20,0,30,10
1746534101324,SOCI 110,A00,890567,Holkenbrink-Monk; Charlene,19,0,30,11
1746534102356,SOCI 112,A00,890568,Victoria Torres; Pablo,1,0,55,54
1746534103383,SOCI 115,A00,890597,Arnal; Maud Marie Leonie,28,0,45,17
1746534105440,SOCI 121,A00,890604,Pardo Guerra; Juan Pablo,38,0,45,7
1746534106467,SOCI 126,A01,890608,Staff,8,0,10,2
1746534107491,SOCI 127,A00,890609,Staff,18,0,30,12
1746534108521,SOCI 131,A00,890610,Thorpe; Charles Robert,37,0,45,8
1746534109547,SOCI 135,A00,890615,Payne; Christine Anna,14,0,45,31
1746534110572,SOCI 139,A00,890620,Staff,38,0,45,7
1746534111602,SOCI 148E,A00,890622,Calderon-Zaks; Michael Aar,36,0,45,9
1746534112628,SOCI 150,A00,890623,Kohler; Kristopher M.,31,0,45,14
1746534113654,SOCI 157,A00,890625,Jules-Rosette; Bennetta W.,18,0,20,2
1746534114680,SOCI 160,A00,890627,Payne; Christine Anna,21,0,45,24
1746534115711,SYN 1,A00,886855,Fish; Gwendolyn Anne,0,0,0,0
1746534115711,SYN 1,B00,906086,Fish; Gwendolyn Anne,0,1,0,2
1746534116744,SYN 2R,A00,886860,Staff,0,17,15,15
1746534116744,SYN 2R,B00,906106,Atkinson; Arthur Laird,0,16,15,15
1746534117773,SYN 100,A01,886866,Browne; Emily,0,28,20,20
1746534117773,SYN 100,B01,906128,Rock; Martin,0,5,20,20
1746534117773,SYN 100,C01,906140,Deavenport; James Cary,0,3,20,20
1746534117773,SYN 100,D01,907816,Deavenport; James Cary,0,5,20,20
1746534118804,TDAC 1,A00,890286,Walsh; Kim C.,9,0,20,11
1746534119835,TDAC 101,A00,890296,Basso; Beatrice,16,0,20,4
1746534120865,TDDE 131,A00,890297,Staff,47,0,50,3
1746534121890,TDDM 1,A00,890287,Weinberg; Sadie,25,0,30,5
1746534122924,TDGE 11,A00,890288,Fulton; Julia,137,0,200,63
1746534122924,TDGE 11,B00,890289,Castro; Robert Jess,184,0,200,16
1746534123952,TDGE 25,B00,957359,Walsh; Kim C.,3,0,20,17
1746534124980,TDGE 40,A01,890292,Power; Jade Yukana,27,0,30,3
1746534126009,TDGE 124,A00,890298,Havis; Allan,0,0,50,50
1746534127035,TDGE 131R,A00,890299,Burelle; Julie Sara Veronique,15,0,42,27
1746534128064,TDHT 101,A00,890300,Staff,10,0,20,10
1746534129089,TDHT 109,A01,890302,Anderson; Mysia Anyse,31,0,40,9
1746534130115,TDMV 1,A00,890293,Arcidiacono; Kristin,18,0,30,12
1746534131145,TDMV 2,A00,890294,Weinberg; Sadie,23,0,30,7
1746534132182,TDMV 3,A00,957878,Arcidiacono; Kristin,28,0,30,2
1746534134234,TDMV 138,A00,890304,Jun; Grace Shin Hae,25,0,40,15
1746534135260,TDMV 140,A00,890305,Corrales; Joseph Bernales,25,0,30,5
1746534136286,TDMV 142,A00,890307,Caligagan; Tony,32,0,40,8
1746534137313,TDMV 144,A00,890308,Camaya; Michelle Ann,25,0,30,5
1746534138346,TDPW 1,A00,890295,Stein; Deborah Isobel,3,0,20,17
1746534139372,USP 2,A01,890272,Lerner; Amy M,6,0,20,14
1746534140398,USP 3,A01,890274,Staff,12,0,30,18
1746534141429,USP 15,A01,890276,Sun; Feiyang,17,0,30,13
1746534142459,USP 25,A00,890277,Shenkman; Michael Thomas,19,0,25,6
1746534143487,USP 138,A00,890278,Staff,13,0,25,12
1746534144520,USP 143,A00,890279,Staff,21,0,70,49
1746534145546,USP 144,A00,890280,Chowdhury; Muhammed Zohir,16,0,30,14
1746534146577,USP 150,A00,890281,Boomhower; Matthew Charles,4,0,30,26
1746534147606,USP 151,A00,890282,Staff,16,0,20,4
1746534148632,USP 162,A00,890283,Andrews; Abigail Leslie,16,0,20,4
1746534149664,USP 168,A00,920477,Kwak; Nancy,1,0,5,4
1746534150694,USP 181,A00,890284,Staff,3,0,20,17
1746534151721,USP 191A,A00,890285,Staff,13,0,20,7
1746534152752,VIS 101,A00,886512,Staff,25,0,75,50
1746534153781,VIS 103,A00,886513,Cruz; Edwin Teddy,61,0,75,14
1746534154806,VIS 108,A00,886514,Staff,3,0,15,12
1746534155833,VIS 127P,A00,886515,Shen; Kuiyi,80,0,146,66
1746534156860,VIS 149,A00,886516,Yoldas; Pinar,0,0,15,15
1746534157928,VIS 164,A00,886526,Erdmann; Dean,19,0,22,3
1746534158953,VIS 194S,A00,886527,Staff,61,0,75,14
1746534159980,WCWP 10A,C00,886484,Martiniuk; Jill,12,0,15,3
1746534161015,WCWP 10B,A00,886490,Uriarte; Emma,0,0,15,15
1746534161015,WCWP 10B,B00,886491,Dhir; Simrita,11,0,15,4
1746534161015,WCWP 10B,C00,886492,Ornelas; Tricia,0,0,15,15
1746534162046,WCWP 100,A00,886494,Young; Mark T,0,7,15,15
1746534164278,AAS 10,A01,886199,Childs; Dennis R.,0,3,0,0
1746534165307,ANAR 104,A01,886940,Shtienberg; Gilad,27,0,30,3
1746534166333,ANAR 120,A00,886953,Staff,12,0,20,8
1746534167360,ANBI 148,A01,886955,Wilder; Linnea Lorene,30,0,40,10
1746534169411,ANSC 122,A00,886957,Staff,25,0,30,5
1746534170441,ANSC 150,A00,886958,Sloane; Julia Kathryn,3,0,15,12
1746534171469,ANSC 156,A00,886959,Jenkins; Janis A.,0,1,15,15
1746534172493,ANSC 180,A00,886960,Staff,11,0,17,6
1746534173521,ANSC 188,A00,886961,Jassal; Aftab,9,0,25,16
1746534174545,ANSC 190,A00,886962,Jassal; Aftab,14,0,25,11
1746534175573,ANSC 191,A00,886963,Staff,18,0,20,2
1746534176599,ANTH 3,A01,891689,Staff,17,0,20,3
1746534177625,ANTH 5,A00,886933,Semendeferi; Ekaterini,16,0,20,4
1746534178654,ANTH 10,A00,886934,Staff,0,12,30,30
1746534179683,ANTH 21,A01,886936,Staff,40,0,60,20
1746534180715,ANTH 23,A01,886938,Staff,92,0,100,8
1746534181742,ANTH 105,A00,886964,Stewart; Alexander B,84,0,100,16
1746534182770,ANTH 108,A00,886965,Pedersen; David,9,0,20,11
1746534183800,AWP 10,001,886147,Staff,0,0,0,0
1746534183800,AWP 10,002,886148,Staff,0,0,0,0
1746534183800,AWP 10,003,886149,Staff,0,0,0,0
1746534183800,AWP 10,004,886150,Staff,0,0,0,0
1746534183800,AWP 10,005,886151,Staff,0,0,0,0
1746534183800,AWP 10,006,886152,Staff,0,0,0,0
1746534183800,AWP 10,007,886153,Staff,0,0,0,0
1746534183800,AWP 10,008,886154,Staff,0,0,0,0
1746534183800,AWP 10,009,886155,Staff,0,0,0,0
1746534183800,AWP 10,010,886156,Staff,0,0,0,0
1746534183800,AWP 10,011,886158,Staff,0,0,0,0
1746534183800,AWP 10,012,886160,Staff,0,0,0,0
1746534183800,AWP 10,013,886161,Staff,0,0,0,0
1746534183800,AWP 10,014,886162,Staff,0,0,0,0
1746534183800,AWP 10,015,886163,Staff,0,0,0,0
1746534183800,AWP 10,016,886164,Staff,0,0,0,0
1746534183800,AWP 10,017,886165,Staff,0,0,0,0
1746534183800,AWP 10,018,886166,Staff,0,0,0,0
1746534183800,AWP 10,019,886168,Staff,0,0,0,0
1746534183800,AWP 10,020,886170,Staff,0,0,0,0
1746534183800,AWP 10,021,886172,Staff,0,0,0,0
1746534184829,AWP 10R,001,886173,Staff,0,1,0,0
1746534184829,AWP 10R,002,886174,Staff,0,1,0,0
1746534184829,AWP 10R,003,886175,Staff,0,0,0,0
1746534184829,AWP 10R,004,886176,Staff,0,0,0,0
1746534184829,AWP 10R,005,886177,Staff,0,0,0,0
1746534184829,AWP 10R,006,886178,Staff,0,0,0,0
1746534184829,AWP 10R,007,886179,Staff,0,0,0,0
1746534184829,AWP 10R,008,886181,Staff,0,0,0,0
1746534184829,AWP 10R,009,886182,Staff,0,0,0,0
1746534184829,AWP 10R,010,886183,Staff,0,0,0,0
1746534184829,AWP 10R,011,886184,Staff,0,0,0,0
1746534184829,AWP 10R,012,886185,Staff,0,0,0,0
1746534184829,AWP 10R,013,886186,Staff,0,0,0,0
1746534184829,AWP 10R,014,886187,Staff,0,0,0,0
1746534184829,AWP 10R,015,886188,Staff,0,0,0,0
1746534184829,AWP 10R,016,886189,Staff,0,0,0,0
1746534185861,AWP 102R,A00,886190,Staff,0,0,0,0
1746534185861,AWP 102R,B00,886191,Staff,0,0,0,0
1746534186888,BENG 100,A01,886193,Staff,17,0,30,13
1746534187917,BENG 122A,A01,886195,Hasty; Jeff M,13,0,30,17
1746534188950,BENG 166A,A00,886196,Sah; Robert Lie-Yuan,0,1,30,30
1746534189979,BENG 190,A00,958050,Khojah; Reem I,24,0,25,1
1746534191007,BIBC 102,A01,894320,Staff,0,0,46,46
1746534191007,BIBC 102,A02,894321,Staff,1,0,46,45
1746534191007,BIBC 102,A03,894344,Staff,7,0,46,39
1746534191007,BIBC 102,A04,894345,Staff,26,0,47,21
1746534192043,BICD 100R,A01,894365,Smith; Laurie,0,3,58,58
1746534192043,BICD 100R,A02,894366,Smith; Laurie,0,5,58,58
1746534192043,BICD 100R,A03,894367,Smith; Laurie,2,0,59,57
1746534192043,BICD 100R,A04,959869,Smith; Laurie,41,0,59,18
1746534193070,BICD 136,A01,894383,Gustafson-Brown; Cindy,14,0,50,36
1746534194101,BIEB 102,A01,894494,Butler; Shannon Rhey,51,0,130,79
1746534196156,BIEB 150,A01,894617,Wills; Christopher,3,0,20,17
1746534196156,BIEB 150,A02,894631,Wills; Christopher,3,0,20,17
1746534196156,BIEB 150,A03,894937,Wills; Christopher,3,0,20,17
1746534196156,BIEB 150,A04,894946,Wills; Christopher,5,0,20,15
1746534197184,BIEB 194,A00,906141,Kurle; Carolyn M.,6,0,20,14
1746534198216,BILD 1,A01,894154,Staff,2,0,19,17
1746534198216,BILD 1,A02,894155,Staff,14,0,19,5
1746534198216,BILD 1,A03,894160,Staff,13,0,19,6
1746534198216,BILD 1,A04,894161,Staff,15,0,18,3
1746534199244,BILD 2,A01,894168,Staff,0,0,50,50
1746534199244,BILD 2,A02,894169,Staff,0,0,50,50
1746534199244,BILD 2,A03,894179,Staff,4,0,50,46
1746534199244,BILD 2,A04,894203,Staff,27,0,50,23
1746534200272,BILD 3,A01,894213,Staff,22,0,31,9
1746534200272,BILD 3,A02,894214,Staff,26,0,31,5
1746534200272,BILD 3,A03,894235,Staff,28,0,31,3
1746534200272,BILD 3,A04,894236,Staff,28,0,32,4
1746534201298,BILD 4,A01,894253,Reuther; Keefe,5,0,24,19
1746534201298,BILD 4,A02,894258,Reuther; Keefe,16,0,24,8
1746534202330,BILD 5,A01,894276,Reuther; Keefe,35,0,50,15
1746534202330,BILD 5,A02,894277,Reuther; Keefe,45,0,50,5
1746534202330,BILD 5,A03,894290,Reuther; Keefe,44,0,50,6
1746534202330,BILD 5,A04,894291,Reuther; Keefe,48,0,50,2
1746534203359,BILD 24,A01,894297,Pirino; Giorgia,40,0,60,20
1746534204391,BIMM 100,B01,958915,Staff,72,0,100,28
1746534205419,BIMM 101,A01,895017,McDonnell; Lisa Marie,0,5,24,24
1746534205419,BIMM 101,A02,895018,McDonnell; Lisa Marie,0,5,24,24
1746534205419,BIMM 101,B01,895020,McDonnell; Lisa Marie,0,6,24,24
1746534205419,BIMM 101,B02,895021,McDonnell; Lisa Marie,0,4,24,24
1746534206453,BIMM 110,A01,895023,Staff,1,0,25,24
1746534206453,BIMM 110,A02,895024,Staff,9,0,25,16
1746534206453,BIMM 110,A03,895025,Staff,18,0,25,7
1746534206453,BIMM 110,A04,895031,Staff,20,0,25,5
1746534207486,BIMM 120,A01,895114,Gustafson-Brown; Cindy,13,0,28,15
1746534207486,BIMM 120,A02,895126,Gustafson-Brown; Cindy,21,0,27,6
1746534208512,BIPN 100,A01,895130,Yang; Mingyu,1,0,38,37
1746534208512,BIPN 100,A02,895131,Yang; Mingyu,32,0,38,6
1746534208512,BIPN 100,A03,895132,Yang; Mingyu,32,0,38,6
1746534208512,BIPN 100,A04,895133,Yang; Mingyu,27,0,36,9
1746534209540,BIPN 120,A01,895135,Cooke; James Edward,0,3,13,13
1746534209540,BIPN 120,A02,895136,Cooke; James Edward,0,1,13,13
1746534209540,BIPN 120,A03,895137,Cooke; James Edward,0,3,13,13
1746534209540,BIPN 120,A04,895156,Cooke; James Edward,0,2,11,11
1746534210569,BIPN 134,A01,895235,Cooke; James Edward,0,2,25,25
1746534210569,BIPN 134,A02,895237,Cooke; James Edward,0,0,25,25
1746534210569,BIPN 134,A03,895240,Cooke; James Edward,3,0,25,22
1746534210569,BIPN 134,A04,895270,Cooke; James Edward,20,0,25,5
1746534211600,BIPN 189,A00,892103,Staff,0,13,14,14
1746534213652,BISP 194,A00,958008,Staff,0,2,0,0
1746534214682,CAT 124,A01,922009,Staff,0,5,20,20
1746534215722,CAT 125R,A00,886390,Morales; Celeste Georgianna,0,2,20,20
1746534215722,CAT 125R,B00,886391,Irwin; Matthew Joseph,0,3,20,20
1746534215722,CAT 125R,C00,886392,Smith; Lauryn Alissa,0,2,20,20
1746534215722,CAT 125R,D00,886393,Vanderschuit; Maya Alysia,0,2,20,20
1746534215722,CAT 125R,E00,886394,Marchisotto; Jennifer Anne,0,4,20,20
1746534216750,CENG 15,A01,886218,Drews; Aaron,3,0,8,5
1746534217780,CENG 113,A00,886219,Opatkiewicz; Justin Paul,15,0,25,10
1746534218810,CGS 101,A00,887044,Staff,7,0,20,13
1746534219836,CGS 105,A01,887046,Staff,14,0,25,11
1746534220864,CGS 112,A00,887047,Cuong; Marisol,12,0,15,3
1746534221891,CGS 113,A00,887048,Staff,23,0,30,7
1746534222917,CGS 120,A00,887049,Staff,10,0,17,7
1746534223954,CHEM 6A,A01,886336,Lam; Tin Yiu,38,0,50,12
1746534223954,CHEM 6A,A02,886338,Lam; Tin Yiu,37,0,50,13
1746534224986,CHEM 6B,A01,886341,Hopkins; Patrycja Anna,16,0,50,34
1746534224986,CHEM 6B,A02,886343,Hopkins; Patrycja Anna,42,0,50,8
1746534226012,CHEM 6C,A01,886346,Albizati; Kim F.,0,2,50,50
1746534226012,CHEM 6C,A02,886348,Albizati; Kim F.,23,0,50,27
1746534227040,CHEM 40A,A01,886352,Klosterman; Jeremy K,65,0,100,35
1746534228072,CHEM 40B,A01,886356,Klosterman; Jeremy K,0,23,100,100
1746534229106,CHEM 41B,A01,886360,Theodorakis; Emmanuel,25,0,50,25
1746534229106,CHEM 41B,A02,886362,Theodorakis; Emmanuel,47,0,50,3
1746534230136,CHIN 165A,A00,886382,Xu; Li,18,0,20,2
1746534231166,CLAS 120,A00,886387,Myerston Santana; Jacobo,33,0,40,7
1746534232194,COGS 9,A01,886967,Shannon; Kyle Michael,42,0,60,18
1746534233223,COGS 11,A01,886969,Staff,11,0,30,19
1746534234251,COGS 14A,A01,886971,Staff,6,0,60,54
1746534235283,COGS 14B,A01,886973,Hoffman; Drew Ellen,4,0,60,56
1746534236310,COGS 18,A01,886975,Morgan; Eric,35,0,60,25
1746534237339,COGS 20,A01,886977,Staff,4,0,8,4
1746534237339,COGS 20,A02,886978,Staff,5,0,7,2
1746534238365,COGS 100,A01,907783,Staff,0,2,30,30
1746534239391,COGS 101B,A01,886980,Staff,0,3,48,48
1746534240419,COGS 101C,A01,886982,Delgado; Tania,0,5,44,44
1746534241449,COGS 102A,A01,886984,Johnson; Christine M.,4,0,30,26
1746534242477,COGS 118B,A01,886986,Staff,0,3,88,88
1746534243503,COGS 150,A01,886988,Bergen; Benjamin,23,0,50,27
1746534244532,COGS 153,A00,886989,Delgado; Tania,0,2,41,41
1746534245559,COGS 186,A01,886991,Staff,0,0,32,32
1746534246588,COGS 187A,A01,886993,Boyle; Mary E. T.,7,0,30,23
1746534247614,COGS 189,A00,886994,Staff,0,1,30,30
1746534248643,COMM 10,A01,886996,Staff,0,0,20,21
1746534248643,COMM 10,A02,886997,Staff,12,0,20,8
1746534248643,COMM 10,A03,959845,Staff,19,0,20,1
1746534249673,COMM 20,A01,886999,Leuning; Grant Maurstad,24,0,40,16
1746534251724,COMM 100A,A01,887002,Staff,0,0,20,25
1746534251724,COMM 100A,A02,887003,Staff,7,0,20,13
1746534252752,COMM 100B,A01,887005,Staff,0,8,20,24
1746534253778,COMM 106D,A00,887006,Staff,14,0,40,26
1746534254805,COMM 110G,A00,887007,Whitworth-Smith; Andrew C,12,0,40,28
1746534255835,COMM 111B,A00,887008,Staff,31,0,40,9
1746534256862,COMM 113T,A00,887009,Abuelhiga; Soraya Jill,28,0,40,12
1746534256862,COMM 113T,B00,906733,Staff,40,0,40,0
1746534257893,COMM 145,A00,887010,Staff,12,0,40,28
1746534258925,COMM 146,A00,887054,Staff,31,0,40,9
1746534259954,COMM 190,A00,887012,Staff,8,0,23,15
1746534260982,CSE 8A,A50,887015,Cao; Yingjun,57,0,85,28
1746534262050,CSE 11,A01,887017,Cao; Yingjun,12,0,70,58
1746534263076,CSE 20,A01,887019,Staff,30,0,50,20
1746534264112,CSE 21,A01,887021,Staff,78,0,100,22
1746534264112,CSE 21,B01,892583,Braun; Oliver,45,0,50,5
1746534265141,CSE 30,A01,887025,Eldon; John,143,0,200,57
1746534266167,CSE 100,A01,887027,Staff,26,0,50,24
1746534266167,CSE 100,A02,887028,Staff,40,0,50,10
1746534267194,CSE 101,A01,887030,Braun; Oliver,75,0,100,25
1746534267194,CSE 101,B01,887032,Jones; Miles E,0,3,50,50
1746534267194,CSE 101,B02,887033,Jones; Miles E,0,1,50,50
1746534268224,CSE 105,A01,908084,Jones; Miles E,32,0,50,18
1746534268224,CSE 105,A02,908087,Jones; Miles E,33,0,50,17
1746534269253,CSE 135,A01,887035,Powell; Thomas Allan,0,4,50,50
1746534270280,CSE 142,A01,887037,Staff,8,0,60,52
1746534271308,CSE 142L,A01,887039,Staff,34,0,60,26
1746534272337,CSE 151A,A01,887041,Solares; Edwin A,48,0,100,52
1746534273364,CSE 175,A01,887043,Kumar; Rakesh,30,0,30,0
1746534274395,CSS 1,A01,886389,Staff,0,1,40,40
1746534275423,DSC 30,A01,908097,Liao; Soohyun Nam,47,0,75,28
1746534276455,DSC 40A,A01,908099,Shannon; Kyle Michael,30,0,50,20
1746534277482,DSC 40B,A01,908112,Staff,16,0,50,34
1746534278509,DSC 80,A01,908116,Staff,19,0,60,41
1746534279539,DSC 197,001,956863,Eldridge; Justin Matthew,9999,0,9999,0
1746534280568,ECE 5,A01,886400,Morris; Karcher William,2,0,6,4
1746534280568,ECE 5,A02,886401,Morris; Karcher William,3,0,6,3
1746534281596,ECE 148,A01,886403,Silberman; Jack,0,14,14,14
1746534282625,ECON 1,A01,887265,Crane; Meredith Helen,12,0,70,58
1746534282625,ECON 1,B01,887268,Staff,43,0,50,7
1746534283653,ECON 2,A01,887273,Crane; Meredith Helen,56,0,70,14
1746534284682,ECON 3,A01,887279,Rondina; Giacomo,32,0,70,38
1746534285710,ECON 4,A01,887282,Anderson; John Charles,0,2,10,10
1746534286737,ECON 5,A01,887285,Staff,33,0,45,12
1746534286737,ECON 5,B01,887292,Staff,41,0,45,4
1746534287766,ECON 100A,A01,887337,Newhouse; Herbert S,54,0,70,16
1746534287766,ECON 100A,B01,887349,Staff,45,0,50,5
1746534288795,ECON 100B,A01,887361,Du; Songzi,29,0,70,41
1746534289824,ECON 100C,A01,887445,Newhouse; Herbert S,59,0,70,11
1746534290854,ECON 105,A00,887488,Vespa; Emanuel Ignacio,23,0,35,12
1746534291886,ECON 109,A01,887506,Shishkin; Denis,28,0,35,7
1746534292916,ECON 110A,A01,887568,Alon; Titan Michael,0,3,35,35
1746534292916,ECON 110A,B01,907601,Alon; Titan Michael,20,0,35,15
1746534293942,ECON 110B,A01,887598,Levkoff; Steven B.,0,23,70,70
1746534294993,ECON 112,A00,887599,Rondina; Giacomo,19,0,35,16
1746534296026,ECON 120A,A01,887603,Dai; Yinlin,36,0,70,34
1746534297054,ECON 120C,A01,887608,Sun; Yixiao,0,1,35,35
1746534297054,ECON 120C,B01,887614,Sun; Yixiao,0,0,35,35
1746534298086,ECON 138,A00,887621,Bharadwaj; Prashant,0,20,20,20
1746534299116,ECON 144,A00,958007,Squires; Dale E,13,0,35,22
1746534300143,ECON 171,A01,907666,Staff,18,0,35,17
1746534301173,ECON 175,A00,887626,Wu; Pak Yeung,23,0,35,12
1746534302200,ECON 190,A00,887640,Vespa; Emanuel Ignacio,23,0,35,12
1746534303252,EDS 25,A01,888197,Staff,0,0,0,0
1746534303252,EDS 25,A02,888209,Staff,0,0,0,0
1746534303252,EDS 25,A03,888210,Staff,0,0,0,0
1746534303252,EDS 25,A04,888212,Staff,0,0,0,0
1746534303252,EDS 25,A05,888213,Staff,0,0,0,0
1746534303252,EDS 25,A06,888214,Staff,0,0,0,0
1746534303252,EDS 25,A07,888235,Staff,0,2,0,0
1746534303252,EDS 25,A08,888236,Staff,0,0,0,0
1746534303252,EDS 25,A09,888240,Staff,0,0,0,0
1746534303252,EDS 25,A10,888244,Staff,0,0,0,0
1746534303252,EDS 25,B01,888273,Staff,0,0,0,0
1746534303252,EDS 25,B02,888285,Staff,0,0,0,0
1746534303252,EDS 25,B03,888423,Staff,0,0,0,1
1746534303252,EDS 25,B04,888432,Staff,0,0,0,0
1746534303252,EDS 25,B05,888433,Staff,0,0,0,0
1746534303252,EDS 25,B06,888467,Staff,0,0,0,0
1746534303252,EDS 25,B07,888468,Staff,0,0,0,0
1746534303252,EDS 25,B08,888479,Staff,0,0,0,0
1746534303252,EDS 25,B09,888484,Staff,0,0,0,0
1746534303252,EDS 25,B10,888487,Staff,0,0,0,0
1746534304286,EDS 38,A01,907700,Choi; Bailey Miyeon,30,0,30,0
1746534305319,EDS 112,A01,888601,Chapman; Thandeka K,14,0,40,26
1746534306347,EDS 115,A00,888697,Mendez; Kathrina Mendoza,10,0,30,20
1746534307376,EDS 116,A01,888893,Staff,35,0,40,5
1746534309437,EDS 124AR,A00,889133,Staff,29,0,50,21
1746534309437,EDS 124AR,B00,907471,Simon; Elizabeth A,37,0,50,13
1746534310465,EDS 124BR,A00,889134,Simon; Elizabeth A,45,0,100,55
1746534311491,EDS 125,A00,889135,Staff,25,0,30,5
1746534312519,EDS 126,A01,889138,Staff,36,0,40,4
1746534313546,EDS 164R,A01,889142,Wishard Guerra; Alison G.,33,0,50,17
1746534314574,ENG 30,A01,886396,Staff,0,0,0,0
1746534314574,ENG 30,B01,886398,Staff,0,0,0,0
1746534315607,ENVR 102,A00,906150,Montejo; Carolina,23,0,25,2
1746534316636,ETHN 103A,A00,887236,Man; Simeon S,0,3,0,0
1746534317663,ETHN 113,A00,887239,Staff,16,0,30,14
1746534318692,ETHN 116,A00,887240,Staff,16,0,25,9
1746534319723,ETHN 117,A00,887241,Choi; Esther Min,28,0,30,2
1746534320750,ETHN 118,A00,887243,Staff,24,0,30,6
1746534321778,ETHN 127,A00,887248,Cuong; Marisol,11,0,15,4
1746534322804,ETHN 139,A00,887250,Staff,7,0,10,3
1746534323830,ETHN 142,A00,887252,Staff,10,0,30,20
1746534324861,ETHN 161,A00,887253,Browne; Errol Tsekani,24,0,30,6
1746534325887,ETHN 163FR,A00,887255,Burelle; Julie Sara Veronique,0,0,5,5
1746534326917,GLBH 20,A00,889149,Elwardani; Nile Regina,8,0,42,34
1746534328975,GLBH 111,A01,889152,Burgos; Jose L.,17,0,17,0
1746534330010,GLBH 150,A00,889181,Sloane; Julia Kathryn,0,5,15,15
1746534332061,HDS 60,A01,886406,Warstadt; Melissa Fawn,73,0,80,7
1746534333088,HIAF 111,A00,889324,Gyamfi; Bright,25,0,32,7
1746534334118,HIEA 131,A00,889328,Staff,16,0,32,16
1746534335146,HIEA 144,A00,889333,Henry; Todd A.,26,0,32,6
1746534336174,HIEA 154,A00,889336,Henry; Todd A.,24,0,32,8
1746534337200,HIEU 106,A00,889339,Staff,22,0,32,10
1746534339259,HIEU 114,A00,889340,Staff,3,0,32,29
1746534340286,HIEU 135GS,A00,889342,Patterson; Patrick H.,0,0,1,24
1746534341315,HIEU 137,A00,889343,Edington; Claire Ellen,9,0,25,16
1746534342339,HIEU 148,A00,889345,Staff,14,0,32,18
1746534343368,HIEU 154,A00,889346,Biess; Frank Peter,21,0,32,11
1746534344397,HILA 102,A00,889351,Staff,12,0,32,20
1746534345427,HILD 2A,A01,889221,Lewandoski; Julia Mavis,1,10,32,31
1746534346453,HILD 7B,A01,889225,Man; Simeon S,0,13,32,32
1746534347480,HILD 7C,A01,889288,Alvarez; Luis A,0,14,32,32
1746534348510,HILD 30,A01,889323,Staff,0,5,32,32
1746534350566,HISC 119,A00,889383,Golan; Tal,21,0,32,11
1746534351599,HIUS 103,A00,889384,Man; Simeon S,0,0,32,32
1746534352624,HIUS 117,A00,919797,Kwak; Nancy,18,0,32,14
1746534353652,HIUS 142A,A00,919788,Staff,22,0,32,10
1746534355707,HIUS 149,A00,889386,Gyamfi; Bright,27,0,32,5
1746534356736,HIUS 155,A00,889387,Alvarez; Luis A,14,0,32,18
1746534357761,HUM 3,A01,886499,Caldwell; Michael Alan,19,0,50,31
1746534358789,HUM 3GS,A00,886500,Rodriguez; Bretton Sigfred,0,0,0,28
1746534359821,HUM 3R,A01,886502,Markman; Kristina,0,36,50,50
1746534360856,HUM 4,A01,886504,Crum; Matthew Stephen,24,0,50,26
1746534360856,HUM 4,B01,886506,West; Geoffrey Scott,17,0,50,33
1746534361884,HUM 4GS,A00,886507,Staff,0,0,0,19
1746534362915,HUM 5,A01,886509,Staff,32,0,50,18
1746534363948,HUM 5R,A01,886511,Zavodny; Tatiana Sophia,0,39,50,50
1746534364975,JAPN 180,A00,886407,Staff,18,0,40,22
1746534366063,LATI 50,A01,886409,Martin-Cabrera; Luis,4,0,22,18
1746534366063,LATI 50,A02,886410,Martin-Cabrera; Luis,19,0,22,3
1746534366063,LATI 50,A03,886411,Martin-Cabrera; Luis,21,0,22,1
1746534366063,LATI 50,A04,886412,Martin-Cabrera; Luis,9,0,22,13
1746534367091,LAWS 101,A00,907664,Staff,28,0,60,32
1746534368119,LIAB 1A,A00,889388,Saab; Dima,17,0,20,3
1746534369149,LIAB 1AX,A00,889389,El Cheddadi; Youniss,17,0,20,3
1746534370180,LIFR 1C,A00,889391,Van Moer; Vinciane G,8,0,20,12
1746534371209,LIFR 1CX,A00,889392,Van Moer; Vinciane G,7,0,20,13
1746534372238,LIFR 1D,A00,889393,Van Moer; Vinciane G,7,0,20,13
1746534373264,LIFR 1DX,A00,889394,Van Moer; Vinciane G,8,0,20,12
1746534374293,LIGN 7,A00,886923,Staff,24,0,50,26
1746534375324,LIGN 17,A00,886924,Kehler; Andrew Scott,125,0,150,25
1746534376351,LTAM 110,A00,889395,Staff,15,0,30,15
1746534377380,LTAM 110GS,A00,958010,Rodriguez; Bretton Sigfred,0,0,0,28
1746534378406,LTCH 101,A00,889397,Staff,23,0,25,2
1746534379436,LTCS 130,A00,889398,Staff,23,0,25,2
1746534380464,LTEA 138,A00,889399,Staff,24,0,40,16
1746534381498,LTEN 149,A00,889400,Wesling; Megan E.,0,3,25,25
1746534382527,LTEN 169,A00,889401,Staff,20,0,25,5
1746534383559,LTEN 180,A00,889402,Staff,10,0,15,5
1746534384588,LTEN 181,A00,889403,Staff,21,0,25,4
1746534385618,LTWL 100,A00,889404,Myerston Santana; Jacobo,3,0,25,22
1746534386647,LTWL 180GS,A00,889405,Staff,0,0,20,20
1746534387672,LTWL 181,A00,889406,Staff,17,0,25,8
1746534388702,LTWL 184,A00,889475,Mukherjee; Silpa,22,0,25,3
1746534389729,LTWR 102C,A00,889486,Staff,29,0,30,1
1746534390757,LTWR 115W,A00,889491,Staff,0,2,15,15
1746534391782,MAE 8,A01,886905,Staff,0,2,0,0
1746534392809,MAE 11,A00,886906,Bandaru; Prabhakar,0,7,50,50
1746534393836,MAE 20,A00,886907,Evdokimenko; Ekaterina,44,0,70,26
1746534394866,MAE 30B,A00,886909,Ghazinejad; Maziar,26,0,45,19
1746534395893,MAE 101B,A00,886910,Saintillan; David,29,0,45,16
1746534396922,MAE 105,A00,886911,Bandaru; Prabhakar,18,0,50,32
1746534397949,MAE 107,B00,958024,Staff,9,0,50,41
1746534398974,MAE 143B,A00,886913,Bewley; Thomas R,7,0,40,33
1746534400000,MAE 148,A01,886915,Silberman; Jack,0,3,14,14
1746534401026,MAE 160,A00,886916,Evdokimenko; Ekaterina,31,0,60,29
1746534402060,MATH 3C,A01,889681,Staff,0,3,30,30
1746534402060,MATH 3C,A02,960048,Staff,25,0,30,5
1746534403088,MATH 10A,A01,889760,Staff,26,0,30,4
1746534403088,MATH 10A,A02,889783,Staff,29,0,30,1
1746534404116,MATH 10B,A01,889785,Verstraete; Jacques Allan,2,0,35,33
1746534404116,MATH 10B,A02,889795,Verstraete; Jacques Allan,4,0,35,31
1746534404116,MATH 10B,B01,889797,Verstraete; Jacques Allan,3,0,35,32
1746534404116,MATH 10B,B02,889828,Verstraete; Jacques Allan,3,0,35,32
1746534405157,MATH 10C,A01,889849,Habib; Yousaf,9,0,30,21
1746534405157,MATH 10C,A02,889852,Habib; Yousaf,14,0,30,16
1746534405157,MATH 10C,A03,889853,Habib; Yousaf,22,0,30,8
1746534405157,MATH 10C,A04,889858,Habib; Yousaf,20,0,30,10
1746534405157,MATH 10C,B01,889861,Staff,1,0,30,29
1746534405157,MATH 10C,B02,889862,Staff,24,0,30,6
1746534405157,MATH 10C,B03,889863,Staff,27,0,30,3
1746534405157,MATH 10C,B04,889967,Staff,23,0,30,7
1746534406188,MATH 18,A01,889974,Staff,7,0,30,23
1746534406188,MATH 18,A02,889977,Staff,20,0,30,10
1746534406188,MATH 18,B01,889984,Hardiman; Liam,22,0,30,8
1746534406188,MATH 18,B02,889985,Hardiman; Liam,25,0,30,5
1746534407215,MATH 20A,A01,889990,Suk; Andrew Hoon,29,0,35,6
1746534408248,MATH 20B,A01,889993,Ohm; Ko Woon,22,0,30,8
1746534408248,MATH 20B,A02,889994,Ohm; Ko Woon,30,0,30,0
1746534408248,MATH 20B,B01,889996,Ohm; Ko Woon,21,0,30,9
1746534408248,MATH 20B,B02,889997,Ohm; Ko Woon,23,0,30,7
1746534409274,MATH 20C,A01,889999,Hammock; Frances H,17,0,30,13
1746534409274,MATH 20C,A02,890003,Hammock; Frances H,23,0,30,7
1746534409274,MATH 20C,B01,890006,Hammock; Frances H,3,0,30,27
1746534409274,MATH 20C,B02,890007,Hammock; Frances H,11,0,30,19
1746534410301,MATH 20D,A01,890011,Cheng; Hsiao-Bing,1,1,30,29
1746534410301,MATH 20D,A02,890012,Cheng; Hsiao-Bing,14,0,30,16
1746534410301,MATH 20D,B01,890016,Cheng; Hsiao-Bing,13,0,30,17
1746534410301,MATH 20D,B02,890017,Cheng; Hsiao-Bing,13,0,30,17
1746534411332,MATH 20E,A01,890026,Harel; Guershon,1,0,30,29
1746534411332,MATH 20E,A02,890029,Harel; Guershon,23,0,30,7
1746534411332,MATH 20E,B01,890033,Harel; Guershon,7,0,30,23
1746534411332,MATH 20E,B02,890101,Harel; Guershon,21,0,30,9
1746534412358,MATH 102,A01,890104,Staff,17,0,30,13
1746534412358,MATH 102,A02,890105,Staff,27,0,30,3
1746534413385,MATH 103B,A01,890116,Salehi Golsefidy; Alireza,3,0,30,27
1746534413385,MATH 103B,B01,890118,Staff,0,3,34,34
1746534414414,MATH 109,A01,890121,Aliabadi Sr.; Mohsen,1,0,30,29
1746534414414,MATH 109,B01,890124,Upadrashta; Pranav Kumar,18,0,30,12
1746534415441,MATH 120A,A01,890126,Eggers; John Dietrich,13,0,30,17
1746534416472,MATH 142B,A01,890128,Ioana; Adrian,19,0,30,11
1746534416472,MATH 142B,A02,890129,Ioana; Adrian,13,0,30,17
1746534417501,MATH 154,A01,890174,Staff,0,0,30,30
1746534417501,MATH 154,A02,890182,Staff,0,0,30,30
1746534418530,MATH 168A,A01,890197,Dumitriu; Ioana,21,0,35,14
1746534419560,MATH 170A,A01,890240,Nie; Jiawang,1,0,30,29
1746534419560,MATH 170A,A02,890241,Nie; Jiawang,11,0,30,19
1746534419560,MATH 170A,A03,890249,Nie; Jiawang,23,0,30,7
1746534420588,MATH 170B,A01,957891,Nag; Panchali,13,0,35,22
1746534422641,MATH 181A,A01,908025,Staff,0,4,35,35
1746534422641,MATH 181A,A02,960115,Staff,27,0,35,8
1746534423668,MATH 181B,A01,959874,Staff,26,0,30,4
1746534424701,MATH 193B,A01,890265,Staff,0,4,35,35
1746534425726,MGT 4,A01,890311,Anderson; John Charles,42,0,88,46
1746534426752,MGT 5,A00,907740,Staff,13,0,98,85
1746534427778,MGT 12,A00,890312,Lindenberger; Wade Douglas,67,0,98,31
1746534428804,MGT 16,A00,957883,Staff,78,0,98,20
1746534430858,MGT 45,A00,890314,Pecore; Joseph P.,47,0,98,51
1746534431884,MGT 71,A00,890315,Staff,0,11,98,98
1746534432911,MGT 100,A00,890316,Yavorsky; Daniel Ryan,44,0,98,54
1746534433938,MGT 103,A00,890317,Ehrich; Kristine R,73,0,98,25
1746534434965,MGT 105,A00,890356,Bates; Kenneth Walter,0,7,98,98
1746534435994,MGT 112,A00,890360,Ehrich; Kristine R,55,0,98,43
1746534437024,MGT 127R,A00,907732,Zhu; Kevin Xiaoguo,23,0,98,75
1746534438052,MGT 131B,A00,890361,Anderson; John Charles,61,0,98,37
1746534439079,MGT 137,A00,890362,Lindenberger; Wade Douglas,65,0,98,33
1746534440107,MGT 160,A00,890369,Johnson; Erik Barry,9,0,98,89
1746534442163,MGT 164,A00,890372,Zimmermann; Carsten,0,39,98,98
1746534443191,MGT 180,A00,890374,Bliss; Barbara Ann,12,0,98,86
1746534444220,MMW 15,A01,886414,Chang; Edmond Yi-Teh,0,12,28,28
1746534444220,MMW 15,A02,886415,Chang; Edmond Yi-Teh,0,8,28,28
1746534444220,MMW 15,A03,886416,Chang; Edmond Yi-Teh,0,8,28,28
1746534444220,MMW 15,A04,886417,Chang; Edmond Yi-Teh,0,8,28,28
1746534444220,MMW 15,B01,886419,Chang; Edmond Yi-Teh,0,7,28,28
1746534444220,MMW 15,B02,886420,Chang; Edmond Yi-Teh,0,8,28,28
1746534444220,MMW 15,B03,886421,Chang; Edmond Yi-Teh,0,7,28,28
1746534444220,MMW 15,B04,886422,Chang; Edmond Yi-Teh,0,8,28,28
1746534444220,MMW 15,C01,886424,Staff,0,9,28,28
1746534444220,MMW 15,C02,886425,Staff,0,8,28,28
1746534444220,MMW 15,C03,886426,Staff,0,8,28,28
1746534444220,MMW 15,C04,886427,Staff,0,7,28,28
1746534444220,MMW 15,C05,958038,Staff,0,7,28,28
1746534444220,MMW 15,C06,958039,Staff,0,8,28,28
1746534445247,MMW 15GS,A00,906910,Patterson; Patrick H.,4,0,28,24
1746534446276,MMW 122R,A01,886429,Rahimi; Babak,0,13,28,28
1746534446276,MMW 122R,A02,886430,Rahimi; Babak,0,12,28,28
1746534446276,MMW 122R,A03,958040,Rahimi; Babak,0,11,28,28
1746534447313,MUS 1A,A01,890937,Staff,3,0,25,22
1746534447313,MUS 1A,A02,891035,Staff,6,0,25,19
1746534447313,MUS 1A,C01,958912,Staff,24,0,25,1
1746534447313,MUS 1A,C02,958913,Staff,25,0,25,0
1746534449370,MUS 2AK,A00,957092,Ohnishi; Takae,15,0,15,0
1746534450396,MUS 4,A01,891044,Staff,2,0,25,23
1746534450396,MUS 4,A02,891045,Staff,23,0,25,2
1746534450396,MUS 4,B01,891048,Staff,17,0,25,8
1746534450396,MUS 4,B02,891050,Staff,25,0,25,0
1746534451426,MUS 5,A01,957506,Dubnov; Shlomo,0,0,25,25
1746534451426,MUS 5,A02,957622,Dubnov; Shlomo,14,0,25,11
1746534451426,MUS 5,A03,957623,Dubnov; Shlomo,20,0,25,5
1746534452459,MUS 6,A01,891053,Freitas Caetano; Marcelo,24,0,25,1
1746534452459,MUS 6,A02,891054,Freitas Caetano; Marcelo,23,0,25,2
1746534453486,MUS 7,A01,891081,Staff,0,0,25,25
1746534453486,MUS 7,A02,891082,Staff,4,0,25,21
1746534454517,MUS 8GS,A00,891118,Borgo; David Garcia,0,0,25,25
1746534455542,MUS 11,A01,891140,Staff,11,0,25,14
1746534455542,MUS 11,A02,891141,Staff,22,0,25,3
1746534456572,MUS 13,A01,891143,Staff,8,0,25,17
1746534456572,MUS 13,A02,891144,Staff,24,0,25,1
1746534457603,MUS 15,A01,891146,Staff,9,0,25,16
1746534457603,MUS 15,A02,891148,Staff,21,0,25,4
1746534457603,MUS 15,B01,891150,Staff,18,0,25,7
1746534457603,MUS 15,B02,891151,Staff,25,0,25,0
1746534458630,MUS 20,A01,891153,Staff,5,0,20,15
1746534458630,MUS 20,A02,891155,Staff,14,0,20,6
1746534459659,MUS 80,A00,891156,Staff,19,0,25,6
1746534459659,MUS 80,B00,891157,Staff,23,0,25,2
1746534460686,MUS 130,A00,891158,Ohnishi; Takae,35,0,35,0
1746534461711,MUS 150GS,A01,891160,Borgo; David Garcia,0,0,25,25
1746534462739,MUS 170,A01,891162,Freitas Caetano; Marcelo,20,0,25,5
1746534462739,MUS 170,A02,891164,Freitas Caetano; Marcelo,21,0,25,4
1746534463767,NANO 11,A00,886220,Vazquez Mena; Oscar,13,0,15,2
1746534464798,NANO 15,A01,886222,Drews; Aaron,4,0,7,3
1746534465831,NANO 104,A00,886224,Sirbuly; Donald,18,0,25,7
1746534466860,PH 40,A00,886528,Staff,23,0,40,17
1746534467888,PH 45,A01,886799,Staff,35,0,40,5
1746534468916,PH 110,A00,886802,Staff,0,7,40,40
1746534469948,PH 172,A00,906716,Staff,19,0,35,16
1746534470975,PH 191,A00,886803,Staff,6,0,40,34
1746534472009,PHIL 1,A00,889500,Staff,19,0,30,11
1746534473041,PHIL 10,A01,889549,Grush; Rick Scott,15,0,22,7
1746534473041,PHIL 10,A02,889551,Grush; Rick Scott,22,0,22,0
1746534474072,PHIL 28,A01,889559,Lamey; Andy M.,0,1,31,31
1746534474072,PHIL 28,A02,889561,Lamey; Andy M.,0,1,30,30
1746534474072,PHIL 28,A03,889572,Lamey; Andy M.,0,0,30,30
1746534475100,PHIL 35,A00,907839,Staff,13,0,15,2
1746534476128,PHIL 60,A00,889574,Staff,74,0,90,16
1746534477153,PHIL 101,A00,958004,Staff,13,0,15,2
1746534479205,PHIL 136,A00,889582,Fulkerson; Matthew Todd,26,0,45,19
1746534480234,PHIL 163,A01,889601,Staff,21,0,30,9
1746534480234,PHIL 163,B01,889606,Brandt; Reuven A,0,3,0,0
1746534481259,PHIL 164,A00,889610,Staff,16,0,30,14
1746534482285,PHIL 165,A00,889613,Staff,23,0,30,7
1746534483312,PHYS 1A,A00,886431,Staff,26,0,70,44
1746534484340,PHYS 1AL,001,886432,Tsai; Philbert S,0,2,30,30
1746534484340,PHYS 1AL,002,886436,Tsai; Philbert S,11,0,30,19
1746534485369,PHYS 1B,A00,886439,Staff,185,0,240,55
1746534486394,PHYS 1BL,001,886441,Tsai; Philbert S,0,4,30,30
1746534486394,PHYS 1BL,002,886444,Tsai; Philbert S,2,0,30,28
1746534487423,PHYS 1C,A00,896092,Arnold; Kam S,78,0,146,68
1746534488451,PHYS 1CL,001,886448,Tsai; Philbert S,0,0,30,30
1746534488451,PHYS 1CL,002,886449,Tsai; Philbert S,0,0,30,30
1746534488451,PHYS 1CL,003,886450,Tsai; Philbert S,15,0,30,15
1746534488451,PHYS 1CL,004,886451,Tsai; Philbert S,15,0,30,15
1746534489479,PHYS 2B,A01,886457,Staff,69,0,115,46
1746534491473,PHYS 2C,A01,886460,Shotwell; Brian,0,8,65,65
1746534492500,PHYS 2CL,A01,886467,Staff,0,4,28,28
1746534492500,PHYS 2CL,A02,886468,Staff,0,3,28,28
1746534493525,PHYS 2D,A01,886470,Staff,10,0,50,40
1746534494552,PHYS 4B,A01,886475,Grinstein; Benjamin,22,0,40,18
1746534495583,POLI 5,A00,891173,Desposato; Scott,7,0,25,18
1746534496610,POLI 5D,A01,891175,Staff,5,0,5,0
1746534496610,POLI 5D,B01,891178,Staff,5,0,5,0
1746534497642,POLI 11,A00,891179,Ferree; Karen E,2,0,35,33
1746534498667,POLI 12,A00,891180,Staff,16,0,30,14
1746534499693,POLI 27,A01,891182,Staff,12,0,75,63
1746534500717,POLI 30,A00,891183,Staff,9,0,50,41
1746534501747,POLI 100B,A00,891244,Staff,5,1,35,30
1746534502775,POLI 100I,A00,891247,Staff,7,0,30,23
1746534503801,POLI 104J,A00,891248,Nichter; Maysa,14,0,30,16
1746534504828,POLI 104U,A00,891250,Nichter; Maysa,2,0,30,28
1746534506881,POLI 110B,A00,891255,Wiens; David,20,0,25,5
1746534507908,POLI 112A,A00,891256,Wiens; David,6,0,25,19
1746534508940,POLI 114BR,A00,891261,Staff,19,0,30,11
1746534509968,POLI 117R,A00,891262,Forman; Fonna,0,6,50,50
1746534510994,POLI 118,A00,891264,Ingham; Sean,17,0,25,8
1746534512022,POLI 124A,A00,891265,Staff,18,0,20,2
1746534513053,POLI 125D,A00,891266,Nichter; Simeon C,2,0,25,23
1746534514079,POLI 126,A00,891268,Nichter; Simeon C,7,0,25,18
1746534515108,POLI 126AA,A00,891272,Staff,18,0,25,7
1746534516137,POLI 130AA,A00,891273,Staff,15,0,20,5
1746534517163,POLI 134AA,A00,891274,Staff,4,0,20,16
1746534519221,POLI 138,A00,891278,Staff,21,0,25,4
1746534520248,POLI 142K,A00,891280,Staff,11,0,25,14
1746534521279,POLI 142M,A00,891281,Gartzke; Erik,17,0,30,13
1746534522305,POLI 142P,A00,891284,Staff,20,0,30,10
1746534523330,POLI 143,A00,891285,Gartzke; Erik,12,0,30,18
1746534524356,POLI 153,A00,891286,Staff,19,0,20,1
1746534526411,POLI 175,A00,891290,Staff,15,0,20,5
1746534527437,PSYC 1,A00,890674,Steiner; Eric Tomas,0,11,45,45
1746534528469,PSYC 2,A00,890676,Albright; Thomas D,21,0,35,14
1746534529499,PSYC 3,A00,890679,Staff,17,0,20,3
1746534530527,PSYC 6,A00,959858,Staff,20,0,20,0
1746534531555,PSYC 60,A01,890684,Rickard; Timothy C.,0,5,45,45
1746534532584,PSYC 70,A01,890689,Geller; Emma Harlan,7,0,30,23
1746534533617,PSYC 71,A01,959860,Staff,21,0,25,4
1746534534642,PSYC 100,A00,890690,Lacefield; Katharine I,0,50,180,180
1746534535667,PSYC 102,A00,890695,Staff,18,0,40,22
1746534536693,PSYC 105,A00,890699,Geller; Emma Harlan,71,0,100,29
1746534537727,PSYC 106,A00,890701,Gorman; Michael R.,5,0,30,25
1746534538753,PSYC 108,A00,890704,Adrian; Julia Anna,0,28,50,50
1746534539782,PSYC 118,A01,890712,Staff,11,0,30,19
1746534540812,PSYC 124,A00,890716,Chapman; Eddie Nathaniel,25,0,60,35
1746534541841,PSYC 131,A00,890717,Anagnostaras; Stephan,0,7,80,80
1746534542874,PSYC 137,A00,890719,Winkielman; Piotr,0,11,30,30
1746534543901,PSYC 144,A00,890721,Adrian; Julia Anna,0,9,45,45
1746534544926,PSYC 162,A00,890805,Staff,2,0,75,73
1746534545956,PSYC 169,A00,890810,Staff,0,15,30,30
1746534546984,PSYC 172,A00,890814,Gorman; Michael R.,9,0,30,21
1746534548012,PSYC 181,A00,890818,Anagnostaras; Stephan,8,0,200,192
1746534549042,PSYC 184,A00,959861,Staff,170,0,175,5
1746534550075,PSYC 189,A00,890823,Staff,0,1,30,30
1746534551102,PSYC 191,A00,890884,Rickard; Timothy C.,0,11,35,35
1746534552128,PSYC 193,A00,890913,Staff,19,0,30,11
1746534552128,PSYC 193,B00,890914,Chapman; Eddie Nathaniel,24,0,30,6
1746534553163,PSYC 193L,A01,890918,Lowe; Angela Beth,20,0,30,10
1746534553163,PSYC 193L,B01,890921,Hurwitz; Ethan Scott,20,0,30,10
1746534553163,PSYC 193L,C01,890928,Staff,30,0,30,0
1746534554195,RELI 149,A00,886806,Rahimi; Babak,23,0,40,17
1746534555223,SE 9,A01,886814,Staff,7,0,20,13
1746534556257,SE 101B,A01,886816,Chadha; Mayank,4,0,35,31
1746534557287,SE 110B,A00,886818,Zhu; Qiang,4,0,75,71
1746534558317,SE 125,A01,886830,Staff,10,0,30,20
1746534559348,SE 130B,A01,886835,Staff,14,0,40,26
1746534560375,SE 131A,A01,886838,Krysl; Petr,34,0,55,21
1746534561404,SE 154,A00,886840,Staff,30,0,50,20
1746534562436,SE 164GS,A01,886849,Staff,6,0,20,14
1746534563462,SE 167GS,A01,886853,Staff,6,0,20,14
1746534564493,SIO 25,A01,890107,Staff,19,0,30,11
1746534565520,SIO 45,A00,890109,Cook; Geoffrey W,117,0,200,83
1746534566549,SIO 109R,A00,890110,Forman; Fonna,0,16,20,20
1746534567577,SIO 187,A01,890114,Kacev; David,15,0,40,25
1746534568609,SOCI 1,A01,890431,Thorpe; Charles Robert,15,0,30,15
1746534568609,SOCI 1,A02,890518,Thorpe; Charles Robert,30,0,30,0
1746534569636,SOCI 2,A01,957978,Staff,25,0,25,0
1746534569636,SOCI 2,A02,957979,Staff,23,0,25,2
1746534570669,SOCI 20,A01,890523,Calderon-Zaks; Michael Aar,23,0,30,7
1746534570669,SOCI 20,A02,890526,Calderon-Zaks; Michael Aar,29,0,30,1
1746534571914,SOCI 30,A01,890533,Pardo Guerra; Juan Pablo,37,0,40,3
1746534572941,SOCI 40,A01,890535,Staff,27,0,45,18
1746534573974,SOCI 104Q,A00,890559,Staff,18,0,30,12
1746534575042,SOCI 106,A00,890560,Arnal; Maud Marie Leonie,20,0,30,10
1746534576070,SOCI 110,A00,890567,Holkenbrink-Monk; Charlene,19,0,30,11
1746534577100,SOCI 112,A00,890568,Victoria Torres; Pablo,1,0,55,54
1746534578132,SOCI 115,A00,890597,Arnal; Maud Marie Leonie,28,0,45,17
1746534580198,SOCI 121,A00,890604,Pardo Guerra; Juan Pablo,38,0,45,7
1746534581231,SOCI 126,A01,890608,Staff,8,0,10,2
1746534582259,SOCI 127,A00,890609,Staff,18,0,30,12
1746534583285,SOCI 131,A00,890610,Thorpe; Charles Robert,37,0,45,8
1746534584319,SOCI 135,A00,890615,Payne; Christine Anna,14,0,45,31
1746534585351,SOCI 139,A00,890620,Staff,38,0,45,7
1746534586379,SOCI 148E,A00,890622,Calderon-Zaks; Michael Aar,36,0,45,9
1746534587406,SOCI 150,A00,890623,Kohler; Kristopher M.,31,0,45,14
1746534588437,SOCI 157,A00,890625,Jules-Rosette; Bennetta W.,18,0,20,2
1746534589464,SOCI 160,A00,890627,Payne; Christine Anna,21,0,45,24
1746534590491,SYN 1,A00,886855,Fish; Gwendolyn Anne,0,0,0,0
1746534590491,SYN 1,B00,906086,Fish; Gwendolyn Anne,0,1,0,2
1746534591521,SYN 2R,A00,886860,Staff,0,17,15,15
1746534591521,SYN 2R,B00,906106,Atkinson; Arthur Laird,0,16,15,15
1746534592568,SYN 100,A01,886866,Browne; Emily,0,28,20,20
1746534592568,SYN 100,B01,906128,Rock; Martin,0,5,20,20
1746534592568,SYN 100,C01,906140,Deavenport; James Cary,0,3,20,20
1746534592568,SYN 100,D01,907816,Deavenport; James Cary,0,5,20,20
1746534593595,TDAC 1,A00,890286,Walsh; Kim C.,9,0,20,11
1746534594626,TDAC 101,A00,890296,Basso; Beatrice,16,0,20,4
1746534595656,TDDE 131,A00,890297,Staff,47,0,50,3
1746534596686,TDDM 1,A00,890287,Weinberg; Sadie,25,0,30,5
1746534597714,TDGE 11,A00,890288,Fulton; Julia,137,0,200,63
1746534597714,TDGE 11,B00,890289,Castro; Robert Jess,184,0,200,16
1746534598742,TDGE 25,B00,957359,Walsh; Kim C.,3,0,20,17
1746534599776,TDGE 40,A01,890292,Power; Jade Yukana,27,0,30,3
1746534600806,TDGE 124,A00,890298,Havis; Allan,0,0,50,50
1746534601836,TDGE 131R,A00,890299,Burelle; Julie Sara Veronique,15,0,42,27
1746534602865,TDHT 101,A00,890300,Staff,10,0,20,10
1746534603893,TDHT 109,A01,890302,Anderson; Mysia Anyse,31,0,40,9
1746534604924,TDMV 1,A00,890293,Arcidiacono; Kristin,18,0,30,12
1746534605955,TDMV 2,A00,890294,Weinberg; Sadie,23,0,30,7
1746534606983,TDMV 3,A00,957878,Arcidiacono; Kristin,28,0,30,2
1746534609041,TDMV 138,A00,890304,Jun; Grace Shin Hae,25,0,40,15
1746534610071,TDMV 140,A00,890305,Corrales; Joseph Bernales,25,0,30,5
1746534611099,TDMV 142,A00,890307,Caligagan; Tony,32,0,40,8
1746534612125,TDMV 144,A00,890308,Camaya; Michelle Ann,25,0,30,5
1746534613151,TDPW 1,A00,890295,Stein; Deborah Isobel,3,0,20,17
1746534614185,USP 2,A01,890272,Lerner; Amy M,6,0,20,14
1746534615212,USP 3,A01,890274,Staff,12,0,30,18
1746534616246,USP 15,A01,890276,Sun; Feiyang,17,0,30,13
1746534617273,USP 25,A00,890277,Shenkman; Michael Thomas,19,0,25,6
1746534618302,USP 138,A00,890278,Staff,13,0,25,12
1746534619330,USP 143,A00,890279,Staff,21,0,70,49
1746534620358,USP 144,A00,890280,Chowdhury; Muhammed Zohir,16,0,30,14
1746534621389,USP 150,A00,890281,Boomhower; Matthew Charles,4,0,30,26
1746534622417,USP 151,A00,890282,Staff,16,0,20,4
1746534623449,USP 162,A00,890283,Andrews; Abigail Leslie,16,0,20,4
1746534624482,USP 168,A00,920477,Kwak; Nancy,1,0,5,4
1746534625509,USP 181,A00,890284,Staff,3,0,20,17
1746534626536,USP 191A,A00,890285,Staff,13,0,20,7
1746534627566,VIS 101,A00,886512,Staff,25,0,75,50
1746534628592,VIS 103,A00,886513,Cruz; Edwin Teddy,61,0,75,14
1746534629619,VIS 108,A00,886514,Staff,3,0,15,12
1746534630648,VIS 127P,A00,886515,Shen; Kuiyi,80,0,146,66
1746534631673,VIS 149,A00,886516,Yoldas; Pinar,0,0,15,15
1746534632706,VIS 164,A00,886526,Erdmann; Dean,19,0,22,3
1746534633731,VIS 194S,A00,886527,Staff,61,0,75,14
1746534634764,WCWP 10A,C00,886484,Martiniuk; Jill,12,0,15,3
1746534635792,WCWP 10B,A00,886490,Uriarte; Emma,0,0,15,15
1746534635792,WCWP 10B,B00,886491,Dhir; Simrita,11,0,15,4
1746534635792,WCWP 10B,C00,886492,Ornelas; Tricia,0,0,15,15
1746534636821,WCWP 100,A00,886494,Young; Mark T,0,7,15,15
1746534639013,AAS 10,A01,886199,Childs; Dennis R.,0,3,0,0
1746534640051,ANAR 104,A01,886940,Shtienberg; Gilad,27,0,30,3
1746534641079,ANAR 120,A00,886953,Staff,12,0,20,8
1746534642111,ANBI 148,A01,886955,Wilder; Linnea Lorene,30,0,40,10
1746534644166,ANSC 122,A00,886957,Staff,25,0,30,5
1746534645194,ANSC 150,A00,886958,Sloane; Julia Kathryn,3,0,15,12
1746534646223,ANSC 156,A00,886959,Jenkins; Janis A.,0,1,15,15
1746534647249,ANSC 180,A00,886960,Staff,11,0,17,6
1746534648277,ANSC 188,A00,886961,Jassal; Aftab,9,0,25,16
1746534649305,ANSC 190,A00,886962,Jassal; Aftab,14,0,25,11
1746534650330,ANSC 191,A00,886963,Staff,18,0,20,2
1746534651358,ANTH 3,A01,891689,Staff,17,0,20,3
1746534652390,ANTH 5,A00,886933,Semendeferi; Ekaterini,16,0,20,4
1746534653416,ANTH 10,A00,886934,Staff,0,12,30,30
1746534654447,ANTH 21,A01,886936,Staff,40,0,60,20
1746534655473,ANTH 23,A01,886938,Staff,92,0,100,8
1746534656504,ANTH 105,A00,886964,Stewart; Alexander B,84,0,100,16
1746534657540,ANTH 108,A00,886965,Pedersen; David,9,0,20,11
1746534658573,AWP 10,001,886147,Staff,0,0,0,0
1746534658573,AWP 10,002,886148,Staff,0,0,0,0
1746534658573,AWP 10,003,886149,Staff,0,0,0,0
1746534658573,AWP 10,004,886150,Staff,0,0,0,0
1746534658573,AWP 10,005,886151,Staff,0,0,0,0
1746534658573,AWP 10,006,886152,Staff,0,0,0,0
1746534658573,AWP 10,007,886153,Staff,0,0,0,0
1746534658573,AWP 10,008,886154,Staff,0,0,0,0
1746534658573,AWP 10,009,886155,Staff,0,0,0,0
1746534658573,AWP 10,010,886156,Staff,0,0,0,0
1746534658573,AWP 10,011,886158,Staff,0,0,0,0
1746534658573,AWP 10,012,886160,Staff,0,0,0,0
1746534658573,AWP 10,013,886161,Staff,0,0,0,0
1746534658573,AWP 10,014,886162,Staff,0,0,0,0
1746534658573,AWP 10,015,886163,Staff,0,0,0,0
1746534658573,AWP 10,016,886164,Staff,0,0,0,0
1746534658573,AWP 10,017,886165,Staff,0,0,0,0
1746534658573,AWP 10,018,886166,Staff,0,0,0,0
1746534658573,AWP 10,019,886168,Staff,0,0,0,0
1746534658573,AWP 10,020,886170,Staff,0,0,0,0
1746534658573,AWP 10,021,886172,Staff,0,0,0,0
1746534659667,AWP 10R,001,886173,Staff,0,1,0,0
1746534659667,AWP 10R,002,886174,Staff,0,1,0,0
1746534659667,AWP 10R,003,886175,Staff,0,0,0,0
1746534659667,AWP 10R,004,886176,Staff,0,0,0,0
1746534659667,AWP 10R,005,886177,Staff,0,0,0,0
1746534659667,AWP 10R,006,886178,Staff,0,0,0,0
1746534659667,AWP 10R,007,886179,Staff,0,0,0,0
1746534659667,AWP 10R,008,886181,Staff,0,0,0,0
1746534659667,AWP 10R,009,886182,Staff,0,0,0,0
1746534659667,AWP 10R,010,886183,Staff,0,0,0,0
1746534659667,AWP 10R,011,886184,Staff,0,0,0,0
1746534659667,AWP 10R,012,886185,Staff,0,0,0,0
1746534659667,AWP 10R,013,886186,Staff,0,0,0,0
1746534659667,AWP 10R,014,886187,Staff,0,0,0,0
1746534659667,AWP 10R,015,886188,Staff,0,0,0,0
1746534659667,AWP 10R,016,886189,Staff,0,0,0,0
1746534660694,AWP 102R,A00,886190,Staff,0,0,0,0
1746534660694,AWP 102R,B00,886191,Staff,0,0,0,0
1746534661720,BENG 100,A01,886193,Staff,17,0,30,13
1746534662745,BENG 122A,A01,886195,Hasty; Jeff M,13,0,30,17
1746534663772,BENG 166A,A00,886196,Sah; Robert Lie-Yuan,0,1,30,30
1746534664808,BENG 190,A00,958050,Khojah; Reem I,24,0,25,1
1746534665843,BIBC 102,A01,894320,Staff,0,0,46,46
1746534665843,BIBC 102,A02,894321,Staff,1,0,46,45
1746534665843,BIBC 102,A03,894344,Staff,7,0,46,39
1746534665843,BIBC 102,A04,894345,Staff,26,0,47,21
1746534666882,BICD 100R,A01,894365,Smith; Laurie,0,3,58,58
1746534666882,BICD 100R,A02,894366,Smith; Laurie,0,5,58,58
1746534666882,BICD 100R,A03,894367,Smith; Laurie,2,0,59,57
1746534666882,BICD 100R,A04,959869,Smith; Laurie,41,0,59,18
1746534667912,BICD 136,A01,894383,Gustafson-Brown; Cindy,14,0,50,36
1746534668951,BIEB 102,A01,894494,Butler; Shannon Rhey,51,0,130,79
1746534671014,BIEB 150,A01,894617,Wills; Christopher,3,0,20,17
1746534671014,BIEB 150,A02,894631,Wills; Christopher,3,0,20,17
1746534671014,BIEB 150,A03,894937,Wills; Christopher,3,0,20,17
1746534671014,BIEB 150,A04,894946,Wills; Christopher,5,0,20,15
1746534672046,BIEB 194,A00,906141,Kurle; Carolyn M.,6,0,20,14
1746534673080,BILD 1,A01,894154,Staff,2,0,19,17
1746534673080,BILD 1,A02,894155,Staff,14,0,19,5
1746534673080,BILD 1,A03,894160,Staff,13,0,19,6
1746534673080,BILD 1,A04,894161,Staff,15,0,18,3
1746534674108,BILD 2,A01,894168,Staff,0,0,50,50
1746534674108,BILD 2,A02,894169,Staff,0,0,50,50
1746534674108,BILD 2,A03,894179,Staff,4,0,50,46
1746534674108,BILD 2,A04,894203,Staff,27,0,50,23
1746534675137,BILD 3,A01,894213,Staff,22,0,31,9
1746534675137,BILD 3,A02,894214,Staff,26,0,31,5
1746534675137,BILD 3,A03,894235,Staff,28,0,31,3
1746534675137,BILD 3,A04,894236,Staff,28,0,32,4
1746534676162,BILD 4,A01,894253,Reuther; Keefe,5,0,24,19
1746534676162,BILD 4,A02,894258,Reuther; Keefe,16,0,24,8
1746534677188,BILD 5,A01,894276,Reuther; Keefe,35,0,50,15
1746534677188,BILD 5,A02,894277,Reuther; Keefe,45,0,50,5
1746534677188,BILD 5,A03,894290,Reuther; Keefe,44,0,50,6
1746534677188,BILD 5,A04,894291,Reuther; Keefe,48,0,50,2
1746534678214,BILD 24,A01,894297,Pirino; Giorgia,40,0,60,20
1746534679282,BIMM 100,B01,958915,Staff,72,0,100,28
1746534680312,BIMM 101,A01,895017,McDonnell; Lisa Marie,0,5,24,24
1746534680312,BIMM 101,A02,895018,McDonnell; Lisa Marie,0,5,24,24
1746534680312,BIMM 101,B01,895020,McDonnell; Lisa Marie,0,6,24,24
1746534680312,BIMM 101,B02,895021,McDonnell; Lisa Marie,0,4,24,24
1746534681341,BIMM 110,A01,895023,Staff,1,0,25,24
1746534681341,BIMM 110,A02,895024,Staff,9,0,25,16
1746534681341,BIMM 110,A03,895025,Staff,18,0,25,7
1746534681341,BIMM 110,A04,895031,Staff,20,0,25,5
1746534682369,BIMM 120,A01,895114,Gustafson-Brown; Cindy,13,0,28,15
1746534682369,BIMM 120,A02,895126,Gustafson-Brown; Cindy,21,0,27,6
1746534683398,BIPN 100,A01,895130,Yang; Mingyu,1,0,38,37
1746534683398,BIPN 100,A02,895131,Yang; Mingyu,32,0,38,6
1746534683398,BIPN 100,A03,895132,Yang; Mingyu,32,0,38,6
1746534683398,BIPN 100,A04,895133,Yang; Mingyu,27,0,36,9
1746534684425,BIPN 120,A01,895135,Cooke; James Edward,0,3,13,13
1746534684425,BIPN 120,A02,895136,Cooke; James Edward,0,1,13,13
1746534684425,BIPN 120,A03,895137,Cooke; James Edward,0,3,13,13
1746534684425,BIPN 120,A04,895156,Cooke; James Edward,0,2,11,11
1746534685460,BIPN 134,A01,895235,Cooke; James Edward,0,2,25,25
1746534685460,BIPN 134,A02,895237,Cooke; James Edward,0,0,25,25
1746534685460,BIPN 134,A03,895240,Cooke; James Edward,3,0,25,22
1746534685460,BIPN 134,A04,895270,Cooke; James Edward,20,0,25,5
1746534686493,BIPN 189,A00,892103,Staff,0,13,14,14
1746534688548,BISP 194,A00,958008,Staff,0,2,0,0
1746534689578,CAT 124,A01,922009,Staff,0,5,20,20
1746534690623,CAT 125R,A00,886390,Morales; Celeste Georgianna,0,2,20,20
1746534690623,CAT 125R,B00,886391,Irwin; Matthew Joseph,0,3,20,20
1746534690623,CAT 125R,C00,886392,Smith; Lauryn Alissa,0,2,20,20
1746534690623,CAT 125R,D00,886393,Vanderschuit; Maya Alysia,0,2,20,20
1746534690623,CAT 125R,E00,886394,Marchisotto; Jennifer Anne,0,4,20,20
1746534691658,CENG 15,A01,886218,Drews; Aaron,3,0,8,5
1746534692687,CENG 113,A00,886219,Opatkiewicz; Justin Paul,15,0,25,10
1746534693714,CGS 101,A00,887044,Staff,7,0,20,13
1746534694746,CGS 105,A01,887046,Staff,14,0,25,11
1746534695777,CGS 112,A00,887047,Cuong; Marisol,12,0,15,3
1746534696802,CGS 113,A00,887048,Staff,23,0,30,7
1746534697828,CGS 120,A00,887049,Staff,10,0,17,7
1746534698866,CHEM 6A,A01,886336,Lam; Tin Yiu,38,0,50,12
1746534698866,CHEM 6A,A02,886338,Lam; Tin Yiu,37,0,50,13
1746534699903,CHEM 6B,A01,886341,Hopkins; Patrycja Anna,16,0,50,34
1746534699903,CHEM 6B,A02,886343,Hopkins; Patrycja Anna,42,0,50,8
1746534700931,CHEM 6C,A01,886346,Albizati; Kim F.,0,2,50,50
1746534700931,CHEM 6C,A02,886348,Albizati; Kim F.,23,0,50,27
1746534701958,CHEM 40A,A01,886352,Klosterman; Jeremy K,65,0,100,35
1746534702985,CHEM 40B,A01,886356,Klosterman; Jeremy K,0,23,100,100
1746534704020,CHEM 41B,A01,886360,Theodorakis; Emmanuel,25,0,50,25
1746534704020,CHEM 41B,A02,886362,Theodorakis; Emmanuel,47,0,50,3
1746534705047,CHIN 165A,A00,886382,Xu; Li,18,0,20,2
1746534706076,CLAS 120,A00,886387,Myerston Santana; Jacobo,33,0,40,7
1746534707110,COGS 9,A01,886967,Shannon; Kyle Michael,42,0,60,18
1746534708136,COGS 11,A01,886969,Staff,11,0,30,19
1746534709164,COGS 14A,A01,886971,Staff,6,0,60,54
1746534710192,COGS 14B,A01,886973,Hoffman; Drew Ellen,4,0,60,56
1746534711217,COGS 18,A01,886975,Morgan; Eric,35,0,60,25
1746534712281,COGS 20,A01,886977,Staff,4,0,8,4
1746534712281,COGS 20,A02,886978,Staff,5,0,7,2
1746534713308,COGS 100,A01,907783,Staff,0,2,30,30
1746534714340,COGS 101B,A01,886980,Staff,0,3,48,48
1746534715368,COGS 101C,A01,886982,Delgado; Tania,0,5,44,44
1746534716397,COGS 102A,A01,886984,Johnson; Christine M.,4,0,30,26
1746534717427,COGS 118B,A01,886986,Staff,0,3,88,88
1746534718459,COGS 150,A01,886988,Bergen; Benjamin,23,0,50,27
1746534719487,COGS 153,A00,886989,Delgado; Tania,0,2,41,41
1746534720514,COGS 186,A01,886991,Staff,0,0,32,32
1746534721545,COGS 187A,A01,886993,Boyle; Mary E. T.,7,0,30,23
1746534722574,COGS 189,A00,886994,Staff,0,1,30,30
1746534723600,COMM 10,A01,886996,Staff,0,0,20,21
1746534723600,COMM 10,A02,886997,Staff,12,0,20,8
1746534723600,COMM 10,A03,959845,Staff,19,0,20,1
1746534724631,COMM 20,A01,886999,Leuning; Grant Maurstad,24,0,40,16
1746534726689,COMM 100A,A01,887002,Staff,0,0,20,25
1746534726689,COMM 100A,A02,887003,Staff,7,0,20,13
1746534727716,COMM 100B,A01,887005,Staff,0,8,20,24
1746534728742,COMM 106D,A00,887006,Staff,14,0,40,26
1746534729774,COMM 110G,A00,887007,Whitworth-Smith; Andrew C,12,0,40,28
1746534730802,COMM 111B,A00,887008,Staff,31,0,40,9
1746534731827,COMM 113T,A00,887009,Abuelhiga; Soraya Jill,28,0,40,12
1746534731827,COMM 113T,B00,906733,Staff,40,0,40,0
1746534732857,COMM 145,A00,887010,Staff,12,0,40,28
1746534733884,COMM 146,A00,887054,Staff,31,0,40,9
1746534734909,COMM 190,A00,887012,Staff,8,0,23,15
1746534735941,CSE 8A,A50,887015,Cao; Yingjun,57,0,85,28
1746534736966,CSE 11,A01,887017,Cao; Yingjun,12,0,70,58
1746534737995,CSE 20,A01,887019,Staff,30,0,50,20
1746534739029,CSE 21,A01,887021,Staff,78,0,100,22
1746534739029,CSE 21,B01,892583,Braun; Oliver,45,0,50,5
1746534740062,CSE 30,A01,887025,Eldon; John,143,0,200,57
1746534741089,CSE 100,A01,887027,Staff,26,0,50,24
1746534741089,CSE 100,A02,887028,Staff,40,0,50,10
1746534742117,CSE 101,A01,887030,Braun; Oliver,75,0,100,25
1746534742117,CSE 101,B01,887032,Jones; Miles E,0,3,50,50
1746534742117,CSE 101,B02,887033,Jones; Miles E,0,1,50,50
1746534743145,CSE 105,A01,908084,Jones; Miles E,32,0,50,18
1746534743145,CSE 105,A02,908087,Jones; Miles E,33,0,50,17
1746534744173,CSE 135,A01,887035,Powell; Thomas Allan,0,4,50,50
1746534745199,CSE 142,A01,887037,Staff,8,0,60,52
1746534746226,CSE 142L,A01,887039,Staff,34,0,60,26
1746534747252,CSE 151A,A01,887041,Solares; Edwin A,48,0,100,52
1746534748281,CSE 175,A01,887043,Kumar; Rakesh,30,0,30,0
1746534749309,CSS 1,A01,886389,Staff,0,1,40,40
1746534750338,DSC 30,A01,908097,Liao; Soohyun Nam,47,0,75,28
1746534751364,DSC 40A,A01,908099,Shannon; Kyle Michael,30,0,50,20
1746534752395,DSC 40B,A01,908112,Staff,16,0,50,34
1746534753422,DSC 80,A01,908116,Staff,19,0,60,41
1746534754451,DSC 197,001,956863,Eldridge; Justin Matthew,9999,0,9999,0
1746534755483,ECE 5,A01,886400,Morris; Karcher William,2,0,6,4
1746534755483,ECE 5,A02,886401,Morris; Karcher William,3,0,6,3
1746534756509,ECE 148,A01,886403,Silberman; Jack,0,14,14,14
1746534757543,ECON 1,A01,887265,Crane; Meredith Helen,12,0,70,58
1746534757543,ECON 1,B01,887268,Staff,43,0,50,7
1746534758568,ECON 2,A01,887273,Crane; Meredith Helen,56,0,70,14
1746534759597,ECON 3,A01,887279,Rondina; Giacomo,32,0,70,38
1746534760625,ECON 4,A01,887282,Anderson; John Charles,0,2,10,10
1746534761652,ECON 5,A01,887285,Staff,33,0,45,12
1746534761652,ECON 5,B01,887292,Staff,41,0,45,4
1746534762750,ECON 100A,A01,887337,Newhouse; Herbert S,54,0,70,16
1746534762750,ECON 100A,B01,887349,Staff,45,0,50,5
1746534763780,ECON 100B,A01,887361,Du; Songzi,29,0,70,41
1746534764814,ECON 100C,A01,887445,Newhouse; Herbert S,59,0,70,11
1746534765850,ECON 105,A00,887488,Vespa; Emanuel Ignacio,23,0,35,12
1746534766876,ECON 109,A01,887506,Shishkin; Denis,28,0,35,7
1746534767910,ECON 110A,A01,887568,Alon; Titan Michael,0,3,35,35
1746534767910,ECON 110A,B01,907601,Alon; Titan Michael,20,0,35,15
1746534768941,ECON 110B,A01,887598,Levkoff; Steven B.,0,23,70,70
1746534769969,ECON 112,A00,887599,Rondina; Giacomo,19,0,35,16
1746534771008,ECON 120A,A01,887603,Dai; Yinlin,36,0,70,34
1746534772037,ECON 120C,A01,887608,Sun; Yixiao,0,1,35,35
1746534772037,ECON 120C,B01,887614,Sun; Yixiao,0,0,35,35
1746534773070,ECON 138,A00,887621,Bharadwaj; Prashant,0,20,20,20
1746534774098,ECON 144,A00,958007,Squires; Dale E,13,0,35,22
1746534775129,ECON 171,A01,907666,Staff,18,0,35,17
1746534776157,ECON 175,A00,887626,Wu; Pak Yeung,23,0,35,12
1746534777188,ECON 190,A00,887640,Vespa; Emanuel Ignacio,23,0,35,12
1746534778226,EDS 25,A01,888197,Staff,0,0,0,0
1746534778226,EDS 25,A02,888209,Staff,0,0,0,0
1746534778226,EDS 25,A03,888210,Staff,0,0,0,0
1746534778226,EDS 25,A04,888212,Staff,0,0,0,0
1746534778226,EDS 25,A05,888213,Staff,0,0,0,0
1746534778226,EDS 25,A06,888214,Staff,0,0,0,0
1746534778226,EDS 25,A07,888235,Staff,0,2,0,0
1746534778226,EDS 25,A08,888236,Staff,0,0,0,0
1746534778226,EDS 25,A09,888240,Staff,0,0,0,0
1746534778226,EDS 25,A10,888244,Staff,0,0,0,0
1746534778226,EDS 25,B01,888273,Staff,0,0,0,0
1746534778226,EDS 25,B02,888285,Staff,0,0,0,0
1746534778226,EDS 25,B03,888423,Staff,0,0,0,1
1746534778226,EDS 25,B04,888432,Staff,0,0,0,0
1746534778226,EDS 25,B05,888433,Staff,0,0,0,0
1746534778226,EDS 25,B06,888467,Staff,0,0,0,0
1746534778226,EDS 25,B07,888468,Staff,0,0,0,0
1746534778226,EDS 25,B08,888479,Staff,0,0,0,0
1746534778226,EDS 25,B09,888484,Staff,0,0,0,0
1746534778226,EDS 25,B10,888487,Staff,0,0,0,0
1746534779253,EDS 38,A01,907700,Choi; Bailey Miyeon,30,0,30,0
1746534780284,EDS 112,A01,888601,Chapman; Thandeka K,14,0,40,26
1746534781312,EDS 115,A00,888697,Mendez; Kathrina Mendoza,10,0,30,20
1746534782340,EDS 116,A01,888893,Staff,35,0,40,5
1746534784395,EDS 124AR,A00,889133,Staff,29,0,50,21
1746534784395,EDS 124AR,B00,907471,Simon; Elizabeth A,37,0,50,13
1746534785422,EDS 124BR,A00,889134,Simon; Elizabeth A,45,0,100,55
1746534786452,EDS 125,A00,889135,Staff,25,0,30,5
1746534787481,EDS 126,A01,889138,Staff,36,0,40,4
1746534788509,EDS 164R,A01,889142,Wishard Guerra; Alison G.,33,0,50,17
1746534789538,ENG 30,A01,886396,Staff,0,0,0,0
1746534789538,ENG 30,B01,886398,Staff,0,0,0,0
1746534790575,ENVR 102,A00,906150,Montejo; Carolina,23,0,25,2
1746534791604,ETHN 103A,A00,887236,Man; Simeon S,0,3,0,0
1746534792633,ETHN 113,A00,887239,Staff,16,0,30,14
1746534793663,ETHN 116,A00,887240,Staff,16,0,25,9
1746534794691,ETHN 117,A00,887241,Choi; Esther Min,28,0,30,2
1746534795717,ETHN 118,A00,887243,Staff,24,0,30,6
1746534796743,ETHN 127,A00,887248,Cuong; Marisol,11,0,15,4
1746534797775,ETHN 139,A00,887250,Staff,7,0,10,3
1746534798809,ETHN 142,A00,887252,Staff,10,0,30,20
1746534799836,ETHN 161,A00,887253,Browne; Errol Tsekani,24,0,30,6
1746534800865,ETHN 163FR,A00,887255,Burelle; Julie Sara Veronique,0,0,5,5
1746534801894,GLBH 20,A00,889149,Elwardani; Nile Regina,8,0,42,34
1746534803950,GLBH 111,A01,889152,Burgos; Jose L.,17,0,17,0
1746534804984,GLBH 150,A00,889181,Sloane; Julia Kathryn,0,5,15,15
1746534807045,HDS 60,A01,886406,Warstadt; Melissa Fawn,73,0,80,7
1746534808072,HIAF 111,A00,889324,Gyamfi; Bright,25,0,32,7
1746534809101,HIEA 131,A00,889328,Staff,16,0,32,16
1746534810128,HIEA 144,A00,889333,Henry; Todd A.,26,0,32,6
1746534811157,HIEA 154,A00,889336,Henry; Todd A.,24,0,32,8
1746534812186,HIEU 106,A00,889339,Staff,22,0,32,10
1746534814239,HIEU 114,A00,889340,Staff,3,0,32,29
1746534815267,HIEU 135GS,A00,889342,Patterson; Patrick H.,0,0,1,24
1746534816291,HIEU 137,A00,889343,Edington; Claire Ellen,9,0,25,16
1746534817317,HIEU 148,A00,889345,Staff,14,0,32,18
1746534818344,HIEU 154,A00,889346,Biess; Frank Peter,21,0,32,11
1746534819369,HILA 102,A00,889351,Staff,12,0,32,20
1746534820395,HILD 2A,A01,889221,Lewandoski; Julia Mavis,1,10,32,31
1746534821421,HILD 7B,A01,889225,Man; Simeon S,0,13,32,32
1746534822451,HILD 7C,A01,889288,Alvarez; Luis A,0,14,32,32
1746534823480,HILD 30,A01,889323,Staff,0,5,32,32
1746534825541,HISC 119,A00,889383,Golan; Tal,21,0,32,11
1746534826566,HIUS 103,A00,889384,Man; Simeon S,0,0,32,32
1746534827594,HIUS 117,A00,919797,Kwak; Nancy,18,0,32,14
1746534828622,HIUS 142A,A00,919788,Staff,22,0,32,10
1746534830676,HIUS 149,A00,889386,Gyamfi; Bright,27,0,32,5
1746534831703,HIUS 155,A00,889387,Alvarez; Luis A,14,0,32,18
1746534832738,HUM 3,A01,886499,Caldwell; Michael Alan,19,0,50,31
1746534833773,HUM 3GS,A00,886500,Rodriguez; Bretton Sigfred,0,0,0,28
1746534834806,HUM 3R,A01,886502,Markman; Kristina,0,36,50,50
1746534835841,HUM 4,A01,886504,Crum; Matthew Stephen,24,0,50,26
1746534835841,HUM 4,B01,886506,West; Geoffrey Scott,17,0,50,33
1746534836867,HUM 4GS,A00,886507,Staff,0,0,0,19
1746534837897,HUM 5,A01,886509,Staff,32,0,50,18
1746534838931,HUM 5R,A01,886511,Zavodny; Tatiana Sophia,0,39,50,50
1746534839958,JAPN 180,A00,886407,Staff,18,0,40,22
1746534840987,LATI 50,A01,886409,Martin-Cabrera; Luis,4,0,22,18
1746534840987,LATI 50,A02,886410,Martin-Cabrera; Luis,19,0,22,3
1746534840987,LATI 50,A03,886411,Martin-Cabrera; Luis,21,0,22,1
1746534840987,LATI 50,A04,886412,Martin-Cabrera; Luis,9,0,22,13
1746534842015,LAWS 101,A00,907664,Staff,28,0,60,32
1746534843046,LIAB 1A,A00,889388,Saab; Dima,17,0,20,3
1746534844080,LIAB 1AX,A00,889389,El Cheddadi; Youniss,17,0,20,3
1746534845113,LIFR 1C,A00,889391,Van Moer; Vinciane G,8,0,20,12
1746534846140,LIFR 1CX,A00,889392,Van Moer; Vinciane G,7,0,20,13
1746534847171,LIFR 1D,A00,889393,Van Moer; Vinciane G,7,0,20,13
1746534848200,LIFR 1DX,A00,889394,Van Moer; Vinciane G,8,0,20,12
1746534849230,LIGN 7,A00,886923,Staff,24,0,50,26
1746534850263,LIGN 17,A00,886924,Kehler; Andrew Scott,125,0,150,25
1746534851291,LTAM 110,A00,889395,Staff,15,0,30,15
1746534852316,LTAM 110GS,A00,958010,Rodriguez; Bretton Sigfred,0,0,0,28
1746534853344,LTCH 101,A00,889397,Staff,23,0,25,2
1746534854372,LTCS 130,A00,889398,Staff,23,0,25,2
1746534855399,LTEA 138,A00,889399,Staff,24,0,40,16
1746534856426,LTEN 149,A00,889400,Wesling; Megan E.,0,3,25,25
1746534857454,LTEN 169,A00,889401,Staff,20,0,25,5
1746534858484,LTEN 180,A00,889402,Staff,10,0,15,5
1746534859511,LTEN 181,A00,889403,Staff,21,0,25,4
1746534860538,LTWL 100,A00,889404,Myerston Santana; Jacobo,3,0,25,22
1746534861567,LTWL 180GS,A00,889405,Staff,0,0,20,20
1746534862597,LTWL 181,A00,889406,Staff,17,0,25,8
1746534863629,LTWL 184,A00,889475,Mukherjee; Silpa,22,0,25,3
1746534864657,LTWR 102C,A00,889486,Staff,29,0,30,1
1746534865684,LTWR 115W,A00,889491,Staff,0,2,15,15
1746534866715,MAE 8,A01,886905,Staff,0,2,0,0
1746534867750,MAE 11,A00,886906,Bandaru; Prabhakar,0,7,50,50
1746534868783,MAE 20,A00,886907,Evdokimenko; Ekaterina,44,0,70,26
1746534869811,MAE 30B,A00,886909,Ghazinejad; Maziar,26,0,45,19
1746534870839,MAE 101B,A00,886910,Saintillan; David,29,0,45,16
1746534871870,MAE 105,A00,886911,Bandaru; Prabhakar,18,0,50,32
1746534872899,MAE 107,B00,958024,Staff,9,0,50,41
1746534873928,MAE 143B,A00,886913,Bewley; Thomas R,7,0,40,33
1746534874954,MAE 148,A01,886915,Silberman; Jack,0,3,14,14
1746534875982,MAE 160,A00,886916,Evdokimenko; Ekaterina,31,0,60,29
1746534877012,MATH 3C,A01,889681,Staff,0,3,30,30
1746534877012,MATH 3C,A02,960048,Staff,25,0,30,5
1746534878042,MATH 10A,A01,889760,Staff,26,0,30,4
1746534878042,MATH 10A,A02,889783,Staff,29,0,30,1
1746534879073,MATH 10B,A01,889785,Verstraete; Jacques Allan,2,0,35,33
1746534879073,MATH 10B,A02,889795,Verstraete; Jacques Allan,4,0,35,31
1746534879073,MATH 10B,B01,889797,Verstraete; Jacques Allan,3,0,35,32
1746534879073,MATH 10B,B02,889828,Verstraete; Jacques Allan,3,0,35,32
1746534880111,MATH 10C,A01,889849,Habib; Yousaf,9,0,30,21
1746534880111,MATH 10C,A02,889852,Habib; Yousaf,14,0,30,16
1746534880111,MATH 10C,A03,889853,Habib; Yousaf,22,0,30,8
1746534880111,MATH 10C,A04,889858,Habib; Yousaf,20,0,30,10
1746534880111,MATH 10C,B01,889861,Staff,1,0,30,29
1746534880111,MATH 10C,B02,889862,Staff,24,0,30,6
1746534880111,MATH 10C,B03,889863,Staff,27,0,30,3
1746534880111,MATH 10C,B04,889967,Staff,23,0,30,7
1746534881181,MATH 18,A01,889974,Staff,7,0,30,23
1746534881181,MATH 18,A02,889977,Staff,20,0,30,10
1746534881181,MATH 18,B01,889984,Hardiman; Liam,22,0,30,8
1746534881181,MATH 18,B02,889985,Hardiman; Liam,25,0,30,5
1746534882213,MATH 20A,A01,889990,Suk; Andrew Hoon,29,0,35,6
1746534883249,MATH 20B,A01,889993,Ohm; Ko Woon,22,0,30,8
1746534883249,MATH 20B,A02,889994,Ohm; Ko Woon,30,0,30,0
1746534883249,MATH 20B,B01,889996,Ohm; Ko Woon,21,0,30,9
1746534883249,MATH 20B,B02,889997,Ohm; Ko Woon,23,0,30,7
1746534884285,MATH 20C,A01,889999,Hammock; Frances H,17,0,30,13
1746534884285,MATH 20C,A02,890003,Hammock; Frances H,23,0,30,7
1746534884285,MATH 20C,B01,890006,Hammock; Frances H,3,0,30,27
1746534884285,MATH 20C,B02,890007,Hammock; Frances H,11,0,30,19
1746534885313,MATH 20D,A01,890011,Cheng; Hsiao-Bing,1,1,30,29
1746534885313,MATH 20D,A02,890012,Cheng; Hsiao-Bing,14,0,30,16
1746534885313,MATH 20D,B01,890016,Cheng; Hsiao-Bing,13,0,30,17
1746534885313,MATH 20D,B02,890017,Cheng; Hsiao-Bing,13,0,30,17
1746534886349,MATH 20E,A01,890026,Harel; Guershon,1,0,30,29
1746534886349,MATH 20E,A02,890029,Harel; Guershon,23,0,30,7
1746534886349,MATH 20E,B01,890033,Harel; Guershon,7,0,30,23
1746534886349,MATH 20E,B02,890101,Harel; Guershon,21,0,30,9
1746534887379,MATH 102,A01,890104,Staff,17,0,30,13
1746534887379,MATH 102,A02,890105,Staff,27,0,30,3
1746534888414,MATH 103B,A01,890116,Salehi Golsefidy; Alireza,3,0,30,27
1746534888414,MATH 103B,B01,890118,Staff,0,3,34,34
1746534889447,MATH 109,A01,890121,Aliabadi Sr.; Mohsen,1,0,30,29
1746534889447,MATH 109,B01,890124,Upadrashta; Pranav Kumar,18,0,30,12
1746534890475,MATH 120A,A01,890126,Eggers; John Dietrich,13,0,30,17
1746534891504,MATH 142B,A01,890128,Ioana; Adrian,19,0,30,11
1746534891504,MATH 142B,A02,890129,Ioana; Adrian,13,0,30,17
1746534892532,MATH 154,A01,890174,Staff,0,0,30,30
1746534892532,MATH 154,A02,890182,Staff,0,0,30,30
1746534893557,MATH 168A,A01,890197,Dumitriu; Ioana,21,0,35,14
1746534894583,MATH 170A,A01,890240,Nie; Jiawang,1,0,30,29
1746534894583,MATH 170A,A02,890241,Nie; Jiawang,11,0,30,19
1746534894583,MATH 170A,A03,890249,Nie; Jiawang,23,0,30,7
1746534895610,MATH 170B,A01,957891,Nag; Panchali,13,0,35,22
1746534897668,MATH 181A,A01,908025,Staff,0,4,35,35
1746534897668,MATH 181A,A02,960115,Staff,27,0,35,8
1746534898700,MATH 181B,A01,959874,Staff,26,0,30,4
1746534899728,MATH 193B,A01,890265,Staff,0,4,35,35
1746534900756,MGT 4,A01,890311,Anderson; John Charles,42,0,88,46
1746534901784,MGT 5,A00,907740,Staff,13,0,98,85
1746534902818,MGT 12,A00,890312,Lindenberger; Wade Douglas,67,0,98,31
1746534903848,MGT 16,A00,957883,Staff,78,0,98,20
1746534905902,MGT 45,A00,890314,Pecore; Joseph P.,47,0,98,51
1746534906930,MGT 71,A00,890315,Staff,0,11,98,98
1746534907961,MGT 100,A00,890316,Yavorsky; Daniel Ryan,44,0,98,54
1746534909002,MGT 103,A00,890317,Ehrich; Kristine R,73,0,98,25
1746534910032,MGT 105,A00,890356,Bates; Kenneth Walter,0,7,98,98
1746534911058,MGT 112,A00,890360,Ehrich; Kristine R,55,0,98,43
1746534912083,MGT 127R,A00,907732,Zhu; Kevin Xiaoguo,23,0,98,75
1746534913114,MGT 131B,A00,890361,Anderson; John Charles,61,0,98,37
1746534914145,MGT 137,A00,890362,Lindenberger; Wade Douglas,65,0,98,33
1746534915173,MGT 160,A00,890369,Johnson; Erik Barry,9,0,98,89
1746534917228,MGT 164,A00,890372,Zimmermann; Carsten,0,39,98,98
1746534918253,MGT 180,A00,890374,Bliss; Barbara Ann,12,0,98,86
1746534919287,MMW 15,A01,886414,Chang; Edmond Yi-Teh,0,12,28,28
1746534919287,MMW 15,A02,886415,Chang; Edmond Yi-Teh,0,8,28,28
1746534919287,MMW 15,A03,886416,Chang; Edmond Yi-Teh,0,8,28,28
1746534919287,MMW 15,A04,886417,Chang; Edmond Yi-Teh,0,8,28,28
1746534919287,MMW 15,B01,886419,Chang; Edmond Yi-Teh,0,7,28,28
1746534919287,MMW 15,B02,886420,Chang; Edmond Yi-Teh,0,8,28,28
1746534919287,MMW 15,B03,886421,Chang; Edmond Yi-Teh,0,7,28,28
1746534919287,MMW 15,B04,886422,Chang; Edmond Yi-Teh,0,8,28,28
1746534919287,MMW 15,C01,886424,Staff,0,9,28,28
1746534919287,MMW 15,C02,886425,Staff,0,8,28,28
1746534919287,MMW 15,C03,886426,Staff,0,8,28,28
1746534919287,MMW 15,C04,886427,Staff,0,7,28,28
1746534919287,MMW 15,C05,958038,Staff,0,7,28,28
1746534919287,MMW 15,C06,958039,Staff,0,8,28,28
1746534920321,MMW 15GS,A00,906910,Patterson; Patrick H.,4,0,28,24
1746534921363,MMW 122R,A01,886429,Rahimi; Babak,0,13,28,28
1746534921363,MMW 122R,A02,886430,Rahimi; Babak,0,12,28,28
1746534921363,MMW 122R,A03,958040,Rahimi; Babak,0,11,28,28
1746534922400,MUS 1A,A01,890937,Staff,3,0,25,22
1746534922400,MUS 1A,A02,891035,Staff,6,0,25,19
1746534922400,MUS 1A,C01,958912,Staff,24,0,25,1
1746534922400,MUS 1A,C02,958913,Staff,25,0,25,0
1746534924464,MUS 2AK,A00,957092,Ohnishi; Takae,15,0,15,0
1746534925491,MUS 4,A01,891044,Staff,2,0,25,23
1746534925491,MUS 4,A02,891045,Staff,23,0,25,2
1746534925491,MUS 4,B01,891048,Staff,17,0,25,8
1746534925491,MUS 4,B02,891050,Staff,25,0,25,0
1746534926523,MUS 5,A01,957506,Dubnov; Shlomo,0,0,25,25
1746534926523,MUS 5,A02,957622,Dubnov; Shlomo,14,0,25,11
1746534926523,MUS 5,A03,957623,Dubnov; Shlomo,20,0,25,5
1746534927550,MUS 6,A01,891053,Freitas Caetano; Marcelo,24,0,25,1
1746534927550,MUS 6,A02,891054,Freitas Caetano; Marcelo,23,0,25,2
1746534928582,MUS 7,A01,891081,Staff,0,0,25,25
1746534928582,MUS 7,A02,891082,Staff,4,0,25,21
1746534929611,MUS 8GS,A00,891118,Borgo; David Garcia,0,0,25,25
1746534930641,MUS 11,A01,891140,Staff,11,0,25,14
1746534930641,MUS 11,A02,891141,Staff,22,0,25,3
1746534931666,MUS 13,A01,891143,Staff,8,0,25,17
1746534931666,MUS 13,A02,891144,Staff,24,0,25,1
1746534932698,MUS 15,A01,891146,Staff,9,0,25,16
1746534932698,MUS 15,A02,891148,Staff,21,0,25,4
1746534932698,MUS 15,B01,891150,Staff,18,0,25,7
1746534932698,MUS 15,B02,891151,Staff,25,0,25,0
1746534933727,MUS 20,A01,891153,Staff,5,0,20,15
1746534933727,MUS 20,A02,891155,Staff,14,0,20,6
1746534934756,MUS 80,A00,891156,Staff,19,0,25,6
1746534934756,MUS 80,B00,891157,Staff,23,0,25,2
1746534935787,MUS 130,A00,891158,Ohnishi; Takae,35,0,35,0
1746534936814,MUS 150GS,A01,891160,Borgo; David Garcia,0,0,25,25
1746534937883,MUS 170,A01,891162,Freitas Caetano; Marcelo,20,0,25,5
1746534937883,MUS 170,A02,891164,Freitas Caetano; Marcelo,21,0,25,4
1746534938910,NANO 11,A00,886220,Vazquez Mena; Oscar,13,0,15,2
1746534939947,NANO 15,A01,886222,Drews; Aaron,4,0,7,3
1746534940974,NANO 104,A00,886224,Sirbuly; Donald,18,0,25,7
1746534942004,PH 40,A00,886528,Staff,23,0,40,17
1746534943033,PH 45,A01,886799,Staff,35,0,40,5
1746534944063,PH 110,A00,886802,Staff,0,7,40,40
1746534945091,PH 172,A00,906716,Staff,19,0,35,16
1746534946116,PH 191,A00,886803,Staff,6,0,40,34
1746534947145,PHIL 1,A00,889500,Staff,19,0,30,11
1746534948182,PHIL 10,A01,889549,Grush; Rick Scott,15,0,22,7
1746534948182,PHIL 10,A02,889551,Grush; Rick Scott,22,0,22,0
1746534949216,PHIL 28,A01,889559,Lamey; Andy M.,0,1,31,31
1746534949216,PHIL 28,A02,889561,Lamey; Andy M.,0,1,30,30
1746534949216,PHIL 28,A03,889572,Lamey; Andy M.,0,0,30,30
1746534950248,PHIL 35,A00,907839,Staff,13,0,15,2
1746534951278,PHIL 60,A00,889574,Staff,74,0,90,16
1746534952304,PHIL 101,A00,958004,Staff,13,0,15,2
1746534954365,PHIL 136,A00,889582,Fulkerson; Matthew Todd,26,0,45,19
1746534955393,PHIL 163,A01,889601,Staff,21,0,30,9
1746534955393,PHIL 163,B01,889606,Brandt; Reuven A,0,3,0,0
1746534956418,PHIL 164,A00,889610,Staff,16,0,30,14
1746534957443,PHIL 165,A00,889613,Staff,23,0,30,7
1746534958475,PHYS 1A,A00,886431,Staff,26,0,70,44
1746534959504,PHYS 1AL,001,886432,Tsai; Philbert S,0,2,30,30
1746534959504,PHYS 1AL,002,886436,Tsai; Philbert S,11,0,30,19
1746534960538,PHYS 1B,A00,886439,Staff,185,0,240,55
1746534961568,PHYS 1BL,001,886441,Tsai; Philbert S,0,4,30,30
1746534961568,PHYS 1BL,002,886444,Tsai; Philbert S,2,0,30,28
1746534962595,PHYS 1C,A00,896092,Arnold; Kam S,78,0,146,68
1746534963623,PHYS 1CL,001,886448,Tsai; Philbert S,0,0,30,30
1746534963623,PHYS 1CL,002,886449,Tsai; Philbert S,0,0,30,30
1746534963623,PHYS 1CL,003,886450,Tsai; Philbert S,15,0,30,15
1746534963623,PHYS 1CL,004,886451,Tsai; Philbert S,15,0,30,15
1746534964650,PHYS 2B,A01,886457,Staff,69,0,115,46
1746534965677,PHYS 2C,A01,886460,Shotwell; Brian,0,8,65,65
1746534966705,PHYS 2CL,A01,886467,Staff,0,4,28,28
1746534966705,PHYS 2CL,A02,886468,Staff,0,3,28,28
1746534967731,PHYS 2D,A01,886470,Staff,10,0,50,40
1746534968760,PHYS 4B,A01,886475,Grinstein; Benjamin,22,0,40,18
1746534969795,POLI 5,A00,891173,Desposato; Scott,7,0,25,18
1746534970822,POLI 5D,A01,891175,Staff,5,0,5,0
1746534970822,POLI 5D,B01,891178,Staff,5,0,5,0
1746534971850,POLI 11,A00,891179,Ferree; Karen E,2,0,35,33
1746534972875,POLI 12,A00,891180,Staff,16,0,30,14
1746534973903,POLI 27,A01,891182,Staff,12,0,75,63
1746534974934,POLI 30,A00,891183,Staff,9,0,50,41
1746534975962,POLI 100B,A00,891244,Staff,5,1,35,30
1746534977013,POLI 100I,A00,891247,Staff,7,0,30,23
1746534978044,POLI 104J,A00,891248,Nichter; Maysa,14,0,30,16
1746534979070,POLI 104U,A00,891250,Nichter; Maysa,2,0,30,28
1746534981120,POLI 110B,A00,891255,Wiens; David,20,0,25,5
1746534982148,POLI 112A,A00,891256,Wiens; David,6,0,25,19
1746534983178,POLI 114BR,A00,891261,Staff,19,0,30,11
1746534984206,POLI 117R,A00,891262,Forman; Fonna,0,6,50,50
1746534985240,POLI 118,A00,891264,Ingham; Sean,17,0,25,8
1746534986351,POLI 124A,A00,891265,Staff,18,0,20,2
1746534987379,POLI 125D,A00,891266,Nichter; Simeon C,2,0,25,23
1746534988406,POLI 126,A00,891268,Nichter; Simeon C,7,0,25,18
1746534989430,POLI 126AA,A00,891272,Staff,18,0,25,7
1746534990456,POLI 130AA,A00,891273,Staff,15,0,20,5
1746534991484,POLI 134AA,A00,891274,Staff,4,0,20,16
1746534993539,POLI 138,A00,891278,Staff,21,0,25,4
1746534994567,POLI 142K,A00,891280,Staff,11,0,25,14
1746534995593,POLI 142M,A00,891281,Gartzke; Erik,17,0,30,13
1746534996624,POLI 142P,A00,891284,Staff,20,0,30,10
1746534997651,POLI 143,A00,891285,Gartzke; Erik,12,0,30,18
1746534998679,POLI 153,A00,891286,Staff,19,0,20,1
1746535000731,POLI 175,A00,891290,Staff,15,0,20,5
1746535001760,PSYC 1,A00,890674,Steiner; Eric Tomas,0,11,45,45
1746535002793,PSYC 2,A00,890676,Albright; Thomas D,21,0,35,14
1746535003823,PSYC 3,A00,890679,Staff,17,0,20,3
1746535004850,PSYC 6,A00,959858,Staff,20,0,20,0
1746535005881,PSYC 60,A01,890684,Rickard; Timothy C.,0,5,45,45
1746535006910,PSYC 70,A01,890689,Geller; Emma Harlan,7,0,30,23
1746535007935,PSYC 71,A01,959860,Staff,21,0,25,4
1746535008966,PSYC 100,A00,890690,Lacefield; Katharine I,0,50,180,180
1746535010000,PSYC 102,A00,890695,Staff,18,0,40,22
1746535011027,PSYC 105,A00,890699,Geller; Emma Harlan,71,0,100,29
1746535012054,PSYC 106,A00,890701,Gorman; Michael R.,5,0,30,25
1746535013087,PSYC 108,A00,890704,Adrian; Julia Anna,0,28,50,50
1746535014117,PSYC 118,A01,890712,Staff,11,0,30,19
1746535015149,PSYC 124,A00,890716,Chapman; Eddie Nathaniel,25,0,60,35
1746535016175,PSYC 131,A00,890717,Anagnostaras; Stephan,0,7,80,80
1746535017206,PSYC 137,A00,890719,Winkielman; Piotr,0,11,30,30
1746535018238,PSYC 144,A00,890721,Adrian; Julia Anna,0,9,45,45
1746535019267,PSYC 162,A00,890805,Staff,2,0,75,73
1746535020294,PSYC 169,A00,890810,Staff,0,15,30,30
1746535021325,PSYC 172,A00,890814,Gorman; Michael R.,9,0,30,21
1746535022351,PSYC 181,A00,890818,Anagnostaras; Stephan,8,0,200,192
1746535023380,PSYC 184,A00,959861,Staff,170,0,175,5
1746535024406,PSYC 189,A00,890823,Staff,0,1,30,30
1746535025432,PSYC 191,A00,890884,Rickard; Timothy C.,0,11,35,35
1746535026461,PSYC 193,A00,890913,Staff,19,0,30,11
1746535026461,PSYC 193,B00,890914,Chapman; Eddie Nathaniel,24,0,30,6
1746535027493,PSYC 193L,A01,890918,Lowe; Angela Beth,20,0,30,10
1746535027493,PSYC 193L,B01,890921,Hurwitz; Ethan Scott,20,0,30,10
1746535027493,PSYC 193L,C01,890928,Staff,30,0,30,0
1746535028526,RELI 149,A00,886806,Rahimi; Babak,23,0,40,17
1746535029555,SE 9,A01,886814,Staff,7,0,20,13
1746535030584,SE 101B,A01,886816,Chadha; Mayank,4,0,35,31
1746535031618,SE 110B,A00,886818,Zhu; Qiang,4,0,75,71
1746535032644,SE 125,A01,886830,Staff,10,0,30,20
1746535033675,SE 130B,A01,886835,Staff,14,0,40,26
1746535034707,SE 131A,A01,886838,Krysl; Petr,34,0,55,21
1746535035736,SE 154,A00,886840,Staff,30,0,50,20
1746535036766,SE 164GS,A01,886849,Staff,6,0,20,14
1746535037796,SE 167GS,A01,886853,Staff,6,0,20,14
1746535038825,SIO 25,A01,890107,Staff,19,0,30,11
1746535039855,SIO 45,A00,890109,Cook; Geoffrey W,117,0,200,83
1746535040889,SIO 109R,A00,890110,Forman; Fonna,0,16,20,20
1746535041917,SIO 187,A01,890114,Kacev; David,15,0,40,25
1746535042947,SOCI 1,A01,890431,Thorpe; Charles Robert,15,0,30,15
1746535042947,SOCI 1,A02,890518,Thorpe; Charles Robert,30,0,30,0
1746535043978,SOCI 2,A01,957978,Staff,25,0,25,0
1746535043978,SOCI 2,A02,957979,Staff,23,0,25,2
1746535045005,SOCI 20,A01,890523,Calderon-Zaks; Michael Aar,23,0,30,7
1746535045005,SOCI 20,A02,890526,Calderon-Zaks; Michael Aar,29,0,30,1
1746535046032,SOCI 30,A01,890533,Pardo Guerra; Juan Pablo,37,0,40,3
1746535047060,SOCI 40,A01,890535,Staff,27,0,45,18
1746535048087,SOCI 104Q,A00,890559,Staff,18,0,30,12
1746535049115,SOCI 106,A00,890560,Arnal; Maud Marie Leonie,20,0,30,10
1746535050143,SOCI 110,A00,890567,Holkenbrink-Monk; Charlene,19,0,30,11
1746535051173,SOCI 112,A00,890568,Victoria Torres; Pablo,1,0,55,54
1746535052205,SOCI 115,A00,890597,Arnal; Maud Marie Leonie,28,0,45,17
1746535054299,SOCI 121,A00,890604,Pardo Guerra; Juan Pablo,38,0,45,7
1746535055326,SOCI 126,A01,890608,Staff,8,0,10,2
1746535056354,SOCI 127,A00,890609,Staff,18,0,30,12
1746535057382,SOCI 131,A00,890610,Thorpe; Charles Robert,37,0,45,8
1746535058409,SOCI 135,A00,890615,Payne; Christine Anna,14,0,45,31
1746535059436,SOCI 139,A00,890620,Staff,38,0,45,7
1746535060461,SOCI 148E,A00,890622,Calderon-Zaks; Michael Aar,36,0,45,9
1746535061489,SOCI 150,A00,890623,Kohler; Kristopher M.,31,0,45,14
1746535062519,SOCI 157,A00,890625,Jules-Rosette; Bennetta W.,18,0,20,2
1746535063548,SOCI 160,A00,890627,Payne; Christine Anna,21,0,45,24
1746535064576,SYN 1,A00,886855,Fish; Gwendolyn Anne,0,0,0,0
1746535064576,SYN 1,B00,906086,Fish; Gwendolyn Anne,0,1,0,2
1746535065605,SYN 2R,A00,886860,Staff,0,17,15,15
1746535065605,SYN 2R,B00,906106,Atkinson; Arthur Laird,0,16,15,15
1746535066637,SYN 100,A01,886866,Browne; Emily,0,28,20,20
1746535066637,SYN 100,B01,906128,Rock; Martin,0,5,20,20
1746535066637,SYN 100,C01,906140,Deavenport; James Cary,0,3,20,20
1746535066637,SYN 100,D01,907816,Deavenport; James Cary,0,5,20,20
1746535067666,TDAC 1,A00,890286,Walsh; Kim C.,9,0,20,11
1746535068693,TDAC 101,A00,890296,Basso; Beatrice,16,0,20,4
1746535069720,TDDE 131,A00,890297,Staff,47,0,50,3
1746535070751,TDDM 1,A00,890287,Weinberg; Sadie,25,0,30,5
1746535072555,TDGE 11,A00,890288,Fulton; Julia,137,0,200,63
1746535072555,TDGE 11,B00,890289,Castro; Robert Jess,184,0,200,16
1746535073586,TDGE 25,B00,957359,Walsh; Kim C.,3,0,20,17
1746535074618,TDGE 40,A01,890292,Power; Jade Yukana,27,0,30,3
1746535075646,TDGE 124,A00,890298,Havis; Allan,0,0,50,50
1746535076675,TDGE 131R,A00,890299,Burelle; Julie Sara Veronique,15,0,42,27
1746535077700,TDHT 101,A00,890300,Staff,10,0,20,10
1746535078728,TDHT 109,A01,890302,Anderson; Mysia Anyse,31,0,40,9
1746535079759,TDMV 1,A00,890293,Arcidiacono; Kristin,18,0,30,12
1746535080786,TDMV 2,A00,890294,Weinberg; Sadie,23,0,30,7
1746535081814,TDMV 3,A00,957878,Arcidiacono; Kristin,28,0,30,2
1746535083868,TDMV 138,A00,890304,Jun; Grace Shin Hae,25,0,40,15
1746535084898,TDMV 140,A00,890305,Corrales; Joseph Bernales,25,0,30,5
1746535085928,TDMV 142,A00,890307,Caligagan; Tony,32,0,40,8
1746535086957,TDMV 144,A00,890308,Camaya; Michelle Ann,25,0,30,5
1746535087987,TDPW 1,A00,890295,Stein; Deborah Isobel,3,0,20,17
1746535089013,USP 2,A01,890272,Lerner; Amy M,6,0,20,14
1746535090040,USP 3,A01,890274,Staff,12,0,30,18
1746535091066,USP 15,A01,890276,Sun; Feiyang,17,0,30,13
1746535092093,USP 25,A00,890277,Shenkman; Michael Thomas,19,0,25,6
1746535093124,USP 138,A00,890278,Staff,13,0,25,12
1746535094151,USP 143,A00,890279,Staff,21,0,70,49
1746535095177,USP 144,A00,890280,Chowdhury; Muhammed Zohir,16,0,30,14
1746535096204,USP 150,A00,890281,Boomhower; Matthew Charles,4,0,30,26
1746535097232,USP 151,A00,890282,Staff,16,0,20,4
1746535098260,USP 162,A00,890283,Andrews; Abigail Leslie,16,0,20,4
1746535099290,USP 168,A00,920477,Kwak; Nancy,1,0,5,4
1746535100315,USP 181,A00,890284,Staff,3,0,20,17
1746535101342,USP 191A,A00,890285,Staff,13,0,20,7
1746535102368,VIS 101,A00,886512,Staff,25,0,75,50
1746535103396,VIS 103,A00,886513,Cruz; Edwin Teddy,61,0,75,14
1746535104421,VIS 108,A00,886514,Staff,3,0,15,12
1746535105449,VIS 127P,A00,886515,Shen; Kuiyi,80,0,146,66
1746535106477,VIS 149,A00,886516,Yoldas; Pinar,0,0,15,15
1746535107503,VIS 164,A00,886526,Erdmann; Dean,19,0,22,3
1746535108529,VIS 194S,A00,886527,Staff,61,0,75,14
1746535109558,WCWP 10A,C00,886484,Martiniuk; Jill,12,0,15,3
1746535110584,WCWP 10B,A00,886490,Uriarte; Emma,0,0,15,15
1746535110584,WCWP 10B,B00,886491,Dhir; Simrita,11,0,15,4
1746535110584,WCWP 10B,C00,886492,Ornelas; Tricia,0,0,15,15
1746535111612,WCWP 100,A00,886494,Young; Mark T,0,7,15,15
1746535113753,AAS 10,A01,886199,Childs; Dennis R.,0,3,0,0
1746535114780,ANAR 104,A01,886940,Shtienberg; Gilad,27,0,30,3
1746535115808,ANAR 120,A00,886953,Staff,12,0,20,8
1746535116835,ANBI 148,A01,886955,Wilder; Linnea Lorene,30,0,40,10
1746535118889,ANSC 122,A00,886957,Staff,25,0,30,5
1746535119921,ANSC 150,A00,886958,Sloane; Julia Kathryn,3,0,15,12
1746535120948,ANSC 156,A00,886959,Jenkins; Janis A.,0,1,15,15
1746535121975,ANSC 180,A00,886960,Staff,11,0,17,6
1746535123003,ANSC 188,A00,886961,Jassal; Aftab,9,0,25,16
1746535124029,ANSC 190,A00,886962,Jassal; Aftab,14,0,25,11
1746535125056,ANSC 191,A00,886963,Staff,18,0,20,2
1746535126085,ANTH 3,A01,891689,Staff,17,0,20,3
1746535127116,ANTH 5,A00,886933,Semendeferi; Ekaterini,16,0,20,4
1746535128142,ANTH 10,A00,886934,Staff,0,12,30,30
1746535129169,ANTH 21,A01,886936,Staff,40,0,60,20
1746535130195,ANTH 23,A01,886938,Staff,92,0,100,8
1746535131222,ANTH 105,A00,886964,Stewart; Alexander B,84,0,100,16
1746535132249,ANTH 108,A00,886965,Pedersen; David,9,0,20,11
1746535133281,AWP 10,001,886147,Staff,0,0,0,0
1746535133281,AWP 10,002,886148,Staff,0,0,0,0
1746535133281,AWP 10,003,886149,Staff,0,0,0,0
1746535133281,AWP 10,004,886150,Staff,0,0,0,0
1746535133281,AWP 10,005,886151,Staff,0,0,0,0
1746535133281,AWP 10,006,886152,Staff,0,0,0,0
1746535133281,AWP 10,007,886153,Staff,0,0,0,0
1746535133281,AWP 10,008,886154,Staff,0,0,0,0
1746535133281,AWP 10,009,886155,Staff,0,0,0,0
1746535133281,AWP 10,010,886156,Staff,0,0,0,0
1746535133281,AWP 10,011,886158,Staff,0,0,0,0
1746535133281,AWP 10,012,886160,Staff,0,0,0,0
1746535133281,AWP 10,013,886161,Staff,0,0,0,0
1746535133281,AWP 10,014,886162,Staff,0,0,0,0
1746535133281,AWP 10,015,886163,Staff,0,0,0,0
1746535133281,AWP 10,016,886164,Staff,0,0,0,0
1746535133281,AWP 10,017,886165,Staff,0,0,0,0
1746535133281,AWP 10,018,886166,Staff,0,0,0,0
1746535133281,AWP 10,019,886168,Staff,0,0,0,0
1746535133281,AWP 10,020,886170,Staff,0,0,0,0
1746535133281,AWP 10,021,886172,Staff,0,0,0,0
1746535134318,AWP 10R,001,886173,Staff,0,1,0,0
1746535134318,AWP 10R,002,886174,Staff,0,1,0,0
1746535134318,AWP 10R,003,886175,Staff,0,0,0,0
1746535134318,AWP 10R,004,886176,Staff,0,0,0,0
1746535134318,AWP 10R,005,886177,Staff,0,0,0,0
1746535134318,AWP 10R,006,886178,Staff,0,0,0,0
1746535134318,AWP 10R,007,886179,Staff,0,0,0,0
1746535134318,AWP 10R,008,886181,Staff,0,0,0,0
1746535134318,AWP 10R,009,886182,Staff,0,0,0,0
1746535134318,AWP 10R,010,886183,Staff,0,0,0,0
1746535134318,AWP 10R,011,886184,Staff,0,0,0,0
1746535134318,AWP 10R,012,886185,Staff,0,0,0,0
1746535134318,AWP 10R,013,886186,Staff,0,0,0,0
1746535134318,AWP 10R,014,886187,Staff,0,0,0,0
1746535134318,AWP 10R,015,886188,Staff,0,0,0,0
1746535134318,AWP 10R,016,886189,Staff,0,0,0,0
1746535135347,AWP 102R,A00,886190,Staff,0,0,0,0
1746535135347,AWP 102R,B00,886191,Staff,0,0,0,0
1746535136373,BENG 100,A01,886193,Staff,17,0,30,13
1746535137405,BENG 122A,A01,886195,Hasty; Jeff M,13,0,30,17
1746535138430,BENG 166A,A00,886196,Sah; Robert Lie-Yuan,0,1,30,30
1746535139459,BENG 190,A00,958050,Khojah; Reem I,24,0,25,1
1746535140495,BIBC 102,A01,894320,Staff,0,0,46,46
1746535140495,BIBC 102,A02,894321,Staff,1,0,46,45
1746535140495,BIBC 102,A03,894344,Staff,7,0,46,39
1746535140495,BIBC 102,A04,894345,Staff,26,0,47,21
1746535141534,BICD 100R,A01,894365,Smith; Laurie,0,3,58,58
1746535141534,BICD 100R,A02,894366,Smith; Laurie,0,5,58,58
1746535141534,BICD 100R,A03,894367,Smith; Laurie,2,0,59,57
1746535141534,BICD 100R,A04,959869,Smith; Laurie,41,0,59,18
1746535142563,BICD 136,A01,894383,Gustafson-Brown; Cindy,14,0,50,36
1746535143593,BIEB 102,A01,894494,Butler; Shannon Rhey,51,0,130,79
1746535145661,BIEB 150,A01,894617,Wills; Christopher,3,0,20,17
1746535145661,BIEB 150,A02,894631,Wills; Christopher,3,0,20,17
1746535145661,BIEB 150,A03,894937,Wills; Christopher,3,0,20,17
1746535145661,BIEB 150,A04,894946,Wills; Christopher,5,0,20,15
1746535146686,BIEB 194,A00,906141,Kurle; Carolyn M.,6,0,20,14
1746535147713,BILD 1,A01,894154,Staff,2,0,19,17
1746535147713,BILD 1,A02,894155,Staff,14,0,19,5
1746535147713,BILD 1,A03,894160,Staff,13,0,19,6
1746535147713,BILD 1,A04,894161,Staff,15,0,18,3
1746535148743,BILD 2,A01,894168,Staff,0,0,50,50
1746535148743,BILD 2,A02,894169,Staff,0,0,50,50
1746535148743,BILD 2,A03,894179,Staff,4,0,50,46
1746535148743,BILD 2,A04,894203,Staff,27,0,50,23
1746535149779,BILD 3,A01,894213,Staff,22,0,31,9
1746535149779,BILD 3,A02,894214,Staff,26,0,31,5
1746535149779,BILD 3,A03,894235,Staff,28,0,31,3
1746535149779,BILD 3,A04,894236,Staff,28,0,32,4
1746535150811,BILD 4,A01,894253,Reuther; Keefe,5,0,24,19
1746535150811,BILD 4,A02,894258,Reuther; Keefe,16,0,24,8
1746535151845,BILD 5,A01,894276,Reuther; Keefe,35,0,50,15
1746535151845,BILD 5,A02,894277,Reuther; Keefe,45,0,50,5
1746535151845,BILD 5,A03,894290,Reuther; Keefe,44,0,50,6
1746535151845,BILD 5,A04,894291,Reuther; Keefe,48,0,50,2
1746535152885,BILD 24,A01,894297,Pirino; Giorgia,40,0,60,20
1746535153917,BIMM 100,B01,958915,Staff,72,0,100,28
1746535154951,BIMM 101,A01,895017,McDonnell; Lisa Marie,0,5,24,24
1746535154951,BIMM 101,A02,895018,McDonnell; Lisa Marie,0,5,24,24
1746535154951,BIMM 101,B01,895020,McDonnell; Lisa Marie,0,6,24,24
1746535154951,BIMM 101,B02,895021,McDonnell; Lisa Marie,0,4,24,24
1746535155977,BIMM 110,A01,895023,Staff,1,0,25,24
1746535155977,BIMM 110,A02,895024,Staff,9,0,25,16
1746535155977,BIMM 110,A03,895025,Staff,18,0,25,7
1746535155977,BIMM 110,A04,895031,Staff,20,0,25,5
1746535157011,BIMM 120,A01,895114,Gustafson-Brown; Cindy,13,0,28,15
1746535157011,BIMM 120,A02,895126,Gustafson-Brown; Cindy,21,0,27,6
1746535158038,BIPN 100,A01,895130,Yang; Mingyu,1,0,38,37
1746535158038,BIPN 100,A02,895131,Yang; Mingyu,32,0,38,6
1746535158038,BIPN 100,A03,895132,Yang; Mingyu,32,0,38,6
1746535158038,BIPN 100,A04,895133,Yang; Mingyu,27,0,36,9
1746535159066,BIPN 120,A01,895135,Cooke; James Edward,0,3,13,13
1746535159066,BIPN 120,A02,895136,Cooke; James Edward,0,1,13,13
1746535159066,BIPN 120,A03,895137,Cooke; James Edward,0,3,13,13
1746535159066,BIPN 120,A04,895156,Cooke; James Edward,0,2,11,11
1746535160100,BIPN 134,A01,895235,Cooke; James Edward,0,2,25,25
1746535160100,BIPN 134,A02,895237,Cooke; James Edward,0,0,25,25
1746535160100,BIPN 134,A03,895240,Cooke; James Edward,3,0,25,22
1746535160100,BIPN 134,A04,895270,Cooke; James Edward,20,0,25,5
1746535161126,BIPN 189,A00,892103,Staff,0,13,14,14
1746535163179,BISP 194,A00,958008,Staff,0,2,0,0
1746535164205,CAT 124,A01,922009,Staff,0,5,20,20
1746535165244,CAT 125R,A00,886390,Morales; Celeste Georgianna,0,2,20,20
1746535165244,CAT 125R,B00,886391,Irwin; Matthew Joseph,0,3,20,20
1746535165244,CAT 125R,C00,886392,Smith; Lauryn Alissa,0,2,20,20
1746535165244,CAT 125R,D00,886393,Vanderschuit; Maya Alysia,0,2,20,20
1746535165244,CAT 125R,E00,886394,Marchisotto; Jennifer Anne,0,4,20,20
1746535166270,CENG 15,A01,886218,Drews; Aaron,3,0,8,5
1746535167298,CENG 113,A00,886219,Opatkiewicz; Justin Paul,15,0,25,10
1746535168326,CGS 101,A00,887044,Staff,7,0,20,13
1746535169354,CGS 105,A01,887046,Staff,14,0,25,11
1746535170381,CGS 112,A00,887047,Cuong; Marisol,12,0,15,3
1746535171406,CGS 113,A00,887048,Staff,23,0,30,7
1746535172434,CGS 120,A00,887049,Staff,10,0,17,7
1746535173461,CHEM 6A,A01,886336,Lam; Tin Yiu,38,0,50,12
1746535173461,CHEM 6A,A02,886338,Lam; Tin Yiu,37,0,50,13
1746535174489,CHEM 6B,A01,886341,Hopkins; Patrycja Anna,16,0,50,34
1746535174489,CHEM 6B,A02,886343,Hopkins; Patrycja Anna,42,0,50,8
1746535175515,CHEM 6C,A01,886346,Albizati; Kim F.,0,2,50,50
1746535175515,CHEM 6C,A02,886348,Albizati; Kim F.,23,0,50,27
1746535176543,CHEM 40A,A01,886352,Klosterman; Jeremy K,65,0,100,35
1746535177568,CHEM 40B,A01,886356,Klosterman; Jeremy K,0,23,100,100
1746535178595,CHEM 41B,A01,886360,Theodorakis; Emmanuel,25,0,50,25
1746535178595,CHEM 41B,A02,886362,Theodorakis; Emmanuel,47,0,50,3
1746535179622,CHIN 165A,A00,886382,Xu; Li,18,0,20,2
1746535180651,CLAS 120,A00,886387,Myerston Santana; Jacobo,33,0,40,7
1746535181677,COGS 9,A01,886967,Shannon; Kyle Michael,42,0,60,18
1746535182702,COGS 11,A01,886969,Staff,11,0,30,19
1746535183733,COGS 14A,A01,886971,Staff,6,0,60,54
1746535184760,COGS 14B,A01,886973,Hoffman; Drew Ellen,4,0,60,56
1746535185785,COGS 18,A01,886975,Morgan; Eric,35,0,60,25
1746535186816,COGS 20,A01,886977,Staff,4,0,8,4
1746535186816,COGS 20,A02,886978,Staff,5,0,7,2
1746535187847,COGS 100,A01,907783,Staff,0,2,30,30
1746535188874,COGS 101B,A01,886980,Staff,0,3,48,48
1746535189900,COGS 101C,A01,886982,Delgado; Tania,0,5,44,44
1746535190932,COGS 102A,A01,886984,Johnson; Christine M.,4,0,30,26
1746535191961,COGS 118B,A01,886986,Staff,0,3,88,88
1746535192989,COGS 150,A01,886988,Bergen; Benjamin,23,0,50,27
1746535194024,COGS 153,A00,886989,Delgado; Tania,0,2,41,41
1746535195056,COGS 186,A01,886991,Staff,0,0,32,32
1746535196086,COGS 187A,A01,886993,Boyle; Mary E. T.,7,0,30,23
1746535197113,COGS 189,A00,886994,Staff,0,1,30,30
1746535198145,COMM 10,A01,886996,Staff,0,0,20,21
1746535198145,COMM 10,A02,886997,Staff,12,0,20,8
1746535198145,COMM 10,A03,959845,Staff,19,0,20,1
1746535199172,COMM 20,A01,886999,Leuning; Grant Maurstad,24,0,40,16
1746535201229,COMM 100A,A01,887002,Staff,0,0,20,25
1746535201229,COMM 100A,A02,887003,Staff,7,0,20,13
1746535202254,COMM 100B,A01,887005,Staff,0,8,20,24
1746535203284,COMM 106D,A00,887006,Staff,14,0,40,26
1746535204313,COMM 110G,A00,887007,Whitworth-Smith; Andrew C,12,0,40,28
1746535205338,COMM 111B,A00,887008,Staff,31,0,40,9
1746535206373,COMM 113T,A00,887009,Abuelhiga; Soraya Jill,28,0,40,12
1746535206373,COMM 113T,B00,906733,Staff,40,0,40,0
1746535207403,COMM 145,A00,887010,Staff,12,0,40,28
1746535208427,COMM 146,A00,887054,Staff,31,0,40,9
1746535209452,COMM 190,A00,887012,Staff,8,0,23,15
1746535210481,CSE 8A,A50,887015,Cao; Yingjun,57,0,85,28
1746535211507,CSE 11,A01,887017,Cao; Yingjun,12,0,70,58
1746535212535,CSE 20,A01,887019,Staff,30,0,50,20
1746535213567,CSE 21,A01,887021,Staff,78,0,100,22
1746535213567,CSE 21,B01,892583,Braun; Oliver,45,0,50,5
1746535214598,CSE 30,A01,887025,Eldon; John,143,0,200,57
1746535215626,CSE 100,A01,887027,Staff,26,0,50,24
1746535215626,CSE 100,A02,887028,Staff,40,0,50,10
1746535216659,CSE 101,A01,887030,Braun; Oliver,75,0,100,25
1746535216659,CSE 101,B01,887032,Jones; Miles E,0,3,50,50
1746535216659,CSE 101,B02,887033,Jones; Miles E,0,1,50,50
1746535217691,CSE 105,A01,908084,Jones; Miles E,32,0,50,18
1746535217691,CSE 105,A02,908087,Jones; Miles E,33,0,50,17
1746535218718,CSE 135,A01,887035,Powell; Thomas Allan,0,4,50,50
1746535219752,CSE 142,A01,887037,Staff,8,0,60,52
1746535220782,CSE 142L,A01,887039,Staff,34,0,60,26
1746535221809,CSE 151A,A01,887041,Solares; Edwin A,48,0,100,52
1746535222837,CSE 175,A01,887043,Kumar; Rakesh,30,0,30,0
1746535223869,CSS 1,A01,886389,Staff,0,1,40,40
1746535224897,DSC 30,A01,908097,Liao; Soohyun Nam,47,0,75,28
1746535225930,DSC 40A,A01,908099,Shannon; Kyle Michael,30,0,50,20
1746535226959,DSC 40B,A01,908112,Staff,16,0,50,34
1746535227986,DSC 80,A01,908116,Staff,19,0,60,41
1746535229021,DSC 197,001,956863,Eldridge; Justin Matthew,9999,0,9999,0
1746535230051,ECE 5,A01,886400,Morris; Karcher William,2,0,6,4
1746535230051,ECE 5,A02,886401,Morris; Karcher William,3,0,6,3
1746535231080,ECE 148,A01,886403,Silberman; Jack,0,14,14,14
1746535232116,ECON 1,A01,887265,Crane; Meredith Helen,12,0,70,58
1746535232116,ECON 1,B01,887268,Staff,43,0,50,7
1746535233146,ECON 2,A01,887273,Crane; Meredith Helen,56,0,70,14
1746535234173,ECON 3,A01,887279,Rondina; Giacomo,32,0,70,38
1746535235205,ECON 4,A01,887282,Anderson; John Charles,0,2,10,10
1746535236234,ECON 5,A01,887285,Staff,33,0,45,12
1746535236234,ECON 5,B01,887292,Staff,41,0,45,4
1746535237263,ECON 100A,A01,887337,Newhouse; Herbert S,54,0,70,16
1746535237263,ECON 100A,B01,887349,Staff,45,0,50,5
1746535238295,ECON 100B,A01,887361,Du; Songzi,29,0,70,41
1746535239325,ECON 100C,A01,887445,Newhouse; Herbert S,59,0,70,11
1746535240353,ECON 105,A00,887488,Vespa; Emanuel Ignacio,23,0,35,12
1746535241382,ECON 109,A01,887506,Shishkin; Denis,28,0,35,7
1746535242424,ECON 110A,A01,887568,Alon; Titan Michael,0,3,35,35
1746535242424,ECON 110A,B01,907601,Alon; Titan Michael,20,0,35,15
1746535244056,ECON 110B,A01,887598,Levkoff; Steven B.,0,23,70,70
1746535245085,ECON 112,A00,887599,Rondina; Giacomo,19,0,35,16
1746535246113,ECON 120A,A01,887603,Dai; Yinlin,36,0,70,34
1746535247146,ECON 120C,A01,887608,Sun; Yixiao,0,1,35,35
1746535247146,ECON 120C,B01,887614,Sun; Yixiao,0,0,35,35
1746535248173,ECON 138,A00,887621,Bharadwaj; Prashant,0,20,20,20
1746535249201,ECON 144,A00,958007,Squires; Dale E,13,0,35,22
1746535250232,ECON 171,A01,907666,Staff,18,0,35,17
1746535251258,ECON 175,A00,887626,Wu; Pak Yeung,23,0,35,12
1746535252287,ECON 190,A00,887640,Vespa; Emanuel Ignacio,23,0,35,12
1746535253325,EDS 25,A01,888197,Staff,0,0,0,0
1746535253325,EDS 25,A02,888209,Staff,0,0,0,0
1746535253325,EDS 25,A03,888210,Staff,0,0,0,0
1746535253325,EDS 25,A04,888212,Staff,0,0,0,0
1746535253325,EDS 25,A05,888213,Staff,0,0,0,0
1746535253325,EDS 25,A06,888214,Staff,0,0,0,0
1746535253325,EDS 25,A07,888235,Staff,0,2,0,0
1746535253325,EDS 25,A08,888236,Staff,0,0,0,0
1746535253325,EDS 25,A09,888240,Staff,0,0,0,0
1746535253325,EDS 25,A10,888244,Staff,0,0,0,0
1746535253325,EDS 25,B01,888273,Staff,0,0,0,0
1746535253325,EDS 25,B02,888285,Staff,0,0,0,0
1746535253325,EDS 25,B03,888423,Staff,0,0,0,1
1746535253325,EDS 25,B04,888432,Staff,0,0,0,0
1746535253325,EDS 25,B05,888433,Staff,0,0,0,0
1746535253325,EDS 25,B06,888467,Staff,0,0,0,0
1746535253325,EDS 25,B07,888468,Staff,0,0,0,0
1746535253325,EDS 25,B08,888479,Staff,0,0,0,0
1746535253325,EDS 25,B09,888484,Staff,0,0,0,0
1746535253325,EDS 25,B10,888487,Staff,0,0,0,0
1746535254352,EDS 38,A01,907700,Choi; Bailey Miyeon,30,0,30,0
1746535255378,EDS 112,A01,888601,Chapman; Thandeka K,14,0,40,26
1746535256409,EDS 115,A00,888697,Mendez; Kathrina Mendoza,10,0,30,20
1746535257440,EDS 116,A01,888893,Staff,35,0,40,5
1746535259496,EDS 124AR,A00,889133,Staff,29,0,50,21
1746535259496,EDS 124AR,B00,907471,Simon; Elizabeth A,37,0,50,13
1746535260525,EDS 124BR,A00,889134,Simon; Elizabeth A,45,0,100,55
1746535261557,EDS 125,A00,889135,Staff,25,0,30,5
1746535262588,EDS 126,A01,889138,Staff,36,0,40,4
1746535263614,EDS 164R,A01,889142,Wishard Guerra; Alison G.,33,0,50,17
1746535264642,ENG 30,A01,886396,Staff,0,0,0,0
1746535264642,ENG 30,B01,886398,Staff,0,0,0,0
1746535265674,ENVR 102,A00,906150,Montejo; Carolina,23,0,25,2
1746535266701,ETHN 103A,A00,887236,Man; Simeon S,0,3,0,0
1746535267731,ETHN 113,A00,887239,Staff,16,0,30,14
1746535268759,ETHN 116,A00,887240,Staff,16,0,25,9
1746535269786,ETHN 117,A00,887241,Choi; Esther Min,28,0,30,2
1746535270812,ETHN 118,A00,887243,Staff,24,0,30,6
1746535271844,ETHN 127,A00,887248,Cuong; Marisol,11,0,15,4
1746535272873,ETHN 139,A00,887250,Staff,7,0,10,3
1746535273905,ETHN 142,A00,887252,Staff,10,0,30,20
1746535274931,ETHN 161,A00,887253,Browne; Errol Tsekani,24,0,30,6
1746535275962,ETHN 163FR,A00,887255,Burelle; Julie Sara Veronique,0,0,5,5
1746535276996,GLBH 20,A00,889149,Elwardani; Nile Regina,8,0,42,34
1746535279048,GLBH 111,A01,889152,Burgos; Jose L.,17,0,17,0
1746535280077,GLBH 150,A00,889181,Sloane; Julia Kathryn,0,5,15,15
1746535282136,HDS 60,A01,886406,Warstadt; Melissa Fawn,73,0,80,7
1746535283166,HIAF 111,A00,889324,Gyamfi; Bright,25,0,32,7
1746535284192,HIEA 131,A00,889328,Staff,16,0,32,16
1746535285220,HIEA 144,A00,889333,Henry; Todd A.,26,0,32,6
1746535286250,HIEA 154,A00,889336,Henry; Todd A.,24,0,32,8
1746535287280,HIEU 106,A00,889339,Staff,22,0,32,10
1746535289339,HIEU 114,A00,889340,Staff,3,0,32,29
1746535290366,HIEU 135GS,A00,889342,Patterson; Patrick H.,0,0,1,24
1746535291394,HIEU 137,A00,889343,Edington; Claire Ellen,9,0,25,16
1746535292422,HIEU 148,A00,889345,Staff,14,0,32,18
1746535293451,HIEU 154,A00,889346,Biess; Frank Peter,21,0,32,11
1746535294477,HILA 102,A00,889351,Staff,12,0,32,20
1746535295505,HILD 2A,A01,889221,Lewandoski; Julia Mavis,1,10,32,31
1746535296532,HILD 7B,A01,889225,Man; Simeon S,0,13,32,32
1746535297560,HILD 7C,A01,889288,Alvarez; Luis A,0,14,32,32
1746535298588,HILD 30,A01,889323,Staff,0,5,32,32
1746535300647,HISC 119,A00,889383,Golan; Tal,21,0,32,11
1746535301673,HIUS 103,A00,889384,Man; Simeon S,0,0,32,32
1746535302701,HIUS 117,A00,919797,Kwak; Nancy,18,0,32,14
1746535303731,HIUS 142A,A00,919788,Staff,22,0,32,10
1746535305785,HIUS 149,A00,889386,Gyamfi; Bright,27,0,32,5
1746535306813,HIUS 155,A00,889387,Alvarez; Luis A,14,0,32,18
1746535307837,HUM 3,A01,886499,Caldwell; Michael Alan,19,0,50,31
1746535308863,HUM 3GS,A00,886500,Rodriguez; Bretton Sigfred,0,0,0,28
1746535309889,HUM 3R,A01,886502,Markman; Kristina,0,36,50,50
1746535310925,HUM 4,A01,886504,Crum; Matthew Stephen,24,0,50,26
1746535310925,HUM 4,B01,886506,West; Geoffrey Scott,17,0,50,33
1746535311951,HUM 4GS,A00,886507,Staff,0,0,0,19
1746535312978,HUM 5,A01,886509,Staff,32,0,50,18
1746535314007,HUM 5R,A01,886511,Zavodny; Tatiana Sophia,0,39,50,50
1746535315036,JAPN 180,A00,886407,Staff,18,0,40,22
1746535316063,LATI 50,A01,886409,Martin-Cabrera; Luis,4,0,22,18
1746535316063,LATI 50,A02,886410,Martin-Cabrera; Luis,19,0,22,3
1746535316063,LATI 50,A03,886411,Martin-Cabrera; Luis,21,0,22,1
1746535316063,LATI 50,A04,886412,Martin-Cabrera; Luis,9,0,22,13
1746535317093,LAWS 101,A00,907664,Staff,28,0,60,32
1746535318120,LIAB 1A,A00,889388,Saab; Dima,17,0,20,3
1746535319148,LIAB 1AX,A00,889389,El Cheddadi; Youniss,17,0,20,3
1746535320179,LIFR 1C,A00,889391,Van Moer; Vinciane G,8,0,20,12
1746535321211,LIFR 1CX,A00,889392,Van Moer; Vinciane G,7,0,20,13
1746535322239,LIFR 1D,A00,889393,Van Moer; Vinciane G,7,0,20,13
1746535323267,LIFR 1DX,A00,889394,Van Moer; Vinciane G,8,0,20,12
1746535324293,LIGN 7,A00,886923,Staff,24,0,50,26
1746535325322,LIGN 17,A00,886924,Kehler; Andrew Scott,125,0,150,25
1746535326352,LTAM 110,A00,889395,Staff,15,0,30,15
1746535327380,LTAM 110GS,A00,958010,Rodriguez; Bretton Sigfred,0,0,0,28
1746535328407,LTCH 101,A00,889397,Staff,23,0,25,2
1746535329434,LTCS 130,A00,889398,Staff,23,0,25,2
1746535330461,LTEA 138,A00,889399,Staff,24,0,40,16
1746535331493,LTEN 149,A00,889400,Wesling; Megan E.,0,3,25,25
1746535332525,LTEN 169,A00,889401,Staff,20,0,25,5
1746535333555,LTEN 180,A00,889402,Staff,10,0,15,5
1746535334581,LTEN 181,A00,889403,Staff,21,0,25,4
1746535335614,LTWL 100,A00,889404,Myerston Santana; Jacobo,3,0,25,22
1746535336641,LTWL 180GS,A00,889405,Staff,0,0,20,20
1746535337710,LTWL 181,A00,889406,Staff,17,0,25,8
1746535338741,LTWL 184,A00,889475,Mukherjee; Silpa,22,0,25,3
1746535339766,LTWR 102C,A00,889486,Staff,29,0,30,1
1746535340795,LTWR 115W,A00,889491,Staff,0,2,15,15
1746535341821,MAE 8,A01,886905,Staff,0,2,0,0
1746535342855,MAE 11,A00,886906,Bandaru; Prabhakar,0,7,50,50
1746535343882,MAE 20,A00,886907,Evdokimenko; Ekaterina,44,0,70,26
1746535344909,MAE 30B,A00,886909,Ghazinejad; Maziar,26,0,45,19
1746535345936,MAE 101B,A00,886910,Saintillan; David,29,0,45,16
1746535346969,MAE 105,A00,886911,Bandaru; Prabhakar,18,0,50,32
1746535348002,MAE 107,B00,958024,Staff,9,0,50,41
1746535349033,MAE 143B,A00,886913,Bewley; Thomas R,7,0,40,33
1746535350059,MAE 148,A01,886915,Silberman; Jack,0,3,14,14
1746535351086,MAE 160,A00,886916,Evdokimenko; Ekaterina,31,0,60,29
1746535352118,MATH 3C,A01,889681,Staff,0,3,30,30
1746535352118,MATH 3C,A02,960048,Staff,25,0,30,5
1746535353152,MATH 10A,A01,889760,Staff,26,0,30,4
1746535353152,MATH 10A,A02,889783,Staff,29,0,30,1
1746535354187,MATH 10B,A01,889785,Verstraete; Jacques Allan,2,0,35,33
1746535354187,MATH 10B,A02,889795,Verstraete; Jacques Allan,4,0,35,31
1746535354187,MATH 10B,B01,889797,Verstraete; Jacques Allan,3,0,35,32
1746535354187,MATH 10B,B02,889828,Verstraete; Jacques Allan,3,0,35,32
1746535355216,MATH 10C,A01,889849,Habib; Yousaf,9,0,30,21
1746535355216,MATH 10C,A02,889852,Habib; Yousaf,14,0,30,16
1746535355216,MATH 10C,A03,889853,Habib; Yousaf,22,0,30,8
1746535355216,MATH 10C,A04,889858,Habib; Yousaf,20,0,30,10
1746535355216,MATH 10C,B01,889861,Staff,1,0,30,29
1746535355216,MATH 10C,B02,889862,Staff,24,0,30,6
1746535355216,MATH 10C,B03,889863,Staff,27,0,30,3
1746535355216,MATH 10C,B04,889967,Staff,23,0,30,7
1746535356247,MATH 18,A01,889974,Staff,7,0,30,23
1746535356247,MATH 18,A02,889977,Staff,20,0,30,10
1746535356247,MATH 18,B01,889984,Hardiman; Liam,22,0,30,8
1746535356247,MATH 18,B02,889985,Hardiman; Liam,25,0,30,5
1746535357279,MATH 20A,A01,889990,Suk; Andrew Hoon,29,0,35,6
1746535358308,MATH 20B,A01,889993,Ohm; Ko Woon,22,0,30,8
1746535358308,MATH 20B,A02,889994,Ohm; Ko Woon,30,0,30,0
1746535358308,MATH 20B,B01,889996,Ohm; Ko Woon,21,0,30,9
1746535358308,MATH 20B,B02,889997,Ohm; Ko Woon,23,0,30,7
1746535359337,MATH 20C,A01,889999,Hammock; Frances H,17,0,30,13
1746535359337,MATH 20C,A02,890003,Hammock; Frances H,23,0,30,7
1746535359337,MATH 20C,B01,890006,Hammock; Frances H,3,0,30,27
1746535359337,MATH 20C,B02,890007,Hammock; Frances H,11,0,30,19
1746535360363,MATH 20D,A01,890011,Cheng; Hsiao-Bing,1,1,30,29
1746535360363,MATH 20D,A02,890012,Cheng; Hsiao-Bing,14,0,30,16
1746535360363,MATH 20D,B01,890016,Cheng; Hsiao-Bing,13,0,30,17
1746535360363,MATH 20D,B02,890017,Cheng; Hsiao-Bing,13,0,30,17
1746535361397,MATH 20E,A01,890026,Harel; Guershon,1,0,30,29
1746535361397,MATH 20E,A02,890029,Harel; Guershon,23,0,30,7
1746535361397,MATH 20E,B01,890033,Harel; Guershon,7,0,30,23
1746535361397,MATH 20E,B02,890101,Harel; Guershon,21,0,30,9
1746535362425,MATH 102,A01,890104,Staff,17,0,30,13
1746535362425,MATH 102,A02,890105,Staff,27,0,30,3
1746535363457,MATH 103B,A01,890116,Salehi Golsefidy; Alireza,3,0,30,27
1746535363457,MATH 103B,B01,890118,Staff,0,3,34,34
1746535364484,MATH 109,A01,890121,Aliabadi Sr.; Mohsen,1,0,30,29
1746535364484,MATH 109,B01,890124,Upadrashta; Pranav Kumar,18,0,30,12
1746535365513,MATH 120A,A01,890126,Eggers; John Dietrich,13,0,30,17
1746535366540,MATH 142B,A01,890128,Ioana; Adrian,19,0,30,11
1746535366540,MATH 142B,A02,890129,Ioana; Adrian,13,0,30,17
1746535367573,MATH 154,A01,890174,Staff,0,0,30,30
1746535367573,MATH 154,A02,890182,Staff,0,0,30,30
1746535368601,MATH 168A,A01,890197,Dumitriu; Ioana,21,0,35,14
1746535369629,MATH 170A,A01,890240,Nie; Jiawang,1,0,30,29
1746535369629,MATH 170A,A02,890241,Nie; Jiawang,11,0,30,19
1746535369629,MATH 170A,A03,890249,Nie; Jiawang,23,0,30,7
1746535370658,MATH 170B,A01,957891,Nag; Panchali,13,0,35,22
1746535372717,MATH 181A,A01,908025,Staff,0,4,35,35
1746535372717,MATH 181A,A02,960115,Staff,27,0,35,8
1746535373744,MATH 181B,A01,959874,Staff,26,0,30,4
1746535374772,MATH 193B,A01,890265,Staff,0,4,35,35
1746535375800,MGT 4,A01,890311,Anderson; John Charles,42,0,88,46
1746535376826,MGT 5,A00,907740,Staff,13,0,98,85
1746535377855,MGT 12,A00,890312,Lindenberger; Wade Douglas,67,0,98,31
1746535378880,MGT 16,A00,957883,Staff,78,0,98,20
1746535380937,MGT 45,A00,890314,Pecore; Joseph P.,47,0,98,51
1746535381965,MGT 71,A00,890315,Staff,0,11,98,98
1746535382996,MGT 100,A00,890316,Yavorsky; Daniel Ryan,44,0,98,54
1746535384028,MGT 103,A00,890317,Ehrich; Kristine R,73,0,98,25
1746535385056,MGT 105,A00,890356,Bates; Kenneth Walter,0,7,98,98
1746535386083,MGT 112,A00,890360,Ehrich; Kristine R,55,0,98,43
1746535387111,MGT 127R,A00,907732,Zhu; Kevin Xiaoguo,23,0,98,75
1746535388136,MGT 131B,A00,890361,Anderson; John Charles,61,0,98,37
1746535389168,MGT 137,A00,890362,Lindenberger; Wade Douglas,65,0,98,33
1746535390196,MGT 160,A00,890369,Johnson; Erik Barry,9,0,98,89
1746535392246,MGT 164,A00,890372,Zimmermann; Carsten,0,39,98,98
1746535393271,MGT 180,A00,890374,Bliss; Barbara Ann,12,0,98,86
1746535394299,MMW 15,A01,886414,Chang; Edmond Yi-Teh,0,12,28,28
1746535394299,MMW 15,A02,886415,Chang; Edmond Yi-Teh,0,8,28,28
1746535394299,MMW 15,A03,886416,Chang; Edmond Yi-Teh,0,8,28,28
1746535394299,MMW 15,A04,886417,Chang; Edmond Yi-Teh,0,8,28,28
1746535394299,MMW 15,B01,886419,Chang; Edmond Yi-Teh,0,7,28,28
1746535394299,MMW 15,B02,886420,Chang; Edmond Yi-Teh,0,8,28,28
1746535394299,MMW 15,B03,886421,Chang; Edmond Yi-Teh,0,7,28,28
1746535394299,MMW 15,B04,886422,Chang; Edmond Yi-Teh,0,8,28,28
1746535394299,MMW 15,C01,886424,Staff,0,9,28,28
1746535394299,MMW 15,C02,886425,Staff,0,8,28,28
1746535394299,MMW 15,C03,886426,Staff,0,8,28,28
1746535394299,MMW 15,C04,886427,Staff,0,7,28,28
1746535394299,MMW 15,C05,958038,Staff,0,7,28,28
1746535394299,MMW 15,C06,958039,Staff,0,8,28,28
1746535395331,MMW 15GS,A00,906910,Patterson; Patrick H.,4,0,28,24
1746535396360,MMW 122R,A01,886429,Rahimi; Babak,0,13,28,28
1746535396360,MMW 122R,A02,886430,Rahimi; Babak,0,12,28,28
1746535396360,MMW 122R,A03,958040,Rahimi; Babak,0,11,28,28
1746535397387,MUS 1A,A01,890937,Staff,3,0,25,22
1746535397387,MUS 1A,A02,891035,Staff,6,0,25,19
1746535397387,MUS 1A,C01,958912,Staff,24,0,25,1
1746535397387,MUS 1A,C02,958913,Staff,25,0,25,0
1746535399441,MUS 2AK,A00,957092,Ohnishi; Takae,15,0,15,0
1746535400474,MUS 4,A01,891044,Staff,2,0,25,23
1746535400474,MUS 4,A02,891045,Staff,23,0,25,2
1746535400474,MUS 4,B01,891048,Staff,17,0,25,8
1746535400474,MUS 4,B02,891050,Staff,25,0,25,0
1746535401507,MUS 5,A01,957506,Dubnov; Shlomo,0,0,25,25
1746535401507,MUS 5,A02,957622,Dubnov; Shlomo,14,0,25,11
1746535401507,MUS 5,A03,957623,Dubnov; Shlomo,20,0,25,5
1746535402533,MUS 6,A01,891053,Freitas Caetano; Marcelo,24,0,25,1
1746535402533,MUS 6,A02,891054,Freitas Caetano; Marcelo,23,0,25,2
1746535403566,MUS 7,A01,891081,Staff,0,0,25,25
1746535403566,MUS 7,A02,891082,Staff,4,0,25,21
1746535404598,MUS 8GS,A00,891118,Borgo; David Garcia,0,0,25,25
1746535405625,MUS 11,A01,891140,Staff,11,0,25,14
1746535405625,MUS 11,A02,891141,Staff,22,0,25,3
1746535406653,MUS 13,A01,891143,Staff,8,0,25,17
1746535406653,MUS 13,A02,891144,Staff,24,0,25,1
1746535407683,MUS 15,A01,891146,Staff,9,0,25,16
1746535407683,MUS 15,A02,891148,Staff,21,0,25,4
1746535407683,MUS 15,B01,891150,Staff,18,0,25,7
1746535407683,MUS 15,B02,891151,Staff,25,0,25,0
1746535408709,MUS 20,A01,891153,Staff,5,0,20,15
1746535408709,MUS 20,A02,891155,Staff,14,0,20,6
1746535409735,MUS 80,A00,891156,Staff,19,0,25,6
1746535409735,MUS 80,B00,891157,Staff,23,0,25,2
1746535410766,MUS 130,A00,891158,Ohnishi; Takae,35,0,35,0
1746535411793,MUS 150GS,A01,891160,Borgo; David Garcia,0,0,25,25
1746535412820,MUS 170,A01,891162,Freitas Caetano; Marcelo,20,0,25,5
1746535412820,MUS 170,A02,891164,Freitas Caetano; Marcelo,21,0,25,4
1746535413847,NANO 11,A00,886220,Vazquez Mena; Oscar,13,0,15,2
1746535414878,NANO 15,A01,886222,Drews; Aaron,4,0,7,3
1746535415906,NANO 104,A00,886224,Sirbuly; Donald,18,0,25,7
1746535416934,PH 40,A00,886528,Staff,23,0,40,17
1746535417962,PH 45,A01,886799,Staff,35,0,40,5
1746535418988,PH 110,A00,886802,Staff,0,7,40,40
1746535420018,PH 172,A00,906716,Staff,19,0,35,16
1746535421049,PH 191,A00,886803,Staff,6,0,40,34
1746535422078,PHIL 1,A00,889500,Staff,19,0,30,11
1746535423113,PHIL 10,A01,889549,Grush; Rick Scott,15,0,22,7
1746535423113,PHIL 10,A02,889551,Grush; Rick Scott,22,0,22,0
1746535424150,PHIL 28,A01,889559,Lamey; Andy M.,0,1,31,31
1746535424150,PHIL 28,A02,889561,Lamey; Andy M.,0,1,30,30
1746535424150,PHIL 28,A03,889572,Lamey; Andy M.,0,0,30,30
1746535425177,PHIL 35,A00,907839,Staff,13,0,15,2
1746535426201,PHIL 60,A00,889574,Staff,74,0,90,16
1746535427228,PHIL 101,A00,958004,Staff,13,0,15,2
1746535429285,PHIL 136,A00,889582,Fulkerson; Matthew Todd,26,0,45,19
1746535430322,PHIL 163,A01,889601,Staff,21,0,30,9
1746535430322,PHIL 163,B01,889606,Brandt; Reuven A,0,3,0,0
1746535431352,PHIL 164,A00,889610,Staff,16,0,30,14
1746535432377,PHIL 165,A00,889613,Staff,23,0,30,7
1746535433409,PHYS 1A,A00,886431,Staff,26,0,70,44
1746535434439,PHYS 1AL,001,886432,Tsai; Philbert S,0,2,30,30
1746535434439,PHYS 1AL,002,886436,Tsai; Philbert S,11,0,30,19
1746535435466,PHYS 1B,A00,886439,Staff,185,0,240,55
1746535436492,PHYS 1BL,001,886441,Tsai; Philbert S,0,4,30,30
1746535436492,PHYS 1BL,002,886444,Tsai; Philbert S,2,0,30,28
1746535437520,PHYS 1C,A00,896092,Arnold; Kam S,78,0,146,68
1746535438550,PHYS 1CL,001,886448,Tsai; Philbert S,0,0,30,30
1746535438550,PHYS 1CL,002,886449,Tsai; Philbert S,0,0,30,30
1746535438550,PHYS 1CL,003,886450,Tsai; Philbert S,15,0,30,15
1746535438550,PHYS 1CL,004,886451,Tsai; Philbert S,15,0,30,15
1746535439581,PHYS 2B,A01,886457,Staff,69,0,115,46
1746535440616,PHYS 2C,A01,886460,Shotwell; Brian,0,8,65,65
1746535441644,PHYS 2CL,A01,886467,Staff,0,4,28,28
1746535441644,PHYS 2CL,A02,886468,Staff,0,3,28,28
1746535442671,PHYS 2D,A01,886470,Staff,10,0,50,40
1746535443698,PHYS 4B,A01,886475,Grinstein; Benjamin,22,0,40,18
1746535444729,POLI 5,A00,891173,Desposato; Scott,7,0,25,18
1746535445755,POLI 5D,A01,891175,Staff,5,0,5,0
1746535445755,POLI 5D,B01,891178,Staff,5,0,5,0
1746535446782,POLI 11,A00,891179,Ferree; Karen E,2,0,35,33
1746535447813,POLI 12,A00,891180,Staff,16,0,30,14
1746535448841,POLI 27,A01,891182,Staff,12,0,75,63
1746535449871,POLI 30,A00,891183,Staff,9,0,50,41
1746535450898,POLI 100B,A00,891244,Staff,5,1,35,30
1746535451929,POLI 100I,A00,891247,Staff,7,0,30,23
1746535452964,POLI 104J,A00,891248,Nichter; Maysa,14,0,30,16
1746535453990,POLI 104U,A00,891250,Nichter; Maysa,2,0,30,28
1746535456053,POLI 110B,A00,891255,Wiens; David,20,0,25,5
1746535457082,POLI 112A,A00,891256,Wiens; David,6,0,25,19
1746535458108,POLI 114BR,A00,891261,Staff,19,0,30,11
1746535459136,POLI 117R,A00,891262,Forman; Fonna,0,6,50,50
1746535460164,POLI 118,A00,891264,Ingham; Sean,17,0,25,8
1746535461194,POLI 124A,A00,891265,Staff,18,0,20,2
1746535462221,POLI 125D,A00,891266,Nichter; Simeon C,2,0,25,23
1746535463250,POLI 126,A00,891268,Nichter; Simeon C,7,0,25,18
1746535464280,POLI 126AA,A00,891272,Staff,18,0,25,7
1746535465305,POLI 130AA,A00,891273,Staff,15,0,20,5
1746535466334,POLI 134AA,A00,891274,Staff,4,0,20,16
1746535468388,POLI 138,A00,891278,Staff,21,0,25,4
1746535469415,POLI 142K,A00,891280,Staff,11,0,25,14
1746535470447,POLI 142M,A00,891281,Gartzke; Erik,17,0,30,13
1746535471478,POLI 142P,A00,891284,Staff,20,0,30,10
1746535472510,POLI 143,A00,891285,Gartzke; Erik,12,0,30,18
1746535473538,POLI 153,A00,891286,Staff,19,0,20,1
1746535475599,POLI 175,A00,891290,Staff,15,0,20,5
1746535476628,PSYC 1,A00,890674,Steiner; Eric Tomas,0,11,45,45
1746535477661,PSYC 2,A00,890676,Albright; Thomas D,21,0,35,14
1746535478690,PSYC 3,A00,890679,Staff,17,0,20,3
1746535479716,PSYC 6,A00,959858,Staff,20,0,20,0
1746535480745,PSYC 60,A01,890684,Rickard; Timothy C.,0,5,45,45
1746535481770,PSYC 70,A01,890689,Geller; Emma Harlan,7,0,30,23
1746535482799,PSYC 71,A01,959860,Staff,21,0,25,4
1746535483826,PSYC 100,A00,890690,Lacefield; Katharine I,0,50,180,180
1746535484853,PSYC 102,A00,890695,Staff,18,0,40,22
1746535485882,PSYC 105,A00,890699,Geller; Emma Harlan,71,0,100,29
1746535486910,PSYC 106,A00,890701,Gorman; Michael R.,5,0,30,25
1746535487940,PSYC 108,A00,890704,Adrian; Julia Anna,0,28,50,50
1746535488971,PSYC 118,A01,890712,Staff,11,0,30,19
1746535490002,PSYC 124,A00,890716,Chapman; Eddie Nathaniel,25,0,60,35
1746535491031,PSYC 131,A00,890717,Anagnostaras; Stephan,0,7,80,80
1746535492059,PSYC 137,A00,890719,Winkielman; Piotr,0,11,30,30
1746535493085,PSYC 144,A00,890721,Adrian; Julia Anna,0,9,45,45
1746535494113,PSYC 162,A00,890805,Staff,2,0,75,73
1746535495147,PSYC 169,A00,890810,Staff,0,15,30,30
1746535496179,PSYC 172,A00,890814,Gorman; Michael R.,9,0,30,21
1746535497206,PSYC 181,A00,890818,Anagnostaras; Stephan,8,0,200,192
1746535498234,PSYC 184,A00,959861,Staff,170,0,175,5
1746535499259,PSYC 189,A00,890823,Staff,0,1,30,30
1746535500294,PSYC 191,A00,890884,Rickard; Timothy C.,0,11,35,35
1746535501321,PSYC 193,A00,890913,Staff,19,0,30,11
1746535501321,PSYC 193,B00,890914,Chapman; Eddie Nathaniel,24,0,30,6
1746535502356,PSYC 193L,A01,890918,Lowe; Angela Beth,20,0,30,10
1746535502356,PSYC 193L,B01,890921,Hurwitz; Ethan Scott,20,0,30,10
1746535502356,PSYC 193L,C01,890928,Staff,30,0,30,0
1746535503386,RELI 149,A00,886806,Rahimi; Babak,23,0,40,17
1746535504412,SE 9,A01,886814,Staff,7,0,20,13
1746535505438,SE 101B,A01,886816,Chadha; Mayank,4,0,35,31
1746535506465,SE 110B,A00,886818,Zhu; Qiang,4,0,75,71
1746535507491,SE 125,A01,886830,Staff,10,0,30,20
1746535508518,SE 130B,A01,886835,Staff,14,0,40,26
1746535509546,SE 131A,A01,886838,Krysl; Petr,34,0,55,21
1746535510577,SE 154,A00,886840,Staff,30,0,50,20
1746535511605,SE 164GS,A01,886849,Staff,6,0,20,14
1746535512633,SE 167GS,A01,886853,Staff,6,0,20,14
1746535513661,SIO 25,A01,890107,Staff,19,0,30,11
1746535514693,SIO 45,A00,890109,Cook; Geoffrey W,117,0,200,83
1746535515725,SIO 109R,A00,890110,Forman; Fonna,0,16,20,20
1746535516752,SIO 187,A01,890114,Kacev; David,15,0,40,25
1746535517778,SOCI 1,A01,890431,Thorpe; Charles Robert,15,0,30,15
1746535517778,SOCI 1,A02,890518,Thorpe; Charles Robert,30,0,30,0
1746535518806,SOCI 2,A01,957978,Staff,25,0,25,0
1746535518806,SOCI 2,A02,957979,Staff,23,0,25,2
1746535519833,SOCI 20,A01,890523,Calderon-Zaks; Michael Aar,23,0,30,7
1746535519833,SOCI 20,A02,890526,Calderon-Zaks; Michael Aar,29,0,30,1
1746535520864,SOCI 30,A01,890533,Pardo Guerra; Juan Pablo,37,0,40,3
1746535521892,SOCI 40,A01,890535,Staff,27,0,45,18
1746535522919,SOCI 104Q,A00,890559,Staff,18,0,30,12
1746535523944,SOCI 106,A00,890560,Arnal; Maud Marie Leonie,20,0,30,10
1746535524977,SOCI 110,A00,890567,Holkenbrink-Monk; Charlene,19,0,30,11
1746535526008,SOCI 112,A00,890568,Victoria Torres; Pablo,1,0,55,54
1746535527035,SOCI 115,A00,890597,Arnal; Maud Marie Leonie,28,0,45,17
1746535529091,SOCI 121,A00,890604,Pardo Guerra; Juan Pablo,38,0,45,7
1746535530119,SOCI 126,A01,890608,Staff,8,0,10,2
1746535531147,SOCI 127,A00,890609,Staff,18,0,30,12
1746535532175,SOCI 131,A00,890610,Thorpe; Charles Robert,37,0,45,8
1746535533202,SOCI 135,A00,890615,Payne; Christine Anna,14,0,45,31
1746535534232,SOCI 139,A00,890620,Staff,38,0,45,7
1746535535258,SOCI 148E,A00,890622,Calderon-Zaks; Michael Aar,36,0,45,9
1746535536285,SOCI 150,A00,890623,Kohler; Kristopher M.,31,0,45,14
1746535537314,SOCI 157,A00,890625,Jules-Rosette; Bennetta W.,18,0,20,2
1746535538348,SOCI 160,A00,890627,Payne; Christine Anna,21,0,45,24
1746535539378,SYN 1,A00,886855,Fish; Gwendolyn Anne,0,0,0,0
1746535539378,SYN 1,B00,906086,Fish; Gwendolyn Anne,0,1,0,2
1746535540406,SYN 2R,A00,886860,Staff,0,17,15,15
1746535540406,SYN 2R,B00,906106,Atkinson; Arthur Laird,0,16,15,15
1746535541437,SYN 100,A01,886866,Browne; Emily,0,28,20,20
1746535541437,SYN 100,B01,906128,Rock; Martin,0,5,20,20
1746535541437,SYN 100,C01,906140,Deavenport; James Cary,0,3,20,20
1746535541437,SYN 100,D01,907816,Deavenport; James Cary,0,5,20,20
1746535542465,TDAC 1,A00,890286,Walsh; Kim C.,9,0,20,11
1746535543492,TDAC 101,A00,890296,Basso; Beatrice,16,0,20,4
1746535544519,TDDE 131,A00,890297,Staff,47,0,50,3
1746535545545,TDDM 1,A00,890287,Weinberg; Sadie,25,0,30,5
1746535546574,TDGE 11,A00,890288,Fulton; Julia,137,0,200,63
1746535546574,TDGE 11,B00,890289,Castro; Robert Jess,184,0,200,16
1746535547601,TDGE 25,B00,957359,Walsh; Kim C.,3,0,20,17
1746535548631,TDGE 40,A01,890292,Power; Jade Yukana,27,0,30,3
1746535549656,TDGE 124,A00,890298,Havis; Allan,0,0,50,50
1746535550683,TDGE 131R,A00,890299,Burelle; Julie Sara Veronique,15,0,42,27
1746535551711,TDHT 101,A00,890300,Staff,10,0,20,10
1746535552740,TDHT 109,A01,890302,Anderson; Mysia Anyse,31,0,40,9
1746535553773,TDMV 1,A00,890293,Arcidiacono; Kristin,18,0,30,12
1746535554798,TDMV 2,A00,890294,Weinberg; Sadie,23,0,30,7
1746535555828,TDMV 3,A00,957878,Arcidiacono; Kristin,28,0,30,2
1746535557886,TDMV 138,A00,890304,Jun; Grace Shin Hae,25,0,40,15
1746535558912,TDMV 140,A00,890305,Corrales; Joseph Bernales,25,0,30,5
1746535559939,TDMV 142,A00,890307,Caligagan; Tony,32,0,40,8
1746535560971,TDMV 144,A00,890308,Camaya; Michelle Ann,25,0,30,5
1746535561998,TDPW 1,A00,890295,Stein; Deborah Isobel,3,0,20,17
1746535563030,USP 2,A01,890272,Lerner; Amy M,6,0,20,14
1746535564059,USP 3,A01,890274,Staff,12,0,30,18
1746535565085,USP 15,A01,890276,Sun; Feiyang,17,0,30,13
1746535566115,USP 25,A00,890277,Shenkman; Michael Thomas,19,0,25,6
1746535567142,USP 138,A00,890278,Staff,13,0,25,12
1746535568167,USP 143,A00,890279,Staff,21,0,70,49
1746535569199,USP 144,A00,890280,Chowdhury; Muhammed Zohir,16,0,30,14
1746535570225,USP 150,A00,890281,Boomhower; Matthew Charles,4,0,30,26
1746535571254,USP 151,A00,890282,Staff,16,0,20,4
1746535572281,USP 162,A00,890283,Andrews; Abigail Leslie,16,0,20,4
1746535573306,USP 168,A00,920477,Kwak; Nancy,1,0,5,4
1746535574331,USP 181,A00,890284,Staff,3,0,20,17
1746535575360,USP 191A,A00,890285,Staff,13,0,20,7
1746535576391,VIS 101,A00,886512,Staff,25,0,75,50
1746535577419,VIS 103,A00,886513,Cruz; Edwin Teddy,61,0,75,14
1746535578446,VIS 108,A00,886514,Staff,3,0,15,12
1746535579473,VIS 127P,A00,886515,Shen; Kuiyi,80,0,146,66
1746535580500,VIS 149,A00,886516,Yoldas; Pinar,0,0,15,15
1746535581531,VIS 164,A00,886526,Erdmann; Dean,19,0,22,3
1746535582561,VIS 194S,A00,886527,Staff,61,0,75,14
1746535583590,WCWP 10A,C00,886484,Martiniuk; Jill,12,0,15,3
1746535584619,WCWP 10B,A00,886490,Uriarte; Emma,0,0,15,15
1746535584619,WCWP 10B,B00,886491,Dhir; Simrita,11,0,15,4
1746535584619,WCWP 10B,C00,886492,Ornelas; Tricia,0,0,15,15
1746535585646,WCWP 100,A00,886494,Young; Mark T,0,7,15,15
1746535587769,AAS 10,A01,886199,Childs; Dennis R.,0,3,0,0
1746535588803,ANAR 104,A01,886940,Shtienberg; Gilad,27,0,30,3
1746535589832,ANAR 120,A00,886953,Staff,12,0,20,8
1746535590860,ANBI 148,A01,886955,Wilder; Linnea Lorene,30,0,40,10
1746535592919,ANSC 122,A00,886957,Staff,25,0,30,5
1746535593944,ANSC 150,A00,886958,Sloane; Julia Kathryn,3,0,15,12
1746535594977,ANSC 156,A00,886959,Jenkins; Janis A.,0,1,15,15
1746535596005,ANSC 180,A00,886960,Staff,11,0,17,6
1746535597033,ANSC 188,A00,886961,Jassal; Aftab,9,0,25,16
1746535598060,ANSC 190,A00,886962,Jassal; Aftab,14,0,25,11
1746535599092,ANSC 191,A00,886963,Staff,18,0,20,2
1746535600119,ANTH 3,A01,891689,Staff,17,0,20,3
1746535601146,ANTH 5,A00,886933,Semendeferi; Ekaterini,16,0,20,4
1746535602178,ANTH 10,A00,886934,Staff,0,12,30,30
1746535603202,ANTH 21,A01,886936,Staff,40,0,60,20
1746535604231,ANTH 23,A01,886938,Staff,92,0,100,8
1746535605258,ANTH 105,A00,886964,Stewart; Alexander B,84,0,100,16
1746535606290,ANTH 108,A00,886965,Pedersen; David,9,0,20,11
1746535607320,AWP 10,001,886147,Staff,0,0,0,0
1746535607320,AWP 10,002,886148,Staff,0,0,0,0
1746535607320,AWP 10,003,886149,Staff,0,0,0,0
1746535607320,AWP 10,004,886150,Staff,0,0,0,0
1746535607320,AWP 10,005,886151,Staff,0,0,0,0
1746535607320,AWP 10,006,886152,Staff,0,0,0,0
1746535607320,AWP 10,007,886153,Staff,0,0,0,0
1746535607320,AWP 10,008,886154,Staff,0,0,0,0
1746535607320,AWP 10,009,886155,Staff,0,0,0,0
1746535607320,AWP 10,010,886156,Staff,0,0,0,0
1746535607320,AWP 10,011,886158,Staff,0,0,0,0
1746535607320,AWP 10,012,886160,Staff,0,0,0,0
1746535607320,AWP 10,013,886161,Staff,0,0,0,0
1746535607320,AWP 10,014,886162,Staff,0,0,0,0
1746535607320,AWP 10,015,886163,Staff,0,0,0,0
1746535607320,AWP 10,016,886164,Staff,0,0,0,0
1746535607320,AWP 10,017,886165,Staff,0,0,0,0
1746535607320,AWP 10,018,886166,Staff,0,0,0,0
1746535607320,AWP 10,019,886168,Staff,0,0,0,0
1746535607320,AWP 10,020,886170,Staff,0,0,0,0
1746535607320,AWP 10,021,886172,Staff,0,0,0,0
1746535608348,AWP 10R,001,886173,Staff,0,1,0,0
1746535608348,AWP 10R,002,886174,Staff,0,1,0,0
1746535608348,AWP 10R,003,886175,Staff,0,0,0,0
1746535608348,AWP 10R,004,886176,Staff,0,0,0,0
1746535608348,AWP 10R,005,886177,Staff,0,0,0,0
1746535608348,AWP 10R,006,886178,Staff,0,0,0,0
1746535608348,AWP 10R,007,886179,Staff,0,0,0,0
1746535608348,AWP 10R,008,886181,Staff,0,0,0,0
1746535608348,AWP 10R,009,886182,Staff,0,0,0,0
1746535608348,AWP 10R,010,886183,Staff,0,0,0,0
1746535608348,AWP 10R,011,886184,Staff,0,0,0,0
1746535608348,AWP 10R,012,886185,Staff,0,0,0,0
1746535608348,AWP 10R,013,886186,Staff,0,0,0,0
1746535608348,AWP 10R,014,886187,Staff,0,0,0,0
1746535608348,AWP 10R,015,886188,Staff,0,0,0,0
1746535608348,AWP 10R,016,886189,Staff,0,0,0,0
1746535609378,AWP 102R,A00,886190,Staff,0,0,0,0
1746535609378,AWP 102R,B00,886191,Staff,0,0,0,0
1746535610403,BENG 100,A01,886193,Staff,17,0,30,13
1746535611430,BENG 122A,A01,886195,Hasty; Jeff M,13,0,30,17
1746535612461,BENG 166A,A00,886196,Sah; Robert Lie-Yuan,0,1,30,30
1746535613492,BENG 190,A00,958050,Khojah; Reem I,24,0,25,1
1746535614522,BIBC 102,A01,894320,Staff,0,0,46,46
1746535614522,BIBC 102,A02,894321,Staff,1,0,46,45
1746535614522,BIBC 102,A03,894344,Staff,7,0,46,39
1746535614522,BIBC 102,A04,894345,Staff,26,0,47,21
1746535615560,BICD 100R,A01,894365,Smith; Laurie,0,3,58,58
1746535615560,BICD 100R,A02,894366,Smith; Laurie,0,5,58,58
1746535615560,BICD 100R,A03,894367,Smith; Laurie,2,0,59,57
1746535615560,BICD 100R,A04,959869,Smith; Laurie,41,0,59,18
1746535616587,BICD 136,A01,894383,Gustafson-Brown; Cindy,14,0,50,36
1746535617621,BIEB 102,A01,894494,Butler; Shannon Rhey,51,0,130,79
1746535619679,BIEB 150,A01,894617,Wills; Christopher,3,0,20,17
1746535619679,BIEB 150,A02,894631,Wills; Christopher,3,0,20,17
1746535619679,BIEB 150,A03,894937,Wills; Christopher,3,0,20,17
1746535619679,BIEB 150,A04,894946,Wills; Christopher,5,0,20,15
1746535620709,BIEB 194,A00,906141,Kurle; Carolyn M.,6,0,20,14
1746535621735,BILD 1,A01,894154,Staff,2,0,19,17
1746535621735,BILD 1,A02,894155,Staff,14,0,19,5
1746535621735,BILD 1,A03,894160,Staff,13,0,19,6
1746535621735,BILD 1,A04,894161,Staff,15,0,18,3
1746535622762,BILD 2,A01,894168,Staff,0,0,50,50
1746535622762,BILD 2,A02,894169,Staff,0,0,50,50
1746535622762,BILD 2,A03,894179,Staff,4,0,50,46
1746535622762,BILD 2,A04,894203,Staff,27,0,50,23
1746535623793,BILD 3,A01,894213,Staff,22,0,31,9
1746535623793,BILD 3,A02,894214,Staff,26,0,31,5
1746535623793,BILD 3,A03,894235,Staff,28,0,31,3
1746535623793,BILD 3,A04,894236,Staff,28,0,32,4
1746535624823,BILD 4,A01,894253,Reuther; Keefe,5,0,24,19
1746535624823,BILD 4,A02,894258,Reuther; Keefe,16,0,24,8
1746535625851,BILD 5,A01,894276,Reuther; Keefe,35,0,50,15
1746535625851,BILD 5,A02,894277,Reuther; Keefe,45,0,50,5
1746535625851,BILD 5,A03,894290,Reuther; Keefe,44,0,50,6
1746535625851,BILD 5,A04,894291,Reuther; Keefe,48,0,50,2
1746535626879,BILD 24,A01,894297,Pirino; Giorgia,40,0,60,20
1746535627911,BIMM 100,B01,958915,Staff,72,0,100,28
1746535628938,BIMM 101,A01,895017,McDonnell; Lisa Marie,0,5,24,24
1746535628938,BIMM 101,A02,895018,McDonnell; Lisa Marie,0,5,24,24
1746535628938,BIMM 101,B01,895020,McDonnell; Lisa Marie,0,6,24,24
1746535628938,BIMM 101,B02,895021,McDonnell; Lisa Marie,0,4,24,24
1746535629965,BIMM 110,A01,895023,Staff,1,0,25,24
1746535629965,BIMM 110,A02,895024,Staff,9,0,25,16
1746535629965,BIMM 110,A03,895025,Staff,18,0,25,7
1746535629965,BIMM 110,A04,895031,Staff,20,0,25,5
1746535630991,BIMM 120,A01,895114,Gustafson-Brown; Cindy,13,0,28,15
1746535630991,BIMM 120,A02,895126,Gustafson-Brown; Cindy,21,0,27,6
1746535632020,BIPN 100,A01,895130,Yang; Mingyu,1,0,38,37
1746535632020,BIPN 100,A02,895131,Yang; Mingyu,32,0,38,6
1746535632020,BIPN 100,A03,895132,Yang; Mingyu,32,0,38,6
1746535632020,BIPN 100,A04,895133,Yang; Mingyu,27,0,36,9
1746535633053,BIPN 120,A01,895135,Cooke; James Edward,0,3,13,13
1746535633053,BIPN 120,A02,895136,Cooke; James Edward,0,1,13,13
1746535633053,BIPN 120,A03,895137,Cooke; James Edward,0,3,13,13
1746535633053,BIPN 120,A04,895156,Cooke; James Edward,0,2,11,11
1746535634079,BIPN 134,A01,895235,Cooke; James Edward,0,2,25,25
1746535634079,BIPN 134,A02,895237,Cooke; James Edward,0,0,25,25
1746535634079,BIPN 134,A03,895240,Cooke; James Edward,3,0,25,22
1746535634079,BIPN 134,A04,895270,Cooke; James Edward,20,0,25,5
1746535635110,BIPN 189,A00,892103,Staff,0,13,14,14
1746535637163,BISP 194,A00,958008,Staff,0,2,0,0
1746535638194,CAT 124,A01,922009,Staff,0,5,20,20
1746535639225,CAT 125R,A00,886390,Morales; Celeste Georgianna,0,2,20,20
1746535639225,CAT 125R,B00,886391,Irwin; Matthew Joseph,0,3,20,20
1746535639225,CAT 125R,C00,886392,Smith; Lauryn Alissa,0,2,20,20
1746535639225,CAT 125R,D00,886393,Vanderschuit; Maya Alysia,0,2,20,20
1746535639225,CAT 125R,E00,886394,Marchisotto; Jennifer Anne,0,4,20,20
1746535640251,CENG 15,A01,886218,Drews; Aaron,3,0,8,5
1746535641279,CENG 113,A00,886219,Opatkiewicz; Justin Paul,15,0,25,10
1746535642308,CGS 101,A00,887044,Staff,7,0,20,13
1746535643336,CGS 105,A01,887046,Staff,14,0,25,11
1746535644369,CGS 112,A00,887047,Cuong; Marisol,12,0,15,3
1746535645395,CGS 113,A00,887048,Staff,23,0,30,7
1746535646424,CGS 120,A00,887049,Staff,10,0,17,7
1746535647451,CHEM 6A,A01,886336,Lam; Tin Yiu,38,0,50,12
1746535647451,CHEM 6A,A02,886338,Lam; Tin Yiu,37,0,50,13
1746535648478,CHEM 6B,A01,886341,Hopkins; Patrycja Anna,16,0,50,34
1746535648478,CHEM 6B,A02,886343,Hopkins; Patrycja Anna,42,0,50,8
1746535649512,CHEM 6C,A01,886346,Albizati; Kim F.,0,2,50,50
1746535649512,CHEM 6C,A02,886348,Albizati; Kim F.,23,0,50,27
1746535650544,CHEM 40A,A01,886352,Klosterman; Jeremy K,65,0,100,35
1746535651570,CHEM 40B,A01,886356,Klosterman; Jeremy K,0,23,100,100
1746535652596,CHEM 41B,A01,886360,Theodorakis; Emmanuel,25,0,50,25
1746535652596,CHEM 41B,A02,886362,Theodorakis; Emmanuel,47,0,50,3
1746535653621,CHIN 165A,A00,886382,Xu; Li,18,0,20,2
1746535654647,CLAS 120,A00,886387,Myerston Santana; Jacobo,33,0,40,7
1746535655680,COGS 9,A01,886967,Shannon; Kyle Michael,42,0,60,18
1746535656706,COGS 11,A01,886969,Staff,11,0,30,19
1746535657731,COGS 14A,A01,886971,Staff,6,0,60,54
1746535658762,COGS 14B,A01,886973,Hoffman; Drew Ellen,4,0,60,56
1746535659793,COGS 18,A01,886975,Morgan; Eric,35,0,60,25
1746535660819,COGS 20,A01,886977,Staff,4,0,8,4
1746535660819,COGS 20,A02,886978,Staff,5,0,7,2
1746535661852,COGS 100,A01,907783,Staff,0,2,30,30
1746535662883,COGS 101B,A01,886980,Staff,0,3,48,48
1746535663912,COGS 101C,A01,886982,Delgado; Tania,0,5,44,44
1746535664940,COGS 102A,A01,886984,Johnson; Christine M.,4,0,30,26
1746535665968,COGS 118B,A01,886986,Staff,0,3,88,88
1746535666999,COGS 150,A01,886988,Bergen; Benjamin,23,0,50,27
1746535668027,COGS 153,A00,886989,Delgado; Tania,0,2,41,41
1746535669051,COGS 186,A01,886991,Staff,0,0,32,32
1746535670078,COGS 187A,A01,886993,Boyle; Mary E. T.,7,0,30,23
1746535671105,COGS 189,A00,886994,Staff,0,1,30,30
1746535672132,COMM 10,A01,886996,Staff,0,0,20,21
1746535672132,COMM 10,A02,886997,Staff,12,0,20,8
1746535672132,COMM 10,A03,959845,Staff,19,0,20,1
1746535673158,COMM 20,A01,886999,Leuning; Grant Maurstad,24,0,40,16
1746535675211,COMM 100A,A01,887002,Staff,0,0,20,25
1746535675211,COMM 100A,A02,887003,Staff,7,0,20,13
1746535676240,COMM 100B,A01,887005,Staff,0,8,20,24
1746535677270,COMM 106D,A00,887006,Staff,14,0,40,26
1746535678296,COMM 110G,A00,887007,Whitworth-Smith; Andrew C,12,0,40,28
1746535679322,COMM 111B,A00,887008,Staff,31,0,40,9
1746535680349,COMM 113T,A00,887009,Abuelhiga; Soraya Jill,28,0,40,12
1746535680349,COMM 113T,B00,906733,Staff,40,0,40,0
1746535681377,COMM 145,A00,887010,Staff,12,0,40,28
1746535682408,COMM 146,A00,887054,Staff,31,0,40,9
1746535683434,COMM 190,A00,887012,Staff,8,0,23,15
1746535684503,CSE 8A,A50,887015,Cao; Yingjun,57,0,85,28
1746535685529,CSE 11,A01,887017,Cao; Yingjun,12,0,70,58
1746535686557,CSE 20,A01,887019,Staff,30,0,50,20
1746535687587,CSE 21,A01,887021,Staff,78,0,100,22
1746535687587,CSE 21,B01,892583,Braun; Oliver,45,0,50,5
1746535688613,CSE 30,A01,887025,Eldon; John,143,0,200,57
1746535689643,CSE 100,A01,887027,Staff,26,0,50,24
1746535689643,CSE 100,A02,887028,Staff,40,0,50,10
1746535690673,CSE 101,A01,887030,Braun; Oliver,75,0,100,25
1746535690673,CSE 101,B01,887032,Jones; Miles E,0,3,50,50
1746535690673,CSE 101,B02,887033,Jones; Miles E,0,1,50,50
1746535691699,CSE 105,A01,908084,Jones; Miles E,32,0,50,18
1746535691699,CSE 105,A02,908087,Jones; Miles E,33,0,50,17
1746535692726,CSE 135,A01,887035,Powell; Thomas Allan,0,4,50,50
1746535693753,CSE 142,A01,887037,Staff,8,0,60,52
1746535694787,CSE 142L,A01,887039,Staff,34,0,60,26
1746535695819,CSE 151A,A01,887041,Solares; Edwin A,48,0,100,52
1746535696847,CSE 175,A01,887043,Kumar; Rakesh,30,0,30,0
1746535697874,CSS 1,A01,886389,Staff,0,1,40,40
1746535698899,DSC 30,A01,908097,Liao; Soohyun Nam,47,0,75,28
1746535699927,DSC 40A,A01,908099,Shannon; Kyle Michael,30,0,50,20
1746535700953,DSC 40B,A01,908112,Staff,16,0,50,34
1746535701981,DSC 80,A01,908116,Staff,19,0,60,41
1746535703014,DSC 197,001,956863,Eldridge; Justin Matthew,9999,0,9999,0
1746535704040,ECE 5,A01,886400,Morris; Karcher William,2,0,6,4
1746535704040,ECE 5,A02,886401,Morris; Karcher William,3,0,6,3
1746535705069,ECE 148,A01,886403,Silberman; Jack,0,14,14,14
1746535706095,ECON 1,A01,887265,Crane; Meredith Helen,12,0,70,58
1746535706095,ECON 1,B01,887268,Staff,43,0,50,7
1746535707124,ECON 2,A01,887273,Crane; Meredith Helen,56,0,70,14
1746535708150,ECON 3,A01,887279,Rondina; Giacomo,32,0,70,38
1746535709182,ECON 4,A01,887282,Anderson; John Charles,0,2,10,10
1746535710214,ECON 5,A01,887285,Staff,33,0,45,12
1746535710214,ECON 5,B01,887292,Staff,41,0,45,4
1746535711251,ECON 100A,A01,887337,Newhouse; Herbert S,54,0,70,16
1746535711251,ECON 100A,B01,887349,Staff,45,0,50,5
1746535712277,ECON 100B,A01,887361,Du; Songzi,29,0,70,41
1746535713303,ECON 100C,A01,887445,Newhouse; Herbert S,59,0,70,11
1746535714328,ECON 105,A00,887488,Vespa; Emanuel Ignacio,23,0,35,12
1746535715359,ECON 109,A01,887506,Shishkin; Denis,28,0,35,7
1746535716392,ECON 110A,A01,887568,Alon; Titan Michael,0,3,35,35
1746535716392,ECON 110A,B01,907601,Alon; Titan Michael,20,0,35,15
1746535717420,ECON 110B,A01,887598,Levkoff; Steven B.,0,23,70,70
1746535718445,ECON 112,A00,887599,Rondina; Giacomo,19,0,35,16
1746535719477,ECON 120A,A01,887603,Dai; Yinlin,36,0,70,34
1746535720508,ECON 120C,A01,887608,Sun; Yixiao,0,1,35,35
1746535720508,ECON 120C,B01,887614,Sun; Yixiao,0,0,35,35
1746535721539,ECON 138,A00,887621,Bharadwaj; Prashant,0,20,20,20
1746535722567,ECON 144,A00,958007,Squires; Dale E,13,0,35,22
1746535723595,ECON 171,A01,907666,Staff,18,0,35,17
1746535724625,ECON 175,A00,887626,Wu; Pak Yeung,23,0,35,12
1746535725653,ECON 190,A00,887640,Vespa; Emanuel Ignacio,23,0,35,12
1746535726687,EDS 25,A01,888197,Staff,0,0,0,0
1746535726687,EDS 25,A02,888209,Staff,0,0,0,0
1746535726687,EDS 25,A03,888210,Staff,0,0,0,0
1746535726687,EDS 25,A04,888212,Staff,0,0,0,0
1746535726687,EDS 25,A05,888213,Staff,0,0,0,0
1746535726687,EDS 25,A06,888214,Staff,0,0,0,0
1746535726687,EDS 25,A07,888235,Staff,0,2,0,0
1746535726687,EDS 25,A08,888236,Staff,0,0,0,0
1746535726687,EDS 25,A09,888240,Staff,0,0,0,0
1746535726687,EDS 25,A10,888244,Staff,0,0,0,0
1746535726687,EDS 25,B01,888273,Staff,0,0,0,0
1746535726687,EDS 25,B02,888285,Staff,0,0,0,0
1746535726687,EDS 25,B03,888423,Staff,0,0,0,1
1746535726687,EDS 25,B04,888432,Staff,0,0,0,0
1746535726687,EDS 25,B05,888433,Staff,0,0,0,0
1746535726687,EDS 25,B06,888467,Staff,0,0,0,0
1746535726687,EDS 25,B07,888468,Staff,0,0,0,0
1746535726687,EDS 25,B08,888479,Staff,0,0,0,0
1746535726687,EDS 25,B09,888484,Staff,0,0,0,0
1746535726687,EDS 25,B10,888487,Staff,0,0,0,0
1746535727721,EDS 38,A01,907700,Choi; Bailey Miyeon,30,0,30,0
1746535728750,EDS 112,A01,888601,Chapman; Thandeka K,14,0,40,26
1746535729779,EDS 115,A00,888697,Mendez; Kathrina Mendoza,10,0,30,20
1746535730807,EDS 116,A01,888893,Staff,35,0,40,5
1746535732863,EDS 124AR,A00,889133,Staff,29,0,50,21
1746535732863,EDS 124AR,B00,907471,Simon; Elizabeth A,37,0,50,13
1746535733892,EDS 124BR,A00,889134,Simon; Elizabeth A,45,0,100,55
1746535734956,EDS 125,A00,889135,Staff,25,0,30,5
1746535735983,EDS 126,A01,889138,Staff,36,0,40,4
1746535737011,EDS 164R,A01,889142,Wishard Guerra; Alison G.,33,0,50,17
1746535738039,ENG 30,A01,886396,Staff,0,0,0,0
1746535738039,ENG 30,B01,886398,Staff,0,0,0,0
1746535739069,ENVR 102,A00,906150,Montejo; Carolina,23,0,25,2
1746535740094,ETHN 103A,A00,887236,Man; Simeon S,0,3,0,0
1746535741126,ETHN 113,A00,887239,Staff,16,0,30,14
1746535742152,ETHN 116,A00,887240,Staff,16,0,25,9
1746535743187,ETHN 117,A00,887241,Choi; Esther Min,28,0,30,2
1746535744215,ETHN 118,A00,887243,Staff,24,0,30,6
1746535745244,ETHN 127,A00,887248,Cuong; Marisol,11,0,15,4
1746535746270,ETHN 139,A00,887250,Staff,7,0,10,3
1746535747302,ETHN 142,A00,887252,Staff,10,0,30,20
1746535748329,ETHN 161,A00,887253,Browne; Errol Tsekani,24,0,30,6
1746535749354,ETHN 163FR,A00,887255,Burelle; Julie Sara Veronique,0,0,5,5
1746535750381,GLBH 20,A00,889149,Elwardani; Nile Regina,8,0,42,34
1746535752436,GLBH 111,A01,889152,Burgos; Jose L.,17,0,17,0
1746535753467,GLBH 150,A00,889181,Sloane; Julia Kathryn,0,5,15,15
1746535755525,HDS 60,A01,886406,Warstadt; Melissa Fawn,73,0,80,7
1746535756558,HIAF 111,A00,889324,Gyamfi; Bright,25,0,32,7
1746535757586,HIEA 131,A00,889328,Staff,16,0,32,16
1746535758612,HIEA 144,A00,889333,Henry; Todd A.,26,0,32,6
1746535759637,HIEA 154,A00,889336,Henry; Todd A.,24,0,32,8
1746535760667,HIEU 106,A00,889339,Staff,22,0,32,10
1746535762723,HIEU 114,A00,889340,Staff,3,0,32,29
1746535763752,HIEU 135GS,A00,889342,Patterson; Patrick H.,0,0,1,24
1746535764780,HIEU 137,A00,889343,Edington; Claire Ellen,9,0,25,16
1746535765804,HIEU 148,A00,889345,Staff,14,0,32,18
1746535766830,HIEU 154,A00,889346,Biess; Frank Peter,21,0,32,11
1746535767860,HILA 102,A00,889351,Staff,12,0,32,20
1746535768890,HILD 2A,A01,889221,Lewandoski; Julia Mavis,1,10,32,31
1746535769915,HILD 7B,A01,889225,Man; Simeon S,0,13,32,32
1746535770948,HILD 7C,A01,889288,Alvarez; Luis A,0,14,32,32
1746535771977,HILD 30,A01,889323,Staff,0,5,32,32
1746535774032,HISC 119,A00,889383,Golan; Tal,21,0,32,11
1746535775060,HIUS 103,A00,889384,Man; Simeon S,0,0,32,32
1746535776087,HIUS 117,A00,919797,Kwak; Nancy,18,0,32,14
1746535777114,HIUS 142A,A00,919788,Staff,22,0,32,10
1746535779170,HIUS 149,A00,889386,Gyamfi; Bright,27,0,32,5
1746535780197,HIUS 155,A00,889387,Alvarez; Luis A,14,0,32,18
1746535781224,HUM 3,A01,886499,Caldwell; Michael Alan,19,0,50,31
1746535782253,HUM 3GS,A00,886500,Rodriguez; Bretton Sigfred,0,0,0,28
1746535783282,HUM 3R,A01,886502,Markman; Kristina,0,36,50,50
1746535784307,HUM 4,A01,886504,Crum; Matthew Stephen,24,0,50,26
1746535784307,HUM 4,B01,886506,West; Geoffrey Scott,17,0,50,33
1746535785336,HUM 4GS,A00,886507,Staff,0,0,0,19
1746535786362,HUM 5,A01,886509,Staff,32,0,50,18
1746535787390,HUM 5R,A01,886511,Zavodny; Tatiana Sophia,0,39,50,50
1746535788454,JAPN 180,A00,886407,Staff,18,0,40,22
1746535789486,LATI 50,A01,886409,Martin-Cabrera; Luis,4,0,22,18
1746535789486,LATI 50,A02,886410,Martin-Cabrera; Luis,19,0,22,3
1746535789486,LATI 50,A03,886411,Martin-Cabrera; Luis,21,0,22,1
1746535789486,LATI 50,A04,886412,Martin-Cabrera; Luis,9,0,22,13
1746535790516,LAWS 101,A00,907664,Staff,28,0,60,32
1746535791545,LIAB 1A,A00,889388,Saab; Dima,17,0,20,3
1746535792571,LIAB 1AX,A00,889389,El Cheddadi; Youniss,17,0,20,3
1746535793597,LIFR 1C,A00,889391,Van Moer; Vinciane G,8,0,20,12
1746535794625,LIFR 1CX,A00,889392,Van Moer; Vinciane G,7,0,20,13
1746535795653,LIFR 1D,A00,889393,Van Moer; Vinciane G,7,0,20,13
1746535796681,LIFR 1DX,A00,889394,Van Moer; Vinciane G,8,0,20,12
1746535797709,LIGN 7,A00,886923,Staff,24,0,50,26
1746535798744,LIGN 17,A00,886924,Kehler; Andrew Scott,125,0,150,25
1746535799771,LTAM 110,A00,889395,Staff,15,0,30,15
1746535800801,LTAM 110GS,A00,958010,Rodriguez; Bretton Sigfred,0,0,0,28
1746535801827,LTCH 101,A00,889397,Staff,23,0,25,2
1746535802856,LTCS 130,A00,889398,Staff,23,0,25,2
1746535803887,LTEA 138,A00,889399,Staff,24,0,40,16
1746535804915,LTEN 149,A00,889400,Wesling; Megan E.,0,3,25,25
1746535805944,LTEN 169,A00,889401,Staff,20,0,25,5
1746535806970,LTEN 180,A00,889402,Staff,10,0,15,5
1746535807997,LTEN 181,A00,889403,Staff,21,0,25,4
1746535809026,LTWL 100,A00,889404,Myerston Santana; Jacobo,3,0,25,22
1746535810057,LTWL 180GS,A00,889405,Staff,0,0,20,20
1746535811083,LTWL 181,A00,889406,Staff,17,0,25,8
1746535812110,LTWL 184,A00,889475,Mukherjee; Silpa,22,0,25,3
1746535813136,LTWR 102C,A00,889486,Staff,29,0,30,1
1746535814160,LTWR 115W,A00,889491,Staff,0,2,15,15
1746535815191,MAE 8,A01,886905,Staff,0,2,0,0
1746535816226,MAE 11,A00,886906,Bandaru; Prabhakar,0,7,50,50
1746535817252,MAE 20,A00,886907,Evdokimenko; Ekaterina,44,0,70,26
1746535818285,MAE 30B,A00,886909,Ghazinejad; Maziar,26,0,45,19
1746535819313,MAE 101B,A00,886910,Saintillan; David,29,0,45,16
1746535820342,MAE 105,A00,886911,Bandaru; Prabhakar,18,0,50,32
1746535821370,MAE 107,B00,958024,Staff,9,0,50,41
1746535822405,MAE 143B,A00,886913,Bewley; Thomas R,7,0,40,33
1746535823437,MAE 148,A01,886915,Silberman; Jack,0,3,14,14
1746535824463,MAE 160,A00,886916,Evdokimenko; Ekaterina,31,0,60,29
1746535825492,MATH 3C,A01,889681,Staff,0,3,30,30
1746535825492,MATH 3C,A02,960048,Staff,25,0,30,5
1746535826519,MATH 10A,A01,889760,Staff,26,0,30,4
1746535826519,MATH 10A,A02,889783,Staff,29,0,30,1
1746535827557,MATH 10B,A01,889785,Verstraete; Jacques Allan,2,0,35,33
1746535827557,MATH 10B,A02,889795,Verstraete; Jacques Allan,4,0,35,31
1746535827557,MATH 10B,B01,889797,Verstraete; Jacques Allan,3,0,35,32
1746535827557,MATH 10B,B02,889828,Verstraete; Jacques Allan,3,0,35,32
1746535828588,MATH 10C,A01,889849,Habib; Yousaf,9,0,30,21
1746535828588,MATH 10C,A02,889852,Habib; Yousaf,14,0,30,16
1746535828588,MATH 10C,A03,889853,Habib; Yousaf,22,0,30,8
1746535828588,MATH 10C,A04,889858,Habib; Yousaf,20,0,30,10
1746535828588,MATH 10C,B01,889861,Staff,1,0,30,29
1746535828588,MATH 10C,B02,889862,Staff,24,0,30,6
1746535828588,MATH 10C,B03,889863,Staff,27,0,30,3
1746535828588,MATH 10C,B04,889967,Staff,23,0,30,7
1746535829616,MATH 18,A01,889974,Staff,7,0,30,23
1746535829616,MATH 18,A02,889977,Staff,20,0,30,10
1746535829616,MATH 18,B01,889984,Hardiman; Liam,22,0,30,8
1746535829616,MATH 18,B02,889985,Hardiman; Liam,25,0,30,5
1746535830646,MATH 20A,A01,889990,Suk; Andrew Hoon,29,0,35,6
1746535831680,MATH 20B,A01,889993,Ohm; Ko Woon,22,0,30,8
1746535831680,MATH 20B,A02,889994,Ohm; Ko Woon,30,0,30,0
1746535831680,MATH 20B,B01,889996,Ohm; Ko Woon,21,0,30,9
1746535831680,MATH 20B,B02,889997,Ohm; Ko Woon,23,0,30,7
1746535832707,MATH 20C,A01,889999,Hammock; Frances H,17,0,30,13
1746535832707,MATH 20C,A02,890003,Hammock; Frances H,23,0,30,7
1746535832707,MATH 20C,B01,890006,Hammock; Frances H,3,0,30,27
1746535832707,MATH 20C,B02,890007,Hammock; Frances H,11,0,30,19
1746535833736,MATH 20D,A01,890011,Cheng; Hsiao-Bing,1,1,30,29
1746535833736,MATH 20D,A02,890012,Cheng; Hsiao-Bing,14,0,30,16
1746535833736,MATH 20D,B01,890016,Cheng; Hsiao-Bing,13,0,30,17
1746535833736,MATH 20D,B02,890017,Cheng; Hsiao-Bing,13,0,30,17
1746535834765,MATH 20E,A01,890026,Harel; Guershon,1,0,30,29
1746535834765,MATH 20E,A02,890029,Harel; Guershon,23,0,30,7
1746535834765,MATH 20E,B01,890033,Harel; Guershon,7,0,30,23
1746535834765,MATH 20E,B02,890101,Harel; Guershon,21,0,30,9
1746535835794,MATH 102,A01,890104,Staff,17,0,30,13
1746535835794,MATH 102,A02,890105,Staff,27,0,30,3
1746535836822,MATH 103B,A01,890116,Salehi Golsefidy; Alireza,3,0,30,27
1746535836822,MATH 103B,B01,890118,Staff,0,3,34,34
1746535837852,MATH 109,A01,890121,Aliabadi Sr.; Mohsen,1,0,30,29
1746535837852,MATH 109,B01,890124,Upadrashta; Pranav Kumar,18,0,30,12
1746535838880,MATH 120A,A01,890126,Eggers; John Dietrich,13,0,30,17
1746535839906,MATH 142B,A01,890128,Ioana; Adrian,19,0,30,11
1746535839906,MATH 142B,A02,890129,Ioana; Adrian,13,0,30,17
1746535840938,MATH 154,A01,890174,Staff,0,0,30,30
1746535840938,MATH 154,A02,890182,Staff,0,0,30,30
1746535841964,MATH 168A,A01,890197,Dumitriu; Ioana,21,0,35,14
1746535842991,MATH 170A,A01,890240,Nie; Jiawang,1,0,30,29
1746535842991,MATH 170A,A02,890241,Nie; Jiawang,11,0,30,19
1746535842991,MATH 170A,A03,890249,Nie; Jiawang,23,0,30,7
1746535844017,MATH 170B,A01,957891,Nag; Panchali,13,0,35,22
1746535846076,MATH 181A,A01,908025,Staff,0,4,35,35
1746535846076,MATH 181A,A02,960115,Staff,27,0,35,8
1746535847106,MATH 181B,A01,959874,Staff,26,0,30,4
1746535848134,MATH 193B,A01,890265,Staff,0,4,35,35
1746535849160,MGT 4,A01,890311,Anderson; John Charles,42,0,88,46
1746535850189,MGT 5,A00,907740,Staff,13,0,98,85
1746535851223,MGT 12,A00,890312,Lindenberger; Wade Douglas,67,0,98,31
1746535852251,MGT 16,A00,957883,Staff,78,0,98,20
1746535854311,MGT 45,A00,890314,Pecore; Joseph P.,47,0,98,51
1746535855339,MGT 71,A00,890315,Staff,0,11,98,98
1746535856365,MGT 100,A00,890316,Yavorsky; Daniel Ryan,44,0,98,54
1746535857397,MGT 103,A00,890317,Ehrich; Kristine R,73,0,98,25
1746535858429,MGT 105,A00,890356,Bates; Kenneth Walter,0,7,98,98
1746535859464,MGT 112,A00,890360,Ehrich; Kristine R,55,0,98,43
1746535860495,MGT 127R,A00,907732,Zhu; Kevin Xiaoguo,23,0,98,75
1746535861528,MGT 131B,A00,890361,Anderson; John Charles,61,0,98,37
1746535862555,MGT 137,A00,890362,Lindenberger; Wade Douglas,65,0,98,33
1746535863587,MGT 160,A00,890369,Johnson; Erik Barry,9,0,98,89
1746535865646,MGT 164,A00,890372,Zimmermann; Carsten,0,39,98,98
1746535866673,MGT 180,A00,890374,Bliss; Barbara Ann,12,0,98,86
1746535867704,MMW 15,A01,886414,Chang; Edmond Yi-Teh,0,12,28,28
1746535867704,MMW 15,A02,886415,Chang; Edmond Yi-Teh,0,8,28,28
1746535867704,MMW 15,A03,886416,Chang; Edmond Yi-Teh,0,8,28,28
1746535867704,MMW 15,A04,886417,Chang; Edmond Yi-Teh,0,8,28,28
1746535867704,MMW 15,B01,886419,Chang; Edmond Yi-Teh,0,7,28,28
1746535867704,MMW 15,B02,886420,Chang; Edmond Yi-Teh,0,8,28,28
1746535867704,MMW 15,B03,886421,Chang; Edmond Yi-Teh,0,7,28,28
1746535867704,MMW 15,B04,886422,Chang; Edmond Yi-Teh,0,8,28,28
1746535867704,MMW 15,C01,886424,Staff,0,9,28,28
1746535867704,MMW 15,C02,886425,Staff,0,8,28,28
1746535867704,MMW 15,C03,886426,Staff,0,8,28,28
1746535867704,MMW 15,C04,886427,Staff,0,7,28,28
1746535867704,MMW 15,C05,958038,Staff,0,7,28,28
1746535867704,MMW 15,C06,958039,Staff,0,8,28,28
1746535868731,MMW 15GS,A00,906910,Patterson; Patrick H.,4,0,28,24
1746535869770,MMW 122R,A01,886429,Rahimi; Babak,0,13,28,28
1746535869770,MMW 122R,A02,886430,Rahimi; Babak,0,12,28,28
1746535869770,MMW 122R,A03,958040,Rahimi; Babak,0,11,28,28
1746535870798,MUS 1A,A01,890937,Staff,3,0,25,22
1746535870798,MUS 1A,A02,891035,Staff,6,0,25,19
1746535870798,MUS 1A,C01,958912,Staff,24,0,25,1
1746535870798,MUS 1A,C02,958913,Staff,25,0,25,0
1746535872852,MUS 2AK,A00,957092,Ohnishi; Takae,15,0,15,0
1746535873881,MUS 4,A01,891044,Staff,2,0,25,23
1746535873881,MUS 4,A02,891045,Staff,23,0,25,2
1746535873881,MUS 4,B01,891048,Staff,17,0,25,8
1746535873881,MUS 4,B02,891050,Staff,25,0,25,0
1746535874918,MUS 5,A01,957506,Dubnov; Shlomo,0,0,25,25
1746535874918,MUS 5,A02,957622,Dubnov; Shlomo,14,0,25,11
1746535874918,MUS 5,A03,957623,Dubnov; Shlomo,20,0,25,5
1746535875949,MUS 6,A01,891053,Freitas Caetano; Marcelo,24,0,25,1
1746535875949,MUS 6,A02,891054,Freitas Caetano; Marcelo,23,0,25,2
1746535876982,MUS 7,A01,891081,Staff,0,0,25,25
1746535876982,MUS 7,A02,891082,Staff,4,0,25,21
1746535878014,MUS 8GS,A00,891118,Borgo; David Garcia,0,0,25,25
1746535879045,MUS 11,A01,891140,Staff,11,0,25,14
1746535879045,MUS 11,A02,891141,Staff,22,0,25,3
1746535880078,MUS 13,A01,891143,Staff,8,0,25,17
1746535880078,MUS 13,A02,891144,Staff,24,0,25,1
1746535881110,MUS 15,A01,891146,Staff,9,0,25,16
1746535881110,MUS 15,A02,891148,Staff,21,0,25,4
1746535881110,MUS 15,B01,891150,Staff,18,0,25,7
1746535881110,MUS 15,B02,891151,Staff,25,0,25,0
1746535882139,MUS 20,A01,891153,Staff,5,0,20,15
1746535882139,MUS 20,A02,891155,Staff,14,0,20,6
1746535883166,MUS 80,A00,891156,Staff,19,0,25,6
1746535883166,MUS 80,B00,891157,Staff,23,0,25,2
1746535884195,MUS 130,A00,891158,Ohnishi; Takae,35,0,35,0
1746535885221,MUS 150GS,A01,891160,Borgo; David Garcia,0,0,25,25
1746535886251,MUS 170,A01,891162,Freitas Caetano; Marcelo,20,0,25,5
1746535886251,MUS 170,A02,891164,Freitas Caetano; Marcelo,21,0,25,4
1746535887281,NANO 11,A00,886220,Vazquez Mena; Oscar,13,0,15,2
1746535888314,NANO 15,A01,886222,Drews; Aaron,4,0,7,3
1746535889341,NANO 104,A00,886224,Sirbuly; Donald,18,0,25,7
1746535890365,PH 40,A00,886528,Staff,23,0,40,17
1746535891390,PH 45,A01,886799,Staff,35,0,40,5
1746535892456,PH 110,A00,886802,Staff,0,7,40,40
1746535893482,PH 172,A00,906716,Staff,19,0,35,16
1746535894508,PH 191,A00,886803,Staff,6,0,40,34
1746535895539,PHIL 1,A00,889500,Staff,19,0,30,11
1746535896572,PHIL 10,A01,889549,Grush; Rick Scott,15,0,22,7
1746535896572,PHIL 10,A02,889551,Grush; Rick Scott,22,0,22,0
1746535897608,PHIL 28,A01,889559,Lamey; Andy M.,0,1,31,31
1746535897608,PHIL 28,A02,889561,Lamey; Andy M.,0,1,30,30
1746535897608,PHIL 28,A03,889572,Lamey; Andy M.,0,0,30,30
1746535898636,PHIL 35,A00,907839,Staff,13,0,15,2
1746535899662,PHIL 60,A00,889574,Staff,74,0,90,16
1746535900695,PHIL 101,A00,958004,Staff,13,0,15,2
1746535902747,PHIL 136,A00,889582,Fulkerson; Matthew Todd,26,0,45,19
1746535903774,PHIL 163,A01,889601,Staff,21,0,30,9
1746535903774,PHIL 163,B01,889606,Brandt; Reuven A,0,3,0,0
1746535904801,PHIL 164,A00,889610,Staff,16,0,30,14
1746535905828,PHIL 165,A00,889613,Staff,23,0,30,7
1746535906856,PHYS 1A,A00,886431,Staff,26,0,70,44
1746535907884,PHYS 1AL,001,886432,Tsai; Philbert S,0,2,30,30
1746535907884,PHYS 1AL,002,886436,Tsai; Philbert S,11,0,30,19
1746535908913,PHYS 1B,A00,886439,Staff,185,0,240,55
1746535909942,PHYS 1BL,001,886441,Tsai; Philbert S,0,4,30,30
1746535909942,PHYS 1BL,002,886444,Tsai; Philbert S,2,0,30,28
1746535910969,PHYS 1C,A00,896092,Arnold; Kam S,78,0,146,68
1746535911999,PHYS 1CL,001,886448,Tsai; Philbert S,0,0,30,30
1746535911999,PHYS 1CL,002,886449,Tsai; Philbert S,0,0,30,30
1746535911999,PHYS 1CL,003,886450,Tsai; Philbert S,15,0,30,15
1746535911999,PHYS 1CL,004,886451,Tsai; Philbert S,15,0,30,15
1746535913026,PHYS 2B,A01,886457,Staff,69,0,115,46
1746535914056,PHYS 2C,A01,886460,Shotwell; Brian,0,8,65,65
1746535915109,PHYS 2CL,A01,886467,Staff,0,4,28,28
1746535915109,PHYS 2CL,A02,886468,Staff,0,3,28,28
1746535916141,PHYS 2D,A01,886470,Staff,10,0,50,40
1746535917167,PHYS 4B,A01,886475,Grinstein; Benjamin,22,0,40,18
1746535918200,POLI 5,A00,891173,Desposato; Scott,7,0,25,18
1746535919228,POLI 5D,A01,891175,Staff,5,0,5,0
1746535919228,POLI 5D,B01,891178,Staff,5,0,5,0
1746535920257,POLI 11,A00,891179,Ferree; Karen E,2,0,35,33
1746535921281,POLI 12,A00,891180,Staff,16,0,30,14
1746535922310,POLI 27,A01,891182,Staff,12,0,75,63
1746535923338,POLI 30,A00,891183,Staff,9,0,50,41
1746535924366,POLI 100B,A00,891244,Staff,5,1,35,30
1746535925391,POLI 100I,A00,891247,Staff,7,0,30,23
1746535926424,POLI 104J,A00,891248,Nichter; Maysa,14,0,30,16
1746535927452,POLI 104U,A00,891250,Nichter; Maysa,2,0,30,28
1746535929509,POLI 110B,A00,891255,Wiens; David,20,0,25,5
1746535930540,POLI 112A,A00,891256,Wiens; David,6,0,25,19
1746535931573,POLI 114BR,A00,891261,Staff,19,0,30,11
1746535932601,POLI 117R,A00,891262,Forman; Fonna,0,6,50,50
1746535933631,POLI 118,A00,891264,Ingham; Sean,17,0,25,8
1746535934657,POLI 124A,A00,891265,Staff,18,0,20,2
1746535935690,POLI 125D,A00,891266,Nichter; Simeon C,2,0,25,23
1746535936716,POLI 126,A00,891268,Nichter; Simeon C,7,0,25,18
1746535937744,POLI 126AA,A00,891272,Staff,18,0,25,7
1746535938771,POLI 130AA,A00,891273,Staff,15,0,20,5
1746535939800,POLI 134AA,A00,891274,Staff,4,0,20,16
1746535941865,POLI 138,A00,891278,Staff,21,0,25,4
1746535942891,POLI 142K,A00,891280,Staff,11,0,25,14
1746535943923,POLI 142M,A00,891281,Gartzke; Erik,17,0,30,13
1746535944949,POLI 142P,A00,891284,Staff,20,0,30,10
1746535945976,POLI 143,A00,891285,Gartzke; Erik,12,0,30,18
1746535947002,POLI 153,A00,891286,Staff,19,0,20,1
1746535949059,POLI 175,A00,891290,Staff,15,0,20,5
1746535950088,PSYC 1,A00,890674,Steiner; Eric Tomas,0,11,45,45
1746535951119,PSYC 2,A00,890676,Albright; Thomas D,21,0,35,14
1746535952148,PSYC 3,A00,890679,Staff,17,0,20,3
1746535953177,PSYC 6,A00,959858,Staff,20,0,20,0
1746535954206,PSYC 60,A01,890684,Rickard; Timothy C.,0,5,45,45
1746535955239,PSYC 70,A01,890689,Geller; Emma Harlan,7,0,30,23
1746535956264,PSYC 71,A01,959860,Staff,21,0,25,4
1746535957297,PSYC 100,A00,890690,Lacefield; Katharine I,0,50,180,180
1746535958327,PSYC 102,A00,890695,Staff,18,0,40,22
1746535959354,PSYC 105,A00,890699,Geller; Emma Harlan,71,0,100,29
1746535960383,PSYC 106,A00,890701,Gorman; Michael R.,5,0,30,25
1746535961411,PSYC 108,A00,890704,Adrian; Julia Anna,0,28,50,50
1746535962437,PSYC 118,A01,890712,Staff,11,0,30,19
1746535963468,PSYC 124,A00,890716,Chapman; Eddie Nathaniel,25,0,60,35
1746535964494,PSYC 131,A00,890717,Anagnostaras; Stephan,0,7,80,80
1746535965521,PSYC 137,A00,890719,Winkielman; Piotr,0,11,30,30
1746535966555,PSYC 144,A00,890721,Adrian; Julia Anna,0,9,45,45
1746535967584,PSYC 162,A00,890805,Staff,2,0,75,73
1746535968610,PSYC 169,A00,890810,Staff,0,15,30,30
1746535969641,PSYC 172,A00,890814,Gorman; Michael R.,9,0,30,21
1746535970673,PSYC 181,A00,890818,Anagnostaras; Stephan,8,0,200,192
1746535971702,PSYC 184,A00,959861,Staff,170,0,175,5
1746535972729,PSYC 189,A00,890823,Staff,0,1,30,30
1746535973760,PSYC 191,A00,890884,Rickard; Timothy C.,0,11,35,35
1746535974790,PSYC 193,A00,890913,Staff,19,0,30,11
1746535974790,PSYC 193,B00,890914,Chapman; Eddie Nathaniel,24,0,30,6
1746535975830,PSYC 193L,A01,890918,Lowe; Angela Beth,20,0,30,10
1746535975830,PSYC 193L,B01,890921,Hurwitz; Ethan Scott,20,0,30,10
1746535975830,PSYC 193L,C01,890928,Staff,30,0,30,0
1746535976857,RELI 149,A00,886806,Rahimi; Babak,23,0,40,17
1746535977889,SE 9,A01,886814,Staff,7,0,20,13
1746535978917,SE 101B,A01,886816,Chadha; Mayank,4,0,35,31
1746535979953,SE 110B,A00,886818,Zhu; Qiang,4,0,75,71
1746535980981,SE 125,A01,886830,Staff,10,0,30,20
1746535982011,SE 130B,A01,886835,Staff,14,0,40,26
1746535983039,SE 131A,A01,886838,Krysl; Petr,34,0,55,21
1746535984066,SE 154,A00,886840,Staff,30,0,50,20
1746535985095,SE 164GS,A01,886849,Staff,6,0,20,14
1746535986125,SE 167GS,A01,886853,Staff,6,0,20,14
1746535987150,SIO 25,A01,890107,Staff,19,0,30,11
1746535988178,SIO 45,A00,890109,Cook; Geoffrey W,117,0,200,83
1746535989205,SIO 109R,A00,890110,Forman; Fonna,0,16,20,20
1746535990236,SIO 187,A01,890114,Kacev; David,15,0,40,25
1746535991274,SOCI 1,A01,890431,Thorpe; Charles Robert,15,0,30,15
1746535991274,SOCI 1,A02,890518,Thorpe; Charles Robert,30,0,30,0
1746535992304,SOCI 2,A01,957978,Staff,25,0,25,0
1746535992304,SOCI 2,A02,957979,Staff,23,0,25,2
1746535993331,SOCI 20,A01,890523,Calderon-Zaks; Michael Aar,23,0,30,7
1746535993331,SOCI 20,A02,890526,Calderon-Zaks; Michael Aar,29,0,30,1
1746535994360,SOCI 30,A01,890533,Pardo Guerra; Juan Pablo,37,0,40,3
1746535995386,SOCI 40,A01,890535,Staff,27,0,45,18
1746535996450,SOCI 104Q,A00,890559,Staff,18,0,30,12
1746535997482,SOCI 106,A00,890560,Arnal; Maud Marie Leonie,20,0,30,10
1746535998507,SOCI 110,A00,890567,Holkenbrink-Monk; Charlene,19,0,30,11
1746535999534,SOCI 112,A00,890568,Victoria Torres; Pablo,1,0,55,54
1746536000565,SOCI 115,A00,890597,Arnal; Maud Marie Leonie,28,0,45,17
1746536002619,SOCI 121,A00,890604,Pardo Guerra; Juan Pablo,38,0,45,7
1746536003648,SOCI 126,A01,890608,Staff,8,0,10,2
1746536004676,SOCI 127,A00,890609,Staff,18,0,30,12
1746536005705,SOCI 131,A00,890610,Thorpe; Charles Robert,37,0,45,8
1746536006732,SOCI 135,A00,890615,Payne; Christine Anna,14,0,45,31
1746536007757,SOCI 139,A00,890620,Staff,38,0,45,7
1746536008785,SOCI 148E,A00,890622,Calderon-Zaks; Michael Aar,36,0,45,9
1746536009815,SOCI 150,A00,890623,Kohler; Kristopher M.,31,0,45,14
1746536010847,SOCI 157,A00,890625,Jules-Rosette; Bennetta W.,18,0,20,2
1746536011872,SOCI 160,A00,890627,Payne; Christine Anna,21,0,45,24
1746536012899,SYN 1,A00,886855,Fish; Gwendolyn Anne,0,0,0,0
1746536012899,SYN 1,B00,906086,Fish; Gwendolyn Anne,0,1,0,2
1746536013928,SYN 2R,A00,886860,Staff,0,17,15,15
1746536013928,SYN 2R,B00,906106,Atkinson; Arthur Laird,0,16,15,15
1746536014958,SYN 100,A01,886866,Browne; Emily,0,28,20,20
1746536014958,SYN 100,B01,906128,Rock; Martin,0,5,20,20
1746536014958,SYN 100,C01,906140,Deavenport; James Cary,0,3,20,20
1746536014958,SYN 100,D01,907816,Deavenport; James Cary,0,5,20,20
1746536015986,TDAC 1,A00,890286,Walsh; Kim C.,9,0,20,11
1746536017019,TDAC 101,A00,890296,Basso; Beatrice,16,0,20,4
1746536018049,TDDE 131,A00,890297,Staff,47,0,50,3
1746536019077,TDDM 1,A00,890287,Weinberg; Sadie,25,0,30,5
1746536020106,TDGE 11,A00,890288,Fulton; Julia,137,0,200,63
1746536020106,TDGE 11,B00,890289,Castro; Robert Jess,184,0,200,16
1746536021141,TDGE 25,B00,957359,Walsh; Kim C.,3,0,20,17
1746536022168,TDGE 40,A01,890292,Power; Jade Yukana,27,0,30,3
1746536023194,TDGE 124,A00,890298,Havis; Allan,0,0,50,50
1746536024219,TDGE 131R,A00,890299,Burelle; Julie Sara Veronique,15,0,42,27
1746536025249,TDHT 101,A00,890300,Staff,10,0,20,10
1746536026278,TDHT 109,A01,890302,Anderson; Mysia Anyse,31,0,40,9
1746536027308,TDMV 1,A00,890293,Arcidiacono; Kristin,18,0,30,12
1746536028333,TDMV 2,A00,890294,Weinberg; Sadie,23,0,30,7
1746536029359,TDMV 3,A00,957878,Arcidiacono; Kristin,28,0,30,2
1746536031413,TDMV 138,A00,890304,Jun; Grace Shin Hae,25,0,40,15
1746536032439,TDMV 140,A00,890305,Corrales; Joseph Bernales,25,0,30,5
1746536033472,TDMV 142,A00,890307,Caligagan; Tony,32,0,40,8
1746536034498,TDMV 144,A00,890308,Camaya; Michelle Ann,25,0,30,5
1746536035524,TDPW 1,A00,890295,Stein; Deborah Isobel,3,0,20,17
1746536036552,USP 2,A01,890272,Lerner; Amy M,6,0,20,14
1746536037579,USP 3,A01,890274,Staff,12,0,30,18
1746536038605,USP 15,A01,890276,Sun; Feiyang,17,0,30,13
1746536039633,USP 25,A00,890277,Shenkman; Michael Thomas,19,0,25,6
1746536040660,USP 138,A00,890278,Staff,13,0,25,12
1746536041688,USP 143,A00,890279,Staff,21,0,70,49
1746536042717,USP 144,A00,890280,Chowdhury; Muhammed Zohir,16,0,30,14
1746536043744,USP 150,A00,890281,Boomhower; Matthew Charles,4,0,30,26
1746536044770,USP 151,A00,890282,Staff,16,0,20,4
1746536045798,USP 162,A00,890283,Andrews; Abigail Leslie,16,0,20,4
1746536046822,USP 168,A00,920477,Kwak; Nancy,1,0,5,4
1746536047849,USP 181,A00,890284,Staff,3,0,20,17
1746536048877,USP 191A,A00,890285,Staff,13,0,20,7
1746536049905,VIS 101,A00,886512,Staff,25,0,75,50
1746536050935,VIS 103,A00,886513,Cruz; Edwin Teddy,61,0,75,14
1746536051961,VIS 108,A00,886514,Staff,3,0,15,12
1746536052987,VIS 127P,A00,886515,Shen; Kuiyi,80,0,146,66
1746536054014,VIS 149,A00,886516,Yoldas; Pinar,0,0,15,15
1746536055047,VIS 164,A00,886526,Erdmann; Dean,19,0,22,3
1746536056072,VIS 194S,A00,886527,Staff,61,0,75,14
1746536057107,WCWP 10A,C00,886484,Martiniuk; Jill,12,0,15,3
1746536058134,WCWP 10B,A00,886490,Uriarte; Emma,0,0,15,15
1746536058134,WCWP 10B,B00,886491,Dhir; Simrita,11,0,15,4
1746536058134,WCWP 10B,C00,886492,Ornelas; Tricia,0,0,15,15
1746536059160,WCWP 100,A00,886494,Young; Mark T,0,7,15,15
1746536061288,AAS 10,A01,886199,Childs; Dennis R.,0,3,0,0
1746536062321,ANAR 104,A01,886940,Shtienberg; Gilad,27,0,30,3
1746536063348,ANAR 120,A00,886953,Staff,12,0,20,8
1746536064375,ANBI 148,A01,886955,Wilder; Linnea Lorene,30,0,40,10
1746536066429,ANSC 122,A00,886957,Staff,25,0,30,5
1746536067455,ANSC 150,A00,886958,Sloane; Julia Kathryn,3,0,15,12
1746536068482,ANSC 156,A00,886959,Jenkins; Janis A.,0,1,15,15
1746536069508,ANSC 180,A00,886960,Staff,11,0,17,6
1746536070536,ANSC 188,A00,886961,Jassal; Aftab,9,0,25,16
1746536071569,ANSC 190,A00,886962,Jassal; Aftab,14,0,25,11
1746536072595,ANSC 191,A00,886963,Staff,18,0,20,2
1746536073625,ANTH 3,A01,891689,Staff,17,0,20,3
1746536074651,ANTH 5,A00,886933,Semendeferi; Ekaterini,16,0,20,4
1746536075677,ANTH 10,A00,886934,Staff,0,12,30,30
1746536076703,ANTH 21,A01,886936,Staff,40,0,60,20
1746536077728,ANTH 23,A01,886938,Staff,92,0,100,8
1746536078759,ANTH 105,A00,886964,Stewart; Alexander B,84,0,100,16
1746536079786,ANTH 108,A00,886965,Pedersen; David,9,0,20,11
1746536080818,AWP 10,001,886147,Staff,0,0,0,0
1746536080818,AWP 10,002,886148,Staff,0,0,0,0
1746536080818,AWP 10,003,886149,Staff,0,0,0,0
1746536080818,AWP 10,004,886150,Staff,0,0,0,0
1746536080818,AWP 10,005,886151,Staff,0,0,0,0
1746536080818,AWP 10,006,886152,Staff,0,0,0,0
1746536080818,AWP 10,007,886153,Staff,0,0,0,0
1746536080818,AWP 10,008,886154,Staff,0,0,0,0
1746536080818,AWP 10,009,886155,Staff,0,0,0,0
1746536080818,AWP 10,010,886156,Staff,0,0,0,0
1746536080818,AWP 10,011,886158,Staff,0,0,0,0
1746536080818,AWP 10,012,886160,Staff,0,0,0,0
1746536080818,AWP 10,013,886161,Staff,0,0,0,0
1746536080818,AWP 10,014,886162,Staff,0,0,0,0
1746536080818,AWP 10,015,886163,Staff,0,0,0,0
1746536080818,AWP 10,016,886164,Staff,0,0,0,0
1746536080818,AWP 10,017,886165,Staff,0,0,0,0
1746536080818,AWP 10,018,886166,Staff,0,0,0,0
1746536080818,AWP 10,019,886168,Staff,0,0,0,0
1746536080818,AWP 10,020,886170,Staff,0,0,0,0
1746536080818,AWP 10,021,886172,Staff,0,0,0,0
1746536081853,AWP 10R,001,886173,Staff,0,1,0,0
1746536081853,AWP 10R,002,886174,Staff,0,1,0,0
1746536081853,AWP 10R,003,886175,Staff,0,0,0,0
1746536081853,AWP 10R,004,886176,Staff,0,0,0,0
1746536081853,AWP 10R,005,886177,Staff,0,0,0,0
1746536081853,AWP 10R,006,886178,Staff,0,0,0,0
1746536081853,AWP 10R,007,886179,Staff,0,0,0,0
1746536081853,AWP 10R,008,886181,Staff,0,0,0,0
1746536081853,AWP 10R,009,886182,Staff,0,0,0,0
1746536081853,AWP 10R,010,886183,Staff,0,0,0,0
1746536081853,AWP 10R,011,886184,Staff,0,0,0,0
1746536081853,AWP 10R,012,886185,Staff,0,0,0,0
1746536081853,AWP 10R,013,886186,Staff,0,0,0,0
1746536081853,AWP 10R,014,886187,Staff,0,0,0,0
1746536081853,AWP 10R,015,886188,Staff,0,0,0,0
1746536081853,AWP 10R,016,886189,Staff,0,0,0,0
1746536082883,AWP 102R,A00,886190,Staff,0,0,0,0
1746536082883,AWP 102R,B00,886191,Staff,0,0,0,0
1746536083907,BENG 100,A01,886193,Staff,17,0,30,13
1746536084933,BENG 122A,A01,886195,Hasty; Jeff M,13,0,30,17
1746536085962,BENG 166A,A00,886196,Sah; Robert Lie-Yuan,0,1,30,30
1746536086990,BENG 190,A00,958050,Khojah; Reem I,24,0,25,1
1746536088022,BIBC 102,A01,894320,Staff,0,0,46,46
1746536088022,BIBC 102,A02,894321,Staff,1,0,46,45
1746536088022,BIBC 102,A03,894344,Staff,7,0,46,39
1746536088022,BIBC 102,A04,894345,Staff,26,0,47,21
1746536089051,BICD 100R,A01,894365,Smith; Laurie,0,3,58,58
1746536089051,BICD 100R,A02,894366,Smith; Laurie,0,5,58,58
1746536089051,BICD 100R,A03,894367,Smith; Laurie,2,0,59,57
1746536089051,BICD 100R,A04,959869,Smith; Laurie,41,0,59,18
1746536090084,BICD 136,A01,894383,Gustafson-Brown; Cindy,14,0,50,36
1746536091116,BIEB 102,A01,894494,Butler; Shannon Rhey,51,0,130,79
1746536093177,BIEB 150,A01,894617,Wills; Christopher,3,0,20,17
1746536093177,BIEB 150,A02,894631,Wills; Christopher,3,0,20,17
1746536093177,BIEB 150,A03,894937,Wills; Christopher,3,0,20,17
1746536093177,BIEB 150,A04,894946,Wills; Christopher,5,0,20,15
1746536094206,BIEB 194,A00,906141,Kurle; Carolyn M.,6,0,20,14
1746536095269,BILD 1,A01,894154,Staff,2,0,19,17
1746536095269,BILD 1,A02,894155,Staff,14,0,19,5
1746536095269,BILD 1,A03,894160,Staff,13,0,19,6
1746536095269,BILD 1,A04,894161,Staff,15,0,18,3
1746536096295,BILD 2,A01,894168,Staff,0,0,50,50
1746536096295,BILD 2,A02,894169,Staff,0,0,50,50
1746536096295,BILD 2,A03,894179,Staff,4,0,50,46
1746536096295,BILD 2,A04,894203,Staff,27,0,50,23
1746536097325,BILD 3,A01,894213,Staff,22,0,31,9
1746536097325,BILD 3,A02,894214,Staff,26,0,31,5
1746536097325,BILD 3,A03,894235,Staff,28,0,31,3
1746536097325,BILD 3,A04,894236,Staff,28,0,32,4
1746536098354,BILD 4,A01,894253,Reuther; Keefe,5,0,24,19
1746536098354,BILD 4,A02,894258,Reuther; Keefe,16,0,24,8
1746536099378,BILD 5,A01,894276,Reuther; Keefe,35,0,50,15
1746536099378,BILD 5,A02,894277,Reuther; Keefe,45,0,50,5
1746536099378,BILD 5,A03,894290,Reuther; Keefe,44,0,50,6
1746536099378,BILD 5,A04,894291,Reuther; Keefe,48,0,50,2
1746536100450,BILD 24,A01,894297,Pirino; Giorgia,40,0,60,20
1746536101476,BIMM 100,B01,958915,Staff,72,0,100,28
1746536102507,BIMM 101,A01,895017,McDonnell; Lisa Marie,0,5,24,24
1746536102507,BIMM 101,A02,895018,McDonnell; Lisa Marie,0,5,24,24
1746536102507,BIMM 101,B01,895020,McDonnell; Lisa Marie,0,6,24,24
1746536102507,BIMM 101,B02,895021,McDonnell; Lisa Marie,0,4,24,24
1746536103535,BIMM 110,A01,895023,Staff,1,0,25,24
1746536103535,BIMM 110,A02,895024,Staff,9,0,25,16
1746536103535,BIMM 110,A03,895025,Staff,18,0,25,7
1746536103535,BIMM 110,A04,895031,Staff,20,0,25,5
1746536104567,BIMM 120,A01,895114,Gustafson-Brown; Cindy,13,0,28,15
1746536104567,BIMM 120,A02,895126,Gustafson-Brown; Cindy,21,0,27,6
1746536105593,BIPN 100,A01,895130,Yang; Mingyu,1,0,38,37
1746536105593,BIPN 100,A02,895131,Yang; Mingyu,32,0,38,6
1746536105593,BIPN 100,A03,895132,Yang; Mingyu,32,0,38,6
1746536105593,BIPN 100,A04,895133,Yang; Mingyu,27,0,36,9
1746536106622,BIPN 120,A01,895135,Cooke; James Edward,0,3,13,13
1746536106622,BIPN 120,A02,895136,Cooke; James Edward,0,1,13,13
1746536106622,BIPN 120,A03,895137,Cooke; James Edward,0,3,13,13
1746536106622,BIPN 120,A04,895156,Cooke; James Edward,0,2,11,11
1746536107652,BIPN 134,A01,895235,Cooke; James Edward,0,2,25,25
1746536107652,BIPN 134,A02,895237,Cooke; James Edward,0,0,25,25
1746536107652,BIPN 134,A03,895240,Cooke; James Edward,3,0,25,22
1746536107652,BIPN 134,A04,895270,Cooke; James Edward,20,0,25,5
1746536108681,BIPN 189,A00,892103,Staff,0,13,14,14
1746536110733,BISP 194,A00,958008,Staff,0,2,0,0
1746536111758,CAT 124,A01,922009,Staff,0,5,20,20
1746536112791,CAT 125R,A00,886390,Morales; Celeste Georgianna,0,2,20,20
1746536112791,CAT 125R,B00,886391,Irwin; Matthew Joseph,0,3,20,20
1746536112791,CAT 125R,C00,886392,Smith; Lauryn Alissa,0,2,20,20
1746536112791,CAT 125R,D00,886393,Vanderschuit; Maya Alysia,0,2,20,20
1746536112791,CAT 125R,E00,886394,Marchisotto; Jennifer Anne,0,4,20,20
1746536113825,CENG 15,A01,886218,Drews; Aaron,3,0,8,5
1746536114853,CENG 113,A00,886219,Opatkiewicz; Justin Paul,15,0,25,10
1746536115880,CGS 101,A00,887044,Staff,7,0,20,13
1746536116908,CGS 105,A01,887046,Staff,14,0,25,11
1746536117937,CGS 112,A00,887047,Cuong; Marisol,12,0,15,3
1746536118963,CGS 113,A00,887048,Staff,23,0,30,7
1746536119993,CGS 120,A00,887049,Staff,10,0,17,7
1746536121020,CHEM 6A,A01,886336,Lam; Tin Yiu,38,0,50,12
1746536121020,CHEM 6A,A02,886338,Lam; Tin Yiu,37,0,50,13
1746536122049,CHEM 6B,A01,886341,Hopkins; Patrycja Anna,16,0,50,34
1746536122049,CHEM 6B,A02,886343,Hopkins; Patrycja Anna,42,0,50,8
1746536123077,CHEM 6C,A01,886346,Albizati; Kim F.,0,2,50,50
1746536123077,CHEM 6C,A02,886348,Albizati; Kim F.,23,0,50,27
1746536124110,CHEM 40A,A01,886352,Klosterman; Jeremy K,65,0,100,35
1746536125138,CHEM 40B,A01,886356,Klosterman; Jeremy K,0,23,100,100
1746536126165,CHEM 41B,A01,886360,Theodorakis; Emmanuel,25,0,50,25
1746536126165,CHEM 41B,A02,886362,Theodorakis; Emmanuel,47,0,50,3
1746536127191,CHIN 165A,A00,886382,Xu; Li,18,0,20,2
1746536128217,CLAS 120,A00,886387,Myerston Santana; Jacobo,33,0,40,7
1746536129242,COGS 9,A01,886967,Shannon; Kyle Michael,42,0,60,18
1746536130271,COGS 11,A01,886969,Staff,11,0,30,19
1746536131298,COGS 14A,A01,886971,Staff,6,0,60,54
1746536132327,COGS 14B,A01,886973,Hoffman; Drew Ellen,4,0,60,56
1746536133353,COGS 18,A01,886975,Morgan; Eric,35,0,60,25
1746536134378,COGS 20,A01,886977,Staff,4,0,8,4
1746536134378,COGS 20,A02,886978,Staff,5,0,7,2
1746536135405,COGS 100,A01,907783,Staff,0,2,30,30
1746536136436,COGS 101B,A01,886980,Staff,0,3,48,48
1746536137463,COGS 101C,A01,886982,Delgado; Tania,0,5,44,44
1746536138493,COGS 102A,A01,886984,Johnson; Christine M.,4,0,30,26
1746536139522,COGS 118B,A01,886986,Staff,0,3,88,88
1746536140554,COGS 150,A01,886988,Bergen; Benjamin,23,0,50,27
1746536141582,COGS 153,A00,886989,Delgado; Tania,0,2,41,41
1746536142607,COGS 186,A01,886991,Staff,0,0,32,32
1746536143637,COGS 187A,A01,886993,Boyle; Mary E. T.,7,0,30,23
1746536144663,COGS 189,A00,886994,Staff,0,1,30,30
1746536145693,COMM 10,A01,886996,Staff,0,0,20,21
1746536145693,COMM 10,A02,886997,Staff,12,0,20,8
1746536145693,COMM 10,A03,959845,Staff,19,0,20,1
1746536146721,COMM 20,A01,886999,Leuning; Grant Maurstad,24,0,40,16
1746536148772,COMM 100A,A01,887002,Staff,0,0,20,25
1746536148772,COMM 100A,A02,887003,Staff,7,0,20,13
1746536149798,COMM 100B,A01,887005,Staff,0,8,20,24
1746536150824,COMM 106D,A00,887006,Staff,14,0,40,26
1746536151857,COMM 110G,A00,887007,Whitworth-Smith; Andrew C,12,0,40,28
1746536152885,COMM 111B,A00,887008,Staff,31,0,40,9
1746536153917,COMM 113T,A00,887009,Abuelhiga; Soraya Jill,28,0,40,12
1746536153917,COMM 113T,B00,906733,Staff,40,0,40,0
1746536154943,COMM 145,A00,887010,Staff,12,0,40,28
1746536155973,COMM 146,A00,887054,Staff,31,0,40,9
1746536157004,COMM 190,A00,887012,Staff,8,0,23,15
1746536158036,CSE 8A,A50,887015,Cao; Yingjun,57,0,85,28
1746536159064,CSE 11,A01,887017,Cao; Yingjun,12,0,70,58
1746536160140,CSE 20,A01,887019,Staff,30,0,50,20
1746536161168,CSE 21,A01,887021,Staff,78,0,100,22
1746536161168,CSE 21,B01,892583,Braun; Oliver,45,0,50,5
1746536162197,CSE 30,A01,887025,Eldon; John,143,0,200,57
1746536163229,CSE 100,A01,887027,Staff,26,0,50,24
1746536163229,CSE 100,A02,887028,Staff,40,0,50,10
1746536164264,CSE 101,A01,887030,Braun; Oliver,75,0,100,25
1746536164264,CSE 101,B01,887032,Jones; Miles E,0,3,50,50
1746536164264,CSE 101,B02,887033,Jones; Miles E,0,1,50,50
1746536165291,CSE 105,A01,908084,Jones; Miles E,32,0,50,18
1746536165291,CSE 105,A02,908087,Jones; Miles E,33,0,50,17
1746536166323,CSE 135,A01,887035,Powell; Thomas Allan,0,4,50,50
1746536167353,CSE 142,A01,887037,Staff,8,0,60,52
1746536168379,CSE 142L,A01,887039,Staff,34,0,60,26
1746536169405,CSE 151A,A01,887041,Solares; Edwin A,48,0,100,52
1746536170433,CSE 175,A01,887043,Kumar; Rakesh,30,0,30,0
1746536171461,CSS 1,A01,886389,Staff,0,1,40,40
1746536172488,DSC 30,A01,908097,Liao; Soohyun Nam,47,0,75,28
1746536173518,DSC 40A,A01,908099,Shannon; Kyle Michael,30,0,50,20
1746536174548,DSC 40B,A01,908112,Staff,16,0,50,34
1746536175576,DSC 80,A01,908116,Staff,19,0,60,41
1746536176606,DSC 197,001,956863,Eldridge; Justin Matthew,9999,0,9999,0
1746536177638,ECE 5,A01,886400,Morris; Karcher William,2,0,6,4
1746536177638,ECE 5,A02,886401,Morris; Karcher William,3,0,6,3
1746536178665,ECE 148,A01,886403,Silberman; Jack,0,14,14,14
1746536179691,ECON 1,A01,887265,Crane; Meredith Helen,12,0,70,58
1746536179691,ECON 1,B01,887268,Staff,43,0,50,7
1746536180717,ECON 2,A01,887273,Crane; Meredith Helen,56,0,70,14
1746536181744,ECON 3,A01,887279,Rondina; Giacomo,32,0,70,38
1746536182772,ECON 4,A01,887282,Anderson; John Charles,0,2,10,10
1746536183804,ECON 5,A01,887285,Staff,33,0,45,12
1746536183804,ECON 5,B01,887292,Staff,41,0,45,4
1746536184839,ECON 100A,A01,887337,Newhouse; Herbert S,54,0,70,16
1746536184839,ECON 100A,B01,887349,Staff,45,0,50,5
1746536185865,ECON 100B,A01,887361,Du; Songzi,29,0,70,41
1746536186898,ECON 100C,A01,887445,Newhouse; Herbert S,59,0,70,11
1746536187922,ECON 105,A00,887488,Vespa; Emanuel Ignacio,23,0,35,12
1746536188950,ECON 109,A01,887506,Shishkin; Denis,28,0,35,7
1746536189979,ECON 110A,A01,887568,Alon; Titan Michael,0,3,35,35
1746536189979,ECON 110A,B01,907601,Alon; Titan Michael,20,0,35,15
1746536191006,ECON 110B,A01,887598,Levkoff; Steven B.,0,23,70,70
1746536192032,ECON 112,A00,887599,Rondina; Giacomo,19,0,35,16
1746536193062,ECON 120A,A01,887603,Dai; Yinlin,36,0,70,34
1746536194104,ECON 120C,A01,887608,Sun; Yixiao,0,1,35,35
1746536194104,ECON 120C,B01,887614,Sun; Yixiao,0,0,35,35
1746536195129,ECON 138,A00,887621,Bharadwaj; Prashant,0,20,20,20
1746536196154,ECON 144,A00,958007,Squires; Dale E,13,0,35,22
1746536197188,ECON 171,A01,907666,Staff,18,0,35,17
1746536198215,ECON 175,A00,887626,Wu; Pak Yeung,23,0,35,12
1746536199240,ECON 190,A00,887640,Vespa; Emanuel Ignacio,23,0,35,12
1746536200284,EDS 25,A01,888197,Staff,0,0,0,0
1746536200284,EDS 25,A02,888209,Staff,0,0,0,0
1746536200284,EDS 25,A03,888210,Staff,0,0,0,0
1746536200284,EDS 25,A04,888212,Staff,0,0,0,0
1746536200284,EDS 25,A05,888213,Staff,0,0,0,0
1746536200284,EDS 25,A06,888214,Staff,0,0,0,0
1746536200284,EDS 25,A07,888235,Staff,0,2,0,0
1746536200284,EDS 25,A08,888236,Staff,0,0,0,0
1746536200284,EDS 25,A09,888240,Staff,0,0,0,0
1746536200284,EDS 25,A10,888244,Staff,0,0,0,0
1746536200284,EDS 25,B01,888273,Staff,0,0,0,0
1746536200284,EDS 25,B02,888285,Staff,0,0,0,0
1746536200284,EDS 25,B03,888423,Staff,0,0,0,1
1746536200284,EDS 25,B04,888432,Staff,0,0,0,0
1746536200284,EDS 25,B05,888433,Staff,0,0,0,0
1746536200284,EDS 25,B06,888467,Staff,0,0,0,0
1746536200284,EDS 25,B07,888468,Staff,0,0,0,0
1746536200284,EDS 25,B08,888479,Staff,0,0,0,0
1746536200284,EDS 25,B09,888484,Staff,0,0,0,0
1746536200284,EDS 25,B10,888487,Staff,0,0,0,0
1746536201311,EDS 38,A01,907700,Choi; Bailey Miyeon,30,0,30,0
1746536202338,EDS 112,A01,888601,Chapman; Thandeka K,14,0,40,26
1746536203366,EDS 115,A00,888697,Mendez; Kathrina Mendoza,10,0,30,20
1746536204431,EDS 116,A01,888893,Staff,35,0,40,5
1746536206488,EDS 124AR,A00,889133,Staff,29,0,50,21
1746536206488,EDS 124AR,B00,907471,Simon; Elizabeth A,37,0,50,13
1746536207513,EDS 124BR,A00,889134,Simon; Elizabeth A,45,0,100,55
1746536208537,EDS 125,A00,889135,Staff,25,0,30,5
1746536209564,EDS 126,A01,889138,Staff,36,0,40,4
1746536210592,EDS 164R,A01,889142,Wishard Guerra; Alison G.,33,0,50,17
1746536211620,ENG 30,A01,886396,Staff,0,0,0,0
1746536211620,ENG 30,B01,886398,Staff,0,0,0,0
1746536212645,ENVR 102,A00,906150,Montejo; Carolina,23,0,25,2
1746536213675,ETHN 103A,A00,887236,Man; Simeon S,0,3,0,0
1746536214707,ETHN 113,A00,887239,Staff,16,0,30,14
1746536215732,ETHN 116,A00,887240,Staff,16,0,25,9
1746536216763,ETHN 117,A00,887241,Choi; Esther Min,28,0,30,2
1746536217791,ETHN 118,A00,887243,Staff,24,0,30,6
1746536218815,ETHN 127,A00,887248,Cuong; Marisol,11,0,15,4
1746536219841,ETHN 139,A00,887250,Staff,7,0,10,3
1746536220869,ETHN 142,A00,887252,Staff,10,0,30,20
1746536221894,ETHN 161,A00,887253,Browne; Errol Tsekani,24,0,30,6
1746536222924,ETHN 163FR,A00,887255,Burelle; Julie Sara Veronique,0,0,5,5
1746536223952,GLBH 20,A00,889149,Elwardani; Nile Regina,8,0,42,34
1746536226009,GLBH 111,A01,889152,Burgos; Jose L.,17,0,17,0
1746536227036,GLBH 150,A00,889181,Sloane; Julia Kathryn,0,5,15,15
1746536229096,HDS 60,A01,886406,Warstadt; Melissa Fawn,73,0,80,7
1746536230123,HIAF 111,A00,889324,Gyamfi; Bright,25,0,32,7
1746536231148,HIEA 131,A00,889328,Staff,16,0,32,16
1746536232175,HIEA 144,A00,889333,Henry; Todd A.,26,0,32,6
1746536233201,HIEA 154,A00,889336,Henry; Todd A.,24,0,32,8
1746536234228,HIEU 106,A00,889339,Staff,22,0,32,10
1746536236283,HIEU 114,A00,889340,Staff,3,0,32,29
1746536237308,HIEU 135GS,A00,889342,Patterson; Patrick H.,0,0,1,24
1746536238336,HIEU 137,A00,889343,Edington; Claire Ellen,9,0,25,16
1746536239365,HIEU 148,A00,889345,Staff,14,0,32,18
1746536240391,HIEU 154,A00,889346,Biess; Frank Peter,21,0,32,11
1746536241419,HILA 102,A00,889351,Staff,12,0,32,20
1746536242446,HILD 2A,A01,889221,Lewandoski; Julia Mavis,1,10,32,31
1746536243471,HILD 7B,A01,889225,Man; Simeon S,0,13,32,32
1746536244499,HILD 7C,A01,889288,Alvarez; Luis A,0,14,32,32
1746536245528,HILD 30,A01,889323,Staff,0,5,32,32
1746536247587,HISC 119,A00,889383,Golan; Tal,21,0,32,11
1746536248614,HIUS 103,A00,889384,Man; Simeon S,0,0,32,32
1746536249642,HIUS 117,A00,919797,Kwak; Nancy,18,0,32,14
1746536250670,HIUS 142A,A00,919788,Staff,22,0,32,10
1746536252728,HIUS 149,A00,889386,Gyamfi; Bright,27,0,32,5
1746536253756,HIUS 155,A00,889387,Alvarez; Luis A,14,0,32,18
1746536254787,HUM 3,A01,886499,Caldwell; Michael Alan,19,0,50,31
1746536255812,HUM 3GS,A00,886500,Rodriguez; Bretton Sigfred,0,0,0,28
1746536256840,HUM 3R,A01,886502,Markman; Kristina,0,36,50,50
1746536257868,HUM 4,A01,886504,Crum; Matthew Stephen,24,0,50,26
1746536257868,HUM 4,B01,886506,West; Geoffrey Scott,17,0,50,33
1746536258894,HUM 4GS,A00,886507,Staff,0,0,0,19
1746536259924,HUM 5,A01,886509,Staff,32,0,50,18
1746536260950,HUM 5R,A01,886511,Zavodny; Tatiana Sophia,0,39,50,50
1746536261976,JAPN 180,A00,886407,Staff,18,0,40,22
1746536263007,LATI 50,A01,886409,Martin-Cabrera; Luis,4,0,22,18
1746536263007,LATI 50,A02,886410,Martin-Cabrera; Luis,19,0,22,3
1746536263007,LATI 50,A03,886411,Martin-Cabrera; Luis,21,0,22,1
1746536263007,LATI 50,A04,886412,Martin-Cabrera; Luis,9,0,22,13
1746536264036,LAWS 101,A00,907664,Staff,28,0,60,32
1746536265067,LIAB 1A,A00,889388,Saab; Dima,17,0,20,3
1746536266095,LIAB 1AX,A00,889389,El Cheddadi; Youniss,17,0,20,3
1746536267122,LIFR 1C,A00,889391,Van Moer; Vinciane G,8,0,20,12
1746536268147,LIFR 1CX,A00,889392,Van Moer; Vinciane G,7,0,20,13
1746536269173,LIFR 1D,A00,889393,Van Moer; Vinciane G,7,0,20,13
1746536270200,LIFR 1DX,A00,889394,Van Moer; Vinciane G,8,0,20,12
1746536271231,LIGN 7,A00,886923,Staff,24,0,50,26
1746536272258,LIGN 17,A00,886924,Kehler; Andrew Scott,125,0,150,25
1746536273286,LTAM 110,A00,889395,Staff,15,0,30,15
1746536274311,LTAM 110GS,A00,958010,Rodriguez; Bretton Sigfred,0,0,0,28
1746536275383,LTCH 101,A00,889397,Staff,23,0,25,2
1746536276411,LTCS 130,A00,889398,Staff,23,0,25,2
1746536277442,LTEA 138,A00,889399,Staff,24,0,40,16
1746536278473,LTEN 149,A00,889400,Wesling; Megan E.,0,3,25,25
1746536279501,LTEN 169,A00,889401,Staff,20,0,25,5
1746536280528,LTEN 180,A00,889402,Staff,10,0,15,5
1746536281555,LTEN 181,A00,889403,Staff,21,0,25,4
1746536282585,LTWL 100,A00,889404,Myerston Santana; Jacobo,3,0,25,22
1746536283615,LTWL 180GS,A00,889405,Staff,0,0,20,20
1746536284643,LTWL 181,A00,889406,Staff,17,0,25,8
1746536285673,LTWL 184,A00,889475,Mukherjee; Silpa,22,0,25,3
1746536286701,LTWR 102C,A00,889486,Staff,29,0,30,1
1746536287728,LTWR 115W,A00,889491,Staff,0,2,15,15
1746536288753,MAE 8,A01,886905,Staff,0,2,0,0
1746536289781,MAE 11,A00,886906,Bandaru; Prabhakar,0,7,50,50
1746536290813,MAE 20,A00,886907,Evdokimenko; Ekaterina,44,0,70,26
1746536291840,MAE 30B,A00,886909,Ghazinejad; Maziar,26,0,45,19
1746536292866,MAE 101B,A00,886910,Saintillan; David,29,0,45,16
1746536293895,MAE 105,A00,886911,Bandaru; Prabhakar,18,0,50,32
1746536294930,MAE 107,B00,958024,Staff,9,0,50,41
1746536295957,MAE 143B,A00,886913,Bewley; Thomas R,7,0,40,33
1746536296986,MAE 148,A01,886915,Silberman; Jack,0,3,14,14
1746536298016,MAE 160,A00,886916,Evdokimenko; Ekaterina,31,0,60,29
1746536299049,MATH 3C,A01,889681,Staff,0,3,30,30
1746536299049,MATH 3C,A02,960048,Staff,25,0,30,5
1746536300077,MATH 10A,A01,889760,Staff,26,0,30,4
1746536300077,MATH 10A,A02,889783,Staff,29,0,30,1
1746536301105,MATH 10B,A01,889785,Verstraete; Jacques Allan,2,0,35,33
1746536301105,MATH 10B,A02,889795,Verstraete; Jacques Allan,4,0,35,31
1746536301105,MATH 10B,B01,889797,Verstraete; Jacques Allan,3,0,35,32
1746536301105,MATH 10B,B02,889828,Verstraete; Jacques Allan,3,0,35,32
1746536302141,MATH 10C,A01,889849,Habib; Yousaf,9,0,30,21
1746536302141,MATH 10C,A02,889852,Habib; Yousaf,14,0,30,16
1746536302141,MATH 10C,A03,889853,Habib; Yousaf,22,0,30,8
1746536302141,MATH 10C,A04,889858,Habib; Yousaf,20,0,30,10
1746536302141,MATH 10C,B01,889861,Staff,1,0,30,29
1746536302141,MATH 10C,B02,889862,Staff,24,0,30,6
1746536302141,MATH 10C,B03,889863,Staff,27,0,30,3
1746536302141,MATH 10C,B04,889967,Staff,23,0,30,7
1746536303172,MATH 18,A01,889974,Staff,7,0,30,23
1746536303172,MATH 18,A02,889977,Staff,20,0,30,10
1746536303172,MATH 18,B01,889984,Hardiman; Liam,22,0,30,8
1746536303172,MATH 18,B02,889985,Hardiman; Liam,25,0,30,5
1746536304202,MATH 20A,A01,889990,Suk; Andrew Hoon,29,0,35,6
1746536305231,MATH 20B,A01,889993,Ohm; Ko Woon,22,0,30,8
1746536305231,MATH 20B,A02,889994,Ohm; Ko Woon,30,0,30,0
1746536305231,MATH 20B,B01,889996,Ohm; Ko Woon,21,0,30,9
1746536305231,MATH 20B,B02,889997,Ohm; Ko Woon,23,0,30,7
1746536306261,MATH 20C,A01,889999,Hammock; Frances H,17,0,30,13
1746536306261,MATH 20C,A02,890003,Hammock; Frances H,23,0,30,7
1746536306261,MATH 20C,B01,890006,Hammock; Frances H,3,0,30,27
1746536306261,MATH 20C,B02,890007,Hammock; Frances H,11,0,30,19
1746536307295,MATH 20D,A01,890011,Cheng; Hsiao-Bing,1,1,30,29
1746536307295,MATH 20D,A02,890012,Cheng; Hsiao-Bing,14,0,30,16
1746536307295,MATH 20D,B01,890016,Cheng; Hsiao-Bing,13,0,30,17
1746536307295,MATH 20D,B02,890017,Cheng; Hsiao-Bing,13,0,30,17
1746536308373,MATH 20E,A01,890026,Harel; Guershon,1,0,30,29
1746536308373,MATH 20E,A02,890029,Harel; Guershon,23,0,30,7
1746536308373,MATH 20E,B01,890033,Harel; Guershon,7,0,30,23
1746536308373,MATH 20E,B02,890101,Harel; Guershon,21,0,30,9
1746536309401,MATH 102,A01,890104,Staff,17,0,30,13
1746536309401,MATH 102,A02,890105,Staff,27,0,30,3
1746536310432,MATH 103B,A01,890116,Salehi Golsefidy; Alireza,3,0,30,27
1746536310432,MATH 103B,B01,890118,Staff,0,3,34,34
1746536311464,MATH 109,A01,890121,Aliabadi Sr.; Mohsen,1,0,30,29
1746536311464,MATH 109,B01,890124,Upadrashta; Pranav Kumar,18,0,30,12
1746536312490,MATH 120A,A01,890126,Eggers; John Dietrich,13,0,30,17
1746536313517,MATH 142B,A01,890128,Ioana; Adrian,19,0,30,11
1746536313517,MATH 142B,A02,890129,Ioana; Adrian,13,0,30,17
1746536314544,MATH 154,A01,890174,Staff,0,0,30,30
1746536314544,MATH 154,A02,890182,Staff,0,0,30,30
1746536315578,MATH 168A,A01,890197,Dumitriu; Ioana,21,0,35,14
1746536316604,MATH 170A,A01,890240,Nie; Jiawang,1,0,30,29
1746536316604,MATH 170A,A02,890241,Nie; Jiawang,11,0,30,19
1746536316604,MATH 170A,A03,890249,Nie; Jiawang,23,0,30,7
1746536317635,MATH 170B,A01,957891,Nag; Panchali,13,0,35,22
1746536319695,MATH 181A,A01,908025,Staff,0,4,35,35
1746536319695,MATH 181A,A02,960115,Staff,27,0,35,8
1746536320722,MATH 181B,A01,959874,Staff,26,0,30,4
1746536321751,MATH 193B,A01,890265,Staff,0,4,35,35
1746536322778,MGT 4,A01,890311,Anderson; John Charles,42,0,88,46
1746536323804,MGT 5,A00,907740,Staff,13,0,98,85
1746536324831,MGT 12,A00,890312,Lindenberger; Wade Douglas,67,0,98,31
1746536325860,MGT 16,A00,957883,Staff,78,0,98,20
1746536327919,MGT 45,A00,890314,Pecore; Joseph P.,47,0,98,51
1746536328949,MGT 71,A00,890315,Staff,0,11,98,98
1746536329987,MGT 100,A00,890316,Yavorsky; Daniel Ryan,44,0,98,54
1746536331013,MGT 103,A00,890317,Ehrich; Kristine R,73,0,98,25
1746536332043,MGT 105,A00,890356,Bates; Kenneth Walter,0,7,98,98
1746536333073,MGT 112,A00,890360,Ehrich; Kristine R,55,0,98,43
1746536334109,MGT 127R,A00,907732,Zhu; Kevin Xiaoguo,23,0,98,75
1746536335139,MGT 131B,A00,890361,Anderson; John Charles,61,0,98,37
1746536336170,MGT 137,A00,890362,Lindenberger; Wade Douglas,65,0,98,33
1746536337201,MGT 160,A00,890369,Johnson; Erik Barry,9,0,98,89
1746536339255,MGT 164,A00,890372,Zimmermann; Carsten,0,39,98,98
1746536340280,MGT 180,A00,890374,Bliss; Barbara Ann,12,0,98,86
1746536341310,MMW 15,A01,886414,Chang; Edmond Yi-Teh,0,12,28,28
1746536341310,MMW 15,A02,886415,Chang; Edmond Yi-Teh,0,8,28,28
1746536341310,MMW 15,A03,886416,Chang; Edmond Yi-Teh,0,8,28,28
1746536341310,MMW 15,A04,886417,Chang; Edmond Yi-Teh,0,8,28,28
1746536341310,MMW 15,B01,886419,Chang; Edmond Yi-Teh,0,7,28,28
1746536341310,MMW 15,B02,886420,Chang; Edmond Yi-Teh,0,8,28,28
1746536341310,MMW 15,B03,886421,Chang; Edmond Yi-Teh,0,7,28,28
1746536341310,MMW 15,B04,886422,Chang; Edmond Yi-Teh,0,8,28,28
1746536341310,MMW 15,C01,886424,Staff,0,9,28,28
1746536341310,MMW 15,C02,886425,Staff,0,8,28,28
1746536341310,MMW 15,C03,886426,Staff,0,8,28,28
1746536341310,MMW 15,C04,886427,Staff,0,7,28,28
1746536341310,MMW 15,C05,958038,Staff,0,7,28,28
1746536341310,MMW 15,C06,958039,Staff,0,8,28,28
1746536342341,MMW 15GS,A00,906910,Patterson; Patrick H.,4,0,28,24
1746536343368,MMW 122R,A01,886429,Rahimi; Babak,0,13,28,28
1746536343368,MMW 122R,A02,886430,Rahimi; Babak,0,12,28,28
1746536343368,MMW 122R,A03,958040,Rahimi; Babak,0,11,28,28
1746536344403,MUS 1A,A01,890937,Staff,3,0,25,22
1746536344403,MUS 1A,A02,891035,Staff,6,0,25,19
1746536344403,MUS 1A,C01,958912,Staff,24,0,25,1
1746536344403,MUS 1A,C02,958913,Staff,25,0,25,0
1746536346457,MUS 2AK,A00,957092,Ohnishi; Takae,15,0,15,0
1746536347487,MUS 4,A01,891044,Staff,2,0,25,23
1746536347487,MUS 4,A02,891045,Staff,23,0,25,2
1746536347487,MUS 4,B01,891048,Staff,17,0,25,8
1746536347487,MUS 4,B02,891050,Staff,25,0,25,0
1746536348518,MUS 5,A01,957506,Dubnov; Shlomo,0,0,25,25
1746536348518,MUS 5,A02,957622,Dubnov; Shlomo,14,0,25,11
1746536348518,MUS 5,A03,957623,Dubnov; Shlomo,20,0,25,5
1746536349548,MUS 6,A01,891053,Freitas Caetano; Marcelo,24,0,25,1
1746536349548,MUS 6,A02,891054,Freitas Caetano; Marcelo,23,0,25,2
1746536350575,MUS 7,A01,891081,Staff,0,0,25,25
1746536350575,MUS 7,A02,891082,Staff,4,0,25,21
1746536351602,MUS 8GS,A00,891118,Borgo; David Garcia,0,0,25,25
1746536352633,MUS 11,A01,891140,Staff,11,0,25,14
1746536352633,MUS 11,A02,891141,Staff,22,0,25,3
1746536353660,MUS 13,A01,891143,Staff,8,0,25,17
1746536353660,MUS 13,A02,891144,Staff,24,0,25,1
1746536354688,MUS 15,A01,891146,Staff,9,0,25,16
1746536354688,MUS 15,A02,891148,Staff,21,0,25,4
1746536354688,MUS 15,B01,891150,Staff,18,0,25,7
1746536354688,MUS 15,B02,891151,Staff,25,0,25,0
1746536355719,MUS 20,A01,891153,Staff,5,0,20,15
1746536355719,MUS 20,A02,891155,Staff,14,0,20,6
1746536356748,MUS 80,A00,891156,Staff,19,0,25,6
1746536356748,MUS 80,B00,891157,Staff,23,0,25,2
1746536357775,MUS 130,A00,891158,Ohnishi; Takae,35,0,35,0
1746536358801,MUS 150GS,A01,891160,Borgo; David Garcia,0,0,25,25
1746536359827,MUS 170,A01,891162,Freitas Caetano; Marcelo,20,0,25,5
1746536359827,MUS 170,A02,891164,Freitas Caetano; Marcelo,21,0,25,4
1746536360860,NANO 11,A00,886220,Vazquez Mena; Oscar,13,0,15,2
1746536361889,NANO 15,A01,886222,Drews; Aaron,4,0,7,3
1746536362915,NANO 104,A00,886224,Sirbuly; Donald,18,0,25,7
1746536363942,PH 40,A00,886528,Staff,23,0,40,17
1746536364968,PH 45,A01,886799,Staff,35,0,40,5
1746536365995,PH 110,A00,886802,Staff,0,7,40,40
1746536367027,PH 172,A00,906716,Staff,19,0,35,16
1746536368056,PH 191,A00,886803,Staff,6,0,40,34
1746536369087,PHIL 1,A00,889500,Staff,19,0,30,11
1746536370117,PHIL 10,A01,889549,Grush; Rick Scott,15,0,22,7
1746536370117,PHIL 10,A02,889551,Grush; Rick Scott,22,0,22,0
1746536371150,PHIL 28,A01,889559,Lamey; Andy M.,0,1,31,31
1746536371150,PHIL 28,A02,889561,Lamey; Andy M.,0,1,30,30
1746536371150,PHIL 28,A03,889572,Lamey; Andy M.,0,0,30,30
1746536372177,PHIL 35,A00,907839,Staff,13,0,15,2
1746536373201,PHIL 60,A00,889574,Staff,74,0,90,16
1746536374232,PHIL 101,A00,958004,Staff,13,0,15,2
1746536376288,PHIL 136,A00,889582,Fulkerson; Matthew Todd,26,0,45,19
1746536377314,PHIL 163,A01,889601,Staff,21,0,30,9
1746536377314,PHIL 163,B01,889606,Brandt; Reuven A,0,3,0,0
1746536378339,PHIL 164,A00,889610,Staff,16,0,30,14
1746536379366,PHIL 165,A00,889613,Staff,23,0,30,7
1746536380391,PHYS 1A,A00,886431,Staff,26,0,70,44
1746536381420,PHYS 1AL,001,886432,Tsai; Philbert S,0,2,30,30
1746536381420,PHYS 1AL,002,886436,Tsai; Philbert S,11,0,30,19
1746536382449,PHYS 1B,A00,886439,Staff,185,0,240,55
1746536383479,PHYS 1BL,001,886441,Tsai; Philbert S,0,4,30,30
1746536383479,PHYS 1BL,002,886444,Tsai; Philbert S,2,0,30,28
1746536384509,PHYS 1C,A00,896092,Arnold; Kam S,78,0,146,68
1746536385543,PHYS 1CL,001,886448,Tsai; Philbert S,0,0,30,30
1746536385543,PHYS 1CL,002,886449,Tsai; Philbert S,0,0,30,30
1746536385543,PHYS 1CL,003,886450,Tsai; Philbert S,15,0,30,15
1746536385543,PHYS 1CL,004,886451,Tsai; Philbert S,15,0,30,15
1746536386576,PHYS 2B,A01,886457,Staff,69,0,115,46
1746536387603,PHYS 2C,A01,886460,Shotwell; Brian,0,8,65,65
1746536388632,PHYS 2CL,A01,886467,Staff,0,4,28,28
1746536388632,PHYS 2CL,A02,886468,Staff,0,3,28,28
1746536389659,PHYS 2D,A01,886470,Staff,10,0,50,40
1746536390687,PHYS 4B,A01,886475,Grinstein; Benjamin,22,0,40,18
1746536391720,POLI 5,A00,891173,Desposato; Scott,7,0,25,18
1746536392749,POLI 5D,A01,891175,Staff,5,0,5,0
1746536392749,POLI 5D,B01,891178,Staff,5,0,5,0
1746536393781,POLI 11,A00,891179,Ferree; Karen E,2,0,35,33
1746536394806,POLI 12,A00,891180,Staff,16,0,30,14
1746536395837,POLI 27,A01,891182,Staff,12,0,75,63
1746536396866,POLI 30,A00,891183,Staff,9,0,50,41
1746536397895,POLI 100B,A00,891244,Staff,5,1,35,30
1746536398924,POLI 100I,A00,891247,Staff,7,0,30,23
1746536399955,POLI 104J,A00,891248,Nichter; Maysa,14,0,30,16
1746536400983,POLI 104U,A00,891250,Nichter; Maysa,2,0,30,28
1746536403041,POLI 110B,A00,891255,Wiens; David,20,0,25,5
1746536404067,POLI 112A,A00,891256,Wiens; David,6,0,25,19
1746536405097,POLI 114BR,A00,891261,Staff,19,0,30,11
1746536406122,POLI 117R,A00,891262,Forman; Fonna,0,6,50,50
1746536407154,POLI 118,A00,891264,Ingham; Sean,17,0,25,8
1746536408180,POLI 124A,A00,891265,Staff,18,0,20,2
1746536409206,POLI 125D,A00,891266,Nichter; Simeon C,2,0,25,23
1746536410232,POLI 126,A00,891268,Nichter; Simeon C,7,0,25,18
1746536411463,POLI 126AA,A00,891272,Staff,18,0,25,7
1746536412492,POLI 130AA,A00,891273,Staff,15,0,20,5
1746536413517,POLI 134AA,A00,891274,Staff,4,0,20,16
1746536415572,POLI 138,A00,891278,Staff,21,0,25,4
1746536416600,POLI 142K,A00,891280,Staff,11,0,25,14
1746536417627,POLI 142M,A00,891281,Gartzke; Erik,17,0,30,13
1746536418654,POLI 142P,A00,891284,Staff,20,0,30,10
1746536419681,POLI 143,A00,891285,Gartzke; Erik,12,0,30,18
1746536420708,POLI 153,A00,891286,Staff,19,0,20,1
1746536422764,POLI 175,A00,891290,Staff,15,0,20,5
1746536423800,PSYC 1,A00,890674,Steiner; Eric Tomas,0,11,45,45
1746536424829,PSYC 2,A00,890676,Albright; Thomas D,21,0,35,14
1746536425861,PSYC 3,A00,890679,Staff,17,0,20,3
1746536426888,PSYC 6,A00,959858,Staff,20,0,20,0
1746536427913,PSYC 60,A01,890684,Rickard; Timothy C.,0,5,45,45
1746536428944,PSYC 70,A01,890689,Geller; Emma Harlan,7,0,30,23
1746536429977,PSYC 71,A01,959860,Staff,21,0,25,4
1746536431003,PSYC 100,A00,890690,Lacefield; Katharine I,0,50,180,180
1746536432031,PSYC 102,A00,890695,Staff,18,0,40,22
1746536433060,PSYC 105,A00,890699,Geller; Emma Harlan,71,0,100,29
1746536434089,PSYC 106,A00,890701,Gorman; Michael R.,5,0,30,25
1746536435123,PSYC 108,A00,890704,Adrian; Julia Anna,0,28,50,50
1746536436150,PSYC 118,A01,890712,Staff,11,0,30,19
1746536437179,PSYC 124,A00,890716,Chapman; Eddie Nathaniel,25,0,60,35
1746536438209,PSYC 131,A00,890717,Anagnostaras; Stephan,0,7,80,80
1746536439236,PSYC 137,A00,890719,Winkielman; Piotr,0,11,30,30
1746536440267,PSYC 144,A00,890721,Adrian; Julia Anna,0,9,45,45
1746536441294,PSYC 162,A00,890805,Staff,2,0,75,73
1746536442319,PSYC 169,A00,890810,Staff,0,15,30,30
1746536443345,PSYC 172,A00,890814,Gorman; Michael R.,9,0,30,21
1746536444373,PSYC 181,A00,890818,Anagnostaras; Stephan,8,0,200,192
1746536445399,PSYC 184,A00,959861,Staff,170,0,175,5
1746536446426,PSYC 189,A00,890823,Staff,0,1,30,30
1746536447453,PSYC 191,A00,890884,Rickard; Timothy C.,0,11,35,35
1746536448479,PSYC 193,A00,890913,Staff,19,0,30,11
1746536448479,PSYC 193,B00,890914,Chapman; Eddie Nathaniel,24,0,30,6
1746536449506,PSYC 193L,A01,890918,Lowe; Angela Beth,20,0,30,10
1746536449506,PSYC 193L,B01,890921,Hurwitz; Ethan Scott,20,0,30,10
1746536449506,PSYC 193L,C01,890928,Staff,30,0,30,0
1746536450532,RELI 149,A00,886806,Rahimi; Babak,23,0,40,17
1746536451559,SE 9,A01,886814,Staff,7,0,20,13
1746536452587,SE 101B,A01,886816,Chadha; Mayank,4,0,35,31
1746536453615,SE 110B,A00,886818,Zhu; Qiang,4,0,75,71
1746536454640,SE 125,A01,886830,Staff,10,0,30,20
1746536455670,SE 130B,A01,886835,Staff,14,0,40,26
1746536456696,SE 131A,A01,886838,Krysl; Petr,34,0,55,21
1746536457726,SE 154,A00,886840,Staff,30,0,50,20
1746536458751,SE 164GS,A01,886849,Staff,6,0,20,14
1746536459779,SE 167GS,A01,886853,Staff,6,0,20,14
1746536460804,SIO 25,A01,890107,Staff,19,0,30,11
1746536461835,SIO 45,A00,890109,Cook; Geoffrey W,117,0,200,83
1746536462860,SIO 109R,A00,890110,Forman; Fonna,0,16,20,20
1746536463885,SIO 187,A01,890114,Kacev; David,15,0,40,25
1746536464920,SOCI 1,A01,890431,Thorpe; Charles Robert,15,0,30,15
1746536464920,SOCI 1,A02,890518,Thorpe; Charles Robert,30,0,30,0
1746536465951,SOCI 2,A01,957978,Staff,25,0,25,0
1746536465951,SOCI 2,A02,957979,Staff,23,0,25,2
1746536466978,SOCI 20,A01,890523,Calderon-Zaks; Michael Aar,23,0,30,7
1746536466978,SOCI 20,A02,890526,Calderon-Zaks; Michael Aar,29,0,30,1
1746536468009,SOCI 30,A01,890533,Pardo Guerra; Juan Pablo,37,0,40,3
1746536469035,SOCI 40,A01,890535,Staff,27,0,45,18
1746536470063,SOCI 104Q,A00,890559,Staff,18,0,30,12
1746536471092,SOCI 106,A00,890560,Arnal; Maud Marie Leonie,20,0,30,10
1746536472123,SOCI 110,A00,890567,Holkenbrink-Monk; Charlene,19,0,30,11
1746536473155,SOCI 112,A00,890568,Victoria Torres; Pablo,1,0,55,54
1746536474188,SOCI 115,A00,890597,Arnal; Maud Marie Leonie,28,0,45,17
1746536476242,SOCI 121,A00,890604,Pardo Guerra; Juan Pablo,38,0,45,7
1746536477271,SOCI 126,A01,890608,Staff,8,0,10,2
1746536478300,SOCI 127,A00,890609,Staff,18,0,30,12
1746536479328,SOCI 131,A00,890610,Thorpe; Charles Robert,37,0,45,8
1746536480360,SOCI 135,A00,890615,Payne; Christine Anna,14,0,45,31
1746536481387,SOCI 139,A00,890620,Staff,38,0,45,7
1746536482428,SOCI 148E,A00,890622,Calderon-Zaks; Michael Aar,36,0,45,9
1746536483455,SOCI 150,A00,890623,Kohler; Kristopher M.,31,0,45,14
1746536484484,SOCI 157,A00,890625,Jules-Rosette; Bennetta W.,18,0,20,2
1746536485510,SOCI 160,A00,890627,Payne; Christine Anna,21,0,45,24
1746536486544,SYN 1,A00,886855,Fish; Gwendolyn Anne,0,0,0,0
1746536486544,SYN 1,B00,906086,Fish; Gwendolyn Anne,0,1,0,2
1746536487578,SYN 2R,A00,886860,Staff,0,17,15,15
1746536487578,SYN 2R,B00,906106,Atkinson; Arthur Laird,0,16,15,15
1746536488616,SYN 100,A01,886866,Browne; Emily,0,28,20,20
1746536488616,SYN 100,B01,906128,Rock; Martin,0,5,20,20
1746536488616,SYN 100,C01,906140,Deavenport; James Cary,0,3,20,20
1746536488616,SYN 100,D01,907816,Deavenport; James Cary,0,5,20,20
1746536489655,TDAC 1,A00,890286,Walsh; Kim C.,9,0,20,11
1746536490690,TDAC 101,A00,890296,Basso; Beatrice,16,0,20,4
1746536491716,TDDE 131,A00,890297,Staff,47,0,50,3
1746536492748,TDDM 1,A00,890287,Weinberg; Sadie,25,0,30,5
1746536493775,TDGE 11,A00,890288,Fulton; Julia,137,0,200,63
1746536493775,TDGE 11,B00,890289,Castro; Robert Jess,184,0,200,16
1746536494800,TDGE 25,B00,957359,Walsh; Kim C.,3,0,20,17
1746536495827,TDGE 40,A01,890292,Power; Jade Yukana,27,0,30,3
1746536496858,TDGE 124,A00,890298,Havis; Allan,0,0,50,50
1746536497885,TDGE 131R,A00,890299,Burelle; Julie Sara Veronique,15,0,42,27
1746536498915,TDHT 101,A00,890300,Staff,10,0,20,10
1746536499945,TDHT 109,A01,890302,Anderson; Mysia Anyse,31,0,40,9
1746536500977,TDMV 1,A00,890293,Arcidiacono; Kristin,18,0,30,12
1746536502006,TDMV 2,A00,890294,Weinberg; Sadie,23,0,30,7
1746536503039,TDMV 3,A00,957878,Arcidiacono; Kristin,28,0,30,2
1746536505104,TDMV 138,A00,890304,Jun; Grace Shin Hae,25,0,40,15
1746536506132,TDMV 140,A00,890305,Corrales; Joseph Bernales,25,0,30,5
1746536507158,TDMV 142,A00,890307,Caligagan; Tony,32,0,40,8
1746536508189,TDMV 144,A00,890308,Camaya; Michelle Ann,25,0,30,5
1746536509217,TDPW 1,A00,890295,Stein; Deborah Isobel,3,0,20,17
1746536510245,USP 2,A01,890272,Lerner; Amy M,6,0,20,14
1746536511271,USP 3,A01,890274,Staff,12,0,30,18
1746536512300,USP 15,A01,890276,Sun; Feiyang,17,0,30,13
1746536513328,USP 25,A00,890277,Shenkman; Michael Thomas,19,0,25,6
1746536514357,USP 138,A00,890278,Staff,13,0,25,12
1746536515384,USP 143,A00,890279,Staff,21,0,70,49
1746536516414,USP 144,A00,890280,Chowdhury; Muhammed Zohir,16,0,30,14
1746536517441,USP 150,A00,890281,Boomhower; Matthew Charles,4,0,30,26
1746536518468,USP 151,A00,890282,Staff,16,0,20,4
1746536519494,USP 162,A00,890283,Andrews; Abigail Leslie,16,0,20,4
1746536520526,USP 168,A00,920477,Kwak; Nancy,1,0,5,4
1746536521556,USP 181,A00,890284,Staff,3,0,20,17
1746536522581,USP 191A,A00,890285,Staff,13,0,20,7
1746536523608,VIS 101,A00,886512,Staff,25,0,75,50
1746536524635,VIS 103,A00,886513,Cruz; Edwin Teddy,61,0,75,14
1746536525663,VIS 108,A00,886514,Staff,3,0,15,12
1746536526690,VIS 127P,A00,886515,Shen; Kuiyi,80,0,146,66
1746536527717,VIS 149,A00,886516,Yoldas; Pinar,0,0,15,15
1746536528744,VIS 164,A00,886526,Erdmann; Dean,19,0,22,3
1746536529771,VIS 194S,A00,886527,Staff,61,0,75,14
1746536530798,WCWP 10A,C00,886484,Martiniuk; Jill,12,0,15,3
1746536531824,WCWP 10B,A00,886490,Uriarte; Emma,0,0,15,15
1746536531824,WCWP 10B,B00,886491,Dhir; Simrita,11,0,15,4
1746536531824,WCWP 10B,C00,886492,Ornelas; Tricia,0,0,15,15
1746536532852,WCWP 100,A00,886494,Young; Mark T,0,7,15,15
1746536535018,AAS 10,A01,886199,Childs; Dennis R.,0,3,0,0
1746536536051,ANAR 104,A01,886940,Shtienberg; Gilad,27,0,30,3
1746536537078,ANAR 120,A00,886953,Staff,12,0,20,8
1746536538108,ANBI 148,A01,886955,Wilder; Linnea Lorene,30,0,40,10
1746536540160,ANSC 122,A00,886957,Staff,25,0,30,5
1746536541192,ANSC 150,A00,886958,Sloane; Julia Kathryn,3,0,15,12
1746536542220,ANSC 156,A00,886959,Jenkins; Janis A.,0,1,15,15
1746536543249,ANSC 180,A00,886960,Staff,11,0,17,6
1746536544279,ANSC 188,A00,886961,Jassal; Aftab,9,0,25,16
1746536545304,ANSC 190,A00,886962,Jassal; Aftab,14,0,25,11
1746536546330,ANSC 191,A00,886963,Staff,18,0,20,2
1746536547360,ANTH 3,A01,891689,Staff,17,0,20,3
1746536548384,ANTH 5,A00,886933,Semendeferi; Ekaterini,16,0,20,4
1746536549409,ANTH 10,A00,886934,Staff,0,12,30,30
1746536550435,ANTH 21,A01,886936,Staff,40,0,60,20
1746536551462,ANTH 23,A01,886938,Staff,92,0,100,8
1746536552492,ANTH 105,A00,886964,Stewart; Alexander B,84,0,100,16
1746536553519,ANTH 108,A00,886965,Pedersen; David,9,0,20,11
1746536554548,AWP 10,001,886147,Staff,0,0,0,0
1746536554548,AWP 10,002,886148,Staff,0,0,0,0
1746536554548,AWP 10,003,886149,Staff,0,0,0,0
1746536554548,AWP 10,004,886150,Staff,0,0,0,0
1746536554548,AWP 10,005,886151,Staff,0,0,0,0
1746536554548,AWP 10,006,886152,Staff,0,0,0,0
1746536554548,AWP 10,007,886153,Staff,0,0,0,0
1746536554548,AWP 10,008,886154,Staff,0,0,0,0
1746536554548,AWP 10,009,886155,Staff,0,0,0,0
1746536554548,AWP 10,010,886156,Staff,0,0,0,0
1746536554548,AWP 10,011,886158,Staff,0,0,0,0
1746536554548,AWP 10,012,886160,Staff,0,0,0,0
1746536554548,AWP 10,013,886161,Staff,0,0,0,0
1746536554548,AWP 10,014,886162,Staff,0,0,0,0
1746536554548,AWP 10,015,886163,Staff,0,0,0,0
1746536554548,AWP 10,016,886164,Staff,0,0,0,0
1746536554548,AWP 10,017,886165,Staff,0,0,0,0
1746536554548,AWP 10,018,886166,Staff,0,0,0,0
1746536554548,AWP 10,019,886168,Staff,0,0,0,0
1746536554548,AWP 10,020,886170,Staff,0,0,0,0
1746536554548,AWP 10,021,886172,Staff,0,0,0,0
1746536555583,AWP 10R,001,886173,Staff,0,1,0,0
1746536555583,AWP 10R,002,886174,Staff,0,1,0,0
1746536555583,AWP 10R,003,886175,Staff,0,0,0,0
1746536555583,AWP 10R,004,886176,Staff,0,0,0,0
1746536555583,AWP 10R,005,886177,Staff,0,0,0,0
1746536555583,AWP 10R,006,886178,Staff,0,0,0,0
1746536555583,AWP 10R,007,886179,Staff,0,0,0,0
1746536555583,AWP 10R,008,886181,Staff,0,0,0,0
1746536555583,AWP 10R,009,886182,Staff,0,0,0,0
1746536555583,AWP 10R,010,886183,Staff,0,0,0,0
1746536555583,AWP 10R,011,886184,Staff,0,0,0,0
1746536555583,AWP 10R,012,886185,Staff,0,0,0,0
1746536555583,AWP 10R,013,886186,Staff,0,0,0,0
1746536555583,AWP 10R,014,886187,Staff,0,0,0,0
1746536555583,AWP 10R,015,886188,Staff,0,0,0,0
1746536555583,AWP 10R,016,886189,Staff,0,0,0,0
1746536556609,AWP 102R,A00,886190,Staff,0,0,0,0
1746536556609,AWP 102R,B00,886191,Staff,0,0,0,0
1746536557640,BENG 100,A01,886193,Staff,17,0,30,13
1746536558667,BENG 122A,A01,886195,Hasty; Jeff M,13,0,30,17
1746536559695,BENG 166A,A00,886196,Sah; Robert Lie-Yuan,0,1,30,30
1746536560724,BENG 190,A00,958050,Khojah; Reem I,24,0,25,1
1746536561753,BIBC 102,A01,894320,Staff,0,0,46,46
1746536561753,BIBC 102,A02,894321,Staff,1,0,46,45
1746536561753,BIBC 102,A03,894344,Staff,7,0,46,39
1746536561753,BIBC 102,A04,894345,Staff,26,0,47,21
1746536562781,BICD 100R,A01,894365,Smith; Laurie,0,3,58,58
1746536562781,BICD 100R,A02,894366,Smith; Laurie,0,5,58,58
1746536562781,BICD 100R,A03,894367,Smith; Laurie,2,0,59,57
1746536562781,BICD 100R,A04,959869,Smith; Laurie,41,0,59,18
1746536563809,BICD 136,A01,894383,Gustafson-Brown; Cindy,14,0,50,36
1746536564846,BIEB 102,A01,894494,Butler; Shannon Rhey,51,0,130,79
1746536566911,BIEB 150,A01,894617,Wills; Christopher,3,0,20,17
1746536566911,BIEB 150,A02,894631,Wills; Christopher,3,0,20,17
1746536566911,BIEB 150,A03,894937,Wills; Christopher,3,0,20,17
1746536566911,BIEB 150,A04,894946,Wills; Christopher,5,0,20,15
1746536567940,BIEB 194,A00,906141,Kurle; Carolyn M.,6,0,20,14
1746536568969,BILD 1,A01,894154,Staff,2,0,19,17
1746536568969,BILD 1,A02,894155,Staff,14,0,19,5
1746536568969,BILD 1,A03,894160,Staff,13,0,19,6
1746536568969,BILD 1,A04,894161,Staff,15,0,18,3
1746536569996,BILD 2,A01,894168,Staff,0,0,50,50
1746536569996,BILD 2,A02,894169,Staff,0,0,50,50
1746536569996,BILD 2,A03,894179,Staff,4,0,50,46
1746536569996,BILD 2,A04,894203,Staff,27,0,50,23
1746536571023,BILD 3,A01,894213,Staff,22,0,31,9
1746536571023,BILD 3,A02,894214,Staff,26,0,31,5
1746536571023,BILD 3,A03,894235,Staff,28,0,31,3
1746536571023,BILD 3,A04,894236,Staff,28,0,32,4
1746536572051,BILD 4,A01,894253,Reuther; Keefe,5,0,24,19
1746536572051,BILD 4,A02,894258,Reuther; Keefe,16,0,24,8
1746536573081,BILD 5,A01,894276,Reuther; Keefe,35,0,50,15
1746536573081,BILD 5,A02,894277,Reuther; Keefe,45,0,50,5
1746536573081,BILD 5,A03,894290,Reuther; Keefe,44,0,50,6
1746536573081,BILD 5,A04,894291,Reuther; Keefe,48,0,50,2
1746536574110,BILD 24,A01,894297,Pirino; Giorgia,40,0,60,20
1746536575139,BIMM 100,B01,958915,Staff,72,0,100,28
1746536576172,BIMM 101,A01,895017,McDonnell; Lisa Marie,0,5,24,24
1746536576172,BIMM 101,A02,895018,McDonnell; Lisa Marie,0,5,24,24
1746536576172,BIMM 101,B01,895020,McDonnell; Lisa Marie,0,6,24,24
1746536576172,BIMM 101,B02,895021,McDonnell; Lisa Marie,0,4,24,24
1746536577205,BIMM 110,A01,895023,Staff,1,0,25,24
1746536577205,BIMM 110,A02,895024,Staff,9,0,25,16
1746536577205,BIMM 110,A03,895025,Staff,18,0,25,7
1746536577205,BIMM 110,A04,895031,Staff,20,0,25,5
1746536578235,BIMM 120,A01,895114,Gustafson-Brown; Cindy,13,0,28,15
1746536578235,BIMM 120,A02,895126,Gustafson-Brown; Cindy,21,0,27,6
1746536579264,BIPN 100,A01,895130,Yang; Mingyu,1,0,38,37
1746536579264,BIPN 100,A02,895131,Yang; Mingyu,32,0,38,6
1746536579264,BIPN 100,A03,895132,Yang; Mingyu,32,0,38,6
1746536579264,BIPN 100,A04,895133,Yang; Mingyu,27,0,36,9
1746536580291,BIPN 120,A01,895135,Cooke; James Edward,0,3,13,13
1746536580291,BIPN 120,A02,895136,Cooke; James Edward,0,1,13,13
1746536580291,BIPN 120,A03,895137,Cooke; James Edward,0,3,13,13
1746536580291,BIPN 120,A04,895156,Cooke; James Edward,0,2,11,11
1746536581322,BIPN 134,A01,895235,Cooke; James Edward,0,2,25,25
1746536581322,BIPN 134,A02,895237,Cooke; James Edward,0,0,25,25
1746536581322,BIPN 134,A03,895240,Cooke; James Edward,3,0,25,22
1746536581322,BIPN 134,A04,895270,Cooke; James Edward,20,0,25,5
1746536582350,BIPN 189,A00,892103,Staff,0,13,14,14
1746536584410,BISP 194,A00,958008,Staff,0,2,0,0
1746536585435,CAT 124,A01,922009,Staff,0,5,20,20
1746536586468,CAT 125R,A00,886390,Morales; Celeste Georgianna,0,2,20,20
1746536586468,CAT 125R,B00,886391,Irwin; Matthew Joseph,0,3,20,20
1746536586468,CAT 125R,C00,886392,Smith; Lauryn Alissa,0,2,20,20
1746536586468,CAT 125R,D00,886393,Vanderschuit; Maya Alysia,0,2,20,20
1746536586468,CAT 125R,E00,886394,Marchisotto; Jennifer Anne,0,4,20,20
1746536587495,CENG 15,A01,886218,Drews; Aaron,3,0,8,5
1746536588522,CENG 113,A00,886219,Opatkiewicz; Justin Paul,15,0,25,10
1746536589548,CGS 101,A00,887044,Staff,7,0,20,13
1746536590577,CGS 105,A01,887046,Staff,14,0,25,11
1746536591608,CGS 112,A00,887047,Cuong; Marisol,12,0,15,3
1746536592634,CGS 113,A00,887048,Staff,23,0,30,7
1746536593660,CGS 120,A00,887049,Staff,10,0,17,7
1746536594687,CHEM 6A,A01,886336,Lam; Tin Yiu,38,0,50,12
1746536594687,CHEM 6A,A02,886338,Lam; Tin Yiu,37,0,50,13
1746536595722,CHEM 6B,A01,886341,Hopkins; Patrycja Anna,16,0,50,34
1746536595722,CHEM 6B,A02,886343,Hopkins; Patrycja Anna,42,0,50,8
1746536596749,CHEM 6C,A01,886346,Albizati; Kim F.,0,2,50,50
1746536596749,CHEM 6C,A02,886348,Albizati; Kim F.,23,0,50,27
1746536597777,CHEM 40A,A01,886352,Klosterman; Jeremy K,65,0,100,35
1746536598803,CHEM 40B,A01,886356,Klosterman; Jeremy K,0,23,100,100
1746536599831,CHEM 41B,A01,886360,Theodorakis; Emmanuel,25,0,50,25
1746536599831,CHEM 41B,A02,886362,Theodorakis; Emmanuel,47,0,50,3
1746536600857,CHIN 165A,A00,886382,Xu; Li,18,0,20,2
1746536601888,CLAS 120,A00,886387,Myerston Santana; Jacobo,33,0,40,7
1746536602917,COGS 9,A01,886967,Shannon; Kyle Michael,42,0,60,18
1746536603942,COGS 11,A01,886969,Staff,11,0,30,19
1746536604968,COGS 14A,A01,886971,Staff,6,0,60,54
1746536606000,COGS 14B,A01,886973,Hoffman; Drew Ellen,4,0,60,56
1746536607030,COGS 18,A01,886975,Morgan; Eric,35,0,60,25
1746536608057,COGS 20,A01,886977,Staff,4,0,8,4
1746536608057,COGS 20,A02,886978,Staff,5,0,7,2
1746536609084,COGS 100,A01,907783,Staff,0,2,30,30
1746536610110,COGS 101B,A01,886980,Staff,0,3,48,48
1746536611138,COGS 101C,A01,886982,Delgado; Tania,0,5,44,44
1746536612166,COGS 102A,A01,886984,Johnson; Christine M.,4,0,30,26
1746536613192,COGS 118B,A01,886986,Staff,0,3,88,88
1746536614222,COGS 150,A01,886988,Bergen; Benjamin,23,0,50,27
1746536615249,COGS 153,A00,886989,Delgado; Tania,0,2,41,41
1746536616276,COGS 186,A01,886991,Staff,0,0,32,32
1746536617308,COGS 187A,A01,886993,Boyle; Mary E. T.,7,0,30,23
1746536618334,COGS 189,A00,886994,Staff,0,1,30,30
1746536619365,COMM 10,A01,886996,Staff,0,0,20,21
1746536619365,COMM 10,A02,886997,Staff,12,0,20,8
1746536619365,COMM 10,A03,959845,Staff,19,0,20,1
1746536620396,COMM 20,A01,886999,Leuning; Grant Maurstad,24,0,40,16
1746536622447,COMM 100A,A01,887002,Staff,0,0,20,25
1746536622447,COMM 100A,A02,887003,Staff,7,0,20,13
1746536623474,COMM 100B,A01,887005,Staff,0,8,20,24
1746536624502,COMM 106D,A00,887006,Staff,14,0,40,26
1746536625532,COMM 110G,A00,887007,Whitworth-Smith; Andrew C,12,0,40,28
1746536626558,COMM 111B,A00,887008,Staff,31,0,40,9
1746536627584,COMM 113T,A00,887009,Abuelhiga; Soraya Jill,28,0,40,12
1746536627584,COMM 113T,B00,906733,Staff,40,0,40,0
1746536628609,COMM 145,A00,887010,Staff,12,0,40,28
1746536629639,COMM 146,A00,887054,Staff,31,0,40,9
1746536630669,COMM 190,A00,887012,Staff,8,0,23,15
1746536631695,CSE 8A,A50,887015,Cao; Yingjun,57,0,85,28
1746536632728,CSE 11,A01,887017,Cao; Yingjun,12,0,70,58
1746536633756,CSE 20,A01,887019,Staff,30,0,50,20
1746536634794,CSE 21,A01,887021,Staff,78,0,100,22
1746536634794,CSE 21,B01,892583,Braun; Oliver,45,0,50,5
1746536635821,CSE 30,A01,887025,Eldon; John,143,0,200,57
1746536636849,CSE 100,A01,887027,Staff,26,0,50,24
1746536636849,CSE 100,A02,887028,Staff,40,0,50,10
1746536637875,CSE 101,A01,887030,Braun; Oliver,75,0,100,25
1746536637875,CSE 101,B01,887032,Jones; Miles E,0,3,50,50
1746536637875,CSE 101,B02,887033,Jones; Miles E,0,1,50,50
1746536638901,CSE 105,A01,908084,Jones; Miles E,32,0,50,18
1746536638901,CSE 105,A02,908087,Jones; Miles E,33,0,50,17
1746536639928,CSE 135,A01,887035,Powell; Thomas Allan,0,4,50,50
1746536640955,CSE 142,A01,887037,Staff,8,0,60,52
1746536641985,CSE 142L,A01,887039,Staff,34,0,60,26
1746536643012,CSE 151A,A01,887041,Solares; Edwin A,48,0,100,52
1746536644039,CSE 175,A01,887043,Kumar; Rakesh,30,0,30,0
1746536645070,CSS 1,A01,886389,Staff,0,1,40,40
1746536646102,DSC 30,A01,908097,Liao; Soohyun Nam,47,0,75,28
1746536647128,DSC 40A,A01,908099,Shannon; Kyle Michael,30,0,50,20
1746536648155,DSC 40B,A01,908112,Staff,16,0,50,34
1746536649181,DSC 80,A01,908116,Staff,19,0,60,41
1746536650209,DSC 197,001,956863,Eldridge; Justin Matthew,9999,0,9999,0
1746536651236,ECE 5,A01,886400,Morris; Karcher William,2,0,6,4
1746536651236,ECE 5,A02,886401,Morris; Karcher William,3,0,6,3
1746536652263,ECE 148,A01,886403,Silberman; Jack,0,14,14,14
1746536653295,ECON 1,A01,887265,Crane; Meredith Helen,12,0,70,58
1746536653295,ECON 1,B01,887268,Staff,43,0,50,7
1746536654320,ECON 2,A01,887273,Crane; Meredith Helen,56,0,70,14
1746536655347,ECON 3,A01,887279,Rondina; Giacomo,32,0,70,38
1746536656373,ECON 4,A01,887282,Anderson; John Charles,0,2,10,10
1746536657405,ECON 5,A01,887285,Staff,33,0,45,12
1746536657405,ECON 5,B01,887292,Staff,41,0,45,4
1746536658435,ECON 100A,A01,887337,Newhouse; Herbert S,54,0,70,16
1746536658435,ECON 100A,B01,887349,Staff,45,0,50,5
1746536659460,ECON 100B,A01,887361,Du; Songzi,29,0,70,41
1746536660488,ECON 100C,A01,887445,Newhouse; Herbert S,59,0,70,11
1746536661517,ECON 105,A00,887488,Vespa; Emanuel Ignacio,23,0,35,12
1746536662544,ECON 109,A01,887506,Shishkin; Denis,28,0,35,7
1746536663576,ECON 110A,A01,887568,Alon; Titan Michael,0,3,35,35
1746536663576,ECON 110A,B01,907601,Alon; Titan Michael,20,0,35,15
1746536664603,ECON 110B,A01,887598,Levkoff; Steven B.,0,23,70,70
1746536665633,ECON 112,A00,887599,Rondina; Giacomo,19,0,35,16
1746536666660,ECON 120A,A01,887603,Dai; Yinlin,36,0,70,34
1746536667687,ECON 120C,A01,887608,Sun; Yixiao,0,1,35,35
1746536667687,ECON 120C,B01,887614,Sun; Yixiao,0,0,35,35
1746536668714,ECON 138,A00,887621,Bharadwaj; Prashant,0,20,20,20
1746536669749,ECON 144,A00,958007,Squires; Dale E,13,0,35,22
1746536670775,ECON 171,A01,907666,Staff,18,0,35,17
1746536671805,ECON 175,A00,887626,Wu; Pak Yeung,23,0,35,12
1746536672831,ECON 190,A00,887640,Vespa; Emanuel Ignacio,23,0,35,12
1746536673877,EDS 25,A01,888197,Staff,0,0,0,0
1746536673877,EDS 25,A02,888209,Staff,0,0,0,0
1746536673877,EDS 25,A03,888210,Staff,0,0,0,0
1746536673877,EDS 25,A04,888212,Staff,0,0,0,0
1746536673877,EDS 25,A05,888213,Staff,0,0,0,0
1746536673877,EDS 25,A06,888214,Staff,0,0,0,0
1746536673877,EDS 25,A07,888235,Staff,0,2,0,0
1746536673877,EDS 25,A08,888236,Staff,0,0,0,0
1746536673877,EDS 25,A09,888240,Staff,0,0,0,0
1746536673877,EDS 25,A10,888244,Staff,0,0,0,0
1746536673877,EDS 25,B01,888273,Staff,0,0,0,0
1746536673877,EDS 25,B02,888285,Staff,0,0,0,0
1746536673877,EDS 25,B03,888423,Staff,0,0,0,1
1746536673877,EDS 25,B04,888432,Staff,0,0,0,0
1746536673877,EDS 25,B05,888433,Staff,0,0,0,0
1746536673877,EDS 25,B06,888467,Staff,0,0,0,0
1746536673877,EDS 25,B07,888468,Staff,0,0,0,0
1746536673877,EDS 25,B08,888479,Staff,0,0,0,0
1746536673877,EDS 25,B09,888484,Staff,0,0,0,0
1746536673877,EDS 25,B10,888487,Staff,0,0,0,0
1746536674905,EDS 38,A01,907700,Choi; Bailey Miyeon,30,0,30,0
1746536675930,EDS 112,A01,888601,Chapman; Thandeka K,14,0,40,26
1746536676961,EDS 115,A00,888697,Mendez; Kathrina Mendoza,10,0,30,20
1746536677989,EDS 116,A01,888893,Staff,35,0,40,5
1746536680045,EDS 124AR,A00,889133,Staff,29,0,50,21
1746536680045,EDS 124AR,B00,907471,Simon; Elizabeth A,37,0,50,13
1746536681074,EDS 124BR,A00,889134,Simon; Elizabeth A,45,0,100,55
1746536682102,EDS 125,A00,889135,Staff,25,0,30,5
1746536683127,EDS 126,A01,889138,Staff,36,0,40,4
1746536684153,EDS 164R,A01,889142,Wishard Guerra; Alison G.,33,0,50,17
1746536685180,ENG 30,A01,886396,Staff,0,0,0,0
1746536685180,ENG 30,B01,886398,Staff,0,0,0,0
1746536686207,ENVR 102,A00,906150,Montejo; Carolina,23,0,25,2
1746536687240,ETHN 103A,A00,887236,Man; Simeon S,0,3,0,0
1746536688269,ETHN 113,A00,887239,Staff,16,0,30,14
1746536689297,ETHN 116,A00,887240,Staff,16,0,25,9
1746536690327,ETHN 117,A00,887241,Choi; Esther Min,28,0,30,2
1746536691356,ETHN 118,A00,887243,Staff,24,0,30,6
1746536692380,ETHN 127,A00,887248,Cuong; Marisol,11,0,15,4
1746536693406,ETHN 139,A00,887250,Staff,7,0,10,3
1746536694432,ETHN 142,A00,887252,Staff,10,0,30,20
1746536695461,ETHN 161,A00,887253,Browne; Errol Tsekani,24,0,30,6
1746536696487,ETHN 163FR,A00,887255,Burelle; Julie Sara Veronique,0,0,5,5
1746536697515,GLBH 20,A00,889149,Elwardani; Nile Regina,8,0,42,34
1746536699574,GLBH 111,A01,889152,Burgos; Jose L.,17,0,17,0
1746536700606,GLBH 150,A00,889181,Sloane; Julia Kathryn,0,5,15,15
1746536702660,HDS 60,A01,886406,Warstadt; Melissa Fawn,73,0,80,7
1746536703691,HIAF 111,A00,889324,Gyamfi; Bright,25,0,32,7
1746536704718,HIEA 131,A00,889328,Staff,16,0,32,16
1746536705751,HIEA 144,A00,889333,Henry; Todd A.,26,0,32,6
1746536706778,HIEA 154,A00,889336,Henry; Todd A.,24,0,32,8
1746536707803,HIEU 106,A00,889339,Staff,22,0,32,10
1746536709859,HIEU 114,A00,889340,Staff,3,0,32,29
1746536710890,HIEU 135GS,A00,889342,Patterson; Patrick H.,0,0,1,24
1746536711919,HIEU 137,A00,889343,Edington; Claire Ellen,9,0,25,16
1746536712945,HIEU 148,A00,889345,Staff,14,0,32,18
1746536713971,HIEU 154,A00,889346,Biess; Frank Peter,21,0,32,11
1746536714996,HILA 102,A00,889351,Staff,12,0,32,20
1746536716024,HILD 2A,A01,889221,Lewandoski; Julia Mavis,1,10,32,31
1746536717051,HILD 7B,A01,889225,Man; Simeon S,0,13,32,32
1746536718084,HILD 7C,A01,889288,Alvarez; Luis A,0,14,32,32
1746536719111,HILD 30,A01,889323,Staff,0,5,32,32
1746536721166,HISC 119,A00,889383,Golan; Tal,21,0,32,11
1746536722197,HIUS 103,A00,889384,Man; Simeon S,0,0,32,32
1746536723224,HIUS 117,A00,919797,Kwak; Nancy,18,0,32,14
1746536724249,HIUS 142A,A00,919788,Staff,22,0,32,10
1746536726307,HIUS 149,A00,889386,Gyamfi; Bright,27,0,32,5
1746536727337,HIUS 155,A00,889387,Alvarez; Luis A,14,0,32,18
1746536728364,HUM 3,A01,886499,Caldwell; Michael Alan,19,0,50,31
1746536729390,HUM 3GS,A00,886500,Rodriguez; Bretton Sigfred,0,0,0,28
1746536730424,HUM 3R,A01,886502,Markman; Kristina,0,36,50,50
1746536731452,HUM 4,A01,886504,Crum; Matthew Stephen,24,0,50,26
1746536731452,HUM 4,B01,886506,West; Geoffrey Scott,17,0,50,33
1746536732477,HUM 4GS,A00,886507,Staff,0,0,0,19
1746536733508,HUM 5,A01,886509,Staff,32,0,50,18
1746536734535,HUM 5R,A01,886511,Zavodny; Tatiana Sophia,0,39,50,50
1746536735560,JAPN 180,A00,886407,Staff,18,0,40,22
1746536736587,LATI 50,A01,886409,Martin-Cabrera; Luis,4,0,22,18
1746536736587,LATI 50,A02,886410,Martin-Cabrera; Luis,19,0,22,3
1746536736587,LATI 50,A03,886411,Martin-Cabrera; Luis,21,0,22,1
1746536736587,LATI 50,A04,886412,Martin-Cabrera; Luis,9,0,22,13
1746536737614,LAWS 101,A00,907664,Staff,28,0,60,32
1746536738645,LIAB 1A,A00,889388,Saab; Dima,17,0,20,3
1746536739678,LIAB 1AX,A00,889389,El Cheddadi; Youniss,17,0,20,3
1746536740706,LIFR 1C,A00,889391,Van Moer; Vinciane G,8,0,20,12
1746536741731,LIFR 1CX,A00,889392,Van Moer; Vinciane G,7,0,20,13
1746536742758,LIFR 1D,A00,889393,Van Moer; Vinciane G,7,0,20,13
1746536743790,LIFR 1DX,A00,889394,Van Moer; Vinciane G,8,0,20,12
1746536744822,LIGN 7,A00,886923,Staff,24,0,50,26
1746536745856,LIGN 17,A00,886924,Kehler; Andrew Scott,125,0,150,25
1746536746886,LTAM 110,A00,889395,Staff,15,0,30,15
1746536747911,LTAM 110GS,A00,958010,Rodriguez; Bretton Sigfred,0,0,0,28
1746536748940,LTCH 101,A00,889397,Staff,23,0,25,2
1746536749971,LTCS 130,A00,889398,Staff,23,0,25,2
1746536751000,LTEA 138,A00,889399,Staff,24,0,40,16
1746536752030,LTEN 149,A00,889400,Wesling; Megan E.,0,3,25,25
1746536753056,LTEN 169,A00,889401,Staff,20,0,25,5
1746536754086,LTEN 180,A00,889402,Staff,10,0,15,5
1746536755115,LTEN 181,A00,889403,Staff,21,0,25,4
1746536756142,LTWL 100,A00,889404,Myerston Santana; Jacobo,3,0,25,22
1746536757170,LTWL 180GS,A00,889405,Staff,0,0,20,20
1746536758200,LTWL 181,A00,889406,Staff,17,0,25,8
1746536759232,LTWL 184,A00,889475,Mukherjee; Silpa,22,0,25,3
1746536760262,LTWR 102C,A00,889486,Staff,29,0,30,1
1746536761289,LTWR 115W,A00,889491,Staff,0,2,15,15
1746536762318,MAE 8,A01,886905,Staff,0,2,0,0
1746536763348,MAE 11,A00,886906,Bandaru; Prabhakar,0,7,50,50
1746536764373,MAE 20,A00,886907,Evdokimenko; Ekaterina,44,0,70,26
1746536765401,MAE 30B,A00,886909,Ghazinejad; Maziar,26,0,45,19
1746536766432,MAE 101B,A00,886910,Saintillan; David,29,0,45,16
1746536767461,MAE 105,A00,886911,Bandaru; Prabhakar,18,0,50,32
1746536768491,MAE 107,B00,958024,Staff,9,0,50,41
1746536769520,MAE 143B,A00,886913,Bewley; Thomas R,7,0,40,33
1746536770550,MAE 148,A01,886915,Silberman; Jack,0,3,14,14
1746536771576,MAE 160,A00,886916,Evdokimenko; Ekaterina,31,0,60,29
1746536772604,MATH 3C,A01,889681,Staff,0,3,30,30
1746536772604,MATH 3C,A02,960048,Staff,25,0,30,5
1746536773635,MATH 10A,A01,889760,Staff,26,0,30,4
1746536773635,MATH 10A,A02,889783,Staff,29,0,30,1
1746536774670,MATH 10B,A01,889785,Verstraete; Jacques Allan,2,0,35,33
1746536774670,MATH 10B,A02,889795,Verstraete; Jacques Allan,4,0,35,31
1746536774670,MATH 10B,B01,889797,Verstraete; Jacques Allan,3,0,35,32
1746536774670,MATH 10B,B02,889828,Verstraete; Jacques Allan,3,0,35,32
1746536775701,MATH 10C,A01,889849,Habib; Yousaf,9,0,30,21
1746536775701,MATH 10C,A02,889852,Habib; Yousaf,14,0,30,16
1746536775701,MATH 10C,A03,889853,Habib; Yousaf,22,0,30,8
1746536775701,MATH 10C,A04,889858,Habib; Yousaf,20,0,30,10
1746536775701,MATH 10C,B01,889861,Staff,1,0,30,29
1746536775701,MATH 10C,B02,889862,Staff,24,0,30,6
1746536775701,MATH 10C,B03,889863,Staff,27,0,30,3
1746536775701,MATH 10C,B04,889967,Staff,23,0,30,7
1746536776729,MATH 18,A01,889974,Staff,7,0,30,23
1746536776729,MATH 18,A02,889977,Staff,20,0,30,10
1746536776729,MATH 18,B01,889984,Hardiman; Liam,22,0,30,8
1746536776729,MATH 18,B02,889985,Hardiman; Liam,25,0,30,5
1746536777756,MATH 20A,A01,889990,Suk; Andrew Hoon,29,0,35,6
1746536778783,MATH 20B,A01,889993,Ohm; Ko Woon,22,0,30,8
1746536778783,MATH 20B,A02,889994,Ohm; Ko Woon,30,0,30,0
1746536778783,MATH 20B,B01,889996,Ohm; Ko Woon,21,0,30,9
1746536778783,MATH 20B,B02,889997,Ohm; Ko Woon,23,0,30,7
1746536779813,MATH 20C,A01,889999,Hammock; Frances H,17,0,30,13
1746536779813,MATH 20C,A02,890003,Hammock; Frances H,23,0,30,7
1746536779813,MATH 20C,B01,890006,Hammock; Frances H,3,0,30,27
1746536779813,MATH 20C,B02,890007,Hammock; Frances H,11,0,30,19
1746536780842,MATH 20D,A01,890011,Cheng; Hsiao-Bing,1,1,30,29
1746536780842,MATH 20D,A02,890012,Cheng; Hsiao-Bing,14,0,30,16
1746536780842,MATH 20D,B01,890016,Cheng; Hsiao-Bing,13,0,30,17
1746536780842,MATH 20D,B02,890017,Cheng; Hsiao-Bing,13,0,30,17
1746536781872,MATH 20E,A01,890026,Harel; Guershon,1,0,30,29
1746536781872,MATH 20E,A02,890029,Harel; Guershon,23,0,30,7
1746536781872,MATH 20E,B01,890033,Harel; Guershon,7,0,30,23
1746536781872,MATH 20E,B02,890101,Harel; Guershon,21,0,30,9
1746536782901,MATH 102,A01,890104,Staff,17,0,30,13
1746536782901,MATH 102,A02,890105,Staff,27,0,30,3
1746536783930,MATH 103B,A01,890116,Salehi Golsefidy; Alireza,3,0,30,27
1746536783930,MATH 103B,B01,890118,Staff,0,3,34,34
1746536784959,MATH 109,A01,890121,Aliabadi Sr.; Mohsen,1,0,30,29
1746536784959,MATH 109,B01,890124,Upadrashta; Pranav Kumar,18,0,30,12
1746536785988,MATH 120A,A01,890126,Eggers; John Dietrich,13,0,30,17
1746536787016,MATH 142B,A01,890128,Ioana; Adrian,19,0,30,11
1746536787016,MATH 142B,A02,890129,Ioana; Adrian,13,0,30,17
1746536788042,MATH 154,A01,890174,Staff,0,0,30,30
1746536788042,MATH 154,A02,890182,Staff,0,0,30,30
1746536789067,MATH 168A,A01,890197,Dumitriu; Ioana,21,0,35,14
1746536790095,MATH 170A,A01,890240,Nie; Jiawang,1,0,30,29
1746536790095,MATH 170A,A02,890241,Nie; Jiawang,11,0,30,19
1746536790095,MATH 170A,A03,890249,Nie; Jiawang,23,0,30,7
1746536791124,MATH 170B,A01,957891,Nag; Panchali,13,0,35,22
1746536793188,MATH 181A,A01,908025,Staff,0,4,35,35
1746536793188,MATH 181A,A02,960115,Staff,27,0,35,8
1746536794212,MATH 181B,A01,959874,Staff,26,0,30,4
1746536795240,MATH 193B,A01,890265,Staff,0,4,35,35
1746536796270,MGT 4,A01,890311,Anderson; John Charles,42,0,88,46
1746536797302,MGT 5,A00,907740,Staff,13,0,98,85
1746536798330,MGT 12,A00,890312,Lindenberger; Wade Douglas,67,0,98,31
1746536799356,MGT 16,A00,957883,Staff,78,0,98,20
1746536801415,MGT 45,A00,890314,Pecore; Joseph P.,47,0,98,51
1746536802442,MGT 71,A00,890315,Staff,0,11,98,98
1746536803473,MGT 100,A00,890316,Yavorsky; Daniel Ryan,44,0,98,54
1746536804502,MGT 103,A00,890317,Ehrich; Kristine R,73,0,98,25
1746536805533,MGT 105,A00,890356,Bates; Kenneth Walter,0,7,98,98
1746536806570,MGT 112,A00,890360,Ehrich; Kristine R,55,0,98,43
1746536807597,MGT 127R,A00,907732,Zhu; Kevin Xiaoguo,23,0,98,75
1746536808625,MGT 131B,A00,890361,Anderson; John Charles,61,0,98,37
1746536809656,MGT 137,A00,890362,Lindenberger; Wade Douglas,65,0,98,33
1746536810684,MGT 160,A00,890369,Johnson; Erik Barry,9,0,98,89
1746536812743,MGT 164,A00,890372,Zimmermann; Carsten,0,39,98,98
1746536813769,MGT 180,A00,890374,Bliss; Barbara Ann,12,0,98,86
1746536814797,MMW 15,A01,886414,Chang; Edmond Yi-Teh,0,12,28,28
1746536814797,MMW 15,A02,886415,Chang; Edmond Yi-Teh,0,8,28,28
1746536814797,MMW 15,A03,886416,Chang; Edmond Yi-Teh,0,8,28,28
1746536814797,MMW 15,A04,886417,Chang; Edmond Yi-Teh,0,8,28,28
1746536814797,MMW 15,B01,886419,Chang; Edmond Yi-Teh,0,7,28,28
1746536814797,MMW 15,B02,886420,Chang; Edmond Yi-Teh,0,8,28,28
1746536814797,MMW 15,B03,886421,Chang; Edmond Yi-Teh,0,7,28,28
1746536814797,MMW 15,B04,886422,Chang; Edmond Yi-Teh,0,8,28,28
1746536814797,MMW 15,C01,886424,Staff,0,9,28,28
1746536814797,MMW 15,C02,886425,Staff,0,8,28,28
1746536814797,MMW 15,C03,886426,Staff,0,8,28,28
1746536814797,MMW 15,C04,886427,Staff,0,7,28,28
1746536814797,MMW 15,C05,958038,Staff,0,7,28,28
1746536814797,MMW 15,C06,958039,Staff,0,8,28,28
1746536815829,MMW 15GS,A00,906910,Patterson; Patrick H.,4,0,28,24
1746536816858,MMW 122R,A01,886429,Rahimi; Babak,0,13,28,28
1746536816858,MMW 122R,A02,886430,Rahimi; Babak,0,12,28,28
1746536816858,MMW 122R,A03,958040,Rahimi; Babak,0,11,28,28
1746536817891,MUS 1A,A01,890937,Staff,3,0,25,22
1746536817891,MUS 1A,A02,891035,Staff,6,0,25,19
1746536817891,MUS 1A,C01,958912,Staff,24,0,25,1
1746536817891,MUS 1A,C02,958913,Staff,25,0,25,0
1746536819957,MUS 2AK,A00,957092,Ohnishi; Takae,15,0,15,0
1746536820986,MUS 4,A01,891044,Staff,2,0,25,23
1746536820986,MUS 4,A02,891045,Staff,23,0,25,2
1746536820986,MUS 4,B01,891048,Staff,17,0,25,8
1746536820986,MUS 4,B02,891050,Staff,25,0,25,0
1746536822014,MUS 5,A01,957506,Dubnov; Shlomo,0,0,25,25
1746536822014,MUS 5,A02,957622,Dubnov; Shlomo,14,0,25,11
1746536822014,MUS 5,A03,957623,Dubnov; Shlomo,20,0,25,5
1746536823040,MUS 6,A01,891053,Freitas Caetano; Marcelo,24,0,25,1
1746536823040,MUS 6,A02,891054,Freitas Caetano; Marcelo,23,0,25,2
1746536824067,MUS 7,A01,891081,Staff,0,0,25,25
1746536824067,MUS 7,A02,891082,Staff,4,0,25,21
1746536825095,MUS 8GS,A00,891118,Borgo; David Garcia,0,0,25,25
1746536826121,MUS 11,A01,891140,Staff,11,0,25,14
1746536826121,MUS 11,A02,891141,Staff,22,0,25,3
1746536827149,MUS 13,A01,891143,Staff,8,0,25,17
1746536827149,MUS 13,A02,891144,Staff,24,0,25,1
1746536828177,MUS 15,A01,891146,Staff,9,0,25,16
1746536828177,MUS 15,A02,891148,Staff,21,0,25,4
1746536828177,MUS 15,B01,891150,Staff,18,0,25,7
1746536828177,MUS 15,B02,891151,Staff,25,0,25,0
1746536829212,MUS 20,A01,891153,Staff,5,0,20,15
1746536829212,MUS 20,A02,891155,Staff,14,0,20,6
1746536830241,MUS 80,A00,891156,Staff,19,0,25,6
1746536830241,MUS 80,B00,891157,Staff,23,0,25,2
1746536831268,MUS 130,A00,891158,Ohnishi; Takae,35,0,35,0
1746536832294,MUS 150GS,A01,891160,Borgo; David Garcia,0,0,25,25
1746536833319,MUS 170,A01,891162,Freitas Caetano; Marcelo,20,0,25,5
1746536833319,MUS 170,A02,891164,Freitas Caetano; Marcelo,21,0,25,4
1746536834345,NANO 11,A00,886220,Vazquez Mena; Oscar,13,0,15,2
1746536835372,NANO 15,A01,886222,Drews; Aaron,4,0,7,3
1746536836401,NANO 104,A00,886224,Sirbuly; Donald,18,0,25,7
1746536837429,PH 40,A00,886528,Staff,23,0,40,17
1746536838454,PH 45,A01,886799,Staff,35,0,40,5
1746536839481,PH 110,A00,886802,Staff,0,7,40,40
1746536840510,PH 172,A00,906716,Staff,19,0,35,16
1746536841536,PH 191,A00,886803,Staff,6,0,40,34
1746536842566,PHIL 1,A00,889500,Staff,19,0,30,11
1746536843594,PHIL 10,A01,889549,Grush; Rick Scott,15,0,22,7
1746536843594,PHIL 10,A02,889551,Grush; Rick Scott,22,0,22,0
1746536844623,PHIL 28,A01,889559,Lamey; Andy M.,0,1,31,31
1746536844623,PHIL 28,A02,889561,Lamey; Andy M.,0,1,30,30
1746536844623,PHIL 28,A03,889572,Lamey; Andy M.,0,0,30,30
1746536845650,PHIL 35,A00,907839,Staff,13,0,15,2
1746536846679,PHIL 60,A00,889574,Staff,74,0,90,16
1746536847706,PHIL 101,A00,958004,Staff,13,0,15,2
1746536849765,PHIL 136,A00,889582,Fulkerson; Matthew Todd,26,0,45,19
1746536850793,PHIL 163,A01,889601,Staff,21,0,30,9
1746536850793,PHIL 163,B01,889606,Brandt; Reuven A,0,3,0,0
1746536851822,PHIL 164,A00,889610,Staff,16,0,30,14
1746536852852,PHIL 165,A00,889613,Staff,23,0,30,7
1746536853879,PHYS 1A,A00,886431,Staff,26,0,70,44
1746536854911,PHYS 1AL,001,886432,Tsai; Philbert S,0,2,30,30
1746536854911,PHYS 1AL,002,886436,Tsai; Philbert S,11,0,30,19
1746536855942,PHYS 1B,A00,886439,Staff,185,0,240,55
1746536856968,PHYS 1BL,001,886441,Tsai; Philbert S,0,4,30,30
1746536856968,PHYS 1BL,002,886444,Tsai; Philbert S,2,0,30,28
1746536857995,PHYS 1C,A00,896092,Arnold; Kam S,78,0,146,68
1746536859023,PHYS 1CL,001,886448,Tsai; Philbert S,0,0,30,30
1746536859023,PHYS 1CL,002,886449,Tsai; Philbert S,0,0,30,30
1746536859023,PHYS 1CL,003,886450,Tsai; Philbert S,15,0,30,15
1746536859023,PHYS 1CL,004,886451,Tsai; Philbert S,15,0,30,15
1746536860058,PHYS 2B,A01,886457,Staff,69,0,115,46
1746536861091,PHYS 2C,A01,886460,Shotwell; Brian,0,8,65,65
1746536862118,PHYS 2CL,A01,886467,Staff,0,4,28,28
1746536862118,PHYS 2CL,A02,886468,Staff,0,3,28,28
1746536863149,PHYS 2D,A01,886470,Staff,10,0,50,40
1746536864180,PHYS 4B,A01,886475,Grinstein; Benjamin,22,0,40,18
1746536865205,POLI 5,A00,891173,Desposato; Scott,7,0,25,18
1746536866232,POLI 5D,A01,891175,Staff,5,0,5,0
1746536866232,POLI 5D,B01,891178,Staff,5,0,5,0
1746536867259,POLI 11,A00,891179,Ferree; Karen E,2,0,35,33
1746536868284,POLI 12,A00,891180,Staff,16,0,30,14
1746536869310,POLI 27,A01,891182,Staff,12,0,75,63
1746536870337,POLI 30,A00,891183,Staff,9,0,50,41
1746536871364,POLI 100B,A00,891244,Staff,5,1,35,30
1746536872390,POLI 100I,A00,891247,Staff,7,0,30,23
1746536873416,POLI 104J,A00,891248,Nichter; Maysa,14,0,30,16
1746536874442,POLI 104U,A00,891250,Nichter; Maysa,2,0,30,28
1746536876497,POLI 110B,A00,891255,Wiens; David,20,0,25,5
1746536877527,POLI 112A,A00,891256,Wiens; David,6,0,25,19
1746536878553,POLI 114BR,A00,891261,Staff,19,0,30,11
1746536879585,POLI 117R,A00,891262,Forman; Fonna,0,6,50,50
1746536880610,POLI 118,A00,891264,Ingham; Sean,17,0,25,8
1746536881636,POLI 124A,A00,891265,Staff,18,0,20,2
1746536882665,POLI 125D,A00,891266,Nichter; Simeon C,2,0,25,23
1746536883693,POLI 126,A00,891268,Nichter; Simeon C,7,0,25,18
1746536884722,POLI 126AA,A00,891272,Staff,18,0,25,7
1746536885757,POLI 130AA,A00,891273,Staff,15,0,20,5
1746536886784,POLI 134AA,A00,891274,Staff,4,0,20,16
1746536888836,POLI 138,A00,891278,Staff,21,0,25,4
1746536889861,POLI 142K,A00,891280,Staff,11,0,25,14
1746536890893,POLI 142M,A00,891281,Gartzke; Erik,17,0,30,13
1746536891919,POLI 142P,A00,891284,Staff,20,0,30,10
1746536892945,POLI 143,A00,891285,Gartzke; Erik,12,0,30,18
1746536893974,POLI 153,A00,891286,Staff,19,0,20,1
1746536896031,POLI 175,A00,891290,Staff,15,0,20,5
1746536897060,PSYC 1,A00,890674,Steiner; Eric Tomas,0,11,45,45
1746536898086,PSYC 2,A00,890676,Albright; Thomas D,21,0,35,14
1746536899114,PSYC 3,A00,890679,Staff,17,0,20,3
1746536900145,PSYC 6,A00,959858,Staff,20,0,20,0
1746536901179,PSYC 60,A01,890684,Rickard; Timothy C.,0,5,45,45
1746536902209,PSYC 70,A01,890689,Geller; Emma Harlan,7,0,30,23
1746536903236,PSYC 71,A01,959860,Staff,21,0,25,4
1746536904271,PSYC 100,A00,890690,Lacefield; Katharine I,0,50,180,180
1746536905301,PSYC 102,A00,890695,Staff,18,0,40,22
1746536906326,PSYC 105,A00,890699,Geller; Emma Harlan,71,0,100,29
1746536907353,PSYC 106,A00,890701,Gorman; Michael R.,5,0,30,25
1746536908380,PSYC 108,A00,890704,Adrian; Julia Anna,0,28,50,50
1746536909410,PSYC 118,A01,890712,Staff,11,0,30,19
1746536910435,PSYC 124,A00,890716,Chapman; Eddie Nathaniel,25,0,60,35
1746536911461,PSYC 131,A00,890717,Anagnostaras; Stephan,0,7,80,80
1746536912489,PSYC 137,A00,890719,Winkielman; Piotr,0,11,30,30
1746536913514,PSYC 144,A00,890721,Adrian; Julia Anna,0,9,45,45
1746536914545,PSYC 162,A00,890805,Staff,2,0,75,73
1746536915574,PSYC 169,A00,890810,Staff,0,15,30,30
1746536916601,PSYC 172,A00,890814,Gorman; Michael R.,9,0,30,21
1746536917628,PSYC 181,A00,890818,Anagnostaras; Stephan,8,0,200,192
1746536918659,PSYC 184,A00,959861,Staff,170,0,175,5
1746536919688,PSYC 189,A00,890823,Staff,0,1,30,30
1746536920720,PSYC 191,A00,890884,Rickard; Timothy C.,0,11,35,35
1746536921747,PSYC 193,A00,890913,Staff,19,0,30,11
1746536921747,PSYC 193,B00,890914,Chapman; Eddie Nathaniel,24,0,30,6
1746536922777,PSYC 193L,A01,890918,Lowe; Angela Beth,20,0,30,10
1746536922777,PSYC 193L,B01,890921,Hurwitz; Ethan Scott,20,0,30,10
1746536922777,PSYC 193L,C01,890928,Staff,30,0,30,0
1746536923805,RELI 149,A00,886806,Rahimi; Babak,23,0,40,17
1746536924836,SE 9,A01,886814,Staff,7,0,20,13
1746536925864,SE 101B,A01,886816,Chadha; Mayank,4,0,35,31
1746536926896,SE 110B,A00,886818,Zhu; Qiang,4,0,75,71
1746536927924,SE 125,A01,886830,Staff,10,0,30,20
1746536928950,SE 130B,A01,886835,Staff,14,0,40,26
1746536929981,SE 131A,A01,886838,Krysl; Petr,34,0,55,21
1746536931011,SE 154,A00,886840,Staff,30,0,50,20
1746536932037,SE 164GS,A01,886849,Staff,6,0,20,14
1746536933065,SE 167GS,A01,886853,Staff,6,0,20,14
1746536934092,SIO 25,A01,890107,Staff,19,0,30,11
1746536935119,SIO 45,A00,890109,Cook; Geoffrey W,117,0,200,83
1746536936147,SIO 109R,A00,890110,Forman; Fonna,0,16,20,20
1746536937178,SIO 187,A01,890114,Kacev; David,15,0,40,25
1746536938213,SOCI 1,A01,890431,Thorpe; Charles Robert,15,0,30,15
1746536938213,SOCI 1,A02,890518,Thorpe; Charles Robert,30,0,30,0
1746536939240,SOCI 2,A01,957978,Staff,25,0,25,0
1746536939240,SOCI 2,A02,957979,Staff,23,0,25,2
1746536940272,SOCI 20,A01,890523,Calderon-Zaks; Michael Aar,23,0,30,7
1746536940272,SOCI 20,A02,890526,Calderon-Zaks; Michael Aar,29,0,30,1
1746536941306,SOCI 30,A01,890533,Pardo Guerra; Juan Pablo,37,0,40,3
1746536942336,SOCI 40,A01,890535,Staff,27,0,45,18
1746536943367,SOCI 104Q,A00,890559,Staff,18,0,30,12
1746536944392,SOCI 106,A00,890560,Arnal; Maud Marie Leonie,20,0,30,10
1746536945419,SOCI 110,A00,890567,Holkenbrink-Monk; Charlene,19,0,30,11
1746536946448,SOCI 112,A00,890568,Victoria Torres; Pablo,1,0,55,54
1746536947479,SOCI 115,A00,890597,Arnal; Maud Marie Leonie,28,0,45,17
1746536949532,SOCI 121,A00,890604,Pardo Guerra; Juan Pablo,38,0,45,7
1746536950557,SOCI 126,A01,890608,Staff,8,0,10,2
1746536951585,SOCI 127,A00,890609,Staff,18,0,30,12
1746536952614,SOCI 131,A00,890610,Thorpe; Charles Robert,37,0,45,8
1746536953641,SOCI 135,A00,890615,Payne; Christine Anna,14,0,45,31
1746536954669,SOCI 139,A00,890620,Staff,38,0,45,7
1746536955699,SOCI 148E,A00,890622,Calderon-Zaks; Michael Aar,36,0,45,9
1746536956731,SOCI 150,A00,890623,Kohler; Kristopher M.,31,0,45,14
1746536957762,SOCI 157,A00,890625,Jules-Rosette; Bennetta W.,18,0,20,2
1746536958786,SOCI 160,A00,890627,Payne; Christine Anna,21,0,45,24
1746536959815,SYN 1,A00,886855,Fish; Gwendolyn Anne,0,0,0,0
1746536959815,SYN 1,B00,906086,Fish; Gwendolyn Anne,0,1,0,2
1746536960843,SYN 2R,A00,886860,Staff,0,17,15,15
1746536960843,SYN 2R,B00,906106,Atkinson; Arthur Laird,0,16,15,15
1746536961873,SYN 100,A01,886866,Browne; Emily,0,28,20,20
1746536961873,SYN 100,B01,906128,Rock; Martin,0,5,20,20
1746536961873,SYN 100,C01,906140,Deavenport; James Cary,0,3,20,20
1746536961873,SYN 100,D01,907816,Deavenport; James Cary,0,5,20,20
1746536962903,TDAC 1,A00,890286,Walsh; Kim C.,9,0,20,11
1746536963930,TDAC 101,A00,890296,Basso; Beatrice,16,0,20,4
1746536964958,TDDE 131,A00,890297,Staff,47,0,50,3
1746536965989,TDDM 1,A00,890287,Weinberg; Sadie,25,0,30,5
1746536967024,TDGE 11,A00,890288,Fulton; Julia,137,0,200,63
1746536967024,TDGE 11,B00,890289,Castro; Robert Jess,184,0,200,16
1746536968052,TDGE 25,B00,957359,Walsh; Kim C.,3,0,20,17
1746536969083,TDGE 40,A01,890292,Power; Jade Yukana,27,0,30,3
1746536970110,TDGE 124,A00,890298,Havis; Allan,0,0,50,50
1746536971141,TDGE 131R,A00,890299,Burelle; Julie Sara Veronique,15,0,42,27
1746536972169,TDHT 101,A00,890300,Staff,10,0,20,10
1746536973196,TDHT 109,A01,890302,Anderson; Mysia Anyse,31,0,40,9
1746536974224,TDMV 1,A00,890293,Arcidiacono; Kristin,18,0,30,12
1746536975255,TDMV 2,A00,890294,Weinberg; Sadie,23,0,30,7
1746536976281,TDMV 3,A00,957878,Arcidiacono; Kristin,28,0,30,2
1746536978339,TDMV 138,A00,890304,Jun; Grace Shin Hae,25,0,40,15
1746536979369,TDMV 140,A00,890305,Corrales; Joseph Bernales,25,0,30,5
1746536980394,TDMV 142,A00,890307,Caligagan; Tony,32,0,40,8
1746536981420,TDMV 144,A00,890308,Camaya; Michelle Ann,25,0,30,5
1746536982450,TDPW 1,A00,890295,Stein; Deborah Isobel,3,0,20,17
1746536983481,USP 2,A01,890272,Lerner; Amy M,6,0,20,14
1746536984507,USP 3,A01,890274,Staff,12,0,30,18
1746536985535,USP 15,A01,890276,Sun; Feiyang,17,0,30,13
1746536986563,USP 25,A00,890277,Shenkman; Michael Thomas,19,0,25,6
1746536987592,USP 138,A00,890278,Staff,13,0,25,12
1746536988619,USP 143,A00,890279,Staff,21,0,70,49
1746536989649,USP 144,A00,890280,Chowdhury; Muhammed Zohir,16,0,30,14
1746536990678,USP 150,A00,890281,Boomhower; Matthew Charles,4,0,30,26
1746536991706,USP 151,A00,890282,Staff,16,0,20,4
1746536992735,USP 162,A00,890283,Andrews; Abigail Leslie,16,0,20,4
1746536993766,USP 168,A00,920477,Kwak; Nancy,1,0,5,4
1746536994797,USP 181,A00,890284,Staff,3,0,20,17
1746536995826,USP 191A,A00,890285,Staff,13,0,20,7
1746536996854,VIS 101,A00,886512,Staff,25,0,75,50
1746536997885,VIS 103,A00,886513,Cruz; Edwin Teddy,61,0,75,14
1746536998914,VIS 108,A00,886514,Staff,3,0,15,12
1746536999942,VIS 127P,A00,886515,Shen; Kuiyi,80,0,146,66
1746537000971,VIS 149,A00,886516,Yoldas; Pinar,0,0,15,15
1746537002006,VIS 164,A00,886526,Erdmann; Dean,19,0,22,3
1746537003035,VIS 194S,A00,886527,Staff,61,0,75,14
1746537004062,WCWP 10A,C00,886484,Martiniuk; Jill,12,0,15,3
1746537005092,WCWP 10B,A00,886490,Uriarte; Emma,0,0,15,15
1746537005092,WCWP 10B,B00,886491,Dhir; Simrita,11,0,15,4
1746537005092,WCWP 10B,C00,886492,Ornelas; Tricia,0,0,15,15
1746537006119,WCWP 100,A00,886494,Young; Mark T,0,7,15,15
1746537008246,AAS 10,A01,886199,Childs; Dennis R.,0,3,0,0
1746537009277,ANAR 104,A01,886940,Shtienberg; Gilad,27,0,30,3
1746537010303,ANAR 120,A00,886953,Staff,12,0,20,8
1746537011333,ANBI 148,A01,886955,Wilder; Linnea Lorene,30,0,40,10
1746537013390,ANSC 122,A00,886957,Staff,25,0,30,5
1746537014416,ANSC 150,A00,886958,Sloane; Julia Kathryn,3,0,15,12
1746537015443,ANSC 156,A00,886959,Jenkins; Janis A.,0,1,15,15
1746537016470,ANSC 180,A00,886960,Staff,11,0,17,6
1746537017502,ANSC 188,A00,886961,Jassal; Aftab,9,0,25,16
1746537018528,ANSC 190,A00,886962,Jassal; Aftab,14,0,25,11
1746537019557,ANSC 191,A00,886963,Staff,18,0,20,2
1746537020584,ANTH 3,A01,891689,Staff,17,0,20,3
1746537021613,ANTH 5,A00,886933,Semendeferi; Ekaterini,16,0,20,4
1746537022638,ANTH 10,A00,886934,Staff,0,12,30,30
1746537023666,ANTH 21,A01,886936,Staff,40,0,60,20
1746537024692,ANTH 23,A01,886938,Staff,92,0,100,8
1746537025719,ANTH 105,A00,886964,Stewart; Alexander B,84,0,100,16
1746537026745,ANTH 108,A00,886965,Pedersen; David,9,0,20,11
1746537027784,AWP 10,001,886147,Staff,0,0,0,0
1746537027784,AWP 10,002,886148,Staff,0,0,0,0
1746537027784,AWP 10,003,886149,Staff,0,0,0,0
1746537027784,AWP 10,004,886150,Staff,0,0,0,0
1746537027784,AWP 10,005,886151,Staff,0,0,0,0
1746537027784,AWP 10,006,886152,Staff,0,0,0,0
1746537027784,AWP 10,007,886153,Staff,0,0,0,0
1746537027784,AWP 10,008,886154,Staff,0,0,0,0
1746537027784,AWP 10,009,886155,Staff,0,0,0,0
1746537027784,AWP 10,010,886156,Staff,0,0,0,0
1746537027784,AWP 10,011,886158,Staff,0,0,0,0
1746537027784,AWP 10,012,886160,Staff,0,0,0,0
1746537027784,AWP 10,013,886161,Staff,0,0,0,0
1746537027784,AWP 10,014,886162,Staff,0,0,0,0
1746537027784,AWP 10,015,886163,Staff,0,0,0,0
1746537027784,AWP 10,016,886164,Staff,0,0,0,0
1746537027784,AWP 10,017,886165,Staff,0,0,0,0
1746537027784,AWP 10,018,886166,Staff,0,0,0,0
1746537027784,AWP 10,019,886168,Staff,0,0,0,0
1746537027784,AWP 10,020,886170,Staff,0,0,0,0
1746537027784,AWP 10,021,886172,Staff,0,0,0,0
1746537028813,AWP 10R,001,886173,Staff,0,1,0,0
1746537028813,AWP 10R,002,886174,Staff,0,1,0,0
1746537028813,AWP 10R,003,886175,Staff,0,0,0,0
1746537028813,AWP 10R,004,886176,Staff,0,0,0,0
1746537028813,AWP 10R,005,886177,Staff,0,0,0,0
1746537028813,AWP 10R,006,886178,Staff,0,0,0,0
1746537028813,AWP 10R,007,886179,Staff,0,0,0,0
1746537028813,AWP 10R,008,886181,Staff,0,0,0,0
1746537028813,AWP 10R,009,886182,Staff,0,0,0,0
1746537028813,AWP 10R,010,886183,Staff,0,0,0,0
1746537028813,AWP 10R,011,886184,Staff,0,0,0,0
1746537028813,AWP 10R,012,886185,Staff,0,0,0,0
1746537028813,AWP 10R,013,886186,Staff,0,0,0,0
1746537028813,AWP 10R,014,886187,Staff,0,0,0,0
1746537028813,AWP 10R,015,886188,Staff,0,0,0,0
1746537028813,AWP 10R,016,886189,Staff,0,0,0,0
1746537029840,AWP 102R,A00,886190,Staff,0,0,0,0
1746537029840,AWP 102R,B00,886191,Staff,0,0,0,0
1746537030867,BENG 100,A01,886193,Staff,17,0,30,13
1746537031897,BENG 122A,A01,886195,Hasty; Jeff M,13,0,30,17
1746537032924,BENG 166A,A00,886196,Sah; Robert Lie-Yuan,0,1,30,30
1746537033951,BENG 190,A00,958050,Khojah; Reem I,24,0,25,1
1746537034978,BIBC 102,A01,894320,Staff,0,0,46,46
1746537034978,BIBC 102,A02,894321,Staff,1,0,46,45
1746537034978,BIBC 102,A03,894344,Staff,7,0,46,39
1746537034978,BIBC 102,A04,894345,Staff,26,0,47,21
1746537036007,BICD 100R,A01,894365,Smith; Laurie,0,3,58,58
1746537036007,BICD 100R,A02,894366,Smith; Laurie,0,5,58,58
1746537036007,BICD 100R,A03,894367,Smith; Laurie,2,0,59,57
1746537036007,BICD 100R,A04,959869,Smith; Laurie,41,0,59,18
1746537037036,BICD 136,A01,894383,Gustafson-Brown; Cindy,14,0,50,36
1746537038068,BIEB 102,A01,894494,Butler; Shannon Rhey,51,0,130,79
1746537040136,BIEB 150,A01,894617,Wills; Christopher,3,0,20,17
1746537040136,BIEB 150,A02,894631,Wills; Christopher,3,0,20,17
1746537040136,BIEB 150,A03,894937,Wills; Christopher,3,0,20,17
1746537040136,BIEB 150,A04,894946,Wills; Christopher,5,0,20,15
1746537041164,BIEB 194,A00,906141,Kurle; Carolyn M.,6,0,20,14
1746537042191,BILD 1,A01,894154,Staff,2,0,19,17
1746537042191,BILD 1,A02,894155,Staff,14,0,19,5
1746537042191,BILD 1,A03,894160,Staff,13,0,19,6
1746537042191,BILD 1,A04,894161,Staff,15,0,18,3
1746537043219,BILD 2,A01,894168,Staff,0,0,50,50
1746537043219,BILD 2,A02,894169,Staff,0,0,50,50
1746537043219,BILD 2,A03,894179,Staff,4,0,50,46
1746537043219,BILD 2,A04,894203,Staff,27,0,50,23
1746537044246,BILD 3,A01,894213,Staff,22,0,31,9
1746537044246,BILD 3,A02,894214,Staff,26,0,31,5
1746537044246,BILD 3,A03,894235,Staff,28,0,31,3
1746537044246,BILD 3,A04,894236,Staff,28,0,32,4
1746537045274,BILD 4,A01,894253,Reuther; Keefe,5,0,24,19
1746537045274,BILD 4,A02,894258,Reuther; Keefe,16,0,24,8
1746537046303,BILD 5,A01,894276,Reuther; Keefe,35,0,50,15
1746537046303,BILD 5,A02,894277,Reuther; Keefe,45,0,50,5
1746537046303,BILD 5,A03,894290,Reuther; Keefe,44,0,50,6
1746537046303,BILD 5,A04,894291,Reuther; Keefe,48,0,50,2
1746537047331,BILD 24,A01,894297,Pirino; Giorgia,40,0,60,20
1746537048365,BIMM 100,B01,958915,Staff,72,0,100,28
1746537049396,BIMM 101,A01,895017,McDonnell; Lisa Marie,0,5,24,24
1746537049396,BIMM 101,A02,895018,McDonnell; Lisa Marie,0,5,24,24
1746537049396,BIMM 101,B01,895020,McDonnell; Lisa Marie,0,6,24,24
1746537049396,BIMM 101,B02,895021,McDonnell; Lisa Marie,0,4,24,24
1746537050425,BIMM 110,A01,895023,Staff,1,0,25,24
1746537050425,BIMM 110,A02,895024,Staff,9,0,25,16
1746537050425,BIMM 110,A03,895025,Staff,18,0,25,7
1746537050425,BIMM 110,A04,895031,Staff,20,0,25,5
1746537051457,BIMM 120,A01,895114,Gustafson-Brown; Cindy,13,0,28,15
1746537051457,BIMM 120,A02,895126,Gustafson-Brown; Cindy,21,0,27,6
1746537052487,BIPN 100,A01,895130,Yang; Mingyu,1,0,38,37
1746537052487,BIPN 100,A02,895131,Yang; Mingyu,32,0,38,6
1746537052487,BIPN 100,A03,895132,Yang; Mingyu,32,0,38,6
1746537052487,BIPN 100,A04,895133,Yang; Mingyu,27,0,36,9
1746537053515,BIPN 120,A01,895135,Cooke; James Edward,0,3,13,13
1746537053515,BIPN 120,A02,895136,Cooke; James Edward,0,1,13,13
1746537053515,BIPN 120,A03,895137,Cooke; James Edward,0,3,13,13
1746537053515,BIPN 120,A04,895156,Cooke; James Edward,0,2,11,11
1746537054542,BIPN 134,A01,895235,Cooke; James Edward,0,2,25,25
1746537054542,BIPN 134,A02,895237,Cooke; James Edward,0,0,25,25
1746537054542,BIPN 134,A03,895240,Cooke; James Edward,3,0,25,22
1746537054542,BIPN 134,A04,895270,Cooke; James Edward,20,0,25,5
1746537055569,BIPN 189,A00,892103,Staff,0,13,14,14
1746537057627,BISP 194,A00,958008,Staff,0,2,0,0
1746537058653,CAT 124,A01,922009,Staff,0,5,20,20
1746537059683,CAT 125R,A00,886390,Morales; Celeste Georgianna,0,2,20,20
1746537059683,CAT 125R,B00,886391,Irwin; Matthew Joseph,0,3,20,20
1746537059683,CAT 125R,C00,886392,Smith; Lauryn Alissa,0,2,20,20
1746537059683,CAT 125R,D00,886393,Vanderschuit; Maya Alysia,0,2,20,20
1746537059683,CAT 125R,E00,886394,Marchisotto; Jennifer Anne,0,4,20,20
1746537060709,CENG 15,A01,886218,Drews; Aaron,3,0,8,5
1746537061734,CENG 113,A00,886219,Opatkiewicz; Justin Paul,15,0,25,10
1746537062761,CGS 101,A00,887044,Staff,7,0,20,13
1746537063791,CGS 105,A01,887046,Staff,14,0,25,11
1746537064818,CGS 112,A00,887047,Cuong; Marisol,12,0,15,3
1746537065853,CGS 113,A00,887048,Staff,23,0,30,7
1746537066881,CGS 120,A00,887049,Staff,10,0,17,7
1746537067908,CHEM 6A,A01,886336,Lam; Tin Yiu,38,0,50,12
1746537067908,CHEM 6A,A02,886338,Lam; Tin Yiu,37,0,50,13
1746537068942,CHEM 6B,A01,886341,Hopkins; Patrycja Anna,16,0,50,34
1746537068942,CHEM 6B,A02,886343,Hopkins; Patrycja Anna,42,0,50,8
1746537069969,CHEM 6C,A01,886346,Albizati; Kim F.,0,2,50,50
1746537069969,CHEM 6C,A02,886348,Albizati; Kim F.,23,0,50,27
1746537071001,CHEM 40A,A01,886352,Klosterman; Jeremy K,65,0,100,35
1746537072028,CHEM 40B,A01,886356,Klosterman; Jeremy K,0,23,100,100
1746537073057,CHEM 41B,A01,886360,Theodorakis; Emmanuel,25,0,50,25
1746537073057,CHEM 41B,A02,886362,Theodorakis; Emmanuel,47,0,50,3
1746537074083,CHIN 165A,A00,886382,Xu; Li,18,0,20,2
1746537075116,CLAS 120,A00,886387,Myerston Santana; Jacobo,33,0,40,7
1746537076143,COGS 9,A01,886967,Shannon; Kyle Michael,42,0,60,18
1746537077172,COGS 11,A01,886969,Staff,11,0,30,19
1746537078202,COGS 14A,A01,886971,Staff,6,0,60,54
1746537079234,COGS 14B,A01,886973,Hoffman; Drew Ellen,4,0,60,56
1746537080262,COGS 18,A01,886975,Morgan; Eric,35,0,60,25
1746537081288,COGS 20,A01,886977,Staff,4,0,8,4
1746537081288,COGS 20,A02,886978,Staff,5,0,7,2
1746537082319,COGS 100,A01,907783,Staff,0,2,30,30
1746537083346,COGS 101B,A01,886980,Staff,0,3,48,48
1746537084378,COGS 101C,A01,886982,Delgado; Tania,0,5,44,44
1746537085408,COGS 102A,A01,886984,Johnson; Christine M.,4,0,30,26
1746537086433,COGS 118B,A01,886986,Staff,0,3,88,88
1746537087463,COGS 150,A01,886988,Bergen; Benjamin,23,0,50,27
1746537088492,COGS 153,A00,886989,Delgado; Tania,0,2,41,41
1746537089517,COGS 186,A01,886991,Staff,0,0,32,32
1746537090546,COGS 187A,A01,886993,Boyle; Mary E. T.,7,0,30,23
1746537091571,COGS 189,A00,886994,Staff,0,1,30,30
1746537092601,COMM 10,A01,886996,Staff,0,0,20,21
1746537092601,COMM 10,A02,886997,Staff,12,0,20,8
1746537092601,COMM 10,A03,959845,Staff,19,0,20,1
1746537093633,COMM 20,A01,886999,Leuning; Grant Maurstad,24,0,40,16
1746537095685,COMM 100A,A01,887002,Staff,0,0,20,25
1746537095685,COMM 100A,A02,887003,Staff,7,0,20,13
1746537096714,COMM 100B,A01,887005,Staff,0,8,20,24
1746537097739,COMM 106D,A00,887006,Staff,14,0,40,26
1746537098766,COMM 110G,A00,887007,Whitworth-Smith; Andrew C,12,0,40,28
1746537099791,COMM 111B,A00,887008,Staff,31,0,40,9
1746537100820,COMM 113T,A00,887009,Abuelhiga; Soraya Jill,28,0,40,12
1746537100820,COMM 113T,B00,906733,Staff,40,0,40,0
1746537101848,COMM 145,A00,887010,Staff,12,0,40,28
1746537102876,COMM 146,A00,887054,Staff,31,0,40,9
1746537103903,COMM 190,A00,887012,Staff,8,0,23,15
1746537104934,CSE 8A,A50,887015,Cao; Yingjun,57,0,85,28
1746537105959,CSE 11,A01,887017,Cao; Yingjun,12,0,70,58
1746537106986,CSE 20,A01,887019,Staff,30,0,50,20
1746537108019,CSE 21,A01,887021,Staff,78,0,100,22
1746537108019,CSE 21,B01,892583,Braun; Oliver,45,0,50,5
1746537109047,CSE 30,A01,887025,Eldon; John,143,0,200,57
1746537110073,CSE 100,A01,887027,Staff,26,0,50,24
1746537110073,CSE 100,A02,887028,Staff,40,0,50,10
1746537111103,CSE 101,A01,887030,Braun; Oliver,75,0,100,25
1746537111103,CSE 101,B01,887032,Jones; Miles E,0,3,50,50
1746537111103,CSE 101,B02,887033,Jones; Miles E,0,1,50,50
1746537112131,CSE 105,A01,908084,Jones; Miles E,32,0,50,18
1746537112131,CSE 105,A02,908087,Jones; Miles E,33,0,50,17
1746537113164,CSE 135,A01,887035,Powell; Thomas Allan,0,4,50,50
1746537114193,CSE 142,A01,887037,Staff,8,0,60,52
1746537115218,CSE 142L,A01,887039,Staff,34,0,60,26
1746537116251,CSE 151A,A01,887041,Solares; Edwin A,48,0,100,52
1746537117276,CSE 175,A01,887043,Kumar; Rakesh,30,0,30,0
1746537118303,CSS 1,A01,886389,Staff,0,1,40,40
1746537119333,DSC 30,A01,908097,Liao; Soohyun Nam,47,0,75,28
1746537120360,DSC 40A,A01,908099,Shannon; Kyle Michael,30,0,50,20
1746537121388,DSC 40B,A01,908112,Staff,16,0,50,34
1746537122428,DSC 80,A01,908116,Staff,19,0,60,41
1746537123454,DSC 197,001,956863,Eldridge; Justin Matthew,9999,0,9999,0
1746537124480,ECE 5,A01,886400,Morris; Karcher William,2,0,6,4
1746537124480,ECE 5,A02,886401,Morris; Karcher William,3,0,6,3
1746537125507,ECE 148,A01,886403,Silberman; Jack,0,14,14,14
1746537126536,ECON 1,A01,887265,Crane; Meredith Helen,12,0,70,58
1746537126536,ECON 1,B01,887268,Staff,43,0,50,7
1746537127562,ECON 2,A01,887273,Crane; Meredith Helen,56,0,70,14
1746537128589,ECON 3,A01,887279,Rondina; Giacomo,32,0,70,38
1746537129615,ECON 4,A01,887282,Anderson; John Charles,0,2,10,10
1746537130640,ECON 5,A01,887285,Staff,33,0,45,12
1746537130640,ECON 5,B01,887292,Staff,41,0,45,4
1746537131673,ECON 100A,A01,887337,Newhouse; Herbert S,54,0,70,16
1746537131673,ECON 100A,B01,887349,Staff,45,0,50,5
1746537132700,ECON 100B,A01,887361,Du; Songzi,29,0,70,41
1746537133730,ECON 100C,A01,887445,Newhouse; Herbert S,59,0,70,11
1746537134757,ECON 105,A00,887488,Vespa; Emanuel Ignacio,23,0,35,12
1746537135784,ECON 109,A01,887506,Shishkin; Denis,28,0,35,7
1746537136814,ECON 110A,A01,887568,Alon; Titan Michael,0,3,35,35
1746537136814,ECON 110A,B01,907601,Alon; Titan Michael,20,0,35,15
1746537137840,ECON 110B,A01,887598,Levkoff; Steven B.,0,23,70,70
1746537138867,ECON 112,A00,887599,Rondina; Giacomo,19,0,35,16
1746537139894,ECON 120A,A01,887603,Dai; Yinlin,36,0,70,34
1746537140928,ECON 120C,A01,887608,Sun; Yixiao,0,1,35,35
1746537140928,ECON 120C,B01,887614,Sun; Yixiao,0,0,35,35
1746537141955,ECON 138,A00,887621,Bharadwaj; Prashant,0,20,20,20
1746537142986,ECON 144,A00,958007,Squires; Dale E,13,0,35,22
1746537144017,ECON 171,A01,907666,Staff,18,0,35,17
1746537145044,ECON 175,A00,887626,Wu; Pak Yeung,23,0,35,12
1746537146070,ECON 190,A00,887640,Vespa; Emanuel Ignacio,23,0,35,12
1746537147115,EDS 25,A01,888197,Staff,0,0,0,0
1746537147115,EDS 25,A02,888209,Staff,0,0,0,0
1746537147115,EDS 25,A03,888210,Staff,0,0,0,0
1746537147115,EDS 25,A04,888212,Staff,0,0,0,0
1746537147115,EDS 25,A05,888213,Staff,0,0,0,0
1746537147115,EDS 25,A06,888214,Staff,0,0,0,0
1746537147115,EDS 25,A07,888235,Staff,0,2,0,0
1746537147115,EDS 25,A08,888236,Staff,0,0,0,0
1746537147115,EDS 25,A09,888240,Staff,0,0,0,0
1746537147115,EDS 25,A10,888244,Staff,0,0,0,0
1746537147115,EDS 25,B01,888273,Staff,0,0,0,0
1746537147115,EDS 25,B02,888285,Staff,0,0,0,0
1746537147115,EDS 25,B03,888423,Staff,0,0,0,1
1746537147115,EDS 25,B04,888432,Staff,0,0,0,0
1746537147115,EDS 25,B05,888433,Staff,0,0,0,0
1746537147115,EDS 25,B06,888467,Staff,0,0,0,0
1746537147115,EDS 25,B07,888468,Staff,0,0,0,0
1746537147115,EDS 25,B08,888479,Staff,0,0,0,0
1746537147115,EDS 25,B09,888484,Staff,0,0,0,0
1746537147115,EDS 25,B10,888487,Staff,0,0,0,0
1746537148147,EDS 38,A01,907700,Choi; Bailey Miyeon,30,0,30,0
1746537149174,EDS 112,A01,888601,Chapman; Thandeka K,14,0,40,26
1746537150205,EDS 115,A00,888697,Mendez; Kathrina Mendoza,10,0,30,20
1746537151236,EDS 116,A01,888893,Staff,35,0,40,5
1746537153295,EDS 124AR,A00,889133,Staff,29,0,50,21
1746537153295,EDS 124AR,B00,907471,Simon; Elizabeth A,37,0,50,13
1746537154322,EDS 124BR,A00,889134,Simon; Elizabeth A,45,0,100,55
1746537155350,EDS 125,A00,889135,Staff,25,0,30,5
1746537156381,EDS 126,A01,889138,Staff,36,0,40,4
1746537157407,EDS 164R,A01,889142,Wishard Guerra; Alison G.,33,0,50,17
1746537158437,ENG 30,A01,886396,Staff,0,0,0,0
1746537158437,ENG 30,B01,886398,Staff,0,0,0,0
1746537159465,ENVR 102,A00,906150,Montejo; Carolina,23,0,25,2
1746537160497,ETHN 103A,A00,887236,Man; Simeon S,0,3,0,0
1746537161522,ETHN 113,A00,887239,Staff,16,0,30,14
1746537162588,ETHN 116,A00,887240,Staff,16,0,25,9
1746537163616,ETHN 117,A00,887241,Choi; Esther Min,28,0,30,2
1746537164642,ETHN 118,A00,887243,Staff,24,0,30,6
1746537165668,ETHN 127,A00,887248,Cuong; Marisol,11,0,15,4
1746537166698,ETHN 139,A00,887250,Staff,7,0,10,3
1746537167729,ETHN 142,A00,887252,Staff,10,0,30,20
1746537168756,ETHN 161,A00,887253,Browne; Errol Tsekani,24,0,30,6
1746537169787,ETHN 163FR,A00,887255,Burelle; Julie Sara Veronique,0,0,5,5
1746537170815,GLBH 20,A00,889149,Elwardani; Nile Regina,8,0,42,34
1746537172871,GLBH 111,A01,889152,Burgos; Jose L.,17,0,17,0
1746537173899,GLBH 150,A00,889181,Sloane; Julia Kathryn,0,5,15,15
1746537175950,HDS 60,A01,886406,Warstadt; Melissa Fawn,73,0,80,7
1746537176976,HIAF 111,A00,889324,Gyamfi; Bright,25,0,32,7
1746537178004,HIEA 131,A00,889328,Staff,16,0,32,16
1746537179030,HIEA 144,A00,889333,Henry; Todd A.,26,0,32,6
1746537180056,HIEA 154,A00,889336,Henry; Todd A.,24,0,32,8
1746537181085,HIEU 106,A00,889339,Staff,22,0,32,10
1746537183147,HIEU 114,A00,889340,Staff,3,0,32,29
1746537184175,HIEU 135GS,A00,889342,Patterson; Patrick H.,0,0,1,24
1746537185205,HIEU 137,A00,889343,Edington; Claire Ellen,9,0,25,16
1746537186236,HIEU 148,A00,889345,Staff,14,0,32,18
1746537187261,HIEU 154,A00,889346,Biess; Frank Peter,21,0,32,11
1746537188288,HILA 102,A00,889351,Staff,12,0,32,20
1746537189313,HILD 2A,A01,889221,Lewandoski; Julia Mavis,1,10,32,31
1746537190340,HILD 7B,A01,889225,Man; Simeon S,0,13,32,32
1746537191366,HILD 7C,A01,889288,Alvarez; Luis A,0,14,32,32
1746537192406,HILD 30,A01,889323,Staff,0,5,32,32
1746537194458,HISC 119,A00,889383,Golan; Tal,21,0,32,11
1746537195485,HIUS 103,A00,889384,Man; Simeon S,0,0,32,32
1746537196510,HIUS 117,A00,919797,Kwak; Nancy,18,0,32,14
1746537197540,HIUS 142A,A00,919788,Staff,22,0,32,10
1746537199595,HIUS 149,A00,889386,Gyamfi; Bright,27,0,32,5
1746537200623,HIUS 155,A00,889387,Alvarez; Luis A,14,0,32,18
1746537201649,HUM 3,A01,886499,Caldwell; Michael Alan,19,0,50,31
1746537202677,HUM 3GS,A00,886500,Rodriguez; Bretton Sigfred,0,0,0,28
1746537203708,HUM 3R,A01,886502,Markman; Kristina,0,36,50,50
1746537204740,HUM 4,A01,886504,Crum; Matthew Stephen,24,0,50,26
1746537204740,HUM 4,B01,886506,West; Geoffrey Scott,17,0,50,33
1746537205765,HUM 4GS,A00,886507,Staff,0,0,0,19
1746537206792,HUM 5,A01,886509,Staff,32,0,50,18
1746537207822,HUM 5R,A01,886511,Zavodny; Tatiana Sophia,0,39,50,50
1746537208853,JAPN 180,A00,886407,Staff,18,0,40,22
1746537209883,LATI 50,A01,886409,Martin-Cabrera; Luis,4,0,22,18
1746537209883,LATI 50,A02,886410,Martin-Cabrera; Luis,19,0,22,3
1746537209883,LATI 50,A03,886411,Martin-Cabrera; Luis,21,0,22,1
1746537209883,LATI 50,A04,886412,Martin-Cabrera; Luis,9,0,22,13
1746537210909,LAWS 101,A00,907664,Staff,28,0,60,32
1746537211937,LIAB 1A,A00,889388,Saab; Dima,17,0,20,3
1746537212965,LIAB 1AX,A00,889389,El Cheddadi; Youniss,17,0,20,3
1746537213991,LIFR 1C,A00,889391,Van Moer; Vinciane G,8,0,20,12
1746537215018,LIFR 1CX,A00,889392,Van Moer; Vinciane G,7,0,20,13
1746537216048,LIFR 1D,A00,889393,Van Moer; Vinciane G,7,0,20,13
1746537217075,LIFR 1DX,A00,889394,Van Moer; Vinciane G,8,0,20,12
1746537218102,LIGN 7,A00,886923,Staff,24,0,50,26
1746537219129,LIGN 17,A00,886924,Kehler; Andrew Scott,125,0,150,25
1746537220155,LTAM 110,A00,889395,Staff,15,0,30,15
1746537221185,LTAM 110GS,A00,958010,Rodriguez; Bretton Sigfred,0,0,0,28
1746537222212,LTCH 101,A00,889397,Staff,23,0,25,2
1746537223239,LTCS 130,A00,889398,Staff,23,0,25,2
1746537224266,LTEA 138,A00,889399,Staff,24,0,40,16
1746537225292,LTEN 149,A00,889400,Wesling; Megan E.,0,3,25,25
1746537226319,LTEN 169,A00,889401,Staff,20,0,25,5
1746537227350,LTEN 180,A00,889402,Staff,10,0,15,5
1746537228376,LTEN 181,A00,889403,Staff,21,0,25,4
1746537229406,LTWL 100,A00,889404,Myerston Santana; Jacobo,3,0,25,22
1746537230430,LTWL 180GS,A00,889405,Staff,0,0,20,20
1746537231458,LTWL 181,A00,889406,Staff,17,0,25,8
1746537232483,LTWL 184,A00,889475,Mukherjee; Silpa,22,0,25,3
1746537233518,LTWR 102C,A00,889486,Staff,29,0,30,1
1746537234545,LTWR 115W,A00,889491,Staff,0,2,15,15
1746537235570,MAE 8,A01,886905,Staff,0,2,0,0
1746537236598,MAE 11,A00,886906,Bandaru; Prabhakar,0,7,50,50
1746537237625,MAE 20,A00,886907,Evdokimenko; Ekaterina,44,0,70,26
1746537238653,MAE 30B,A00,886909,Ghazinejad; Maziar,26,0,45,19
1746537239686,MAE 101B,A00,886910,Saintillan; David,29,0,45,16
1746537240711,MAE 105,A00,886911,Bandaru; Prabhakar,18,0,50,32
1746537241740,MAE 107,B00,958024,Staff,9,0,50,41
1746537242767,MAE 143B,A00,886913,Bewley; Thomas R,7,0,40,33
1746537243794,MAE 148,A01,886915,Silberman; Jack,0,3,14,14
1746537244819,MAE 160,A00,886916,Evdokimenko; Ekaterina,31,0,60,29
1746537245852,MATH 3C,A01,889681,Staff,0,3,30,30
1746537245852,MATH 3C,A02,960048,Staff,25,0,30,5
1746537246885,MATH 10A,A01,889760,Staff,26,0,30,4
1746537246885,MATH 10A,A02,889783,Staff,29,0,30,1
1746537247921,MATH 10B,A01,889785,Verstraete; Jacques Allan,2,0,35,33
1746537247921,MATH 10B,A02,889795,Verstraete; Jacques Allan,4,0,35,31
1746537247921,MATH 10B,B01,889797,Verstraete; Jacques Allan,3,0,35,32
1746537247921,MATH 10B,B02,889828,Verstraete; Jacques Allan,3,0,35,32
1746537248949,MATH 10C,A01,889849,Habib; Yousaf,9,0,30,21
1746537248949,MATH 10C,A02,889852,Habib; Yousaf,14,0,30,16
1746537248949,MATH 10C,A03,889853,Habib; Yousaf,22,0,30,8
1746537248949,MATH 10C,A04,889858,Habib; Yousaf,20,0,30,10
1746537248949,MATH 10C,B01,889861,Staff,1,0,30,29
1746537248949,MATH 10C,B02,889862,Staff,24,0,30,6
1746537248949,MATH 10C,B03,889863,Staff,27,0,30,3
1746537248949,MATH 10C,B04,889967,Staff,23,0,30,7
1746537249978,MATH 18,A01,889974,Staff,7,0,30,23
1746537249978,MATH 18,A02,889977,Staff,20,0,30,10
1746537249978,MATH 18,B01,889984,Hardiman; Liam,22,0,30,8
1746537249978,MATH 18,B02,889985,Hardiman; Liam,25,0,30,5
1746537251010,MATH 20A,A01,889990,Suk; Andrew Hoon,29,0,35,6
1746537252041,MATH 20B,A01,889993,Ohm; Ko Woon,22,0,30,8
1746537252041,MATH 20B,A02,889994,Ohm; Ko Woon,30,0,30,0
1746537252041,MATH 20B,B01,889996,Ohm; Ko Woon,21,0,30,9
1746537252041,MATH 20B,B02,889997,Ohm; Ko Woon,23,0,30,7
1746537253070,MATH 20C,A01,889999,Hammock; Frances H,17,0,30,13
1746537253070,MATH 20C,A02,890003,Hammock; Frances H,23,0,30,7
1746537253070,MATH 20C,B01,890006,Hammock; Frances H,3,0,30,27
1746537253070,MATH 20C,B02,890007,Hammock; Frances H,11,0,30,19
1746537254098,MATH 20D,A01,890011,Cheng; Hsiao-Bing,1,1,30,29
1746537254098,MATH 20D,A02,890012,Cheng; Hsiao-Bing,14,0,30,16
1746537254098,MATH 20D,B01,890016,Cheng; Hsiao-Bing,13,0,30,17
1746537254098,MATH 20D,B02,890017,Cheng; Hsiao-Bing,13,0,30,17
1746537255130,MATH 20E,A01,890026,Harel; Guershon,1,0,30,29
1746537255130,MATH 20E,A02,890029,Harel; Guershon,23,0,30,7
1746537255130,MATH 20E,B01,890033,Harel; Guershon,7,0,30,23
1746537255130,MATH 20E,B02,890101,Harel; Guershon,21,0,30,9
1746537256160,MATH 102,A01,890104,Staff,17,0,30,13
1746537256160,MATH 102,A02,890105,Staff,27,0,30,3
1746537257189,MATH 103B,A01,890116,Salehi Golsefidy; Alireza,3,0,30,27
1746537257189,MATH 103B,B01,890118,Staff,0,3,34,34
1746537258220,MATH 109,A01,890121,Aliabadi Sr.; Mohsen,1,0,30,29
1746537258220,MATH 109,B01,890124,Upadrashta; Pranav Kumar,18,0,30,12
1746537259252,MATH 120A,A01,890126,Eggers; John Dietrich,13,0,30,17
1746537260284,MATH 142B,A01,890128,Ioana; Adrian,19,0,30,11
1746537260284,MATH 142B,A02,890129,Ioana; Adrian,13,0,30,17
1746537261317,MATH 154,A01,890174,Staff,0,0,30,30
1746537261317,MATH 154,A02,890182,Staff,0,0,30,30
1746537262348,MATH 168A,A01,890197,Dumitriu; Ioana,21,0,35,14
1746537263375,MATH 170A,A01,890240,Nie; Jiawang,1,0,30,29
1746537263375,MATH 170A,A02,890241,Nie; Jiawang,11,0,30,19
1746537263375,MATH 170A,A03,890249,Nie; Jiawang,23,0,30,7
1746537264400,MATH 170B,A01,957891,Nag; Panchali,13,0,35,22
1746537266499,MATH 181A,A01,908025,Staff,0,4,35,35
1746537266499,MATH 181A,A02,960115,Staff,27,0,35,8
1746537267530,MATH 181B,A01,959874,Staff,26,0,30,4
1746537268556,MATH 193B,A01,890265,Staff,0,4,35,35
1746537269584,MGT 4,A01,890311,Anderson; John Charles,42,0,88,46
1746537270611,MGT 5,A00,907740,Staff,13,0,98,85
1746537271638,MGT 12,A00,890312,Lindenberger; Wade Douglas,67,0,98,31
1746537272667,MGT 16,A00,957883,Staff,78,0,98,20
1746537274717,MGT 45,A00,890314,Pecore; Joseph P.,47,0,98,51
1746537275742,MGT 71,A00,890315,Staff,0,11,98,98
1746537276769,MGT 100,A00,890316,Yavorsky; Daniel Ryan,44,0,98,54
1746537277796,MGT 103,A00,890317,Ehrich; Kristine R,73,0,98,25
1746537278827,MGT 105,A00,890356,Bates; Kenneth Walter,0,7,98,98
1746537279853,MGT 112,A00,890360,Ehrich; Kristine R,55,0,98,43
1746537280880,MGT 127R,A00,907732,Zhu; Kevin Xiaoguo,23,0,98,75
1746537281910,MGT 131B,A00,890361,Anderson; John Charles,61,0,98,37
1746537282936,MGT 137,A00,890362,Lindenberger; Wade Douglas,65,0,98,33
1746537283967,MGT 160,A00,890369,Johnson; Erik Barry,9,0,98,89
1746537286018,MGT 164,A00,890372,Zimmermann; Carsten,0,39,98,98
1746537287044,MGT 180,A00,890374,Bliss; Barbara Ann,12,0,98,86
1746537288072,MMW 15,A01,886414,Chang; Edmond Yi-Teh,0,12,28,28
1746537288072,MMW 15,A02,886415,Chang; Edmond Yi-Teh,0,8,28,28
1746537288072,MMW 15,A03,886416,Chang; Edmond Yi-Teh,0,8,28,28
1746537288072,MMW 15,A04,886417,Chang; Edmond Yi-Teh,0,8,28,28
1746537288072,MMW 15,B01,886419,Chang; Edmond Yi-Teh,0,7,28,28
1746537288072,MMW 15,B02,886420,Chang; Edmond Yi-Teh,0,8,28,28
1746537288072,MMW 15,B03,886421,Chang; Edmond Yi-Teh,0,7,28,28
1746537288072,MMW 15,B04,886422,Chang; Edmond Yi-Teh,0,8,28,28
1746537288072,MMW 15,C01,886424,Staff,0,9,28,28
1746537288072,MMW 15,C02,886425,Staff,0,8,28,28
1746537288072,MMW 15,C03,886426,Staff,0,8,28,28
1746537288072,MMW 15,C04,886427,Staff,0,7,28,28
1746537288072,MMW 15,C05,958038,Staff,0,7,28,28
1746537288072,MMW 15,C06,958039,Staff,0,8,28,28
1746537289103,MMW 15GS,A00,906910,Patterson; Patrick H.,4,0,28,24
1746537290136,MMW 122R,A01,886429,Rahimi; Babak,0,13,28,28
1746537290136,MMW 122R,A02,886430,Rahimi; Babak,0,12,28,28
1746537290136,MMW 122R,A03,958040,Rahimi; Babak,0,11,28,28
1746537291165,MUS 1A,A01,890937,Staff,3,0,25,22
1746537291165,MUS 1A,A02,891035,Staff,6,0,25,19
1746537291165,MUS 1A,C01,958912,Staff,24,0,25,1
1746537291165,MUS 1A,C02,958913,Staff,25,0,25,0
1746537293220,MUS 2AK,A00,957092,Ohnishi; Takae,15,0,15,0
1746537294253,MUS 4,A01,891044,Staff,2,0,25,23
1746537294253,MUS 4,A02,891045,Staff,23,0,25,2
1746537294253,MUS 4,B01,891048,Staff,17,0,25,8
1746537294253,MUS 4,B02,891050,Staff,25,0,25,0
1746537295279,MUS 5,A01,957506,Dubnov; Shlomo,0,0,25,25
1746537295279,MUS 5,A02,957622,Dubnov; Shlomo,14,0,25,11
1746537295279,MUS 5,A03,957623,Dubnov; Shlomo,20,0,25,5
1746537296311,MUS 6,A01,891053,Freitas Caetano; Marcelo,24,0,25,1
1746537296311,MUS 6,A02,891054,Freitas Caetano; Marcelo,23,0,25,2
1746537297335,MUS 7,A01,891081,Staff,0,0,25,25
1746537297335,MUS 7,A02,891082,Staff,4,0,25,21
1746537298362,MUS 8GS,A00,891118,Borgo; David Garcia,0,0,25,25
1746537299387,MUS 11,A01,891140,Staff,11,0,25,14
1746537299387,MUS 11,A02,891141,Staff,22,0,25,3
1746537300414,MUS 13,A01,891143,Staff,8,0,25,17
1746537300414,MUS 13,A02,891144,Staff,24,0,25,1
1746537301449,MUS 15,A01,891146,Staff,9,0,25,16
1746537301449,MUS 15,A02,891148,Staff,21,0,25,4
1746537301449,MUS 15,B01,891150,Staff,18,0,25,7
1746537301449,MUS 15,B02,891151,Staff,25,0,25,0
1746537302478,MUS 20,A01,891153,Staff,5,0,20,15
1746537302478,MUS 20,A02,891155,Staff,14,0,20,6
1746537303505,MUS 80,A00,891156,Staff,19,0,25,6
1746537303505,MUS 80,B00,891157,Staff,23,0,25,2
1746537304531,MUS 130,A00,891158,Ohnishi; Takae,35,0,35,0
1746537305558,MUS 150GS,A01,891160,Borgo; David Garcia,0,0,25,25
1746537306584,MUS 170,A01,891162,Freitas Caetano; Marcelo,20,0,25,5
1746537306584,MUS 170,A02,891164,Freitas Caetano; Marcelo,21,0,25,4
1746537307612,NANO 11,A00,886220,Vazquez Mena; Oscar,13,0,15,2
1746537308645,NANO 15,A01,886222,Drews; Aaron,4,0,7,3
1746537309672,NANO 104,A00,886224,Sirbuly; Donald,18,0,25,7
1746537310699,PH 40,A00,886528,Staff,23,0,40,17
1746537311725,PH 45,A01,886799,Staff,35,0,40,5
1746537312754,PH 110,A00,886802,Staff,0,7,40,40
1746537313780,PH 172,A00,906716,Staff,19,0,35,16
1746537314807,PH 191,A00,886803,Staff,6,0,40,34
1746537315838,PHIL 1,A00,889500,Staff,19,0,30,11
1746537316866,PHIL 10,A01,889549,Grush; Rick Scott,15,0,22,7
1746537316866,PHIL 10,A02,889551,Grush; Rick Scott,22,0,22,0
1746537317900,PHIL 28,A01,889559,Lamey; Andy M.,0,1,31,31
1746537317900,PHIL 28,A02,889561,Lamey; Andy M.,0,1,30,30
1746537317900,PHIL 28,A03,889572,Lamey; Andy M.,0,0,30,30
1746537318926,PHIL 35,A00,907839,Staff,13,0,15,2
1746537319952,PHIL 60,A00,889574,Staff,74,0,90,16
1746537320982,PHIL 101,A00,958004,Staff,13,0,15,2
1746537323036,PHIL 136,A00,889582,Fulkerson; Matthew Todd,26,0,45,19
1746537324065,PHIL 163,A01,889601,Staff,21,0,30,9
1746537324065,PHIL 163,B01,889606,Brandt; Reuven A,0,3,0,0
1746537325092,PHIL 164,A00,889610,Staff,16,0,30,14
1746537326122,PHIL 165,A00,889613,Staff,23,0,30,7
1746537327148,PHYS 1A,A00,886431,Staff,26,0,70,44
1746537328180,PHYS 1AL,001,886432,Tsai; Philbert S,0,2,30,30
1746537328180,PHYS 1AL,002,886436,Tsai; Philbert S,11,0,30,19
1746537329206,PHYS 1B,A00,886439,Staff,185,0,240,55
1746537330237,PHYS 1BL,001,886441,Tsai; Philbert S,0,4,30,30
1746537330237,PHYS 1BL,002,886444,Tsai; Philbert S,2,0,30,28
1746537331265,PHYS 1C,A00,896092,Arnold; Kam S,78,0,146,68
1746537332297,PHYS 1CL,001,886448,Tsai; Philbert S,0,0,30,30
1746537332297,PHYS 1CL,002,886449,Tsai; Philbert S,0,0,30,30
1746537332297,PHYS 1CL,003,886450,Tsai; Philbert S,15,0,30,15
1746537332297,PHYS 1CL,004,886451,Tsai; Philbert S,15,0,30,15
1746537333327,PHYS 2B,A01,886457,Staff,69,0,115,46
1746537334360,PHYS 2C,A01,886460,Shotwell; Brian,0,8,65,65
1746537335390,PHYS 2CL,A01,886467,Staff,0,4,28,28
1746537335390,PHYS 2CL,A02,886468,Staff,0,3,28,28
1746537336417,PHYS 2D,A01,886470,Staff,10,0,50,40
1746537337443,PHYS 4B,A01,886475,Grinstein; Benjamin,22,0,40,18
1746537338469,POLI 5,A00,891173,Desposato; Scott,7,0,25,18
1746537339495,POLI 5D,A01,891175,Staff,5,0,5,0
1746537339495,POLI 5D,B01,891178,Staff,5,0,5,0
1746537340521,POLI 11,A00,891179,Ferree; Karen E,2,0,35,33
1746537341550,POLI 12,A00,891180,Staff,16,0,30,14
1746537342579,POLI 27,A01,891182,Staff,12,0,75,63
1746537343605,POLI 30,A00,891183,Staff,9,0,50,41
1746537344631,POLI 100B,A00,891244,Staff,5,1,35,30
1746537345658,POLI 100I,A00,891247,Staff,7,0,30,23
1746537346687,POLI 104J,A00,891248,Nichter; Maysa,14,0,30,16
1746537347713,POLI 104U,A00,891250,Nichter; Maysa,2,0,30,28
1746537349767,POLI 110B,A00,891255,Wiens; David,20,0,25,5
1746537350796,POLI 112A,A00,891256,Wiens; David,6,0,25,19
1746537351822,POLI 114BR,A00,891261,Staff,19,0,30,11
1746537352847,POLI 117R,A00,891262,Forman; Fonna,0,6,50,50
1746537353875,POLI 118,A00,891264,Ingham; Sean,17,0,25,8
1746537354904,POLI 124A,A00,891265,Staff,18,0,20,2
1746537355935,POLI 125D,A00,891266,Nichter; Simeon C,2,0,25,23
1746537356961,POLI 126,A00,891268,Nichter; Simeon C,7,0,25,18
1746537357988,POLI 126AA,A00,891272,Staff,18,0,25,7
1746537359015,POLI 130AA,A00,891273,Staff,15,0,20,5
1746537360044,POLI 134AA,A00,891274,Staff,4,0,20,16
1746537362100,POLI 138,A00,891278,Staff,21,0,25,4
1746537363127,POLI 142K,A00,891280,Staff,11,0,25,14
1746537364156,POLI 142M,A00,891281,Gartzke; Erik,17,0,30,13
1746537365184,POLI 142P,A00,891284,Staff,20,0,30,10
1746537366211,POLI 143,A00,891285,Gartzke; Erik,12,0,30,18
1746537367242,POLI 153,A00,891286,Staff,19,0,20,1
1746537369297,POLI 175,A00,891290,Staff,15,0,20,5
1746537370363,PSYC 1,A00,890674,Steiner; Eric Tomas,0,11,45,45
1746537371394,PSYC 2,A00,890676,Albright; Thomas D,21,0,35,14
1746537372420,PSYC 3,A00,890679,Staff,17,0,20,3
1746537373452,PSYC 6,A00,959858,Staff,20,0,20,0
1746537374484,PSYC 60,A01,890684,Rickard; Timothy C.,0,5,45,45
1746537375511,PSYC 70,A01,890689,Geller; Emma Harlan,7,0,30,23
1746537376537,PSYC 71,A01,959860,Staff,21,0,25,4
1746537377564,PSYC 100,A00,890690,Lacefield; Katharine I,0,50,180,180
1746537378591,PSYC 102,A00,890695,Staff,18,0,40,22
1746537379620,PSYC 105,A00,890699,Geller; Emma Harlan,71,0,100,29
1746537380649,PSYC 106,A00,890701,Gorman; Michael R.,5,0,30,25
1746537381680,PSYC 108,A00,890704,Adrian; Julia Anna,0,28,50,50
1746537382710,PSYC 118,A01,890712,Staff,11,0,30,19
1746537383738,PSYC 124,A00,890716,Chapman; Eddie Nathaniel,25,0,60,35
1746537384775,PSYC 131,A00,890717,Anagnostaras; Stephan,0,7,80,80
1746537385806,PSYC 137,A00,890719,Winkielman; Piotr,0,11,30,30
1746537386834,PSYC 144,A00,890721,Adrian; Julia Anna,0,9,45,45
1746537387860,PSYC 162,A00,890805,Staff,2,0,75,73
1746537388887,PSYC 169,A00,890810,Staff,0,15,30,30
1746537389917,PSYC 172,A00,890814,Gorman; Michael R.,9,0,30,21
1746537390946,PSYC 181,A00,890818,Anagnostaras; Stephan,8,0,200,192
1746537391976,PSYC 184,A00,959861,Staff,170,0,175,5
1746537393010,PSYC 189,A00,890823,Staff,0,1,30,30
1746537394041,PSYC 191,A00,890884,Rickard; Timothy C.,0,11,35,35
1746537395069,PSYC 193,A00,890913,Staff,19,0,30,11
1746537395069,PSYC 193,B00,890914,Chapman; Eddie Nathaniel,24,0,30,6
1746537396116,PSYC 193L,A01,890918,Lowe; Angela Beth,20,0,30,10
1746537396116,PSYC 193L,B01,890921,Hurwitz; Ethan Scott,20,0,30,10
1746537396116,PSYC 193L,C01,890928,Staff,30,0,30,0
1746537397147,RELI 149,A00,886806,Rahimi; Babak,23,0,40,17
1746537398173,SE 9,A01,886814,Staff,7,0,20,13
1746537399205,SE 101B,A01,886816,Chadha; Mayank,4,0,35,31
1746537400233,SE 110B,A00,886818,Zhu; Qiang,4,0,75,71
1746537401259,SE 125,A01,886830,Staff,10,0,30,20
1746537402289,SE 130B,A01,886835,Staff,14,0,40,26
1746537403322,SE 131A,A01,886838,Krysl; Petr,34,0,55,21
1746537404351,SE 154,A00,886840,Staff,30,0,50,20
1746537405379,SE 164GS,A01,886849,Staff,6,0,20,14
1746537406405,SE 167GS,A01,886853,Staff,6,0,20,14
1746537407431,SIO 25,A01,890107,Staff,19,0,30,11
1746537408458,SIO 45,A00,890109,Cook; Geoffrey W,117,0,200,83
1746537409486,SIO 109R,A00,890110,Forman; Fonna,0,16,20,20
1746537410516,SIO 187,A01,890114,Kacev; David,15,0,40,25
1746537411545,SOCI 1,A01,890431,Thorpe; Charles Robert,15,0,30,15
1746537411545,SOCI 1,A02,890518,Thorpe; Charles Robert,30,0,30,0
1746537412572,SOCI 2,A01,957978,Staff,25,0,25,0
1746537412572,SOCI 2,A02,957979,Staff,23,0,25,2
1746537413603,SOCI 20,A01,890523,Calderon-Zaks; Michael Aar,23,0,30,7
1746537413603,SOCI 20,A02,890526,Calderon-Zaks; Michael Aar,29,0,30,1
1746537414634,SOCI 30,A01,890533,Pardo Guerra; Juan Pablo,37,0,40,3
1746537415660,SOCI 40,A01,890535,Staff,27,0,45,18
1746537416689,SOCI 104Q,A00,890559,Staff,18,0,30,12
1746537417721,SOCI 106,A00,890560,Arnal; Maud Marie Leonie,20,0,30,10
1746537418749,SOCI 110,A00,890567,Holkenbrink-Monk; Charlene,19,0,30,11
1746537419775,SOCI 112,A00,890568,Victoria Torres; Pablo,1,0,55,54
1746537420802,SOCI 115,A00,890597,Arnal; Maud Marie Leonie,28,0,45,17
1746537422851,SOCI 121,A00,890604,Pardo Guerra; Juan Pablo,38,0,45,7
1746537423880,SOCI 126,A01,890608,Staff,8,0,10,2
1746537424906,SOCI 127,A00,890609,Staff,18,0,30,12
1746537425931,SOCI 131,A00,890610,Thorpe; Charles Robert,37,0,45,8
1746537426958,SOCI 135,A00,890615,Payne; Christine Anna,14,0,45,31
1746537427983,SOCI 139,A00,890620,Staff,38,0,45,7
1746537429012,SOCI 148E,A00,890622,Calderon-Zaks; Michael Aar,36,0,45,9
1746537430043,SOCI 150,A00,890623,Kohler; Kristopher M.,31,0,45,14
1746537431068,SOCI 157,A00,890625,Jules-Rosette; Bennetta W.,18,0,20,2
1746537432093,SOCI 160,A00,890627,Payne; Christine Anna,21,0,45,24
1746537433120,SYN 1,A00,886855,Fish; Gwendolyn Anne,0,0,0,0
1746537433120,SYN 1,B00,906086,Fish; Gwendolyn Anne,0,1,0,2
1746537434147,SYN 2R,A00,886860,Staff,0,17,15,15
1746537434147,SYN 2R,B00,906106,Atkinson; Arthur Laird,0,16,15,15
1746537435177,SYN 100,A01,886866,Browne; Emily,0,28,20,20
1746537435177,SYN 100,B01,906128,Rock; Martin,0,5,20,20
1746537435177,SYN 100,C01,906140,Deavenport; James Cary,0,3,20,20
1746537435177,SYN 100,D01,907816,Deavenport; James Cary,0,5,20,20
1746537436204,TDAC 1,A00,890286,Walsh; Kim C.,9,0,20,11
1746537437236,TDAC 101,A00,890296,Basso; Beatrice,16,0,20,4
1746537438262,TDDE 131,A00,890297,Staff,47,0,50,3
1746537439288,TDDM 1,A00,890287,Weinberg; Sadie,25,0,30,5
1746537440320,TDGE 11,A00,890288,Fulton; Julia,137,0,200,63
1746537440320,TDGE 11,B00,890289,Castro; Robert Jess,184,0,200,16
1746537441353,TDGE 25,B00,957359,Walsh; Kim C.,3,0,20,17
1746537442383,TDGE 40,A01,890292,Power; Jade Yukana,27,0,30,3
1746537443409,TDGE 124,A00,890298,Havis; Allan,0,0,50,50
1746537444440,TDGE 131R,A00,890299,Burelle; Julie Sara Veronique,15,0,42,27
1746537445468,TDHT 101,A00,890300,Staff,10,0,20,10
1746537446495,TDHT 109,A01,890302,Anderson; Mysia Anyse,31,0,40,9
1746537447523,TDMV 1,A00,890293,Arcidiacono; Kristin,18,0,30,12
1746537448553,TDMV 2,A00,890294,Weinberg; Sadie,23,0,30,7
1746537449587,TDMV 3,A00,957878,Arcidiacono; Kristin,28,0,30,2
1746537451643,TDMV 138,A00,890304,Jun; Grace Shin Hae,25,0,40,15
1746537452668,TDMV 140,A00,890305,Corrales; Joseph Bernales,25,0,30,5
1746537453699,TDMV 142,A00,890307,Caligagan; Tony,32,0,40,8
1746537454724,TDMV 144,A00,890308,Camaya; Michelle Ann,25,0,30,5
1746537455753,TDPW 1,A00,890295,Stein; Deborah Isobel,3,0,20,17
1746537456782,USP 2,A01,890272,Lerner; Amy M,6,0,20,14
1746537457808,USP 3,A01,890274,Staff,12,0,30,18
1746537458840,USP 15,A01,890276,Sun; Feiyang,17,0,30,13
1746537459866,USP 25,A00,890277,Shenkman; Michael Thomas,19,0,25,6
1746537460895,USP 138,A00,890278,Staff,13,0,25,12
1746537461923,USP 143,A00,890279,Staff,21,0,70,49
1746537462955,USP 144,A00,890280,Chowdhury; Muhammed Zohir,16,0,30,14
1746537463982,USP 150,A00,890281,Boomhower; Matthew Charles,4,0,30,26
1746537465014,USP 151,A00,890282,Staff,16,0,20,4
1746537466040,USP 162,A00,890283,Andrews; Abigail Leslie,16,0,20,4
1746537467071,USP 168,A00,920477,Kwak; Nancy,1,0,5,4
1746537468100,USP 181,A00,890284,Staff,3,0,20,17
1746537469128,USP 191A,A00,890285,Staff,13,0,20,7
1746537470155,VIS 101,A00,886512,Staff,25,0,75,50
1746537471183,VIS 103,A00,886513,Cruz; Edwin Teddy,61,0,75,14
1746537472210,VIS 108,A00,886514,Staff,3,0,15,12
1746537473242,VIS 127P,A00,886515,Shen; Kuiyi,80,0,146,66
1746537474268,VIS 149,A00,886516,Yoldas; Pinar,0,0,15,15
1746537475293,VIS 164,A00,886526,Erdmann; Dean,19,0,22,3
1746537476322,VIS 194S,A00,886527,Staff,61,0,75,14
1746537477357,WCWP 10A,C00,886484,Martiniuk; Jill,12,0,15,3
1746537478383,WCWP 10B,A00,886490,Uriarte; Emma,0,0,15,15
1746537478383,WCWP 10B,B00,886491,Dhir; Simrita,11,0,15,4
1746537478383,WCWP 10B,C00,886492,Ornelas; Tricia,0,0,15,15
1746537479411,WCWP 100,A00,886494,Young; Mark T,0,7,15,15
1746537481559,AAS 10,A01,886199,Childs; Dennis R.,0,3,0,0
1746537482587,ANAR 104,A01,886940,Shtienberg; Gilad,27,0,30,3
1746537483616,ANAR 120,A00,886953,Staff,12,0,20,8
1746537484647,ANBI 148,A01,886955,Wilder; Linnea Lorene,30,0,40,10
1746537486705,ANSC 122,A00,886957,Staff,25,0,30,5
1746537487732,ANSC 150,A00,886958,Sloane; Julia Kathryn,3,0,15,12
1746537488762,ANSC 156,A00,886959,Jenkins; Janis A.,0,1,15,15
1746537489789,ANSC 180,A00,886960,Staff,11,0,17,6
1746537490823,ANSC 188,A00,886961,Jassal; Aftab,9,0,25,16
1746537491849,ANSC 190,A00,886962,Jassal; Aftab,14,0,25,11
1746537492878,ANSC 191,A00,886963,Staff,18,0,20,2
1746537493905,ANTH 3,A01,891689,Staff,17,0,20,3
1746537494935,ANTH 5,A00,886933,Semendeferi; Ekaterini,16,0,20,4
1746537495959,ANTH 10,A00,886934,Staff,0,12,30,30
1746537496986,ANTH 21,A01,886936,Staff,40,0,60,20
1746537498012,ANTH 23,A01,886938,Staff,92,0,100,8
1746537499037,ANTH 105,A00,886964,Stewart; Alexander B,84,0,100,16
1746537500070,ANTH 108,A00,886965,Pedersen; David,9,0,20,11
1746537501110,AWP 10,001,886147,Staff,0,0,0,0
1746537501110,AWP 10,002,886148,Staff,0,0,0,0
1746537501110,AWP 10,003,886149,Staff,0,0,0,0
1746537501110,AWP 10,004,886150,Staff,0,0,0,0
1746537501110,AWP 10,005,886151,Staff,0,0,0,0
1746537501110,AWP 10,006,886152,Staff,0,0,0,0
1746537501110,AWP 10,007,886153,Staff,0,0,0,0
1746537501110,AWP 10,008,886154,Staff,0,0,0,0
1746537501110,AWP 10,009,886155,Staff,0,0,0,0
1746537501110,AWP 10,010,886156,Staff,0,0,0,0
1746537501110,AWP 10,011,886158,Staff,0,0,0,0
1746537501110,AWP 10,012,886160,Staff,0,0,0,0
1746537501110,AWP 10,013,886161,Staff,0,0,0,0
1746537501110,AWP 10,014,886162,Staff,0,0,0,0
1746537501110,AWP 10,015,886163,Staff,0,0,0,0
1746537501110,AWP 10,016,886164,Staff,0,0,0,0
1746537501110,AWP 10,017,886165,Staff,0,0,0,0
1746537501110,AWP 10,018,886166,Staff,0,0,0,0
1746537501110,AWP 10,019,886168,Staff,0,0,0,0
1746537501110,AWP 10,020,886170,Staff,0,0,0,0
1746537501110,AWP 10,021,886172,Staff,0,0,0,0
1746537502139,AWP 10R,001,886173,Staff,0,1,0,0
1746537502139,AWP 10R,002,886174,Staff,0,1,0,0
1746537502139,AWP 10R,003,886175,Staff,0,0,0,0
1746537502139,AWP 10R,004,886176,Staff,0,0,0,0
1746537502139,AWP 10R,005,886177,Staff,0,0,0,0
1746537502139,AWP 10R,006,886178,Staff,0,0,0,0
1746537502139,AWP 10R,007,886179,Staff,0,0,0,0
1746537502139,AWP 10R,008,886181,Staff,0,0,0,0
1746537502139,AWP 10R,009,886182,Staff,0,0,0,0
1746537502139,AWP 10R,010,886183,Staff,0,0,0,0
1746537502139,AWP 10R,011,886184,Staff,0,0,0,0
1746537502139,AWP 10R,012,886185,Staff,0,0,0,0
1746537502139,AWP 10R,013,886186,Staff,0,0,0,0
1746537502139,AWP 10R,014,886187,Staff,0,0,0,0
1746537502139,AWP 10R,015,886188,Staff,0,0,0,0
1746537502139,AWP 10R,016,886189,Staff,0,0,0,0
1746537503168,AWP 102R,A00,886190,Staff,0,0,0,0
1746537503168,AWP 102R,B00,886191,Staff,0,0,0,0
1746537504194,BENG 100,A01,886193,Staff,17,0,30,13
1746537505220,BENG 122A,A01,886195,Hasty; Jeff M,13,0,30,17
1746537506253,BENG 166A,A00,886196,Sah; Robert Lie-Yuan,0,1,30,30
1746537507285,BENG 190,A00,958050,Khojah; Reem I,24,0,25,1
1746537508313,BIBC 102,A01,894320,Staff,0,0,46,46
1746537508313,BIBC 102,A02,894321,Staff,1,0,46,45
1746537508313,BIBC 102,A03,894344,Staff,7,0,46,39
1746537508313,BIBC 102,A04,894345,Staff,26,0,47,21
1746537509342,BICD 100R,A01,894365,Smith; Laurie,0,3,58,58
1746537509342,BICD 100R,A02,894366,Smith; Laurie,0,5,58,58
1746537509342,BICD 100R,A03,894367,Smith; Laurie,2,0,59,57
1746537509342,BICD 100R,A04,959869,Smith; Laurie,41,0,59,18
1746537510378,BICD 136,A01,894383,Gustafson-Brown; Cindy,14,0,50,36
1746537511403,BIEB 102,A01,894494,Butler; Shannon Rhey,51,0,130,79
1746537513464,BIEB 150,A01,894617,Wills; Christopher,3,0,20,17
1746537513464,BIEB 150,A02,894631,Wills; Christopher,3,0,20,17
1746537513464,BIEB 150,A03,894937,Wills; Christopher,3,0,20,17
1746537513464,BIEB 150,A04,894946,Wills; Christopher,5,0,20,15
1746537514490,BIEB 194,A00,906141,Kurle; Carolyn M.,6,0,20,14
1746537515517,BILD 1,A01,894154,Staff,2,0,19,17
1746537515517,BILD 1,A02,894155,Staff,14,0,19,5
1746537515517,BILD 1,A03,894160,Staff,13,0,19,6
1746537515517,BILD 1,A04,894161,Staff,15,0,18,3
1746537516542,BILD 2,A01,894168,Staff,0,0,50,50
1746537516542,BILD 2,A02,894169,Staff,0,0,50,50
1746537516542,BILD 2,A03,894179,Staff,4,0,50,46
1746537516542,BILD 2,A04,894203,Staff,27,0,50,23
1746537517572,BILD 3,A01,894213,Staff,22,0,31,9
1746537517572,BILD 3,A02,894214,Staff,26,0,31,5
1746537517572,BILD 3,A03,894235,Staff,28,0,31,3
1746537517572,BILD 3,A04,894236,Staff,28,0,32,4
1746537518599,BILD 4,A01,894253,Reuther; Keefe,5,0,24,19
1746537518599,BILD 4,A02,894258,Reuther; Keefe,16,0,24,8
1746537519626,BILD 5,A01,894276,Reuther; Keefe,35,0,50,15
1746537519626,BILD 5,A02,894277,Reuther; Keefe,45,0,50,5
1746537519626,BILD 5,A03,894290,Reuther; Keefe,44,0,50,6
1746537519626,BILD 5,A04,894291,Reuther; Keefe,48,0,50,2
1746537520658,BILD 24,A01,894297,Pirino; Giorgia,40,0,60,20
1746537521685,BIMM 100,B01,958915,Staff,72,0,100,28
1746537522714,BIMM 101,A01,895017,McDonnell; Lisa Marie,0,5,24,24
1746537522714,BIMM 101,A02,895018,McDonnell; Lisa Marie,0,5,24,24
1746537522714,BIMM 101,B01,895020,McDonnell; Lisa Marie,0,6,24,24
1746537522714,BIMM 101,B02,895021,McDonnell; Lisa Marie,0,4,24,24
1746537523743,BIMM 110,A01,895023,Staff,1,0,25,24
1746537523743,BIMM 110,A02,895024,Staff,9,0,25,16
1746537523743,BIMM 110,A03,895025,Staff,18,0,25,7
1746537523743,BIMM 110,A04,895031,Staff,20,0,25,5
1746537524778,BIMM 120,A01,895114,Gustafson-Brown; Cindy,13,0,28,15
1746537524778,BIMM 120,A02,895126,Gustafson-Brown; Cindy,21,0,27,6
1746537525804,BIPN 100,A01,895130,Yang; Mingyu,1,0,38,37
1746537525804,BIPN 100,A02,895131,Yang; Mingyu,32,0,38,6
1746537525804,BIPN 100,A03,895132,Yang; Mingyu,32,0,38,6
1746537525804,BIPN 100,A04,895133,Yang; Mingyu,27,0,36,9
1746537526830,BIPN 120,A01,895135,Cooke; James Edward,0,3,13,13
1746537526830,BIPN 120,A02,895136,Cooke; James Edward,0,1,13,13
1746537526830,BIPN 120,A03,895137,Cooke; James Edward,0,3,13,13
1746537526830,BIPN 120,A04,895156,Cooke; James Edward,0,2,11,11
1746537527863,BIPN 134,A01,895235,Cooke; James Edward,0,2,25,25
1746537527863,BIPN 134,A02,895237,Cooke; James Edward,0,0,25,25
1746537527863,BIPN 134,A03,895240,Cooke; James Edward,3,0,25,22
1746537527863,BIPN 134,A04,895270,Cooke; James Edward,20,0,25,5
1746537528889,BIPN 189,A00,892103,Staff,0,13,14,14
1746537530940,BISP 194,A00,958008,Staff,0,2,0,0
1746537531970,CAT 124,A01,922009,Staff,0,5,20,20
1746537533019,CAT 125R,A00,886390,Morales; Celeste Georgianna,0,2,20,20
1746537533019,CAT 125R,B00,886391,Irwin; Matthew Joseph,0,3,20,20
1746537533019,CAT 125R,C00,886392,Smith; Lauryn Alissa,0,2,20,20
1746537533019,CAT 125R,D00,886393,Vanderschuit; Maya Alysia,0,2,20,20
1746537533019,CAT 125R,E00,886394,Marchisotto; Jennifer Anne,0,4,20,20
1746537534043,CENG 15,A01,886218,Drews; Aaron,3,0,8,5
1746537535069,CENG 113,A00,886219,Opatkiewicz; Justin Paul,15,0,25,10
1746537536097,CGS 101,A00,887044,Staff,7,0,20,13
1746537537126,CGS 105,A01,887046,Staff,14,0,25,11
1746537538157,CGS 112,A00,887047,Cuong; Marisol,12,0,15,3
1746537539184,CGS 113,A00,887048,Staff,23,0,30,7
1746537540210,CGS 120,A00,887049,Staff,10,0,17,7
1746537541239,CHEM 6A,A01,886336,Lam; Tin Yiu,38,0,50,12
1746537541239,CHEM 6A,A02,886338,Lam; Tin Yiu,37,0,50,13
1746537542268,CHEM 6B,A01,886341,Hopkins; Patrycja Anna,16,0,50,34
1746537542268,CHEM 6B,A02,886343,Hopkins; Patrycja Anna,42,0,50,8
1746537543297,CHEM 6C,A01,886346,Albizati; Kim F.,0,2,50,50
1746537543297,CHEM 6C,A02,886348,Albizati; Kim F.,23,0,50,27
1746537544327,CHEM 40A,A01,886352,Klosterman; Jeremy K,65,0,100,35
1746537545355,CHEM 40B,A01,886356,Klosterman; Jeremy K,0,23,100,100
1746537546383,CHEM 41B,A01,886360,Theodorakis; Emmanuel,25,0,50,25
1746537546383,CHEM 41B,A02,886362,Theodorakis; Emmanuel,47,0,50,3
1746537547412,CHIN 165A,A00,886382,Xu; Li,18,0,20,2
1746537548440,CLAS 120,A00,886387,Myerston Santana; Jacobo,33,0,40,7
1746537549472,COGS 9,A01,886967,Shannon; Kyle Michael,42,0,60,18
1746537550501,COGS 11,A01,886969,Staff,11,0,30,19
1746537551529,COGS 14A,A01,886971,Staff,6,0,60,54
1746537552556,COGS 14B,A01,886973,Hoffman; Drew Ellen,4,0,60,56
1746537553584,COGS 18,A01,886975,Morgan; Eric,35,0,60,25
1746537554612,COGS 20,A01,886977,Staff,4,0,8,4
1746537554612,COGS 20,A02,886978,Staff,5,0,7,2
1746537555643,COGS 100,A01,907783,Staff,0,2,30,30
1746537556670,COGS 101B,A01,886980,Staff,0,3,48,48
1746537557701,COGS 101C,A01,886982,Delgado; Tania,0,5,44,44
1746537558727,COGS 102A,A01,886984,Johnson; Christine M.,4,0,30,26
1746537559756,COGS 118B,A01,886986,Staff,0,3,88,88
1746537560786,COGS 150,A01,886988,Bergen; Benjamin,23,0,50,27
1746537561817,COGS 153,A00,886989,Delgado; Tania,0,2,41,41
1746537562841,COGS 186,A01,886991,Staff,0,0,32,32
1746537563872,COGS 187A,A01,886993,Boyle; Mary E. T.,7,0,30,23
1746537564898,COGS 189,A00,886994,Staff,0,1,30,30
1746537565924,COMM 10,A01,886996,Staff,0,0,20,21
1746537565924,COMM 10,A02,886997,Staff,12,0,20,8
1746537565924,COMM 10,A03,959845,Staff,19,0,20,1
1746537566951,COMM 20,A01,886999,Leuning; Grant Maurstad,24,0,40,16
1746537569007,COMM 100A,A01,887002,Staff,0,0,20,25
1746537569007,COMM 100A,A02,887003,Staff,7,0,20,13
1746537570033,COMM 100B,A01,887005,Staff,0,8,20,24
1746537571060,COMM 106D,A00,887006,Staff,14,0,40,26
1746537572088,COMM 110G,A00,887007,Whitworth-Smith; Andrew C,12,0,40,28
1746537573115,COMM 111B,A00,887008,Staff,31,0,40,9
1746537574142,COMM 113T,A00,887009,Abuelhiga; Soraya Jill,28,0,40,12
1746537574142,COMM 113T,B00,906733,Staff,40,0,40,0
1746537575172,COMM 145,A00,887010,Staff,12,0,40,28
1746537576200,COMM 146,A00,887054,Staff,31,0,40,9
1746537577227,COMM 190,A00,887012,Staff,8,0,23,15
1746537578254,CSE 8A,A50,887015,Cao; Yingjun,57,0,85,28
1746537579284,CSE 11,A01,887017,Cao; Yingjun,12,0,70,58
1746537580311,CSE 20,A01,887019,Staff,30,0,50,20
1746537581345,CSE 21,A01,887021,Staff,78,0,100,22
1746537581345,CSE 21,B01,892583,Braun; Oliver,45,0,50,5
1746537582375,CSE 30,A01,887025,Eldon; John,143,0,200,57
1746537583406,CSE 100,A01,887027,Staff,26,0,50,24
1746537583406,CSE 100,A02,887028,Staff,40,0,50,10
1746537584435,CSE 101,A01,887030,Braun; Oliver,75,0,100,25
1746537584435,CSE 101,B01,887032,Jones; Miles E,0,3,50,50
1746537584435,CSE 101,B02,887033,Jones; Miles E,0,1,50,50
1746537585464,CSE 105,A01,908084,Jones; Miles E,32,0,50,18
1746537585464,CSE 105,A02,908087,Jones; Miles E,33,0,50,17
1746537586491,CSE 135,A01,887035,Powell; Thomas Allan,0,4,50,50
1746537587519,CSE 142,A01,887037,Staff,8,0,60,52
1746537588546,CSE 142L,A01,887039,Staff,34,0,60,26
1746537589577,CSE 151A,A01,887041,Solares; Edwin A,48,0,100,52
1746537590605,CSE 175,A01,887043,Kumar; Rakesh,30,0,30,0
1746537591636,CSS 1,A01,886389,Staff,0,1,40,40
1746537592668,DSC 30,A01,908097,Liao; Soohyun Nam,47,0,75,28
1746537593697,DSC 40A,A01,908099,Shannon; Kyle Michael,30,0,50,20
1746537594727,DSC 40B,A01,908112,Staff,16,0,50,34
1746537595755,DSC 80,A01,908116,Staff,19,0,60,41
1746537596782,DSC 197,001,956863,Eldridge; Justin Matthew,9999,0,9999,0
1746537597809,ECE 5,A01,886400,Morris; Karcher William,2,0,6,4
1746537597809,ECE 5,A02,886401,Morris; Karcher William,3,0,6,3
1746537598842,ECE 148,A01,886403,Silberman; Jack,0,14,14,14
1746537599870,ECON 1,A01,887265,Crane; Meredith Helen,12,0,70,58
1746537599870,ECON 1,B01,887268,Staff,43,0,50,7
1746537600898,ECON 2,A01,887273,Crane; Meredith Helen,56,0,70,14
1746537601926,ECON 3,A01,887279,Rondina; Giacomo,32,0,70,38
1746537602971,ECON 4,A01,887282,Anderson; John Charles,0,2,10,10
1746537604002,ECON 5,A01,887285,Staff,33,0,45,12
1746537604002,ECON 5,B01,887292,Staff,41,0,45,4
1746537605029,ECON 100A,A01,887337,Newhouse; Herbert S,54,0,70,16
1746537605029,ECON 100A,B01,887349,Staff,45,0,50,5
1746537606055,ECON 100B,A01,887361,Du; Songzi,29,0,70,41
1746537607081,ECON 100C,A01,887445,Newhouse; Herbert S,59,0,70,11
1746537608108,ECON 105,A00,887488,Vespa; Emanuel Ignacio,23,0,35,12
1746537609139,ECON 109,A01,887506,Shishkin; Denis,28,0,35,7
1746537610178,ECON 110A,A01,887568,Alon; Titan Michael,0,3,35,35
1746537610178,ECON 110A,B01,907601,Alon; Titan Michael,20,0,35,15
1746537611207,ECON 110B,A01,887598,Levkoff; Steven B.,0,23,70,70
1746537612240,ECON 112,A00,887599,Rondina; Giacomo,19,0,35,16
1746537613265,ECON 120A,A01,887603,Dai; Yinlin,36,0,70,34
1746537614290,ECON 120C,A01,887608,Sun; Yixiao,0,1,35,35
1746537614290,ECON 120C,B01,887614,Sun; Yixiao,0,0,35,35
1746537615316,ECON 138,A00,887621,Bharadwaj; Prashant,0,20,20,20
1746537616347,ECON 144,A00,958007,Squires; Dale E,13,0,35,22
1746537617378,ECON 171,A01,907666,Staff,18,0,35,17
1746537618409,ECON 175,A00,887626,Wu; Pak Yeung,23,0,35,12
1746537619434,ECON 190,A00,887640,Vespa; Emanuel Ignacio,23,0,35,12
1746537620470,EDS 25,A01,888197,Staff,0,0,0,0
1746537620470,EDS 25,A02,888209,Staff,0,0,0,0
1746537620470,EDS 25,A03,888210,Staff,0,0,0,0
1746537620470,EDS 25,A04,888212,Staff,0,0,0,0
1746537620470,EDS 25,A05,888213,Staff,0,0,0,0
1746537620470,EDS 25,A06,888214,Staff,0,0,0,0
1746537620470,EDS 25,A07,888235,Staff,0,2,0,0
1746537620470,EDS 25,A08,888236,Staff,0,0,0,0
1746537620470,EDS 25,A09,888240,Staff,0,0,0,0
1746537620470,EDS 25,A10,888244,Staff,0,0,0,0
1746537620470,EDS 25,B01,888273,Staff,0,0,0,0
1746537620470,EDS 25,B02,888285,Staff,0,0,0,0
1746537620470,EDS 25,B03,888423,Staff,0,0,0,1
1746537620470,EDS 25,B04,888432,Staff,0,0,0,0
1746537620470,EDS 25,B05,888433,Staff,0,0,0,0
1746537620470,EDS 25,B06,888467,Staff,0,0,0,0
1746537620470,EDS 25,B07,888468,Staff,0,0,0,0
1746537620470,EDS 25,B08,888479,Staff,0,0,0,0
1746537620470,EDS 25,B09,888484,Staff,0,0,0,0
1746537620470,EDS 25,B10,888487,Staff,0,0,0,0
1746537621500,EDS 38,A01,907700,Choi; Bailey Miyeon,30,0,30,0
1746537622530,EDS 112,A01,888601,Chapman; Thandeka K,14,0,40,26
1746537623561,EDS 115,A00,888697,Mendez; Kathrina Mendoza,10,0,30,20
1746537624590,EDS 116,A01,888893,Staff,35,0,40,5
1746537626646,EDS 124AR,A00,889133,Staff,29,0,50,21
1746537626646,EDS 124AR,B00,907471,Simon; Elizabeth A,37,0,50,13
1746537627673,EDS 124BR,A00,889134,Simon; Elizabeth A,45,0,100,55
1746537628700,EDS 125,A00,889135,Staff,25,0,30,5
1746537629726,EDS 126,A01,889138,Staff,36,0,40,4
1746537630755,EDS 164R,A01,889142,Wishard Guerra; Alison G.,33,0,50,17
1746537631780,ENG 30,A01,886396,Staff,0,0,0,0
1746537631780,ENG 30,B01,886398,Staff,0,0,0,0
1746537632811,ENVR 102,A00,906150,Montejo; Carolina,23,0,25,2
1746537633843,ETHN 103A,A00,887236,Man; Simeon S,0,3,0,0
1746537634868,ETHN 113,A00,887239,Staff,16,0,30,14
1746537635933,ETHN 116,A00,887240,Staff,16,0,25,9
1746537636966,ETHN 117,A00,887241,Choi; Esther Min,28,0,30,2
1746537637996,ETHN 118,A00,887243,Staff,24,0,30,6
1746537639021,ETHN 127,A00,887248,Cuong; Marisol,11,0,15,4
1746537640053,ETHN 139,A00,887250,Staff,7,0,10,3
1746537641082,ETHN 142,A00,887252,Staff,10,0,30,20
1746537642109,ETHN 161,A00,887253,Browne; Errol Tsekani,24,0,30,6
1746537643136,ETHN 163FR,A00,887255,Burelle; Julie Sara Veronique,0,0,5,5
1746537644162,GLBH 20,A00,889149,Elwardani; Nile Regina,8,0,42,34
1746537646220,GLBH 111,A01,889152,Burgos; Jose L.,17,0,17,0
1746537647248,GLBH 150,A00,889181,Sloane; Julia Kathryn,0,5,15,15
1746537649299,HDS 60,A01,886406,Warstadt; Melissa Fawn,73,0,80,7
1746537650326,HIAF 111,A00,889324,Gyamfi; Bright,25,0,32,7
1746537651353,HIEA 131,A00,889328,Staff,16,0,32,16
1746537652379,HIEA 144,A00,889333,Henry; Todd A.,26,0,32,6
1746537653408,HIEA 154,A00,889336,Henry; Todd A.,24,0,32,8
1746537654438,HIEU 106,A00,889339,Staff,22,0,32,10
1746537656489,HIEU 114,A00,889340,Staff,3,0,32,29
1746537657520,HIEU 135GS,A00,889342,Patterson; Patrick H.,0,0,1,24
1746537658548,HIEU 137,A00,889343,Edington; Claire Ellen,9,0,25,16
1746537659578,HIEU 148,A00,889345,Staff,14,0,32,18
1746537660608,HIEU 154,A00,889346,Biess; Frank Peter,21,0,32,11
1746537661635,HILA 102,A00,889351,Staff,12,0,32,20
1746537662665,HILD 2A,A01,889221,Lewandoski; Julia Mavis,1,10,32,31
1746537663692,HILD 7B,A01,889225,Man; Simeon S,0,13,32,32
1746537664716,HILD 7C,A01,889288,Alvarez; Luis A,0,14,32,32
1746537665743,HILD 30,A01,889323,Staff,0,5,32,32
1746537667795,HISC 119,A00,889383,Golan; Tal,21,0,32,11
1746537668824,HIUS 103,A00,889384,Man; Simeon S,0,0,32,32
1746537669850,HIUS 117,A00,919797,Kwak; Nancy,18,0,32,14
1746537670880,HIUS 142A,A00,919788,Staff,22,0,32,10
1746537672937,HIUS 149,A00,889386,Gyamfi; Bright,27,0,32,5
1746537673963,HIUS 155,A00,889387,Alvarez; Luis A,14,0,32,18
1746537674991,HUM 3,A01,886499,Caldwell; Michael Alan,19,0,50,31
1746537676017,HUM 3GS,A00,886500,Rodriguez; Bretton Sigfred,0,0,0,28
1746537677049,HUM 3R,A01,886502,Markman; Kristina,0,36,50,50
1746537678078,HUM 4,A01,886504,Crum; Matthew Stephen,24,0,50,26
1746537678078,HUM 4,B01,886506,West; Geoffrey Scott,17,0,50,33
1746537679104,HUM 4GS,A00,886507,Staff,0,0,0,19
1746537680129,HUM 5,A01,886509,Staff,32,0,50,18
1746537681159,HUM 5R,A01,886511,Zavodny; Tatiana Sophia,0,39,50,50
1746537682185,JAPN 180,A00,886407,Staff,18,0,40,22
1746537683213,LATI 50,A01,886409,Martin-Cabrera; Luis,4,0,22,18
1746537683213,LATI 50,A02,886410,Martin-Cabrera; Luis,19,0,22,3
1746537683213,LATI 50,A03,886411,Martin-Cabrera; Luis,21,0,22,1
1746537683213,LATI 50,A04,886412,Martin-Cabrera; Luis,9,0,22,13
1746537684241,LAWS 101,A00,907664,Staff,28,0,60,32
1746537685272,LIAB 1A,A00,889388,Saab; Dima,17,0,20,3
1746537686298,LIAB 1AX,A00,889389,El Cheddadi; Youniss,17,0,20,3
1746537687328,LIFR 1C,A00,889391,Van Moer; Vinciane G,8,0,20,12
1746537688354,LIFR 1CX,A00,889392,Van Moer; Vinciane G,7,0,20,13
1746537689385,LIFR 1D,A00,889393,Van Moer; Vinciane G,7,0,20,13
1746537690416,LIFR 1DX,A00,889394,Van Moer; Vinciane G,8,0,20,12
1746537691441,LIGN 7,A00,886923,Staff,24,0,50,26
1746537692468,LIGN 17,A00,886924,Kehler; Andrew Scott,125,0,150,25
1746537693496,LTAM 110,A00,889395,Staff,15,0,30,15
1746537694522,LTAM 110GS,A00,958010,Rodriguez; Bretton Sigfred,0,0,0,28
1746537695548,LTCH 101,A00,889397,Staff,23,0,25,2
1746537696577,LTCS 130,A00,889398,Staff,23,0,25,2
1746537697603,LTEA 138,A00,889399,Staff,24,0,40,16
1746537698632,LTEN 149,A00,889400,Wesling; Megan E.,0,3,25,25
1746537699659,LTEN 169,A00,889401,Staff,20,0,25,5
1746537700689,LTEN 180,A00,889402,Staff,10,0,15,5
1746537701716,LTEN 181,A00,889403,Staff,21,0,25,4
1746537702743,LTWL 100,A00,889404,Myerston Santana; Jacobo,3,0,25,22
1746537703768,LTWL 180GS,A00,889405,Staff,0,0,20,20
1746537704799,LTWL 181,A00,889406,Staff,17,0,25,8
1746537705826,LTWL 184,A00,889475,Mukherjee; Silpa,22,0,25,3
1746537706851,LTWR 102C,A00,889486,Staff,29,0,30,1
1746537707878,LTWR 115W,A00,889491,Staff,0,2,15,15
1746537708909,MAE 8,A01,886905,Staff,0,2,0,0
1746537709936,MAE 11,A00,886906,Bandaru; Prabhakar,0,7,50,50
1746537710960,MAE 20,A00,886907,Evdokimenko; Ekaterina,44,0,70,26
1746537711990,MAE 30B,A00,886909,Ghazinejad; Maziar,26,0,45,19
1746537713016,MAE 101B,A00,886910,Saintillan; David,29,0,45,16
1746537714043,MAE 105,A00,886911,Bandaru; Prabhakar,18,0,50,32
1746537715071,MAE 107,B00,958024,Staff,9,0,50,41
1746537716103,MAE 143B,A00,886913,Bewley; Thomas R,7,0,40,33
1746537717128,MAE 148,A01,886915,Silberman; Jack,0,3,14,14
1746537718158,MAE 160,A00,886916,Evdokimenko; Ekaterina,31,0,60,29
1746537719189,MATH 3C,A01,889681,Staff,0,3,30,30
1746537719189,MATH 3C,A02,960048,Staff,25,0,30,5
1746537720216,MATH 10A,A01,889760,Staff,26,0,30,4
1746537720216,MATH 10A,A02,889783,Staff,29,0,30,1
1746537721249,MATH 10B,A01,889785,Verstraete; Jacques Allan,2,0,35,33
1746537721249,MATH 10B,A02,889795,Verstraete; Jacques Allan,4,0,35,31
1746537721249,MATH 10B,B01,889797,Verstraete; Jacques Allan,3,0,35,32
1746537721249,MATH 10B,B02,889828,Verstraete; Jacques Allan,3,0,35,32
1746537722286,MATH 10C,A01,889849,Habib; Yousaf,9,0,30,21
1746537722286,MATH 10C,A02,889852,Habib; Yousaf,14,0,30,16
1746537722286,MATH 10C,A03,889853,Habib; Yousaf,22,0,30,8
1746537722286,MATH 10C,A04,889858,Habib; Yousaf,20,0,30,10
1746537722286,MATH 10C,B01,889861,Staff,1,0,30,29
1746537722286,MATH 10C,B02,889862,Staff,24,0,30,6
1746537722286,MATH 10C,B03,889863,Staff,27,0,30,3
1746537722286,MATH 10C,B04,889967,Staff,23,0,30,7
1746537723315,MATH 18,A01,889974,Staff,7,0,30,23
1746537723315,MATH 18,A02,889977,Staff,20,0,30,10
1746537723315,MATH 18,B01,889984,Hardiman; Liam,22,0,30,8
1746537723315,MATH 18,B02,889985,Hardiman; Liam,25,0,30,5
1746537724341,MATH 20A,A01,889990,Suk; Andrew Hoon,29,0,35,6
1746537725368,MATH 20B,A01,889993,Ohm; Ko Woon,22,0,30,8
1746537725368,MATH 20B,A02,889994,Ohm; Ko Woon,30,0,30,0
1746537725368,MATH 20B,B01,889996,Ohm; Ko Woon,21,0,30,9
1746537725368,MATH 20B,B02,889997,Ohm; Ko Woon,23,0,30,7
1746537726396,MATH 20C,A01,889999,Hammock; Frances H,17,0,30,13
1746537726396,MATH 20C,A02,890003,Hammock; Frances H,23,0,30,7
1746537726396,MATH 20C,B01,890006,Hammock; Frances H,3,0,30,27
1746537726396,MATH 20C,B02,890007,Hammock; Frances H,11,0,30,19
1746537727424,MATH 20D,A01,890011,Cheng; Hsiao-Bing,1,1,30,29
1746537727424,MATH 20D,A02,890012,Cheng; Hsiao-Bing,14,0,30,16
1746537727424,MATH 20D,B01,890016,Cheng; Hsiao-Bing,13,0,30,17
1746537727424,MATH 20D,B02,890017,Cheng; Hsiao-Bing,13,0,30,17
1746537728458,MATH 20E,A01,890026,Harel; Guershon,1,0,30,29
1746537728458,MATH 20E,A02,890029,Harel; Guershon,23,0,30,7
1746537728458,MATH 20E,B01,890033,Harel; Guershon,7,0,30,23
1746537728458,MATH 20E,B02,890101,Harel; Guershon,21,0,30,9
1746537729485,MATH 102,A01,890104,Staff,17,0,30,13
1746537729485,MATH 102,A02,890105,Staff,27,0,30,3
1746537730512,MATH 103B,A01,890116,Salehi Golsefidy; Alireza,3,0,30,27
1746537730512,MATH 103B,B01,890118,Staff,0,3,34,34
1746537731552,MATH 109,A01,890121,Aliabadi Sr.; Mohsen,1,0,30,29
1746537731552,MATH 109,B01,890124,Upadrashta; Pranav Kumar,18,0,30,12
1746537732580,MATH 120A,A01,890126,Eggers; John Dietrich,13,0,30,17
1746537733617,MATH 142B,A01,890128,Ioana; Adrian,19,0,30,11
1746537733617,MATH 142B,A02,890129,Ioana; Adrian,13,0,30,17
1746537734645,MATH 154,A01,890174,Staff,0,0,30,30
1746537734645,MATH 154,A02,890182,Staff,0,0,30,30
1746537735676,MATH 168A,A01,890197,Dumitriu; Ioana,21,0,35,14
1746537736709,MATH 170A,A01,890240,Nie; Jiawang,1,0,30,29
1746537736709,MATH 170A,A02,890241,Nie; Jiawang,11,0,30,19
1746537736709,MATH 170A,A03,890249,Nie; Jiawang,23,0,30,7
1746537737739,MATH 170B,A01,957891,Nag; Panchali,13,0,35,22
1746537739832,MATH 181A,A01,908025,Staff,0,4,35,35
1746537739832,MATH 181A,A02,960115,Staff,27,0,35,8
1746537740859,MATH 181B,A01,959874,Staff,26,0,30,4
1746537741886,MATH 193B,A01,890265,Staff,0,4,35,35
1746537742919,MGT 4,A01,890311,Anderson; John Charles,42,0,88,46
1746537743948,MGT 5,A00,907740,Staff,13,0,98,85
1746537744975,MGT 12,A00,890312,Lindenberger; Wade Douglas,67,0,98,31
1746537746001,MGT 16,A00,957883,Staff,78,0,98,20
1746537748054,MGT 45,A00,890314,Pecore; Joseph P.,47,0,98,51
1746537749081,MGT 71,A00,890315,Staff,0,11,98,98
1746537750111,MGT 100,A00,890316,Yavorsky; Daniel Ryan,44,0,98,54
1746537751145,MGT 103,A00,890317,Ehrich; Kristine R,73,0,98,25
1746537752172,MGT 105,A00,890356,Bates; Kenneth Walter,0,7,98,98
1746537753201,MGT 112,A00,890360,Ehrich; Kristine R,55,0,98,43
1746537754227,MGT 127R,A00,907732,Zhu; Kevin Xiaoguo,23,0,98,75
1746537755252,MGT 131B,A00,890361,Anderson; John Charles,61,0,98,37
1746537756279,MGT 137,A00,890362,Lindenberger; Wade Douglas,65,0,98,33
1746537757309,MGT 160,A00,890369,Johnson; Erik Barry,9,0,98,89
1746537759365,MGT 164,A00,890372,Zimmermann; Carsten,0,39,98,98
1746537760391,MGT 180,A00,890374,Bliss; Barbara Ann,12,0,98,86
1746537761425,MMW 15,A01,886414,Chang; Edmond Yi-Teh,0,12,28,28
1746537761425,MMW 15,A02,886415,Chang; Edmond Yi-Teh,0,8,28,28
1746537761425,MMW 15,A03,886416,Chang; Edmond Yi-Teh,0,8,28,28
1746537761425,MMW 15,A04,886417,Chang; Edmond Yi-Teh,0,8,28,28
1746537761425,MMW 15,B01,886419,Chang; Edmond Yi-Teh,0,7,28,28
1746537761425,MMW 15,B02,886420,Chang; Edmond Yi-Teh,0,8,28,28
1746537761425,MMW 15,B03,886421,Chang; Edmond Yi-Teh,0,7,28,28
1746537761425,MMW 15,B04,886422,Chang; Edmond Yi-Teh,0,8,28,28
1746537761425,MMW 15,C01,886424,Staff,0,9,28,28
1746537761425,MMW 15,C02,886425,Staff,0,8,28,28
1746537761425,MMW 15,C03,886426,Staff,0,8,28,28
1746537761425,MMW 15,C04,886427,Staff,0,7,28,28
1746537761425,MMW 15,C05,958038,Staff,0,7,28,28
1746537761425,MMW 15,C06,958039,Staff,0,8,28,28
1746537762455,MMW 15GS,A00,906910,Patterson; Patrick H.,4,0,28,24
1746537763486,MMW 122R,A01,886429,Rahimi; Babak,0,13,28,28
1746537763486,MMW 122R,A02,886430,Rahimi; Babak,0,12,28,28
1746537763486,MMW 122R,A03,958040,Rahimi; Babak,0,11,28,28
1746537764515,MUS 1A,A01,890937,Staff,3,0,25,22
1746537764515,MUS 1A,A02,891035,Staff,6,0,25,19
1746537764515,MUS 1A,C01,958912,Staff,24,0,25,1
1746537764515,MUS 1A,C02,958913,Staff,25,0,25,0
1746537766566,MUS 2AK,A00,957092,Ohnishi; Takae,15,0,15,0
1746537767596,MUS 4,A01,891044,Staff,2,0,25,23
1746537767596,MUS 4,A02,891045,Staff,23,0,25,2
1746537767596,MUS 4,B01,891048,Staff,17,0,25,8
1746537767596,MUS 4,B02,891050,Staff,25,0,25,0
1746537768629,MUS 5,A01,957506,Dubnov; Shlomo,0,0,25,25
1746537768629,MUS 5,A02,957622,Dubnov; Shlomo,14,0,25,11
1746537768629,MUS 5,A03,957623,Dubnov; Shlomo,20,0,25,5
1746537769660,MUS 6,A01,891053,Freitas Caetano; Marcelo,24,0,25,1
1746537769660,MUS 6,A02,891054,Freitas Caetano; Marcelo,23,0,25,2
1746537770686,MUS 7,A01,891081,Staff,0,0,25,25
1746537770686,MUS 7,A02,891082,Staff,4,0,25,21
1746537771713,MUS 8GS,A00,891118,Borgo; David Garcia,0,0,25,25
1746537772739,MUS 11,A01,891140,Staff,11,0,25,14
1746537772739,MUS 11,A02,891141,Staff,22,0,25,3
1746537773767,MUS 13,A01,891143,Staff,8,0,25,17
1746537773767,MUS 13,A02,891144,Staff,24,0,25,1
1746537774793,MUS 15,A01,891146,Staff,9,0,25,16
1746537774793,MUS 15,A02,891148,Staff,21,0,25,4
1746537774793,MUS 15,B01,891150,Staff,18,0,25,7
1746537774793,MUS 15,B02,891151,Staff,25,0,25,0
1746537775821,MUS 20,A01,891153,Staff,5,0,20,15
1746537775821,MUS 20,A02,891155,Staff,14,0,20,6
1746537776847,MUS 80,A00,891156,Staff,19,0,25,6
1746537776847,MUS 80,B00,891157,Staff,23,0,25,2
1746537777875,MUS 130,A00,891158,Ohnishi; Takae,35,0,35,0
1746537778899,MUS 150GS,A01,891160,Borgo; David Garcia,0,0,25,25
1746537779925,MUS 170,A01,891162,Freitas Caetano; Marcelo,20,0,25,5
1746537779925,MUS 170,A02,891164,Freitas Caetano; Marcelo,21,0,25,4
1746537780953,NANO 11,A00,886220,Vazquez Mena; Oscar,13,0,15,2
1746537781985,NANO 15,A01,886222,Drews; Aaron,4,0,7,3
1746537783017,NANO 104,A00,886224,Sirbuly; Donald,18,0,25,7
1746537784047,PH 40,A00,886528,Staff,23,0,40,17
1746537785073,PH 45,A01,886799,Staff,35,0,40,5
1746537786098,PH 110,A00,886802,Staff,0,7,40,40
1746537787127,PH 172,A00,906716,Staff,19,0,35,16
1746537788155,PH 191,A00,886803,Staff,6,0,40,34
1746537789183,PHIL 1,A00,889500,Staff,19,0,30,11
1746537790221,PHIL 10,A01,889549,Grush; Rick Scott,15,0,22,7
1746537790221,PHIL 10,A02,889551,Grush; Rick Scott,22,0,22,0
1746537791249,PHIL 28,A01,889559,Lamey; Andy M.,0,1,31,31
1746537791249,PHIL 28,A02,889561,Lamey; Andy M.,0,1,30,30
1746537791249,PHIL 28,A03,889572,Lamey; Andy M.,0,0,30,30
1746537792276,PHIL 35,A00,907839,Staff,13,0,15,2
1746537793303,PHIL 60,A00,889574,Staff,74,0,90,16
1746537794334,PHIL 101,A00,958004,Staff,13,0,15,2
1746537796386,PHIL 136,A00,889582,Fulkerson; Matthew Todd,26,0,45,19
1746537797418,PHIL 163,A01,889601,Staff,21,0,30,9
1746537797418,PHIL 163,B01,889606,Brandt; Reuven A,0,3,0,0
1746537798444,PHIL 164,A00,889610,Staff,16,0,30,14
1746537799470,PHIL 165,A00,889613,Staff,23,0,30,7
1746537800496,PHYS 1A,A00,886431,Staff,26,0,70,44
1746537801524,PHYS 1AL,001,886432,Tsai; Philbert S,0,2,30,30
1746537801524,PHYS 1AL,002,886436,Tsai; Philbert S,11,0,30,19
1746537802555,PHYS 1B,A00,886439,Staff,185,0,240,55
1746537803585,PHYS 1BL,001,886441,Tsai; Philbert S,0,4,30,30
1746537803585,PHYS 1BL,002,886444,Tsai; Philbert S,2,0,30,28
1746537804612,PHYS 1C,A00,896092,Arnold; Kam S,78,0,146,68
1746537805638,PHYS 1CL,001,886448,Tsai; Philbert S,0,0,30,30
1746537805638,PHYS 1CL,002,886449,Tsai; Philbert S,0,0,30,30
1746537805638,PHYS 1CL,003,886450,Tsai; Philbert S,15,0,30,15
1746537805638,PHYS 1CL,004,886451,Tsai; Philbert S,15,0,30,15
1746537806663,PHYS 2B,A01,886457,Staff,69,0,115,46
1746537807696,PHYS 2C,A01,886460,Shotwell; Brian,0,8,65,65
1746537808725,PHYS 2CL,A01,886467,Staff,0,4,28,28
1746537808725,PHYS 2CL,A02,886468,Staff,0,3,28,28
1746537809757,PHYS 2D,A01,886470,Staff,10,0,50,40
1746537810786,PHYS 4B,A01,886475,Grinstein; Benjamin,22,0,40,18
1746537811813,POLI 5,A00,891173,Desposato; Scott,7,0,25,18
1746537812844,POLI 5D,A01,891175,Staff,5,0,5,0
1746537812844,POLI 5D,B01,891178,Staff,5,0,5,0
1746537813875,POLI 11,A00,891179,Ferree; Karen E,2,0,35,33
1746537814906,POLI 12,A00,891180,Staff,16,0,30,14
1746537815930,POLI 27,A01,891182,Staff,12,0,75,63
1746537816957,POLI 30,A00,891183,Staff,9,0,50,41
1746537817987,POLI 100B,A00,891244,Staff,5,1,35,30
1746537819010,POLI 100I,A00,891247,Staff,7,0,30,23
1746537820041,POLI 104J,A00,891248,Nichter; Maysa,14,0,30,16
1746537821069,POLI 104U,A00,891250,Nichter; Maysa,2,0,30,28
1746537823124,POLI 110B,A00,891255,Wiens; David,20,0,25,5
1746537824152,POLI 112A,A00,891256,Wiens; David,6,0,25,19
1746537825179,POLI 114BR,A00,891261,Staff,19,0,30,11
1746537826206,POLI 117R,A00,891262,Forman; Fonna,0,6,50,50
1746537827232,POLI 118,A00,891264,Ingham; Sean,17,0,25,8
1746537828261,POLI 124A,A00,891265,Staff,18,0,20,2
1746537829291,POLI 125D,A00,891266,Nichter; Simeon C,2,0,25,23
1746537830317,POLI 126,A00,891268,Nichter; Simeon C,7,0,25,18
1746537831349,POLI 126AA,A00,891272,Staff,18,0,25,7
1746537832375,POLI 130AA,A00,891273,Staff,15,0,20,5
1746537833403,POLI 134AA,A00,891274,Staff,4,0,20,16
1746537835454,POLI 138,A00,891278,Staff,21,0,25,4
1746537836481,POLI 142K,A00,891280,Staff,11,0,25,14
1746537837507,POLI 142M,A00,891281,Gartzke; Erik,17,0,30,13
1746537838534,POLI 142P,A00,891284,Staff,20,0,30,10
1746537839562,POLI 143,A00,891285,Gartzke; Erik,12,0,30,18
1746537840590,POLI 153,A00,891286,Staff,19,0,20,1
1746537842644,POLI 175,A00,891290,Staff,15,0,20,5
1746537843712,PSYC 1,A00,890674,Steiner; Eric Tomas,0,11,45,45
1746537844745,PSYC 2,A00,890676,Albright; Thomas D,21,0,35,14
1746537845777,PSYC 3,A00,890679,Staff,17,0,20,3
1746537846803,PSYC 6,A00,959858,Staff,20,0,20,0
1746537847830,PSYC 60,A01,890684,Rickard; Timothy C.,0,5,45,45
1746537848856,PSYC 70,A01,890689,Geller; Emma Harlan,7,0,30,23
1746537849883,PSYC 71,A01,959860,Staff,21,0,25,4
1746537850911,PSYC 100,A00,890690,Lacefield; Katharine I,0,50,180,180
1746537851936,PSYC 102,A00,890695,Staff,18,0,40,22
1746537852961,PSYC 105,A00,890699,Geller; Emma Harlan,71,0,100,29
1746537853989,PSYC 106,A00,890701,Gorman; Michael R.,5,0,30,25
1746537855017,PSYC 108,A00,890704,Adrian; Julia Anna,0,28,50,50
1746537856047,PSYC 118,A01,890712,Staff,11,0,30,19
1746537857072,PSYC 124,A00,890716,Chapman; Eddie Nathaniel,25,0,60,35
1746537858097,PSYC 131,A00,890717,Anagnostaras; Stephan,0,7,80,80
1746537859129,PSYC 137,A00,890719,Winkielman; Piotr,0,11,30,30
1746537860156,PSYC 144,A00,890721,Adrian; Julia Anna,0,9,45,45
1746537861182,PSYC 162,A00,890805,Staff,2,0,75,73
1746537862209,PSYC 169,A00,890810,Staff,0,15,30,30
1746537863237,PSYC 172,A00,890814,Gorman; Michael R.,9,0,30,21
1746537864263,PSYC 181,A00,890818,Anagnostaras; Stephan,8,0,200,192
1746537865288,PSYC 184,A00,959861,Staff,170,0,175,5
1746537866316,PSYC 189,A00,890823,Staff,0,1,30,30
1746537867351,PSYC 191,A00,890884,Rickard; Timothy C.,0,11,35,35
1746537868377,PSYC 193,A00,890913,Staff,19,0,30,11
1746537868377,PSYC 193,B00,890914,Chapman; Eddie Nathaniel,24,0,30,6
1746537869404,PSYC 193L,A01,890918,Lowe; Angela Beth,20,0,30,10
1746537869404,PSYC 193L,B01,890921,Hurwitz; Ethan Scott,20,0,30,10
1746537869404,PSYC 193L,C01,890928,Staff,30,0,30,0
1746537870434,RELI 149,A00,886806,Rahimi; Babak,23,0,40,17
1746537871460,SE 9,A01,886814,Staff,7,0,20,13
1746537872491,SE 101B,A01,886816,Chadha; Mayank,4,0,35,31
1746537873522,SE 110B,A00,886818,Zhu; Qiang,4,0,75,71
1746537874550,SE 125,A01,886830,Staff,10,0,30,20
1746537875575,SE 130B,A01,886835,Staff,14,0,40,26
1746537876604,SE 131A,A01,886838,Krysl; Petr,34,0,55,21
1746537877631,SE 154,A00,886840,Staff,30,0,50,20
1746537878656,SE 164GS,A01,886849,Staff,6,0,20,14
1746537879685,SE 167GS,A01,886853,Staff,6,0,20,14
1746537880713,SIO 25,A01,890107,Staff,19,0,30,11
1746537881743,SIO 45,A00,890109,Cook; Geoffrey W,117,0,200,83
1746537882773,SIO 109R,A00,890110,Forman; Fonna,0,16,20,20
1746537883799,SIO 187,A01,890114,Kacev; David,15,0,40,25
1746537884827,SOCI 1,A01,890431,Thorpe; Charles Robert,15,0,30,15
1746537884827,SOCI 1,A02,890518,Thorpe; Charles Robert,30,0,30,0
1746537885857,SOCI 2,A01,957978,Staff,25,0,25,0
1746537885857,SOCI 2,A02,957979,Staff,23,0,25,2
1746537886885,SOCI 20,A01,890523,Calderon-Zaks; Michael Aar,23,0,30,7
1746537886885,SOCI 20,A02,890526,Calderon-Zaks; Michael Aar,29,0,30,1
1746537887917,SOCI 30,A01,890533,Pardo Guerra; Juan Pablo,37,0,40,3
1746537888943,SOCI 40,A01,890535,Staff,27,0,45,18
1746537889970,SOCI 104Q,A00,890559,Staff,18,0,30,12
1746537890997,SOCI 106,A00,890560,Arnal; Maud Marie Leonie,20,0,30,10
1746537892023,SOCI 110,A00,890567,Holkenbrink-Monk; Charlene,19,0,30,11
1746537893050,SOCI 112,A00,890568,Victoria Torres; Pablo,1,0,55,54
1746537894079,SOCI 115,A00,890597,Arnal; Maud Marie Leonie,28,0,45,17
1746537896142,SOCI 121,A00,890604,Pardo Guerra; Juan Pablo,38,0,45,7
1746537897172,SOCI 126,A01,890608,Staff,8,0,10,2
1746537898202,SOCI 127,A00,890609,Staff,18,0,30,12
1746537899232,SOCI 131,A00,890610,Thorpe; Charles Robert,37,0,45,8
1746537900260,SOCI 135,A00,890615,Payne; Christine Anna,14,0,45,31
1746537901285,SOCI 139,A00,890620,Staff,38,0,45,7
1746537902322,SOCI 148E,A00,890622,Calderon-Zaks; Michael Aar,36,0,45,9
1746537903348,SOCI 150,A00,890623,Kohler; Kristopher M.,31,0,45,14
1746537904377,SOCI 157,A00,890625,Jules-Rosette; Bennetta W.,18,0,20,2
1746537905408,SOCI 160,A00,890627,Payne; Christine Anna,21,0,45,24
1746537906444,SYN 1,A00,886855,Fish; Gwendolyn Anne,0,0,0,0
1746537906444,SYN 1,B00,906086,Fish; Gwendolyn Anne,0,1,0,2
1746537907470,SYN 2R,A00,886860,Staff,0,17,15,15
1746537907470,SYN 2R,B00,906106,Atkinson; Arthur Laird,0,16,15,15
1746537908511,SYN 100,A01,886866,Browne; Emily,0,28,20,20
1746537908511,SYN 100,B01,906128,Rock; Martin,0,5,20,20
1746537908511,SYN 100,C01,906140,Deavenport; James Cary,0,3,20,20
1746537908511,SYN 100,D01,907816,Deavenport; James Cary,0,5,20,20
1746537909539,TDAC 1,A00,890286,Walsh; Kim C.,9,0,20,11
1746537910566,TDAC 101,A00,890296,Basso; Beatrice,16,0,20,4
1746537911592,TDDE 131,A00,890297,Staff,47,0,50,3
1746537912621,TDDM 1,A00,890287,Weinberg; Sadie,25,0,30,5
1746537913648,TDGE 11,A00,890288,Fulton; Julia,137,0,200,63
1746537913648,TDGE 11,B00,890289,Castro; Robert Jess,184,0,200,16
1746537914676,TDGE 25,B00,957359,Walsh; Kim C.,3,0,20,17
1746537915703,TDGE 40,A01,890292,Power; Jade Yukana,27,0,30,3
1746537916732,TDGE 124,A00,890298,Havis; Allan,0,0,50,50
1746537917758,TDGE 131R,A00,890299,Burelle; Julie Sara Veronique,15,0,42,27
1746537918785,TDHT 101,A00,890300,Staff,10,0,20,10
1746537919816,TDHT 109,A01,890302,Anderson; Mysia Anyse,31,0,40,9
1746537920848,TDMV 1,A00,890293,Arcidiacono; Kristin,18,0,30,12
1746537921874,TDMV 2,A00,890294,Weinberg; Sadie,23,0,30,7
1746537922909,TDMV 3,A00,957878,Arcidiacono; Kristin,28,0,30,2
1746537924964,TDMV 138,A00,890304,Jun; Grace Shin Hae,25,0,40,15
1746537925990,TDMV 140,A00,890305,Corrales; Joseph Bernales,25,0,30,5
1746537927016,TDMV 142,A00,890307,Caligagan; Tony,32,0,40,8
1746537928043,TDMV 144,A00,890308,Camaya; Michelle Ann,25,0,30,5
1746537929073,TDPW 1,A00,890295,Stein; Deborah Isobel,3,0,20,17
1746537930104,USP 2,A01,890272,Lerner; Amy M,6,0,20,14
1746537931132,USP 3,A01,890274,Staff,12,0,30,18
1746537932160,USP 15,A01,890276,Sun; Feiyang,17,0,30,13
1746537933191,USP 25,A00,890277,Shenkman; Michael Thomas,19,0,25,6
1746537934218,USP 138,A00,890278,Staff,13,0,25,12
1746537935251,USP 143,A00,890279,Staff,21,0,70,49
1746537936279,USP 144,A00,890280,Chowdhury; Muhammed Zohir,16,0,30,14
1746537937306,USP 150,A00,890281,Boomhower; Matthew Charles,4,0,30,26
1746537938334,USP 151,A00,890282,Staff,16,0,20,4
1746537939362,USP 162,A00,890283,Andrews; Abigail Leslie,16,0,20,4
1746537940390,USP 168,A00,920477,Kwak; Nancy,1,0,5,4
1746537941415,USP 181,A00,890284,Staff,3,0,20,17
1746537942445,USP 191A,A00,890285,Staff,13,0,20,7
1746537943473,VIS 101,A00,886512,Staff,25,0,75,50
1746537944506,VIS 103,A00,886513,Cruz; Edwin Teddy,61,0,75,14
1746537945531,VIS 108,A00,886514,Staff,3,0,15,12
1746537946562,VIS 127P,A00,886515,Shen; Kuiyi,80,0,146,66
1746537947631,VIS 149,A00,886516,Yoldas; Pinar,0,0,15,15
1746537948662,VIS 164,A00,886526,Erdmann; Dean,19,0,22,3
1746537949687,VIS 194S,A00,886527,Staff,61,0,75,14
1746537950719,WCWP 10A,C00,886484,Martiniuk; Jill,12,0,15,3
1746537951753,WCWP 10B,A00,886490,Uriarte; Emma,0,0,15,15
1746537951753,WCWP 10B,B00,886491,Dhir; Simrita,11,0,15,4
1746537951753,WCWP 10B,C00,886492,Ornelas; Tricia,0,0,15,15
1746537952780,WCWP 100,A00,886494,Young; Mark T,0,7,15,15
1746537954947,AAS 10,A01,886199,Childs; Dennis R.,0,3,0,0
1746537955975,ANAR 104,A01,886940,Shtienberg; Gilad,27,0,30,3
1746537957001,ANAR 120,A00,886953,Staff,12,0,20,8
1746537958026,ANBI 148,A01,886955,Wilder; Linnea Lorene,30,0,40,10
1746537960085,ANSC 122,A00,886957,Staff,25,0,30,5
1746537961115,ANSC 150,A00,886958,Sloane; Julia Kathryn,3,0,15,12
1746537962149,ANSC 156,A00,886959,Jenkins; Janis A.,0,1,15,15
1746537963178,ANSC 180,A00,886960,Staff,11,0,17,6
1746537964209,ANSC 188,A00,886961,Jassal; Aftab,9,0,25,16
1746537965241,ANSC 190,A00,886962,Jassal; Aftab,14,0,25,11
1746537966267,ANSC 191,A00,886963,Staff,18,0,20,2
1746537967294,ANTH 3,A01,891689,Staff,17,0,20,3
1746537968321,ANTH 5,A00,886933,Semendeferi; Ekaterini,16,0,20,4
1746537969346,ANTH 10,A00,886934,Staff,0,12,30,30
1746537970373,ANTH 21,A01,886936,Staff,40,0,60,20
1746537971400,ANTH 23,A01,886938,Staff,92,0,100,8
1746537972428,ANTH 105,A00,886964,Stewart; Alexander B,84,0,100,16
1746537973454,ANTH 108,A00,886965,Pedersen; David,9,0,20,11
1746537974483,AWP 10,001,886147,Staff,0,0,0,0
1746537974483,AWP 10,002,886148,Staff,0,0,0,0
1746537974483,AWP 10,003,886149,Staff,0,0,0,0
1746537974483,AWP 10,004,886150,Staff,0,0,0,0
1746537974483,AWP 10,005,886151,Staff,0,0,0,0
1746537974483,AWP 10,006,886152,Staff,0,0,0,0
1746537974483,AWP 10,007,886153,Staff,0,0,0,0
1746537974483,AWP 10,008,886154,Staff,0,0,0,0
1746537974483,AWP 10,009,886155,Staff,0,0,0,0
1746537974483,AWP 10,010,886156,Staff,0,0,0,0
1746537974483,AWP 10,011,886158,Staff,0,0,0,0
1746537974483,AWP 10,012,886160,Staff,0,0,0,0
1746537974483,AWP 10,013,886161,Staff,0,0,0,0
1746537974483,AWP 10,014,886162,Staff,0,0,0,0
1746537974483,AWP 10,015,886163,Staff,0,0,0,0
1746537974483,AWP 10,016,886164,Staff,0,0,0,0
1746537974483,AWP 10,017,886165,Staff,0,0,0,0
1746537974483,AWP 10,018,886166,Staff,0,0,0,0
1746537974483,AWP 10,019,886168,Staff,0,0,0,0
1746537974483,AWP 10,020,886170,Staff,0,0,0,0
1746537974483,AWP 10,021,886172,Staff,0,0,0,0
1746537975510,AWP 10R,001,886173,Staff,0,1,0,0
1746537975510,AWP 10R,002,886174,Staff,0,1,0,0
1746537975510,AWP 10R,003,886175,Staff,0,0,0,0
1746537975510,AWP 10R,004,886176,Staff,0,0,0,0
1746537975510,AWP 10R,005,886177,Staff,0,0,0,0
1746537975510,AWP 10R,006,886178,Staff,0,0,0,0
1746537975510,AWP 10R,007,886179,Staff,0,0,0,0
1746537975510,AWP 10R,008,886181,Staff,0,0,0,0
1746537975510,AWP 10R,009,886182,Staff,0,0,0,0
1746537975510,AWP 10R,010,886183,Staff,0,0,0,0
1746537975510,AWP 10R,011,886184,Staff,0,0,0,0
1746537975510,AWP 10R,012,886185,Staff,0,0,0,0
1746537975510,AWP 10R,013,886186,Staff,0,0,0,0
1746537975510,AWP 10R,014,886187,Staff,0,0,0,0
1746537975510,AWP 10R,015,886188,Staff,0,0,0,0
1746537975510,AWP 10R,016,886189,Staff,0,0,0,0
1746537976537,AWP 102R,A00,886190,Staff,0,0,0,0
1746537976537,AWP 102R,B00,886191,Staff,0,0,0,0
1746537977563,BENG 100,A01,886193,Staff,17,0,30,13
1746537978589,BENG 122A,A01,886195,Hasty; Jeff M,13,0,30,17
1746537979614,BENG 166A,A00,886196,Sah; Robert Lie-Yuan,0,1,30,30
1746537980645,BENG 190,A00,958050,Khojah; Reem I,24,0,25,1
1746537981677,BIBC 102,A01,894320,Staff,0,0,46,46
1746537981677,BIBC 102,A02,894321,Staff,1,0,46,45
1746537981677,BIBC 102,A03,894344,Staff,7,0,46,39
1746537981677,BIBC 102,A04,894345,Staff,26,0,47,21
1746537982707,BICD 100R,A01,894365,Smith; Laurie,0,3,58,58
1746537982707,BICD 100R,A02,894366,Smith; Laurie,0,5,58,58
1746537982707,BICD 100R,A03,894367,Smith; Laurie,2,0,59,57
1746537982707,BICD 100R,A04,959869,Smith; Laurie,41,0,59,18
1746537983736,BICD 136,A01,894383,Gustafson-Brown; Cindy,14,0,50,36
1746537984765,BIEB 102,A01,894494,Butler; Shannon Rhey,51,0,130,79
1746537986826,BIEB 150,A01,894617,Wills; Christopher,3,0,20,17
1746537986826,BIEB 150,A02,894631,Wills; Christopher,3,0,20,17
1746537986826,BIEB 150,A03,894937,Wills; Christopher,3,0,20,17
1746537986826,BIEB 150,A04,894946,Wills; Christopher,5,0,20,15
1746537987854,BIEB 194,A00,906141,Kurle; Carolyn M.,6,0,20,14
1746537988880,BILD 1,A01,894154,Staff,2,0,19,17
1746537988880,BILD 1,A02,894155,Staff,14,0,19,5
1746537988880,BILD 1,A03,894160,Staff,13,0,19,6
1746537988880,BILD 1,A04,894161,Staff,15,0,18,3
1746537989911,BILD 2,A01,894168,Staff,0,0,50,50
1746537989911,BILD 2,A02,894169,Staff,0,0,50,50
1746537989911,BILD 2,A03,894179,Staff,4,0,50,46
1746537989911,BILD 2,A04,894203,Staff,27,0,50,23
1746537990939,BILD 3,A01,894213,Staff,22,0,31,9
1746537990939,BILD 3,A02,894214,Staff,26,0,31,5
1746537990939,BILD 3,A03,894235,Staff,28,0,31,3
1746537990939,BILD 3,A04,894236,Staff,28,0,32,4
1746537991966,BILD 4,A01,894253,Reuther; Keefe,5,0,24,19
1746537991966,BILD 4,A02,894258,Reuther; Keefe,16,0,24,8
1746537992993,BILD 5,A01,894276,Reuther; Keefe,35,0,50,15
1746537992993,BILD 5,A02,894277,Reuther; Keefe,45,0,50,5
1746537992993,BILD 5,A03,894290,Reuther; Keefe,44,0,50,6
1746537992993,BILD 5,A04,894291,Reuther; Keefe,48,0,50,2
1746537994022,BILD 24,A01,894297,Pirino; Giorgia,40,0,60,20
1746537995047,BIMM 100,B01,958915,Staff,72,0,100,28
1746537996075,BIMM 101,A01,895017,McDonnell; Lisa Marie,0,5,24,24
1746537996075,BIMM 101,A02,895018,McDonnell; Lisa Marie,0,5,24,24
1746537996075,BIMM 101,B01,895020,McDonnell; Lisa Marie,0,6,24,24
1746537996075,BIMM 101,B02,895021,McDonnell; Lisa Marie,0,4,24,24
1746537997106,BIMM 110,A01,895023,Staff,1,0,25,24
1746537997106,BIMM 110,A02,895024,Staff,9,0,25,16
1746537997106,BIMM 110,A03,895025,Staff,18,0,25,7
1746537997106,BIMM 110,A04,895031,Staff,20,0,25,5
1746537998133,BIMM 120,A01,895114,Gustafson-Brown; Cindy,13,0,28,15
1746537998133,BIMM 120,A02,895126,Gustafson-Brown; Cindy,21,0,27,6
1746537999166,BIPN 100,A01,895130,Yang; Mingyu,1,0,38,37
1746537999166,BIPN 100,A02,895131,Yang; Mingyu,32,0,38,6
1746537999166,BIPN 100,A03,895132,Yang; Mingyu,32,0,38,6
1746537999166,BIPN 100,A04,895133,Yang; Mingyu,27,0,36,9
1746538000192,BIPN 120,A01,895135,Cooke; James Edward,0,3,13,13
1746538000192,BIPN 120,A02,895136,Cooke; James Edward,0,1,13,13
1746538000192,BIPN 120,A03,895137,Cooke; James Edward,0,3,13,13
1746538000192,BIPN 120,A04,895156,Cooke; James Edward,0,2,11,11
1746538001222,BIPN 134,A01,895235,Cooke; James Edward,0,2,25,25
1746538001222,BIPN 134,A02,895237,Cooke; James Edward,0,0,25,25
1746538001222,BIPN 134,A03,895240,Cooke; James Edward,3,0,25,22
1746538001222,BIPN 134,A04,895270,Cooke; James Edward,20,0,25,5
1746538002253,BIPN 189,A00,892103,Staff,0,13,14,14
1746538004309,BISP 194,A00,958008,Staff,0,2,0,0
1746538005337,CAT 124,A01,922009,Staff,0,5,20,20
1746538006376,CAT 125R,A00,886390,Morales; Celeste Georgianna,0,2,20,20
1746538006376,CAT 125R,B00,886391,Irwin; Matthew Joseph,0,3,20,20
1746538006376,CAT 125R,C00,886392,Smith; Lauryn Alissa,0,2,20,20
1746538006376,CAT 125R,D00,886393,Vanderschuit; Maya Alysia,0,2,20,20
1746538006376,CAT 125R,E00,886394,Marchisotto; Jennifer Anne,0,4,20,20
1746538007404,CENG 15,A01,886218,Drews; Aaron,3,0,8,5
1746538008433,CENG 113,A00,886219,Opatkiewicz; Justin Paul,15,0,25,10
1746538009461,CGS 101,A00,887044,Staff,7,0,20,13
1746538010490,CGS 105,A01,887046,Staff,14,0,25,11
1746538011524,CGS 112,A00,887047,Cuong; Marisol,12,0,15,3
1746538012550,CGS 113,A00,887048,Staff,23,0,30,7
1746538013578,CGS 120,A00,887049,Staff,10,0,17,7
1746538014608,CHEM 6A,A01,886336,Lam; Tin Yiu,38,0,50,12
1746538014608,CHEM 6A,A02,886338,Lam; Tin Yiu,37,0,50,13
1746538015639,CHEM 6B,A01,886341,Hopkins; Patrycja Anna,16,0,50,34
1746538015639,CHEM 6B,A02,886343,Hopkins; Patrycja Anna,42,0,50,8
1746538016668,CHEM 6C,A01,886346,Albizati; Kim F.,0,2,50,50
1746538016668,CHEM 6C,A02,886348,Albizati; Kim F.,23,0,50,27
1746538017696,CHEM 40A,A01,886352,Klosterman; Jeremy K,65,0,100,35
1746538018725,CHEM 40B,A01,886356,Klosterman; Jeremy K,0,23,100,100
1746538019759,CHEM 41B,A01,886360,Theodorakis; Emmanuel,25,0,50,25
1746538019759,CHEM 41B,A02,886362,Theodorakis; Emmanuel,47,0,50,3
1746538020786,CHIN 165A,A00,886382,Xu; Li,18,0,20,2
1746538021817,CLAS 120,A00,886387,Myerston Santana; Jacobo,33,0,40,7
1746538022845,COGS 9,A01,886967,Shannon; Kyle Michael,42,0,60,18
1746538023872,COGS 11,A01,886969,Staff,11,0,30,19
1746538024898,COGS 14A,A01,886971,Staff,6,0,60,54
1746538025924,COGS 14B,A01,886973,Hoffman; Drew Ellen,4,0,60,56
1746538026954,COGS 18,A01,886975,Morgan; Eric,35,0,60,25
1746538027985,COGS 20,A01,886977,Staff,4,0,8,4
1746538027985,COGS 20,A02,886978,Staff,5,0,7,2
1746538029010,COGS 100,A01,907783,Staff,0,2,30,30
1746538030042,COGS 101B,A01,886980,Staff,0,3,48,48
1746538031074,COGS 101C,A01,886982,Delgado; Tania,0,5,44,44
1746538032101,COGS 102A,A01,886984,Johnson; Christine M.,4,0,30,26
1746538033126,COGS 118B,A01,886986,Staff,0,3,88,88
1746538034157,COGS 150,A01,886988,Bergen; Benjamin,23,0,50,27
1746538035182,COGS 153,A00,886989,Delgado; Tania,0,2,41,41
1746538036207,COGS 186,A01,886991,Staff,0,0,32,32
1746538037236,COGS 187A,A01,886993,Boyle; Mary E. T.,7,0,30,23
1746538038264,COGS 189,A00,886994,Staff,0,1,30,30
1746538039295,COMM 10,A01,886996,Staff,0,0,20,21
1746538039295,COMM 10,A02,886997,Staff,12,0,20,8
1746538039295,COMM 10,A03,959845,Staff,19,0,20,1
1746538040321,COMM 20,A01,886999,Leuning; Grant Maurstad,24,0,40,16
1746538042379,COMM 100A,A01,887002,Staff,0,0,20,25
1746538042379,COMM 100A,A02,887003,Staff,7,0,20,13
1746538043407,COMM 100B,A01,887005,Staff,0,8,20,24
1746538044439,COMM 106D,A00,887006,Staff,14,0,40,26
1746538045469,COMM 110G,A00,887007,Whitworth-Smith; Andrew C,12,0,40,28
1746538046505,COMM 111B,A00,887008,Staff,31,0,40,9
1746538047536,COMM 113T,A00,887009,Abuelhiga; Soraya Jill,28,0,40,12
1746538047536,COMM 113T,B00,906733,Staff,40,0,40,0
1746538048565,COMM 145,A00,887010,Staff,12,0,40,28
1746538049594,COMM 146,A00,887054,Staff,31,0,40,9
1746538050620,COMM 190,A00,887012,Staff,8,0,23,15
1746538051647,CSE 8A,A50,887015,Cao; Yingjun,57,0,85,28
1746538052677,CSE 11,A01,887017,Cao; Yingjun,12,0,70,58
1746538053703,CSE 20,A01,887019,Staff,30,0,50,20
1746538054732,CSE 21,A01,887021,Staff,78,0,100,22
1746538054732,CSE 21,B01,892583,Braun; Oliver,45,0,50,5
1746538055764,CSE 30,A01,887025,Eldon; John,143,0,200,57
1746538056789,CSE 100,A01,887027,Staff,26,0,50,24
1746538056789,CSE 100,A02,887028,Staff,40,0,50,10
1746538057817,CSE 101,A01,887030,Braun; Oliver,75,0,100,25
1746538057817,CSE 101,B01,887032,Jones; Miles E,0,3,50,50
1746538057817,CSE 101,B02,887033,Jones; Miles E,0,1,50,50
1746538058843,CSE 105,A01,908084,Jones; Miles E,32,0,50,18
1746538058843,CSE 105,A02,908087,Jones; Miles E,33,0,50,17
1746538059869,CSE 135,A01,887035,Powell; Thomas Allan,0,4,50,50
1746538060897,CSE 142,A01,887037,Staff,8,0,60,52
1746538061924,CSE 142L,A01,887039,Staff,34,0,60,26
1746538062954,CSE 151A,A01,887041,Solares; Edwin A,48,0,100,52
1746538063980,CSE 175,A01,887043,Kumar; Rakesh,30,0,30,0
1746538065007,CSS 1,A01,886389,Staff,0,1,40,40
1746538066034,DSC 30,A01,908097,Liao; Soohyun Nam,47,0,75,28
1746538067060,DSC 40A,A01,908099,Shannon; Kyle Michael,30,0,50,20
1746538068086,DSC 40B,A01,908112,Staff,16,0,50,34
1746538069112,DSC 80,A01,908116,Staff,19,0,60,41
1746538070137,DSC 197,001,956863,Eldridge; Justin Matthew,9999,0,9999,0
1746538071164,ECE 5,A01,886400,Morris; Karcher William,2,0,6,4
1746538071164,ECE 5,A02,886401,Morris; Karcher William,3,0,6,3
1746538072190,ECE 148,A01,886403,Silberman; Jack,0,14,14,14
1746538073224,ECON 1,A01,887265,Crane; Meredith Helen,12,0,70,58
1746538073224,ECON 1,B01,887268,Staff,43,0,50,7
1746538074255,ECON 2,A01,887273,Crane; Meredith Helen,56,0,70,14
1746538075287,ECON 3,A01,887279,Rondina; Giacomo,32,0,70,38
1746538076318,ECON 4,A01,887282,Anderson; John Charles,0,2,10,10
1746538077353,ECON 5,A01,887285,Staff,33,0,45,12
1746538077353,ECON 5,B01,887292,Staff,41,0,45,4
1746538078385,ECON 100A,A01,887337,Newhouse; Herbert S,54,0,70,16
1746538078385,ECON 100A,B01,887349,Staff,45,0,50,5
1746538079411,ECON 100B,A01,887361,Du; Songzi,29,0,70,41
1746538080444,ECON 100C,A01,887445,Newhouse; Herbert S,59,0,70,11
1746538081471,ECON 105,A00,887488,Vespa; Emanuel Ignacio,23,0,35,12
1746538082501,ECON 109,A01,887506,Shishkin; Denis,28,0,35,7
1746538083537,ECON 110A,A01,887568,Alon; Titan Michael,0,3,35,35
1746538083537,ECON 110A,B01,907601,Alon; Titan Michael,20,0,35,15
1746538084562,ECON 110B,A01,887598,Levkoff; Steven B.,0,23,70,70
1746538085587,ECON 112,A00,887599,Rondina; Giacomo,19,0,35,16
1746538086615,ECON 120A,A01,887603,Dai; Yinlin,36,0,70,34
1746538087648,ECON 120C,A01,887608,Sun; Yixiao,0,1,35,35
1746538087648,ECON 120C,B01,887614,Sun; Yixiao,0,0,35,35
1746538088674,ECON 138,A00,887621,Bharadwaj; Prashant,0,20,20,20
1746538089700,ECON 144,A00,958007,Squires; Dale E,13,0,35,22
1746538090727,ECON 171,A01,907666,Staff,18,0,35,17
1746538091760,ECON 175,A00,887626,Wu; Pak Yeung,23,0,35,12
1746538092788,ECON 190,A00,887640,Vespa; Emanuel Ignacio,23,0,35,12
1746538093820,EDS 25,A01,888197,Staff,0,0,0,0
1746538093820,EDS 25,A02,888209,Staff,0,0,0,0
1746538093820,EDS 25,A03,888210,Staff,0,0,0,0
1746538093820,EDS 25,A04,888212,Staff,0,0,0,0
1746538093820,EDS 25,A05,888213,Staff,0,0,0,0
1746538093820,EDS 25,A06,888214,Staff,0,0,0,0
1746538093820,EDS 25,A07,888235,Staff,0,2,0,0
1746538093820,EDS 25,A08,888236,Staff,0,0,0,0
1746538093820,EDS 25,A09,888240,Staff,0,0,0,0
1746538093820,EDS 25,A10,888244,Staff,0,0,0,0
1746538093820,EDS 25,B01,888273,Staff,0,0,0,0
1746538093820,EDS 25,B02,888285,Staff,0,0,0,0
1746538093820,EDS 25,B03,888423,Staff,0,0,0,1
1746538093820,EDS 25,B04,888432,Staff,0,0,0,0
1746538093820,EDS 25,B05,888433,Staff,0,0,0,0
1746538093820,EDS 25,B06,888467,Staff,0,0,0,0
1746538093820,EDS 25,B07,888468,Staff,0,0,0,0
1746538093820,EDS 25,B08,888479,Staff,0,0,0,0
1746538093820,EDS 25,B09,888484,Staff,0,0,0,0
1746538093820,EDS 25,B10,888487,Staff,0,0,0,0
1746538094847,EDS 38,A01,907700,Choi; Bailey Miyeon,30,0,30,0
1746538095875,EDS 112,A01,888601,Chapman; Thandeka K,14,0,40,26
1746538096907,EDS 115,A00,888697,Mendez; Kathrina Mendoza,10,0,30,20
1746538097935,EDS 116,A01,888893,Staff,35,0,40,5
1746538099986,EDS 124AR,A00,889133,Staff,29,0,50,21
1746538099986,EDS 124AR,B00,907471,Simon; Elizabeth A,37,0,50,13
1746538101014,EDS 124BR,A00,889134,Simon; Elizabeth A,45,0,100,55
1746538102043,EDS 125,A00,889135,Staff,25,0,30,5
1746538103074,EDS 126,A01,889138,Staff,36,0,40,4
1746538104101,EDS 164R,A01,889142,Wishard Guerra; Alison G.,33,0,50,17
1746538105130,ENG 30,A01,886396,Staff,0,0,0,0
1746538105130,ENG 30,B01,886398,Staff,0,0,0,0
1746538106161,ENVR 102,A00,906150,Montejo; Carolina,23,0,25,2
1746538107189,ETHN 103A,A00,887236,Man; Simeon S,0,3,0,0
1746538108215,ETHN 113,A00,887239,Staff,16,0,30,14
1746538109241,ETHN 116,A00,887240,Staff,16,0,25,9
1746538110267,ETHN 117,A00,887241,Choi; Esther Min,28,0,30,2
1746538111297,ETHN 118,A00,887243,Staff,24,0,30,6
1746538112324,ETHN 127,A00,887248,Cuong; Marisol,11,0,15,4
1746538113351,ETHN 139,A00,887250,Staff,7,0,10,3
1746538114380,ETHN 142,A00,887252,Staff,10,0,30,20
1746538115407,ETHN 161,A00,887253,Browne; Errol Tsekani,24,0,30,6
1746538116436,ETHN 163FR,A00,887255,Burelle; Julie Sara Veronique,0,0,5,5
1746538117464,GLBH 20,A00,889149,Elwardani; Nile Regina,8,0,42,34
1746538119526,GLBH 111,A01,889152,Burgos; Jose L.,17,0,17,0
1746538120553,GLBH 150,A00,889181,Sloane; Julia Kathryn,0,5,15,15
1746538122621,HDS 60,A01,886406,Warstadt; Melissa Fawn,73,0,80,7
1746538123649,HIAF 111,A00,889324,Gyamfi; Bright,25,0,32,7
1746538124675,HIEA 131,A00,889328,Staff,16,0,32,16
1746538125707,HIEA 144,A00,889333,Henry; Todd A.,26,0,32,6
1746538126734,HIEA 154,A00,889336,Henry; Todd A.,24,0,32,8
1746538127761,HIEU 106,A00,889339,Staff,22,0,32,10
1746538129812,HIEU 114,A00,889340,Staff,3,0,32,29
1746538130842,HIEU 135GS,A00,889342,Patterson; Patrick H.,0,0,1,24
1746538131869,HIEU 137,A00,889343,Edington; Claire Ellen,9,0,25,16
1746538132894,HIEU 148,A00,889345,Staff,14,0,32,18
1746538133925,HIEU 154,A00,889346,Biess; Frank Peter,21,0,32,11
1746538134949,HILA 102,A00,889351,Staff,12,0,32,20
1746538135975,HILD 2A,A01,889221,Lewandoski; Julia Mavis,1,10,32,31
1746538137004,HILD 7B,A01,889225,Man; Simeon S,0,13,32,32
1746538138035,HILD 7C,A01,889288,Alvarez; Luis A,0,14,32,32
1746538139061,HILD 30,A01,889323,Staff,0,5,32,32
1746538141119,HISC 119,A00,889383,Golan; Tal,21,0,32,11
1746538142145,HIUS 103,A00,889384,Man; Simeon S,0,0,32,32
1746538143175,HIUS 117,A00,919797,Kwak; Nancy,18,0,32,14
1746538144202,HIUS 142A,A00,919788,Staff,22,0,32,10
1746538146257,HIUS 149,A00,889386,Gyamfi; Bright,27,0,32,5
1746538147280,HIUS 155,A00,889387,Alvarez; Luis A,14,0,32,18
1746538148351,HUM 3,A01,886499,Caldwell; Michael Alan,19,0,50,31
1746538149380,HUM 3GS,A00,886500,Rodriguez; Bretton Sigfred,0,0,0,28
1746538150404,HUM 3R,A01,886502,Markman; Kristina,0,36,50,50
1746538151432,HUM 4,A01,886504,Crum; Matthew Stephen,24,0,50,26
1746538151432,HUM 4,B01,886506,West; Geoffrey Scott,17,0,50,33
1746538152457,HUM 4GS,A00,886507,Staff,0,0,0,19
1746538153483,HUM 5,A01,886509,Staff,32,0,50,18
1746538154509,HUM 5R,A01,886511,Zavodny; Tatiana Sophia,0,39,50,50
1746538155538,JAPN 180,A00,886407,Staff,18,0,40,22
1746538156572,LATI 50,A01,886409,Martin-Cabrera; Luis,4,0,22,18
1746538156572,LATI 50,A02,886410,Martin-Cabrera; Luis,19,0,22,3
1746538156572,LATI 50,A03,886411,Martin-Cabrera; Luis,21,0,22,1
1746538156572,LATI 50,A04,886412,Martin-Cabrera; Luis,9,0,22,13
1746538157602,LAWS 101,A00,907664,Staff,28,0,60,32
1746538158629,LIAB 1A,A00,889388,Saab; Dima,17,0,20,3
1746538159662,LIAB 1AX,A00,889389,El Cheddadi; Youniss,17,0,20,3
1746538160691,LIFR 1C,A00,889391,Van Moer; Vinciane G,8,0,20,12
1746538161721,LIFR 1CX,A00,889392,Van Moer; Vinciane G,7,0,20,13
1746538162748,LIFR 1D,A00,889393,Van Moer; Vinciane G,7,0,20,13
1746538163776,LIFR 1DX,A00,889394,Van Moer; Vinciane G,8,0,20,12
1746538164802,LIGN 7,A00,886923,Staff,24,0,50,26
1746538165829,LIGN 17,A00,886924,Kehler; Andrew Scott,125,0,150,25
1746538166856,LTAM 110,A00,889395,Staff,15,0,30,15
1746538167885,LTAM 110GS,A00,958010,Rodriguez; Bretton Sigfred,0,0,0,28
1746538168912,LTCH 101,A00,889397,Staff,23,0,25,2
1746538169939,LTCS 130,A00,889398,Staff,23,0,25,2
1746538170963,LTEA 138,A00,889399,Staff,24,0,40,16
1746538171994,LTEN 149,A00,889400,Wesling; Megan E.,0,3,25,25
1746538173020,LTEN 169,A00,889401,Staff,20,0,25,5
1746538174054,LTEN 180,A00,889402,Staff,10,0,15,5
1746538175080,LTEN 181,A00,889403,Staff,21,0,25,4
1746538176109,LTWL 100,A00,889404,Myerston Santana; Jacobo,3,0,25,22
1746538177136,LTWL 180GS,A00,889405,Staff,0,0,20,20
1746538178162,LTWL 181,A00,889406,Staff,17,0,25,8
1746538179188,LTWL 184,A00,889475,Mukherjee; Silpa,22,0,25,3
1746538180215,LTWR 102C,A00,889486,Staff,29,0,30,1
1746538181243,LTWR 115W,A00,889491,Staff,0,2,15,15
1746538182271,MAE 8,A01,886905,Staff,0,2,0,0
1746538183304,MAE 11,A00,886906,Bandaru; Prabhakar,0,7,50,50
1746538184332,MAE 20,A00,886907,Evdokimenko; Ekaterina,44,0,70,26
1746538185358,MAE 30B,A00,886909,Ghazinejad; Maziar,26,0,45,19
1746538186383,MAE 101B,A00,886910,Saintillan; David,29,0,45,16
1746538187409,MAE 105,A00,886911,Bandaru; Prabhakar,18,0,50,32
1746538188445,MAE 107,B00,958024,Staff,9,0,50,41
1746538189472,MAE 143B,A00,886913,Bewley; Thomas R,7,0,40,33
1746538190497,MAE 148,A01,886915,Silberman; Jack,0,3,14,14
1746538191528,MAE 160,A00,886916,Evdokimenko; Ekaterina,31,0,60,29
1746538192558,MATH 3C,A01,889681,Staff,0,3,30,30
1746538192558,MATH 3C,A02,960048,Staff,25,0,30,5
1746538193585,MATH 10A,A01,889760,Staff,26,0,30,4
1746538193585,MATH 10A,A02,889783,Staff,29,0,30,1
1746538194617,MATH 10B,A01,889785,Verstraete; Jacques Allan,2,0,35,33
1746538194617,MATH 10B,A02,889795,Verstraete; Jacques Allan,4,0,35,31
1746538194617,MATH 10B,B01,889797,Verstraete; Jacques Allan,3,0,35,32
1746538194617,MATH 10B,B02,889828,Verstraete; Jacques Allan,3,0,35,32
1746538195646,MATH 10C,A01,889849,Habib; Yousaf,9,0,30,21
1746538195646,MATH 10C,A02,889852,Habib; Yousaf,14,0,30,16
1746538195646,MATH 10C,A03,889853,Habib; Yousaf,22,0,30,8
1746538195646,MATH 10C,A04,889858,Habib; Yousaf,20,0,30,10
1746538195646,MATH 10C,B01,889861,Staff,1,0,30,29
1746538195646,MATH 10C,B02,889862,Staff,24,0,30,6
1746538195646,MATH 10C,B03,889863,Staff,27,0,30,3
1746538195646,MATH 10C,B04,889967,Staff,23,0,30,7
1746538196674,MATH 18,A01,889974,Staff,7,0,30,23
1746538196674,MATH 18,A02,889977,Staff,20,0,30,10
1746538196674,MATH 18,B01,889984,Hardiman; Liam,22,0,30,8
1746538196674,MATH 18,B02,889985,Hardiman; Liam,25,0,30,5
1746538197700,MATH 20A,A01,889990,Suk; Andrew Hoon,29,0,35,6
1746538198728,MATH 20B,A01,889993,Ohm; Ko Woon,22,0,30,8
1746538198728,MATH 20B,A02,889994,Ohm; Ko Woon,30,0,30,0
1746538198728,MATH 20B,B01,889996,Ohm; Ko Woon,21,0,30,9
1746538198728,MATH 20B,B02,889997,Ohm; Ko Woon,23,0,30,7
1746538199764,MATH 20C,A01,889999,Hammock; Frances H,17,0,30,13
1746538199764,MATH 20C,A02,890003,Hammock; Frances H,23,0,30,7
1746538199764,MATH 20C,B01,890006,Hammock; Frances H,3,0,30,27
1746538199764,MATH 20C,B02,890007,Hammock; Frances H,11,0,30,19
1746538200799,MATH 20D,A01,890011,Cheng; Hsiao-Bing,1,1,30,29
1746538200799,MATH 20D,A02,890012,Cheng; Hsiao-Bing,14,0,30,16
1746538200799,MATH 20D,B01,890016,Cheng; Hsiao-Bing,13,0,30,17
1746538200799,MATH 20D,B02,890017,Cheng; Hsiao-Bing,13,0,30,17
1746538201834,MATH 20E,A01,890026,Harel; Guershon,1,0,30,29
1746538201834,MATH 20E,A02,890029,Harel; Guershon,23,0,30,7
1746538201834,MATH 20E,B01,890033,Harel; Guershon,7,0,30,23
1746538201834,MATH 20E,B02,890101,Harel; Guershon,21,0,30,9
1746538202871,MATH 102,A01,890104,Staff,17,0,30,13
1746538202871,MATH 102,A02,890105,Staff,27,0,30,3
1746538203900,MATH 103B,A01,890116,Salehi Golsefidy; Alireza,3,0,30,27
1746538203900,MATH 103B,B01,890118,Staff,0,3,34,34
1746538204935,MATH 109,A01,890121,Aliabadi Sr.; Mohsen,1,0,30,29
1746538204935,MATH 109,B01,890124,Upadrashta; Pranav Kumar,18,0,30,12
1746538205967,MATH 120A,A01,890126,Eggers; John Dietrich,13,0,30,17
1746538207000,MATH 142B,A01,890128,Ioana; Adrian,19,0,30,11
1746538207000,MATH 142B,A02,890129,Ioana; Adrian,13,0,30,17
1746538208025,MATH 154,A01,890174,Staff,0,0,30,30
1746538208025,MATH 154,A02,890182,Staff,0,0,30,30
1746538209059,MATH 168A,A01,890197,Dumitriu; Ioana,21,0,35,14
1746538210086,MATH 170A,A01,890240,Nie; Jiawang,1,0,30,29
1746538210086,MATH 170A,A02,890241,Nie; Jiawang,11,0,30,19
1746538210086,MATH 170A,A03,890249,Nie; Jiawang,23,0,30,7
1746538211114,MATH 170B,A01,957891,Nag; Panchali,13,0,35,22
1746538213176,MATH 181A,A01,908025,Staff,0,4,35,35
1746538213176,MATH 181A,A02,960115,Staff,27,0,35,8
1746538214205,MATH 181B,A01,959874,Staff,26,0,30,4
1746538215232,MATH 193B,A01,890265,Staff,0,4,35,35
1746538216258,MGT 4,A01,890311,Anderson; John Charles,42,0,88,46
1746538217289,MGT 5,A00,907740,Staff,13,0,98,85
1746538218316,MGT 12,A00,890312,Lindenberger; Wade Douglas,67,0,98,31
1746538219341,MGT 16,A00,957883,Staff,78,0,98,20
1746538221400,MGT 45,A00,890314,Pecore; Joseph P.,47,0,98,51
1746538222429,MGT 71,A00,890315,Staff,0,11,98,98
1746538223454,MGT 100,A00,890316,Yavorsky; Daniel Ryan,44,0,98,54
1746538224487,MGT 103,A00,890317,Ehrich; Kristine R,73,0,98,25
1746538225517,MGT 105,A00,890356,Bates; Kenneth Walter,0,7,98,98
1746538226547,MGT 112,A00,890360,Ehrich; Kristine R,55,0,98,43
1746538227575,MGT 127R,A00,907732,Zhu; Kevin Xiaoguo,23,0,98,75
1746538228607,MGT 131B,A00,890361,Anderson; John Charles,61,0,98,37
1746538229639,MGT 137,A00,890362,Lindenberger; Wade Douglas,65,0,98,33
1746538230672,MGT 160,A00,890369,Johnson; Erik Barry,9,0,98,89
1746538232723,MGT 164,A00,890372,Zimmermann; Carsten,0,39,98,98
1746538233752,MGT 180,A00,890374,Bliss; Barbara Ann,12,0,98,86
1746538234779,MMW 15,A01,886414,Chang; Edmond Yi-Teh,0,12,28,28
1746538234779,MMW 15,A02,886415,Chang; Edmond Yi-Teh,0,8,28,28
1746538234779,MMW 15,A03,886416,Chang; Edmond Yi-Teh,0,8,28,28
1746538234779,MMW 15,A04,886417,Chang; Edmond Yi-Teh,0,8,28,28
1746538234779,MMW 15,B01,886419,Chang; Edmond Yi-Teh,0,7,28,28
1746538234779,MMW 15,B02,886420,Chang; Edmond Yi-Teh,0,8,28,28
1746538234779,MMW 15,B03,886421,Chang; Edmond Yi-Teh,0,7,28,28
1746538234779,MMW 15,B04,886422,Chang; Edmond Yi-Teh,0,8,28,28
1746538234779,MMW 15,C01,886424,Staff,0,9,28,28
1746538234779,MMW 15,C02,886425,Staff,0,8,28,28
1746538234779,MMW 15,C03,886426,Staff,0,8,28,28
1746538234779,MMW 15,C04,886427,Staff,0,7,28,28
1746538234779,MMW 15,C05,958038,Staff,0,7,28,28
1746538234779,MMW 15,C06,958039,Staff,0,8,28,28
1746538235812,MMW 15GS,A00,906910,Patterson; Patrick H.,4,0,28,24
1746538236841,MMW 122R,A01,886429,Rahimi; Babak,0,13,28,28
1746538236841,MMW 122R,A02,886430,Rahimi; Babak,0,12,28,28
1746538236841,MMW 122R,A03,958040,Rahimi; Babak,0,11,28,28
1746538237882,MUS 1A,A01,890937,Staff,3,0,25,22
1746538237882,MUS 1A,A02,891035,Staff,6,0,25,19
1746538237882,MUS 1A,C01,958912,Staff,24,0,25,1
1746538237882,MUS 1A,C02,958913,Staff,25,0,25,0
1746538239937,MUS 2AK,A00,957092,Ohnishi; Takae,15,0,15,0
1746538240970,MUS 4,A01,891044,Staff,2,0,25,23
1746538240970,MUS 4,A02,891045,Staff,23,0,25,2
1746538240970,MUS 4,B01,891048,Staff,17,0,25,8
1746538240970,MUS 4,B02,891050,Staff,25,0,25,0
1746538241999,MUS 5,A01,957506,Dubnov; Shlomo,0,0,25,25
1746538241999,MUS 5,A02,957622,Dubnov; Shlomo,14,0,25,11
1746538241999,MUS 5,A03,957623,Dubnov; Shlomo,20,0,25,5
1746538243029,MUS 6,A01,891053,Freitas Caetano; Marcelo,24,0,25,1
1746538243029,MUS 6,A02,891054,Freitas Caetano; Marcelo,23,0,25,2
1746538244055,MUS 7,A01,891081,Staff,0,0,25,25
1746538244055,MUS 7,A02,891082,Staff,4,0,25,21
1746538245087,MUS 8GS,A00,891118,Borgo; David Garcia,0,0,25,25
1746538246113,MUS 11,A01,891140,Staff,11,0,25,14
1746538246113,MUS 11,A02,891141,Staff,22,0,25,3
1746538247142,MUS 13,A01,891143,Staff,8,0,25,17
1746538247142,MUS 13,A02,891144,Staff,24,0,25,1
1746538248176,MUS 15,A01,891146,Staff,9,0,25,16
1746538248176,MUS 15,A02,891148,Staff,21,0,25,4
1746538248176,MUS 15,B01,891150,Staff,18,0,25,7
1746538248176,MUS 15,B02,891151,Staff,25,0,25,0
1746538249201,MUS 20,A01,891153,Staff,5,0,20,15
1746538249201,MUS 20,A02,891155,Staff,14,0,20,6
1746538250230,MUS 80,A00,891156,Staff,19,0,25,6
1746538250230,MUS 80,B00,891157,Staff,23,0,25,2
1746538251260,MUS 130,A00,891158,Ohnishi; Takae,35,0,35,0
1746538252327,MUS 150GS,A01,891160,Borgo; David Garcia,0,0,25,25
1746538253352,MUS 170,A01,891162,Freitas Caetano; Marcelo,20,0,25,5
1746538253352,MUS 170,A02,891164,Freitas Caetano; Marcelo,21,0,25,4
1746538254384,NANO 11,A00,886220,Vazquez Mena; Oscar,13,0,15,2
1746538255411,NANO 15,A01,886222,Drews; Aaron,4,0,7,3
1746538256440,NANO 104,A00,886224,Sirbuly; Donald,18,0,25,7
1746538257470,PH 40,A00,886528,Staff,23,0,40,17
1746538258501,PH 45,A01,886799,Staff,35,0,40,5
1746538259527,PH 110,A00,886802,Staff,0,7,40,40
1746538260554,PH 172,A00,906716,Staff,19,0,35,16
1746538261582,PH 191,A00,886803,Staff,6,0,40,34
1746538262611,PHIL 1,A00,889500,Staff,19,0,30,11
1746538263642,PHIL 10,A01,889549,Grush; Rick Scott,15,0,22,7
1746538263642,PHIL 10,A02,889551,Grush; Rick Scott,22,0,22,0
1746538264672,PHIL 28,A01,889559,Lamey; Andy M.,0,1,31,31
1746538264672,PHIL 28,A02,889561,Lamey; Andy M.,0,1,30,30
1746538264672,PHIL 28,A03,889572,Lamey; Andy M.,0,0,30,30
1746538265706,PHIL 35,A00,907839,Staff,13,0,15,2
1746538266731,PHIL 60,A00,889574,Staff,74,0,90,16
1746538267757,PHIL 101,A00,958004,Staff,13,0,15,2
1746538269816,PHIL 136,A00,889582,Fulkerson; Matthew Todd,26,0,45,19
1746538270853,PHIL 163,A01,889601,Staff,21,0,30,9
1746538270853,PHIL 163,B01,889606,Brandt; Reuven A,0,3,0,0
1746538271882,PHIL 164,A00,889610,Staff,16,0,30,14
1746538272910,PHIL 165,A00,889613,Staff,23,0,30,7
1746538273938,PHYS 1A,A00,886431,Staff,26,0,70,44
1746538274966,PHYS 1AL,001,886432,Tsai; Philbert S,0,2,30,30
1746538274966,PHYS 1AL,002,886436,Tsai; Philbert S,11,0,30,19
1746538275993,PHYS 1B,A00,886439,Staff,185,0,240,55
1746538277018,PHYS 1BL,001,886441,Tsai; Philbert S,0,4,30,30
1746538277018,PHYS 1BL,002,886444,Tsai; Philbert S,2,0,30,28
1746538278047,PHYS 1C,A00,896092,Arnold; Kam S,78,0,146,68
1746538279081,PHYS 1CL,001,886448,Tsai; Philbert S,0,0,30,30
1746538279081,PHYS 1CL,002,886449,Tsai; Philbert S,0,0,30,30
1746538279081,PHYS 1CL,003,886450,Tsai; Philbert S,15,0,30,15
1746538279081,PHYS 1CL,004,886451,Tsai; Philbert S,15,0,30,15
1746538280110,PHYS 2B,A01,886457,Staff,69,0,115,46
1746538281139,PHYS 2C,A01,886460,Shotwell; Brian,0,8,65,65
1746538282168,PHYS 2CL,A01,886467,Staff,0,4,28,28
1746538282168,PHYS 2CL,A02,886468,Staff,0,3,28,28
1746538283196,PHYS 2D,A01,886470,Staff,10,0,50,40
1746538284229,PHYS 4B,A01,886475,Grinstein; Benjamin,22,0,40,18
1746538285263,POLI 5,A00,891173,Desposato; Scott,7,0,25,18
1746538286292,POLI 5D,A01,891175,Staff,5,0,5,0
1746538286292,POLI 5D,B01,891178,Staff,5,0,5,0
1746538287323,POLI 11,A00,891179,Ferree; Karen E,2,0,35,33
1746538288350,POLI 12,A00,891180,Staff,16,0,30,14
1746538289376,POLI 27,A01,891182,Staff,12,0,75,63
1746538290408,POLI 30,A00,891183,Staff,9,0,50,41
1746538291438,POLI 100B,A00,891244,Staff,5,1,35,30
1746538292471,POLI 100I,A00,891247,Staff,7,0,30,23
1746538293502,POLI 104J,A00,891248,Nichter; Maysa,14,0,30,16
1746538294532,POLI 104U,A00,891250,Nichter; Maysa,2,0,30,28
1746538296596,POLI 110B,A00,891255,Wiens; David,20,0,25,5
1746538297624,POLI 112A,A00,891256,Wiens; David,6,0,25,19
1746538298650,POLI 114BR,A00,891261,Staff,19,0,30,11
1746538299678,POLI 117R,A00,891262,Forman; Fonna,0,6,50,50
1746538300709,POLI 118,A00,891264,Ingham; Sean,17,0,25,8
1746538301741,POLI 124A,A00,891265,Staff,18,0,20,2
1746538302769,POLI 125D,A00,891266,Nichter; Simeon C,2,0,25,23
1746538303794,POLI 126,A00,891268,Nichter; Simeon C,7,0,25,18
1746538304821,POLI 126AA,A00,891272,Staff,18,0,25,7
1746538305852,POLI 130AA,A00,891273,Staff,15,0,20,5
1746538306877,POLI 134AA,A00,891274,Staff,4,0,20,16
1746538308935,POLI 138,A00,891278,Staff,21,0,25,4
1746538309963,POLI 142K,A00,891280,Staff,11,0,25,14
1746538310995,POLI 142M,A00,891281,Gartzke; Erik,17,0,30,13
1746538312024,POLI 142P,A00,891284,Staff,20,0,30,10
1746538313054,POLI 143,A00,891285,Gartzke; Erik,12,0,30,18
1746538314082,POLI 153,A00,891286,Staff,19,0,20,1
1746538316139,POLI 175,A00,891290,Staff,15,0,20,5
1746538317168,PSYC 1,A00,890674,Steiner; Eric Tomas,0,11,45,45
1746538318200,PSYC 2,A00,890676,Albright; Thomas D,21,0,35,14
1746538319229,PSYC 3,A00,890679,Staff,17,0,20,3
1746538320257,PSYC 6,A00,959858,Staff,20,0,20,0
1746538321290,PSYC 60,A01,890684,Rickard; Timothy C.,0,5,45,45
1746538322354,PSYC 70,A01,890689,Geller; Emma Harlan,7,0,30,23
1746538323379,PSYC 71,A01,959860,Staff,21,0,25,4
1746538324412,PSYC 100,A00,890690,Lacefield; Katharine I,0,50,180,180
1746538325440,PSYC 102,A00,890695,Staff,18,0,40,22
1746538326470,PSYC 105,A00,890699,Geller; Emma Harlan,71,0,100,29
1746538327497,PSYC 106,A00,890701,Gorman; Michael R.,5,0,30,25
1746538328526,PSYC 108,A00,890704,Adrian; Julia Anna,0,28,50,50
1746538329554,PSYC 118,A01,890712,Staff,11,0,30,19
1746538330581,PSYC 124,A00,890716,Chapman; Eddie Nathaniel,25,0,60,35
1746538331608,PSYC 131,A00,890717,Anagnostaras; Stephan,0,7,80,80
1746538332634,PSYC 137,A00,890719,Winkielman; Piotr,0,11,30,30
1746538333661,PSYC 144,A00,890721,Adrian; Julia Anna,0,9,45,45
1746538334689,PSYC 162,A00,890805,Staff,2,0,75,73
1746538335717,PSYC 169,A00,890810,Staff,0,15,30,30
1746538336744,PSYC 172,A00,890814,Gorman; Michael R.,9,0,30,21
1746538337771,PSYC 181,A00,890818,Anagnostaras; Stephan,8,0,200,192
1746538338799,PSYC 184,A00,959861,Staff,170,0,175,5
1746538339828,PSYC 189,A00,890823,Staff,0,1,30,30
1746538340865,PSYC 191,A00,890884,Rickard; Timothy C.,0,11,35,35
1746538341896,PSYC 193,A00,890913,Staff,19,0,30,11
1746538341896,PSYC 193,B00,890914,Chapman; Eddie Nathaniel,24,0,30,6
1746538342933,PSYC 193L,A01,890918,Lowe; Angela Beth,20,0,30,10
1746538342933,PSYC 193L,B01,890921,Hurwitz; Ethan Scott,20,0,30,10
1746538342933,PSYC 193L,C01,890928,Staff,30,0,30,0
1746538343961,RELI 149,A00,886806,Rahimi; Babak,23,0,40,17
1746538344993,SE 9,A01,886814,Staff,7,0,20,13
1746538346024,SE 101B,A01,886816,Chadha; Mayank,4,0,35,31
1746538347052,SE 110B,A00,886818,Zhu; Qiang,4,0,75,71
1746538348079,SE 125,A01,886830,Staff,10,0,30,20
1746538349109,SE 130B,A01,886835,Staff,14,0,40,26
1746538350142,SE 131A,A01,886838,Krysl; Petr,34,0,55,21
1746538351166,SE 154,A00,886840,Staff,30,0,50,20
1746538352190,SE 164GS,A01,886849,Staff,6,0,20,14
1746538353256,SE 167GS,A01,886853,Staff,6,0,20,14
1746538354286,SIO 25,A01,890107,Staff,19,0,30,11
1746538355317,SIO 45,A00,890109,Cook; Geoffrey W,117,0,200,83
1746538356348,SIO 109R,A00,890110,Forman; Fonna,0,16,20,20
1746538357379,SIO 187,A01,890114,Kacev; David,15,0,40,25
1746538358419,SOCI 1,A01,890431,Thorpe; Charles Robert,15,0,30,15
1746538358419,SOCI 1,A02,890518,Thorpe; Charles Robert,30,0,30,0
1746538359449,SOCI 2,A01,957978,Staff,25,0,25,0
1746538359449,SOCI 2,A02,957979,Staff,23,0,25,2
1746538360477,SOCI 20,A01,890523,Calderon-Zaks; Michael Aar,23,0,30,7
1746538360477,SOCI 20,A02,890526,Calderon-Zaks; Michael Aar,29,0,30,1
1746538361505,SOCI 30,A01,890533,Pardo Guerra; Juan Pablo,37,0,40,3
1746538362534,SOCI 40,A01,890535,Staff,27,0,45,18
1746538363561,SOCI 104Q,A00,890559,Staff,18,0,30,12
1746538364586,SOCI 106,A00,890560,Arnal; Maud Marie Leonie,20,0,30,10
1746538365618,SOCI 110,A00,890567,Holkenbrink-Monk; Charlene,19,0,30,11
1746538366649,SOCI 112,A00,890568,Victoria Torres; Pablo,1,0,55,54
1746538367679,SOCI 115,A00,890597,Arnal; Maud Marie Leonie,28,0,45,17
1746538369738,SOCI 121,A00,890604,Pardo Guerra; Juan Pablo,38,0,45,7
1746538370765,SOCI 126,A01,890608,Staff,8,0,10,2
1746538371793,SOCI 127,A00,890609,Staff,18,0,30,12
1746538372822,SOCI 131,A00,890610,Thorpe; Charles Robert,37,0,45,8
1746538373851,SOCI 135,A00,890615,Payne; Christine Anna,14,0,45,31
1746538374876,SOCI 139,A00,890620,Staff,38,0,45,7
1746538375903,SOCI 148E,A00,890622,Calderon-Zaks; Michael Aar,36,0,45,9
1746538376930,SOCI 150,A00,890623,Kohler; Kristopher M.,31,0,45,14
1746538377960,SOCI 157,A00,890625,Jules-Rosette; Bennetta W.,18,0,20,2
1746538378985,SOCI 160,A00,890627,Payne; Christine Anna,21,0,45,24
1746538380031,SYN 1,A00,886855,Fish; Gwendolyn Anne,0,0,0,0
1746538380031,SYN 1,B00,906086,Fish; Gwendolyn Anne,0,1,0,2
1746538381059,SYN 2R,A00,886860,Staff,0,17,15,15
1746538381059,SYN 2R,B00,906106,Atkinson; Arthur Laird,0,16,15,15
1746538382089,SYN 100,A01,886866,Browne; Emily,0,28,20,20
1746538382089,SYN 100,B01,906128,Rock; Martin,0,5,20,20
1746538382089,SYN 100,C01,906140,Deavenport; James Cary,0,3,20,20
1746538382089,SYN 100,D01,907816,Deavenport; James Cary,0,5,20,20
1746538383124,TDAC 1,A00,890286,Walsh; Kim C.,9,0,20,11
1746538384155,TDAC 101,A00,890296,Basso; Beatrice,16,0,20,4
1746538385180,TDDE 131,A00,890297,Staff,47,0,50,3
1746538386209,TDDM 1,A00,890287,Weinberg; Sadie,25,0,30,5
1746538387245,TDGE 11,A00,890288,Fulton; Julia,137,0,200,63
1746538387245,TDGE 11,B00,890289,Castro; Robert Jess,184,0,200,16
1746538388277,TDGE 25,B00,957359,Walsh; Kim C.,3,0,20,17
1746538389304,TDGE 40,A01,890292,Power; Jade Yukana,27,0,30,3
1746538390336,TDGE 124,A00,890298,Havis; Allan,0,0,50,50
1746538391364,TDGE 131R,A00,890299,Burelle; Julie Sara Veronique,15,0,42,27
1746538392402,TDHT 101,A00,890300,Staff,10,0,20,10
1746538393431,TDHT 109,A01,890302,Anderson; Mysia Anyse,31,0,40,9
1746538394460,TDMV 1,A00,890293,Arcidiacono; Kristin,18,0,30,12
1746538395485,TDMV 2,A00,890294,Weinberg; Sadie,23,0,30,7
1746538396517,TDMV 3,A00,957878,Arcidiacono; Kristin,28,0,30,2
1746538398570,TDMV 138,A00,890304,Jun; Grace Shin Hae,25,0,40,15
1746538399597,TDMV 140,A00,890305,Corrales; Joseph Bernales,25,0,30,5
1746538400624,TDMV 142,A00,890307,Caligagan; Tony,32,0,40,8
1746538401651,TDMV 144,A00,890308,Camaya; Michelle Ann,25,0,30,5
1746538402684,TDPW 1,A00,890295,Stein; Deborah Isobel,3,0,20,17
1746538403715,USP 2,A01,890272,Lerner; Amy M,6,0,20,14
1746538404746,USP 3,A01,890274,Staff,12,0,30,18
1746538405774,USP 15,A01,890276,Sun; Feiyang,17,0,30,13
1746538406806,USP 25,A00,890277,Shenkman; Michael Thomas,19,0,25,6
1746538407834,USP 138,A00,890278,Staff,13,0,25,12
1746538408863,USP 143,A00,890279,Staff,21,0,70,49
1746538409895,USP 144,A00,890280,Chowdhury; Muhammed Zohir,16,0,30,14
1746538410922,USP 150,A00,890281,Boomhower; Matthew Charles,4,0,30,26
1746538411950,USP 151,A00,890282,Staff,16,0,20,4
1746538412981,USP 162,A00,890283,Andrews; Abigail Leslie,16,0,20,4
1746538414012,USP 168,A00,920477,Kwak; Nancy,1,0,5,4
1746538415039,USP 181,A00,890284,Staff,3,0,20,17
1746538416066,USP 191A,A00,890285,Staff,13,0,20,7
1746538417092,VIS 101,A00,886512,Staff,25,0,75,50
1746538418122,VIS 103,A00,886513,Cruz; Edwin Teddy,61,0,75,14
1746538419150,VIS 108,A00,886514,Staff,3,0,15,12
1746538420178,VIS 127P,A00,886515,Shen; Kuiyi,80,0,146,66
1746538421207,VIS 149,A00,886516,Yoldas; Pinar,0,0,15,15
1746538422236,VIS 164,A00,886526,Erdmann; Dean,19,0,22,3
1746538423266,VIS 194S,A00,886527,Staff,61,0,75,14
1746538424295,WCWP 10A,C00,886484,Martiniuk; Jill,12,0,15,3
1746538425327,WCWP 10B,A00,886490,Uriarte; Emma,0,0,15,15
1746538425327,WCWP 10B,B00,886491,Dhir; Simrita,11,0,15,4
1746538425327,WCWP 10B,C00,886492,Ornelas; Tricia,0,0,15,15
1746538426355,WCWP 100,A00,886494,Young; Mark T,0,7,15,15
1746538428617,AAS 10,A01,886199,Childs; Dennis R.,0,3,0,0
1746538429653,ANAR 104,A01,886940,Shtienberg; Gilad,27,0,30,3
1746538430683,ANAR 120,A00,886953,Staff,12,0,20,8
1746538431711,ANBI 148,A01,886955,Wilder; Linnea Lorene,30,0,40,10
1746538433773,ANSC 122,A00,886957,Staff,25,0,30,5
1746538434804,ANSC 150,A00,886958,Sloane; Julia Kathryn,3,0,15,12
1746538435832,ANSC 156,A00,886959,Jenkins; Janis A.,0,1,15,15
1746538436858,ANSC 180,A00,886960,Staff,11,0,17,6
1746538437886,ANSC 188,A00,886961,Jassal; Aftab,9,0,25,16
1746538438915,ANSC 190,A00,886962,Jassal; Aftab,14,0,25,11
1746538439945,ANSC 191,A00,886963,Staff,18,0,20,2
1746538440976,ANTH 3,A01,891689,Staff,17,0,20,3
1746538442004,ANTH 5,A00,886933,Semendeferi; Ekaterini,16,0,20,4
1746538443032,ANTH 10,A00,886934,Staff,0,12,30,30
1746538444062,ANTH 21,A01,886936,Staff,40,0,60,20
1746538445087,ANTH 23,A01,886938,Staff,92,0,100,8
1746538446113,ANTH 105,A00,886964,Stewart; Alexander B,84,0,100,16
1746538447142,ANTH 108,A00,886965,Pedersen; David,9,0,20,11
1746538448171,AWP 10,001,886147,Staff,0,0,0,0
1746538448171,AWP 10,002,886148,Staff,0,0,0,0
1746538448171,AWP 10,003,886149,Staff,0,0,0,0
1746538448171,AWP 10,004,886150,Staff,0,0,0,0
1746538448171,AWP 10,005,886151,Staff,0,0,0,0
1746538448171,AWP 10,006,886152,Staff,0,0,0,0
1746538448171,AWP 10,007,886153,Staff,0,0,0,0
1746538448171,AWP 10,008,886154,Staff,0,0,0,0
1746538448171,AWP 10,009,886155,Staff,0,0,0,0
1746538448171,AWP 10,010,886156,Staff,0,0,0,0
1746538448171,AWP 10,011,886158,Staff,0,0,0,0
1746538448171,AWP 10,012,886160,Staff,0,0,0,0
1746538448171,AWP 10,013,886161,Staff,0,0,0,0
1746538448171,AWP 10,014,886162,Staff,0,0,0,0
1746538448171,AWP 10,015,886163,Staff,0,0,0,0
1746538448171,AWP 10,016,886164,Staff,0,0,0,0
1746538448171,AWP 10,017,886165,Staff,0,0,0,0
1746538448171,AWP 10,018,886166,Staff,0,0,0,0
1746538448171,AWP 10,019,886168,Staff,0,0,0,0
1746538448171,AWP 10,020,886170,Staff,0,0,0,0
1746538448171,AWP 10,021,886172,Staff,0,0,0,0
1746538449203,AWP 10R,001,886173,Staff,0,1,0,0
1746538449203,AWP 10R,002,886174,Staff,0,1,0,0
1746538449203,AWP 10R,003,886175,Staff,0,0,0,0
1746538449203,AWP 10R,004,886176,Staff,0,0,0,0
1746538449203,AWP 10R,005,886177,Staff,0,0,0,0
1746538449203,AWP 10R,006,886178,Staff,0,0,0,0
1746538449203,AWP 10R,007,886179,Staff,0,0,0,0
1746538449203,AWP 10R,008,886181,Staff,0,0,0,0
1746538449203,AWP 10R,009,886182,Staff,0,0,0,0
1746538449203,AWP 10R,010,886183,Staff,0,0,0,0
1746538449203,AWP 10R,011,886184,Staff,0,0,0,0
1746538449203,AWP 10R,012,886185,Staff,0,0,0,0
1746538449203,AWP 10R,013,886186,Staff,0,0,0,0
1746538449203,AWP 10R,014,886187,Staff,0,0,0,0
1746538449203,AWP 10R,015,886188,Staff,0,0,0,0
1746538449203,AWP 10R,016,886189,Staff,0,0,0,0
1746538450228,AWP 102R,A00,886190,Staff,0,0,0,0
1746538450228,AWP 102R,B00,886191,Staff,0,0,0,0
1746538451256,BENG 100,A01,886193,Staff,17,0,30,13
1746538452282,BENG 122A,A01,886195,Hasty; Jeff M,13,0,30,17
1746538453314,BENG 166A,A00,886196,Sah; Robert Lie-Yuan,0,1,30,30
1746538454343,BENG 190,A00,958050,Khojah; Reem I,24,0,25,1
1746538455374,BIBC 102,A01,894320,Staff,0,0,46,46
1746538455374,BIBC 102,A02,894321,Staff,1,0,46,45
1746538455374,BIBC 102,A03,894344,Staff,7,0,46,39
1746538455374,BIBC 102,A04,894345,Staff,26,0,47,21
1746538456401,BICD 100R,A01,894365,Smith; Laurie,0,3,58,58
1746538456401,BICD 100R,A02,894366,Smith; Laurie,0,5,58,58
1746538456401,BICD 100R,A03,894367,Smith; Laurie,2,0,59,57
1746538456401,BICD 100R,A04,959869,Smith; Laurie,41,0,59,18
1746538457431,BICD 136,A01,894383,Gustafson-Brown; Cindy,14,0,50,36
1746538458466,BIEB 102,A01,894494,Butler; Shannon Rhey,51,0,130,79
1746538460523,BIEB 150,A01,894617,Wills; Christopher,3,0,20,17
1746538460523,BIEB 150,A02,894631,Wills; Christopher,3,0,20,17
1746538460523,BIEB 150,A03,894937,Wills; Christopher,3,0,20,17
1746538460523,BIEB 150,A04,894946,Wills; Christopher,5,0,20,15
1746538461549,BIEB 194,A00,906141,Kurle; Carolyn M.,6,0,20,14
1746538462577,BILD 1,A01,894154,Staff,2,0,19,17
1746538462577,BILD 1,A02,894155,Staff,14,0,19,5
1746538462577,BILD 1,A03,894160,Staff,13,0,19,6
1746538462577,BILD 1,A04,894161,Staff,15,0,18,3
1746538463606,BILD 2,A01,894168,Staff,0,0,50,50
1746538463606,BILD 2,A02,894169,Staff,0,0,50,50
1746538463606,BILD 2,A03,894179,Staff,4,0,50,46
1746538463606,BILD 2,A04,894203,Staff,27,0,50,23
1746538464633,BILD 3,A01,894213,Staff,22,0,31,9
1746538464633,BILD 3,A02,894214,Staff,26,0,31,5
1746538464633,BILD 3,A03,894235,Staff,28,0,31,3
1746538464633,BILD 3,A04,894236,Staff,28,0,32,4
1746538465667,BILD 4,A01,894253,Reuther; Keefe,5,0,24,19
1746538465667,BILD 4,A02,894258,Reuther; Keefe,16,0,24,8
1746538466695,BILD 5,A01,894276,Reuther; Keefe,35,0,50,15
1746538466695,BILD 5,A02,894277,Reuther; Keefe,45,0,50,5
1746538466695,BILD 5,A03,894290,Reuther; Keefe,44,0,50,6
1746538466695,BILD 5,A04,894291,Reuther; Keefe,48,0,50,2
1746538467721,BILD 24,A01,894297,Pirino; Giorgia,40,0,60,20
1746538468754,BIMM 100,B01,958915,Staff,72,0,100,28
1746538469782,BIMM 101,A01,895017,McDonnell; Lisa Marie,0,5,24,24
1746538469782,BIMM 101,A02,895018,McDonnell; Lisa Marie,0,5,24,24
1746538469782,BIMM 101,B01,895020,McDonnell; Lisa Marie,0,6,24,24
1746538469782,BIMM 101,B02,895021,McDonnell; Lisa Marie,0,4,24,24
1746538470814,BIMM 110,A01,895023,Staff,1,0,25,24
1746538470814,BIMM 110,A02,895024,Staff,9,0,25,16
1746538470814,BIMM 110,A03,895025,Staff,18,0,25,7
1746538470814,BIMM 110,A04,895031,Staff,20,0,25,5
1746538471841,BIMM 120,A01,895114,Gustafson-Brown; Cindy,13,0,28,15
1746538471841,BIMM 120,A02,895126,Gustafson-Brown; Cindy,21,0,27,6
1746538472869,BIPN 100,A01,895130,Yang; Mingyu,1,0,38,37
1746538472869,BIPN 100,A02,895131,Yang; Mingyu,32,0,38,6
1746538472869,BIPN 100,A03,895132,Yang; Mingyu,32,0,38,6
1746538472869,BIPN 100,A04,895133,Yang; Mingyu,27,0,36,9
1746538473895,BIPN 120,A01,895135,Cooke; James Edward,0,3,13,13
1746538473895,BIPN 120,A02,895136,Cooke; James Edward,0,1,13,13
1746538473895,BIPN 120,A03,895137,Cooke; James Edward,0,3,13,13
1746538473895,BIPN 120,A04,895156,Cooke; James Edward,0,2,11,11
1746538474922,BIPN 134,A01,895235,Cooke; James Edward,0,2,25,25
1746538474922,BIPN 134,A02,895237,Cooke; James Edward,0,0,25,25
1746538474922,BIPN 134,A03,895240,Cooke; James Edward,3,0,25,22
1746538474922,BIPN 134,A04,895270,Cooke; James Edward,20,0,25,5
1746538475953,BIPN 189,A00,892103,Staff,0,13,14,14
1746538478008,BISP 194,A00,958008,Staff,0,2,0,0
1746538479037,CAT 124,A01,922009,Staff,0,5,20,20
1746538480084,CAT 125R,A00,886390,Morales; Celeste Georgianna,0,2,20,20
1746538480084,CAT 125R,B00,886391,Irwin; Matthew Joseph,0,3,20,20
1746538480084,CAT 125R,C00,886392,Smith; Lauryn Alissa,0,2,20,20
1746538480084,CAT 125R,D00,886393,Vanderschuit; Maya Alysia,0,2,20,20
1746538480084,CAT 125R,E00,886394,Marchisotto; Jennifer Anne,0,4,20,20
1746538481119,CENG 15,A01,886218,Drews; Aaron,3,0,8,5
1746538482146,CENG 113,A00,886219,Opatkiewicz; Justin Paul,15,0,25,10
1746538483176,CGS 101,A00,887044,Staff,7,0,20,13
1746538484203,CGS 105,A01,887046,Staff,14,0,25,11
1746538485228,CGS 112,A00,887047,Cuong; Marisol,12,0,15,3
1746538486293,CGS 113,A00,887048,Staff,23,0,30,7
1746538487321,CGS 120,A00,887049,Staff,10,0,17,7
1746538488353,CHEM 6A,A01,886336,Lam; Tin Yiu,38,0,50,12
1746538488353,CHEM 6A,A02,886338,Lam; Tin Yiu,37,0,50,13
1746538489382,CHEM 6B,A01,886341,Hopkins; Patrycja Anna,16,0,50,34
1746538489382,CHEM 6B,A02,886343,Hopkins; Patrycja Anna,42,0,50,8
1746538490416,CHEM 6C,A01,886346,Albizati; Kim F.,0,2,50,50
1746538490416,CHEM 6C,A02,886348,Albizati; Kim F.,23,0,50,27
1746538491446,CHEM 40A,A01,886352,Klosterman; Jeremy K,65,0,100,35
1746538492474,CHEM 40B,A01,886356,Klosterman; Jeremy K,0,23,100,100
1746538493503,CHEM 41B,A01,886360,Theodorakis; Emmanuel,25,0,50,25
1746538493503,CHEM 41B,A02,886362,Theodorakis; Emmanuel,47,0,50,3
1746538494529,CHIN 165A,A00,886382,Xu; Li,18,0,20,2
1746538495558,CLAS 120,A00,886387,Myerston Santana; Jacobo,33,0,40,7
1746538496587,COGS 9,A01,886967,Shannon; Kyle Michael,42,0,60,18
1746538497613,COGS 11,A01,886969,Staff,11,0,30,19
1746538498639,COGS 14A,A01,886971,Staff,6,0,60,54
1746538499666,COGS 14B,A01,886973,Hoffman; Drew Ellen,4,0,60,56
1746538500692,COGS 18,A01,886975,Morgan; Eric,35,0,60,25
1746538501717,COGS 20,A01,886977,Staff,4,0,8,4
1746538501717,COGS 20,A02,886978,Staff,5,0,7,2
1746538502748,COGS 100,A01,907783,Staff,0,2,30,30
1746538503781,COGS 101B,A01,886980,Staff,0,3,48,48
1746538504813,COGS 101C,A01,886982,Delgado; Tania,0,5,44,44
1746538505841,COGS 102A,A01,886984,Johnson; Christine M.,4,0,30,26
1746538506867,COGS 118B,A01,886986,Staff,0,3,88,88
1746538507897,COGS 150,A01,886988,Bergen; Benjamin,23,0,50,27
1746538508922,COGS 153,A00,886989,Delgado; Tania,0,2,41,41
1746538509952,COGS 186,A01,886991,Staff,0,0,32,32
1746538510985,COGS 187A,A01,886993,Boyle; Mary E. T.,7,0,30,23
1746538512011,COGS 189,A00,886994,Staff,0,1,30,30
1746538513042,COMM 10,A01,886996,Staff,0,0,20,21
1746538513042,COMM 10,A02,886997,Staff,12,0,20,8
1746538513042,COMM 10,A03,959845,Staff,19,0,20,1
1746538514073,COMM 20,A01,886999,Leuning; Grant Maurstad,24,0,40,16
1746538516124,COMM 100A,A01,887002,Staff,0,0,20,25
1746538516124,COMM 100A,A02,887003,Staff,7,0,20,13
1746538517152,COMM 100B,A01,887005,Staff,0,8,20,24
1746538518178,COMM 106D,A00,887006,Staff,14,0,40,26
1746538519205,COMM 110G,A00,887007,Whitworth-Smith; Andrew C,12,0,40,28
1746538520230,COMM 111B,A00,887008,Staff,31,0,40,9
1746538521259,COMM 113T,A00,887009,Abuelhiga; Soraya Jill,28,0,40,12
1746538521259,COMM 113T,B00,906733,Staff,40,0,40,0
1746538522292,COMM 145,A00,887010,Staff,12,0,40,28
1746538523321,COMM 146,A00,887054,Staff,31,0,40,9
1746538524346,COMM 190,A00,887012,Staff,8,0,23,15
1746538525383,CSE 8A,A50,887015,Cao; Yingjun,57,0,85,28
1746538526411,CSE 11,A01,887017,Cao; Yingjun,12,0,70,58
1746538527439,CSE 20,A01,887019,Staff,30,0,50,20
1746538528470,CSE 21,A01,887021,Staff,78,0,100,22
1746538528470,CSE 21,B01,892583,Braun; Oliver,45,0,50,5
1746538529496,CSE 30,A01,887025,Eldon; John,143,0,200,57
1746538530522,CSE 100,A01,887027,Staff,26,0,50,24
1746538530522,CSE 100,A02,887028,Staff,40,0,50,10
1746538531556,CSE 101,A01,887030,Braun; Oliver,75,0,100,25
1746538531556,CSE 101,B01,887032,Jones; Miles E,0,3,50,50
1746538531556,CSE 101,B02,887033,Jones; Miles E,0,1,50,50
1746538532589,CSE 105,A01,908084,Jones; Miles E,32,0,50,18
1746538532589,CSE 105,A02,908087,Jones; Miles E,33,0,50,17
1746538533616,CSE 135,A01,887035,Powell; Thomas Allan,0,4,50,50
1746538534643,CSE 142,A01,887037,Staff,8,0,60,52
1746538535673,CSE 142L,A01,887039,Staff,34,0,60,26
1746538536703,CSE 151A,A01,887041,Solares; Edwin A,48,0,100,52
1746538537730,CSE 175,A01,887043,Kumar; Rakesh,30,0,30,0
1746538538756,CSS 1,A01,886389,Staff,0,1,40,40
1746538539786,DSC 30,A01,908097,Liao; Soohyun Nam,47,0,75,28
1746538540811,DSC 40A,A01,908099,Shannon; Kyle Michael,30,0,50,20
1746538541840,DSC 40B,A01,908112,Staff,16,0,50,34
1746538542868,DSC 80,A01,908116,Staff,19,0,60,41
1746538543893,DSC 197,001,956863,Eldridge; Justin Matthew,9999,0,9999,0
1746538544920,ECE 5,A01,886400,Morris; Karcher William,2,0,6,4
1746538544920,ECE 5,A02,886401,Morris; Karcher William,3,0,6,3
1746538545951,ECE 148,A01,886403,Silberman; Jack,0,14,14,14
1746538546978,ECON 1,A01,887265,Crane; Meredith Helen,12,0,70,58
1746538546978,ECON 1,B01,887268,Staff,43,0,50,7
1746538548009,ECON 2,A01,887273,Crane; Meredith Helen,56,0,70,14
1746538549036,ECON 3,A01,887279,Rondina; Giacomo,32,0,70,38
1746538550070,ECON 4,A01,887282,Anderson; John Charles,0,2,10,10
1746538551099,ECON 5,A01,887285,Staff,33,0,45,12
1746538551099,ECON 5,B01,887292,Staff,41,0,45,4
1746538552126,ECON 100A,A01,887337,Newhouse; Herbert S,54,0,70,16
1746538552126,ECON 100A,B01,887349,Staff,45,0,50,5
1746538553153,ECON 100B,A01,887361,Du; Songzi,29,0,70,41
1746538554290,ECON 100C,A01,887445,Newhouse; Herbert S,59,0,70,11
1746538555315,ECON 105,A00,887488,Vespa; Emanuel Ignacio,23,0,35,12
1746538556342,ECON 109,A01,887506,Shishkin; Denis,28,0,35,7
1746538557382,ECON 110A,A01,887568,Alon; Titan Michael,0,3,35,35
1746538557382,ECON 110A,B01,907601,Alon; Titan Michael,20,0,35,15
1746538558414,ECON 110B,A01,887598,Levkoff; Steven B.,0,23,70,70
1746538559440,ECON 112,A00,887599,Rondina; Giacomo,19,0,35,16
1746538560475,ECON 120A,A01,887603,Dai; Yinlin,36,0,70,34
1746538561503,ECON 120C,A01,887608,Sun; Yixiao,0,1,35,35
1746538561503,ECON 120C,B01,887614,Sun; Yixiao,0,0,35,35
1746538562533,ECON 138,A00,887621,Bharadwaj; Prashant,0,20,20,20
1746538563558,ECON 144,A00,958007,Squires; Dale E,13,0,35,22
1746538564589,ECON 171,A01,907666,Staff,18,0,35,17
1746538565616,ECON 175,A00,887626,Wu; Pak Yeung,23,0,35,12
1746538566643,ECON 190,A00,887640,Vespa; Emanuel Ignacio,23,0,35,12
1746538567686,EDS 25,A01,888197,Staff,0,0,0,0
1746538567686,EDS 25,A02,888209,Staff,0,0,0,0
1746538567686,EDS 25,A03,888210,Staff,0,0,0,0
1746538567686,EDS 25,A04,888212,Staff,0,0,0,0
1746538567686,EDS 25,A05,888213,Staff,0,0,0,0
1746538567686,EDS 25,A06,888214,Staff,0,0,0,0
1746538567686,EDS 25,A07,888235,Staff,0,2,0,0
1746538567686,EDS 25,A08,888236,Staff,0,0,0,0
1746538567686,EDS 25,A09,888240,Staff,0,0,0,0
1746538567686,EDS 25,A10,888244,Staff,0,0,0,0
1746538567686,EDS 25,B01,888273,Staff,0,0,0,0
1746538567686,EDS 25,B02,888285,Staff,0,0,0,0
1746538567686,EDS 25,B03,888423,Staff,0,0,0,1
1746538567686,EDS 25,B04,888432,Staff,0,0,0,0
1746538567686,EDS 25,B05,888433,Staff,0,0,0,0
1746538567686,EDS 25,B06,888467,Staff,0,0,0,0
1746538567686,EDS 25,B07,888468,Staff,0,0,0,0
1746538567686,EDS 25,B08,888479,Staff,0,0,0,0
1746538567686,EDS 25,B09,888484,Staff,0,0,0,0
1746538567686,EDS 25,B10,888487,Staff,0,0,0,0
1746538568715,EDS 38,A01,907700,Choi; Bailey Miyeon,30,0,30,0
1746538569742,EDS 112,A01,888601,Chapman; Thandeka K,14,0,40,26
1746538570770,EDS 115,A00,888697,Mendez; Kathrina Mendoza,10,0,30,20
1746538571802,EDS 116,A01,888893,Staff,35,0,40,5
1746538573853,EDS 124AR,A00,889133,Staff,29,0,50,21
1746538573853,EDS 124AR,B00,907471,Simon; Elizabeth A,37,0,50,13
1746538574879,EDS 124BR,A00,889134,Simon; Elizabeth A,45,0,100,55
1746538575914,EDS 125,A00,889135,Staff,25,0,30,5
1746538576939,EDS 126,A01,889138,Staff,36,0,40,4
1746538577962,EDS 164R,A01,889142,Wishard Guerra; Alison G.,33,0,50,17
1746538578987,ENG 30,A01,886396,Staff,0,0,0,0
1746538578987,ENG 30,B01,886398,Staff,0,0,0,0
1746538580021,ENVR 102,A00,906150,Montejo; Carolina,23,0,25,2
1746538581048,ETHN 103A,A00,887236,Man; Simeon S,0,3,0,0
1746538582076,ETHN 113,A00,887239,Staff,16,0,30,14
1746538583102,ETHN 116,A00,887240,Staff,16,0,25,9
1746538584128,ETHN 117,A00,887241,Choi; Esther Min,28,0,30,2
1746538585154,ETHN 118,A00,887243,Staff,24,0,30,6
1746538586182,ETHN 127,A00,887248,Cuong; Marisol,11,0,15,4
1746538587207,ETHN 139,A00,887250,Staff,7,0,10,3
1746538588261,ETHN 142,A00,887252,Staff,10,0,30,20
1746538589291,ETHN 161,A00,887253,Browne; Errol Tsekani,24,0,30,6
1746538590317,ETHN 163FR,A00,887255,Burelle; Julie Sara Veronique,0,0,5,5
1746538591354,GLBH 20,A00,889149,Elwardani; Nile Regina,8,0,42,34
1746538593405,GLBH 111,A01,889152,Burgos; Jose L.,17,0,17,0
1746538594439,GLBH 150,A00,889181,Sloane; Julia Kathryn,0,5,15,15
1746538596509,HDS 60,A01,886406,Warstadt; Melissa Fawn,73,0,80,7
1746538597540,HIAF 111,A00,889324,Gyamfi; Bright,25,0,32,7
1746538598567,HIEA 131,A00,889328,Staff,16,0,32,16
1746538599599,HIEA 144,A00,889333,Henry; Todd A.,26,0,32,6
1746538600629,HIEA 154,A00,889336,Henry; Todd A.,24,0,32,8
1746538601660,HIEU 106,A00,889339,Staff,22,0,32,10
1746538603716,HIEU 114,A00,889340,Staff,3,0,32,29
1746538604752,HIEU 135GS,A00,889342,Patterson; Patrick H.,0,0,1,24
1746538605780,HIEU 137,A00,889343,Edington; Claire Ellen,9,0,25,16
1746538606814,HIEU 148,A00,889345,Staff,14,0,32,18
1746538607843,HIEU 154,A00,889346,Biess; Frank Peter,21,0,32,11
1746538608871,HILA 102,A00,889351,Staff,12,0,32,20
1746538609905,HILD 2A,A01,889221,Lewandoski; Julia Mavis,1,10,32,31
1746538610997,HILD 7B,A01,889225,Man; Simeon S,0,13,32,32
1746538612024,HILD 7C,A01,889288,Alvarez; Luis A,0,14,32,32
1746538613049,HILD 30,A01,889323,Staff,0,5,32,32
1746538615163,HISC 119,A00,889383,Golan; Tal,21,0,32,11
1746538616187,HIUS 103,A00,889384,Man; Simeon S,0,0,32,32
1746538617219,HIUS 117,A00,919797,Kwak; Nancy,18,0,32,14
1746538618246,HIUS 142A,A00,919788,Staff,22,0,32,10
1746538620299,HIUS 149,A00,889386,Gyamfi; Bright,27,0,32,5
1746538621327,HIUS 155,A00,889387,Alvarez; Luis A,14,0,32,18
1746538622367,HUM 3,A01,886499,Caldwell; Michael Alan,19,0,50,31
1746538623404,HUM 3GS,A00,886500,Rodriguez; Bretton Sigfred,0,0,0,28
1746538624431,HUM 3R,A01,886502,Markman; Kristina,0,36,50,50
1746538625457,HUM 4,A01,886504,Crum; Matthew Stephen,24,0,50,26
1746538625457,HUM 4,B01,886506,West; Geoffrey Scott,17,0,50,33
1746538626485,HUM 4GS,A00,886507,Staff,0,0,0,19
1746538627518,HUM 5,A01,886509,Staff,32,0,50,18
1746538628544,HUM 5R,A01,886511,Zavodny; Tatiana Sophia,0,39,50,50
1746538629570,JAPN 180,A00,886407,Staff,18,0,40,22
1746538630598,LATI 50,A01,886409,Martin-Cabrera; Luis,4,0,22,18
1746538630598,LATI 50,A02,886410,Martin-Cabrera; Luis,19,0,22,3
1746538630598,LATI 50,A03,886411,Martin-Cabrera; Luis,21,0,22,1
1746538630598,LATI 50,A04,886412,Martin-Cabrera; Luis,9,0,22,13
1746538631626,LAWS 101,A00,907664,Staff,28,0,60,32
1746538632657,LIAB 1A,A00,889388,Saab; Dima,17,0,20,3
1746538633684,LIAB 1AX,A00,889389,El Cheddadi; Youniss,17,0,20,3
1746538634716,LIFR 1C,A00,889391,Van Moer; Vinciane G,8,0,20,12
1746538635742,LIFR 1CX,A00,889392,Van Moer; Vinciane G,7,0,20,13
1746538636771,LIFR 1D,A00,889393,Van Moer; Vinciane G,7,0,20,13
1746538637799,LIFR 1DX,A00,889394,Van Moer; Vinciane G,8,0,20,12
1746538638831,LIGN 7,A00,886923,Staff,24,0,50,26
1746538639871,LIGN 17,A00,886924,Kehler; Andrew Scott,125,0,150,25
1746538640901,LTAM 110,A00,889395,Staff,15,0,30,15
1746538641928,LTAM 110GS,A00,958010,Rodriguez; Bretton Sigfred,0,0,0,28
1746538642957,LTCH 101,A00,889397,Staff,23,0,25,2
1746538643984,LTCS 130,A00,889398,Staff,23,0,25,2
1746538645009,LTEA 138,A00,889399,Staff,24,0,40,16
1746538646040,LTEN 149,A00,889400,Wesling; Megan E.,0,3,25,25
1746538647065,LTEN 169,A00,889401,Staff,20,0,25,5
1746538648094,LTEN 180,A00,889402,Staff,10,0,15,5
1746538649122,LTEN 181,A00,889403,Staff,21,0,25,4
1746538650152,LTWL 100,A00,889404,Myerston Santana; Jacobo,3,0,25,22
1746538651180,LTWL 180GS,A00,889405,Staff,0,0,20,20
1746538652208,LTWL 181,A00,889406,Staff,17,0,25,8
1746538653235,LTWL 184,A00,889475,Mukherjee; Silpa,22,0,25,3
1746538654264,LTWR 102C,A00,889486,Staff,29,0,30,1
1746538655290,LTWR 115W,A00,889491,Staff,0,2,15,15
1746538656317,MAE 8,A01,886905,Staff,0,2,0,0
1746538657348,MAE 11,A00,886906,Bandaru; Prabhakar,0,7,50,50
1746538658376,MAE 20,A00,886907,Evdokimenko; Ekaterina,44,0,70,26
1746538659406,MAE 30B,A00,886909,Ghazinejad; Maziar,26,0,45,19
1746538660435,MAE 101B,A00,886910,Saintillan; David,29,0,45,16
1746538661462,MAE 105,A00,886911,Bandaru; Prabhakar,18,0,50,32
1746538662496,MAE 107,B00,958024,Staff,9,0,50,41
1746538663526,MAE 143B,A00,886913,Bewley; Thomas R,7,0,40,33
1746538664552,MAE 148,A01,886915,Silberman; Jack,0,3,14,14
1746538665586,MAE 160,A00,886916,Evdokimenko; Ekaterina,31,0,60,29
1746538666616,MATH 3C,A01,889681,Staff,0,3,30,30
1746538666616,MATH 3C,A02,960048,Staff,25,0,30,5
1746538667648,MATH 10A,A01,889760,Staff,26,0,30,4
1746538667648,MATH 10A,A02,889783,Staff,29,0,30,1
1746538668714,MATH 10B,A01,889785,Verstraete; Jacques Allan,2,0,35,33
1746538668714,MATH 10B,A02,889795,Verstraete; Jacques Allan,4,0,35,31
1746538668714,MATH 10B,B01,889797,Verstraete; Jacques Allan,3,0,35,32
1746538668714,MATH 10B,B02,889828,Verstraete; Jacques Allan,3,0,35,32
1746538669744,MATH 10C,A01,889849,Habib; Yousaf,9,0,30,21
1746538669744,MATH 10C,A02,889852,Habib; Yousaf,14,0,30,16
1746538669744,MATH 10C,A03,889853,Habib; Yousaf,22,0,30,8
1746538669744,MATH 10C,A04,889858,Habib; Yousaf,20,0,30,10
1746538669744,MATH 10C,B01,889861,Staff,1,0,30,29
1746538669744,MATH 10C,B02,889862,Staff,24,0,30,6
1746538669744,MATH 10C,B03,889863,Staff,27,0,30,3
1746538669744,MATH 10C,B04,889967,Staff,23,0,30,7
1746538670774,MATH 18,A01,889974,Staff,7,0,30,23
1746538670774,MATH 18,A02,889977,Staff,20,0,30,10
1746538670774,MATH 18,B01,889984,Hardiman; Liam,22,0,30,8
1746538670774,MATH 18,B02,889985,Hardiman; Liam,25,0,30,5
1746538671802,MATH 20A,A01,889990,Suk; Andrew Hoon,29,0,35,6
1746538672834,MATH 20B,A01,889993,Ohm; Ko Woon,22,0,30,8
1746538672834,MATH 20B,A02,889994,Ohm; Ko Woon,30,0,30,0
1746538672834,MATH 20B,B01,889996,Ohm; Ko Woon,21,0,30,9
1746538672834,MATH 20B,B02,889997,Ohm; Ko Woon,23,0,30,7
1746538673865,MATH 20C,A01,889999,Hammock; Frances H,17,0,30,13
1746538673865,MATH 20C,A02,890003,Hammock; Frances H,23,0,30,7
1746538673865,MATH 20C,B01,890006,Hammock; Frances H,3,0,30,27
1746538673865,MATH 20C,B02,890007,Hammock; Frances H,11,0,30,19
1746538674894,MATH 20D,A01,890011,Cheng; Hsiao-Bing,1,1,30,29
1746538674894,MATH 20D,A02,890012,Cheng; Hsiao-Bing,14,0,30,16
1746538674894,MATH 20D,B01,890016,Cheng; Hsiao-Bing,13,0,30,17
1746538674894,MATH 20D,B02,890017,Cheng; Hsiao-Bing,13,0,30,17
1746538675929,MATH 20E,A01,890026,Harel; Guershon,1,0,30,29
1746538675929,MATH 20E,A02,890029,Harel; Guershon,23,0,30,7
1746538675929,MATH 20E,B01,890033,Harel; Guershon,7,0,30,23
1746538675929,MATH 20E,B02,890101,Harel; Guershon,21,0,30,9
1746538679751,MATH 102,A01,890104,Staff,17,0,30,13
1746538679751,MATH 102,A02,890105,Staff,27,0,30,3
1746538680777,MATH 103B,A01,890116,Salehi Golsefidy; Alireza,3,0,30,27
1746538680777,MATH 103B,B01,890118,Staff,0,3,34,34
1746538681816,MATH 109,A01,890121,Aliabadi Sr.; Mohsen,1,0,30,29
1746538681816,MATH 109,B01,890124,Upadrashta; Pranav Kumar,18,0,30,12
1746538682845,MATH 120A,A01,890126,Eggers; John Dietrich,13,0,30,17
1746538683879,MATH 142B,A01,890128,Ioana; Adrian,19,0,30,11
1746538683879,MATH 142B,A02,890129,Ioana; Adrian,13,0,30,17
1746538684909,MATH 154,A01,890174,Staff,0,0,30,30
1746538684909,MATH 154,A02,890182,Staff,0,0,30,30
1746538685934,MATH 168A,A01,890197,Dumitriu; Ioana,21,0,35,14
1746538686991,MATH 170A,A01,890240,Nie; Jiawang,1,0,30,29
1746538686991,MATH 170A,A02,890241,Nie; Jiawang,11,0,30,19
1746538686991,MATH 170A,A03,890249,Nie; Jiawang,23,0,30,7
1746538688017,MATH 170B,A01,957891,Nag; Panchali,13,0,35,22
1746538690068,MATH 181A,A01,908025,Staff,0,4,35,35
1746538690068,MATH 181A,A02,960115,Staff,27,0,35,8
1746538691095,MATH 181B,A01,959874,Staff,26,0,30,4
1746538692126,MATH 193B,A01,890265,Staff,0,4,35,35
1746538693153,MGT 4,A01,890311,Anderson; John Charles,42,0,88,46
1746538694184,MGT 5,A00,907740,Staff,13,0,98,85
1746538695209,MGT 12,A00,890312,Lindenberger; Wade Douglas,67,0,98,31
1746538696235,MGT 16,A00,957883,Staff,78,0,98,20
1746538698299,MGT 45,A00,890314,Pecore; Joseph P.,47,0,98,51
1746538699323,MGT 71,A00,890315,Staff,0,11,98,98
1746538700350,MGT 100,A00,890316,Yavorsky; Daniel Ryan,44,0,98,54
1746538701376,MGT 103,A00,890317,Ehrich; Kristine R,73,0,98,25
1746538702404,MGT 105,A00,890356,Bates; Kenneth Walter,0,7,98,98
1746538703430,MGT 112,A00,890360,Ehrich; Kristine R,55,0,98,43
1746538704457,MGT 127R,A00,907732,Zhu; Kevin Xiaoguo,23,0,98,75
1746538705486,MGT 131B,A00,890361,Anderson; John Charles,61,0,98,37
1746538706512,MGT 137,A00,890362,Lindenberger; Wade Douglas,65,0,98,33
1746538707539,MGT 160,A00,890369,Johnson; Erik Barry,9,0,98,89
1746538709590,MGT 164,A00,890372,Zimmermann; Carsten,0,39,98,98
1746538710617,MGT 180,A00,890374,Bliss; Barbara Ann,12,0,98,86
1746538711649,MMW 15,A01,886414,Chang; Edmond Yi-Teh,0,12,28,28
1746538711649,MMW 15,A02,886415,Chang; Edmond Yi-Teh,0,8,28,28
1746538711649,MMW 15,A03,886416,Chang; Edmond Yi-Teh,0,8,28,28
1746538711649,MMW 15,A04,886417,Chang; Edmond Yi-Teh,0,8,28,28
1746538711649,MMW 15,B01,886419,Chang; Edmond Yi-Teh,0,7,28,28
1746538711649,MMW 15,B02,886420,Chang; Edmond Yi-Teh,0,8,28,28
1746538711649,MMW 15,B03,886421,Chang; Edmond Yi-Teh,0,7,28,28
1746538711649,MMW 15,B04,886422,Chang; Edmond Yi-Teh,0,8,28,28
1746538711649,MMW 15,C01,886424,Staff,0,9,28,28
1746538711649,MMW 15,C02,886425,Staff,0,8,28,28
1746538711649,MMW 15,C03,886426,Staff,0,8,28,28
1746538711649,MMW 15,C04,886427,Staff,0,7,28,28
1746538711649,MMW 15,C05,958038,Staff,0,7,28,28
1746538711649,MMW 15,C06,958039,Staff,0,8,28,28
1746538712674,MMW 15GS,A00,906910,Patterson; Patrick H.,4,0,28,24
1746538713705,MMW 122R,A01,886429,Rahimi; Babak,0,13,28,28
1746538713705,MMW 122R,A02,886430,Rahimi; Babak,0,12,28,28
1746538713705,MMW 122R,A03,958040,Rahimi; Babak,0,11,28,28
1746538714741,MUS 1A,A01,890937,Staff,3,0,25,22
1746538714741,MUS 1A,A02,891035,Staff,6,0,25,19
1746538714741,MUS 1A,C01,958912,Staff,24,0,25,1
1746538714741,MUS 1A,C02,958913,Staff,25,0,25,0
1746538716798,MUS 2AK,A00,957092,Ohnishi; Takae,15,0,15,0
1746538717823,MUS 4,A01,891044,Staff,2,0,25,23
1746538717823,MUS 4,A02,891045,Staff,23,0,25,2
1746538717823,MUS 4,B01,891048,Staff,17,0,25,8
1746538717823,MUS 4,B02,891050,Staff,25,0,25,0
1746538718853,MUS 5,A01,957506,Dubnov; Shlomo,0,0,25,25
1746538718853,MUS 5,A02,957622,Dubnov; Shlomo,14,0,25,11
1746538718853,MUS 5,A03,957623,Dubnov; Shlomo,20,0,25,5
1746538719882,MUS 6,A01,891053,Freitas Caetano; Marcelo,24,0,25,1
1746538719882,MUS 6,A02,891054,Freitas Caetano; Marcelo,23,0,25,2
1746538720940,MUS 7,A01,891081,Staff,0,0,25,25
1746538720940,MUS 7,A02,891082,Staff,4,0,25,21
1746538721975,MUS 8GS,A00,891118,Borgo; David Garcia,0,0,25,25
1746538723004,MUS 11,A01,891140,Staff,11,0,25,14
1746538723004,MUS 11,A02,891141,Staff,22,0,25,3
1746538724030,MUS 13,A01,891143,Staff,8,0,25,17
1746538724030,MUS 13,A02,891144,Staff,24,0,25,1
1746538725054,MUS 15,A01,891146,Staff,9,0,25,16
1746538725054,MUS 15,A02,891148,Staff,21,0,25,4
1746538725054,MUS 15,B01,891150,Staff,18,0,25,7
1746538725054,MUS 15,B02,891151,Staff,25,0,25,0
1746538726084,MUS 20,A01,891153,Staff,5,0,20,15
1746538726084,MUS 20,A02,891155,Staff,14,0,20,6
1746538727112,MUS 80,A00,891156,Staff,19,0,25,6
1746538727112,MUS 80,B00,891157,Staff,23,0,25,2
1746538728136,MUS 130,A00,891158,Ohnishi; Takae,35,0,35,0
1746538729162,MUS 150GS,A01,891160,Borgo; David Garcia,0,0,25,25
1746538730189,MUS 170,A01,891162,Freitas Caetano; Marcelo,20,0,25,5
1746538730189,MUS 170,A02,891164,Freitas Caetano; Marcelo,21,0,25,4
1746538731221,NANO 11,A00,886220,Vazquez Mena; Oscar,13,0,15,2
1746538732251,NANO 15,A01,886222,Drews; Aaron,4,0,7,3
1746538733283,NANO 104,A00,886224,Sirbuly; Donald,18,0,25,7
1746538734314,PH 40,A00,886528,Staff,23,0,40,17
1746538735341,PH 45,A01,886799,Staff,35,0,40,5
1746538736367,PH 110,A00,886802,Staff,0,7,40,40
1746538737396,PH 172,A00,906716,Staff,19,0,35,16
1746538738423,PH 191,A00,886803,Staff,6,0,40,34
1746538739455,PHIL 1,A00,889500,Staff,19,0,30,11
1746538740490,PHIL 10,A01,889549,Grush; Rick Scott,15,0,22,7
1746538740490,PHIL 10,A02,889551,Grush; Rick Scott,22,0,22,0
1746538741524,PHIL 28,A01,889559,Lamey; Andy M.,0,1,31,31
1746538741524,PHIL 28,A02,889561,Lamey; Andy M.,0,1,30,30
1746538741524,PHIL 28,A03,889572,Lamey; Andy M.,0,0,30,30
1746538742551,PHIL 35,A00,907839,Staff,13,0,15,2
1746538743574,PHIL 60,A00,889574,Staff,74,0,90,16
1746538744606,PHIL 101,A00,958004,Staff,13,0,15,2
1746538746657,PHIL 136,A00,889582,Fulkerson; Matthew Todd,26,0,45,19
1746538747687,PHIL 163,A01,889601,Staff,21,0,30,9
1746538747687,PHIL 163,B01,889606,Brandt; Reuven A,0,3,0,0
1746538748716,PHIL 164,A00,889610,Staff,16,0,30,14
1746538749745,PHIL 165,A00,889613,Staff,23,0,30,7
1746538750769,PHYS 1A,A00,886431,Staff,26,0,70,44
1746538751796,PHYS 1AL,001,886432,Tsai; Philbert S,0,2,30,30
1746538751796,PHYS 1AL,002,886436,Tsai; Philbert S,11,0,30,19
1746538752846,PHYS 1B,A00,886439,Staff,185,0,240,55
1746538753873,PHYS 1BL,001,886441,Tsai; Philbert S,0,4,30,30
1746538753873,PHYS 1BL,002,886444,Tsai; Philbert S,2,0,30,28
1746538754901,PHYS 1C,A00,896092,Arnold; Kam S,78,0,146,68
1746538755928,PHYS 1CL,001,886448,Tsai; Philbert S,0,0,30,30
1746538755928,PHYS 1CL,002,886449,Tsai; Philbert S,0,0,30,30
1746538755928,PHYS 1CL,003,886450,Tsai; Philbert S,15,0,30,15
1746538755928,PHYS 1CL,004,886451,Tsai; Philbert S,15,0,30,15
1746538756957,PHYS 2B,A01,886457,Staff,69,0,115,46
1746538757988,PHYS 2C,A01,886460,Shotwell; Brian,0,8,65,65
1746538759015,PHYS 2CL,A01,886467,Staff,0,4,28,28
1746538759015,PHYS 2CL,A02,886468,Staff,0,3,28,28
1746538760042,PHYS 2D,A01,886470,Staff,10,0,50,40
1746538761073,PHYS 4B,A01,886475,Grinstein; Benjamin,22,0,40,18
1746538762100,POLI 5,A00,891173,Desposato; Scott,7,0,25,18
1746538763131,POLI 5D,A01,891175,Staff,5,0,5,0
1746538763131,POLI 5D,B01,891178,Staff,5,0,5,0
1746538764160,POLI 11,A00,891179,Ferree; Karen E,2,0,35,33
1746538765190,POLI 12,A00,891180,Staff,16,0,30,14
1746538766215,POLI 27,A01,891182,Staff,12,0,75,63
1746538767243,POLI 30,A00,891183,Staff,9,0,50,41
1746538768273,POLI 100B,A00,891244,Staff,5,1,35,30
1746538769298,POLI 100I,A00,891247,Staff,7,0,30,23
1746538770323,POLI 104J,A00,891248,Nichter; Maysa,14,0,30,16
1746538771348,POLI 104U,A00,891250,Nichter; Maysa,2,0,30,28
1746538773402,POLI 110B,A00,891255,Wiens; David,20,0,25,5
1746538774431,POLI 112A,A00,891256,Wiens; David,6,0,25,19
1746538775456,POLI 114BR,A00,891261,Staff,19,0,30,11
1746538776486,POLI 117R,A00,891262,Forman; Fonna,0,6,50,50
1746538777516,POLI 118,A00,891264,Ingham; Sean,17,0,25,8
1746538778540,POLI 124A,A00,891265,Staff,18,0,20,2
1746538779571,POLI 125D,A00,891266,Nichter; Simeon C,2,0,25,23
1746538780595,POLI 126,A00,891268,Nichter; Simeon C,7,0,25,18
1746538781621,POLI 126AA,A00,891272,Staff,18,0,25,7
1746538782645,POLI 130AA,A00,891273,Staff,15,0,20,5
1746538783670,POLI 134AA,A00,891274,Staff,4,0,20,16
1746538785720,POLI 138,A00,891278,Staff,21,0,25,4
1746538786749,POLI 142K,A00,891280,Staff,11,0,25,14
1746538787779,POLI 142M,A00,891281,Gartzke; Erik,17,0,30,13
1746538788802,POLI 142P,A00,891284,Staff,20,0,30,10
1746538789831,POLI 143,A00,891285,Gartzke; Erik,12,0,30,18
1746538790860,POLI 153,A00,891286,Staff,19,0,20,1
1746538792911,POLI 175,A00,891290,Staff,15,0,20,5
1746538793939,PSYC 1,A00,890674,Steiner; Eric Tomas,0,11,45,45
1746538794975,PSYC 2,A00,890676,Albright; Thomas D,21,0,35,14
1746538796002,PSYC 3,A00,890679,Staff,17,0,20,3
1746538797027,PSYC 6,A00,959858,Staff,20,0,20,0
1746538798061,PSYC 60,A01,890684,Rickard; Timothy C.,0,5,45,45
1746538799087,PSYC 70,A01,890689,Geller; Emma Harlan,7,0,30,23
1746538800115,PSYC 71,A01,959860,Staff,21,0,25,4
1746538801141,PSYC 100,A00,890690,Lacefield; Katharine I,0,50,180,180
1746538802166,PSYC 102,A00,890695,Staff,18,0,40,22
1746538803195,PSYC 105,A00,890699,Geller; Emma Harlan,71,0,100,29
1746538804220,PSYC 106,A00,890701,Gorman; Michael R.,5,0,30,25
1746538805250,PSYC 108,A00,890704,Adrian; Julia Anna,0,28,50,50
1746538806301,PSYC 118,A01,890712,Staff,11,0,30,19
1746538807325,PSYC 124,A00,890716,Chapman; Eddie Nathaniel,25,0,60,35
1746538808351,PSYC 131,A00,890717,Anagnostaras; Stephan,0,7,80,80
1746538809379,PSYC 137,A00,890719,Winkielman; Piotr,0,11,30,30
1746538810404,PSYC 144,A00,890721,Adrian; Julia Anna,0,9,45,45
1746538811430,PSYC 162,A00,890805,Staff,2,0,75,73
1746538812456,PSYC 169,A00,890810,Staff,0,15,30,30
1746538813482,PSYC 172,A00,890814,Gorman; Michael R.,9,0,30,21
1746538814512,PSYC 181,A00,890818,Anagnostaras; Stephan,8,0,200,192
1746538815542,PSYC 184,A00,959861,Staff,170,0,175,5
1746538816568,PSYC 189,A00,890823,Staff,0,1,30,30
1746538817600,PSYC 191,A00,890884,Rickard; Timothy C.,0,11,35,35
1746538818631,PSYC 193,A00,890913,Staff,19,0,30,11
1746538818631,PSYC 193,B00,890914,Chapman; Eddie Nathaniel,24,0,30,6
1746538819657,PSYC 193L,A01,890918,Lowe; Angela Beth,20,0,30,10
1746538819657,PSYC 193L,B01,890921,Hurwitz; Ethan Scott,20,0,30,10
1746538819657,PSYC 193L,C01,890928,Staff,30,0,30,0
1746538820688,RELI 149,A00,886806,Rahimi; Babak,23,0,40,17
1746538821715,SE 9,A01,886814,Staff,7,0,20,13
1746538822747,SE 101B,A01,886816,Chadha; Mayank,4,0,35,31
1746538823776,SE 110B,A00,886818,Zhu; Qiang,4,0,75,71
1746538824803,SE 125,A01,886830,Staff,10,0,30,20
1746538825830,SE 130B,A01,886835,Staff,14,0,40,26
1746538826861,SE 131A,A01,886838,Krysl; Petr,34,0,55,21
1746538827890,SE 154,A00,886840,Staff,30,0,50,20
1746538828916,SE 164GS,A01,886849,Staff,6,0,20,14
1746538829944,SE 167GS,A01,886853,Staff,6,0,20,14
1746538830969,SIO 25,A01,890107,Staff,19,0,30,11
1746538831996,SIO 45,A00,890109,Cook; Geoffrey W,117,0,200,83
1746538833022,SIO 109R,A00,890110,Forman; Fonna,0,16,20,20
1746538834049,SIO 187,A01,890114,Kacev; David,15,0,40,25
1746538835087,SOCI 1,A01,890431,Thorpe; Charles Robert,15,0,30,15
1746538835087,SOCI 1,A02,890518,Thorpe; Charles Robert,30,0,30,0
1746538836116,SOCI 2,A01,957978,Staff,25,0,25,0
1746538836116,SOCI 2,A02,957979,Staff,23,0,25,2
1746538837146,SOCI 20,A01,890523,Calderon-Zaks; Michael Aar,23,0,30,7
1746538837146,SOCI 20,A02,890526,Calderon-Zaks; Michael Aar,29,0,30,1
1746538838174,SOCI 30,A01,890533,Pardo Guerra; Juan Pablo,37,0,40,3
1746538839200,SOCI 40,A01,890535,Staff,27,0,45,18
1746538840225,SOCI 104Q,A00,890559,Staff,18,0,30,12
1746538841255,SOCI 106,A00,890560,Arnal; Maud Marie Leonie,20,0,30,10
1746538842282,SOCI 110,A00,890567,Holkenbrink-Monk; Charlene,19,0,30,11
1746538843306,SOCI 112,A00,890568,Victoria Torres; Pablo,1,0,55,54
1746538844336,SOCI 115,A00,890597,Arnal; Maud Marie Leonie,28,0,45,17
1746538846391,SOCI 121,A00,890604,Pardo Guerra; Juan Pablo,38,0,45,7
1746538847417,SOCI 126,A01,890608,Staff,8,0,10,2
1746538848446,SOCI 127,A00,890609,Staff,18,0,30,12
1746538849471,SOCI 131,A00,890610,Thorpe; Charles Robert,37,0,45,8
1746538850498,SOCI 135,A00,890615,Payne; Christine Anna,14,0,45,31
1746538851525,SOCI 139,A00,890620,Staff,38,0,45,7
1746538852551,SOCI 148E,A00,890622,Calderon-Zaks; Michael Aar,36,0,45,9
1746538853583,SOCI 150,A00,890623,Kohler; Kristopher M.,31,0,45,14
1746538854612,SOCI 157,A00,890625,Jules-Rosette; Bennetta W.,18,0,20,2
1746538855636,SOCI 160,A00,890627,Payne; Christine Anna,21,0,45,24
1746538856664,SYN 1,A00,886855,Fish; Gwendolyn Anne,0,0,0,0
1746538856664,SYN 1,B00,906086,Fish; Gwendolyn Anne,0,1,0,2
1746538857697,SYN 2R,A00,886860,Staff,0,17,15,15
1746538857697,SYN 2R,B00,906106,Atkinson; Arthur Laird,0,16,15,15
1746538858739,SYN 100,A01,886866,Browne; Emily,0,28,20,20
1746538858739,SYN 100,B01,906128,Rock; Martin,0,5,20,20
1746538858739,SYN 100,C01,906140,Deavenport; James Cary,0,3,20,20
1746538858739,SYN 100,D01,907816,Deavenport; James Cary,0,5,20,20
1746538859774,TDAC 1,A00,890286,Walsh; Kim C.,9,0,20,11
1746538860800,TDAC 101,A00,890296,Basso; Beatrice,16,0,20,4
1746538861829,TDDE 131,A00,890297,Staff,47,0,50,3
1746538862857,TDDM 1,A00,890287,Weinberg; Sadie,25,0,30,5
1746538863890,TDGE 11,A00,890288,Fulton; Julia,137,0,200,63
1746538863890,TDGE 11,B00,890289,Castro; Robert Jess,184,0,200,16
1746538864917,TDGE 25,B00,957359,Walsh; Kim C.,3,0,20,17
1746538865948,TDGE 40,A01,890292,Power; Jade Yukana,27,0,30,3
1746538866977,TDGE 124,A00,890298,Havis; Allan,0,0,50,50
1746538868004,TDGE 131R,A00,890299,Burelle; Julie Sara Veronique,15,0,42,27
1746538869035,TDHT 101,A00,890300,Staff,10,0,20,10
1746538870060,TDHT 109,A01,890302,Anderson; Mysia Anyse,31,0,40,9
1746538871092,TDMV 1,A00,890293,Arcidiacono; Kristin,18,0,30,12
1746538872121,TDMV 2,A00,890294,Weinberg; Sadie,23,0,30,7
1746538873148,TDMV 3,A00,957878,Arcidiacono; Kristin,28,0,30,2
1746538875203,TDMV 138,A00,890304,Jun; Grace Shin Hae,25,0,40,15
1746538876233,TDMV 140,A00,890305,Corrales; Joseph Bernales,25,0,30,5
1746538877265,TDMV 142,A00,890307,Caligagan; Tony,32,0,40,8
1746538878292,TDMV 144,A00,890308,Camaya; Michelle Ann,25,0,30,5
1746538879323,TDPW 1,A00,890295,Stein; Deborah Isobel,3,0,20,17
1746538880355,USP 2,A01,890272,Lerner; Amy M,6,0,20,14
1746538881382,USP 3,A01,890274,Staff,12,0,30,18
1746538882425,USP 15,A01,890276,Sun; Feiyang,17,0,30,13
1746538883452,USP 25,A00,890277,Shenkman; Michael Thomas,19,0,25,6
1746538884479,USP 138,A00,890278,Staff,13,0,25,12
1746538885504,USP 143,A00,890279,Staff,21,0,70,49
1746538886533,USP 144,A00,890280,Chowdhury; Muhammed Zohir,16,0,30,14
1746538887567,USP 150,A00,890281,Boomhower; Matthew Charles,4,0,30,26
1746538888598,USP 151,A00,890282,Staff,16,0,20,4
1746538889626,USP 162,A00,890283,Andrews; Abigail Leslie,16,0,20,4
1746538890659,USP 168,A00,920477,Kwak; Nancy,1,0,5,4
1746538891686,USP 181,A00,890284,Staff,3,0,20,17
1746538892713,USP 191A,A00,890285,Staff,13,0,20,7
1746538893738,VIS 101,A00,886512,Staff,25,0,75,50
1746538894771,VIS 103,A00,886513,Cruz; Edwin Teddy,61,0,75,14
1746538895801,VIS 108,A00,886514,Staff,3,0,15,12
1746538896829,VIS 127P,A00,886515,Shen; Kuiyi,80,0,146,66
1746538897854,VIS 149,A00,886516,Yoldas; Pinar,0,0,15,15
1746538898886,VIS 164,A00,886526,Erdmann; Dean,19,0,22,3
1746538899911,VIS 194S,A00,886527,Staff,61,0,75,14
1746538900939,WCWP 10A,C00,886484,Martiniuk; Jill,12,0,15,3
1746538901966,WCWP 10B,A00,886490,Uriarte; Emma,0,0,15,15
1746538901966,WCWP 10B,B00,886491,Dhir; Simrita,11,0,15,4
1746538901966,WCWP 10B,C00,886492,Ornelas; Tricia,0,0,15,15
1746538903020,WCWP 100,A00,886494,Young; Mark T,0,7,15,15
1746538905123,AAS 10,A01,886199,Childs; Dennis R.,0,3,0,0
1746538906153,ANAR 104,A01,886940,Shtienberg; Gilad,27,0,30,3
1746538907179,ANAR 120,A00,886953,Staff,12,0,20,8
1746538908211,ANBI 148,A01,886955,Wilder; Linnea Lorene,30,0,40,10
1746538910263,ANSC 122,A00,886957,Staff,25,0,30,5
1746538911289,ANSC 150,A00,886958,Sloane; Julia Kathryn,3,0,15,12
1746538912315,ANSC 156,A00,886959,Jenkins; Janis A.,0,1,15,15
1746538913346,ANSC 180,A00,886960,Staff,11,0,17,6
1746538914373,ANSC 188,A00,886961,Jassal; Aftab,9,0,25,16
1746538915401,ANSC 190,A00,886962,Jassal; Aftab,14,0,25,11
1746538916427,ANSC 191,A00,886963,Staff,18,0,20,2
1746538917453,ANTH 3,A01,891689,Staff,17,0,20,3
1746538918479,ANTH 5,A00,886933,Semendeferi; Ekaterini,16,0,20,4
1746538919510,ANTH 10,A00,886934,Staff,0,12,30,30
1746538920535,ANTH 21,A01,886936,Staff,40,0,60,20
1746538921559,ANTH 23,A01,886938,Staff,92,0,100,8
1746538922584,ANTH 105,A00,886964,Stewart; Alexander B,84,0,100,16
1746538923613,ANTH 108,A00,886965,Pedersen; David,9,0,20,11
1746538924641,AWP 10,001,886147,Staff,0,0,0,0
1746538924641,AWP 10,002,886148,Staff,0,0,0,0
1746538924641,AWP 10,003,886149,Staff,0,0,0,0
1746538924641,AWP 10,004,886150,Staff,0,0,0,0
1746538924641,AWP 10,005,886151,Staff,0,0,0,0
1746538924641,AWP 10,006,886152,Staff,0,0,0,0
1746538924641,AWP 10,007,886153,Staff,0,0,0,0
1746538924641,AWP 10,008,886154,Staff,0,0,0,0
1746538924641,AWP 10,009,886155,Staff,0,0,0,0
1746538924641,AWP 10,010,886156,Staff,0,0,0,0
1746538924641,AWP 10,011,886158,Staff,0,0,0,0
1746538924641,AWP 10,012,886160,Staff,0,0,0,0
1746538924641,AWP 10,013,886161,Staff,0,0,0,0
1746538924641,AWP 10,014,886162,Staff,0,0,0,0
1746538924641,AWP 10,015,886163,Staff,0,0,0,0
1746538924641,AWP 10,016,886164,Staff,0,0,0,0
1746538924641,AWP 10,017,886165,Staff,0,0,0,0
1746538924641,AWP 10,018,886166,Staff,0,0,0,0
1746538924641,AWP 10,019,886168,Staff,0,0,0,0
1746538924641,AWP 10,020,886170,Staff,0,0,0,0
1746538924641,AWP 10,021,886172,Staff,0,0,0,0
1746538925674,AWP 10R,001,886173,Staff,0,1,0,0
1746538925674,AWP 10R,002,886174,Staff,0,1,0,0
1746538925674,AWP 10R,003,886175,Staff,0,0,0,0
1746538925674,AWP 10R,004,886176,Staff,0,0,0,0
1746538925674,AWP 10R,005,886177,Staff,0,0,0,0
1746538925674,AWP 10R,006,886178,Staff,0,0,0,0
1746538925674,AWP 10R,007,886179,Staff,0,0,0,0
1746538925674,AWP 10R,008,886181,Staff,0,0,0,0
1746538925674,AWP 10R,009,886182,Staff,0,0,0,0
1746538925674,AWP 10R,010,886183,Staff,0,0,0,0
1746538925674,AWP 10R,011,886184,Staff,0,0,0,0
1746538925674,AWP 10R,012,886185,Staff,0,0,0,0
1746538925674,AWP 10R,013,886186,Staff,0,0,0,0
1746538925674,AWP 10R,014,886187,Staff,0,0,0,0
1746538925674,AWP 10R,015,886188,Staff,0,0,0,0
1746538925674,AWP 10R,016,886189,Staff,0,0,0,0
1746538926702,AWP 102R,A00,886190,Staff,0,0,0,0
1746538926702,AWP 102R,B00,886191,Staff,0,0,0,0
1746538927729,BENG 100,A01,886193,Staff,17,0,30,13
1746538928759,BENG 122A,A01,886195,Hasty; Jeff M,13,0,30,17
1746538929790,BENG 166A,A00,886196,Sah; Robert Lie-Yuan,0,1,30,30
1746538930824,BENG 190,A00,958050,Khojah; Reem I,24,0,25,1
1746538931853,BIBC 102,A01,894320,Staff,0,0,46,46
1746538931853,BIBC 102,A02,894321,Staff,1,0,46,45
1746538931853,BIBC 102,A03,894344,Staff,7,0,46,39
1746538931853,BIBC 102,A04,894345,Staff,26,0,47,21
1746538932890,BICD 100R,A01,894365,Smith; Laurie,0,3,58,58
1746538932890,BICD 100R,A02,894366,Smith; Laurie,0,5,58,58
1746538932890,BICD 100R,A03,894367,Smith; Laurie,2,0,59,57
1746538932890,BICD 100R,A04,959869,Smith; Laurie,41,0,59,18
1746538933920,BICD 136,A01,894383,Gustafson-Brown; Cindy,14,0,50,36
1746538934956,BIEB 102,A01,894494,Butler; Shannon Rhey,51,0,130,79
1746538937018,BIEB 150,A01,894617,Wills; Christopher,3,0,20,17
1746538937018,BIEB 150,A02,894631,Wills; Christopher,3,0,20,17
1746538937018,BIEB 150,A03,894937,Wills; Christopher,3,0,20,17
1746538937018,BIEB 150,A04,894946,Wills; Christopher,5,0,20,15
1746538938048,BIEB 194,A00,906141,Kurle; Carolyn M.,6,0,20,14
1746538939078,BILD 1,A01,894154,Staff,2,0,19,17
1746538939078,BILD 1,A02,894155,Staff,14,0,19,5
1746538939078,BILD 1,A03,894160,Staff,13,0,19,6
1746538939078,BILD 1,A04,894161,Staff,15,0,18,3
1746538940103,BILD 2,A01,894168,Staff,0,0,50,50
1746538940103,BILD 2,A02,894169,Staff,0,0,50,50
1746538940103,BILD 2,A03,894179,Staff,4,0,50,46
1746538940103,BILD 2,A04,894203,Staff,27,0,50,23
1746538941129,BILD 3,A01,894213,Staff,22,0,31,9
1746538941129,BILD 3,A02,894214,Staff,26,0,31,5
1746538941129,BILD 3,A03,894235,Staff,28,0,31,3
1746538941129,BILD 3,A04,894236,Staff,28,0,32,4
1746538942157,BILD 4,A01,894253,Reuther; Keefe,5,0,24,19
1746538942157,BILD 4,A02,894258,Reuther; Keefe,16,0,24,8
1746538943184,BILD 5,A01,894276,Reuther; Keefe,35,0,50,15
1746538943184,BILD 5,A02,894277,Reuther; Keefe,45,0,50,5
1746538943184,BILD 5,A03,894290,Reuther; Keefe,44,0,50,6
1746538943184,BILD 5,A04,894291,Reuther; Keefe,48,0,50,2
1746538944211,BILD 24,A01,894297,Pirino; Giorgia,40,0,60,20
1746538945238,BIMM 100,B01,958915,Staff,72,0,100,28
1746538946270,BIMM 101,A01,895017,McDonnell; Lisa Marie,0,5,24,24
1746538946270,BIMM 101,A02,895018,McDonnell; Lisa Marie,0,5,24,24
1746538946270,BIMM 101,B01,895020,McDonnell; Lisa Marie,0,6,24,24
1746538946270,BIMM 101,B02,895021,McDonnell; Lisa Marie,0,4,24,24
1746538947298,BIMM 110,A01,895023,Staff,1,0,25,24
1746538947298,BIMM 110,A02,895024,Staff,9,0,25,16
1746538947298,BIMM 110,A03,895025,Staff,18,0,25,7
1746538947298,BIMM 110,A04,895031,Staff,20,0,25,5
1746538948331,BIMM 120,A01,895114,Gustafson-Brown; Cindy,13,0,28,15
1746538948331,BIMM 120,A02,895126,Gustafson-Brown; Cindy,21,0,27,6
1746538949365,BIPN 100,A01,895130,Yang; Mingyu,1,0,38,37
1746538949365,BIPN 100,A02,895131,Yang; Mingyu,32,0,38,6
1746538949365,BIPN 100,A03,895132,Yang; Mingyu,32,0,38,6
1746538949365,BIPN 100,A04,895133,Yang; Mingyu,27,0,36,9
1746538950392,BIPN 120,A01,895135,Cooke; James Edward,0,3,13,13
1746538950392,BIPN 120,A02,895136,Cooke; James Edward,0,1,13,13
1746538950392,BIPN 120,A03,895137,Cooke; James Edward,0,3,13,13
1746538950392,BIPN 120,A04,895156,Cooke; James Edward,0,2,11,11
1746538951419,BIPN 134,A01,895235,Cooke; James Edward,0,2,25,25
1746538951419,BIPN 134,A02,895237,Cooke; James Edward,0,0,25,25
1746538951419,BIPN 134,A03,895240,Cooke; James Edward,3,0,25,22
1746538951419,BIPN 134,A04,895270,Cooke; James Edward,20,0,25,5
1746538952449,BIPN 189,A00,892103,Staff,0,13,14,14
1746538954506,BISP 194,A00,958008,Staff,0,2,0,0
1746538955532,CAT 124,A01,922009,Staff,0,5,20,20
1746538956566,CAT 125R,A00,886390,Morales; Celeste Georgianna,0,2,20,20
1746538956566,CAT 125R,B00,886391,Irwin; Matthew Joseph,0,3,20,20
1746538956566,CAT 125R,C00,886392,Smith; Lauryn Alissa,0,2,20,20
1746538956566,CAT 125R,D00,886393,Vanderschuit; Maya Alysia,0,2,20,20
1746538956566,CAT 125R,E00,886394,Marchisotto; Jennifer Anne,0,4,20,20
1746538957595,CENG 15,A01,886218,Drews; Aaron,3,0,8,5
1746538958624,CENG 113,A00,886219,Opatkiewicz; Justin Paul,15,0,25,10
1746538959654,CGS 101,A00,887044,Staff,7,0,20,13
1746538960683,CGS 105,A01,887046,Staff,14,0,25,11
1746538961710,CGS 112,A00,887047,Cuong; Marisol,12,0,15,3
1746538962740,CGS 113,A00,887048,Staff,23,0,30,7
1746538963764,CGS 120,A00,887049,Staff,10,0,17,7
1746538964792,CHEM 6A,A01,886336,Lam; Tin Yiu,38,0,50,12
1746538964792,CHEM 6A,A02,886338,Lam; Tin Yiu,37,0,50,13
1746538965817,CHEM 6B,A01,886341,Hopkins; Patrycja Anna,16,0,50,34
1746538965817,CHEM 6B,A02,886343,Hopkins; Patrycja Anna,42,0,50,8
1746538966846,CHEM 6C,A01,886346,Albizati; Kim F.,0,2,50,50
1746538966846,CHEM 6C,A02,886348,Albizati; Kim F.,23,0,50,27
1746538967878,CHEM 40A,A01,886352,Klosterman; Jeremy K,65,0,100,35
1746538968904,CHEM 40B,A01,886356,Klosterman; Jeremy K,0,23,100,100
1746538969930,CHEM 41B,A01,886360,Theodorakis; Emmanuel,25,0,50,25
1746538969930,CHEM 41B,A02,886362,Theodorakis; Emmanuel,47,0,50,3
1746538970959,CHIN 165A,A00,886382,Xu; Li,18,0,20,2
1746538971989,CLAS 120,A00,886387,Myerston Santana; Jacobo,33,0,40,7
1746538973018,COGS 9,A01,886967,Shannon; Kyle Michael,42,0,60,18
1746538974048,COGS 11,A01,886969,Staff,11,0,30,19
1746538975079,COGS 14A,A01,886971,Staff,6,0,60,54
1746538976106,COGS 14B,A01,886973,Hoffman; Drew Ellen,4,0,60,56
1746538977133,COGS 18,A01,886975,Morgan; Eric,35,0,60,25
1746538978160,COGS 20,A01,886977,Staff,4,0,8,4
1746538978160,COGS 20,A02,886978,Staff,5,0,7,2
1746538979184,COGS 100,A01,907783,Staff,0,2,30,30
1746538980216,COGS 101B,A01,886980,Staff,0,3,48,48
1746538981249,COGS 101C,A01,886982,Delgado; Tania,0,5,44,44
1746538982284,COGS 102A,A01,886984,Johnson; Christine M.,4,0,30,26
1746538983312,COGS 118B,A01,886986,Staff,0,3,88,88
1746538984342,COGS 150,A01,886988,Bergen; Benjamin,23,0,50,27
1746538985370,COGS 153,A00,886989,Delgado; Tania,0,2,41,41
1746538986401,COGS 186,A01,886991,Staff,0,0,32,32
1746538987430,COGS 187A,A01,886993,Boyle; Mary E. T.,7,0,30,23
1746538988460,COGS 189,A00,886994,Staff,0,1,30,30
1746538989485,COMM 10,A01,886996,Staff,0,0,20,21
1746538989485,COMM 10,A02,886997,Staff,12,0,20,8
1746538989485,COMM 10,A03,959845,Staff,19,0,20,1
1746538990511,COMM 20,A01,886999,Leuning; Grant Maurstad,24,0,40,16
1746538992568,COMM 100A,A01,887002,Staff,0,0,20,25
1746538992568,COMM 100A,A02,887003,Staff,7,0,20,13
1746538993598,COMM 100B,A01,887005,Staff,0,8,20,24
1746538994625,COMM 106D,A00,887006,Staff,14,0,40,26
1746538995650,COMM 110G,A00,887007,Whitworth-Smith; Andrew C,12,0,40,28
1746538996675,COMM 111B,A00,887008,Staff,31,0,40,9
1746538997702,COMM 113T,A00,887009,Abuelhiga; Soraya Jill,28,0,40,12
1746538997702,COMM 113T,B00,906733,Staff,40,0,40,0
1746538998730,COMM 145,A00,887010,Staff,12,0,40,28
1746538999756,COMM 146,A00,887054,Staff,31,0,40,9
1746539000783,COMM 190,A00,887012,Staff,8,0,23,15
1746539001809,CSE 8A,A50,887015,Cao; Yingjun,57,0,85,28
1746539002836,CSE 11,A01,887017,Cao; Yingjun,12,0,70,58
1746539003861,CSE 20,A01,887019,Staff,30,0,50,20
1746539004896,CSE 21,A01,887021,Staff,78,0,100,22
1746539004896,CSE 21,B01,892583,Braun; Oliver,45,0,50,5
1746539005923,CSE 30,A01,887025,Eldon; John,143,0,200,57
1746539006948,CSE 100,A01,887027,Staff,26,0,50,24
1746539006948,CSE 100,A02,887028,Staff,40,0,50,10
1746539007979,CSE 101,A01,887030,Braun; Oliver,75,0,100,25
1746539007979,CSE 101,B01,887032,Jones; Miles E,0,3,50,50
1746539007979,CSE 101,B02,887033,Jones; Miles E,0,1,50,50
1746539009013,CSE 105,A01,908084,Jones; Miles E,32,0,50,18
1746539009013,CSE 105,A02,908087,Jones; Miles E,33,0,50,17
1746539010040,CSE 135,A01,887035,Powell; Thomas Allan,0,4,50,50
1746539011071,CSE 142,A01,887037,Staff,8,0,60,52
1746539012097,CSE 142L,A01,887039,Staff,34,0,60,26
1746539013128,CSE 151A,A01,887041,Solares; Edwin A,48,0,100,52
1746539014157,CSE 175,A01,887043,Kumar; Rakesh,30,0,30,0
1746539015188,CSS 1,A01,886389,Staff,0,1,40,40
1746539016216,DSC 30,A01,908097,Liao; Soohyun Nam,47,0,75,28
1746539017243,DSC 40A,A01,908099,Shannon; Kyle Michael,30,0,50,20
1746539018274,DSC 40B,A01,908112,Staff,16,0,50,34
1746539019302,DSC 80,A01,908116,Staff,19,0,60,41
1746539020328,DSC 197,001,956863,Eldridge; Justin Matthew,9999,0,9999,0
1746539021355,ECE 5,A01,886400,Morris; Karcher William,2,0,6,4
1746539021355,ECE 5,A02,886401,Morris; Karcher William,3,0,6,3
1746539022383,ECE 148,A01,886403,Silberman; Jack,0,14,14,14
1746539023412,ECON 1,A01,887265,Crane; Meredith Helen,12,0,70,58
1746539023412,ECON 1,B01,887268,Staff,43,0,50,7
1746539024438,ECON 2,A01,887273,Crane; Meredith Helen,56,0,70,14
1746539025474,ECON 3,A01,887279,Rondina; Giacomo,32,0,70,38
1746539026506,ECON 4,A01,887282,Anderson; John Charles,0,2,10,10
1746539027532,ECON 5,A01,887285,Staff,33,0,45,12
1746539027532,ECON 5,B01,887292,Staff,41,0,45,4
1746539028568,ECON 100A,A01,887337,Newhouse; Herbert S,54,0,70,16
1746539028568,ECON 100A,B01,887349,Staff,45,0,50,5
1746539029598,ECON 100B,A01,887361,Du; Songzi,29,0,70,41
1746539030625,ECON 100C,A01,887445,Newhouse; Herbert S,59,0,70,11
1746539031655,ECON 105,A00,887488,Vespa; Emanuel Ignacio,23,0,35,12
1746539032682,ECON 109,A01,887506,Shishkin; Denis,28,0,35,7
1746539033713,ECON 110A,A01,887568,Alon; Titan Michael,0,3,35,35
1746539033713,ECON 110A,B01,907601,Alon; Titan Michael,20,0,35,15
1746539034739,ECON 110B,A01,887598,Levkoff; Steven B.,0,23,70,70
1746539035769,ECON 112,A00,887599,Rondina; Giacomo,19,0,35,16
1746539036793,ECON 120A,A01,887603,Dai; Yinlin,36,0,70,34
1746539037822,ECON 120C,A01,887608,Sun; Yixiao,0,1,35,35
1746539037822,ECON 120C,B01,887614,Sun; Yixiao,0,0,35,35
1746539038849,ECON 138,A00,887621,Bharadwaj; Prashant,0,20,20,20
1746539039875,ECON 144,A00,958007,Squires; Dale E,13,0,35,22
1746539040902,ECON 171,A01,907666,Staff,18,0,35,17
1746539041929,ECON 175,A00,887626,Wu; Pak Yeung,23,0,35,12
1746539042996,ECON 190,A00,887640,Vespa; Emanuel Ignacio,23,0,35,12
1746539044028,EDS 25,A01,888197,Staff,0,0,0,0
1746539044028,EDS 25,A02,888209,Staff,0,0,0,0
1746539044028,EDS 25,A03,888210,Staff,0,0,0,0
1746539044028,EDS 25,A04,888212,Staff,0,0,0,0
1746539044028,EDS 25,A05,888213,Staff,0,0,0,0
1746539044028,EDS 25,A06,888214,Staff,0,0,0,0
1746539044028,EDS 25,A07,888235,Staff,0,2,0,0
1746539044028,EDS 25,A08,888236,Staff,0,0,0,0
1746539044028,EDS 25,A09,888240,Staff,0,0,0,0
1746539044028,EDS 25,A10,888244,Staff,0,0,0,0
1746539044028,EDS 25,B01,888273,Staff,0,0,0,0
1746539044028,EDS 25,B02,888285,Staff,0,0,0,0
1746539044028,EDS 25,B03,888423,Staff,0,0,0,1
1746539044028,EDS 25,B04,888432,Staff,0,0,0,0
1746539044028,EDS 25,B05,888433,Staff,0,0,0,0
1746539044028,EDS 25,B06,888467,Staff,0,0,0,0
1746539044028,EDS 25,B07,888468,Staff,0,0,0,0
1746539044028,EDS 25,B08,888479,Staff,0,0,0,0
1746539044028,EDS 25,B09,888484,Staff,0,0,0,0
1746539044028,EDS 25,B10,888487,Staff,0,0,0,0
1746539045060,EDS 38,A01,907700,Choi; Bailey Miyeon,30,0,30,0
1746539046091,EDS 112,A01,888601,Chapman; Thandeka K,14,0,40,26
1746539047117,EDS 115,A00,888697,Mendez; Kathrina Mendoza,10,0,30,20
1746539048144,EDS 116,A01,888893,Staff,35,0,40,5
1746539050201,EDS 124AR,A00,889133,Staff,29,0,50,21
1746539050201,EDS 124AR,B00,907471,Simon; Elizabeth A,37,0,50,13
1746539051226,EDS 124BR,A00,889134,Simon; Elizabeth A,45,0,100,55
1746539052266,EDS 125,A00,889135,Staff,25,0,30,5
1746539053291,EDS 126,A01,889138,Staff,36,0,40,4
1746539054318,EDS 164R,A01,889142,Wishard Guerra; Alison G.,33,0,50,17
1746539055344,ENG 30,A01,886396,Staff,0,0,0,0
1746539055344,ENG 30,B01,886398,Staff,0,0,0,0
1746539056373,ENVR 102,A00,906150,Montejo; Carolina,23,0,25,2
1746539057401,ETHN 103A,A00,887236,Man; Simeon S,0,3,0,0
1746539058425,ETHN 113,A00,887239,Staff,16,0,30,14
1746539059455,ETHN 116,A00,887240,Staff,16,0,25,9
1746539060484,ETHN 117,A00,887241,Choi; Esther Min,28,0,30,2
1746539061509,ETHN 118,A00,887243,Staff,24,0,30,6
1746539062535,ETHN 127,A00,887248,Cuong; Marisol,11,0,15,4
1746539063561,ETHN 139,A00,887250,Staff,7,0,10,3
1746539064585,ETHN 142,A00,887252,Staff,10,0,30,20
1746539065616,ETHN 161,A00,887253,Browne; Errol Tsekani,24,0,30,6
1746539066646,ETHN 163FR,A00,887255,Burelle; Julie Sara Veronique,0,0,5,5
1746539067674,GLBH 20,A00,889149,Elwardani; Nile Regina,8,0,42,34
1746539069725,GLBH 111,A01,889152,Burgos; Jose L.,17,0,17,0
1746539070754,GLBH 150,A00,889181,Sloane; Julia Kathryn,0,5,15,15
1746539072812,HDS 60,A01,886406,Warstadt; Melissa Fawn,73,0,80,7
1746539073838,HIAF 111,A00,889324,Gyamfi; Bright,25,0,32,7
1746539074868,HIEA 131,A00,889328,Staff,16,0,32,16
1746539075895,HIEA 144,A00,889333,Henry; Todd A.,26,0,32,6
1746539076923,HIEA 154,A00,889336,Henry; Todd A.,24,0,32,8
1746539077952,HIEU 106,A00,889339,Staff,22,0,32,10
1746539080006,HIEU 114,A00,889340,Staff,3,0,32,29
1746539081035,HIEU 135GS,A00,889342,Patterson; Patrick H.,0,0,1,24
1746539082064,HIEU 137,A00,889343,Edington; Claire Ellen,9,0,25,16
1746539083092,HIEU 148,A00,889345,Staff,14,0,32,18
1746539084120,HIEU 154,A00,889346,Biess; Frank Peter,21,0,32,11
1746539085146,HILA 102,A00,889351,Staff,12,0,32,20
1746539086173,HILD 2A,A01,889221,Lewandoski; Julia Mavis,1,10,32,31
1746539087199,HILD 7B,A01,889225,Man; Simeon S,0,13,32,32
1746539088231,HILD 7C,A01,889288,Alvarez; Luis A,0,14,32,32
1746539089261,HILD 30,A01,889323,Staff,0,5,32,32
1746539091311,HISC 119,A00,889383,Golan; Tal,21,0,32,11
1746539092336,HIUS 103,A00,889384,Man; Simeon S,0,0,32,32
1746539093363,HIUS 117,A00,919797,Kwak; Nancy,18,0,32,14
1746539094390,HIUS 142A,A00,919788,Staff,22,0,32,10
1746539096446,HIUS 149,A00,889386,Gyamfi; Bright,27,0,32,5
1746539097474,HIUS 155,A00,889387,Alvarez; Luis A,14,0,32,18
1746539098502,HUM 3,A01,886499,Caldwell; Michael Alan,19,0,50,31
1746539099528,HUM 3GS,A00,886500,Rodriguez; Bretton Sigfred,0,0,0,28
1746539100555,HUM 3R,A01,886502,Markman; Kristina,0,36,50,50
1746539101592,HUM 4,A01,886504,Crum; Matthew Stephen,24,0,50,26
1746539101592,HUM 4,B01,886506,West; Geoffrey Scott,17,0,50,33
1746539102621,HUM 4GS,A00,886507,Staff,0,0,0,19
1746539103647,HUM 5,A01,886509,Staff,32,0,50,18
1746539104675,HUM 5R,A01,886511,Zavodny; Tatiana Sophia,0,39,50,50
1746539105701,JAPN 180,A00,886407,Staff,18,0,40,22
1746539106729,LATI 50,A01,886409,Martin-Cabrera; Luis,4,0,22,18
1746539106729,LATI 50,A02,886410,Martin-Cabrera; Luis,19,0,22,3
1746539106729,LATI 50,A03,886411,Martin-Cabrera; Luis,21,0,22,1
1746539106729,LATI 50,A04,886412,Martin-Cabrera; Luis,9,0,22,13
1746539107755,LAWS 101,A00,907664,Staff,28,0,60,32
1746539108783,LIAB 1A,A00,889388,Saab; Dima,17,0,20,3
1746539109814,LIAB 1AX,A00,889389,El Cheddadi; Youniss,17,0,20,3
1746539110844,LIFR 1C,A00,889391,Van Moer; Vinciane G,8,0,20,12
1746539111875,LIFR 1CX,A00,889392,Van Moer; Vinciane G,7,0,20,13
1746539112901,LIFR 1D,A00,889393,Van Moer; Vinciane G,7,0,20,13
1746539113929,LIFR 1DX,A00,889394,Van Moer; Vinciane G,8,0,20,12
1746539114960,LIGN 7,A00,886923,Staff,24,0,50,26
1746539115990,LIGN 17,A00,886924,Kehler; Andrew Scott,125,0,150,25
1746539117017,LTAM 110,A00,889395,Staff,15,0,30,15
1746539118044,LTAM 110GS,A00,958010,Rodriguez; Bretton Sigfred,0,0,0,28
1746539119072,LTCH 101,A00,889397,Staff,23,0,25,2
1746539120099,LTCS 130,A00,889398,Staff,23,0,25,2
1746539121126,LTEA 138,A00,889399,Staff,24,0,40,16
1746539122154,LTEN 149,A00,889400,Wesling; Megan E.,0,3,25,25
1746539123182,LTEN 169,A00,889401,Staff,20,0,25,5
1746539124210,LTEN 180,A00,889402,Staff,10,0,15,5
1746539125234,LTEN 181,A00,889403,Staff,21,0,25,4
1746539126262,LTWL 100,A00,889404,Myerston Santana; Jacobo,3,0,25,22
1746539127292,LTWL 180GS,A00,889405,Staff,0,0,20,20
1746539128316,LTWL 181,A00,889406,Staff,17,0,25,8
1746539129343,LTWL 184,A00,889475,Mukherjee; Silpa,22,0,25,3
1746539130368,LTWR 102C,A00,889486,Staff,29,0,30,1
1746539131394,LTWR 115W,A00,889491,Staff,0,2,15,15
1746539132421,MAE 8,A01,886905,Staff,0,2,0,0
1746539133446,MAE 11,A00,886906,Bandaru; Prabhakar,0,7,50,50
1746539134471,MAE 20,A00,886907,Evdokimenko; Ekaterina,44,0,70,26
1746539135506,MAE 30B,A00,886909,Ghazinejad; Maziar,26,0,45,19
1746539136539,MAE 101B,A00,886910,Saintillan; David,29,0,45,16
1746539137564,MAE 105,A00,886911,Bandaru; Prabhakar,18,0,50,32
1746539138596,MAE 107,B00,958024,Staff,9,0,50,41
1746539139623,MAE 143B,A00,886913,Bewley; Thomas R,7,0,40,33
1746539140656,MAE 148,A01,886915,Silberman; Jack,0,3,14,14
1746539141686,MAE 160,A00,886916,Evdokimenko; Ekaterina,31,0,60,29
1746539142718,MATH 3C,A01,889681,Staff,0,3,30,30
1746539142718,MATH 3C,A02,960048,Staff,25,0,30,5
1746539143749,MATH 10A,A01,889760,Staff,26,0,30,4
1746539143749,MATH 10A,A02,889783,Staff,29,0,30,1
1746539144778,MATH 10B,A01,889785,Verstraete; Jacques Allan,2,0,35,33
1746539144778,MATH 10B,A02,889795,Verstraete; Jacques Allan,4,0,35,31
1746539144778,MATH 10B,B01,889797,Verstraete; Jacques Allan,3,0,35,32
1746539144778,MATH 10B,B02,889828,Verstraete; Jacques Allan,3,0,35,32
1746539145808,MATH 10C,A01,889849,Habib; Yousaf,9,0,30,21
1746539145808,MATH 10C,A02,889852,Habib; Yousaf,14,0,30,16
1746539145808,MATH 10C,A03,889853,Habib; Yousaf,22,0,30,8
1746539145808,MATH 10C,A04,889858,Habib; Yousaf,20,0,30,10
1746539145808,MATH 10C,B01,889861,Staff,1,0,30,29
1746539145808,MATH 10C,B02,889862,Staff,24,0,30,6
1746539145808,MATH 10C,B03,889863,Staff,27,0,30,3
1746539145808,MATH 10C,B04,889967,Staff,23,0,30,7
1746539146844,MATH 18,A01,889974,Staff,7,0,30,23
1746539146844,MATH 18,A02,889977,Staff,20,0,30,10
1746539146844,MATH 18,B01,889984,Hardiman; Liam,22,0,30,8
1746539146844,MATH 18,B02,889985,Hardiman; Liam,25,0,30,5
1746539147870,MATH 20A,A01,889990,Suk; Andrew Hoon,29,0,35,6
1746539148906,MATH 20B,A01,889993,Ohm; Ko Woon,22,0,30,8
1746539148906,MATH 20B,A02,889994,Ohm; Ko Woon,30,0,30,0
1746539148906,MATH 20B,B01,889996,Ohm; Ko Woon,21,0,30,9
1746539148906,MATH 20B,B02,889997,Ohm; Ko Woon,23,0,30,7
1746539149935,MATH 20C,A01,889999,Hammock; Frances H,17,0,30,13
1746539149935,MATH 20C,A02,890003,Hammock; Frances H,23,0,30,7
1746539149935,MATH 20C,B01,890006,Hammock; Frances H,3,0,30,27
1746539149935,MATH 20C,B02,890007,Hammock; Frances H,11,0,30,19
1746539150965,MATH 20D,A01,890011,Cheng; Hsiao-Bing,1,1,30,29
1746539150965,MATH 20D,A02,890012,Cheng; Hsiao-Bing,14,0,30,16
1746539150965,MATH 20D,B01,890016,Cheng; Hsiao-Bing,13,0,30,17
1746539150965,MATH 20D,B02,890017,Cheng; Hsiao-Bing,13,0,30,17
1746539151993,MATH 20E,A01,890026,Harel; Guershon,1,0,30,29
1746539151993,MATH 20E,A02,890029,Harel; Guershon,23,0,30,7
1746539151993,MATH 20E,B01,890033,Harel; Guershon,7,0,30,23
1746539151993,MATH 20E,B02,890101,Harel; Guershon,21,0,30,9
1746539153018,MATH 102,A01,890104,Staff,17,0,30,13
1746539153018,MATH 102,A02,890105,Staff,27,0,30,3
1746539154046,MATH 103B,A01,890116,Salehi Golsefidy; Alireza,3,0,30,27
1746539154046,MATH 103B,B01,890118,Staff,0,3,34,34
1746539155074,MATH 109,A01,890121,Aliabadi Sr.; Mohsen,1,0,30,29
1746539155074,MATH 109,B01,890124,Upadrashta; Pranav Kumar,18,0,30,12
1746539156105,MATH 120A,A01,890126,Eggers; John Dietrich,13,0,30,17
1746539157132,MATH 142B,A01,890128,Ioana; Adrian,19,0,30,11
1746539157132,MATH 142B,A02,890129,Ioana; Adrian,13,0,30,17
1746539158164,MATH 154,A01,890174,Staff,0,0,30,30
1746539158164,MATH 154,A02,890182,Staff,0,0,30,30
1746539159197,MATH 168A,A01,890197,Dumitriu; Ioana,21,0,35,14
1746539160225,MATH 170A,A01,890240,Nie; Jiawang,1,0,30,29
1746539160225,MATH 170A,A02,890241,Nie; Jiawang,11,0,30,19
1746539160225,MATH 170A,A03,890249,Nie; Jiawang,23,0,30,7
1746539161252,MATH 170B,A01,957891,Nag; Panchali,13,0,35,22
1746539163316,MATH 181A,A01,908025,Staff,0,4,35,35
1746539163316,MATH 181A,A02,960115,Staff,27,0,35,8
1746539164343,MATH 181B,A01,959874,Staff,26,0,30,4
1746539165373,MATH 193B,A01,890265,Staff,0,4,35,35
1746539166404,MGT 4,A01,890311,Anderson; John Charles,42,0,88,46
1746539167433,MGT 5,A00,907740,Staff,13,0,98,85
1746539168462,MGT 12,A00,890312,Lindenberger; Wade Douglas,67,0,98,31
1746539169489,MGT 16,A00,957883,Staff,78,0,98,20
1746539171549,MGT 45,A00,890314,Pecore; Joseph P.,47,0,98,51
1746539172577,MGT 71,A00,890315,Staff,0,11,98,98
1746539173604,MGT 100,A00,890316,Yavorsky; Daniel Ryan,44,0,98,54
1746539174636,MGT 103,A00,890317,Ehrich; Kristine R,73,0,98,25
1746539175667,MGT 105,A00,890356,Bates; Kenneth Walter,0,7,98,98
1746539176694,MGT 112,A00,890360,Ehrich; Kristine R,55,0,98,43
1746539177727,MGT 127R,A00,907732,Zhu; Kevin Xiaoguo,23,0,98,75
1746539178757,MGT 131B,A00,890361,Anderson; John Charles,61,0,98,37
1746539179784,MGT 137,A00,890362,Lindenberger; Wade Douglas,65,0,98,33
1746539180817,MGT 160,A00,890369,Johnson; Erik Barry,9,0,98,89
1746539182871,MGT 164,A00,890372,Zimmermann; Carsten,0,39,98,98
1746539183898,MGT 180,A00,890374,Bliss; Barbara Ann,12,0,98,86
1746539184935,MMW 15,A01,886414,Chang; Edmond Yi-Teh,0,12,28,28
1746539184935,MMW 15,A02,886415,Chang; Edmond Yi-Teh,0,8,28,28
1746539184935,MMW 15,A03,886416,Chang; Edmond Yi-Teh,0,8,28,28
1746539184935,MMW 15,A04,886417,Chang; Edmond Yi-Teh,0,8,28,28
1746539184935,MMW 15,B01,886419,Chang; Edmond Yi-Teh,0,7,28,28
1746539184935,MMW 15,B02,886420,Chang; Edmond Yi-Teh,0,8,28,28
1746539184935,MMW 15,B03,886421,Chang; Edmond Yi-Teh,0,7,28,28
1746539184935,MMW 15,B04,886422,Chang; Edmond Yi-Teh,0,8,28,28
1746539184935,MMW 15,C01,886424,Staff,0,9,28,28
1746539184935,MMW 15,C02,886425,Staff,0,8,28,28
1746539184935,MMW 15,C03,886426,Staff,0,8,28,28
1746539184935,MMW 15,C04,886427,Staff,0,7,28,28
1746539184935,MMW 15,C05,958038,Staff,0,7,28,28
1746539184935,MMW 15,C06,958039,Staff,0,8,28,28
1746539185963,MMW 15GS,A00,906910,Patterson; Patrick H.,4,0,28,24
1746539186990,MMW 122R,A01,886429,Rahimi; Babak,0,13,28,28
1746539186990,MMW 122R,A02,886430,Rahimi; Babak,0,12,28,28
1746539186990,MMW 122R,A03,958040,Rahimi; Babak,0,11,28,28
1746539188029,MUS 1A,A01,890937,Staff,3,0,25,22
1746539188029,MUS 1A,A02,891035,Staff,6,0,25,19
1746539188029,MUS 1A,C01,958912,Staff,24,0,25,1
1746539188029,MUS 1A,C02,958913,Staff,25,0,25,0
1746539190085,MUS 2AK,A00,957092,Ohnishi; Takae,15,0,15,0
1746539191112,MUS 4,A01,891044,Staff,2,0,25,23
1746539191112,MUS 4,A02,891045,Staff,23,0,25,2
1746539191112,MUS 4,B01,891048,Staff,17,0,25,8
1746539191112,MUS 4,B02,891050,Staff,25,0,25,0
1746539192143,MUS 5,A01,957506,Dubnov; Shlomo,0,0,25,25
1746539192143,MUS 5,A02,957622,Dubnov; Shlomo,14,0,25,11
1746539192143,MUS 5,A03,957623,Dubnov; Shlomo,20,0,25,5
1746539193172,MUS 6,A01,891053,Freitas Caetano; Marcelo,24,0,25,1
1746539193172,MUS 6,A02,891054,Freitas Caetano; Marcelo,23,0,25,2
1746539194203,MUS 7,A01,891081,Staff,0,0,25,25
1746539194203,MUS 7,A02,891082,Staff,4,0,25,21
1746539195236,MUS 8GS,A00,891118,Borgo; David Garcia,0,0,25,25
1746539196262,MUS 11,A01,891140,Staff,11,0,25,14
1746539196262,MUS 11,A02,891141,Staff,22,0,25,3
1746539197287,MUS 13,A01,891143,Staff,8,0,25,17
1746539197287,MUS 13,A02,891144,Staff,24,0,25,1
1746539198322,MUS 15,A01,891146,Staff,9,0,25,16
1746539198322,MUS 15,A02,891148,Staff,21,0,25,4
1746539198322,MUS 15,B01,891150,Staff,18,0,25,7
1746539198322,MUS 15,B02,891151,Staff,25,0,25,0
1746539199350,MUS 20,A01,891153,Staff,5,0,20,15
1746539199350,MUS 20,A02,891155,Staff,14,0,20,6
1746539200379,MUS 80,A00,891156,Staff,19,0,25,6
1746539200379,MUS 80,B00,891157,Staff,23,0,25,2
1746539201406,MUS 130,A00,891158,Ohnishi; Takae,35,0,35,0
1746539202429,MUS 150GS,A01,891160,Borgo; David Garcia,0,0,25,25
1746539203457,MUS 170,A01,891162,Freitas Caetano; Marcelo,20,0,25,5
1746539203457,MUS 170,A02,891164,Freitas Caetano; Marcelo,21,0,25,4
1746539204493,NANO 11,A00,886220,Vazquez Mena; Oscar,13,0,15,2
1746539205521,NANO 15,A01,886222,Drews; Aaron,4,0,7,3
1746539206548,NANO 104,A00,886224,Sirbuly; Donald,18,0,25,7
1746539207574,PH 40,A00,886528,Staff,23,0,40,17
1746539208607,PH 45,A01,886799,Staff,35,0,40,5
1746539209643,PH 110,A00,886802,Staff,0,7,40,40
1746539210668,PH 172,A00,906716,Staff,19,0,35,16
1746539211700,PH 191,A00,886803,Staff,6,0,40,34
1746539212726,PHIL 1,A00,889500,Staff,19,0,30,11
1746539213761,PHIL 10,A01,889549,Grush; Rick Scott,15,0,22,7
1746539213761,PHIL 10,A02,889551,Grush; Rick Scott,22,0,22,0
1746539214794,PHIL 28,A01,889559,Lamey; Andy M.,0,1,31,31
1746539214794,PHIL 28,A02,889561,Lamey; Andy M.,0,1,30,30
1746539214794,PHIL 28,A03,889572,Lamey; Andy M.,0,0,30,30
1746539215824,PHIL 35,A00,907839,Staff,13,0,15,2
1746539216851,PHIL 60,A00,889574,Staff,74,0,90,16
1746539217880,PHIL 101,A00,958004,Staff,13,0,15,2
1746539219940,PHIL 136,A00,889582,Fulkerson; Matthew Todd,26,0,45,19
1746539220967,PHIL 163,A01,889601,Staff,21,0,30,9
1746539220967,PHIL 163,B01,889606,Brandt; Reuven A,0,3,0,0
1746539221991,PHIL 164,A00,889610,Staff,16,0,30,14
1746539223017,PHIL 165,A00,889613,Staff,23,0,30,7
1746539224044,PHYS 1A,A00,886431,Staff,26,0,70,44
1746539225073,PHYS 1AL,001,886432,Tsai; Philbert S,0,2,30,30
1746539225073,PHYS 1AL,002,886436,Tsai; Philbert S,11,0,30,19
1746539226100,PHYS 1B,A00,886439,Staff,185,0,240,55
1746539227129,PHYS 1BL,001,886441,Tsai; Philbert S,0,4,30,30
1746539227129,PHYS 1BL,002,886444,Tsai; Philbert S,2,0,30,28
1746539228161,PHYS 1C,A00,896092,Arnold; Kam S,78,0,146,68
1746539229193,PHYS 1CL,001,886448,Tsai; Philbert S,0,0,30,30
1746539229193,PHYS 1CL,002,886449,Tsai; Philbert S,0,0,30,30
1746539229193,PHYS 1CL,003,886450,Tsai; Philbert S,15,0,30,15
1746539229193,PHYS 1CL,004,886451,Tsai; Philbert S,15,0,30,15
1746539230223,PHYS 2B,A01,886457,Staff,69,0,115,46
1746539231249,PHYS 2C,A01,886460,Shotwell; Brian,0,8,65,65
1746539232276,PHYS 2CL,A01,886467,Staff,0,4,28,28
1746539232276,PHYS 2CL,A02,886468,Staff,0,3,28,28
1746539233310,PHYS 2D,A01,886470,Staff,10,0,50,40
1746539234346,PHYS 4B,A01,886475,Grinstein; Benjamin,22,0,40,18
1746539235372,POLI 5,A00,891173,Desposato; Scott,7,0,25,18
1746539236395,POLI 5D,A01,891175,Staff,5,0,5,0
1746539236395,POLI 5D,B01,891178,Staff,5,0,5,0
1746539237421,POLI 11,A00,891179,Ferree; Karen E,2,0,35,33
1746539238446,POLI 12,A00,891180,Staff,16,0,30,14
1746539239474,POLI 27,A01,891182,Staff,12,0,75,63
1746539240502,POLI 30,A00,891183,Staff,9,0,50,41
1746539241528,POLI 100B,A00,891244,Staff,5,1,35,30
1746539242556,POLI 100I,A00,891247,Staff,7,0,30,23
1746539243582,POLI 104J,A00,891248,Nichter; Maysa,14,0,30,16
1746539244612,POLI 104U,A00,891250,Nichter; Maysa,2,0,30,28
1746539246664,POLI 110B,A00,891255,Wiens; David,20,0,25,5
1746539247692,POLI 112A,A00,891256,Wiens; David,6,0,25,19
1746539248718,POLI 114BR,A00,891261,Staff,19,0,30,11
1746539249743,POLI 117R,A00,891262,Forman; Fonna,0,6,50,50
1746539250771,POLI 118,A00,891264,Ingham; Sean,17,0,25,8
1746539251797,POLI 124A,A00,891265,Staff,18,0,20,2
1746539252823,POLI 125D,A00,891266,Nichter; Simeon C,2,0,25,23
1746539253850,POLI 126,A00,891268,Nichter; Simeon C,7,0,25,18
1746539254878,POLI 126AA,A00,891272,Staff,18,0,25,7
1746539255906,POLI 130AA,A00,891273,Staff,15,0,20,5
1746539256930,POLI 134AA,A00,891274,Staff,4,0,20,16
1746539258983,POLI 138,A00,891278,Staff,21,0,25,4
1746539260012,POLI 142K,A00,891280,Staff,11,0,25,14
1746539261040,POLI 142M,A00,891281,Gartzke; Erik,17,0,30,13
1746539262069,POLI 142P,A00,891284,Staff,20,0,30,10
1746539263099,POLI 143,A00,891285,Gartzke; Erik,12,0,30,18
1746539264128,POLI 153,A00,891286,Staff,19,0,20,1
1746539266190,POLI 175,A00,891290,Staff,15,0,20,5
1746539267223,PSYC 1,A00,890674,Steiner; Eric Tomas,0,11,45,45
1746539268249,PSYC 2,A00,890676,Albright; Thomas D,21,0,35,14
1746539269277,PSYC 3,A00,890679,Staff,17,0,20,3
1746539270306,PSYC 6,A00,959858,Staff,20,0,20,0
1746539271335,PSYC 60,A01,890684,Rickard; Timothy C.,0,5,45,45
1746539272360,PSYC 70,A01,890689,Geller; Emma Harlan,7,0,30,23
1746539273387,PSYC 71,A01,959860,Staff,21,0,25,4
1746539274411,PSYC 100,A00,890690,Lacefield; Katharine I,0,50,180,180
1746539275434,PSYC 102,A00,890695,Staff,18,0,40,22
1746539276460,PSYC 105,A00,890699,Geller; Emma Harlan,71,0,100,29
1746539277487,PSYC 106,A00,890701,Gorman; Michael R.,5,0,30,25
1746539278518,PSYC 108,A00,890704,Adrian; Julia Anna,0,28,50,50
1746539279547,PSYC 118,A01,890712,Staff,11,0,30,19
1746539280576,PSYC 124,A00,890716,Chapman; Eddie Nathaniel,25,0,60,35
1746539281607,PSYC 131,A00,890717,Anagnostaras; Stephan,0,7,80,80
1746539282639,PSYC 137,A00,890719,Winkielman; Piotr,0,11,30,30
1746539283668,PSYC 144,A00,890721,Adrian; Julia Anna,0,9,45,45
1746539284696,PSYC 162,A00,890805,Staff,2,0,75,73
1746539285722,PSYC 169,A00,890810,Staff,0,15,30,30
1746539286747,PSYC 172,A00,890814,Gorman; Michael R.,9,0,30,21
1746539287771,PSYC 181,A00,890818,Anagnostaras; Stephan,8,0,200,192
1746539288796,PSYC 184,A00,959861,Staff,170,0,175,5
1746539289847,PSYC 189,A00,890823,Staff,0,1,30,30
1746539290878,PSYC 191,A00,890884,Rickard; Timothy C.,0,11,35,35
1746539291909,PSYC 193,A00,890913,Staff,19,0,30,11
1746539291909,PSYC 193,B00,890914,Chapman; Eddie Nathaniel,24,0,30,6
1746539292936,PSYC 193L,A01,890918,Lowe; Angela Beth,20,0,30,10
1746539292936,PSYC 193L,B01,890921,Hurwitz; Ethan Scott,20,0,30,10
1746539292936,PSYC 193L,C01,890928,Staff,30,0,30,0
1746539293964,RELI 149,A00,886806,Rahimi; Babak,23,0,40,17
1746539294990,SE 9,A01,886814,Staff,7,0,20,13
1746539296016,SE 101B,A01,886816,Chadha; Mayank,4,0,35,31
1746539297050,SE 110B,A00,886818,Zhu; Qiang,4,0,75,71
1746539298076,SE 125,A01,886830,Staff,10,0,30,20
1746539299105,SE 130B,A01,886835,Staff,14,0,40,26
1746539300136,SE 131A,A01,886838,Krysl; Petr,34,0,55,21
1746539301165,SE 154,A00,886840,Staff,30,0,50,20
1746539302189,SE 164GS,A01,886849,Staff,6,0,20,14
1746539303214,SE 167GS,A01,886853,Staff,6,0,20,14
1746539304239,SIO 25,A01,890107,Staff,19,0,30,11
1746539305265,SIO 45,A00,890109,Cook; Geoffrey W,117,0,200,83
1746539306291,SIO 109R,A00,890110,Forman; Fonna,0,16,20,20
1746539307322,SIO 187,A01,890114,Kacev; David,15,0,40,25
1746539308348,SOCI 1,A01,890431,Thorpe; Charles Robert,15,0,30,15
1746539308348,SOCI 1,A02,890518,Thorpe; Charles Robert,30,0,30,0
1746539309377,SOCI 2,A01,957978,Staff,25,0,25,0
1746539309377,SOCI 2,A02,957979,Staff,23,0,25,2
1746539310408,SOCI 20,A01,890523,Calderon-Zaks; Michael Aar,23,0,30,7
1746539310408,SOCI 20,A02,890526,Calderon-Zaks; Michael Aar,29,0,30,1
1746539311441,SOCI 30,A01,890533,Pardo Guerra; Juan Pablo,37,0,40,3
1746539312471,SOCI 40,A01,890535,Staff,27,0,45,18
1746539313502,SOCI 104Q,A00,890559,Staff,18,0,30,12
1746539314527,SOCI 106,A00,890560,Arnal; Maud Marie Leonie,20,0,30,10
1746539315557,SOCI 110,A00,890567,Holkenbrink-Monk; Charlene,19,0,30,11
1746539316584,SOCI 112,A00,890568,Victoria Torres; Pablo,1,0,55,54
1746539317609,SOCI 115,A00,890597,Arnal; Maud Marie Leonie,28,0,45,17
1746539319679,SOCI 121,A00,890604,Pardo Guerra; Juan Pablo,38,0,45,7
1746539320706,SOCI 126,A01,890608,Staff,8,0,10,2
1746539321744,SOCI 127,A00,890609,Staff,18,0,30,12
1746539322773,SOCI 131,A00,890610,Thorpe; Charles Robert,37,0,45,8
1746539323800,SOCI 135,A00,890615,Payne; Christine Anna,14,0,45,31
1746539324830,SOCI 139,A00,890620,Staff,38,0,45,7
1746539325856,SOCI 148E,A00,890622,Calderon-Zaks; Michael Aar,36,0,45,9
1746539326880,SOCI 150,A00,890623,Kohler; Kristopher M.,31,0,45,14
1746539327911,SOCI 157,A00,890625,Jules-Rosette; Bennetta W.,18,0,20,2
1746539328940,SOCI 160,A00,890627,Payne; Christine Anna,21,0,45,24
1746539329968,SYN 1,A00,886855,Fish; Gwendolyn Anne,0,0,0,0
1746539329968,SYN 1,B00,906086,Fish; Gwendolyn Anne,0,1,0,2
1746539330994,SYN 2R,A00,886860,Staff,0,17,15,15
1746539330994,SYN 2R,B00,906106,Atkinson; Arthur Laird,0,16,15,15
1746539332027,SYN 100,A01,886866,Browne; Emily,0,28,20,20
1746539332027,SYN 100,B01,906128,Rock; Martin,0,5,20,20
1746539332027,SYN 100,C01,906140,Deavenport; James Cary,0,3,20,20
1746539332027,SYN 100,D01,907816,Deavenport; James Cary,0,5,20,20
1746539333062,TDAC 1,A00,890286,Walsh; Kim C.,9,0,20,11
1746539334087,TDAC 101,A00,890296,Basso; Beatrice,16,0,20,4
1746539335114,TDDE 131,A00,890297,Staff,47,0,50,3
1746539336140,TDDM 1,A00,890287,Weinberg; Sadie,25,0,30,5
1746539337170,TDGE 11,A00,890288,Fulton; Julia,137,0,200,63
1746539337170,TDGE 11,B00,890289,Castro; Robert Jess,184,0,200,16
1746539338196,TDGE 25,B00,957359,Walsh; Kim C.,3,0,20,17
1746539339223,TDGE 40,A01,890292,Power; Jade Yukana,27,0,30,3
1746539340253,TDGE 124,A00,890298,Havis; Allan,0,0,50,50
1746539341280,TDGE 131R,A00,890299,Burelle; Julie Sara Veronique,15,0,42,27
1746539342306,TDHT 101,A00,890300,Staff,10,0,20,10
1746539343336,TDHT 109,A01,890302,Anderson; Mysia Anyse,31,0,40,9
1746539344360,TDMV 1,A00,890293,Arcidiacono; Kristin,18,0,30,12
1746539345385,TDMV 2,A00,890294,Weinberg; Sadie,23,0,30,7
1746539346410,TDMV 3,A00,957878,Arcidiacono; Kristin,28,0,30,2
1746539348462,TDMV 138,A00,890304,Jun; Grace Shin Hae,25,0,40,15
1746539349492,TDMV 140,A00,890305,Corrales; Joseph Bernales,25,0,30,5
1746539350518,TDMV 142,A00,890307,Caligagan; Tony,32,0,40,8
1746539351548,TDMV 144,A00,890308,Camaya; Michelle Ann,25,0,30,5
1746539352575,TDPW 1,A00,890295,Stein; Deborah Isobel,3,0,20,17
1746539353602,USP 2,A01,890272,Lerner; Amy M,6,0,20,14
1746539354630,USP 3,A01,890274,Staff,12,0,30,18
1746539355658,USP 15,A01,890276,Sun; Feiyang,17,0,30,13
1746539356690,USP 25,A00,890277,Shenkman; Michael Thomas,19,0,25,6
1746539357716,USP 138,A00,890278,Staff,13,0,25,12
1746539358741,USP 143,A00,890279,Staff,21,0,70,49
1746539359769,USP 144,A00,890280,Chowdhury; Muhammed Zohir,16,0,30,14
1746539360796,USP 150,A00,890281,Boomhower; Matthew Charles,4,0,30,26
1746539361823,USP 151,A00,890282,Staff,16,0,20,4
1746539362850,USP 162,A00,890283,Andrews; Abigail Leslie,16,0,20,4
1746539363876,USP 168,A00,920477,Kwak; Nancy,1,0,5,4
1746539364904,USP 181,A00,890284,Staff,3,0,20,17
1746539365932,USP 191A,A00,890285,Staff,13,0,20,7
1746539366962,VIS 101,A00,886512,Staff,25,0,75,50
1746539367996,VIS 103,A00,886513,Cruz; Edwin Teddy,61,0,75,14
1746539369021,VIS 108,A00,886514,Staff,3,0,15,12
1746539370047,VIS 127P,A00,886515,Shen; Kuiyi,80,0,146,66
1746539371074,VIS 149,A00,886516,Yoldas; Pinar,0,0,15,15
1746539372101,VIS 164,A00,886526,Erdmann; Dean,19,0,22,3
1746539373129,VIS 194S,A00,886527,Staff,61,0,75,14
1746539374165,WCWP 10A,C00,886484,Martiniuk; Jill,12,0,15,3
1746539375194,WCWP 10B,A00,886490,Uriarte; Emma,0,0,15,15
1746539375194,WCWP 10B,B00,886491,Dhir; Simrita,11,0,15,4
1746539375194,WCWP 10B,C00,886492,Ornelas; Tricia,0,0,15,15
1746539376222,WCWP 100,A00,886494,Young; Mark T,0,7,15,15
1746539378348,AAS 10,A01,886199,Childs; Dennis R.,0,3,0,0
1746539379376,ANAR 104,A01,886940,Shtienberg; Gilad,27,0,30,3
1746539380402,ANAR 120,A00,886953,Staff,12,0,20,8
1746539381433,ANBI 148,A01,886955,Wilder; Linnea Lorene,30,0,40,10
1746539383484,ANSC 122,A00,886957,Staff,25,0,30,5
1746539384515,ANSC 150,A00,886958,Sloane; Julia Kathryn,3,0,15,12
1746539385547,ANSC 156,A00,886959,Jenkins; Janis A.,0,1,15,15
1746539386573,ANSC 180,A00,886960,Staff,11,0,17,6
1746539387607,ANSC 188,A00,886961,Jassal; Aftab,9,0,25,16
1746539388636,ANSC 190,A00,886962,Jassal; Aftab,14,0,25,11
1746539389662,ANSC 191,A00,886963,Staff,18,0,20,2
1746539390688,ANTH 3,A01,891689,Staff,17,0,20,3
1746539391714,ANTH 5,A00,886933,Semendeferi; Ekaterini,16,0,20,4
1746539392741,ANTH 10,A00,886934,Staff,0,12,30,30
1746539393767,ANTH 21,A01,886936,Staff,40,0,60,20
1746539394797,ANTH 23,A01,886938,Staff,92,0,100,8
1746539395822,ANTH 105,A00,886964,Stewart; Alexander B,84,0,100,16
1746539396853,ANTH 108,A00,886965,Pedersen; David,9,0,20,11
1746539397883,AWP 10,001,886147,Staff,0,0,0,0
1746539397883,AWP 10,002,886148,Staff,0,0,0,0
1746539397883,AWP 10,003,886149,Staff,0,0,0,0
1746539397883,AWP 10,004,886150,Staff,0,0,0,0
1746539397883,AWP 10,005,886151,Staff,0,0,0,0
1746539397883,AWP 10,006,886152,Staff,0,0,0,0
1746539397883,AWP 10,007,886153,Staff,0,0,0,0
1746539397883,AWP 10,008,886154,Staff,0,0,0,0
1746539397883,AWP 10,009,886155,Staff,0,0,0,0
1746539397883,AWP 10,010,886156,Staff,0,0,0,0
1746539397883,AWP 10,011,886158,Staff,0,0,0,0
1746539397883,AWP 10,012,886160,Staff,0,0,0,0
1746539397883,AWP 10,013,886161,Staff,0,0,0,0
1746539397883,AWP 10,014,886162,Staff,0,0,0,0
1746539397883,AWP 10,015,886163,Staff,0,0,0,0
1746539397883,AWP 10,016,886164,Staff,0,0,0,0
1746539397883,AWP 10,017,886165,Staff,0,0,0,0
1746539397883,AWP 10,018,886166,Staff,0,0,0,0
1746539397883,AWP 10,019,886168,Staff,0,0,0,0
1746539397883,AWP 10,020,886170,Staff,0,0,0,0
1746539397883,AWP 10,021,886172,Staff,0,0,0,0
1746539398917,AWP 10R,001,886173,Staff,0,1,0,0
1746539398917,AWP 10R,002,886174,Staff,0,1,0,0
1746539398917,AWP 10R,003,886175,Staff,0,0,0,0
1746539398917,AWP 10R,004,886176,Staff,0,0,0,0
1746539398917,AWP 10R,005,886177,Staff,0,0,0,0
1746539398917,AWP 10R,006,886178,Staff,0,0,0,0
1746539398917,AWP 10R,007,886179,Staff,0,0,0,0
1746539398917,AWP 10R,008,886181,Staff,0,0,0,0
1746539398917,AWP 10R,009,886182,Staff,0,0,0,0
1746539398917,AWP 10R,010,886183,Staff,0,0,0,0
1746539398917,AWP 10R,011,886184,Staff,0,0,0,0
1746539398917,AWP 10R,012,886185,Staff,0,0,0,0
1746539398917,AWP 10R,013,886186,Staff,0,0,0,0
1746539398917,AWP 10R,014,886187,Staff,0,0,0,0
1746539398917,AWP 10R,015,886188,Staff,0,0,0,0
1746539398917,AWP 10R,016,886189,Staff,0,0,0,0
1746539399947,AWP 102R,A00,886190,Staff,0,0,0,0
1746539399947,AWP 102R,B00,886191,Staff,0,0,0,0
1746539400974,BENG 100,A01,886193,Staff,17,0,30,13
1746539402003,BENG 122A,A01,886195,Hasty; Jeff M,13,0,30,17
1746539403032,BENG 166A,A00,886196,Sah; Robert Lie-Yuan,0,1,30,30
1746539404068,BENG 190,A00,958050,Khojah; Reem I,24,0,25,1
1746539405096,BIBC 102,A01,894320,Staff,0,0,46,46
1746539405096,BIBC 102,A02,894321,Staff,1,0,46,45
1746539405096,BIBC 102,A03,894344,Staff,7,0,46,39
1746539405096,BIBC 102,A04,894345,Staff,26,0,47,21
1746539406125,BICD 100R,A01,894365,Smith; Laurie,0,3,58,58
1746539406125,BICD 100R,A02,894366,Smith; Laurie,0,5,58,58
1746539406125,BICD 100R,A03,894367,Smith; Laurie,2,0,59,57
1746539406125,BICD 100R,A04,959869,Smith; Laurie,41,0,59,18
1746539407153,BICD 136,A01,894383,Gustafson-Brown; Cindy,14,0,50,36
1746539408181,BIEB 102,A01,894494,Butler; Shannon Rhey,51,0,130,79
1746539410238,BIEB 150,A01,894617,Wills; Christopher,3,0,20,17
1746539410238,BIEB 150,A02,894631,Wills; Christopher,3,0,20,17
1746539410238,BIEB 150,A03,894937,Wills; Christopher,3,0,20,17
1746539410238,BIEB 150,A04,894946,Wills; Christopher,5,0,20,15
1746539411266,BIEB 194,A00,906141,Kurle; Carolyn M.,6,0,20,14
1746539412298,BILD 1,A01,894154,Staff,2,0,19,17
1746539412298,BILD 1,A02,894155,Staff,14,0,19,5
1746539412298,BILD 1,A03,894160,Staff,13,0,19,6
1746539412298,BILD 1,A04,894161,Staff,15,0,18,3
1746539413324,BILD 2,A01,894168,Staff,0,0,50,50
1746539413324,BILD 2,A02,894169,Staff,0,0,50,50
1746539413324,BILD 2,A03,894179,Staff,4,0,50,46
1746539413324,BILD 2,A04,894203,Staff,27,0,50,23
1746539414352,BILD 3,A01,894213,Staff,22,0,31,9
1746539414352,BILD 3,A02,894214,Staff,26,0,31,5
1746539414352,BILD 3,A03,894235,Staff,28,0,31,3
1746539414352,BILD 3,A04,894236,Staff,28,0,32,4
1746539415380,BILD 4,A01,894253,Reuther; Keefe,5,0,24,19
1746539415380,BILD 4,A02,894258,Reuther; Keefe,16,0,24,8
1746539416406,BILD 5,A01,894276,Reuther; Keefe,35,0,50,15
1746539416406,BILD 5,A02,894277,Reuther; Keefe,45,0,50,5
1746539416406,BILD 5,A03,894290,Reuther; Keefe,44,0,50,6
1746539416406,BILD 5,A04,894291,Reuther; Keefe,48,0,50,2
1746539417435,BILD 24,A01,894297,Pirino; Giorgia,40,0,60,20
1746539418462,BIMM 100,B01,958915,Staff,72,0,100,28
1746539419490,BIMM 101,A01,895017,McDonnell; Lisa Marie,0,5,24,24
1746539419490,BIMM 101,A02,895018,McDonnell; Lisa Marie,0,5,24,24
1746539419490,BIMM 101,B01,895020,McDonnell; Lisa Marie,0,6,24,24
1746539419490,BIMM 101,B02,895021,McDonnell; Lisa Marie,0,4,24,24
1746539420519,BIMM 110,A01,895023,Staff,1,0,25,24
1746539420519,BIMM 110,A02,895024,Staff,9,0,25,16
1746539420519,BIMM 110,A03,895025,Staff,18,0,25,7
1746539420519,BIMM 110,A04,895031,Staff,20,0,25,5
1746539421552,BIMM 120,A01,895114,Gustafson-Brown; Cindy,13,0,28,15
1746539421552,BIMM 120,A02,895126,Gustafson-Brown; Cindy,21,0,27,6
1746539422586,BIPN 100,A01,895130,Yang; Mingyu,1,0,38,37
1746539422586,BIPN 100,A02,895131,Yang; Mingyu,32,0,38,6
1746539422586,BIPN 100,A03,895132,Yang; Mingyu,32,0,38,6
1746539422586,BIPN 100,A04,895133,Yang; Mingyu,27,0,36,9
1746539423620,BIPN 120,A01,895135,Cooke; James Edward,0,3,13,13
1746539423620,BIPN 120,A02,895136,Cooke; James Edward,0,1,13,13
1746539423620,BIPN 120,A03,895137,Cooke; James Edward,0,3,13,13
1746539423620,BIPN 120,A04,895156,Cooke; James Edward,0,2,11,11
1746539424647,BIPN 134,A01,895235,Cooke; James Edward,0,2,25,25
1746539424647,BIPN 134,A02,895237,Cooke; James Edward,0,0,25,25
1746539424647,BIPN 134,A03,895240,Cooke; James Edward,3,0,25,22
1746539424647,BIPN 134,A04,895270,Cooke; James Edward,20,0,25,5
1746539425674,BIPN 189,A00,892103,Staff,0,13,14,14
1746539427727,BISP 194,A00,958008,Staff,0,2,0,0
1746539428757,CAT 124,A01,922009,Staff,0,5,20,20
1746539429789,CAT 125R,A00,886390,Morales; Celeste Georgianna,0,2,20,20
1746539429789,CAT 125R,B00,886391,Irwin; Matthew Joseph,0,3,20,20
1746539429789,CAT 125R,C00,886392,Smith; Lauryn Alissa,0,2,20,20
1746539429789,CAT 125R,D00,886393,Vanderschuit; Maya Alysia,0,2,20,20
1746539429789,CAT 125R,E00,886394,Marchisotto; Jennifer Anne,0,4,20,20
1746539430821,CENG 15,A01,886218,Drews; Aaron,3,0,8,5
1746539431850,CENG 113,A00,886219,Opatkiewicz; Justin Paul,15,0,25,10
1746539432883,CGS 101,A00,887044,Staff,7,0,20,13
1746539433908,CGS 105,A01,887046,Staff,14,0,25,11
1746539434936,CGS 112,A00,887047,Cuong; Marisol,12,0,15,3
1746539435962,CGS 113,A00,887048,Staff,23,0,30,7
1746539436990,CGS 120,A00,887049,Staff,10,0,17,7
1746539438024,CHEM 6A,A01,886336,Lam; Tin Yiu,38,0,50,12
1746539438024,CHEM 6A,A02,886338,Lam; Tin Yiu,37,0,50,13
1746539439051,CHEM 6B,A01,886341,Hopkins; Patrycja Anna,16,0,50,34
1746539439051,CHEM 6B,A02,886343,Hopkins; Patrycja Anna,42,0,50,8
1746539440079,CHEM 6C,A01,886346,Albizati; Kim F.,0,2,50,50
1746539440079,CHEM 6C,A02,886348,Albizati; Kim F.,23,0,50,27
1746539441107,CHEM 40A,A01,886352,Klosterman; Jeremy K,65,0,100,35
1746539442137,CHEM 40B,A01,886356,Klosterman; Jeremy K,0,23,100,100
1746539443164,CHEM 41B,A01,886360,Theodorakis; Emmanuel,25,0,50,25
1746539443164,CHEM 41B,A02,886362,Theodorakis; Emmanuel,47,0,50,3
1746539444188,CHIN 165A,A00,886382,Xu; Li,18,0,20,2
1746539445218,CLAS 120,A00,886387,Myerston Santana; Jacobo,33,0,40,7
1746539446245,COGS 9,A01,886967,Shannon; Kyle Michael,42,0,60,18
1746539447276,COGS 11,A01,886969,Staff,11,0,30,19
1746539448301,COGS 14A,A01,886971,Staff,6,0,60,54
1746539449330,COGS 14B,A01,886973,Hoffman; Drew Ellen,4,0,60,56
1746539450357,COGS 18,A01,886975,Morgan; Eric,35,0,60,25
1746539451383,COGS 20,A01,886977,Staff,4,0,8,4
1746539451383,COGS 20,A02,886978,Staff,5,0,7,2
1746539452418,COGS 100,A01,907783,Staff,0,2,30,30
1746539453450,COGS 101B,A01,886980,Staff,0,3,48,48
1746539454481,COGS 101C,A01,886982,Delgado; Tania,0,5,44,44
1746539455512,COGS 102A,A01,886984,Johnson; Christine M.,4,0,30,26
1746539456537,COGS 118B,A01,886986,Staff,0,3,88,88
1746539457567,COGS 150,A01,886988,Bergen; Benjamin,23,0,50,27
1746539458597,COGS 153,A00,886989,Delgado; Tania,0,2,41,41
1746539459628,COGS 186,A01,886991,Staff,0,0,32,32
1746539460659,COGS 187A,A01,886993,Boyle; Mary E. T.,7,0,30,23
1746539461686,COGS 189,A00,886994,Staff,0,1,30,30
1746539462713,COMM 10,A01,886996,Staff,0,0,20,21
1746539462713,COMM 10,A02,886997,Staff,12,0,20,8
1746539462713,COMM 10,A03,959845,Staff,19,0,20,1
1746539463741,COMM 20,A01,886999,Leuning; Grant Maurstad,24,0,40,16
1746539465797,COMM 100A,A01,887002,Staff,0,0,20,25
1746539465797,COMM 100A,A02,887003,Staff,7,0,20,13
1746539466826,COMM 100B,A01,887005,Staff,0,8,20,24
1746539467852,COMM 106D,A00,887006,Staff,14,0,40,26
1746539468880,COMM 110G,A00,887007,Whitworth-Smith; Andrew C,12,0,40,28
1746539469909,COMM 111B,A00,887008,Staff,31,0,40,9
1746539470942,COMM 113T,A00,887009,Abuelhiga; Soraya Jill,28,0,40,12
1746539470942,COMM 113T,B00,906733,Staff,40,0,40,0
1746539471970,COMM 145,A00,887010,Staff,12,0,40,28
1746539472998,COMM 146,A00,887054,Staff,31,0,40,9
1746539474025,COMM 190,A00,887012,Staff,8,0,23,15
1746539475059,CSE 8A,A50,887015,Cao; Yingjun,57,0,85,28
1746539476088,CSE 11,A01,887017,Cao; Yingjun,12,0,70,58
1746539477114,CSE 20,A01,887019,Staff,30,0,50,20
1746539478148,CSE 21,A01,887021,Staff,78,0,100,22
1746539478148,CSE 21,B01,892583,Braun; Oliver,45,0,50,5
1746539479175,CSE 30,A01,887025,Eldon; John,143,0,200,57
1746539480206,CSE 100,A01,887027,Staff,26,0,50,24
1746539480206,CSE 100,A02,887028,Staff,40,0,50,10
1746539481234,CSE 101,A01,887030,Braun; Oliver,75,0,100,25
1746539481234,CSE 101,B01,887032,Jones; Miles E,0,3,50,50
1746539481234,CSE 101,B02,887033,Jones; Miles E,0,1,50,50
1746539482265,CSE 105,A01,908084,Jones; Miles E,32,0,50,18
1746539482265,CSE 105,A02,908087,Jones; Miles E,33,0,50,17
1746539483297,CSE 135,A01,887035,Powell; Thomas Allan,0,4,50,50
1746539484325,CSE 142,A01,887037,Staff,8,0,60,52
1746539485354,CSE 142L,A01,887039,Staff,34,0,60,26
1746539486385,CSE 151A,A01,887041,Solares; Edwin A,48,0,100,52
1746539487413,CSE 175,A01,887043,Kumar; Rakesh,30,0,30,0
1746539488440,CSS 1,A01,886389,Staff,0,1,40,40
1746539489468,DSC 30,A01,908097,Liao; Soohyun Nam,47,0,75,28
1746539490497,DSC 40A,A01,908099,Shannon; Kyle Michael,30,0,50,20
1746539491530,DSC 40B,A01,908112,Staff,16,0,50,34
1746539492557,DSC 80,A01,908116,Staff,19,0,60,41
1746539493586,DSC 197,001,956863,Eldridge; Justin Matthew,9999,0,9999,0
1746539494612,ECE 5,A01,886400,Morris; Karcher William,2,0,6,4
1746539494612,ECE 5,A02,886401,Morris; Karcher William,3,0,6,3
1746539495636,ECE 148,A01,886403,Silberman; Jack,0,14,14,14
1746539496668,ECON 1,A01,887265,Crane; Meredith Helen,12,0,70,58
1746539496668,ECON 1,B01,887268,Staff,43,0,50,7
1746539497694,ECON 2,A01,887273,Crane; Meredith Helen,56,0,70,14
1746539498722,ECON 3,A01,887279,Rondina; Giacomo,32,0,70,38
1746539499752,ECON 4,A01,887282,Anderson; John Charles,0,2,10,10
1746539500782,ECON 5,A01,887285,Staff,33,0,45,12
1746539500782,ECON 5,B01,887292,Staff,41,0,45,4
1746539501814,ECON 100A,A01,887337,Newhouse; Herbert S,54,0,70,16
1746539501814,ECON 100A,B01,887349,Staff,45,0,50,5
1746539502845,ECON 100B,A01,887361,Du; Songzi,29,0,70,41
1746539503871,ECON 100C,A01,887445,Newhouse; Herbert S,59,0,70,11
1746539504903,ECON 105,A00,887488,Vespa; Emanuel Ignacio,23,0,35,12
1746539505931,ECON 109,A01,887506,Shishkin; Denis,28,0,35,7
1746539506965,ECON 110A,A01,887568,Alon; Titan Michael,0,3,35,35
1746539506965,ECON 110A,B01,907601,Alon; Titan Michael,20,0,35,15
1746539507996,ECON 110B,A01,887598,Levkoff; Steven B.,0,23,70,70
1746539509023,ECON 112,A00,887599,Rondina; Giacomo,19,0,35,16
1746539510054,ECON 120A,A01,887603,Dai; Yinlin,36,0,70,34
1746539511082,ECON 120C,A01,887608,Sun; Yixiao,0,1,35,35
1746539511082,ECON 120C,B01,887614,Sun; Yixiao,0,0,35,35
1746539512108,ECON 138,A00,887621,Bharadwaj; Prashant,0,20,20,20
1746539513139,ECON 144,A00,958007,Squires; Dale E,13,0,35,22
1746539514167,ECON 171,A01,907666,Staff,18,0,35,17
1746539515196,ECON 175,A00,887626,Wu; Pak Yeung,23,0,35,12
1746539516225,ECON 190,A00,887640,Vespa; Emanuel Ignacio,23,0,35,12
1746539517268,EDS 25,A01,888197,Staff,0,0,0,0
1746539517268,EDS 25,A02,888209,Staff,0,0,0,0
1746539517268,EDS 25,A03,888210,Staff,0,0,0,0
1746539517268,EDS 25,A04,888212,Staff,0,0,0,0
1746539517268,EDS 25,A05,888213,Staff,0,0,0,0
1746539517268,EDS 25,A06,888214,Staff,0,0,0,0
1746539517268,EDS 25,A07,888235,Staff,0,2,0,0
1746539517268,EDS 25,A08,888236,Staff,0,0,0,0
1746539517268,EDS 25,A09,888240,Staff,0,0,0,0
1746539517268,EDS 25,A10,888244,Staff,0,0,0,0
1746539517268,EDS 25,B01,888273,Staff,0,0,0,0
1746539517268,EDS 25,B02,888285,Staff,0,0,0,0
1746539517268,EDS 25,B03,888423,Staff,0,0,0,1
1746539517268,EDS 25,B04,888432,Staff,0,0,0,0
1746539517268,EDS 25,B05,888433,Staff,0,0,0,0
1746539517268,EDS 25,B06,888467,Staff,0,0,0,0
1746539517268,EDS 25,B07,888468,Staff,0,0,0,0
1746539517268,EDS 25,B08,888479,Staff,0,0,0,0
1746539517268,EDS 25,B09,888484,Staff,0,0,0,0
1746539517268,EDS 25,B10,888487,Staff,0,0,0,0
1746539518297,EDS 38,A01,907700,Choi; Bailey Miyeon,30,0,30,0
1746539519325,EDS 112,A01,888601,Chapman; Thandeka K,14,0,40,26
1746539520360,EDS 115,A00,888697,Mendez; Kathrina Mendoza,10,0,30,20
1746539521391,EDS 116,A01,888893,Staff,35,0,40,5
1746539523445,EDS 124AR,A00,889133,Staff,29,0,50,21
1746539523445,EDS 124AR,B00,907471,Simon; Elizabeth A,37,0,50,13
1746539524472,EDS 124BR,A00,889134,Simon; Elizabeth A,45,0,100,55
1746539525502,EDS 125,A00,889135,Staff,25,0,30,5
1746539526527,EDS 126,A01,889138,Staff,36,0,40,4
1746539527573,EDS 164R,A01,889142,Wishard Guerra; Alison G.,33,0,50,17
1746539528604,ENG 30,A01,886396,Staff,0,0,0,0
1746539528604,ENG 30,B01,886398,Staff,0,0,0,0
1746539529629,ENVR 102,A00,906150,Montejo; Carolina,23,0,25,2
1746539530655,ETHN 103A,A00,887236,Man; Simeon S,0,3,0,0
1746539531686,ETHN 113,A00,887239,Staff,16,0,30,14
1746539532712,ETHN 116,A00,887240,Staff,16,0,25,9
1746539533743,ETHN 117,A00,887241,Choi; Esther Min,28,0,30,2
1746539534770,ETHN 118,A00,887243,Staff,24,0,30,6
1746539535800,ETHN 127,A00,887248,Cuong; Marisol,11,0,15,4
1746539536827,ETHN 139,A00,887250,Staff,7,0,10,3
1746539537851,ETHN 142,A00,887252,Staff,10,0,30,20
1746539538882,ETHN 161,A00,887253,Browne; Errol Tsekani,24,0,30,6
1746539539912,ETHN 163FR,A00,887255,Burelle; Julie Sara Veronique,0,0,5,5
1746539540946,GLBH 20,A00,889149,Elwardani; Nile Regina,8,0,42,34
1746539543000,GLBH 111,A01,889152,Burgos; Jose L.,17,0,17,0
1746539544026,GLBH 150,A00,889181,Sloane; Julia Kathryn,0,5,15,15
1746539546086,HDS 60,A01,886406,Warstadt; Melissa Fawn,73,0,80,7
1746539547117,HIAF 111,A00,889324,Gyamfi; Bright,25,0,32,7
1746539548143,HIEA 131,A00,889328,Staff,16,0,32,16
1746539549176,HIEA 144,A00,889333,Henry; Todd A.,26,0,32,6
1746539550200,HIEA 154,A00,889336,Henry; Todd A.,24,0,32,8
1746539551228,HIEU 106,A00,889339,Staff,22,0,32,10
1746539553280,HIEU 114,A00,889340,Staff,3,0,32,29
1746539554305,HIEU 135GS,A00,889342,Patterson; Patrick H.,0,0,1,24
1746539555332,HIEU 137,A00,889343,Edington; Claire Ellen,9,0,25,16
1746539556356,HIEU 148,A00,889345,Staff,14,0,32,18
1746539557382,HIEU 154,A00,889346,Biess; Frank Peter,21,0,32,11
1746539558410,HILA 102,A00,889351,Staff,12,0,32,20
1746539559436,HILD 2A,A01,889221,Lewandoski; Julia Mavis,1,10,32,31
1746539560465,HILD 7B,A01,889225,Man; Simeon S,0,13,32,32
1746539561492,HILD 7C,A01,889288,Alvarez; Luis A,0,14,32,32
1746539562517,HILD 30,A01,889323,Staff,0,5,32,32
1746539564573,HISC 119,A00,889383,Golan; Tal,21,0,32,11
1746539565603,HIUS 103,A00,889384,Man; Simeon S,0,0,32,32
1746539566629,HIUS 117,A00,919797,Kwak; Nancy,18,0,32,14
1746539567658,HIUS 142A,A00,919788,Staff,22,0,32,10
1746539569714,HIUS 149,A00,889386,Gyamfi; Bright,27,0,32,5
1746539570739,HIUS 155,A00,889387,Alvarez; Luis A,14,0,32,18
1746539571766,HUM 3,A01,886499,Caldwell; Michael Alan,19,0,50,31
1746539572793,HUM 3GS,A00,886500,Rodriguez; Bretton Sigfred,0,0,0,28
1746539573821,HUM 3R,A01,886502,Markman; Kristina,0,36,50,50
1746539574848,HUM 4,A01,886504,Crum; Matthew Stephen,24,0,50,26
1746539574848,HUM 4,B01,886506,West; Geoffrey Scott,17,0,50,33
1746539575874,HUM 4GS,A00,886507,Staff,0,0,0,19
1746539576900,HUM 5,A01,886509,Staff,32,0,50,18
1746539577931,HUM 5R,A01,886511,Zavodny; Tatiana Sophia,0,39,50,50
1746539578955,JAPN 180,A00,886407,Staff,18,0,40,22
1746539580034,LATI 50,A01,886409,Martin-Cabrera; Luis,4,0,22,18
1746539580034,LATI 50,A02,886410,Martin-Cabrera; Luis,19,0,22,3
1746539580034,LATI 50,A03,886411,Martin-Cabrera; Luis,21,0,22,1
1746539580034,LATI 50,A04,886412,Martin-Cabrera; Luis,9,0,22,13
1746539581069,LAWS 101,A00,907664,Staff,28,0,60,32
1746539582096,LIAB 1A,A00,889388,Saab; Dima,17,0,20,3
1746539583123,LIAB 1AX,A00,889389,El Cheddadi; Youniss,17,0,20,3
1746539584149,LIFR 1C,A00,889391,Van Moer; Vinciane G,8,0,20,12
1746539585176,LIFR 1CX,A00,889392,Van Moer; Vinciane G,7,0,20,13
1746539586200,LIFR 1D,A00,889393,Van Moer; Vinciane G,7,0,20,13
1746539587226,LIFR 1DX,A00,889394,Van Moer; Vinciane G,8,0,20,12
1746539588253,LIGN 7,A00,886923,Staff,24,0,50,26
1746539589280,LIGN 17,A00,886924,Kehler; Andrew Scott,125,0,150,25
1746539590305,LTAM 110,A00,889395,Staff,15,0,30,15
1746539591333,LTAM 110GS,A00,958010,Rodriguez; Bretton Sigfred,0,0,0,28
1746539592363,LTCH 101,A00,889397,Staff,23,0,25,2
1746539593387,LTCS 130,A00,889398,Staff,23,0,25,2
1746539594413,LTEA 138,A00,889399,Staff,24,0,40,16
1746539595439,LTEN 149,A00,889400,Wesling; Megan E.,0,3,25,25
1746539596465,LTEN 169,A00,889401,Staff,20,0,25,5
1746539597495,LTEN 180,A00,889402,Staff,10,0,15,5
1746539598519,LTEN 181,A00,889403,Staff,21,0,25,4
1746539599548,LTWL 100,A00,889404,Myerston Santana; Jacobo,3,0,25,22
1746539600575,LTWL 180GS,A00,889405,Staff,0,0,20,20
1746539601599,LTWL 181,A00,889406,Staff,17,0,25,8
1746539602626,LTWL 184,A00,889475,Mukherjee; Silpa,22,0,25,3
1746539603652,LTWR 102C,A00,889486,Staff,29,0,30,1
1746539604680,LTWR 115W,A00,889491,Staff,0,2,15,15
1746539605711,MAE 8,A01,886905,Staff,0,2,0,0
1746539606736,MAE 11,A00,886906,Bandaru; Prabhakar,0,7,50,50
1746539607765,MAE 20,A00,886907,Evdokimenko; Ekaterina,44,0,70,26
1746539608791,MAE 30B,A00,886909,Ghazinejad; Maziar,26,0,45,19
1746539609818,MAE 101B,A00,886910,Saintillan; David,29,0,45,16
1746539610847,MAE 105,A00,886911,Bandaru; Prabhakar,18,0,50,32
1746539611918,MAE 107,B00,958024,Staff,9,0,50,41
1746539612945,MAE 143B,A00,886913,Bewley; Thomas R,7,0,40,33
1746539613970,MAE 148,A01,886915,Silberman; Jack,0,3,14,14
1746539615004,MAE 160,A00,886916,Evdokimenko; Ekaterina,31,0,60,29
1746539616031,MATH 3C,A01,889681,Staff,0,3,30,30
1746539616031,MATH 3C,A02,960048,Staff,25,0,30,5
1746539617059,MATH 10A,A01,889760,Staff,26,0,30,4
1746539617059,MATH 10A,A02,889783,Staff,29,0,30,1
1746539618089,MATH 10B,A01,889785,Verstraete; Jacques Allan,2,0,35,33
1746539618089,MATH 10B,A02,889795,Verstraete; Jacques Allan,4,0,35,31
1746539618089,MATH 10B,B01,889797,Verstraete; Jacques Allan,3,0,35,32
1746539618089,MATH 10B,B02,889828,Verstraete; Jacques Allan,3,0,35,32
1746539619121,MATH 10C,A01,889849,Habib; Yousaf,9,0,30,21
1746539619121,MATH 10C,A02,889852,Habib; Yousaf,14,0,30,16
1746539619121,MATH 10C,A03,889853,Habib; Yousaf,22,0,30,8
1746539619121,MATH 10C,A04,889858,Habib; Yousaf,20,0,30,10
1746539619121,MATH 10C,B01,889861,Staff,1,0,30,29
1746539619121,MATH 10C,B02,889862,Staff,24,0,30,6
1746539619121,MATH 10C,B03,889863,Staff,27,0,30,3
1746539619121,MATH 10C,B04,889967,Staff,23,0,30,7
1746539620157,MATH 18,A01,889974,Staff,7,0,30,23
1746539620157,MATH 18,A02,889977,Staff,20,0,30,10
1746539620157,MATH 18,B01,889984,Hardiman; Liam,22,0,30,8
1746539620157,MATH 18,B02,889985,Hardiman; Liam,25,0,30,5
1746539621190,MATH 20A,A01,889990,Suk; Andrew Hoon,29,0,35,6
1746539622217,MATH 20B,A01,889993,Ohm; Ko Woon,22,0,30,8
1746539622217,MATH 20B,A02,889994,Ohm; Ko Woon,30,0,30,0
1746539622217,MATH 20B,B01,889996,Ohm; Ko Woon,21,0,30,9
1746539622217,MATH 20B,B02,889997,Ohm; Ko Woon,23,0,30,7
1746539623245,MATH 20C,A01,889999,Hammock; Frances H,17,0,30,13
1746539623245,MATH 20C,A02,890003,Hammock; Frances H,23,0,30,7
1746539623245,MATH 20C,B01,890006,Hammock; Frances H,3,0,30,27
1746539623245,MATH 20C,B02,890007,Hammock; Frances H,11,0,30,19
1746539624280,MATH 20D,A01,890011,Cheng; Hsiao-Bing,1,1,30,29
1746539624280,MATH 20D,A02,890012,Cheng; Hsiao-Bing,14,0,30,16
1746539624280,MATH 20D,B01,890016,Cheng; Hsiao-Bing,13,0,30,17
1746539624280,MATH 20D,B02,890017,Cheng; Hsiao-Bing,13,0,30,17
1746539625308,MATH 20E,A01,890026,Harel; Guershon,1,0,30,29
1746539625308,MATH 20E,A02,890029,Harel; Guershon,23,0,30,7
1746539625308,MATH 20E,B01,890033,Harel; Guershon,7,0,30,23
1746539625308,MATH 20E,B02,890101,Harel; Guershon,21,0,30,9
1746539626333,MATH 102,A01,890104,Staff,17,0,30,13
1746539626333,MATH 102,A02,890105,Staff,27,0,30,3
1746539627359,MATH 103B,A01,890116,Salehi Golsefidy; Alireza,3,0,30,27
1746539627359,MATH 103B,B01,890118,Staff,0,3,34,34
1746539628394,MATH 109,A01,890121,Aliabadi Sr.; Mohsen,1,0,30,29
1746539628394,MATH 109,B01,890124,Upadrashta; Pranav Kumar,18,0,30,12
1746539629429,MATH 120A,A01,890126,Eggers; John Dietrich,13,0,30,17
1746539630460,MATH 142B,A01,890128,Ioana; Adrian,19,0,30,11
1746539630460,MATH 142B,A02,890129,Ioana; Adrian,13,0,30,17
1746539631487,MATH 154,A01,890174,Staff,0,0,30,30
1746539631487,MATH 154,A02,890182,Staff,0,0,30,30
1746539632516,MATH 168A,A01,890197,Dumitriu; Ioana,21,0,35,14
1746539633543,MATH 170A,A01,890240,Nie; Jiawang,1,0,30,29
1746539633543,MATH 170A,A02,890241,Nie; Jiawang,11,0,30,19
1746539633543,MATH 170A,A03,890249,Nie; Jiawang,23,0,30,7
1746539634578,MATH 170B,A01,957891,Nag; Panchali,13,0,35,22
1746539636634,MATH 181A,A01,908025,Staff,0,4,35,35
1746539636634,MATH 181A,A02,960115,Staff,27,0,35,8
1746539637662,MATH 181B,A01,959874,Staff,26,0,30,4
1746539638689,MATH 193B,A01,890265,Staff,0,4,35,35
1746539639716,MGT 4,A01,890311,Anderson; John Charles,42,0,88,46
1746539640741,MGT 5,A00,907740,Staff,13,0,98,85
1746539641769,MGT 12,A00,890312,Lindenberger; Wade Douglas,67,0,98,31
1746539642799,MGT 16,A00,957883,Staff,78,0,98,20
1746539644860,MGT 45,A00,890314,Pecore; Joseph P.,47,0,98,51
1746539645884,MGT 71,A00,890315,Staff,0,11,98,98
1746539646911,MGT 100,A00,890316,Yavorsky; Daniel Ryan,44,0,98,54
1746539647941,MGT 103,A00,890317,Ehrich; Kristine R,73,0,98,25
1746539648970,MGT 105,A00,890356,Bates; Kenneth Walter,0,7,98,98
1746539650004,MGT 112,A00,890360,Ehrich; Kristine R,55,0,98,43
1746539651035,MGT 127R,A00,907732,Zhu; Kevin Xiaoguo,23,0,98,75
1746539652064,MGT 131B,A00,890361,Anderson; John Charles,61,0,98,37
1746539653095,MGT 137,A00,890362,Lindenberger; Wade Douglas,65,0,98,33
1746539654122,MGT 160,A00,890369,Johnson; Erik Barry,9,0,98,89
1746539656173,MGT 164,A00,890372,Zimmermann; Carsten,0,39,98,98
1746539657202,MGT 180,A00,890374,Bliss; Barbara Ann,12,0,98,86
1746539658236,MMW 15,A01,886414,Chang; Edmond Yi-Teh,0,12,28,28
1746539658236,MMW 15,A02,886415,Chang; Edmond Yi-Teh,0,8,28,28
1746539658236,MMW 15,A03,886416,Chang; Edmond Yi-Teh,0,8,28,28
1746539658236,MMW 15,A04,886417,Chang; Edmond Yi-Teh,0,8,28,28
1746539658236,MMW 15,B01,886419,Chang; Edmond Yi-Teh,0,7,28,28
1746539658236,MMW 15,B02,886420,Chang; Edmond Yi-Teh,0,8,28,28
1746539658236,MMW 15,B03,886421,Chang; Edmond Yi-Teh,0,7,28,28
1746539658236,MMW 15,B04,886422,Chang; Edmond Yi-Teh,0,8,28,28
1746539658236,MMW 15,C01,886424,Staff,0,9,28,28
1746539658236,MMW 15,C02,886425,Staff,0,8,28,28
1746539658236,MMW 15,C03,886426,Staff,0,8,28,28
1746539658236,MMW 15,C04,886427,Staff,0,7,28,28
1746539658236,MMW 15,C05,958038,Staff,0,7,28,28
1746539658236,MMW 15,C06,958039,Staff,0,8,28,28
1746539659260,MMW 15GS,A00,906910,Patterson; Patrick H.,4,0,28,24
1746539660285,MMW 122R,A01,886429,Rahimi; Babak,0,13,28,28
1746539660285,MMW 122R,A02,886430,Rahimi; Babak,0,12,28,28
1746539660285,MMW 122R,A03,958040,Rahimi; Babak,0,11,28,28
1746539661320,MUS 1A,A01,890937,Staff,3,0,25,22
1746539661320,MUS 1A,A02,891035,Staff,6,0,25,19
1746539661320,MUS 1A,C01,958912,Staff,24,0,25,1
1746539661320,MUS 1A,C02,958913,Staff,25,0,25,0
1746539663373,MUS 2AK,A00,957092,Ohnishi; Takae,15,0,15,0
1746539664399,MUS 4,A01,891044,Staff,2,0,25,23
1746539664399,MUS 4,A02,891045,Staff,23,0,25,2
1746539664399,MUS 4,B01,891048,Staff,17,0,25,8
1746539664399,MUS 4,B02,891050,Staff,25,0,25,0
1746539665441,MUS 5,A01,957506,Dubnov; Shlomo,0,0,25,25
1746539665441,MUS 5,A02,957622,Dubnov; Shlomo,14,0,25,11
1746539665441,MUS 5,A03,957623,Dubnov; Shlomo,20,0,25,5
1746539666469,MUS 6,A01,891053,Freitas Caetano; Marcelo,24,0,25,1
1746539666469,MUS 6,A02,891054,Freitas Caetano; Marcelo,23,0,25,2
1746539667498,MUS 7,A01,891081,Staff,0,0,25,25
1746539667498,MUS 7,A02,891082,Staff,4,0,25,21
1746539668523,MUS 8GS,A00,891118,Borgo; David Garcia,0,0,25,25
1746539669554,MUS 11,A01,891140,Staff,11,0,25,14
1746539669554,MUS 11,A02,891141,Staff,22,0,25,3
1746539670580,MUS 13,A01,891143,Staff,8,0,25,17
1746539670580,MUS 13,A02,891144,Staff,24,0,25,1
1746539671611,MUS 15,A01,891146,Staff,9,0,25,16
1746539671611,MUS 15,A02,891148,Staff,21,0,25,4
1746539671611,MUS 15,B01,891150,Staff,18,0,25,7
1746539671611,MUS 15,B02,891151,Staff,25,0,25,0
1746539672637,MUS 20,A01,891153,Staff,5,0,20,15
1746539672637,MUS 20,A02,891155,Staff,14,0,20,6
1746539673664,MUS 80,A00,891156,Staff,19,0,25,6
1746539673664,MUS 80,B00,891157,Staff,23,0,25,2
1746539674691,MUS 130,A00,891158,Ohnishi; Takae,35,0,35,0
1746539675722,MUS 150GS,A01,891160,Borgo; David Garcia,0,0,25,25
1746539676751,MUS 170,A01,891162,Freitas Caetano; Marcelo,20,0,25,5
1746539676751,MUS 170,A02,891164,Freitas Caetano; Marcelo,21,0,25,4
1746539677786,NANO 11,A00,886220,Vazquez Mena; Oscar,13,0,15,2
1746539678814,NANO 15,A01,886222,Drews; Aaron,4,0,7,3
1746539679840,NANO 104,A00,886224,Sirbuly; Donald,18,0,25,7
1746539680871,PH 40,A00,886528,Staff,23,0,40,17
1746539681898,PH 45,A01,886799,Staff,35,0,40,5
1746539682924,PH 110,A00,886802,Staff,0,7,40,40
1746539683950,PH 172,A00,906716,Staff,19,0,35,16
1746539685012,PH 191,A00,886803,Staff,6,0,40,34
1746539686038,PHIL 1,A00,889500,Staff,19,0,30,11
1746539687066,PHIL 10,A01,889549,Grush; Rick Scott,15,0,22,7
1746539687066,PHIL 10,A02,889551,Grush; Rick Scott,22,0,22,0
1746539688096,PHIL 28,A01,889559,Lamey; Andy M.,0,1,31,31
1746539688096,PHIL 28,A02,889561,Lamey; Andy M.,0,1,30,30
1746539688096,PHIL 28,A03,889572,Lamey; Andy M.,0,0,30,30
1746539689128,PHIL 35,A00,907839,Staff,13,0,15,2
1746539690159,PHIL 60,A00,889574,Staff,74,0,90,16
1746539691184,PHIL 101,A00,958004,Staff,13,0,15,2
1746539693240,PHIL 136,A00,889582,Fulkerson; Matthew Todd,26,0,45,19
1746539694272,PHIL 163,A01,889601,Staff,21,0,30,9
1746539694272,PHIL 163,B01,889606,Brandt; Reuven A,0,3,0,0
1746539695302,PHIL 164,A00,889610,Staff,16,0,30,14
1746539696326,PHIL 165,A00,889613,Staff,23,0,30,7
1746539697353,PHYS 1A,A00,886431,Staff,26,0,70,44
1746539698378,PHYS 1AL,001,886432,Tsai; Philbert S,0,2,30,30
1746539698378,PHYS 1AL,002,886436,Tsai; Philbert S,11,0,30,19
1746539699405,PHYS 1B,A00,886439,Staff,185,0,240,55
1746539700435,PHYS 1BL,001,886441,Tsai; Philbert S,0,4,30,30
1746539700435,PHYS 1BL,002,886444,Tsai; Philbert S,2,0,30,28
1746539701463,PHYS 1C,A00,896092,Arnold; Kam S,78,0,146,68
1746539702495,PHYS 1CL,001,886448,Tsai; Philbert S,0,0,30,30
1746539702495,PHYS 1CL,002,886449,Tsai; Philbert S,0,0,30,30
1746539702495,PHYS 1CL,003,886450,Tsai; Philbert S,15,0,30,15
1746539702495,PHYS 1CL,004,886451,Tsai; Philbert S,15,0,30,15
1746539703529,PHYS 2B,A01,886457,Staff,69,0,115,46
1746539704561,PHYS 2C,A01,886460,Shotwell; Brian,0,8,65,65
1746539705585,PHYS 2CL,A01,886467,Staff,0,4,28,28
1746539705585,PHYS 2CL,A02,886468,Staff,0,3,28,28
1746539706613,PHYS 2D,A01,886470,Staff,10,0,50,40
1746539707640,PHYS 4B,A01,886475,Grinstein; Benjamin,22,0,40,18
1746539708671,POLI 5,A00,891173,Desposato; Scott,7,0,25,18
1746539709695,POLI 5D,A01,891175,Staff,5,0,5,0
1746539709695,POLI 5D,B01,891178,Staff,5,0,5,0
1746539710723,POLI 11,A00,891179,Ferree; Karen E,2,0,35,33
1746539711751,POLI 12,A00,891180,Staff,16,0,30,14
1746539712781,POLI 27,A01,891182,Staff,12,0,75,63
1746539713807,POLI 30,A00,891183,Staff,9,0,50,41
1746539714836,POLI 100B,A00,891244,Staff,5,1,35,30
1746539715902,POLI 100I,A00,891247,Staff,7,0,30,23
1746539716933,POLI 104J,A00,891248,Nichter; Maysa,14,0,30,16
1746539717961,POLI 104U,A00,891250,Nichter; Maysa,2,0,30,28
1746539720012,POLI 110B,A00,891255,Wiens; David,20,0,25,5
1746539721038,POLI 112A,A00,891256,Wiens; David,6,0,25,19
1746539722066,POLI 114BR,A00,891261,Staff,19,0,30,11
1746539723091,POLI 117R,A00,891262,Forman; Fonna,0,6,50,50
1746539724117,POLI 118,A00,891264,Ingham; Sean,17,0,25,8
1746539725141,POLI 124A,A00,891265,Staff,18,0,20,2
1746539726166,POLI 125D,A00,891266,Nichter; Simeon C,2,0,25,23
1746539727197,POLI 126,A00,891268,Nichter; Simeon C,7,0,25,18
1746539728224,POLI 126AA,A00,891272,Staff,18,0,25,7
1746539729249,POLI 130AA,A00,891273,Staff,15,0,20,5
1746539730277,POLI 134AA,A00,891274,Staff,4,0,20,16
1746539732328,POLI 138,A00,891278,Staff,21,0,25,4
1746539733358,POLI 142K,A00,891280,Staff,11,0,25,14
1746539734383,POLI 142M,A00,891281,Gartzke; Erik,17,0,30,13
1746539735409,POLI 142P,A00,891284,Staff,20,0,30,10
1746539736434,POLI 143,A00,891285,Gartzke; Erik,12,0,30,18
1746539737462,POLI 153,A00,891286,Staff,19,0,20,1
1746539739513,POLI 175,A00,891290,Staff,15,0,20,5
1746539740540,PSYC 1,A00,890674,Steiner; Eric Tomas,0,11,45,45
1746539741567,PSYC 2,A00,890676,Albright; Thomas D,21,0,35,14
1746539742592,PSYC 3,A00,890679,Staff,17,0,20,3
1746539743619,PSYC 6,A00,959858,Staff,20,0,20,0
1746539744647,PSYC 60,A01,890684,Rickard; Timothy C.,0,5,45,45
1746539745676,PSYC 70,A01,890689,Geller; Emma Harlan,7,0,30,23
1746539746702,PSYC 71,A01,959860,Staff,21,0,25,4
1746539747728,PSYC 100,A00,890690,Lacefield; Katharine I,0,50,180,180
1746539748754,PSYC 102,A00,890695,Staff,18,0,40,22
1746539749781,PSYC 105,A00,890699,Geller; Emma Harlan,71,0,100,29
1746539750811,PSYC 106,A00,890701,Gorman; Michael R.,5,0,30,25
1746539751838,PSYC 108,A00,890704,Adrian; Julia Anna,0,28,50,50
1746539752865,PSYC 118,A01,890712,Staff,11,0,30,19
1746539753898,PSYC 124,A00,890716,Chapman; Eddie Nathaniel,25,0,60,35
1746539754925,PSYC 131,A00,890717,Anagnostaras; Stephan,0,7,80,80
1746539755952,PSYC 137,A00,890719,Winkielman; Piotr,0,11,30,30
1746539756982,PSYC 144,A00,890721,Adrian; Julia Anna,0,9,45,45
1746539758008,PSYC 162,A00,890805,Staff,2,0,75,73
1746539759036,PSYC 169,A00,890810,Staff,0,15,30,30
1746539760063,PSYC 172,A00,890814,Gorman; Michael R.,9,0,30,21
1746539761090,PSYC 181,A00,890818,Anagnostaras; Stephan,8,0,200,192
1746539762116,PSYC 184,A00,959861,Staff,170,0,175,5
1746539763141,PSYC 189,A00,890823,Staff,0,1,30,30
1746539764169,PSYC 191,A00,890884,Rickard; Timothy C.,0,11,35,35
1746539765195,PSYC 193,A00,890913,Staff,19,0,30,11
1746539765195,PSYC 193,B00,890914,Chapman; Eddie Nathaniel,24,0,30,6
1746539766222,PSYC 193L,A01,890918,Lowe; Angela Beth,20,0,30,10
1746539766222,PSYC 193L,B01,890921,Hurwitz; Ethan Scott,20,0,30,10
1746539766222,PSYC 193L,C01,890928,Staff,30,0,30,0
1746539767253,RELI 149,A00,886806,Rahimi; Babak,23,0,40,17
1746539768278,SE 9,A01,886814,Staff,7,0,20,13
1746539769308,SE 101B,A01,886816,Chadha; Mayank,4,0,35,31
1746539770339,SE 110B,A00,886818,Zhu; Qiang,4,0,75,71
1746539771365,SE 125,A01,886830,Staff,10,0,30,20
1746539772407,SE 130B,A01,886835,Staff,14,0,40,26
1746539773434,SE 131A,A01,886838,Krysl; Petr,34,0,55,21
1746539774463,SE 154,A00,886840,Staff,30,0,50,20
1746539775490,SE 164GS,A01,886849,Staff,6,0,20,14
1746539776515,SE 167GS,A01,886853,Staff,6,0,20,14
1746539777546,SIO 25,A01,890107,Staff,19,0,30,11
1746539778578,SIO 45,A00,890109,Cook; Geoffrey W,117,0,200,83
1746539779604,SIO 109R,A00,890110,Forman; Fonna,0,16,20,20
1746539780629,SIO 187,A01,890114,Kacev; David,15,0,40,25
1746539781660,SOCI 1,A01,890431,Thorpe; Charles Robert,15,0,30,15
1746539781660,SOCI 1,A02,890518,Thorpe; Charles Robert,30,0,30,0
1746539782690,SOCI 2,A01,957978,Staff,25,0,25,0
1746539782690,SOCI 2,A02,957979,Staff,23,0,25,2
1746539783718,SOCI 20,A01,890523,Calderon-Zaks; Michael Aar,23,0,30,7
1746539783718,SOCI 20,A02,890526,Calderon-Zaks; Michael Aar,29,0,30,1
1746539784746,SOCI 30,A01,890533,Pardo Guerra; Juan Pablo,37,0,40,3
1746539785771,SOCI 40,A01,890535,Staff,27,0,45,18
1746539786796,SOCI 104Q,A00,890559,Staff,18,0,30,12
1746539787822,SOCI 106,A00,890560,Arnal; Maud Marie Leonie,20,0,30,10
1746539788850,SOCI 110,A00,890567,Holkenbrink-Monk; Charlene,19,0,30,11
1746539789874,SOCI 112,A00,890568,Victoria Torres; Pablo,1,0,55,54
1746539790900,SOCI 115,A00,890597,Arnal; Maud Marie Leonie,28,0,45,17
1746539792961,SOCI 121,A00,890604,Pardo Guerra; Juan Pablo,38,0,45,7
1746539793990,SOCI 126,A01,890608,Staff,8,0,10,2
1746539795018,SOCI 127,A00,890609,Staff,18,0,30,12
1746539796045,SOCI 131,A00,890610,Thorpe; Charles Robert,37,0,45,8
1746539797076,SOCI 135,A00,890615,Payne; Christine Anna,14,0,45,31
1746539798106,SOCI 139,A00,890620,Staff,38,0,45,7
1746539799132,SOCI 148E,A00,890622,Calderon-Zaks; Michael Aar,36,0,45,9
1746539800163,SOCI 150,A00,890623,Kohler; Kristopher M.,31,0,45,14
1746539801193,SOCI 157,A00,890625,Jules-Rosette; Bennetta W.,18,0,20,2
1746539802216,SOCI 160,A00,890627,Payne; Christine Anna,21,0,45,24
1746539803243,SYN 1,A00,886855,Fish; Gwendolyn Anne,0,0,0,0
1746539803243,SYN 1,B00,906086,Fish; Gwendolyn Anne,0,1,0,2
1746539804277,SYN 2R,A00,886860,Staff,0,17,15,15
1746539804277,SYN 2R,B00,906106,Atkinson; Arthur Laird,0,16,15,15
1746539805308,SYN 100,A01,886866,Browne; Emily,0,28,20,20
1746539805308,SYN 100,B01,906128,Rock; Martin,0,5,20,20
1746539805308,SYN 100,C01,906140,Deavenport; James Cary,0,3,20,20
1746539805308,SYN 100,D01,907816,Deavenport; James Cary,0,5,20,20
1746539806340,TDAC 1,A00,890286,Walsh; Kim C.,9,0,20,11
1746539807367,TDAC 101,A00,890296,Basso; Beatrice,16,0,20,4
1746539808396,TDDE 131,A00,890297,Staff,47,0,50,3
1746539809422,TDDM 1,A00,890287,Weinberg; Sadie,25,0,30,5
1746539810454,TDGE 11,A00,890288,Fulton; Julia,137,0,200,63
1746539810454,TDGE 11,B00,890289,Castro; Robert Jess,184,0,200,16
1746539811480,TDGE 25,B00,957359,Walsh; Kim C.,3,0,20,17
1746539812505,TDGE 40,A01,890292,Power; Jade Yukana,27,0,30,3
1746539813538,TDGE 124,A00,890298,Havis; Allan,0,0,50,50
1746539814568,TDGE 131R,A00,890299,Burelle; Julie Sara Veronique,15,0,42,27
1746539815592,TDHT 101,A00,890300,Staff,10,0,20,10
1746539816623,TDHT 109,A01,890302,Anderson; Mysia Anyse,31,0,40,9
1746539817652,TDMV 1,A00,890293,Arcidiacono; Kristin,18,0,30,12
1746539818681,TDMV 2,A00,890294,Weinberg; Sadie,23,0,30,7
1746539819746,TDMV 3,A00,957878,Arcidiacono; Kristin,28,0,30,2
1746539821798,TDMV 138,A00,890304,Jun; Grace Shin Hae,25,0,40,15
1746539822828,TDMV 140,A00,890305,Corrales; Joseph Bernales,25,0,30,5
1746539823857,TDMV 142,A00,890307,Caligagan; Tony,32,0,40,8
1746539824883,TDMV 144,A00,890308,Camaya; Michelle Ann,25,0,30,5
1746539825909,TDPW 1,A00,890295,Stein; Deborah Isobel,3,0,20,17
1746539826937,USP 2,A01,890272,Lerner; Amy M,6,0,20,14
1746539827963,USP 3,A01,890274,Staff,12,0,30,18
1746539828993,USP 15,A01,890276,Sun; Feiyang,17,0,30,13
1746539830024,USP 25,A00,890277,Shenkman; Michael Thomas,19,0,25,6
1746539831050,USP 138,A00,890278,Staff,13,0,25,12
1746539832077,USP 143,A00,890279,Staff,21,0,70,49
1746539833103,USP 144,A00,890280,Chowdhury; Muhammed Zohir,16,0,30,14
1746539834129,USP 150,A00,890281,Boomhower; Matthew Charles,4,0,30,26
1746539835158,USP 151,A00,890282,Staff,16,0,20,4
1746539836182,USP 162,A00,890283,Andrews; Abigail Leslie,16,0,20,4
1746539837211,USP 168,A00,920477,Kwak; Nancy,1,0,5,4
1746539838237,USP 181,A00,890284,Staff,3,0,20,17
1746539839266,USP 191A,A00,890285,Staff,13,0,20,7
1746539840293,VIS 101,A00,886512,Staff,25,0,75,50
1746539841323,VIS 103,A00,886513,Cruz; Edwin Teddy,61,0,75,14
1746539842349,VIS 108,A00,886514,Staff,3,0,15,12
1746539843380,VIS 127P,A00,886515,Shen; Kuiyi,80,0,146,66
1746539844407,VIS 149,A00,886516,Yoldas; Pinar,0,0,15,15
1746539845437,VIS 164,A00,886526,Erdmann; Dean,19,0,22,3
1746539846462,VIS 194S,A00,886527,Staff,61,0,75,14
1746539847490,WCWP 10A,C00,886484,Martiniuk; Jill,12,0,15,3
1746539848523,WCWP 10B,A00,886490,Uriarte; Emma,0,0,15,15
1746539848523,WCWP 10B,B00,886491,Dhir; Simrita,11,0,15,4
1746539848523,WCWP 10B,C00,886492,Ornelas; Tricia,0,0,15,15
1746539849556,WCWP 100,A00,886494,Young; Mark T,0,7,15,15
1746539851734,AAS 10,A01,886199,Childs; Dennis R.,0,3,0,0
1746539852767,ANAR 104,A01,886940,Shtienberg; Gilad,27,0,30,3
1746539853795,ANAR 120,A00,886953,Staff,12,0,20,8
1746539854826,ANBI 148,A01,886955,Wilder; Linnea Lorene,30,0,40,10
1746539856887,ANSC 122,A00,886957,Staff,25,0,30,5
1746539857919,ANSC 150,A00,886958,Sloane; Julia Kathryn,3,0,15,12
1746539858948,ANSC 156,A00,886959,Jenkins; Janis A.,0,1,15,15
1746539859974,ANSC 180,A00,886960,Staff,11,0,17,6
1746539861001,ANSC 188,A00,886961,Jassal; Aftab,9,0,25,16
1746539862029,ANSC 190,A00,886962,Jassal; Aftab,14,0,25,11
1746539863053,ANSC 191,A00,886963,Staff,18,0,20,2
1746539864081,ANTH 3,A01,891689,Staff,17,0,20,3
1746539865112,ANTH 5,A00,886933,Semendeferi; Ekaterini,16,0,20,4
1746539866139,ANTH 10,A00,886934,Staff,0,12,30,30
1746539867167,ANTH 21,A01,886936,Staff,40,0,60,20
1746539868193,ANTH 23,A01,886938,Staff,92,0,100,8
1746539869220,ANTH 105,A00,886964,Stewart; Alexander B,84,0,100,16
1746539870247,ANTH 108,A00,886965,Pedersen; David,9,0,20,11
1746539871276,AWP 10,001,886147,Staff,0,0,0,0
1746539871276,AWP 10,002,886148,Staff,0,0,0,0
1746539871276,AWP 10,003,886149,Staff,0,0,0,0
1746539871276,AWP 10,004,886150,Staff,0,0,0,0
1746539871276,AWP 10,005,886151,Staff,0,0,0,0
1746539871276,AWP 10,006,886152,Staff,0,0,0,0
1746539871276,AWP 10,007,886153,Staff,0,0,0,0
1746539871276,AWP 10,008,886154,Staff,0,0,0,0
1746539871276,AWP 10,009,886155,Staff,0,0,0,0
1746539871276,AWP 10,010,886156,Staff,0,0,0,0
1746539871276,AWP 10,011,886158,Staff,0,0,0,0
1746539871276,AWP 10,012,886160,Staff,0,0,0,0
1746539871276,AWP 10,013,886161,Staff,0,0,0,0
1746539871276,AWP 10,014,886162,Staff,0,0,0,0
1746539871276,AWP 10,015,886163,Staff,0,0,0,0
1746539871276,AWP 10,016,886164,Staff,0,0,0,0
1746539871276,AWP 10,017,886165,Staff,0,0,0,0
1746539871276,AWP 10,018,886166,Staff,0,0,0,0
1746539871276,AWP 10,019,886168,Staff,0,0,0,0
1746539871276,AWP 10,020,886170,Staff,0,0,0,0
1746539871276,AWP 10,021,886172,Staff,0,0,0,0
1746539872303,AWP 10R,001,886173,Staff,0,1,0,0
1746539872303,AWP 10R,002,886174,Staff,0,1,0,0
1746539872303,AWP 10R,003,886175,Staff,0,0,0,0
1746539872303,AWP 10R,004,886176,Staff,0,0,0,0
1746539872303,AWP 10R,005,886177,Staff,0,0,0,0
1746539872303,AWP 10R,006,886178,Staff,0,0,0,0
1746539872303,AWP 10R,007,886179,Staff,0,0,0,0
1746539872303,AWP 10R,008,886181,Staff,0,0,0,0
1746539872303,AWP 10R,009,886182,Staff,0,0,0,0
1746539872303,AWP 10R,010,886183,Staff,0,0,0,0
1746539872303,AWP 10R,011,886184,Staff,0,0,0,0
1746539872303,AWP 10R,012,886185,Staff,0,0,0,0
1746539872303,AWP 10R,013,886186,Staff,0,0,0,0
1746539872303,AWP 10R,014,886187,Staff,0,0,0,0
1746539872303,AWP 10R,015,886188,Staff,0,0,0,0
1746539872303,AWP 10R,016,886189,Staff,0,0,0,0
1746539873333,AWP 102R,A00,886190,Staff,0,0,0,0
1746539873333,AWP 102R,B00,886191,Staff,0,0,0,0
1746539874360,BENG 100,A01,886193,Staff,17,0,30,13
1746539875390,BENG 122A,A01,886195,Hasty; Jeff M,13,0,30,17
1746539876422,BENG 166A,A00,886196,Sah; Robert Lie-Yuan,0,1,30,30
1746539877452,BENG 190,A00,958050,Khojah; Reem I,24,0,25,1
1746539878480,BIBC 102,A01,894320,Staff,0,0,46,46
1746539878480,BIBC 102,A02,894321,Staff,1,0,46,45
1746539878480,BIBC 102,A03,894344,Staff,7,0,46,39
1746539878480,BIBC 102,A04,894345,Staff,26,0,47,21
1746539879509,BICD 100R,A01,894365,Smith; Laurie,0,3,58,58
1746539879509,BICD 100R,A02,894366,Smith; Laurie,0,5,58,58
1746539879509,BICD 100R,A03,894367,Smith; Laurie,2,0,59,57
1746539879509,BICD 100R,A04,959869,Smith; Laurie,41,0,59,18
1746539880536,BICD 136,A01,894383,Gustafson-Brown; Cindy,14,0,50,36
1746539881566,BIEB 102,A01,894494,Butler; Shannon Rhey,51,0,130,79
1746539883624,BIEB 150,A01,894617,Wills; Christopher,3,0,20,17
1746539883624,BIEB 150,A02,894631,Wills; Christopher,3,0,20,17
1746539883624,BIEB 150,A03,894937,Wills; Christopher,3,0,20,17
1746539883624,BIEB 150,A04,894946,Wills; Christopher,5,0,20,15
1746539884651,BIEB 194,A00,906141,Kurle; Carolyn M.,6,0,20,14
1746539885678,BILD 1,A01,894154,Staff,2,0,19,17
1746539885678,BILD 1,A02,894155,Staff,14,0,19,5
1746539885678,BILD 1,A03,894160,Staff,13,0,19,6
1746539885678,BILD 1,A04,894161,Staff,15,0,18,3
1746539886704,BILD 2,A01,894168,Staff,0,0,50,50
1746539886704,BILD 2,A02,894169,Staff,0,0,50,50
1746539886704,BILD 2,A03,894179,Staff,4,0,50,46
1746539886704,BILD 2,A04,894203,Staff,27,0,50,23
1746539887731,BILD 3,A01,894213,Staff,22,0,31,9
1746539887731,BILD 3,A02,894214,Staff,26,0,31,5
1746539887731,BILD 3,A03,894235,Staff,28,0,31,3
1746539887731,BILD 3,A04,894236,Staff,28,0,32,4
1746539888756,BILD 4,A01,894253,Reuther; Keefe,5,0,24,19
1746539888756,BILD 4,A02,894258,Reuther; Keefe,16,0,24,8
1746539889784,BILD 5,A01,894276,Reuther; Keefe,35,0,50,15
1746539889784,BILD 5,A02,894277,Reuther; Keefe,45,0,50,5
1746539889784,BILD 5,A03,894290,Reuther; Keefe,44,0,50,6
1746539889784,BILD 5,A04,894291,Reuther; Keefe,48,0,50,2
1746539890812,BILD 24,A01,894297,Pirino; Giorgia,40,0,60,20
1746539891841,BIMM 100,B01,958915,Staff,72,0,100,28
1746539892869,BIMM 101,A01,895017,McDonnell; Lisa Marie,0,5,24,24
1746539892869,BIMM 101,A02,895018,McDonnell; Lisa Marie,0,5,24,24
1746539892869,BIMM 101,B01,895020,McDonnell; Lisa Marie,0,6,24,24
1746539892869,BIMM 101,B02,895021,McDonnell; Lisa Marie,0,4,24,24
1746539893895,BIMM 110,A01,895023,Staff,1,0,25,24
1746539893895,BIMM 110,A02,895024,Staff,9,0,25,16
1746539893895,BIMM 110,A03,895025,Staff,18,0,25,7
1746539893895,BIMM 110,A04,895031,Staff,20,0,25,5
1746539894932,BIMM 120,A01,895114,Gustafson-Brown; Cindy,13,0,28,15
1746539894932,BIMM 120,A02,895126,Gustafson-Brown; Cindy,21,0,27,6
1746539895963,BIPN 100,A01,895130,Yang; Mingyu,1,0,38,37
1746539895963,BIPN 100,A02,895131,Yang; Mingyu,32,0,38,6
1746539895963,BIPN 100,A03,895132,Yang; Mingyu,32,0,38,6
1746539895963,BIPN 100,A04,895133,Yang; Mingyu,27,0,36,9
1746539896995,BIPN 120,A01,895135,Cooke; James Edward,0,3,13,13
1746539896995,BIPN 120,A02,895136,Cooke; James Edward,0,1,13,13
1746539896995,BIPN 120,A03,895137,Cooke; James Edward,0,3,13,13
1746539896995,BIPN 120,A04,895156,Cooke; James Edward,0,2,11,11
1746539898022,BIPN 134,A01,895235,Cooke; James Edward,0,2,25,25
1746539898022,BIPN 134,A02,895237,Cooke; James Edward,0,0,25,25
1746539898022,BIPN 134,A03,895240,Cooke; James Edward,3,0,25,22
1746539898022,BIPN 134,A04,895270,Cooke; James Edward,20,0,25,5
1746539899048,BIPN 189,A00,892103,Staff,0,13,14,14
1746539901107,BISP 194,A00,958008,Staff,0,2,0,0
1746539902137,CAT 124,A01,922009,Staff,0,5,20,20
1746539903172,CAT 125R,A00,886390,Morales; Celeste Georgianna,0,2,20,20
1746539903172,CAT 125R,B00,886391,Irwin; Matthew Joseph,0,3,20,20
1746539903172,CAT 125R,C00,886392,Smith; Lauryn Alissa,0,2,20,20
1746539903172,CAT 125R,D00,886393,Vanderschuit; Maya Alysia,0,2,20,20
1746539903172,CAT 125R,E00,886394,Marchisotto; Jennifer Anne,0,4,20,20
1746539904199,CENG 15,A01,886218,Drews; Aaron,3,0,8,5
1746539905230,CENG 113,A00,886219,Opatkiewicz; Justin Paul,15,0,25,10
1746539906257,CGS 101,A00,887044,Staff,7,0,20,13
1746539907286,CGS 105,A01,887046,Staff,14,0,25,11
1746539908312,CGS 112,A00,887047,Cuong; Marisol,12,0,15,3
1746539909341,CGS 113,A00,887048,Staff,23,0,30,7
1746539910368,CGS 120,A00,887049,Staff,10,0,17,7
1746539911394,CHEM 6A,A01,886336,Lam; Tin Yiu,38,0,50,12
1746539911394,CHEM 6A,A02,886338,Lam; Tin Yiu,37,0,50,13
1746539912424,CHEM 6B,A01,886341,Hopkins; Patrycja Anna,16,0,50,34
1746539912424,CHEM 6B,A02,886343,Hopkins; Patrycja Anna,42,0,50,8
1746539913450,CHEM 6C,A01,886346,Albizati; Kim F.,0,2,50,50
1746539913450,CHEM 6C,A02,886348,Albizati; Kim F.,23,0,50,27
1746539914483,CHEM 40A,A01,886352,Klosterman; Jeremy K,65,0,100,35
1746539915513,CHEM 40B,A01,886356,Klosterman; Jeremy K,0,23,100,100
1746539916540,CHEM 41B,A01,886360,Theodorakis; Emmanuel,25,0,50,25
1746539916540,CHEM 41B,A02,886362,Theodorakis; Emmanuel,47,0,50,3
1746539917566,CHIN 165A,A00,886382,Xu; Li,18,0,20,2
1746539918597,CLAS 120,A00,886387,Myerston Santana; Jacobo,33,0,40,7
1746539919625,COGS 9,A01,886967,Shannon; Kyle Michael,42,0,60,18
1746539920653,COGS 11,A01,886969,Staff,11,0,30,19
1746539921682,COGS 14A,A01,886971,Staff,6,0,60,54
1746539922713,COGS 14B,A01,886973,Hoffman; Drew Ellen,4,0,60,56
1746539923780,COGS 18,A01,886975,Morgan; Eric,35,0,60,25
1746539924808,COGS 20,A01,886977,Staff,4,0,8,4
1746539924808,COGS 20,A02,886978,Staff,5,0,7,2
1746539925838,COGS 100,A01,907783,Staff,0,2,30,30
1746539926864,COGS 101B,A01,886980,Staff,0,3,48,48
1746539927908,COGS 101C,A01,886982,Delgado; Tania,0,5,44,44
1746539928934,COGS 102A,A01,886984,Johnson; Christine M.,4,0,30,26
1746539929962,COGS 118B,A01,886986,Staff,0,3,88,88
1746539930988,COGS 150,A01,886988,Bergen; Benjamin,23,0,50,27
1746539932015,COGS 153,A00,886989,Delgado; Tania,0,2,41,41
1746539933045,COGS 186,A01,886991,Staff,0,0,32,32
1746539934075,COGS 187A,A01,886993,Boyle; Mary E. T.,7,0,30,23
1746539935100,COGS 189,A00,886994,Staff,0,1,30,30
1746539936126,COMM 10,A01,886996,Staff,0,0,20,21
1746539936126,COMM 10,A02,886997,Staff,12,0,20,8
1746539936126,COMM 10,A03,959845,Staff,19,0,20,1
1746539937158,COMM 20,A01,886999,Leuning; Grant Maurstad,24,0,40,16
1746539939213,COMM 100A,A01,887002,Staff,0,0,20,25
1746539939213,COMM 100A,A02,887003,Staff,7,0,20,13
1746539940243,COMM 100B,A01,887005,Staff,0,8,20,24
1746539941273,COMM 106D,A00,887006,Staff,14,0,40,26
1746539942300,COMM 110G,A00,887007,Whitworth-Smith; Andrew C,12,0,40,28
1746539943328,COMM 111B,A00,887008,Staff,31,0,40,9
1746539944355,COMM 113T,A00,887009,Abuelhiga; Soraya Jill,28,0,40,12
1746539944355,COMM 113T,B00,906733,Staff,40,0,40,0
1746539945379,COMM 145,A00,887010,Staff,12,0,40,28
1746539946407,COMM 146,A00,887054,Staff,31,0,40,9
1746539947437,COMM 190,A00,887012,Staff,8,0,23,15
1746539948464,CSE 8A,A50,887015,Cao; Yingjun,57,0,85,28
1746539949491,CSE 11,A01,887017,Cao; Yingjun,12,0,70,58
1746539950518,CSE 20,A01,887019,Staff,30,0,50,20
1746539951550,CSE 21,A01,887021,Staff,78,0,100,22
1746539951550,CSE 21,B01,892583,Braun; Oliver,45,0,50,5
1746539952577,CSE 30,A01,887025,Eldon; John,143,0,200,57
1746539953605,CSE 100,A01,887027,Staff,26,0,50,24
1746539953605,CSE 100,A02,887028,Staff,40,0,50,10
1746539954636,CSE 101,A01,887030,Braun; Oliver,75,0,100,25
1746539954636,CSE 101,B01,887032,Jones; Miles E,0,3,50,50
1746539954636,CSE 101,B02,887033,Jones; Miles E,0,1,50,50
1746539955667,CSE 105,A01,908084,Jones; Miles E,32,0,50,18
1746539955667,CSE 105,A02,908087,Jones; Miles E,33,0,50,17
1746539956694,CSE 135,A01,887035,Powell; Thomas Allan,0,4,50,50
1746539957721,CSE 142,A01,887037,Staff,8,0,60,52
1746539958750,CSE 142L,A01,887039,Staff,34,0,60,26
1746539959783,CSE 151A,A01,887041,Solares; Edwin A,48,0,100,52
1746539960814,CSE 175,A01,887043,Kumar; Rakesh,30,0,30,0
1746539961840,CSS 1,A01,886389,Staff,0,1,40,40
1746539962866,DSC 30,A01,908097,Liao; Soohyun Nam,47,0,75,28
1746539963895,DSC 40A,A01,908099,Shannon; Kyle Michael,30,0,50,20
1746539964920,DSC 40B,A01,908112,Staff,16,0,50,34
1746539965951,DSC 80,A01,908116,Staff,19,0,60,41
1746539966981,DSC 197,001,956863,Eldridge; Justin Matthew,9999,0,9999,0
1746539968008,ECE 5,A01,886400,Morris; Karcher William,2,0,6,4
1746539968008,ECE 5,A02,886401,Morris; Karcher William,3,0,6,3
1746539969037,ECE 148,A01,886403,Silberman; Jack,0,14,14,14
1746539970070,ECON 1,A01,887265,Crane; Meredith Helen,12,0,70,58
1746539970070,ECON 1,B01,887268,Staff,43,0,50,7
1746539971101,ECON 2,A01,887273,Crane; Meredith Helen,56,0,70,14
1746539972132,ECON 3,A01,887279,Rondina; Giacomo,32,0,70,38
1746539973162,ECON 4,A01,887282,Anderson; John Charles,0,2,10,10
1746539974189,ECON 5,A01,887285,Staff,33,0,45,12
1746539974189,ECON 5,B01,887292,Staff,41,0,45,4
1746539975218,ECON 100A,A01,887337,Newhouse; Herbert S,54,0,70,16
1746539975218,ECON 100A,B01,887349,Staff,45,0,50,5
1746539976247,ECON 100B,A01,887361,Du; Songzi,29,0,70,41
1746539977274,ECON 100C,A01,887445,Newhouse; Herbert S,59,0,70,11
1746539978303,ECON 105,A00,887488,Vespa; Emanuel Ignacio,23,0,35,12
1746539979330,ECON 109,A01,887506,Shishkin; Denis,28,0,35,7
1746539980363,ECON 110A,A01,887568,Alon; Titan Michael,0,3,35,35
1746539980363,ECON 110A,B01,907601,Alon; Titan Michael,20,0,35,15
1746539981389,ECON 110B,A01,887598,Levkoff; Steven B.,0,23,70,70
1746539982425,ECON 112,A00,887599,Rondina; Giacomo,19,0,35,16
1746539983454,ECON 120A,A01,887603,Dai; Yinlin,36,0,70,34
1746539984483,ECON 120C,A01,887608,Sun; Yixiao,0,1,35,35
1746539984483,ECON 120C,B01,887614,Sun; Yixiao,0,0,35,35
1746539985508,ECON 138,A00,887621,Bharadwaj; Prashant,0,20,20,20
1746539986539,ECON 144,A00,958007,Squires; Dale E,13,0,35,22
1746539987565,ECON 171,A01,907666,Staff,18,0,35,17
1746539988592,ECON 175,A00,887626,Wu; Pak Yeung,23,0,35,12
1746539989623,ECON 190,A00,887640,Vespa; Emanuel Ignacio,23,0,35,12
1746539990655,EDS 25,A01,888197,Staff,0,0,0,0
1746539990655,EDS 25,A02,888209,Staff,0,0,0,0
1746539990655,EDS 25,A03,888210,Staff,0,0,0,0
1746539990655,EDS 25,A04,888212,Staff,0,0,0,0
1746539990655,EDS 25,A05,888213,Staff,0,0,0,0
1746539990655,EDS 25,A06,888214,Staff,0,0,0,0
1746539990655,EDS 25,A07,888235,Staff,0,2,0,0
1746539990655,EDS 25,A08,888236,Staff,0,0,0,0
1746539990655,EDS 25,A09,888240,Staff,0,0,0,0
1746539990655,EDS 25,A10,888244,Staff,0,0,0,0
1746539990655,EDS 25,B01,888273,Staff,0,0,0,0
1746539990655,EDS 25,B02,888285,Staff,0,0,0,0
1746539990655,EDS 25,B03,888423,Staff,0,0,0,1
1746539990655,EDS 25,B04,888432,Staff,0,0,0,0
1746539990655,EDS 25,B05,888433,Staff,0,0,0,0
1746539990655,EDS 25,B06,888467,Staff,0,0,0,0
1746539990655,EDS 25,B07,888468,Staff,0,0,0,0
1746539990655,EDS 25,B08,888479,Staff,0,0,0,0
1746539990655,EDS 25,B09,888484,Staff,0,0,0,0
1746539990655,EDS 25,B10,888487,Staff,0,0,0,0
1746539991681,EDS 38,A01,907700,Choi; Bailey Miyeon,30,0,30,0
1746539992709,EDS 112,A01,888601,Chapman; Thandeka K,14,0,40,26
1746539993740,EDS 115,A00,888697,Mendez; Kathrina Mendoza,10,0,30,20
1746539994767,EDS 116,A01,888893,Staff,35,0,40,5
1746539996820,EDS 124AR,A00,889133,Staff,29,0,50,21
1746539996820,EDS 124AR,B00,907471,Simon; Elizabeth A,37,0,50,13
1746539997851,EDS 124BR,A00,889134,Simon; Elizabeth A,45,0,100,55
1746539998880,EDS 125,A00,889135,Staff,25,0,30,5
1746539999908,EDS 126,A01,889138,Staff,36,0,40,4
1746540000934,EDS 164R,A01,889142,Wishard Guerra; Alison G.,33,0,50,17
1746540001962,ENG 30,A01,886396,Staff,0,0,0,0
1746540001962,ENG 30,B01,886398,Staff,0,0,0,0
1746540002988,ENVR 102,A00,906150,Montejo; Carolina,23,0,25,2
1746540004014,ETHN 103A,A00,887236,Man; Simeon S,0,3,0,0
1746540005040,ETHN 113,A00,887239,Staff,16,0,30,14
1746540006068,ETHN 116,A00,887240,Staff,16,0,25,9
1746540007097,ETHN 117,A00,887241,Choi; Esther Min,28,0,30,2
1746540008125,ETHN 118,A00,887243,Staff,24,0,30,6
1746540009151,ETHN 127,A00,887248,Cuong; Marisol,11,0,15,4
1746540010177,ETHN 139,A00,887250,Staff,7,0,10,3
1746540011205,ETHN 142,A00,887252,Staff,10,0,30,20
1746540012236,ETHN 161,A00,887253,Browne; Errol Tsekani,24,0,30,6
1746540013261,ETHN 163FR,A00,887255,Burelle; Julie Sara Veronique,0,0,5,5
1746540014287,GLBH 20,A00,889149,Elwardani; Nile Regina,8,0,42,34
1746540016339,GLBH 111,A01,889152,Burgos; Jose L.,17,0,17,0
1746540017368,GLBH 150,A00,889181,Sloane; Julia Kathryn,0,5,15,15
1746540019421,HDS 60,A01,886406,Warstadt; Melissa Fawn,73,0,80,7
1746540020450,HIAF 111,A00,889324,Gyamfi; Bright,25,0,32,7
1746540021476,HIEA 131,A00,889328,Staff,16,0,32,16
1746540022501,HIEA 144,A00,889333,Henry; Todd A.,26,0,32,6
1746540023526,HIEA 154,A00,889336,Henry; Todd A.,24,0,32,8
1746540024554,HIEU 106,A00,889339,Staff,22,0,32,10
1746540026612,HIEU 114,A00,889340,Staff,3,0,32,29
1746540027676,HIEU 135GS,A00,889342,Patterson; Patrick H.,0,0,1,24
1746540028703,HIEU 137,A00,889343,Edington; Claire Ellen,9,0,25,16
1746540029731,HIEU 148,A00,889345,Staff,14,0,32,18
1746540030759,HIEU 154,A00,889346,Biess; Frank Peter,21,0,32,11
1746540031787,HILA 102,A00,889351,Staff,12,0,32,20
1746540032814,HILD 2A,A01,889221,Lewandoski; Julia Mavis,1,10,32,31
1746540033840,HILD 7B,A01,889225,Man; Simeon S,0,13,32,32
1746540034866,HILD 7C,A01,889288,Alvarez; Luis A,0,14,32,32
1746540035893,HILD 30,A01,889323,Staff,0,5,32,32
1746540037952,HISC 119,A00,889383,Golan; Tal,21,0,32,11
1746540038983,HIUS 103,A00,889384,Man; Simeon S,0,0,32,32
1746540040013,HIUS 117,A00,919797,Kwak; Nancy,18,0,32,14
1746540041042,HIUS 142A,A00,919788,Staff,22,0,32,10
1746540043096,HIUS 149,A00,889386,Gyamfi; Bright,27,0,32,5
1746540044122,HIUS 155,A00,889387,Alvarez; Luis A,14,0,32,18
1746540045151,HUM 3,A01,886499,Caldwell; Michael Alan,19,0,50,31
1746540046178,HUM 3GS,A00,886500,Rodriguez; Bretton Sigfred,0,0,0,28
1746540047205,HUM 3R,A01,886502,Markman; Kristina,0,36,50,50
1746540048233,HUM 4,A01,886504,Crum; Matthew Stephen,24,0,50,26
1746540048233,HUM 4,B01,886506,West; Geoffrey Scott,17,0,50,33
1746540049260,HUM 4GS,A00,886507,Staff,0,0,0,19
1746540050291,HUM 5,A01,886509,Staff,32,0,50,18
1746540051317,HUM 5R,A01,886511,Zavodny; Tatiana Sophia,0,39,50,50
1746540052349,JAPN 180,A00,886407,Staff,18,0,40,22
1746540053380,LATI 50,A01,886409,Martin-Cabrera; Luis,4,0,22,18
1746540053380,LATI 50,A02,886410,Martin-Cabrera; Luis,19,0,22,3
1746540053380,LATI 50,A03,886411,Martin-Cabrera; Luis,21,0,22,1
1746540053380,LATI 50,A04,886412,Martin-Cabrera; Luis,9,0,22,13
1746540054407,LAWS 101,A00,907664,Staff,28,0,60,32
1746540055432,LIAB 1A,A00,889388,Saab; Dima,17,0,20,3
1746540056464,LIAB 1AX,A00,889389,El Cheddadi; Youniss,17,0,20,3
1746540057490,LIFR 1C,A00,889391,Van Moer; Vinciane G,8,0,20,12
1746540058517,LIFR 1CX,A00,889392,Van Moer; Vinciane G,7,0,20,13
1746540059547,LIFR 1D,A00,889393,Van Moer; Vinciane G,7,0,20,13
1746540060618,LIFR 1DX,A00,889394,Van Moer; Vinciane G,8,0,20,12
1746540061653,LIGN 7,A00,886923,Staff,24,0,50,26
1746540062681,LIGN 17,A00,886924,Kehler; Andrew Scott,125,0,150,25
1746540063711,LTAM 110,A00,889395,Staff,15,0,30,15
1746540064737,LTAM 110GS,A00,958010,Rodriguez; Bretton Sigfred,0,0,0,28
1746540065762,LTCH 101,A00,889397,Staff,23,0,25,2
1746540066788,LTCS 130,A00,889398,Staff,23,0,25,2
1746540067818,LTEA 138,A00,889399,Staff,24,0,40,16
1746540068848,LTEN 149,A00,889400,Wesling; Megan E.,0,3,25,25
1746540069877,LTEN 169,A00,889401,Staff,20,0,25,5
1746540070904,LTEN 180,A00,889402,Staff,10,0,15,5
1746540071930,LTEN 181,A00,889403,Staff,21,0,25,4
1746540072954,LTWL 100,A00,889404,Myerston Santana; Jacobo,3,0,25,22
1746540073979,LTWL 180GS,A00,889405,Staff,0,0,20,20
1746540075007,LTWL 181,A00,889406,Staff,17,0,25,8
1746540076042,LTWL 184,A00,889475,Mukherjee; Silpa,22,0,25,3
1746540077073,LTWR 102C,A00,889486,Staff,29,0,30,1
1746540078102,LTWR 115W,A00,889491,Staff,0,2,15,15
1746540079129,MAE 8,A01,886905,Staff,0,2,0,0
1746540080157,MAE 11,A00,886906,Bandaru; Prabhakar,0,7,50,50
1746540081186,MAE 20,A00,886907,Evdokimenko; Ekaterina,44,0,70,26
1746540082212,MAE 30B,A00,886909,Ghazinejad; Maziar,26,0,45,19
1746540083241,MAE 101B,A00,886910,Saintillan; David,29,0,45,16
1746540084268,MAE 105,A00,886911,Bandaru; Prabhakar,18,0,50,32
1746540085294,MAE 107,B00,958024,Staff,9,0,50,41
1746540086319,MAE 143B,A00,886913,Bewley; Thomas R,7,0,40,33
1746540087346,MAE 148,A01,886915,Silberman; Jack,0,3,14,14
1746540088370,MAE 160,A00,886916,Evdokimenko; Ekaterina,31,0,60,29
1746540089402,MATH 3C,A01,889681,Staff,0,3,30,30
1746540089402,MATH 3C,A02,960048,Staff,25,0,30,5
1746540090426,MATH 10A,A01,889760,Staff,26,0,30,4
1746540090426,MATH 10A,A02,889783,Staff,29,0,30,1
1746540091459,MATH 10B,A01,889785,Verstraete; Jacques Allan,2,0,35,33
1746540091459,MATH 10B,A02,889795,Verstraete; Jacques Allan,4,0,35,31
1746540091459,MATH 10B,B01,889797,Verstraete; Jacques Allan,3,0,35,32
1746540091459,MATH 10B,B02,889828,Verstraete; Jacques Allan,3,0,35,32
1746540092495,MATH 10C,A01,889849,Habib; Yousaf,9,0,30,21
1746540092495,MATH 10C,A02,889852,Habib; Yousaf,14,0,30,16
1746540092495,MATH 10C,A03,889853,Habib; Yousaf,22,0,30,8
1746540092495,MATH 10C,A04,889858,Habib; Yousaf,20,0,30,10
1746540092495,MATH 10C,B01,889861,Staff,1,0,30,29
1746540092495,MATH 10C,B02,889862,Staff,24,0,30,6
1746540092495,MATH 10C,B03,889863,Staff,27,0,30,3
1746540092495,MATH 10C,B04,889967,Staff,23,0,30,7
1746540093521,MATH 18,A01,889974,Staff,7,0,30,23
1746540093521,MATH 18,A02,889977,Staff,20,0,30,10
1746540093521,MATH 18,B01,889984,Hardiman; Liam,22,0,30,8
1746540093521,MATH 18,B02,889985,Hardiman; Liam,25,0,30,5
1746540094551,MATH 20A,A01,889990,Suk; Andrew Hoon,29,0,35,6
1746540095577,MATH 20B,A01,889993,Ohm; Ko Woon,22,0,30,8
1746540095577,MATH 20B,A02,889994,Ohm; Ko Woon,30,0,30,0
1746540095577,MATH 20B,B01,889996,Ohm; Ko Woon,21,0,30,9
1746540095577,MATH 20B,B02,889997,Ohm; Ko Woon,23,0,30,7
1746540096608,MATH 20C,A01,889999,Hammock; Frances H,17,0,30,13
1746540096608,MATH 20C,A02,890003,Hammock; Frances H,23,0,30,7
1746540096608,MATH 20C,B01,890006,Hammock; Frances H,3,0,30,27
1746540096608,MATH 20C,B02,890007,Hammock; Frances H,11,0,30,19
1746540097634,MATH 20D,A01,890011,Cheng; Hsiao-Bing,1,1,30,29
1746540097634,MATH 20D,A02,890012,Cheng; Hsiao-Bing,14,0,30,16
1746540097634,MATH 20D,B01,890016,Cheng; Hsiao-Bing,13,0,30,17
1746540097634,MATH 20D,B02,890017,Cheng; Hsiao-Bing,13,0,30,17
1746540098662,MATH 20E,A01,890026,Harel; Guershon,1,0,30,29
1746540098662,MATH 20E,A02,890029,Harel; Guershon,23,0,30,7
1746540098662,MATH 20E,B01,890033,Harel; Guershon,7,0,30,23
1746540098662,MATH 20E,B02,890101,Harel; Guershon,21,0,30,9
1746540099691,MATH 102,A01,890104,Staff,17,0,30,13
1746540099691,MATH 102,A02,890105,Staff,27,0,30,3
1746540100719,MATH 103B,A01,890116,Salehi Golsefidy; Alireza,3,0,30,27
1746540100719,MATH 103B,B01,890118,Staff,0,3,34,34
1746540101749,MATH 109,A01,890121,Aliabadi Sr.; Mohsen,1,0,30,29
1746540101749,MATH 109,B01,890124,Upadrashta; Pranav Kumar,18,0,30,12
1746540102779,MATH 120A,A01,890126,Eggers; John Dietrich,13,0,30,17
1746540103806,MATH 142B,A01,890128,Ioana; Adrian,19,0,30,11
1746540103806,MATH 142B,A02,890129,Ioana; Adrian,13,0,30,17
1746540104834,MATH 154,A01,890174,Staff,0,0,30,30
1746540104834,MATH 154,A02,890182,Staff,0,0,30,30
1746540105861,MATH 168A,A01,890197,Dumitriu; Ioana,21,0,35,14
1746540106890,MATH 170A,A01,890240,Nie; Jiawang,1,0,30,29
1746540106890,MATH 170A,A02,890241,Nie; Jiawang,11,0,30,19
1746540106890,MATH 170A,A03,890249,Nie; Jiawang,23,0,30,7
1746540107936,MATH 170B,A01,957891,Nag; Panchali,13,0,35,22
1746540109993,MATH 181A,A01,908025,Staff,0,4,35,35
1746540109993,MATH 181A,A02,960115,Staff,27,0,35,8
1746540111023,MATH 181B,A01,959874,Staff,26,0,30,4
1746540112049,MATH 193B,A01,890265,Staff,0,4,35,35
1746540113078,MGT 4,A01,890311,Anderson; John Charles,42,0,88,46
1746540114108,MGT 5,A00,907740,Staff,13,0,98,85
1746540115133,MGT 12,A00,890312,Lindenberger; Wade Douglas,67,0,98,31
1746540116158,MGT 16,A00,957883,Staff,78,0,98,20
1746540118209,MGT 45,A00,890314,Pecore; Joseph P.,47,0,98,51
1746540119237,MGT 71,A00,890315,Staff,0,11,98,98
1746540120264,MGT 100,A00,890316,Yavorsky; Daniel Ryan,44,0,98,54
1746540121288,MGT 103,A00,890317,Ehrich; Kristine R,73,0,98,25
1746540122314,MGT 105,A00,890356,Bates; Kenneth Walter,0,7,98,98
1746540123341,MGT 112,A00,890360,Ehrich; Kristine R,55,0,98,43
1746540124369,MGT 127R,A00,907732,Zhu; Kevin Xiaoguo,23,0,98,75
1746540125397,MGT 131B,A00,890361,Anderson; John Charles,61,0,98,37
1746540126422,MGT 137,A00,890362,Lindenberger; Wade Douglas,65,0,98,33
1746540127448,MGT 160,A00,890369,Johnson; Erik Barry,9,0,98,89
1746540129498,MGT 164,A00,890372,Zimmermann; Carsten,0,39,98,98
1746540130523,MGT 180,A00,890374,Bliss; Barbara Ann,12,0,98,86
1746540131597,MMW 15,A01,886414,Chang; Edmond Yi-Teh,0,12,28,28
1746540131597,MMW 15,A02,886415,Chang; Edmond Yi-Teh,0,8,28,28
1746540131597,MMW 15,A03,886416,Chang; Edmond Yi-Teh,0,8,28,28
1746540131597,MMW 15,A04,886417,Chang; Edmond Yi-Teh,0,8,28,28
1746540131597,MMW 15,B01,886419,Chang; Edmond Yi-Teh,0,7,28,28
1746540131597,MMW 15,B02,886420,Chang; Edmond Yi-Teh,0,8,28,28
1746540131597,MMW 15,B03,886421,Chang; Edmond Yi-Teh,0,7,28,28
1746540131597,MMW 15,B04,886422,Chang; Edmond Yi-Teh,0,8,28,28
1746540131597,MMW 15,C01,886424,Staff,0,9,28,28
1746540131597,MMW 15,C02,886425,Staff,0,8,28,28
1746540131597,MMW 15,C03,886426,Staff,0,8,28,28
1746540131597,MMW 15,C04,886427,Staff,0,7,28,28
1746540131597,MMW 15,C05,958038,Staff,0,7,28,28
1746540131597,MMW 15,C06,958039,Staff,0,8,28,28
1746540132627,MMW 15GS,A00,906910,Patterson; Patrick H.,4,0,28,24
1746540133653,MMW 122R,A01,886429,Rahimi; Babak,0,13,28,28
1746540133653,MMW 122R,A02,886430,Rahimi; Babak,0,12,28,28
1746540133653,MMW 122R,A03,958040,Rahimi; Babak,0,11,28,28
1746540134685,MUS 1A,A01,890937,Staff,3,0,25,22
1746540134685,MUS 1A,A02,891035,Staff,6,0,25,19
1746540134685,MUS 1A,C01,958912,Staff,24,0,25,1
1746540134685,MUS 1A,C02,958913,Staff,25,0,25,0
1746540136738,MUS 2AK,A00,957092,Ohnishi; Takae,15,0,15,0
1746540137765,MUS 4,A01,891044,Staff,2,0,25,23
1746540137765,MUS 4,A02,891045,Staff,23,0,25,2
1746540137765,MUS 4,B01,891048,Staff,17,0,25,8
1746540137765,MUS 4,B02,891050,Staff,25,0,25,0
1746540138794,MUS 5,A01,957506,Dubnov; Shlomo,0,0,25,25
1746540138794,MUS 5,A02,957622,Dubnov; Shlomo,14,0,25,11
1746540138794,MUS 5,A03,957623,Dubnov; Shlomo,20,0,25,5
1746540139820,MUS 6,A01,891053,Freitas Caetano; Marcelo,24,0,25,1
1746540139820,MUS 6,A02,891054,Freitas Caetano; Marcelo,23,0,25,2
1746540140851,MUS 7,A01,891081,Staff,0,0,25,25
1746540140851,MUS 7,A02,891082,Staff,4,0,25,21
1746540141881,MUS 8GS,A00,891118,Borgo; David Garcia,0,0,25,25
1746540142909,MUS 11,A01,891140,Staff,11,0,25,14
1746540142909,MUS 11,A02,891141,Staff,22,0,25,3
1746540143940,MUS 13,A01,891143,Staff,8,0,25,17
1746540143940,MUS 13,A02,891144,Staff,24,0,25,1
1746540144967,MUS 15,A01,891146,Staff,9,0,25,16
1746540144967,MUS 15,A02,891148,Staff,21,0,25,4
1746540144967,MUS 15,B01,891150,Staff,18,0,25,7
1746540144967,MUS 15,B02,891151,Staff,25,0,25,0
1746540145992,MUS 20,A01,891153,Staff,5,0,20,15
1746540145992,MUS 20,A02,891155,Staff,14,0,20,6
1746540147022,MUS 80,A00,891156,Staff,19,0,25,6
1746540147022,MUS 80,B00,891157,Staff,23,0,25,2
1746540148050,MUS 130,A00,891158,Ohnishi; Takae,35,0,35,0
1746540149075,MUS 150GS,A01,891160,Borgo; David Garcia,0,0,25,25
1746540150101,MUS 170,A01,891162,Freitas Caetano; Marcelo,20,0,25,5
1746540150101,MUS 170,A02,891164,Freitas Caetano; Marcelo,21,0,25,4
1746540151132,NANO 11,A00,886220,Vazquez Mena; Oscar,13,0,15,2
1746540152159,NANO 15,A01,886222,Drews; Aaron,4,0,7,3
1746540153189,NANO 104,A00,886224,Sirbuly; Donald,18,0,25,7
1746540154218,PH 40,A00,886528,Staff,23,0,40,17
1746540155243,PH 45,A01,886799,Staff,35,0,40,5
1746540156271,PH 110,A00,886802,Staff,0,7,40,40
1746540157301,PH 172,A00,906716,Staff,19,0,35,16
1746540158327,PH 191,A00,886803,Staff,6,0,40,34
1746540159353,PHIL 1,A00,889500,Staff,19,0,30,11
1746540160385,PHIL 10,A01,889549,Grush; Rick Scott,15,0,22,7
1746540160385,PHIL 10,A02,889551,Grush; Rick Scott,22,0,22,0
1746540161413,PHIL 28,A01,889559,Lamey; Andy M.,0,1,31,31
1746540161413,PHIL 28,A02,889561,Lamey; Andy M.,0,1,30,30
1746540161413,PHIL 28,A03,889572,Lamey; Andy M.,0,0,30,30
1746540162438,PHIL 35,A00,907839,Staff,13,0,15,2
1746540163465,PHIL 60,A00,889574,Staff,74,0,90,16
1746540164493,PHIL 101,A00,958004,Staff,13,0,15,2
1746540166552,PHIL 136,A00,889582,Fulkerson; Matthew Todd,26,0,45,19
1746540167582,PHIL 163,A01,889601,Staff,21,0,30,9
1746540167582,PHIL 163,B01,889606,Brandt; Reuven A,0,3,0,0
1746540168607,PHIL 164,A00,889610,Staff,16,0,30,14
1746540169633,PHIL 165,A00,889613,Staff,23,0,30,7
1746540170658,PHYS 1A,A00,886431,Staff,26,0,70,44
1746540171684,PHYS 1AL,001,886432,Tsai; Philbert S,0,2,30,30
1746540171684,PHYS 1AL,002,886436,Tsai; Philbert S,11,0,30,19
1746540172708,PHYS 1B,A00,886439,Staff,185,0,240,55
1746540173734,PHYS 1BL,001,886441,Tsai; Philbert S,0,4,30,30
1746540173734,PHYS 1BL,002,886444,Tsai; Philbert S,2,0,30,28
1746540174764,PHYS 1C,A00,896092,Arnold; Kam S,78,0,146,68
1746540175794,PHYS 1CL,001,886448,Tsai; Philbert S,0,0,30,30
1746540175794,PHYS 1CL,002,886449,Tsai; Philbert S,0,0,30,30
1746540175794,PHYS 1CL,003,886450,Tsai; Philbert S,15,0,30,15
1746540175794,PHYS 1CL,004,886451,Tsai; Philbert S,15,0,30,15
1746540176821,PHYS 2B,A01,886457,Staff,69,0,115,46
1746540177847,PHYS 2C,A01,886460,Shotwell; Brian,0,8,65,65
1746540178874,PHYS 2CL,A01,886467,Staff,0,4,28,28
1746540178874,PHYS 2CL,A02,886468,Staff,0,3,28,28
1746540179900,PHYS 2D,A01,886470,Staff,10,0,50,40
1746540180929,PHYS 4B,A01,886475,Grinstein; Benjamin,22,0,40,18
1746540181959,POLI 5,A00,891173,Desposato; Scott,7,0,25,18
1746540182989,POLI 5D,A01,891175,Staff,5,0,5,0
1746540182989,POLI 5D,B01,891178,Staff,5,0,5,0
1746540184014,POLI 11,A00,891179,Ferree; Karen E,2,0,35,33
1746540185043,POLI 12,A00,891180,Staff,16,0,30,14
1746540186069,POLI 27,A01,891182,Staff,12,0,75,63
1746540187099,POLI 30,A00,891183,Staff,9,0,50,41
1746540188128,POLI 100B,A00,891244,Staff,5,1,35,30
1746540189155,POLI 100I,A00,891247,Staff,7,0,30,23
1746540190181,POLI 104J,A00,891248,Nichter; Maysa,14,0,30,16
1746540191206,POLI 104U,A00,891250,Nichter; Maysa,2,0,30,28
1746540193263,POLI 110B,A00,891255,Wiens; David,20,0,25,5
1746540194292,POLI 112A,A00,891256,Wiens; David,6,0,25,19
1746540195321,POLI 114BR,A00,891261,Staff,19,0,30,11
1746540196345,POLI 117R,A00,891262,Forman; Fonna,0,6,50,50
1746540197372,POLI 118,A00,891264,Ingham; Sean,17,0,25,8
1746540198398,POLI 124A,A00,891265,Staff,18,0,20,2
1746540199427,POLI 125D,A00,891266,Nichter; Simeon C,2,0,25,23
1746540200453,POLI 126,A00,891268,Nichter; Simeon C,7,0,25,18
1746540201477,POLI 126AA,A00,891272,Staff,18,0,25,7
1746540202502,POLI 130AA,A00,891273,Staff,15,0,20,5
1746540203529,POLI 134AA,A00,891274,Staff,4,0,20,16
1746540205580,POLI 138,A00,891278,Staff,21,0,25,4
1746540206608,POLI 142K,A00,891280,Staff,11,0,25,14
1746540207636,POLI 142M,A00,891281,Gartzke; Erik,17,0,30,13
1746540208661,POLI 142P,A00,891284,Staff,20,0,30,10
1746540209685,POLI 143,A00,891285,Gartzke; Erik,12,0,30,18
1746540210713,POLI 153,A00,891286,Staff,19,0,20,1
1746540212766,POLI 175,A00,891290,Staff,15,0,20,5
1746540213793,PSYC 1,A00,890674,Steiner; Eric Tomas,0,11,45,45
1746540214819,PSYC 2,A00,890676,Albright; Thomas D,21,0,35,14
1746540215845,PSYC 3,A00,890679,Staff,17,0,20,3
1746540216871,PSYC 6,A00,959858,Staff,20,0,20,0
1746540217897,PSYC 60,A01,890684,Rickard; Timothy C.,0,5,45,45
1746540218924,PSYC 70,A01,890689,Geller; Emma Harlan,7,0,30,23
1746540219951,PSYC 71,A01,959860,Staff,21,0,25,4
1746540220980,PSYC 100,A00,890690,Lacefield; Katharine I,0,50,180,180
1746540222007,PSYC 102,A00,890695,Staff,18,0,40,22
1746540223033,PSYC 105,A00,890699,Geller; Emma Harlan,71,0,100,29
1746540224058,PSYC 106,A00,890701,Gorman; Michael R.,5,0,30,25
1746540225087,PSYC 108,A00,890704,Adrian; Julia Anna,0,28,50,50
1746540226114,PSYC 118,A01,890712,Staff,11,0,30,19
1746540227140,PSYC 124,A00,890716,Chapman; Eddie Nathaniel,25,0,60,35
1746540228166,PSYC 131,A00,890717,Anagnostaras; Stephan,0,7,80,80
1746540229191,PSYC 137,A00,890719,Winkielman; Piotr,0,11,30,30
1746540230221,PSYC 144,A00,890721,Adrian; Julia Anna,0,9,45,45
1746540231248,PSYC 162,A00,890805,Staff,2,0,75,73
1746540232276,PSYC 169,A00,890810,Staff,0,15,30,30
1746540233303,PSYC 172,A00,890814,Gorman; Michael R.,9,0,30,21
1746540234330,PSYC 181,A00,890818,Anagnostaras; Stephan,8,0,200,192
1746540235412,PSYC 184,A00,959861,Staff,170,0,175,5
1746540236437,PSYC 189,A00,890823,Staff,0,1,30,30
1746540237469,PSYC 191,A00,890884,Rickard; Timothy C.,0,11,35,35
1746540238497,PSYC 193,A00,890913,Staff,19,0,30,11
1746540238497,PSYC 193,B00,890914,Chapman; Eddie Nathaniel,24,0,30,6
1746540239525,PSYC 193L,A01,890918,Lowe; Angela Beth,20,0,30,10
1746540239525,PSYC 193L,B01,890921,Hurwitz; Ethan Scott,20,0,30,10
1746540239525,PSYC 193L,C01,890928,Staff,30,0,30,0
1746540240557,RELI 149,A00,886806,Rahimi; Babak,23,0,40,17
1746540241584,SE 9,A01,886814,Staff,7,0,20,13
1746540242616,SE 101B,A01,886816,Chadha; Mayank,4,0,35,31
1746540243641,SE 110B,A00,886818,Zhu; Qiang,4,0,75,71
1746540244671,SE 125,A01,886830,Staff,10,0,30,20
1746540245696,SE 130B,A01,886835,Staff,14,0,40,26
1746540246728,SE 131A,A01,886838,Krysl; Petr,34,0,55,21
1746540247753,SE 154,A00,886840,Staff,30,0,50,20
1746540248776,SE 164GS,A01,886849,Staff,6,0,20,14
1746540249805,SE 167GS,A01,886853,Staff,6,0,20,14
1746540250831,SIO 25,A01,890107,Staff,19,0,30,11
1746540251860,SIO 45,A00,890109,Cook; Geoffrey W,117,0,200,83
1746540252905,SIO 109R,A00,890110,Forman; Fonna,0,16,20,20
1746540253932,SIO 187,A01,890114,Kacev; David,15,0,40,25
1746540254961,SOCI 1,A01,890431,Thorpe; Charles Robert,15,0,30,15
1746540254961,SOCI 1,A02,890518,Thorpe; Charles Robert,30,0,30,0
1746540255986,SOCI 2,A01,957978,Staff,25,0,25,0
1746540255986,SOCI 2,A02,957979,Staff,23,0,25,2
1746540257013,SOCI 20,A01,890523,Calderon-Zaks; Michael Aar,23,0,30,7
1746540257013,SOCI 20,A02,890526,Calderon-Zaks; Michael Aar,29,0,30,1
1746540258039,SOCI 30,A01,890533,Pardo Guerra; Juan Pablo,37,0,40,3
1746540259067,SOCI 40,A01,890535,Staff,27,0,45,18
1746540260097,SOCI 104Q,A00,890559,Staff,18,0,30,12
1746540261134,SOCI 106,A00,890560,Arnal; Maud Marie Leonie,20,0,30,10
1746540262165,SOCI 110,A00,890567,Holkenbrink-Monk; Charlene,19,0,30,11
1746540263191,SOCI 112,A00,890568,Victoria Torres; Pablo,1,0,55,54
1746540264220,SOCI 115,A00,890597,Arnal; Maud Marie Leonie,28,0,45,17
1746540266277,SOCI 121,A00,890604,Pardo Guerra; Juan Pablo,38,0,45,7
1746540267302,SOCI 126,A01,890608,Staff,8,0,10,2
1746540268328,SOCI 127,A00,890609,Staff,18,0,30,12
1746540269354,SOCI 131,A00,890610,Thorpe; Charles Robert,37,0,45,8
1746540270379,SOCI 135,A00,890615,Payne; Christine Anna,14,0,45,31
1746540271403,SOCI 139,A00,890620,Staff,38,0,45,7
1746540272431,SOCI 148E,A00,890622,Calderon-Zaks; Michael Aar,36,0,45,9
1746540273458,SOCI 150,A00,890623,Kohler; Kristopher M.,31,0,45,14
1746540274487,SOCI 157,A00,890625,Jules-Rosette; Bennetta W.,18,0,20,2
1746540275512,SOCI 160,A00,890627,Payne; Christine Anna,21,0,45,24
1746540276542,SYN 1,A00,886855,Fish; Gwendolyn Anne,0,0,0,0
1746540276542,SYN 1,B00,906086,Fish; Gwendolyn Anne,0,1,0,2
1746540277571,SYN 2R,A00,886860,Staff,0,17,15,15
1746540277571,SYN 2R,B00,906106,Atkinson; Arthur Laird,0,16,15,15
1746540278598,SYN 100,A01,886866,Browne; Emily,0,28,20,20
1746540278598,SYN 100,B01,906128,Rock; Martin,0,5,20,20
1746540278598,SYN 100,C01,906140,Deavenport; James Cary,0,3,20,20
1746540278598,SYN 100,D01,907816,Deavenport; James Cary,0,5,20,20
1746540279626,TDAC 1,A00,890286,Walsh; Kim C.,9,0,20,11
1746540280652,TDAC 101,A00,890296,Basso; Beatrice,16,0,20,4
1746540281679,TDDE 131,A00,890297,Staff,47,0,50,3
1746540282705,TDDM 1,A00,890287,Weinberg; Sadie,25,0,30,5
1746540283732,TDGE 11,A00,890288,Fulton; Julia,137,0,200,63
1746540283732,TDGE 11,B00,890289,Castro; Robert Jess,184,0,200,16
1746540284758,TDGE 25,B00,957359,Walsh; Kim C.,3,0,20,17
1746540285785,TDGE 40,A01,890292,Power; Jade Yukana,27,0,30,3
1746540286810,TDGE 124,A00,890298,Havis; Allan,0,0,50,50
1746540287841,TDGE 131R,A00,890299,Burelle; Julie Sara Veronique,15,0,42,27
1746540288866,TDHT 101,A00,890300,Staff,10,0,20,10
1746540289896,TDHT 109,A01,890302,Anderson; Mysia Anyse,31,0,40,9
1746540290925,TDMV 1,A00,890293,Arcidiacono; Kristin,18,0,30,12
1746540291952,TDMV 2,A00,890294,Weinberg; Sadie,23,0,30,7
1746540292978,TDMV 3,A00,957878,Arcidiacono; Kristin,28,0,30,2
1746540295031,TDMV 138,A00,890304,Jun; Grace Shin Hae,25,0,40,15
1746540296058,TDMV 140,A00,890305,Corrales; Joseph Bernales,25,0,30,5
1746540297086,TDMV 142,A00,890307,Caligagan; Tony,32,0,40,8
1746540298112,TDMV 144,A00,890308,Camaya; Michelle Ann,25,0,30,5
1746540299139,TDPW 1,A00,890295,Stein; Deborah Isobel,3,0,20,17
1746540300165,USP 2,A01,890272,Lerner; Amy M,6,0,20,14
1746540301193,USP 3,A01,890274,Staff,12,0,30,18
1746540302262,USP 15,A01,890276,Sun; Feiyang,17,0,30,13
1746540303290,USP 25,A00,890277,Shenkman; Michael Thomas,19,0,25,6
1746540304316,USP 138,A00,890278,Staff,13,0,25,12
1746540305345,USP 143,A00,890279,Staff,21,0,70,49
1746540306375,USP 144,A00,890280,Chowdhury; Muhammed Zohir,16,0,30,14
1746540307402,USP 150,A00,890281,Boomhower; Matthew Charles,4,0,30,26
1746540308430,USP 151,A00,890282,Staff,16,0,20,4
1746540309459,USP 162,A00,890283,Andrews; Abigail Leslie,16,0,20,4
1746540310484,USP 168,A00,920477,Kwak; Nancy,1,0,5,4
1746540311509,USP 181,A00,890284,Staff,3,0,20,17
1746540312533,USP 191A,A00,890285,Staff,13,0,20,7
1746540313563,VIS 101,A00,886512,Staff,25,0,75,50
1746540314590,VIS 103,A00,886513,Cruz; Edwin Teddy,61,0,75,14
1746540315618,VIS 108,A00,886514,Staff,3,0,15,12
1746540316643,VIS 127P,A00,886515,Shen; Kuiyi,80,0,146,66
1746540317668,VIS 149,A00,886516,Yoldas; Pinar,0,0,15,15
1746540318696,VIS 164,A00,886526,Erdmann; Dean,19,0,22,3
1746540319722,VIS 194S,A00,886527,Staff,61,0,75,14
1746540320751,WCWP 10A,C00,886484,Martiniuk; Jill,12,0,15,3
1746540321778,WCWP 10B,A00,886490,Uriarte; Emma,0,0,15,15
1746540321778,WCWP 10B,B00,886491,Dhir; Simrita,11,0,15,4
1746540321778,WCWP 10B,C00,886492,Ornelas; Tricia,0,0,15,15
1746540322810,WCWP 100,A00,886494,Young; Mark T,0,7,15,15
1746540324920,AAS 10,A01,886199,Childs; Dennis R.,0,3,0,0
1746540325946,ANAR 104,A01,886940,Shtienberg; Gilad,27,0,30,3
1746540326976,ANAR 120,A00,886953,Staff,12,0,20,8
1746540328004,ANBI 148,A01,886955,Wilder; Linnea Lorene,30,0,40,10
1746540330060,ANSC 122,A00,886957,Staff,25,0,30,5
1746540331087,ANSC 150,A00,886958,Sloane; Julia Kathryn,3,0,15,12
1746540332114,ANSC 156,A00,886959,Jenkins; Janis A.,0,1,15,15
1746540333140,ANSC 180,A00,886960,Staff,11,0,17,6
1746540334170,ANSC 188,A00,886961,Jassal; Aftab,9,0,25,16
1746540335196,ANSC 190,A00,886962,Jassal; Aftab,14,0,25,11
1746540336223,ANSC 191,A00,886963,Staff,18,0,20,2
1746540337253,ANTH 3,A01,891689,Staff,17,0,20,3
1746540338281,ANTH 5,A00,886933,Semendeferi; Ekaterini,16,0,20,4
1746540339364,ANTH 10,A00,886934,Staff,0,12,30,30
1746540340392,ANTH 21,A01,886936,Staff,40,0,60,20
1746540341418,ANTH 23,A01,886938,Staff,92,0,100,8
1746540342446,ANTH 105,A00,886964,Stewart; Alexander B,84,0,100,16
1746540343473,ANTH 108,A00,886965,Pedersen; David,9,0,20,11
1746540344509,AWP 10,001,886147,Staff,0,0,0,0
1746540344509,AWP 10,002,886148,Staff,0,0,0,0
1746540344509,AWP 10,003,886149,Staff,0,0,0,0
1746540344509,AWP 10,004,886150,Staff,0,0,0,0
1746540344509,AWP 10,005,886151,Staff,0,0,0,0
1746540344509,AWP 10,006,886152,Staff,0,0,0,0
1746540344509,AWP 10,007,886153,Staff,0,0,0,0
1746540344509,AWP 10,008,886154,Staff,0,0,0,0
1746540344509,AWP 10,009,886155,Staff,0,0,0,0
1746540344509,AWP 10,010,886156,Staff,0,0,0,0
1746540344509,AWP 10,011,886158,Staff,0,0,0,0
1746540344509,AWP 10,012,886160,Staff,0,0,0,0
1746540344509,AWP 10,013,886161,Staff,0,0,0,0
1746540344509,AWP 10,014,886162,Staff,0,0,0,0
1746540344509,AWP 10,015,886163,Staff,0,0,0,0
1746540344509,AWP 10,016,886164,Staff,0,0,0,0
1746540344509,AWP 10,017,886165,Staff,0,0,0,0
1746540344509,AWP 10,018,886166,Staff,0,0,0,0
1746540344509,AWP 10,019,886168,Staff,0,0,0,0
1746540344509,AWP 10,020,886170,Staff,0,0,0,0
1746540344509,AWP 10,021,886172,Staff,0,0,0,0
1746540345544,AWP 10R,001,886173,Staff,0,1,0,0
1746540345544,AWP 10R,002,886174,Staff,0,1,0,0
1746540345544,AWP 10R,003,886175,Staff,0,0,0,0
1746540345544,AWP 10R,004,886176,Staff,0,0,0,0
1746540345544,AWP 10R,005,886177,Staff,0,0,0,0
1746540345544,AWP 10R,006,886178,Staff,0,0,0,0
1746540345544,AWP 10R,007,886179,Staff,0,0,0,0
1746540345544,AWP 10R,008,886181,Staff,0,0,0,0
1746540345544,AWP 10R,009,886182,Staff,0,0,0,0
1746540345544,AWP 10R,010,886183,Staff,0,0,0,0
1746540345544,AWP 10R,011,886184,Staff,0,0,0,0
1746540345544,AWP 10R,012,886185,Staff,0,0,0,0
1746540345544,AWP 10R,013,886186,Staff,0,0,0,0
1746540345544,AWP 10R,014,886187,Staff,0,0,0,0
1746540345544,AWP 10R,015,886188,Staff,0,0,0,0
1746540345544,AWP 10R,016,886189,Staff,0,0,0,0
1746540346568,AWP 102R,A00,886190,Staff,0,0,0,0
1746540346568,AWP 102R,B00,886191,Staff,0,0,0,0
1746540347594,BENG 100,A01,886193,Staff,17,0,30,13
1746540348622,BENG 122A,A01,886195,Hasty; Jeff M,13,0,30,17
1746540349648,BENG 166A,A00,886196,Sah; Robert Lie-Yuan,0,1,30,30
1746540350675,BENG 190,A00,958050,Khojah; Reem I,24,0,25,1
1746540351703,BIBC 102,A01,894320,Staff,0,0,46,46
1746540351703,BIBC 102,A02,894321,Staff,1,0,46,45
1746540351703,BIBC 102,A03,894344,Staff,7,0,46,39
1746540351703,BIBC 102,A04,894345,Staff,26,0,47,21
1746540352731,BICD 100R,A01,894365,Smith; Laurie,0,3,58,58
1746540352731,BICD 100R,A02,894366,Smith; Laurie,0,5,58,58
1746540352731,BICD 100R,A03,894367,Smith; Laurie,2,0,59,57
1746540352731,BICD 100R,A04,959869,Smith; Laurie,41,0,59,18
1746540353761,BICD 136,A01,894383,Gustafson-Brown; Cindy,14,0,50,36
1746540354792,BIEB 102,A01,894494,Butler; Shannon Rhey,51,0,130,79
1746540356856,BIEB 150,A01,894617,Wills; Christopher,3,0,20,17
1746540356856,BIEB 150,A02,894631,Wills; Christopher,3,0,20,17
1746540356856,BIEB 150,A03,894937,Wills; Christopher,3,0,20,17
1746540356856,BIEB 150,A04,894946,Wills; Christopher,5,0,20,15
1746540357883,BIEB 194,A00,906141,Kurle; Carolyn M.,6,0,20,14
1746540358908,BILD 1,A01,894154,Staff,2,0,19,17
1746540358908,BILD 1,A02,894155,Staff,14,0,19,5
1746540358908,BILD 1,A03,894160,Staff,13,0,19,6
1746540358908,BILD 1,A04,894161,Staff,15,0,18,3
1746540359934,BILD 2,A01,894168,Staff,0,0,50,50
1746540359934,BILD 2,A02,894169,Staff,0,0,50,50
1746540359934,BILD 2,A03,894179,Staff,4,0,50,46
1746540359934,BILD 2,A04,894203,Staff,27,0,50,23
1746540360963,BILD 3,A01,894213,Staff,22,0,31,9
1746540360963,BILD 3,A02,894214,Staff,26,0,31,5
1746540360963,BILD 3,A03,894235,Staff,28,0,31,3
1746540360963,BILD 3,A04,894236,Staff,28,0,32,4
1746540361993,BILD 4,A01,894253,Reuther; Keefe,5,0,24,19
1746540361993,BILD 4,A02,894258,Reuther; Keefe,16,0,24,8
1746540363023,BILD 5,A01,894276,Reuther; Keefe,35,0,50,15
1746540363023,BILD 5,A02,894277,Reuther; Keefe,45,0,50,5
1746540363023,BILD 5,A03,894290,Reuther; Keefe,44,0,50,6
1746540363023,BILD 5,A04,894291,Reuther; Keefe,48,0,50,2
1746540364051,BILD 24,A01,894297,Pirino; Giorgia,40,0,60,20
1746540365077,BIMM 100,B01,958915,Staff,72,0,100,28
1746540366104,BIMM 101,A01,895017,McDonnell; Lisa Marie,0,5,24,24
1746540366104,BIMM 101,A02,895018,McDonnell; Lisa Marie,0,5,24,24
1746540366104,BIMM 101,B01,895020,McDonnell; Lisa Marie,0,6,24,24
1746540366104,BIMM 101,B02,895021,McDonnell; Lisa Marie,0,4,24,24
1746540367135,BIMM 110,A01,895023,Staff,1,0,25,24
1746540367135,BIMM 110,A02,895024,Staff,9,0,25,16
1746540367135,BIMM 110,A03,895025,Staff,18,0,25,7
1746540367135,BIMM 110,A04,895031,Staff,20,0,25,5
1746540368162,BIMM 120,A01,895114,Gustafson-Brown; Cindy,13,0,28,15
1746540368162,BIMM 120,A02,895126,Gustafson-Brown; Cindy,21,0,27,6
1746540369188,BIPN 100,A01,895130,Yang; Mingyu,1,0,38,37
1746540369188,BIPN 100,A02,895131,Yang; Mingyu,32,0,38,6
1746540369188,BIPN 100,A03,895132,Yang; Mingyu,32,0,38,6
1746540369188,BIPN 100,A04,895133,Yang; Mingyu,27,0,36,9
1746540370218,BIPN 120,A01,895135,Cooke; James Edward,0,3,13,13
1746540370218,BIPN 120,A02,895136,Cooke; James Edward,0,1,13,13
1746540370218,BIPN 120,A03,895137,Cooke; James Edward,0,3,13,13
1746540370218,BIPN 120,A04,895156,Cooke; James Edward,0,2,11,11
1746540371246,BIPN 134,A01,895235,Cooke; James Edward,0,2,25,25
1746540371246,BIPN 134,A02,895237,Cooke; James Edward,0,0,25,25
1746540371246,BIPN 134,A03,895240,Cooke; James Edward,3,0,25,22
1746540371246,BIPN 134,A04,895270,Cooke; James Edward,20,0,25,5
1746540372271,BIPN 189,A00,892103,Staff,0,13,14,14
1746540374333,BISP 194,A00,958008,Staff,0,2,0,0
1746540375359,CAT 124,A01,922009,Staff,0,5,20,20
1746540376389,CAT 125R,A00,886390,Morales; Celeste Georgianna,0,2,20,20
1746540376389,CAT 125R,B00,886391,Irwin; Matthew Joseph,0,3,20,20
1746540376389,CAT 125R,C00,886392,Smith; Lauryn Alissa,0,2,20,20
1746540376389,CAT 125R,D00,886393,Vanderschuit; Maya Alysia,0,2,20,20
1746540376389,CAT 125R,E00,886394,Marchisotto; Jennifer Anne,0,4,20,20
1746540377417,CENG 15,A01,886218,Drews; Aaron,3,0,8,5
1746540378447,CENG 113,A00,886219,Opatkiewicz; Justin Paul,15,0,25,10
1746540379476,CGS 101,A00,887044,Staff,7,0,20,13
1746540380503,CGS 105,A01,887046,Staff,14,0,25,11
1746540381529,CGS 112,A00,887047,Cuong; Marisol,12,0,15,3
1746540382557,CGS 113,A00,887048,Staff,23,0,30,7
1746540383586,CGS 120,A00,887049,Staff,10,0,17,7
1746540384616,CHEM 6A,A01,886336,Lam; Tin Yiu,38,0,50,12
1746540384616,CHEM 6A,A02,886338,Lam; Tin Yiu,37,0,50,13
1746540385649,CHEM 6B,A01,886341,Hopkins; Patrycja Anna,16,0,50,34
1746540385649,CHEM 6B,A02,886343,Hopkins; Patrycja Anna,42,0,50,8
1746540386679,CHEM 6C,A01,886346,Albizati; Kim F.,0,2,50,50
1746540386679,CHEM 6C,A02,886348,Albizati; Kim F.,23,0,50,27
1746540387705,CHEM 40A,A01,886352,Klosterman; Jeremy K,65,0,100,35
1746540388736,CHEM 40B,A01,886356,Klosterman; Jeremy K,0,23,100,100
1746540389764,CHEM 41B,A01,886360,Theodorakis; Emmanuel,25,0,50,25
1746540389764,CHEM 41B,A02,886362,Theodorakis; Emmanuel,47,0,50,3
1746540390792,CHIN 165A,A00,886382,Xu; Li,18,0,20,2
1746540391820,CLAS 120,A00,886387,Myerston Santana; Jacobo,33,0,40,7
1746540392848,COGS 9,A01,886967,Shannon; Kyle Michael,42,0,60,18
1746540393874,COGS 11,A01,886969,Staff,11,0,30,19
1746540394899,COGS 14A,A01,886971,Staff,6,0,60,54
1746540395930,COGS 14B,A01,886973,Hoffman; Drew Ellen,4,0,60,56
1746540396956,COGS 18,A01,886975,Morgan; Eric,35,0,60,25
1746540397981,COGS 20,A01,886977,Staff,4,0,8,4
1746540397981,COGS 20,A02,886978,Staff,5,0,7,2
1746540399006,COGS 100,A01,907783,Staff,0,2,30,30
1746540400034,COGS 101B,A01,886980,Staff,0,3,48,48
1746540401063,COGS 101C,A01,886982,Delgado; Tania,0,5,44,44
1746540402091,COGS 102A,A01,886984,Johnson; Christine M.,4,0,30,26
1746540403114,COGS 118B,A01,886986,Staff,0,3,88,88
1746540404139,COGS 150,A01,886988,Bergen; Benjamin,23,0,50,27
1746540405169,COGS 153,A00,886989,Delgado; Tania,0,2,41,41
1746540406195,COGS 186,A01,886991,Staff,0,0,32,32
1746540407222,COGS 187A,A01,886993,Boyle; Mary E. T.,7,0,30,23
1746540408247,COGS 189,A00,886994,Staff,0,1,30,30
1746540409275,COMM 10,A01,886996,Staff,0,0,20,21
1746540409275,COMM 10,A02,886997,Staff,12,0,20,8
1746540409275,COMM 10,A03,959845,Staff,19,0,20,1
1746540410302,COMM 20,A01,886999,Leuning; Grant Maurstad,24,0,40,16
1746540412356,COMM 100A,A01,887002,Staff,0,0,20,25
1746540412356,COMM 100A,A02,887003,Staff,7,0,20,13
1746540413384,COMM 100B,A01,887005,Staff,0,8,20,24
1746540414412,COMM 106D,A00,887006,Staff,14,0,40,26
1746540415437,COMM 110G,A00,887007,Whitworth-Smith; Andrew C,12,0,40,28
1746540416461,COMM 111B,A00,887008,Staff,31,0,40,9
1746540417491,COMM 113T,A00,887009,Abuelhiga; Soraya Jill,28,0,40,12
1746540417491,COMM 113T,B00,906733,Staff,40,0,40,0
1746540418518,COMM 145,A00,887010,Staff,12,0,40,28
1746540419544,COMM 146,A00,887054,Staff,31,0,40,9
1746540420569,COMM 190,A00,887012,Staff,8,0,23,15
1746540421595,CSE 8A,A50,887015,Cao; Yingjun,57,0,85,28
1746540422622,CSE 11,A01,887017,Cao; Yingjun,12,0,70,58
1746540423650,CSE 20,A01,887019,Staff,30,0,50,20
1746540424682,CSE 21,A01,887021,Staff,78,0,100,22
1746540424682,CSE 21,B01,892583,Braun; Oliver,45,0,50,5
1746540425712,CSE 30,A01,887025,Eldon; John,143,0,200,57
1746540426737,CSE 100,A01,887027,Staff,26,0,50,24
1746540426737,CSE 100,A02,887028,Staff,40,0,50,10
1746540427763,CSE 101,A01,887030,Braun; Oliver,75,0,100,25
1746540427763,CSE 101,B01,887032,Jones; Miles E,0,3,50,50
1746540427763,CSE 101,B02,887033,Jones; Miles E,0,1,50,50
1746540428789,CSE 105,A01,908084,Jones; Miles E,32,0,50,18
1746540428789,CSE 105,A02,908087,Jones; Miles E,33,0,50,17
1746540429820,CSE 135,A01,887035,Powell; Thomas Allan,0,4,50,50
1746540430845,CSE 142,A01,887037,Staff,8,0,60,52
1746540431871,CSE 142L,A01,887039,Staff,34,0,60,26
1746540432899,CSE 151A,A01,887041,Solares; Edwin A,48,0,100,52
1746540433926,CSE 175,A01,887043,Kumar; Rakesh,30,0,30,0
1746540434953,CSS 1,A01,886389,Staff,0,1,40,40
1746540435979,DSC 30,A01,908097,Liao; Soohyun Nam,47,0,75,28
1746540437005,DSC 40A,A01,908099,Shannon; Kyle Michael,30,0,50,20
1746540438033,DSC 40B,A01,908112,Staff,16,0,50,34
1746540439059,DSC 80,A01,908116,Staff,19,0,60,41
1746540440085,DSC 197,001,956863,Eldridge; Justin Matthew,9999,0,9999,0
1746540441111,ECE 5,A01,886400,Morris; Karcher William,2,0,6,4
1746540441111,ECE 5,A02,886401,Morris; Karcher William,3,0,6,3
1746540442140,ECE 148,A01,886403,Silberman; Jack,0,14,14,14
1746540443206,ECON 1,A01,887265,Crane; Meredith Helen,12,0,70,58
1746540443206,ECON 1,B01,887268,Staff,43,0,50,7
1746540444233,ECON 2,A01,887273,Crane; Meredith Helen,56,0,70,14
1746540445260,ECON 3,A01,887279,Rondina; Giacomo,32,0,70,38
1746540446285,ECON 4,A01,887282,Anderson; John Charles,0,2,10,10
1746540447310,ECON 5,A01,887285,Staff,33,0,45,12
1746540447310,ECON 5,B01,887292,Staff,41,0,45,4
1746540448339,ECON 100A,A01,887337,Newhouse; Herbert S,54,0,70,16
1746540448339,ECON 100A,B01,887349,Staff,45,0,50,5
1746540449370,ECON 100B,A01,887361,Du; Songzi,29,0,70,41
1746540450400,ECON 100C,A01,887445,Newhouse; Herbert S,59,0,70,11
1746540451425,ECON 105,A00,887488,Vespa; Emanuel Ignacio,23,0,35,12
1746540452455,ECON 109,A01,887506,Shishkin; Denis,28,0,35,7
1746540453485,ECON 110A,A01,887568,Alon; Titan Michael,0,3,35,35
1746540453485,ECON 110A,B01,907601,Alon; Titan Michael,20,0,35,15
1746540454508,ECON 110B,A01,887598,Levkoff; Steven B.,0,23,70,70
1746540455536,ECON 112,A00,887599,Rondina; Giacomo,19,0,35,16
1746540456561,ECON 120A,A01,887603,Dai; Yinlin,36,0,70,34
1746540457592,ECON 120C,A01,887608,Sun; Yixiao,0,1,35,35
1746540457592,ECON 120C,B01,887614,Sun; Yixiao,0,0,35,35
1746540458618,ECON 138,A00,887621,Bharadwaj; Prashant,0,20,20,20
1746540459645,ECON 144,A00,958007,Squires; Dale E,13,0,35,22
1746540460671,ECON 171,A01,907666,Staff,18,0,35,17
1746540461697,ECON 175,A00,887626,Wu; Pak Yeung,23,0,35,12
1746540462722,ECON 190,A00,887640,Vespa; Emanuel Ignacio,23,0,35,12
1746540463770,EDS 25,A01,888197,Staff,0,0,0,0
1746540463770,EDS 25,A02,888209,Staff,0,0,0,0
1746540463770,EDS 25,A03,888210,Staff,0,0,0,0
1746540463770,EDS 25,A04,888212,Staff,0,0,0,0
1746540463770,EDS 25,A05,888213,Staff,0,0,0,0
1746540463770,EDS 25,A06,888214,Staff,0,0,0,0
1746540463770,EDS 25,A07,888235,Staff,0,2,0,0
1746540463770,EDS 25,A08,888236,Staff,0,0,0,0
1746540463770,EDS 25,A09,888240,Staff,0,0,0,0
1746540463770,EDS 25,A10,888244,Staff,0,0,0,0
1746540463770,EDS 25,B01,888273,Staff,0,0,0,0
1746540463770,EDS 25,B02,888285,Staff,0,0,0,0
1746540463770,EDS 25,B03,888423,Staff,0,0,0,1
1746540463770,EDS 25,B04,888432,Staff,0,0,0,0
1746540463770,EDS 25,B05,888433,Staff,0,0,0,0
1746540463770,EDS 25,B06,888467,Staff,0,0,0,0
1746540463770,EDS 25,B07,888468,Staff,0,0,0,0
1746540463770,EDS 25,B08,888479,Staff,0,0,0,0
1746540463770,EDS 25,B09,888484,Staff,0,0,0,0
1746540463770,EDS 25,B10,888487,Staff,0,0,0,0
1746540464797,EDS 38,A01,907700,Choi; Bailey Miyeon,30,0,30,0
1746540465825,EDS 112,A01,888601,Chapman; Thandeka K,14,0,40,26
1746540466854,EDS 115,A00,888697,Mendez; Kathrina Mendoza,10,0,30,20
1746540467880,EDS 116,A01,888893,Staff,35,0,40,5
1746540469938,EDS 124AR,A00,889133,Staff,29,0,50,21
1746540469938,EDS 124AR,B00,907471,Simon; Elizabeth A,37,0,50,13
1746540470968,EDS 124BR,A00,889134,Simon; Elizabeth A,45,0,100,55
1746540471993,EDS 125,A00,889135,Staff,25,0,30,5
1746540473018,EDS 126,A01,889138,Staff,36,0,40,4
1746540474044,EDS 164R,A01,889142,Wishard Guerra; Alison G.,33,0,50,17
1746540475071,ENG 30,A01,886396,Staff,0,0,0,0
1746540475071,ENG 30,B01,886398,Staff,0,0,0,0
1746540476099,ENVR 102,A00,906150,Montejo; Carolina,23,0,25,2
1746540477125,ETHN 103A,A00,887236,Man; Simeon S,0,3,0,0
1746540478153,ETHN 113,A00,887239,Staff,16,0,30,14
1746540479177,ETHN 116,A00,887240,Staff,16,0,25,9
1746540480205,ETHN 117,A00,887241,Choi; Esther Min,28,0,30,2
1746540481236,ETHN 118,A00,887243,Staff,24,0,30,6
1746540482261,ETHN 127,A00,887248,Cuong; Marisol,11,0,15,4
1746540483285,ETHN 139,A00,887250,Staff,7,0,10,3
1746540484313,ETHN 142,A00,887252,Staff,10,0,30,20
1746540485341,ETHN 161,A00,887253,Browne; Errol Tsekani,24,0,30,6
1746540486369,ETHN 163FR,A00,887255,Burelle; Julie Sara Veronique,0,0,5,5
1746540487398,GLBH 20,A00,889149,Elwardani; Nile Regina,8,0,42,34
1746540489449,GLBH 111,A01,889152,Burgos; Jose L.,17,0,17,0
1746540490481,GLBH 150,A00,889181,Sloane; Julia Kathryn,0,5,15,15
1746540492535,HDS 60,A01,886406,Warstadt; Melissa Fawn,73,0,80,7
1746540493564,HIAF 111,A00,889324,Gyamfi; Bright,25,0,32,7
1746540494591,HIEA 131,A00,889328,Staff,16,0,32,16
1746540495618,HIEA 144,A00,889333,Henry; Todd A.,26,0,32,6
1746540496644,HIEA 154,A00,889336,Henry; Todd A.,24,0,32,8
1746540497671,HIEU 106,A00,889339,Staff,22,0,32,10
1746540499724,HIEU 114,A00,889340,Staff,3,0,32,29
1746540500751,HIEU 135GS,A00,889342,Patterson; Patrick H.,0,0,1,24
1746540501778,HIEU 137,A00,889343,Edington; Claire Ellen,9,0,25,16
1746540502806,HIEU 148,A00,889345,Staff,14,0,32,18
1746540503834,HIEU 154,A00,889346,Biess; Frank Peter,21,0,32,11
1746540504860,HILA 102,A00,889351,Staff,12,0,32,20
1746540505887,HILD 2A,A01,889221,Lewandoski; Julia Mavis,1,10,32,31
1746540506913,HILD 7B,A01,889225,Man; Simeon S,0,13,32,32
1746540507942,HILD 7C,A01,889288,Alvarez; Luis A,0,14,32,32
1746540508968,HILD 30,A01,889323,Staff,0,5,32,32
1746540511025,HISC 119,A00,889383,Golan; Tal,21,0,32,11
1746540512050,HIUS 103,A00,889384,Man; Simeon S,0,0,32,32
1746540513079,HIUS 117,A00,919797,Kwak; Nancy,18,0,32,14
1746540514109,HIUS 142A,A00,919788,Staff,22,0,32,10
1746540516162,HIUS 149,A00,889386,Gyamfi; Bright,27,0,32,5
1746540517188,HIUS 155,A00,889387,Alvarez; Luis A,14,0,32,18
1746540518213,HUM 3,A01,886499,Caldwell; Michael Alan,19,0,50,31
1746540519239,HUM 3GS,A00,886500,Rodriguez; Bretton Sigfred,0,0,0,28
1746540520267,HUM 3R,A01,886502,Markman; Kristina,0,36,50,50
1746540521299,HUM 4,A01,886504,Crum; Matthew Stephen,24,0,50,26
1746540521299,HUM 4,B01,886506,West; Geoffrey Scott,17,0,50,33
1746540522329,HUM 4GS,A00,886507,Staff,0,0,0,19
1746540523355,HUM 5,A01,886509,Staff,32,0,50,18
1746540524379,HUM 5R,A01,886511,Zavodny; Tatiana Sophia,0,39,50,50
1746540525405,JAPN 180,A00,886407,Staff,18,0,40,22
1746540526435,LATI 50,A01,886409,Martin-Cabrera; Luis,4,0,22,18
1746540526435,LATI 50,A02,886410,Martin-Cabrera; Luis,19,0,22,3
1746540526435,LATI 50,A03,886411,Martin-Cabrera; Luis,21,0,22,1
1746540526435,LATI 50,A04,886412,Martin-Cabrera; Luis,9,0,22,13
1746540527461,LAWS 101,A00,907664,Staff,28,0,60,32
1746540528488,LIAB 1A,A00,889388,Saab; Dima,17,0,20,3
1746540529515,LIAB 1AX,A00,889389,El Cheddadi; Youniss,17,0,20,3
1746540530543,LIFR 1C,A00,889391,Van Moer; Vinciane G,8,0,20,12
1746540531571,LIFR 1CX,A00,889392,Van Moer; Vinciane G,7,0,20,13
1746540532599,LIFR 1D,A00,889393,Van Moer; Vinciane G,7,0,20,13
1746540533628,LIFR 1DX,A00,889394,Van Moer; Vinciane G,8,0,20,12
1746540534653,LIGN 7,A00,886923,Staff,24,0,50,26
1746540535679,LIGN 17,A00,886924,Kehler; Andrew Scott,125,0,150,25
1746540536704,LTAM 110,A00,889395,Staff,15,0,30,15
1746540537732,LTAM 110GS,A00,958010,Rodriguez; Bretton Sigfred,0,0,0,28
1746540538757,LTCH 101,A00,889397,Staff,23,0,25,2
1746540539785,LTCS 130,A00,889398,Staff,23,0,25,2
1746540540814,LTEA 138,A00,889399,Staff,24,0,40,16
1746540541839,LTEN 149,A00,889400,Wesling; Megan E.,0,3,25,25
1746540542871,LTEN 169,A00,889401,Staff,20,0,25,5
1746540543896,LTEN 180,A00,889402,Staff,10,0,15,5
1746540544923,LTEN 181,A00,889403,Staff,21,0,25,4
1746540545950,LTWL 100,A00,889404,Myerston Santana; Jacobo,3,0,25,22
1746540547031,LTWL 180GS,A00,889405,Staff,0,0,20,20
1746540548059,LTWL 181,A00,889406,Staff,17,0,25,8
1746540549084,LTWL 184,A00,889475,Mukherjee; Silpa,22,0,25,3
1746540550110,LTWR 102C,A00,889486,Staff,29,0,30,1
1746540551137,LTWR 115W,A00,889491,Staff,0,2,15,15
1746540552164,MAE 8,A01,886905,Staff,0,2,0,0
1746540553194,MAE 11,A00,886906,Bandaru; Prabhakar,0,7,50,50
1746540554219,MAE 20,A00,886907,Evdokimenko; Ekaterina,44,0,70,26
1746540555245,MAE 30B,A00,886909,Ghazinejad; Maziar,26,0,45,19
1746540556273,MAE 101B,A00,886910,Saintillan; David,29,0,45,16
1746540557298,MAE 105,A00,886911,Bandaru; Prabhakar,18,0,50,32
1746540558335,MAE 107,B00,958024,Staff,9,0,50,41
1746540559360,MAE 143B,A00,886913,Bewley; Thomas R,7,0,40,33
1746540560387,MAE 148,A01,886915,Silberman; Jack,0,3,14,14
1746540561415,MAE 160,A00,886916,Evdokimenko; Ekaterina,31,0,60,29
1746540562441,MATH 3C,A01,889681,Staff,0,3,30,30
1746540562441,MATH 3C,A02,960048,Staff,25,0,30,5
1746540563467,MATH 10A,A01,889760,Staff,26,0,30,4
1746540563467,MATH 10A,A02,889783,Staff,29,0,30,1
1746540564499,MATH 10B,A01,889785,Verstraete; Jacques Allan,2,0,35,33
1746540564499,MATH 10B,A02,889795,Verstraete; Jacques Allan,4,0,35,31
1746540564499,MATH 10B,B01,889797,Verstraete; Jacques Allan,3,0,35,32
1746540564499,MATH 10B,B02,889828,Verstraete; Jacques Allan,3,0,35,32
1746540565530,MATH 10C,A01,889849,Habib; Yousaf,9,0,30,21
1746540565530,MATH 10C,A02,889852,Habib; Yousaf,14,0,30,16
1746540565530,MATH 10C,A03,889853,Habib; Yousaf,22,0,30,8
1746540565530,MATH 10C,A04,889858,Habib; Yousaf,20,0,30,10
1746540565530,MATH 10C,B01,889861,Staff,1,0,30,29
1746540565530,MATH 10C,B02,889862,Staff,24,0,30,6
1746540565530,MATH 10C,B03,889863,Staff,27,0,30,3
1746540565530,MATH 10C,B04,889967,Staff,23,0,30,7
1746540566565,MATH 18,A01,889974,Staff,7,0,30,23
1746540566565,MATH 18,A02,889977,Staff,20,0,30,10
1746540566565,MATH 18,B01,889984,Hardiman; Liam,22,0,30,8
1746540566565,MATH 18,B02,889985,Hardiman; Liam,25,0,30,5
1746540567591,MATH 20A,A01,889990,Suk; Andrew Hoon,29,0,35,6
1746540568616,MATH 20B,A01,889993,Ohm; Ko Woon,22,0,30,8
1746540568616,MATH 20B,A02,889994,Ohm; Ko Woon,30,0,30,0
1746540568616,MATH 20B,B01,889996,Ohm; Ko Woon,21,0,30,9
1746540568616,MATH 20B,B02,889997,Ohm; Ko Woon,23,0,30,7
1746540569648,MATH 20C,A01,889999,Hammock; Frances H,17,0,30,13
1746540569648,MATH 20C,A02,890003,Hammock; Frances H,23,0,30,7
1746540569648,MATH 20C,B01,890006,Hammock; Frances H,3,0,30,27
1746540569648,MATH 20C,B02,890007,Hammock; Frances H,11,0,30,19
1746540570678,MATH 20D,A01,890011,Cheng; Hsiao-Bing,1,1,30,29
1746540570678,MATH 20D,A02,890012,Cheng; Hsiao-Bing,14,0,30,16
1746540570678,MATH 20D,B01,890016,Cheng; Hsiao-Bing,13,0,30,17
1746540570678,MATH 20D,B02,890017,Cheng; Hsiao-Bing,13,0,30,17
1746540571705,MATH 20E,A01,890026,Harel; Guershon,1,0,30,29
1746540571705,MATH 20E,A02,890029,Harel; Guershon,23,0,30,7
1746540571705,MATH 20E,B01,890033,Harel; Guershon,7,0,30,23
1746540571705,MATH 20E,B02,890101,Harel; Guershon,21,0,30,9
1746540572734,MATH 102,A01,890104,Staff,17,0,30,13
1746540572734,MATH 102,A02,890105,Staff,27,0,30,3
1746540573758,MATH 103B,A01,890116,Salehi Golsefidy; Alireza,3,0,30,27
1746540573758,MATH 103B,B01,890118,Staff,0,3,34,34
1746540574790,MATH 109,A01,890121,Aliabadi Sr.; Mohsen,1,0,30,29
1746540574790,MATH 109,B01,890124,Upadrashta; Pranav Kumar,18,0,30,12
1746540575816,MATH 120A,A01,890126,Eggers; John Dietrich,13,0,30,17
1746540576846,MATH 142B,A01,890128,Ioana; Adrian,19,0,30,11
1746540576846,MATH 142B,A02,890129,Ioana; Adrian,13,0,30,17
1746540577876,MATH 154,A01,890174,Staff,0,0,30,30
1746540577876,MATH 154,A02,890182,Staff,0,0,30,30
1746540578906,MATH 168A,A01,890197,Dumitriu; Ioana,21,0,35,14
1746540579932,MATH 170A,A01,890240,Nie; Jiawang,1,0,30,29
1746540579932,MATH 170A,A02,890241,Nie; Jiawang,11,0,30,19
1746540579932,MATH 170A,A03,890249,Nie; Jiawang,23,0,30,7
1746540580958,MATH 170B,A01,957891,Nag; Panchali,13,0,35,22
1746540583014,MATH 181A,A01,908025,Staff,0,4,35,35
1746540583014,MATH 181A,A02,960115,Staff,27,0,35,8
1746540584040,MATH 181B,A01,959874,Staff,26,0,30,4
1746540585064,MATH 193B,A01,890265,Staff,0,4,35,35
1746540586088,MGT 4,A01,890311,Anderson; John Charles,42,0,88,46
1746540587115,MGT 5,A00,907740,Staff,13,0,98,85
1746540588142,MGT 12,A00,890312,Lindenberger; Wade Douglas,67,0,98,31
1746540589169,MGT 16,A00,957883,Staff,78,0,98,20
1746540591226,MGT 45,A00,890314,Pecore; Joseph P.,47,0,98,51
1746540592252,MGT 71,A00,890315,Staff,0,11,98,98
1746540593281,MGT 100,A00,890316,Yavorsky; Daniel Ryan,44,0,98,54
1746540594310,MGT 103,A00,890317,Ehrich; Kristine R,73,0,98,25
1746540595336,MGT 105,A00,890356,Bates; Kenneth Walter,0,7,98,98
1746540596362,MGT 112,A00,890360,Ehrich; Kristine R,55,0,98,43
1746540597388,MGT 127R,A00,907732,Zhu; Kevin Xiaoguo,23,0,98,75
1746540598412,MGT 131B,A00,890361,Anderson; John Charles,61,0,98,37
1746540599440,MGT 137,A00,890362,Lindenberger; Wade Douglas,65,0,98,33
1746540600468,MGT 160,A00,890369,Johnson; Erik Barry,9,0,98,89
1746540602523,MGT 164,A00,890372,Zimmermann; Carsten,0,39,98,98
1746540603551,MGT 180,A00,890374,Bliss; Barbara Ann,12,0,98,86
1746540604577,MMW 15,A01,886414,Chang; Edmond Yi-Teh,0,12,28,28
1746540604577,MMW 15,A02,886415,Chang; Edmond Yi-Teh,0,8,28,28
1746540604577,MMW 15,A03,886416,Chang; Edmond Yi-Teh,0,8,28,28
1746540604577,MMW 15,A04,886417,Chang; Edmond Yi-Teh,0,8,28,28
1746540604577,MMW 15,B01,886419,Chang; Edmond Yi-Teh,0,7,28,28
1746540604577,MMW 15,B02,886420,Chang; Edmond Yi-Teh,0,8,28,28
1746540604577,MMW 15,B03,886421,Chang; Edmond Yi-Teh,0,7,28,28
1746540604577,MMW 15,B04,886422,Chang; Edmond Yi-Teh,0,8,28,28
1746540604577,MMW 15,C01,886424,Staff,0,9,28,28
1746540604577,MMW 15,C02,886425,Staff,0,8,28,28
1746540604577,MMW 15,C03,886426,Staff,0,8,28,28
1746540604577,MMW 15,C04,886427,Staff,0,7,28,28
1746540604577,MMW 15,C05,958038,Staff,0,7,28,28
1746540604577,MMW 15,C06,958039,Staff,0,8,28,28
1746540605604,MMW 15GS,A00,906910,Patterson; Patrick H.,4,0,28,24
1746540606633,MMW 122R,A01,886429,Rahimi; Babak,0,13,28,28
1746540606633,MMW 122R,A02,886430,Rahimi; Babak,0,12,28,28
1746540606633,MMW 122R,A03,958040,Rahimi; Babak,0,11,28,28
1746540607665,MUS 1A,A01,890937,Staff,3,0,25,22
1746540607665,MUS 1A,A02,891035,Staff,6,0,25,19
1746540607665,MUS 1A,C01,958912,Staff,24,0,25,1
1746540607665,MUS 1A,C02,958913,Staff,25,0,25,0
1746540609716,MUS 2AK,A00,957092,Ohnishi; Takae,15,0,15,0
1746540610742,MUS 4,A01,891044,Staff,2,0,25,23
1746540610742,MUS 4,A02,891045,Staff,23,0,25,2
1746540610742,MUS 4,B01,891048,Staff,17,0,25,8
1746540610742,MUS 4,B02,891050,Staff,25,0,25,0
1746540611768,MUS 5,A01,957506,Dubnov; Shlomo,0,0,25,25
1746540611768,MUS 5,A02,957622,Dubnov; Shlomo,14,0,25,11
1746540611768,MUS 5,A03,957623,Dubnov; Shlomo,20,0,25,5
1746540612794,MUS 6,A01,891053,Freitas Caetano; Marcelo,24,0,25,1
1746540612794,MUS 6,A02,891054,Freitas Caetano; Marcelo,23,0,25,2
1746540613820,MUS 7,A01,891081,Staff,0,0,25,25
1746540613820,MUS 7,A02,891082,Staff,4,0,25,21
1746540614845,MUS 8GS,A00,891118,Borgo; David Garcia,0,0,25,25
1746540615871,MUS 11,A01,891140,Staff,11,0,25,14
1746540615871,MUS 11,A02,891141,Staff,22,0,25,3
1746540616897,MUS 13,A01,891143,Staff,8,0,25,17
1746540616897,MUS 13,A02,891144,Staff,24,0,25,1
1746540617927,MUS 15,A01,891146,Staff,9,0,25,16
1746540617927,MUS 15,A02,891148,Staff,21,0,25,4
1746540617927,MUS 15,B01,891150,Staff,18,0,25,7
1746540617927,MUS 15,B02,891151,Staff,25,0,25,0
1746540618951,MUS 20,A01,891153,Staff,5,0,20,15
1746540618951,MUS 20,A02,891155,Staff,14,0,20,6
1746540619979,MUS 80,A00,891156,Staff,19,0,25,6
1746540619979,MUS 80,B00,891157,Staff,23,0,25,2
1746540621010,MUS 130,A00,891158,Ohnishi; Takae,35,0,35,0
1746540622038,MUS 150GS,A01,891160,Borgo; David Garcia,0,0,25,25
1746540623067,MUS 170,A01,891162,Freitas Caetano; Marcelo,20,0,25,5
1746540623067,MUS 170,A02,891164,Freitas Caetano; Marcelo,21,0,25,4
1746540624093,NANO 11,A00,886220,Vazquez Mena; Oscar,13,0,15,2
1746540625125,NANO 15,A01,886222,Drews; Aaron,4,0,7,3
1746540626154,NANO 104,A00,886224,Sirbuly; Donald,18,0,25,7
1746540627180,PH 40,A00,886528,Staff,23,0,40,17
1746540628208,PH 45,A01,886799,Staff,35,0,40,5
1746540629234,PH 110,A00,886802,Staff,0,7,40,40
1746540630262,PH 172,A00,906716,Staff,19,0,35,16
1746540631286,PH 191,A00,886803,Staff,6,0,40,34
1746540632312,PHIL 1,A00,889500,Staff,19,0,30,11
1746540633340,PHIL 10,A01,889549,Grush; Rick Scott,15,0,22,7
1746540633340,PHIL 10,A02,889551,Grush; Rick Scott,22,0,22,0
1746540634370,PHIL 28,A01,889559,Lamey; Andy M.,0,1,31,31
1746540634370,PHIL 28,A02,889561,Lamey; Andy M.,0,1,30,30
1746540634370,PHIL 28,A03,889572,Lamey; Andy M.,0,0,30,30
1746540635398,PHIL 35,A00,907839,Staff,13,0,15,2
1746540636421,PHIL 60,A00,889574,Staff,74,0,90,16
1746540637447,PHIL 101,A00,958004,Staff,13,0,15,2
1746540639502,PHIL 136,A00,889582,Fulkerson; Matthew Todd,26,0,45,19
1746540640532,PHIL 163,A01,889601,Staff,21,0,30,9
1746540640532,PHIL 163,B01,889606,Brandt; Reuven A,0,3,0,0
1746540641558,PHIL 164,A00,889610,Staff,16,0,30,14
1746540642585,PHIL 165,A00,889613,Staff,23,0,30,7
1746540643611,PHYS 1A,A00,886431,Staff,26,0,70,44
1746540644638,PHYS 1AL,001,886432,Tsai; Philbert S,0,2,30,30
1746540644638,PHYS 1AL,002,886436,Tsai; Philbert S,11,0,30,19
1746540645666,PHYS 1B,A00,886439,Staff,185,0,240,55
1746540646693,PHYS 1BL,001,886441,Tsai; Philbert S,0,4,30,30
1746540646693,PHYS 1BL,002,886444,Tsai; Philbert S,2,0,30,28
1746540647720,PHYS 1C,A00,896092,Arnold; Kam S,78,0,146,68
1746540648750,PHYS 1CL,001,886448,Tsai; Philbert S,0,0,30,30
1746540648750,PHYS 1CL,002,886449,Tsai; Philbert S,0,0,30,30
1746540648750,PHYS 1CL,003,886450,Tsai; Philbert S,15,0,30,15
1746540648750,PHYS 1CL,004,886451,Tsai; Philbert S,15,0,30,15
1746540649781,PHYS 2B,A01,886457,Staff,69,0,115,46
1746540650867,PHYS 2C,A01,886460,Shotwell; Brian,0,8,65,65
1746540651893,PHYS 2CL,A01,886467,Staff,0,4,28,28
1746540651893,PHYS 2CL,A02,886468,Staff,0,3,28,28
1746540652921,PHYS 2D,A01,886470,Staff,10,0,50,40
1746540653947,PHYS 4B,A01,886475,Grinstein; Benjamin,22,0,40,18
1746540654979,POLI 5,A00,891173,Desposato; Scott,7,0,25,18
1746540656012,POLI 5D,A01,891175,Staff,5,0,5,0
1746540656012,POLI 5D,B01,891178,Staff,5,0,5,0
1746540657040,POLI 11,A00,891179,Ferree; Karen E,2,0,35,33
1746540658065,POLI 12,A00,891180,Staff,16,0,30,14
1746540659094,POLI 27,A01,891182,Staff,12,0,75,63
1746540660124,POLI 30,A00,891183,Staff,9,0,50,41
1746540661150,POLI 100B,A00,891244,Staff,5,1,35,30
1746540662181,POLI 100I,A00,891247,Staff,7,0,30,23
1746540663207,POLI 104J,A00,891248,Nichter; Maysa,14,0,30,16
1746540664231,POLI 104U,A00,891250,Nichter; Maysa,2,0,30,28
1746540666286,POLI 110B,A00,891255,Wiens; David,20,0,25,5
1746540667315,POLI 112A,A00,891256,Wiens; David,6,0,25,19
1746540668360,POLI 114BR,A00,891261,Staff,19,0,30,11
1746540669390,POLI 117R,A00,891262,Forman; Fonna,0,6,50,50
1746540670419,POLI 118,A00,891264,Ingham; Sean,17,0,25,8
1746540671443,POLI 124A,A00,891265,Staff,18,0,20,2
1746540672468,POLI 125D,A00,891266,Nichter; Simeon C,2,0,25,23
1746540673494,POLI 126,A00,891268,Nichter; Simeon C,7,0,25,18
1746540674520,POLI 126AA,A00,891272,Staff,18,0,25,7
1746540675547,POLI 130AA,A00,891273,Staff,15,0,20,5
1746540676573,POLI 134AA,A00,891274,Staff,4,0,20,16
1746540678626,POLI 138,A00,891278,Staff,21,0,25,4
1746540679653,POLI 142K,A00,891280,Staff,11,0,25,14
1746540680683,POLI 142M,A00,891281,Gartzke; Erik,17,0,30,13
1746540681710,POLI 142P,A00,891284,Staff,20,0,30,10
1746540682735,POLI 143,A00,891285,Gartzke; Erik,12,0,30,18
1746540683761,POLI 153,A00,891286,Staff,19,0,20,1
1746540685816,POLI 175,A00,891290,Staff,15,0,20,5
1746540686847,PSYC 1,A00,890674,Steiner; Eric Tomas,0,11,45,45
1746540687872,PSYC 2,A00,890676,Albright; Thomas D,21,0,35,14
1746540688899,PSYC 3,A00,890679,Staff,17,0,20,3
1746540689926,PSYC 6,A00,959858,Staff,20,0,20,0
1746540690956,PSYC 60,A01,890684,Rickard; Timothy C.,0,5,45,45
1746540691982,PSYC 70,A01,890689,Geller; Emma Harlan,7,0,30,23
1746540693014,PSYC 71,A01,959860,Staff,21,0,25,4
1746540694041,PSYC 100,A00,890690,Lacefield; Katharine I,0,50,180,180
1746540695072,PSYC 102,A00,890695,Staff,18,0,40,22
1746540696101,PSYC 105,A00,890699,Geller; Emma Harlan,71,0,100,29
1746540697125,PSYC 106,A00,890701,Gorman; Michael R.,5,0,30,25
1746540698154,PSYC 108,A00,890704,Adrian; Julia Anna,0,28,50,50
1746540699182,PSYC 118,A01,890712,Staff,11,0,30,19
1746540700210,PSYC 124,A00,890716,Chapman; Eddie Nathaniel,25,0,60,35
1746540701237,PSYC 131,A00,890717,Anagnostaras; Stephan,0,7,80,80
1746540702263,PSYC 137,A00,890719,Winkielman; Piotr,0,11,30,30
1746540703286,PSYC 144,A00,890721,Adrian; Julia Anna,0,9,45,45
1746540704312,PSYC 162,A00,890805,Staff,2,0,75,73
1746540705341,PSYC 169,A00,890810,Staff,0,15,30,30
1746540706367,PSYC 172,A00,890814,Gorman; Michael R.,9,0,30,21
1746540707392,PSYC 181,A00,890818,Anagnostaras; Stephan,8,0,200,192
1746540708419,PSYC 184,A00,959861,Staff,170,0,175,5
1746540709449,PSYC 189,A00,890823,Staff,0,1,30,30
1746540710474,PSYC 191,A00,890884,Rickard; Timothy C.,0,11,35,35
1746540711499,PSYC 193,A00,890913,Staff,19,0,30,11
1746540711499,PSYC 193,B00,890914,Chapman; Eddie Nathaniel,24,0,30,6
1746540712530,PSYC 193L,A01,890918,Lowe; Angela Beth,20,0,30,10
1746540712530,PSYC 193L,B01,890921,Hurwitz; Ethan Scott,20,0,30,10
1746540712530,PSYC 193L,C01,890928,Staff,30,0,30,0
1746540713555,RELI 149,A00,886806,Rahimi; Babak,23,0,40,17
1746540714583,SE 9,A01,886814,Staff,7,0,20,13
1746540715610,SE 101B,A01,886816,Chadha; Mayank,4,0,35,31
1746540716637,SE 110B,A00,886818,Zhu; Qiang,4,0,75,71
1746540717663,SE 125,A01,886830,Staff,10,0,30,20
1746540718693,SE 130B,A01,886835,Staff,14,0,40,26
1746540719718,SE 131A,A01,886838,Krysl; Petr,34,0,55,21
1746540720744,SE 154,A00,886840,Staff,30,0,50,20
1746540721768,SE 164GS,A01,886849,Staff,6,0,20,14
1746540722793,SE 167GS,A01,886853,Staff,6,0,20,14
1746540723824,SIO 25,A01,890107,Staff,19,0,30,11
1746540724849,SIO 45,A00,890109,Cook; Geoffrey W,117,0,200,83
1746540725876,SIO 109R,A00,890110,Forman; Fonna,0,16,20,20
1746540726903,SIO 187,A01,890114,Kacev; David,15,0,40,25
1746540727930,SOCI 1,A01,890431,Thorpe; Charles Robert,15,0,30,15
1746540727930,SOCI 1,A02,890518,Thorpe; Charles Robert,30,0,30,0
1746540728959,SOCI 2,A01,957978,Staff,25,0,25,0
1746540728959,SOCI 2,A02,957979,Staff,23,0,25,2
1746540729987,SOCI 20,A01,890523,Calderon-Zaks; Michael Aar,23,0,30,7
1746540729987,SOCI 20,A02,890526,Calderon-Zaks; Michael Aar,29,0,30,1
1746540731014,SOCI 30,A01,890533,Pardo Guerra; Juan Pablo,37,0,40,3
1746540732039,SOCI 40,A01,890535,Staff,27,0,45,18
1746540733064,SOCI 104Q,A00,890559,Staff,18,0,30,12
1746540734092,SOCI 106,A00,890560,Arnal; Maud Marie Leonie,20,0,30,10
1746540735119,SOCI 110,A00,890567,Holkenbrink-Monk; Charlene,19,0,30,11
1746540736145,SOCI 112,A00,890568,Victoria Torres; Pablo,1,0,55,54
1746540737174,SOCI 115,A00,890597,Arnal; Maud Marie Leonie,28,0,45,17
1746540739228,SOCI 121,A00,890604,Pardo Guerra; Juan Pablo,38,0,45,7
1746540740257,SOCI 126,A01,890608,Staff,8,0,10,2
1746540741286,SOCI 127,A00,890609,Staff,18,0,30,12
1746540742315,SOCI 131,A00,890610,Thorpe; Charles Robert,37,0,45,8
1746540743340,SOCI 135,A00,890615,Payne; Christine Anna,14,0,45,31
1746540744371,SOCI 139,A00,890620,Staff,38,0,45,7
1746540745396,SOCI 148E,A00,890622,Calderon-Zaks; Michael Aar,36,0,45,9
1746540746423,SOCI 150,A00,890623,Kohler; Kristopher M.,31,0,45,14
1746540747450,SOCI 157,A00,890625,Jules-Rosette; Bennetta W.,18,0,20,2
1746540748478,SOCI 160,A00,890627,Payne; Christine Anna,21,0,45,24
1746540749505,SYN 1,A00,886855,Fish; Gwendolyn Anne,0,0,0,0
1746540749505,SYN 1,B00,906086,Fish; Gwendolyn Anne,0,1,0,2
1746540750534,SYN 2R,A00,886860,Staff,0,17,15,15
1746540750534,SYN 2R,B00,906106,Atkinson; Arthur Laird,0,16,15,15
1746540751561,SYN 100,A01,886866,Browne; Emily,0,28,20,20
1746540751561,SYN 100,B01,906128,Rock; Martin,0,5,20,20
1746540751561,SYN 100,C01,906140,Deavenport; James Cary,0,3,20,20
1746540751561,SYN 100,D01,907816,Deavenport; James Cary,0,5,20,20
1746540752590,TDAC 1,A00,890286,Walsh; Kim C.,9,0,20,11
1746540753618,TDAC 101,A00,890296,Basso; Beatrice,16,0,20,4
1746540754682,TDDE 131,A00,890297,Staff,47,0,50,3
1746540755706,TDDM 1,A00,890287,Weinberg; Sadie,25,0,30,5
1746540756736,TDGE 11,A00,890288,Fulton; Julia,137,0,200,63
1746540756736,TDGE 11,B00,890289,Castro; Robert Jess,184,0,200,16
1746540757765,TDGE 25,B00,957359,Walsh; Kim C.,3,0,20,17
1746540758791,TDGE 40,A01,890292,Power; Jade Yukana,27,0,30,3
1746540759820,TDGE 124,A00,890298,Havis; Allan,0,0,50,50
1746540760846,TDGE 131R,A00,890299,Burelle; Julie Sara Veronique,15,0,42,27
1746540761872,TDHT 101,A00,890300,Staff,10,0,20,10
1746540762902,TDHT 109,A01,890302,Anderson; Mysia Anyse,31,0,40,9
1746540763931,TDMV 1,A00,890293,Arcidiacono; Kristin,18,0,30,12
1746540764958,TDMV 2,A00,890294,Weinberg; Sadie,23,0,30,7
1746540765983,TDMV 3,A00,957878,Arcidiacono; Kristin,28,0,30,2
1746540768039,TDMV 138,A00,890304,Jun; Grace Shin Hae,25,0,40,15
1746540769065,TDMV 140,A00,890305,Corrales; Joseph Bernales,25,0,30,5
1746540770094,TDMV 142,A00,890307,Caligagan; Tony,32,0,40,8
1746540771123,TDMV 144,A00,890308,Camaya; Michelle Ann,25,0,30,5
1746540772148,TDPW 1,A00,890295,Stein; Deborah Isobel,3,0,20,17
1746540773173,USP 2,A01,890272,Lerner; Amy M,6,0,20,14
1746540774198,USP 3,A01,890274,Staff,12,0,30,18
1746540775224,USP 15,A01,890276,Sun; Feiyang,17,0,30,13
1746540776253,USP 25,A00,890277,Shenkman; Michael Thomas,19,0,25,6
1746540777281,USP 138,A00,890278,Staff,13,0,25,12
1746540778308,USP 143,A00,890279,Staff,21,0,70,49
1746540779335,USP 144,A00,890280,Chowdhury; Muhammed Zohir,16,0,30,14
1746540780362,USP 150,A00,890281,Boomhower; Matthew Charles,4,0,30,26
1746540781386,USP 151,A00,890282,Staff,16,0,20,4
1746540782427,USP 162,A00,890283,Andrews; Abigail Leslie,16,0,20,4
1746540783454,USP 168,A00,920477,Kwak; Nancy,1,0,5,4
1746540784481,USP 181,A00,890284,Staff,3,0,20,17
1746540785506,USP 191A,A00,890285,Staff,13,0,20,7
1746540786531,VIS 101,A00,886512,Staff,25,0,75,50
1746540787557,VIS 103,A00,886513,Cruz; Edwin Teddy,61,0,75,14
1746540788585,VIS 108,A00,886514,Staff,3,0,15,12
1746540789615,VIS 127P,A00,886515,Shen; Kuiyi,80,0,146,66
1746540790642,VIS 149,A00,886516,Yoldas; Pinar,0,0,15,15
1746540791671,VIS 164,A00,886526,Erdmann; Dean,19,0,22,3
1746540792697,VIS 194S,A00,886527,Staff,61,0,75,14
1746540793725,WCWP 10A,C00,886484,Martiniuk; Jill,12,0,15,3
1746540794751,WCWP 10B,A00,886490,Uriarte; Emma,0,0,15,15
1746540794751,WCWP 10B,B00,886491,Dhir; Simrita,11,0,15,4
1746540794751,WCWP 10B,C00,886492,Ornelas; Tricia,0,0,15,15
1746540795777,WCWP 100,A00,886494,Young; Mark T,0,7,15,15
1746540797933,AAS 10,A01,886199,Childs; Dennis R.,0,3,0,0
1746540798958,ANAR 104,A01,886940,Shtienberg; Gilad,27,0,30,3
1746540800029,ANAR 120,A00,886953,Staff,12,0,20,8
1746540801055,ANBI 148,A01,886955,Wilder; Linnea Lorene,30,0,40,10
1746540803109,ANSC 122,A00,886957,Staff,25,0,30,5
1746540804134,ANSC 150,A00,886958,Sloane; Julia Kathryn,3,0,15,12
1746540805161,ANSC 156,A00,886959,Jenkins; Janis A.,0,1,15,15
1746540806190,ANSC 180,A00,886960,Staff,11,0,17,6
1746540807214,ANSC 188,A00,886961,Jassal; Aftab,9,0,25,16
1746540808242,ANSC 190,A00,886962,Jassal; Aftab,14,0,25,11
1746540809269,ANSC 191,A00,886963,Staff,18,0,20,2
1746540810298,ANTH 3,A01,891689,Staff,17,0,20,3
1746540811325,ANTH 5,A00,886933,Semendeferi; Ekaterini,16,0,20,4
1746540812351,ANTH 10,A00,886934,Staff,0,12,30,30
1746540813380,ANTH 21,A01,886936,Staff,40,0,60,20
1746540814405,ANTH 23,A01,886938,Staff,92,0,100,8
1746540815431,ANTH 105,A00,886964,Stewart; Alexander B,84,0,100,16
1746540816457,ANTH 108,A00,886965,Pedersen; David,9,0,20,11
1746540817486,AWP 10,001,886147,Staff,0,0,0,0
1746540817486,AWP 10,002,886148,Staff,0,0,0,0
1746540817486,AWP 10,003,886149,Staff,0,0,0,0
1746540817486,AWP 10,004,886150,Staff,0,0,0,0
1746540817486,AWP 10,005,886151,Staff,0,0,0,0
1746540817486,AWP 10,006,886152,Staff,0,0,0,0
1746540817486,AWP 10,007,886153,Staff,0,0,0,0
1746540817486,AWP 10,008,886154,Staff,0,0,0,0
1746540817486,AWP 10,009,886155,Staff,0,0,0,0
1746540817486,AWP 10,010,886156,Staff,0,0,0,0
1746540817486,AWP 10,011,886158,Staff,0,0,0,0
1746540817486,AWP 10,012,886160,Staff,0,0,0,0
1746540817486,AWP 10,013,886161,Staff,0,0,0,0
1746540817486,AWP 10,014,886162,Staff,0,0,0,0
1746540817486,AWP 10,015,886163,Staff,0,0,0,0
1746540817486,AWP 10,016,886164,Staff,0,0,0,0
1746540817486,AWP 10,017,886165,Staff,0,0,0,0
1746540817486,AWP 10,018,886166,Staff,0,0,0,0
1746540817486,AWP 10,019,886168,Staff,0,0,0,0
1746540817486,AWP 10,020,886170,Staff,0,0,0,0
1746540817486,AWP 10,021,886172,Staff,0,0,0,0
1746540818516,AWP 10R,001,886173,Staff,0,1,0,0
1746540818516,AWP 10R,002,886174,Staff,0,1,0,0
1746540818516,AWP 10R,003,886175,Staff,0,0,0,0
1746540818516,AWP 10R,004,886176,Staff,0,0,0,0
1746540818516,AWP 10R,005,886177,Staff,0,0,0,0
1746540818516,AWP 10R,006,886178,Staff,0,0,0,0
1746540818516,AWP 10R,007,886179,Staff,0,0,0,0
1746540818516,AWP 10R,008,886181,Staff,0,0,0,0
1746540818516,AWP 10R,009,886182,Staff,0,0,0,0
1746540818516,AWP 10R,010,886183,Staff,0,0,0,0
1746540818516,AWP 10R,011,886184,Staff,0,0,0,0
1746540818516,AWP 10R,012,886185,Staff,0,0,0,0
1746540818516,AWP 10R,013,886186,Staff,0,0,0,0
1746540818516,AWP 10R,014,886187,Staff,0,0,0,0
1746540818516,AWP 10R,015,886188,Staff,0,0,0,0
1746540818516,AWP 10R,016,886189,Staff,0,0,0,0
1746540819541,AWP 102R,A00,886190,Staff,0,0,0,0
1746540819541,AWP 102R,B00,886191,Staff,0,0,0,0
1746540820570,BENG 100,A01,886193,Staff,17,0,30,13
1746540821595,BENG 122A,A01,886195,Hasty; Jeff M,13,0,30,17
1746540822621,BENG 166A,A00,886196,Sah; Robert Lie-Yuan,0,1,30,30
1746540823647,BENG 190,A00,958050,Khojah; Reem I,24,0,25,1
1746540824670,BIBC 102,A01,894320,Staff,0,0,46,46
1746540824670,BIBC 102,A02,894321,Staff,1,0,46,45
1746540824670,BIBC 102,A03,894344,Staff,7,0,46,39
1746540824670,BIBC 102,A04,894345,Staff,26,0,47,21
1746540825698,BICD 100R,A01,894365,Smith; Laurie,0,3,58,58
1746540825698,BICD 100R,A02,894366,Smith; Laurie,0,5,58,58
1746540825698,BICD 100R,A03,894367,Smith; Laurie,2,0,59,57
1746540825698,BICD 100R,A04,959869,Smith; Laurie,41,0,59,18
1746540826731,BICD 136,A01,894383,Gustafson-Brown; Cindy,14,0,50,36
1746540827763,BIEB 102,A01,894494,Butler; Shannon Rhey,51,0,130,79
1746540829819,BIEB 150,A01,894617,Wills; Christopher,3,0,20,17
1746540829819,BIEB 150,A02,894631,Wills; Christopher,3,0,20,17
1746540829819,BIEB 150,A03,894937,Wills; Christopher,3,0,20,17
1746540829819,BIEB 150,A04,894946,Wills; Christopher,5,0,20,15
1746540830845,BIEB 194,A00,906141,Kurle; Carolyn M.,6,0,20,14
1746540831872,BILD 1,A01,894154,Staff,2,0,19,17
1746540831872,BILD 1,A02,894155,Staff,14,0,19,5
1746540831872,BILD 1,A03,894160,Staff,13,0,19,6
1746540831872,BILD 1,A04,894161,Staff,15,0,18,3
1746540832899,BILD 2,A01,894168,Staff,0,0,50,50
1746540832899,BILD 2,A02,894169,Staff,0,0,50,50
1746540832899,BILD 2,A03,894179,Staff,4,0,50,46
1746540832899,BILD 2,A04,894203,Staff,27,0,50,23
1746540833923,BILD 3,A01,894213,Staff,22,0,31,9
1746540833923,BILD 3,A02,894214,Staff,26,0,31,5
1746540833923,BILD 3,A03,894235,Staff,28,0,31,3
1746540833923,BILD 3,A04,894236,Staff,28,0,32,4
1746540834953,BILD 4,A01,894253,Reuther; Keefe,5,0,24,19
1746540834953,BILD 4,A02,894258,Reuther; Keefe,16,0,24,8
1746540835981,BILD 5,A01,894276,Reuther; Keefe,35,0,50,15
1746540835981,BILD 5,A02,894277,Reuther; Keefe,45,0,50,5
1746540835981,BILD 5,A03,894290,Reuther; Keefe,44,0,50,6
1746540835981,BILD 5,A04,894291,Reuther; Keefe,48,0,50,2
1746540837008,BILD 24,A01,894297,Pirino; Giorgia,40,0,60,20
1746540838040,BIMM 100,B01,958915,Staff,72,0,100,28
1746540839067,BIMM 101,A01,895017,McDonnell; Lisa Marie,0,5,24,24
1746540839067,BIMM 101,A02,895018,McDonnell; Lisa Marie,0,5,24,24
1746540839067,BIMM 101,B01,895020,McDonnell; Lisa Marie,0,6,24,24
1746540839067,BIMM 101,B02,895021,McDonnell; Lisa Marie,0,4,24,24
1746540840096,BIMM 110,A01,895023,Staff,1,0,25,24
1746540840096,BIMM 110,A02,895024,Staff,9,0,25,16
1746540840096,BIMM 110,A03,895025,Staff,18,0,25,7
1746540840096,BIMM 110,A04,895031,Staff,20,0,25,5
1746540841125,BIMM 120,A01,895114,Gustafson-Brown; Cindy,13,0,28,15
1746540841125,BIMM 120,A02,895126,Gustafson-Brown; Cindy,21,0,27,6
1746540842152,BIPN 100,A01,895130,Yang; Mingyu,1,0,38,37
1746540842152,BIPN 100,A02,895131,Yang; Mingyu,32,0,38,6
1746540842152,BIPN 100,A03,895132,Yang; Mingyu,32,0,38,6
1746540842152,BIPN 100,A04,895133,Yang; Mingyu,27,0,36,9
1746540843179,BIPN 120,A01,895135,Cooke; James Edward,0,3,13,13
1746540843179,BIPN 120,A02,895136,Cooke; James Edward,0,1,13,13
1746540843179,BIPN 120,A03,895137,Cooke; James Edward,0,3,13,13
1746540843179,BIPN 120,A04,895156,Cooke; James Edward,0,2,11,11
1746540844207,BIPN 134,A01,895235,Cooke; James Edward,0,2,25,25
1746540844207,BIPN 134,A02,895237,Cooke; James Edward,0,0,25,25
1746540844207,BIPN 134,A03,895240,Cooke; James Edward,3,0,25,22
1746540844207,BIPN 134,A04,895270,Cooke; James Edward,20,0,25,5
1746540845236,BIPN 189,A00,892103,Staff,0,13,14,14
1746540847286,BISP 194,A00,958008,Staff,0,2,0,0
1746540848313,CAT 124,A01,922009,Staff,0,5,20,20
1746540849342,CAT 125R,A00,886390,Morales; Celeste Georgianna,0,2,20,20
1746540849342,CAT 125R,B00,886391,Irwin; Matthew Joseph,0,3,20,20
1746540849342,CAT 125R,C00,886392,Smith; Lauryn Alissa,0,2,20,20
1746540849342,CAT 125R,D00,886393,Vanderschuit; Maya Alysia,0,2,20,20
1746540849342,CAT 125R,E00,886394,Marchisotto; Jennifer Anne,0,4,20,20
1746540850368,CENG 15,A01,886218,Drews; Aaron,3,0,8,5
1746540851401,CENG 113,A00,886219,Opatkiewicz; Justin Paul,15,0,25,10
1746540852425,CGS 101,A00,887044,Staff,7,0,20,13
1746540853452,CGS 105,A01,887046,Staff,14,0,25,11
1746540854478,CGS 112,A00,887047,Cuong; Marisol,12,0,15,3
1746540855509,CGS 113,A00,887048,Staff,23,0,30,7
1746540856533,CGS 120,A00,887049,Staff,10,0,17,7
1746540857562,CHEM 6A,A01,886336,Lam; Tin Yiu,38,0,50,12
1746540857562,CHEM 6A,A02,886338,Lam; Tin Yiu,37,0,50,13
1746540858646,CHEM 6B,A01,886341,Hopkins; Patrycja Anna,16,0,50,34
1746540858646,CHEM 6B,A02,886343,Hopkins; Patrycja Anna,42,0,50,8
1746540859675,CHEM 6C,A01,886346,Albizati; Kim F.,0,2,50,50
1746540859675,CHEM 6C,A02,886348,Albizati; Kim F.,23,0,50,27
1746540860701,CHEM 40A,A01,886352,Klosterman; Jeremy K,65,0,100,35
1746540861726,CHEM 40B,A01,886356,Klosterman; Jeremy K,0,23,100,100
1746540862752,CHEM 41B,A01,886360,Theodorakis; Emmanuel,25,0,50,25
1746540862752,CHEM 41B,A02,886362,Theodorakis; Emmanuel,47,0,50,3
1746540863782,CHIN 165A,A00,886382,Xu; Li,18,0,20,2
1746540864810,CLAS 120,A00,886387,Myerston Santana; Jacobo,33,0,40,7
1746540865839,COGS 9,A01,886967,Shannon; Kyle Michael,42,0,60,18
1746540866864,COGS 11,A01,886969,Staff,11,0,30,19
1746540867891,COGS 14A,A01,886971,Staff,6,0,60,54
1746540868917,COGS 14B,A01,886973,Hoffman; Drew Ellen,4,0,60,56
1746540869944,COGS 18,A01,886975,Morgan; Eric,35,0,60,25
1746540870970,COGS 20,A01,886977,Staff,4,0,8,4
1746540870970,COGS 20,A02,886978,Staff,5,0,7,2
1746540871996,COGS 100,A01,907783,Staff,0,2,30,30
1746540873021,COGS 101B,A01,886980,Staff,0,3,48,48
1746540874050,COGS 101C,A01,886982,Delgado; Tania,0,5,44,44
1746540875083,COGS 102A,A01,886984,Johnson; Christine M.,4,0,30,26
1746540876110,COGS 118B,A01,886986,Staff,0,3,88,88
1746540877136,COGS 150,A01,886988,Bergen; Benjamin,23,0,50,27
1746540878164,COGS 153,A00,886989,Delgado; Tania,0,2,41,41
1746540879191,COGS 186,A01,886991,Staff,0,0,32,32
1746540880219,COGS 187A,A01,886993,Boyle; Mary E. T.,7,0,30,23
1746540881249,COGS 189,A00,886994,Staff,0,1,30,30
1746540882278,COMM 10,A01,886996,Staff,0,0,20,21
1746540882278,COMM 10,A02,886997,Staff,12,0,20,8
1746540882278,COMM 10,A03,959845,Staff,19,0,20,1
1746540883304,COMM 20,A01,886999,Leuning; Grant Maurstad,24,0,40,16
1746540885356,COMM 100A,A01,887002,Staff,0,0,20,25
1746540885356,COMM 100A,A02,887003,Staff,7,0,20,13
1746540886383,COMM 100B,A01,887005,Staff,0,8,20,24
1746540887413,COMM 106D,A00,887006,Staff,14,0,40,26
1746540888438,COMM 110G,A00,887007,Whitworth-Smith; Andrew C,12,0,40,28
1746540889466,COMM 111B,A00,887008,Staff,31,0,40,9
1746540890495,COMM 113T,A00,887009,Abuelhiga; Soraya Jill,28,0,40,12
1746540890495,COMM 113T,B00,906733,Staff,40,0,40,0
1746540891519,COMM 145,A00,887010,Staff,12,0,40,28
1746540892546,COMM 146,A00,887054,Staff,31,0,40,9
1746540893575,COMM 190,A00,887012,Staff,8,0,23,15
1746540894600,CSE 8A,A50,887015,Cao; Yingjun,57,0,85,28
1746540895629,CSE 11,A01,887017,Cao; Yingjun,12,0,70,58
1746540896656,CSE 20,A01,887019,Staff,30,0,50,20
1746540897686,CSE 21,A01,887021,Staff,78,0,100,22
1746540897686,CSE 21,B01,892583,Braun; Oliver,45,0,50,5
1746540898713,CSE 30,A01,887025,Eldon; John,143,0,200,57
1746540899740,CSE 100,A01,887027,Staff,26,0,50,24
1746540899740,CSE 100,A02,887028,Staff,40,0,50,10
1746540900770,CSE 101,A01,887030,Braun; Oliver,75,0,100,25
1746540900770,CSE 101,B01,887032,Jones; Miles E,0,3,50,50
1746540900770,CSE 101,B02,887033,Jones; Miles E,0,1,50,50
1746540901796,CSE 105,A01,908084,Jones; Miles E,32,0,50,18
1746540901796,CSE 105,A02,908087,Jones; Miles E,33,0,50,17
1746540902826,CSE 135,A01,887035,Powell; Thomas Allan,0,4,50,50
1746540903852,CSE 142,A01,887037,Staff,8,0,60,52
1746540904880,CSE 142L,A01,887039,Staff,34,0,60,26
1746540905909,CSE 151A,A01,887041,Solares; Edwin A,48,0,100,52
1746540906936,CSE 175,A01,887043,Kumar; Rakesh,30,0,30,0
1746540907963,CSS 1,A01,886389,Staff,0,1,40,40
1746540908988,DSC 30,A01,908097,Liao; Soohyun Nam,47,0,75,28
1746540910017,DSC 40A,A01,908099,Shannon; Kyle Michael,30,0,50,20
1746540911044,DSC 40B,A01,908112,Staff,16,0,50,34
1746540912072,DSC 80,A01,908116,Staff,19,0,60,41
1746540913103,DSC 197,001,956863,Eldridge; Justin Matthew,9999,0,9999,0
1746540914129,ECE 5,A01,886400,Morris; Karcher William,2,0,6,4
1746540914129,ECE 5,A02,886401,Morris; Karcher William,3,0,6,3
1746540915156,ECE 148,A01,886403,Silberman; Jack,0,14,14,14
1746540916186,ECON 1,A01,887265,Crane; Meredith Helen,12,0,70,58
1746540916186,ECON 1,B01,887268,Staff,43,0,50,7
1746540917212,ECON 2,A01,887273,Crane; Meredith Helen,56,0,70,14
1746540918239,ECON 3,A01,887279,Rondina; Giacomo,32,0,70,38
1746540919266,ECON 4,A01,887282,Anderson; John Charles,0,2,10,10
1746540920295,ECON 5,A01,887285,Staff,33,0,45,12
1746540920295,ECON 5,B01,887292,Staff,41,0,45,4
1746540921323,ECON 100A,A01,887337,Newhouse; Herbert S,54,0,70,16
1746540921323,ECON 100A,B01,887349,Staff,45,0,50,5
1746540922353,ECON 100B,A01,887361,Du; Songzi,29,0,70,41
1746540923382,ECON 100C,A01,887445,Newhouse; Herbert S,59,0,70,11
1746540924411,ECON 105,A00,887488,Vespa; Emanuel Ignacio,23,0,35,12
1746540925439,ECON 109,A01,887506,Shishkin; Denis,28,0,35,7
1746540926471,ECON 110A,A01,887568,Alon; Titan Michael,0,3,35,35
1746540926471,ECON 110A,B01,907601,Alon; Titan Michael,20,0,35,15
1746540927498,ECON 110B,A01,887598,Levkoff; Steven B.,0,23,70,70
1746540928523,ECON 112,A00,887599,Rondina; Giacomo,19,0,35,16
1746540929555,ECON 120A,A01,887603,Dai; Yinlin,36,0,70,34
1746540930582,ECON 120C,A01,887608,Sun; Yixiao,0,1,35,35
1746540930582,ECON 120C,B01,887614,Sun; Yixiao,0,0,35,35
1746540931607,ECON 138,A00,887621,Bharadwaj; Prashant,0,20,20,20
1746540932634,ECON 144,A00,958007,Squires; Dale E,13,0,35,22
1746540933660,ECON 171,A01,907666,Staff,18,0,35,17
1746540934691,ECON 175,A00,887626,Wu; Pak Yeung,23,0,35,12
1746540935720,ECON 190,A00,887640,Vespa; Emanuel Ignacio,23,0,35,12
1746540936752,EDS 25,A01,888197,Staff,0,0,0,0
1746540936752,EDS 25,A02,888209,Staff,0,0,0,0
1746540936752,EDS 25,A03,888210,Staff,0,0,0,0
1746540936752,EDS 25,A04,888212,Staff,0,0,0,0
1746540936752,EDS 25,A05,888213,Staff,0,0,0,0
1746540936752,EDS 25,A06,888214,Staff,0,0,0,0
1746540936752,EDS 25,A07,888235,Staff,0,2,0,0
1746540936752,EDS 25,A08,888236,Staff,0,0,0,0
1746540936752,EDS 25,A09,888240,Staff,0,0,0,0
1746540936752,EDS 25,A10,888244,Staff,0,0,0,0
1746540936752,EDS 25,B01,888273,Staff,0,0,0,0
1746540936752,EDS 25,B02,888285,Staff,0,0,0,0
1746540936752,EDS 25,B03,888423,Staff,0,0,0,1
1746540936752,EDS 25,B04,888432,Staff,0,0,0,0
1746540936752,EDS 25,B05,888433,Staff,0,0,0,0
1746540936752,EDS 25,B06,888467,Staff,0,0,0,0
1746540936752,EDS 25,B07,888468,Staff,0,0,0,0
1746540936752,EDS 25,B08,888479,Staff,0,0,0,0
1746540936752,EDS 25,B09,888484,Staff,0,0,0,0
1746540936752,EDS 25,B10,888487,Staff,0,0,0,0
1746540937779,EDS 38,A01,907700,Choi; Bailey Miyeon,30,0,30,0
1746540938804,EDS 112,A01,888601,Chapman; Thandeka K,14,0,40,26
1746540939834,EDS 115,A00,888697,Mendez; Kathrina Mendoza,10,0,30,20
1746540940864,EDS 116,A01,888893,Staff,35,0,40,5
1746540942914,EDS 124AR,A00,889133,Staff,29,0,50,21
1746540942914,EDS 124AR,B00,907471,Simon; Elizabeth A,37,0,50,13
1746540943943,EDS 124BR,A00,889134,Simon; Elizabeth A,45,0,100,55
1746540944976,EDS 125,A00,889135,Staff,25,0,30,5
1746540946001,EDS 126,A01,889138,Staff,36,0,40,4
1746540947030,EDS 164R,A01,889142,Wishard Guerra; Alison G.,33,0,50,17
1746540948057,ENG 30,A01,886396,Staff,0,0,0,0
1746540948057,ENG 30,B01,886398,Staff,0,0,0,0
1746540949084,ENVR 102,A00,906150,Montejo; Carolina,23,0,25,2
1746540950110,ETHN 103A,A00,887236,Man; Simeon S,0,3,0,0
1746540951135,ETHN 113,A00,887239,Staff,16,0,30,14
1746540952164,ETHN 116,A00,887240,Staff,16,0,25,9
1746540953192,ETHN 117,A00,887241,Choi; Esther Min,28,0,30,2
1746540954222,ETHN 118,A00,887243,Staff,24,0,30,6
1746540955254,ETHN 127,A00,887248,Cuong; Marisol,11,0,15,4
1746540956283,ETHN 139,A00,887250,Staff,7,0,10,3
1746540957314,ETHN 142,A00,887252,Staff,10,0,30,20
1746540958338,ETHN 161,A00,887253,Browne; Errol Tsekani,24,0,30,6
1746540959365,ETHN 163FR,A00,887255,Burelle; Julie Sara Veronique,0,0,5,5
1746540960396,GLBH 20,A00,889149,Elwardani; Nile Regina,8,0,42,34
1746540962450,GLBH 111,A01,889152,Burgos; Jose L.,17,0,17,0
1746540963477,GLBH 150,A00,889181,Sloane; Julia Kathryn,0,5,15,15
1746540965537,HDS 60,A01,886406,Warstadt; Melissa Fawn,73,0,80,7
1746540966565,HIAF 111,A00,889324,Gyamfi; Bright,25,0,32,7
1746540967591,HIEA 131,A00,889328,Staff,16,0,32,16
1746540968622,HIEA 144,A00,889333,Henry; Todd A.,26,0,32,6
1746540969650,HIEA 154,A00,889336,Henry; Todd A.,24,0,32,8
1746540970679,HIEU 106,A00,889339,Staff,22,0,32,10
1746540972730,HIEU 114,A00,889340,Staff,3,0,32,29
1746540973757,HIEU 135GS,A00,889342,Patterson; Patrick H.,0,0,1,24
1746540974781,HIEU 137,A00,889343,Edington; Claire Ellen,9,0,25,16
1746540975808,HIEU 148,A00,889345,Staff,14,0,32,18
1746540976833,HIEU 154,A00,889346,Biess; Frank Peter,21,0,32,11
1746540977857,HILA 102,A00,889351,Staff,12,0,32,20
1746540978887,HILD 2A,A01,889221,Lewandoski; Julia Mavis,1,10,32,31
1746540979912,HILD 7B,A01,889225,Man; Simeon S,0,13,32,32
1746540980943,HILD 7C,A01,889288,Alvarez; Luis A,0,14,32,32
1746540981972,HILD 30,A01,889323,Staff,0,5,32,32
1746540984025,HISC 119,A00,889383,Golan; Tal,21,0,32,11
1746540985055,HIUS 103,A00,889384,Man; Simeon S,0,0,32,32
1746540986082,HIUS 117,A00,919797,Kwak; Nancy,18,0,32,14
1746540987107,HIUS 142A,A00,919788,Staff,22,0,32,10
1746540989160,HIUS 149,A00,889386,Gyamfi; Bright,27,0,32,5
1746540990188,HIUS 155,A00,889387,Alvarez; Luis A,14,0,32,18
1746540991218,HUM 3,A01,886499,Caldwell; Michael Alan,19,0,50,31
1746540992245,HUM 3GS,A00,886500,Rodriguez; Bretton Sigfred,0,0,0,28
1746540993277,HUM 3R,A01,886502,Markman; Kristina,0,36,50,50
1746540994307,HUM 4,A01,886504,Crum; Matthew Stephen,24,0,50,26
1746540994307,HUM 4,B01,886506,West; Geoffrey Scott,17,0,50,33
1746540995332,HUM 4GS,A00,886507,Staff,0,0,0,19
1746540996357,HUM 5,A01,886509,Staff,32,0,50,18
1746540997381,HUM 5R,A01,886511,Zavodny; Tatiana Sophia,0,39,50,50
1746540998411,JAPN 180,A00,886407,Staff,18,0,40,22
1746540999442,LATI 50,A01,886409,Martin-Cabrera; Luis,4,0,22,18
1746540999442,LATI 50,A02,886410,Martin-Cabrera; Luis,19,0,22,3
1746540999442,LATI 50,A03,886411,Martin-Cabrera; Luis,21,0,22,1
1746540999442,LATI 50,A04,886412,Martin-Cabrera; Luis,9,0,22,13
1746541000468,LAWS 101,A00,907664,Staff,28,0,60,32
1746541001494,LIAB 1A,A00,889388,Saab; Dima,17,0,20,3
1746541002519,LIAB 1AX,A00,889389,El Cheddadi; Youniss,17,0,20,3
1746541003546,LIFR 1C,A00,889391,Van Moer; Vinciane G,8,0,20,12
1746541004573,LIFR 1CX,A00,889392,Van Moer; Vinciane G,7,0,20,13
1746541005599,LIFR 1D,A00,889393,Van Moer; Vinciane G,7,0,20,13
1746541006625,LIFR 1DX,A00,889394,Van Moer; Vinciane G,8,0,20,12
1746541007651,LIGN 7,A00,886923,Staff,24,0,50,26
1746541008682,LIGN 17,A00,886924,Kehler; Andrew Scott,125,0,150,25
1746541009708,LTAM 110,A00,889395,Staff,15,0,30,15
1746541010736,LTAM 110GS,A00,958010,Rodriguez; Bretton Sigfred,0,0,0,28
1746541011762,LTCH 101,A00,889397,Staff,23,0,25,2
1746541012791,LTCS 130,A00,889398,Staff,23,0,25,2
1746541013815,LTEA 138,A00,889399,Staff,24,0,40,16
1746541014843,LTEN 149,A00,889400,Wesling; Megan E.,0,3,25,25
1746541015869,LTEN 169,A00,889401,Staff,20,0,25,5
1746541016894,LTEN 180,A00,889402,Staff,10,0,15,5
1746541017919,LTEN 181,A00,889403,Staff,21,0,25,4
1746541018950,LTWL 100,A00,889404,Myerston Santana; Jacobo,3,0,25,22
1746541019976,LTWL 180GS,A00,889405,Staff,0,0,20,20
1746541021002,LTWL 181,A00,889406,Staff,17,0,25,8
1746541022032,LTWL 184,A00,889475,Mukherjee; Silpa,22,0,25,3
1746541023057,LTWR 102C,A00,889486,Staff,29,0,30,1
1746541024083,LTWR 115W,A00,889491,Staff,0,2,15,15
1746541025111,MAE 8,A01,886905,Staff,0,2,0,0
1746541026140,MAE 11,A00,886906,Bandaru; Prabhakar,0,7,50,50
1746541027164,MAE 20,A00,886907,Evdokimenko; Ekaterina,44,0,70,26
1746541028190,MAE 30B,A00,886909,Ghazinejad; Maziar,26,0,45,19
1746541029218,MAE 101B,A00,886910,Saintillan; David,29,0,45,16
1746541030246,MAE 105,A00,886911,Bandaru; Prabhakar,18,0,50,32
1746541031275,MAE 107,B00,958024,Staff,9,0,50,41
1746541032302,MAE 143B,A00,886913,Bewley; Thomas R,7,0,40,33
1746541033327,MAE 148,A01,886915,Silberman; Jack,0,3,14,14
1746541034357,MAE 160,A00,886916,Evdokimenko; Ekaterina,31,0,60,29
1746541035389,MATH 3C,A01,889681,Staff,0,3,30,30
1746541035389,MATH 3C,A02,960048,Staff,25,0,30,5
1746541036417,MATH 10A,A01,889760,Staff,26,0,30,4
1746541036417,MATH 10A,A02,889783,Staff,29,0,30,1
1746541037445,MATH 10B,A01,889785,Verstraete; Jacques Allan,2,0,35,33
1746541037445,MATH 10B,A02,889795,Verstraete; Jacques Allan,4,0,35,31
1746541037445,MATH 10B,B01,889797,Verstraete; Jacques Allan,3,0,35,32
1746541037445,MATH 10B,B02,889828,Verstraete; Jacques Allan,3,0,35,32
1746541038473,MATH 10C,A01,889849,Habib; Yousaf,9,0,30,21
1746541038473,MATH 10C,A02,889852,Habib; Yousaf,14,0,30,16
1746541038473,MATH 10C,A03,889853,Habib; Yousaf,22,0,30,8
1746541038473,MATH 10C,A04,889858,Habib; Yousaf,20,0,30,10
1746541038473,MATH 10C,B01,889861,Staff,1,0,30,29
1746541038473,MATH 10C,B02,889862,Staff,24,0,30,6
1746541038473,MATH 10C,B03,889863,Staff,27,0,30,3
1746541038473,MATH 10C,B04,889967,Staff,23,0,30,7
1746541039503,MATH 18,A01,889974,Staff,7,0,30,23
1746541039503,MATH 18,A02,889977,Staff,20,0,30,10
1746541039503,MATH 18,B01,889984,Hardiman; Liam,22,0,30,8
1746541039503,MATH 18,B02,889985,Hardiman; Liam,25,0,30,5
1746541040529,MATH 20A,A01,889990,Suk; Andrew Hoon,29,0,35,6
1746541041555,MATH 20B,A01,889993,Ohm; Ko Woon,22,0,30,8
1746541041555,MATH 20B,A02,889994,Ohm; Ko Woon,30,0,30,0
1746541041555,MATH 20B,B01,889996,Ohm; Ko Woon,21,0,30,9
1746541041555,MATH 20B,B02,889997,Ohm; Ko Woon,23,0,30,7
1746541042581,MATH 20C,A01,889999,Hammock; Frances H,17,0,30,13
1746541042581,MATH 20C,A02,890003,Hammock; Frances H,23,0,30,7
1746541042581,MATH 20C,B01,890006,Hammock; Frances H,3,0,30,27
1746541042581,MATH 20C,B02,890007,Hammock; Frances H,11,0,30,19
1746541043606,MATH 20D,A01,890011,Cheng; Hsiao-Bing,1,1,30,29
1746541043606,MATH 20D,A02,890012,Cheng; Hsiao-Bing,14,0,30,16
1746541043606,MATH 20D,B01,890016,Cheng; Hsiao-Bing,13,0,30,17
1746541043606,MATH 20D,B02,890017,Cheng; Hsiao-Bing,13,0,30,17
1746541044632,MATH 20E,A01,890026,Harel; Guershon,1,0,30,29
1746541044632,MATH 20E,A02,890029,Harel; Guershon,23,0,30,7
1746541044632,MATH 20E,B01,890033,Harel; Guershon,7,0,30,23
1746541044632,MATH 20E,B02,890101,Harel; Guershon,21,0,30,9
1746541045659,MATH 102,A01,890104,Staff,17,0,30,13
1746541045659,MATH 102,A02,890105,Staff,27,0,30,3
1746541046684,MATH 103B,A01,890116,Salehi Golsefidy; Alireza,3,0,30,27
1746541046684,MATH 103B,B01,890118,Staff,0,3,34,34
1746541047715,MATH 109,A01,890121,Aliabadi Sr.; Mohsen,1,0,30,29
1746541047715,MATH 109,B01,890124,Upadrashta; Pranav Kumar,18,0,30,12
1746541048743,MATH 120A,A01,890126,Eggers; John Dietrich,13,0,30,17
1746541049769,MATH 142B,A01,890128,Ioana; Adrian,19,0,30,11
1746541049769,MATH 142B,A02,890129,Ioana; Adrian,13,0,30,17
1746541050797,MATH 154,A01,890174,Staff,0,0,30,30
1746541050797,MATH 154,A02,890182,Staff,0,0,30,30
1746541051823,MATH 168A,A01,890197,Dumitriu; Ioana,21,0,35,14
1746541052850,MATH 170A,A01,890240,Nie; Jiawang,1,0,30,29
1746541052850,MATH 170A,A02,890241,Nie; Jiawang,11,0,30,19
1746541052850,MATH 170A,A03,890249,Nie; Jiawang,23,0,30,7
1746541053876,MATH 170B,A01,957891,Nag; Panchali,13,0,35,22
1746541055928,MATH 181A,A01,908025,Staff,0,4,35,35
1746541055928,MATH 181A,A02,960115,Staff,27,0,35,8
1746541056952,MATH 181B,A01,959874,Staff,26,0,30,4
1746541057982,MATH 193B,A01,890265,Staff,0,4,35,35
1746541059008,MGT 4,A01,890311,Anderson; John Charles,42,0,88,46
1746541060035,MGT 5,A00,907740,Staff,13,0,98,85
1746541061063,MGT 12,A00,890312,Lindenberger; Wade Douglas,67,0,98,31
1746541062090,MGT 16,A00,957883,Staff,78,0,98,20
1746541064144,MGT 45,A00,890314,Pecore; Joseph P.,47,0,98,51
1746541065170,MGT 71,A00,890315,Staff,0,11,98,98
1746541066249,MGT 100,A00,890316,Yavorsky; Daniel Ryan,44,0,98,54
1746541067277,MGT 103,A00,890317,Ehrich; Kristine R,73,0,98,25
1746541068305,MGT 105,A00,890356,Bates; Kenneth Walter,0,7,98,98
1746541069328,MGT 112,A00,890360,Ehrich; Kristine R,55,0,98,43
1746541070353,MGT 127R,A00,907732,Zhu; Kevin Xiaoguo,23,0,98,75
1746541071382,MGT 131B,A00,890361,Anderson; John Charles,61,0,98,37
1746541072421,MGT 137,A00,890362,Lindenberger; Wade Douglas,65,0,98,33
1746541073451,MGT 160,A00,890369,Johnson; Erik Barry,9,0,98,89
1746541075505,MGT 164,A00,890372,Zimmermann; Carsten,0,39,98,98
1746541076534,MGT 180,A00,890374,Bliss; Barbara Ann,12,0,98,86
1746541077564,MMW 15,A01,886414,Chang; Edmond Yi-Teh,0,12,28,28
1746541077564,MMW 15,A02,886415,Chang; Edmond Yi-Teh,0,8,28,28
1746541077564,MMW 15,A03,886416,Chang; Edmond Yi-Teh,0,8,28,28
1746541077564,MMW 15,A04,886417,Chang; Edmond Yi-Teh,0,8,28,28
1746541077564,MMW 15,B01,886419,Chang; Edmond Yi-Teh,0,7,28,28
1746541077564,MMW 15,B02,886420,Chang; Edmond Yi-Teh,0,8,28,28
1746541077564,MMW 15,B03,886421,Chang; Edmond Yi-Teh,0,7,28,28
1746541077564,MMW 15,B04,886422,Chang; Edmond Yi-Teh,0,8,28,28
1746541077564,MMW 15,C01,886424,Staff,0,9,28,28
1746541077564,MMW 15,C02,886425,Staff,0,8,28,28
1746541077564,MMW 15,C03,886426,Staff,0,8,28,28
1746541077564,MMW 15,C04,886427,Staff,0,7,28,28
1746541077564,MMW 15,C05,958038,Staff,0,7,28,28
1746541077564,MMW 15,C06,958039,Staff,0,8,28,28
1746541078591,MMW 15GS,A00,906910,Patterson; Patrick H.,4,0,28,24
1746541079617,MMW 122R,A01,886429,Rahimi; Babak,0,13,28,28
1746541079617,MMW 122R,A02,886430,Rahimi; Babak,0,12,28,28
1746541079617,MMW 122R,A03,958040,Rahimi; Babak,0,11,28,28
1746541080644,MUS 1A,A01,890937,Staff,3,0,25,22
1746541080644,MUS 1A,A02,891035,Staff,6,0,25,19
1746541080644,MUS 1A,C01,958912,Staff,24,0,25,1
1746541080644,MUS 1A,C02,958913,Staff,25,0,25,0
1746541082701,MUS 2AK,A00,957092,Ohnishi; Takae,15,0,15,0
1746541083727,MUS 4,A01,891044,Staff,2,0,25,23
1746541083727,MUS 4,A02,891045,Staff,23,0,25,2
1746541083727,MUS 4,B01,891048,Staff,17,0,25,8
1746541083727,MUS 4,B02,891050,Staff,25,0,25,0
1746541084754,MUS 5,A01,957506,Dubnov; Shlomo,0,0,25,25
1746541084754,MUS 5,A02,957622,Dubnov; Shlomo,14,0,25,11
1746541084754,MUS 5,A03,957623,Dubnov; Shlomo,20,0,25,5
1746541085786,MUS 6,A01,891053,Freitas Caetano; Marcelo,24,0,25,1
1746541085786,MUS 6,A02,891054,Freitas Caetano; Marcelo,23,0,25,2
1746541086812,MUS 7,A01,891081,Staff,0,0,25,25
1746541086812,MUS 7,A02,891082,Staff,4,0,25,21
1746541087842,MUS 8GS,A00,891118,Borgo; David Garcia,0,0,25,25
1746541088871,MUS 11,A01,891140,Staff,11,0,25,14
1746541088871,MUS 11,A02,891141,Staff,22,0,25,3
1746541089897,MUS 13,A01,891143,Staff,8,0,25,17
1746541089897,MUS 13,A02,891144,Staff,24,0,25,1
1746541090926,MUS 15,A01,891146,Staff,9,0,25,16
1746541090926,MUS 15,A02,891148,Staff,21,0,25,4
1746541090926,MUS 15,B01,891150,Staff,18,0,25,7
1746541090926,MUS 15,B02,891151,Staff,25,0,25,0
1746541091953,MUS 20,A01,891153,Staff,5,0,20,15
1746541091953,MUS 20,A02,891155,Staff,14,0,20,6
1746541092977,MUS 80,A00,891156,Staff,19,0,25,6
1746541092977,MUS 80,B00,891157,Staff,23,0,25,2
1746541094001,MUS 130,A00,891158,Ohnishi; Takae,35,0,35,0
1746541095034,MUS 150GS,A01,891160,Borgo; David Garcia,0,0,25,25
1746541096064,MUS 170,A01,891162,Freitas Caetano; Marcelo,20,0,25,5
1746541096064,MUS 170,A02,891164,Freitas Caetano; Marcelo,21,0,25,4
1746541097090,NANO 11,A00,886220,Vazquez Mena; Oscar,13,0,15,2
1746541098114,NANO 15,A01,886222,Drews; Aaron,4,0,7,3
1746541099139,NANO 104,A00,886224,Sirbuly; Donald,18,0,25,7
1746541100165,PH 40,A00,886528,Staff,23,0,40,17
1746541101195,PH 45,A01,886799,Staff,35,0,40,5
1746541102220,PH 110,A00,886802,Staff,0,7,40,40
1746541103251,PH 172,A00,906716,Staff,19,0,35,16
1746541104278,PH 191,A00,886803,Staff,6,0,40,34
1746541105307,PHIL 1,A00,889500,Staff,19,0,30,11
1746541106333,PHIL 10,A01,889549,Grush; Rick Scott,15,0,22,7
1746541106333,PHIL 10,A02,889551,Grush; Rick Scott,22,0,22,0
1746541107362,PHIL 28,A01,889559,Lamey; Andy M.,0,1,31,31
1746541107362,PHIL 28,A02,889561,Lamey; Andy M.,0,1,30,30
1746541107362,PHIL 28,A03,889572,Lamey; Andy M.,0,0,30,30
1746541108388,PHIL 35,A00,907839,Staff,13,0,15,2
1746541109418,PHIL 60,A00,889574,Staff,74,0,90,16
1746541110444,PHIL 101,A00,958004,Staff,13,0,15,2
1746541112496,PHIL 136,A00,889582,Fulkerson; Matthew Todd,26,0,45,19
1746541113528,PHIL 163,A01,889601,Staff,21,0,30,9
1746541113528,PHIL 163,B01,889606,Brandt; Reuven A,0,3,0,0
1746541114554,PHIL 164,A00,889610,Staff,16,0,30,14
1746541115583,PHIL 165,A00,889613,Staff,23,0,30,7
1746541116609,PHYS 1A,A00,886431,Staff,26,0,70,44
1746541117635,PHYS 1AL,001,886432,Tsai; Philbert S,0,2,30,30
1746541117635,PHYS 1AL,002,886436,Tsai; Philbert S,11,0,30,19
1746541118665,PHYS 1B,A00,886439,Staff,185,0,240,55
1746541119691,PHYS 1BL,001,886441,Tsai; Philbert S,0,4,30,30
1746541119691,PHYS 1BL,002,886444,Tsai; Philbert S,2,0,30,28
1746541120717,PHYS 1C,A00,896092,Arnold; Kam S,78,0,146,68
1746541121750,PHYS 1CL,001,886448,Tsai; Philbert S,0,0,30,30
1746541121750,PHYS 1CL,002,886449,Tsai; Philbert S,0,0,30,30
1746541121750,PHYS 1CL,003,886450,Tsai; Philbert S,15,0,30,15
1746541121750,PHYS 1CL,004,886451,Tsai; Philbert S,15,0,30,15
1746541122780,PHYS 2B,A01,886457,Staff,69,0,115,46
1746541123807,PHYS 2C,A01,886460,Shotwell; Brian,0,8,65,65
1746541124831,PHYS 2CL,A01,886467,Staff,0,4,28,28
1746541124831,PHYS 2CL,A02,886468,Staff,0,3,28,28
1746541125856,PHYS 2D,A01,886470,Staff,10,0,50,40
1746541126880,PHYS 4B,A01,886475,Grinstein; Benjamin,22,0,40,18
1746541127907,POLI 5,A00,891173,Desposato; Scott,7,0,25,18
1746541128934,POLI 5D,A01,891175,Staff,5,0,5,0
1746541128934,POLI 5D,B01,891178,Staff,5,0,5,0
1746541129966,POLI 11,A00,891179,Ferree; Karen E,2,0,35,33
1746541130995,POLI 12,A00,891180,Staff,16,0,30,14
1746541132021,POLI 27,A01,891182,Staff,12,0,75,63
1746541133047,POLI 30,A00,891183,Staff,9,0,50,41
1746541134075,POLI 100B,A00,891244,Staff,5,1,35,30
1746541135101,POLI 100I,A00,891247,Staff,7,0,30,23
1746541136126,POLI 104J,A00,891248,Nichter; Maysa,14,0,30,16
1746541137154,POLI 104U,A00,891250,Nichter; Maysa,2,0,30,28
1746541139206,POLI 110B,A00,891255,Wiens; David,20,0,25,5
1746541140231,POLI 112A,A00,891256,Wiens; David,6,0,25,19
1746541141260,POLI 114BR,A00,891261,Staff,19,0,30,11
1746541142288,POLI 117R,A00,891262,Forman; Fonna,0,6,50,50
1746541143317,POLI 118,A00,891264,Ingham; Sean,17,0,25,8
1746541144343,POLI 124A,A00,891265,Staff,18,0,20,2
1746541145373,POLI 125D,A00,891266,Nichter; Simeon C,2,0,25,23
1746541146401,POLI 126,A00,891268,Nichter; Simeon C,7,0,25,18
1746541147427,POLI 126AA,A00,891272,Staff,18,0,25,7
1746541148452,POLI 130AA,A00,891273,Staff,15,0,20,5
1746541149478,POLI 134AA,A00,891274,Staff,4,0,20,16
1746541151531,POLI 138,A00,891278,Staff,21,0,25,4
1746541152559,POLI 142K,A00,891280,Staff,11,0,25,14
1746541153585,POLI 142M,A00,891281,Gartzke; Erik,17,0,30,13
1746541154613,POLI 142P,A00,891284,Staff,20,0,30,10
1746541155637,POLI 143,A00,891285,Gartzke; Erik,12,0,30,18
1746541156664,POLI 153,A00,891286,Staff,19,0,20,1
1746541158753,POLI 175,A00,891290,Staff,15,0,20,5
1746541159787,PSYC 1,A00,890674,Steiner; Eric Tomas,0,11,45,45
1746541160815,PSYC 2,A00,890676,Albright; Thomas D,21,0,35,14
1746541161842,PSYC 3,A00,890679,Staff,17,0,20,3
1746541162870,PSYC 6,A00,959858,Staff,20,0,20,0
1746541163898,PSYC 60,A01,890684,Rickard; Timothy C.,0,5,45,45
1746541164925,PSYC 70,A01,890689,Geller; Emma Harlan,7,0,30,23
1746541165951,PSYC 71,A01,959860,Staff,21,0,25,4
1746541166980,PSYC 100,A00,890690,Lacefield; Katharine I,0,50,180,180
1746541168007,PSYC 102,A00,890695,Staff,18,0,40,22
1746541169037,PSYC 105,A00,890699,Geller; Emma Harlan,71,0,100,29
1746541170063,PSYC 106,A00,890701,Gorman; Michael R.,5,0,30,25
1746541171092,PSYC 108,A00,890704,Adrian; Julia Anna,0,28,50,50
1746541172119,PSYC 118,A01,890712,Staff,11,0,30,19
1746541173148,PSYC 124,A00,890716,Chapman; Eddie Nathaniel,25,0,60,35
1746541174172,PSYC 131,A00,890717,Anagnostaras; Stephan,0,7,80,80
1746541175198,PSYC 137,A00,890719,Winkielman; Piotr,0,11,30,30
1746541176227,PSYC 144,A00,890721,Adrian; Julia Anna,0,9,45,45
1746541177253,PSYC 162,A00,890805,Staff,2,0,75,73
1746541178278,PSYC 169,A00,890810,Staff,0,15,30,30
1746541179305,PSYC 172,A00,890814,Gorman; Michael R.,9,0,30,21
1746541180330,PSYC 181,A00,890818,Anagnostaras; Stephan,8,0,200,192
1746541181355,PSYC 184,A00,959861,Staff,170,0,175,5
1746541182379,PSYC 189,A00,890823,Staff,0,1,30,30
1746541183404,PSYC 191,A00,890884,Rickard; Timothy C.,0,11,35,35
1746541184430,PSYC 193,A00,890913,Staff,19,0,30,11
1746541184430,PSYC 193,B00,890914,Chapman; Eddie Nathaniel,24,0,30,6
1746541185461,PSYC 193L,A01,890918,Lowe; Angela Beth,20,0,30,10
1746541185461,PSYC 193L,B01,890921,Hurwitz; Ethan Scott,20,0,30,10
1746541185461,PSYC 193L,C01,890928,Staff,30,0,30,0
1746541186487,RELI 149,A00,886806,Rahimi; Babak,23,0,40,17
1746541187515,SE 9,A01,886814,Staff,7,0,20,13
1746541188542,SE 101B,A01,886816,Chadha; Mayank,4,0,35,31
1746541189575,SE 110B,A00,886818,Zhu; Qiang,4,0,75,71
1746541190602,SE 125,A01,886830,Staff,10,0,30,20
1746541191631,SE 130B,A01,886835,Staff,14,0,40,26
1746541192661,SE 131A,A01,886838,Krysl; Petr,34,0,55,21
1746541193691,SE 154,A00,886840,Staff,30,0,50,20
1746541194720,SE 164GS,A01,886849,Staff,6,0,20,14
1746541195744,SE 167GS,A01,886853,Staff,6,0,20,14
1746541196771,SIO 25,A01,890107,Staff,19,0,30,11
1746541197802,SIO 45,A00,890109,Cook; Geoffrey W,117,0,200,83
1746541198830,SIO 109R,A00,890110,Forman; Fonna,0,16,20,20
1746541199858,SIO 187,A01,890114,Kacev; David,15,0,40,25
1746541200887,SOCI 1,A01,890431,Thorpe; Charles Robert,15,0,30,15
1746541200887,SOCI 1,A02,890518,Thorpe; Charles Robert,30,0,30,0
1746541201912,SOCI 2,A01,957978,Staff,25,0,25,0
1746541201912,SOCI 2,A02,957979,Staff,23,0,25,2
1746541202938,SOCI 20,A01,890523,Calderon-Zaks; Michael Aar,23,0,30,7
1746541202938,SOCI 20,A02,890526,Calderon-Zaks; Michael Aar,29,0,30,1
1746541203965,SOCI 30,A01,890533,Pardo Guerra; Juan Pablo,37,0,40,3
1746541204995,SOCI 40,A01,890535,Staff,27,0,45,18
1746541206024,SOCI 104Q,A00,890559,Staff,18,0,30,12
1746541207052,SOCI 106,A00,890560,Arnal; Maud Marie Leonie,20,0,30,10
1746541208081,SOCI 110,A00,890567,Holkenbrink-Monk; Charlene,19,0,30,11
1746541209106,SOCI 112,A00,890568,Victoria Torres; Pablo,1,0,55,54
1746541210134,SOCI 115,A00,890597,Arnal; Maud Marie Leonie,28,0,45,17
1746541212188,SOCI 121,A00,890604,Pardo Guerra; Juan Pablo,38,0,45,7
1746541213216,SOCI 126,A01,890608,Staff,8,0,10,2
1746541214244,SOCI 127,A00,890609,Staff,18,0,30,12
1746541215270,SOCI 131,A00,890610,Thorpe; Charles Robert,37,0,45,8
1746541216294,SOCI 135,A00,890615,Payne; Christine Anna,14,0,45,31
1746541217321,SOCI 139,A00,890620,Staff,38,0,45,7
1746541218348,SOCI 148E,A00,890622,Calderon-Zaks; Michael Aar,36,0,45,9
1746541219378,SOCI 150,A00,890623,Kohler; Kristopher M.,31,0,45,14
1746541220407,SOCI 157,A00,890625,Jules-Rosette; Bennetta W.,18,0,20,2
1746541221435,SOCI 160,A00,890627,Payne; Christine Anna,21,0,45,24
1746541222462,SYN 1,A00,886855,Fish; Gwendolyn Anne,0,0,0,0
1746541222462,SYN 1,B00,906086,Fish; Gwendolyn Anne,0,1,0,2
1746541223488,SYN 2R,A00,886860,Staff,0,17,15,15
1746541223488,SYN 2R,B00,906106,Atkinson; Arthur Laird,0,16,15,15
1746541224528,SYN 100,A01,886866,Browne; Emily,0,28,20,20
1746541224528,SYN 100,B01,906128,Rock; Martin,0,5,20,20
1746541224528,SYN 100,C01,906140,Deavenport; James Cary,0,3,20,20
1746541224528,SYN 100,D01,907816,Deavenport; James Cary,0,5,20,20
1746541225560,TDAC 1,A00,890286,Walsh; Kim C.,9,0,20,11
1746541226589,TDAC 101,A00,890296,Basso; Beatrice,16,0,20,4
1746541227615,TDDE 131,A00,890297,Staff,47,0,50,3
1746541228642,TDDM 1,A00,890287,Weinberg; Sadie,25,0,30,5
1746541229668,TDGE 11,A00,890288,Fulton; Julia,137,0,200,63
1746541229668,TDGE 11,B00,890289,Castro; Robert Jess,184,0,200,16
1746541230695,TDGE 25,B00,957359,Walsh; Kim C.,3,0,20,17
1746541231720,TDGE 40,A01,890292,Power; Jade Yukana,27,0,30,3
1746541232747,TDGE 124,A00,890298,Havis; Allan,0,0,50,50
1746541233773,TDGE 131R,A00,890299,Burelle; Julie Sara Veronique,15,0,42,27
1746541234802,TDHT 101,A00,890300,Staff,10,0,20,10
1746541235830,TDHT 109,A01,890302,Anderson; Mysia Anyse,31,0,40,9
1746541236857,TDMV 1,A00,890293,Arcidiacono; Kristin,18,0,30,12
1746541237883,TDMV 2,A00,890294,Weinberg; Sadie,23,0,30,7
1746541238914,TDMV 3,A00,957878,Arcidiacono; Kristin,28,0,30,2
1746541240967,TDMV 138,A00,890304,Jun; Grace Shin Hae,25,0,40,15
1746541241995,TDMV 140,A00,890305,Corrales; Joseph Bernales,25,0,30,5
1746541243022,TDMV 142,A00,890307,Caligagan; Tony,32,0,40,8
1746541244051,TDMV 144,A00,890308,Camaya; Michelle Ann,25,0,30,5
1746541245080,TDPW 1,A00,890295,Stein; Deborah Isobel,3,0,20,17
1746541246110,USP 2,A01,890272,Lerner; Amy M,6,0,20,14
1746541247138,USP 3,A01,890274,Staff,12,0,30,18
1746541248169,USP 15,A01,890276,Sun; Feiyang,17,0,30,13
1746541249197,USP 25,A00,890277,Shenkman; Michael Thomas,19,0,25,6
1746541250221,USP 138,A00,890278,Staff,13,0,25,12
1746541251247,USP 143,A00,890279,Staff,21,0,70,49
1746541252277,USP 144,A00,890280,Chowdhury; Muhammed Zohir,16,0,30,14
1746541253305,USP 150,A00,890281,Boomhower; Matthew Charles,4,0,30,26
1746541254335,USP 151,A00,890282,Staff,16,0,20,4
1746541255360,USP 162,A00,890283,Andrews; Abigail Leslie,16,0,20,4
1746541256389,USP 168,A00,920477,Kwak; Nancy,1,0,5,4
1746541257419,USP 181,A00,890284,Staff,3,0,20,17
1746541258448,USP 191A,A00,890285,Staff,13,0,20,7
1746541259479,VIS 101,A00,886512,Staff,25,0,75,50
1746541260505,VIS 103,A00,886513,Cruz; Edwin Teddy,61,0,75,14
1746541261532,VIS 108,A00,886514,Staff,3,0,15,12
1746541262563,VIS 127P,A00,886515,Shen; Kuiyi,80,0,146,66
1746541263588,VIS 149,A00,886516,Yoldas; Pinar,0,0,15,15
1746541264615,VIS 164,A00,886526,Erdmann; Dean,19,0,22,3
1746541265645,VIS 194S,A00,886527,Staff,61,0,75,14
1746541266674,WCWP 10A,C00,886484,Martiniuk; Jill,12,0,15,3
1746541267701,WCWP 10B,A00,886490,Uriarte; Emma,0,0,15,15
1746541267701,WCWP 10B,B00,886491,Dhir; Simrita,11,0,15,4
1746541267701,WCWP 10B,C00,886492,Ornelas; Tricia,0,0,15,15
1746541268727,WCWP 100,A00,886494,Young; Mark T,0,7,15,15
1746541270829,AAS 10,A01,886199,Childs; Dennis R.,0,3,0,0
1746541271858,ANAR 104,A01,886940,Shtienberg; Gilad,27,0,30,3
1746541272887,ANAR 120,A00,886953,Staff,12,0,20,8
1746541273917,ANBI 148,A01,886955,Wilder; Linnea Lorene,30,0,40,10
1746541275967,ANSC 122,A00,886957,Staff,25,0,30,5
1746541276997,ANSC 150,A00,886958,Sloane; Julia Kathryn,3,0,15,12
1746541278027,ANSC 156,A00,886959,Jenkins; Janis A.,0,1,15,15
1746541279052,ANSC 180,A00,886960,Staff,11,0,17,6
1746541280083,ANSC 188,A00,886961,Jassal; Aftab,9,0,25,16
1746541281109,ANSC 190,A00,886962,Jassal; Aftab,14,0,25,11
1746541282135,ANSC 191,A00,886963,Staff,18,0,20,2
1746541283162,ANTH 3,A01,891689,Staff,17,0,20,3
1746541284190,ANTH 5,A00,886933,Semendeferi; Ekaterini,16,0,20,4
1746541285219,ANTH 10,A00,886934,Staff,0,12,30,30
1746541286246,ANTH 21,A01,886936,Staff,40,0,60,20
1746541287274,ANTH 23,A01,886938,Staff,92,0,100,8
1746541288302,ANTH 105,A00,886964,Stewart; Alexander B,84,0,100,16
1746541289329,ANTH 108,A00,886965,Pedersen; David,9,0,20,11
1746541290363,AWP 10,001,886147,Staff,0,0,0,0
1746541290363,AWP 10,002,886148,Staff,0,0,0,0
1746541290363,AWP 10,003,886149,Staff,0,0,0,0
1746541290363,AWP 10,004,886150,Staff,0,0,0,0
1746541290363,AWP 10,005,886151,Staff,0,0,0,0
1746541290363,AWP 10,006,886152,Staff,0,0,0,0
1746541290363,AWP 10,007,886153,Staff,0,0,0,0
1746541290363,AWP 10,008,886154,Staff,0,0,0,0
1746541290363,AWP 10,009,886155,Staff,0,0,0,0
1746541290363,AWP 10,010,886156,Staff,0,0,0,0
1746541290363,AWP 10,011,886158,Staff,0,0,0,0
1746541290363,AWP 10,012,886160,Staff,0,0,0,0
1746541290363,AWP 10,013,886161,Staff,0,0,0,0
1746541290363,AWP 10,014,886162,Staff,0,0,0,0
1746541290363,AWP 10,015,886163,Staff,0,0,0,0
1746541290363,AWP 10,016,886164,Staff,0,0,0,0
1746541290363,AWP 10,017,886165,Staff,0,0,0,0
1746541290363,AWP 10,018,886166,Staff,0,0,0,0
1746541290363,AWP 10,019,886168,Staff,0,0,0,0
1746541290363,AWP 10,020,886170,Staff,0,0,0,0
1746541290363,AWP 10,021,886172,Staff,0,0,0,0
1746541291390,AWP 10R,001,886173,Staff,0,1,0,0
1746541291390,AWP 10R,002,886174,Staff,0,1,0,0
1746541291390,AWP 10R,003,886175,Staff,0,0,0,0
1746541291390,AWP 10R,004,886176,Staff,0,0,0,0
1746541291390,AWP 10R,005,886177,Staff,0,0,0,0
1746541291390,AWP 10R,006,886178,Staff,0,0,0,0
1746541291390,AWP 10R,007,886179,Staff,0,0,0,0
1746541291390,AWP 10R,008,886181,Staff,0,0,0,0
1746541291390,AWP 10R,009,886182,Staff,0,0,0,0
1746541291390,AWP 10R,010,886183,Staff,0,0,0,0
1746541291390,AWP 10R,011,886184,Staff,0,0,0,0
1746541291390,AWP 10R,012,886185,Staff,0,0,0,0
1746541291390,AWP 10R,013,886186,Staff,0,0,0,0
1746541291390,AWP 10R,014,886187,Staff,0,0,0,0
1746541291390,AWP 10R,015,886188,Staff,0,0,0,0
1746541291390,AWP 10R,016,886189,Staff,0,0,0,0
1746541292427,AWP 102R,A00,886190,Staff,0,0,0,0
1746541292427,AWP 102R,B00,886191,Staff,0,0,0,0
1746541293452,BENG 100,A01,886193,Staff,17,0,30,13
1746541294476,BENG 122A,A01,886195,Hasty; Jeff M,13,0,30,17
1746541295502,BENG 166A,A00,886196,Sah; Robert Lie-Yuan,0,1,30,30
1746541296529,BENG 190,A00,958050,Khojah; Reem I,24,0,25,1
1746541297573,BIBC 102,A01,894320,Staff,0,0,46,46
1746541297573,BIBC 102,A02,894321,Staff,1,0,46,45
1746541297573,BIBC 102,A03,894344,Staff,7,0,46,39
1746541297573,BIBC 102,A04,894345,Staff,26,0,47,21
1746541298600,BICD 100R,A01,894365,Smith; Laurie,0,3,58,58
1746541298600,BICD 100R,A02,894366,Smith; Laurie,0,5,58,58
1746541298600,BICD 100R,A03,894367,Smith; Laurie,2,0,59,57
1746541298600,BICD 100R,A04,959869,Smith; Laurie,41,0,59,18
1746541299633,BICD 136,A01,894383,Gustafson-Brown; Cindy,14,0,50,36
1746541300661,BIEB 102,A01,894494,Butler; Shannon Rhey,51,0,130,79
1746541302718,BIEB 150,A01,894617,Wills; Christopher,3,0,20,17
1746541302718,BIEB 150,A02,894631,Wills; Christopher,3,0,20,17
1746541302718,BIEB 150,A03,894937,Wills; Christopher,3,0,20,17
1746541302718,BIEB 150,A04,894946,Wills; Christopher,5,0,20,15
1746541303746,BIEB 194,A00,906141,Kurle; Carolyn M.,6,0,20,14
1746541304775,BILD 1,A01,894154,Staff,2,0,19,17
1746541304775,BILD 1,A02,894155,Staff,14,0,19,5
1746541304775,BILD 1,A03,894160,Staff,13,0,19,6
1746541304775,BILD 1,A04,894161,Staff,15,0,18,3
1746541305801,BILD 2,A01,894168,Staff,0,0,50,50
1746541305801,BILD 2,A02,894169,Staff,0,0,50,50
1746541305801,BILD 2,A03,894179,Staff,4,0,50,46
1746541305801,BILD 2,A04,894203,Staff,27,0,50,23
1746541306831,BILD 3,A01,894213,Staff,22,0,31,9
1746541306831,BILD 3,A02,894214,Staff,26,0,31,5
1746541306831,BILD 3,A03,894235,Staff,28,0,31,3
1746541306831,BILD 3,A04,894236,Staff,28,0,32,4
1746541307859,BILD 4,A01,894253,Reuther; Keefe,5,0,24,19
1746541307859,BILD 4,A02,894258,Reuther; Keefe,16,0,24,8
1746541308888,BILD 5,A01,894276,Reuther; Keefe,35,0,50,15
1746541308888,BILD 5,A02,894277,Reuther; Keefe,45,0,50,5
1746541308888,BILD 5,A03,894290,Reuther; Keefe,44,0,50,6
1746541308888,BILD 5,A04,894291,Reuther; Keefe,48,0,50,2
1746541309918,BILD 24,A01,894297,Pirino; Giorgia,40,0,60,20
1746541310949,BIMM 100,B01,958915,Staff,72,0,100,28
1746541311977,BIMM 101,A01,895017,McDonnell; Lisa Marie,0,5,24,24
1746541311977,BIMM 101,A02,895018,McDonnell; Lisa Marie,0,5,24,24
1746541311977,BIMM 101,B01,895020,McDonnell; Lisa Marie,0,6,24,24
1746541311977,BIMM 101,B02,895021,McDonnell; Lisa Marie,0,4,24,24
1746541313009,BIMM 110,A01,895023,Staff,1,0,25,24
1746541313009,BIMM 110,A02,895024,Staff,9,0,25,16
1746541313009,BIMM 110,A03,895025,Staff,18,0,25,7
1746541313009,BIMM 110,A04,895031,Staff,20,0,25,5
1746541314036,BIMM 120,A01,895114,Gustafson-Brown; Cindy,13,0,28,15
1746541314036,BIMM 120,A02,895126,Gustafson-Brown; Cindy,21,0,27,6
1746541315066,BIPN 100,A01,895130,Yang; Mingyu,1,0,38,37
1746541315066,BIPN 100,A02,895131,Yang; Mingyu,32,0,38,6
1746541315066,BIPN 100,A03,895132,Yang; Mingyu,32,0,38,6
1746541315066,BIPN 100,A04,895133,Yang; Mingyu,27,0,36,9
1746541316093,BIPN 120,A01,895135,Cooke; James Edward,0,3,13,13
1746541316093,BIPN 120,A02,895136,Cooke; James Edward,0,1,13,13
1746541316093,BIPN 120,A03,895137,Cooke; James Edward,0,3,13,13
1746541316093,BIPN 120,A04,895156,Cooke; James Edward,0,2,11,11
1746541317119,BIPN 134,A01,895235,Cooke; James Edward,0,2,25,25
1746541317119,BIPN 134,A02,895237,Cooke; James Edward,0,0,25,25
1746541317119,BIPN 134,A03,895240,Cooke; James Edward,3,0,25,22
1746541317119,BIPN 134,A04,895270,Cooke; James Edward,20,0,25,5
1746541318144,BIPN 189,A00,892103,Staff,0,13,14,14
1746541320201,BISP 194,A00,958008,Staff,0,2,0,0
1746541321230,CAT 124,A01,922009,Staff,0,5,20,20
1746541322258,CAT 125R,A00,886390,Morales; Celeste Georgianna,0,2,20,20
1746541322258,CAT 125R,B00,886391,Irwin; Matthew Joseph,0,3,20,20
1746541322258,CAT 125R,C00,886392,Smith; Lauryn Alissa,0,2,20,20
1746541322258,CAT 125R,D00,886393,Vanderschuit; Maya Alysia,0,2,20,20
1746541322258,CAT 125R,E00,886394,Marchisotto; Jennifer Anne,0,4,20,20
1746541323284,CENG 15,A01,886218,Drews; Aaron,3,0,8,5
1746541324312,CENG 113,A00,886219,Opatkiewicz; Justin Paul,15,0,25,10
1746541325340,CGS 101,A00,887044,Staff,7,0,20,13
1746541326369,CGS 105,A01,887046,Staff,14,0,25,11
1746541327397,CGS 112,A00,887047,Cuong; Marisol,12,0,15,3
1746541328422,CGS 113,A00,887048,Staff,23,0,30,7
1746541329449,CGS 120,A00,887049,Staff,10,0,17,7
1746541330475,CHEM 6A,A01,886336,Lam; Tin Yiu,38,0,50,12
1746541330475,CHEM 6A,A02,886338,Lam; Tin Yiu,37,0,50,13
1746541331506,CHEM 6B,A01,886341,Hopkins; Patrycja Anna,16,0,50,34
1746541331506,CHEM 6B,A02,886343,Hopkins; Patrycja Anna,42,0,50,8
1746541332536,CHEM 6C,A01,886346,Albizati; Kim F.,0,2,50,50
1746541332536,CHEM 6C,A02,886348,Albizati; Kim F.,23,0,50,27
1746541333561,CHEM 40A,A01,886352,Klosterman; Jeremy K,65,0,100,35
1746541334588,CHEM 40B,A01,886356,Klosterman; Jeremy K,0,23,100,100
1746541335614,CHEM 41B,A01,886360,Theodorakis; Emmanuel,25,0,50,25
1746541335614,CHEM 41B,A02,886362,Theodorakis; Emmanuel,47,0,50,3
1746541336644,CHIN 165A,A00,886382,Xu; Li,18,0,20,2
1746541337669,CLAS 120,A00,886387,Myerston Santana; Jacobo,33,0,40,7
1746541338693,COGS 9,A01,886967,Shannon; Kyle Michael,42,0,60,18
1746541339721,COGS 11,A01,886969,Staff,11,0,30,19
1746541340746,COGS 14A,A01,886971,Staff,6,0,60,54
1746541341772,COGS 14B,A01,886973,Hoffman; Drew Ellen,4,0,60,56
1746541342803,COGS 18,A01,886975,Morgan; Eric,35,0,60,25
1746541343829,COGS 20,A01,886977,Staff,4,0,8,4
1746541343829,COGS 20,A02,886978,Staff,5,0,7,2
1746541344858,COGS 100,A01,907783,Staff,0,2,30,30
1746541345885,COGS 101B,A01,886980,Staff,0,3,48,48
1746541346910,COGS 101C,A01,886982,Delgado; Tania,0,5,44,44
1746541347938,COGS 102A,A01,886984,Johnson; Christine M.,4,0,30,26
1746541348963,COGS 118B,A01,886986,Staff,0,3,88,88
1746541349989,COGS 150,A01,886988,Bergen; Benjamin,23,0,50,27
1746541351016,COGS 153,A00,886989,Delgado; Tania,0,2,41,41
1746541352041,COGS 186,A01,886991,Staff,0,0,32,32
1746541353067,COGS 187A,A01,886993,Boyle; Mary E. T.,7,0,30,23
1746541354092,COGS 189,A00,886994,Staff,0,1,30,30
1746541355122,COMM 10,A01,886996,Staff,0,0,20,21
1746541355122,COMM 10,A02,886997,Staff,12,0,20,8
1746541355122,COMM 10,A03,959845,Staff,19,0,20,1
1746541356148,COMM 20,A01,886999,Leuning; Grant Maurstad,24,0,40,16
1746541358200,COMM 100A,A01,887002,Staff,0,0,20,25
1746541358200,COMM 100A,A02,887003,Staff,7,0,20,13
1746541359228,COMM 100B,A01,887005,Staff,0,8,20,24
1746541360256,COMM 106D,A00,887006,Staff,14,0,40,26
1746541361281,COMM 110G,A00,887007,Whitworth-Smith; Andrew C,12,0,40,28
1746541362310,COMM 111B,A00,887008,Staff,31,0,40,9
1746541363337,COMM 113T,A00,887009,Abuelhiga; Soraya Jill,28,0,40,12
1746541363337,COMM 113T,B00,906733,Staff,40,0,40,0
1746541364366,COMM 145,A00,887010,Staff,12,0,40,28
1746541365397,COMM 146,A00,887054,Staff,31,0,40,9
1746541366424,COMM 190,A00,887012,Staff,8,0,23,15
1746541367451,CSE 8A,A50,887015,Cao; Yingjun,57,0,85,28
1746541368477,CSE 11,A01,887017,Cao; Yingjun,12,0,70,58
1746541369505,CSE 20,A01,887019,Staff,30,0,50,20
1746541370535,CSE 21,A01,887021,Staff,78,0,100,22
1746541370535,CSE 21,B01,892583,Braun; Oliver,45,0,50,5
1746541371561,CSE 30,A01,887025,Eldon; John,143,0,200,57
1746541372589,CSE 100,A01,887027,Staff,26,0,50,24
1746541372589,CSE 100,A02,887028,Staff,40,0,50,10
1746541373616,CSE 101,A01,887030,Braun; Oliver,75,0,100,25
1746541373616,CSE 101,B01,887032,Jones; Miles E,0,3,50,50
1746541373616,CSE 101,B02,887033,Jones; Miles E,0,1,50,50
1746541374640,CSE 105,A01,908084,Jones; Miles E,32,0,50,18
1746541374640,CSE 105,A02,908087,Jones; Miles E,33,0,50,17
1746541375670,CSE 135,A01,887035,Powell; Thomas Allan,0,4,50,50
1746541376696,CSE 142,A01,887037,Staff,8,0,60,52
1746541377722,CSE 142L,A01,887039,Staff,34,0,60,26
1746541378749,CSE 151A,A01,887041,Solares; Edwin A,48,0,100,52
1746541379777,CSE 175,A01,887043,Kumar; Rakesh,30,0,30,0
1746541380802,CSS 1,A01,886389,Staff,0,1,40,40
1746541381828,DSC 30,A01,908097,Liao; Soohyun Nam,47,0,75,28
1746541382854,DSC 40A,A01,908099,Shannon; Kyle Michael,30,0,50,20
1746541383883,DSC 40B,A01,908112,Staff,16,0,50,34
1746541384910,DSC 80,A01,908116,Staff,19,0,60,41
1746541385938,DSC 197,001,956863,Eldridge; Justin Matthew,9999,0,9999,0
1746541386964,ECE 5,A01,886400,Morris; Karcher William,2,0,6,4
1746541386964,ECE 5,A02,886401,Morris; Karcher William,3,0,6,3
1746541387990,ECE 148,A01,886403,Silberman; Jack,0,14,14,14
1746541389021,ECON 1,A01,887265,Crane; Meredith Helen,12,0,70,58
1746541389021,ECON 1,B01,887268,Staff,43,0,50,7
1746541390049,ECON 2,A01,887273,Crane; Meredith Helen,56,0,70,14
1746541391079,ECON 3,A01,887279,Rondina; Giacomo,32,0,70,38
1746541392107,ECON 4,A01,887282,Anderson; John Charles,0,2,10,10
1746541393134,ECON 5,A01,887285,Staff,33,0,45,12
1746541393134,ECON 5,B01,887292,Staff,41,0,45,4
1746541394160,ECON 100A,A01,887337,Newhouse; Herbert S,54,0,70,16
1746541394160,ECON 100A,B01,887349,Staff,45,0,50,5
1746541395187,ECON 100B,A01,887361,Du; Songzi,29,0,70,41
1746541396215,ECON 100C,A01,887445,Newhouse; Herbert S,59,0,70,11
1746541397244,ECON 105,A00,887488,Vespa; Emanuel Ignacio,23,0,35,12
1746541398273,ECON 109,A01,887506,Shishkin; Denis,28,0,35,7
1746541399304,ECON 110A,A01,887568,Alon; Titan Michael,0,3,35,35
1746541399304,ECON 110A,B01,907601,Alon; Titan Michael,20,0,35,15
1746541400330,ECON 110B,A01,887598,Levkoff; Steven B.,0,23,70,70
1746541401358,ECON 112,A00,887599,Rondina; Giacomo,19,0,35,16
1746541402398,ECON 120A,A01,887603,Dai; Yinlin,36,0,70,34
1746541403423,ECON 120C,A01,887608,Sun; Yixiao,0,1,35,35
1746541403423,ECON 120C,B01,887614,Sun; Yixiao,0,0,35,35
1746541404449,ECON 138,A00,887621,Bharadwaj; Prashant,0,20,20,20
1746541405478,ECON 144,A00,958007,Squires; Dale E,13,0,35,22
1746541406507,ECON 171,A01,907666,Staff,18,0,35,17
1746541407534,ECON 175,A00,887626,Wu; Pak Yeung,23,0,35,12
1746541408561,ECON 190,A00,887640,Vespa; Emanuel Ignacio,23,0,35,12
1746541409589,EDS 25,A01,888197,Staff,0,0,0,0
1746541409589,EDS 25,A02,888209,Staff,0,0,0,0
1746541409589,EDS 25,A03,888210,Staff,0,0,0,0
1746541409589,EDS 25,A04,888212,Staff,0,0,0,0
1746541409589,EDS 25,A05,888213,Staff,0,0,0,0
1746541409589,EDS 25,A06,888214,Staff,0,0,0,0
1746541409589,EDS 25,A07,888235,Staff,0,2,0,0
1746541409589,EDS 25,A08,888236,Staff,0,0,0,0
1746541409589,EDS 25,A09,888240,Staff,0,0,0,0
1746541409589,EDS 25,A10,888244,Staff,0,0,0,0
1746541409589,EDS 25,B01,888273,Staff,0,0,0,0
1746541409589,EDS 25,B02,888285,Staff,0,0,0,0
1746541409589,EDS 25,B03,888423,Staff,0,0,0,1
1746541409589,EDS 25,B04,888432,Staff,0,0,0,0
1746541409589,EDS 25,B05,888433,Staff,0,0,0,0
1746541409589,EDS 25,B06,888467,Staff,0,0,0,0
1746541409589,EDS 25,B07,888468,Staff,0,0,0,0
1746541409589,EDS 25,B08,888479,Staff,0,0,0,0
1746541409589,EDS 25,B09,888484,Staff,0,0,0,0
1746541409589,EDS 25,B10,888487,Staff,0,0,0,0
1746541410619,EDS 38,A01,907700,Choi; Bailey Miyeon,30,0,30,0
1746541411649,EDS 112,A01,888601,Chapman; Thandeka K,14,0,40,26
1746541412676,EDS 115,A00,888697,Mendez; Kathrina Mendoza,10,0,30,20
1746541413702,EDS 116,A01,888893,Staff,35,0,40,5
1746541415755,EDS 124AR,A00,889133,Staff,29,0,50,21
1746541415755,EDS 124AR,B00,907471,Simon; Elizabeth A,37,0,50,13
1746541416780,EDS 124BR,A00,889134,Simon; Elizabeth A,45,0,100,55
1746541417805,EDS 125,A00,889135,Staff,25,0,30,5
1746541418834,EDS 126,A01,889138,Staff,36,0,40,4
1746541419863,EDS 164R,A01,889142,Wishard Guerra; Alison G.,33,0,50,17
1746541420888,ENG 30,A01,886396,Staff,0,0,0,0
1746541420888,ENG 30,B01,886398,Staff,0,0,0,0
1746541421914,ENVR 102,A00,906150,Montejo; Carolina,23,0,25,2
1746541422944,ETHN 103A,A00,887236,Man; Simeon S,0,3,0,0
1746541423971,ETHN 113,A00,887239,Staff,16,0,30,14
1746541424997,ETHN 116,A00,887240,Staff,16,0,25,9
1746541426023,ETHN 117,A00,887241,Choi; Esther Min,28,0,30,2
1746541427052,ETHN 118,A00,887243,Staff,24,0,30,6
1746541428081,ETHN 127,A00,887248,Cuong; Marisol,11,0,15,4
1746541429107,ETHN 139,A00,887250,Staff,7,0,10,3
1746541430134,ETHN 142,A00,887252,Staff,10,0,30,20
1746541431163,ETHN 161,A00,887253,Browne; Errol Tsekani,24,0,30,6
1746541432190,ETHN 163FR,A00,887255,Burelle; Julie Sara Veronique,0,0,5,5
1746541433216,GLBH 20,A00,889149,Elwardani; Nile Regina,8,0,42,34
1746541435272,GLBH 111,A01,889152,Burgos; Jose L.,17,0,17,0
1746541436305,GLBH 150,A00,889181,Sloane; Julia Kathryn,0,5,15,15
1746541438361,HDS 60,A01,886406,Warstadt; Melissa Fawn,73,0,80,7
1746541439389,HIAF 111,A00,889324,Gyamfi; Bright,25,0,32,7
1746541440415,HIEA 131,A00,889328,Staff,16,0,32,16
1746541441442,HIEA 144,A00,889333,Henry; Todd A.,26,0,32,6
1746541442472,HIEA 154,A00,889336,Henry; Todd A.,24,0,32,8
1746541443496,HIEU 106,A00,889339,Staff,22,0,32,10
1746541445547,HIEU 114,A00,889340,Staff,3,0,32,29
1746541446573,HIEU 135GS,A00,889342,Patterson; Patrick H.,0,0,1,24
1746541447599,HIEU 137,A00,889343,Edington; Claire Ellen,9,0,25,16
1746541448626,HIEU 148,A00,889345,Staff,14,0,32,18
1746541449651,HIEU 154,A00,889346,Biess; Frank Peter,21,0,32,11
1746541450677,HILA 102,A00,889351,Staff,12,0,32,20
1746541451705,HILD 2A,A01,889221,Lewandoski; Julia Mavis,1,10,32,31
1746541452731,HILD 7B,A01,889225,Man; Simeon S,0,13,32,32
1746541453757,HILD 7C,A01,889288,Alvarez; Luis A,0,14,32,32
1746541454786,HILD 30,A01,889323,Staff,0,5,32,32
1746541456837,HISC 119,A00,889383,Golan; Tal,21,0,32,11
1746541457866,HIUS 103,A00,889384,Man; Simeon S,0,0,32,32
1746541458926,HIUS 117,A00,919797,Kwak; Nancy,18,0,32,14
1746541459959,HIUS 142A,A00,919788,Staff,22,0,32,10
1746541462014,HIUS 149,A00,889386,Gyamfi; Bright,27,0,32,5
1746541463043,HIUS 155,A00,889387,Alvarez; Luis A,14,0,32,18
1746541464069,HUM 3,A01,886499,Caldwell; Michael Alan,19,0,50,31
1746541465095,HUM 3GS,A00,886500,Rodriguez; Bretton Sigfred,0,0,0,28
1746541466123,HUM 3R,A01,886502,Markman; Kristina,0,36,50,50
1746541467149,HUM 4,A01,886504,Crum; Matthew Stephen,24,0,50,26
1746541467149,HUM 4,B01,886506,West; Geoffrey Scott,17,0,50,33
1746541468177,HUM 4GS,A00,886507,Staff,0,0,0,19
1746541469204,HUM 5,A01,886509,Staff,32,0,50,18
1746541470229,HUM 5R,A01,886511,Zavodny; Tatiana Sophia,0,39,50,50
1746541471256,JAPN 180,A00,886407,Staff,18,0,40,22
1746541472285,LATI 50,A01,886409,Martin-Cabrera; Luis,4,0,22,18
1746541472285,LATI 50,A02,886410,Martin-Cabrera; Luis,19,0,22,3
1746541472285,LATI 50,A03,886411,Martin-Cabrera; Luis,21,0,22,1
1746541472285,LATI 50,A04,886412,Martin-Cabrera; Luis,9,0,22,13
1746541473312,LAWS 101,A00,907664,Staff,28,0,60,32
1746541474339,LIAB 1A,A00,889388,Saab; Dima,17,0,20,3
1746541475363,LIAB 1AX,A00,889389,El Cheddadi; Youniss,17,0,20,3
1746541476392,LIFR 1C,A00,889391,Van Moer; Vinciane G,8,0,20,12
1746541477418,LIFR 1CX,A00,889392,Van Moer; Vinciane G,7,0,20,13
1746541478444,LIFR 1D,A00,889393,Van Moer; Vinciane G,7,0,20,13
1746541479469,LIFR 1DX,A00,889394,Van Moer; Vinciane G,8,0,20,12
1746541480496,LIGN 7,A00,886923,Staff,24,0,50,26
1746541481523,LIGN 17,A00,886924,Kehler; Andrew Scott,125,0,150,25
1746541482550,LTAM 110,A00,889395,Staff,15,0,30,15
1746541483577,LTAM 110GS,A00,958010,Rodriguez; Bretton Sigfred,0,0,0,28
1746541484603,LTCH 101,A00,889397,Staff,23,0,25,2
1746541485628,LTCS 130,A00,889398,Staff,23,0,25,2
1746541486654,LTEA 138,A00,889399,Staff,24,0,40,16
1746541487680,LTEN 149,A00,889400,Wesling; Megan E.,0,3,25,25
1746541488710,LTEN 169,A00,889401,Staff,20,0,25,5
1746541489737,LTEN 180,A00,889402,Staff,10,0,15,5
1746541490762,LTEN 181,A00,889403,Staff,21,0,25,4
1746541491788,LTWL 100,A00,889404,Myerston Santana; Jacobo,3,0,25,22
1746541492814,LTWL 180GS,A00,889405,Staff,0,0,20,20
1746541493838,LTWL 181,A00,889406,Staff,17,0,25,8
1746541494865,LTWL 184,A00,889475,Mukherjee; Silpa,22,0,25,3
1746541495892,LTWR 102C,A00,889486,Staff,29,0,30,1
1746541496917,LTWR 115W,A00,889491,Staff,0,2,15,15
1746541497945,MAE 8,A01,886905,Staff,0,2,0,0
1746541498972,MAE 11,A00,886906,Bandaru; Prabhakar,0,7,50,50
1746541499998,MAE 20,A00,886907,Evdokimenko; Ekaterina,44,0,70,26
1746541501029,MAE 30B,A00,886909,Ghazinejad; Maziar,26,0,45,19
1746541502061,MAE 101B,A00,886910,Saintillan; David,29,0,45,16
1746541503087,MAE 105,A00,886911,Bandaru; Prabhakar,18,0,50,32
1746541504126,MAE 107,B00,958024,Staff,9,0,50,41
1746541505157,MAE 143B,A00,886913,Bewley; Thomas R,7,0,40,33
1746541506192,MAE 148,A01,886915,Silberman; Jack,0,3,14,14
1746541507225,MAE 160,A00,886916,Evdokimenko; Ekaterina,31,0,60,29
1746541508252,MATH 3C,A01,889681,Staff,0,3,30,30
1746541508252,MATH 3C,A02,960048,Staff,25,0,30,5
1746541509282,MATH 10A,A01,889760,Staff,26,0,30,4
1746541509282,MATH 10A,A02,889783,Staff,29,0,30,1
1746541510310,MATH 10B,A01,889785,Verstraete; Jacques Allan,2,0,35,33
1746541510310,MATH 10B,A02,889795,Verstraete; Jacques Allan,4,0,35,31
1746541510310,MATH 10B,B01,889797,Verstraete; Jacques Allan,3,0,35,32
1746541510310,MATH 10B,B02,889828,Verstraete; Jacques Allan,3,0,35,32
1746541511338,MATH 10C,A01,889849,Habib; Yousaf,9,0,30,21
1746541511338,MATH 10C,A02,889852,Habib; Yousaf,14,0,30,16
1746541511338,MATH 10C,A03,889853,Habib; Yousaf,22,0,30,8
1746541511338,MATH 10C,A04,889858,Habib; Yousaf,20,0,30,10
1746541511338,MATH 10C,B01,889861,Staff,1,0,30,29
1746541511338,MATH 10C,B02,889862,Staff,24,0,30,6
1746541511338,MATH 10C,B03,889863,Staff,27,0,30,3
1746541511338,MATH 10C,B04,889967,Staff,23,0,30,7
1746541512372,MATH 18,A01,889974,Staff,7,0,30,23
1746541512372,MATH 18,A02,889977,Staff,20,0,30,10
1746541512372,MATH 18,B01,889984,Hardiman; Liam,22,0,30,8
1746541512372,MATH 18,B02,889985,Hardiman; Liam,25,0,30,5
1746541513403,MATH 20A,A01,889990,Suk; Andrew Hoon,29,0,35,6
1746541514430,MATH 20B,A01,889993,Ohm; Ko Woon,22,0,30,8
1746541514430,MATH 20B,A02,889994,Ohm; Ko Woon,30,0,30,0
1746541514430,MATH 20B,B01,889996,Ohm; Ko Woon,21,0,30,9
1746541514430,MATH 20B,B02,889997,Ohm; Ko Woon,23,0,30,7
1746541515457,MATH 20C,A01,889999,Hammock; Frances H,17,0,30,13
1746541515457,MATH 20C,A02,890003,Hammock; Frances H,23,0,30,7
1746541515457,MATH 20C,B01,890006,Hammock; Frances H,3,0,30,27
1746541515457,MATH 20C,B02,890007,Hammock; Frances H,11,0,30,19
1746541516483,MATH 20D,A01,890011,Cheng; Hsiao-Bing,1,1,30,29
1746541516483,MATH 20D,A02,890012,Cheng; Hsiao-Bing,14,0,30,16
1746541516483,MATH 20D,B01,890016,Cheng; Hsiao-Bing,13,0,30,17
1746541516483,MATH 20D,B02,890017,Cheng; Hsiao-Bing,13,0,30,17
1746541517510,MATH 20E,A01,890026,Harel; Guershon,1,0,30,29
1746541517510,MATH 20E,A02,890029,Harel; Guershon,23,0,30,7
1746541517510,MATH 20E,B01,890033,Harel; Guershon,7,0,30,23
1746541517510,MATH 20E,B02,890101,Harel; Guershon,21,0,30,9
1746541518536,MATH 102,A01,890104,Staff,17,0,30,13
1746541518536,MATH 102,A02,890105,Staff,27,0,30,3
1746541519563,MATH 103B,A01,890116,Salehi Golsefidy; Alireza,3,0,30,27
1746541519563,MATH 103B,B01,890118,Staff,0,3,34,34
1746541520590,MATH 109,A01,890121,Aliabadi Sr.; Mohsen,1,0,30,29
1746541520590,MATH 109,B01,890124,Upadrashta; Pranav Kumar,18,0,30,12
1746541521618,MATH 120A,A01,890126,Eggers; John Dietrich,13,0,30,17
1746541522646,MATH 142B,A01,890128,Ioana; Adrian,19,0,30,11
1746541522646,MATH 142B,A02,890129,Ioana; Adrian,13,0,30,17
1746541523673,MATH 154,A01,890174,Staff,0,0,30,30
1746541523673,MATH 154,A02,890182,Staff,0,0,30,30
1746541524706,MATH 168A,A01,890197,Dumitriu; Ioana,21,0,35,14
1746541525738,MATH 170A,A01,890240,Nie; Jiawang,1,0,30,29
1746541525738,MATH 170A,A02,890241,Nie; Jiawang,11,0,30,19
1746541525738,MATH 170A,A03,890249,Nie; Jiawang,23,0,30,7
1746541526768,MATH 170B,A01,957891,Nag; Panchali,13,0,35,22
1746541528828,MATH 181A,A01,908025,Staff,0,4,35,35
1746541528828,MATH 181A,A02,960115,Staff,27,0,35,8
1746541529859,MATH 181B,A01,959874,Staff,26,0,30,4
1746541530887,MATH 193B,A01,890265,Staff,0,4,35,35
1746541531912,MGT 4,A01,890311,Anderson; John Charles,42,0,88,46
1746541532938,MGT 5,A00,907740,Staff,13,0,98,85
1746541533967,MGT 12,A00,890312,Lindenberger; Wade Douglas,67,0,98,31
1746541534994,MGT 16,A00,957883,Staff,78,0,98,20
1746541537050,MGT 45,A00,890314,Pecore; Joseph P.,47,0,98,51
1746541538076,MGT 71,A00,890315,Staff,0,11,98,98
1746541539105,MGT 100,A00,890316,Yavorsky; Daniel Ryan,44,0,98,54
1746541540133,MGT 103,A00,890317,Ehrich; Kristine R,73,0,98,25
1746541541160,MGT 105,A00,890356,Bates; Kenneth Walter,0,7,98,98
1746541542187,MGT 112,A00,890360,Ehrich; Kristine R,55,0,98,43
1746541543215,MGT 127R,A00,907732,Zhu; Kevin Xiaoguo,23,0,98,75
1746541544244,MGT 131B,A00,890361,Anderson; John Charles,61,0,98,37
1746541545274,MGT 137,A00,890362,Lindenberger; Wade Douglas,65,0,98,33
1746541546301,MGT 160,A00,890369,Johnson; Erik Barry,9,0,98,89
1746541548365,MGT 164,A00,890372,Zimmermann; Carsten,0,39,98,98
1746541549392,MGT 180,A00,890374,Bliss; Barbara Ann,12,0,98,86
1746541550427,MMW 15,A01,886414,Chang; Edmond Yi-Teh,0,12,28,28
1746541550427,MMW 15,A02,886415,Chang; Edmond Yi-Teh,0,8,28,28
1746541550427,MMW 15,A03,886416,Chang; Edmond Yi-Teh,0,8,28,28
1746541550427,MMW 15,A04,886417,Chang; Edmond Yi-Teh,0,8,28,28
1746541550427,MMW 15,B01,886419,Chang; Edmond Yi-Teh,0,7,28,28
1746541550427,MMW 15,B02,886420,Chang; Edmond Yi-Teh,0,8,28,28
1746541550427,MMW 15,B03,886421,Chang; Edmond Yi-Teh,0,7,28,28
1746541550427,MMW 15,B04,886422,Chang; Edmond Yi-Teh,0,8,28,28
1746541550427,MMW 15,C01,886424,Staff,0,9,28,28
1746541550427,MMW 15,C02,886425,Staff,0,8,28,28
1746541550427,MMW 15,C03,886426,Staff,0,8,28,28
1746541550427,MMW 15,C04,886427,Staff,0,7,28,28
1746541550427,MMW 15,C05,958038,Staff,0,7,28,28
1746541550427,MMW 15,C06,958039,Staff,0,8,28,28
1746541551457,MMW 15GS,A00,906910,Patterson; Patrick H.,4,0,28,24
1746541552488,MMW 122R,A01,886429,Rahimi; Babak,0,13,28,28
1746541552488,MMW 122R,A02,886430,Rahimi; Babak,0,12,28,28
1746541552488,MMW 122R,A03,958040,Rahimi; Babak,0,11,28,28
1746541553521,MUS 1A,A01,890937,Staff,3,0,25,22
1746541553521,MUS 1A,A02,891035,Staff,6,0,25,19
1746541553521,MUS 1A,C01,958912,Staff,24,0,25,1
1746541553521,MUS 1A,C02,958913,Staff,25,0,25,0
1746541555578,MUS 2AK,A00,957092,Ohnishi; Takae,15,0,15,0
1746541556610,MUS 4,A01,891044,Staff,2,0,25,23
1746541556610,MUS 4,A02,891045,Staff,23,0,25,2
1746541556610,MUS 4,B01,891048,Staff,17,0,25,8
1746541556610,MUS 4,B02,891050,Staff,25,0,25,0
1746541557640,MUS 5,A01,957506,Dubnov; Shlomo,0,0,25,25
1746541557640,MUS 5,A02,957622,Dubnov; Shlomo,14,0,25,11
1746541557640,MUS 5,A03,957623,Dubnov; Shlomo,20,0,25,5
1746541558673,MUS 6,A01,891053,Freitas Caetano; Marcelo,24,0,25,1
1746541558673,MUS 6,A02,891054,Freitas Caetano; Marcelo,23,0,25,2
1746541559699,MUS 7,A01,891081,Staff,0,0,25,25
1746541559699,MUS 7,A02,891082,Staff,4,0,25,21
1746541560727,MUS 8GS,A00,891118,Borgo; David Garcia,0,0,25,25
1746541561758,MUS 11,A01,891140,Staff,11,0,25,14
1746541561758,MUS 11,A02,891141,Staff,22,0,25,3
1746541562783,MUS 13,A01,891143,Staff,8,0,25,17
1746541562783,MUS 13,A02,891144,Staff,24,0,25,1
1746541563818,MUS 15,A01,891146,Staff,9,0,25,16
1746541563818,MUS 15,A02,891148,Staff,21,0,25,4
1746541563818,MUS 15,B01,891150,Staff,18,0,25,7
1746541563818,MUS 15,B02,891151,Staff,25,0,25,0
1746541564849,MUS 20,A01,891153,Staff,5,0,20,15
1746541564849,MUS 20,A02,891155,Staff,14,0,20,6
1746541565877,MUS 80,A00,891156,Staff,19,0,25,6
1746541565877,MUS 80,B00,891157,Staff,23,0,25,2
1746541566904,MUS 130,A00,891158,Ohnishi; Takae,35,0,35,0
1746541567931,MUS 150GS,A01,891160,Borgo; David Garcia,0,0,25,25
1746541568961,MUS 170,A01,891162,Freitas Caetano; Marcelo,20,0,25,5
1746541568961,MUS 170,A02,891164,Freitas Caetano; Marcelo,21,0,25,4
1746541570017,NANO 11,A00,886220,Vazquez Mena; Oscar,13,0,15,2
1746541571049,NANO 15,A01,886222,Drews; Aaron,4,0,7,3
1746541572078,NANO 104,A00,886224,Sirbuly; Donald,18,0,25,7
1746541573104,PH 40,A00,886528,Staff,23,0,40,17
1746541574132,PH 45,A01,886799,Staff,35,0,40,5
1746541575159,PH 110,A00,886802,Staff,0,7,40,40
1746541576185,PH 172,A00,906716,Staff,19,0,35,16
1746541577210,PH 191,A00,886803,Staff,6,0,40,34
1746541578238,PHIL 1,A00,889500,Staff,19,0,30,11
1746541579263,PHIL 10,A01,889549,Grush; Rick Scott,15,0,22,7
1746541579263,PHIL 10,A02,889551,Grush; Rick Scott,22,0,22,0
1746541580300,PHIL 28,A01,889559,Lamey; Andy M.,0,1,31,31
1746541580300,PHIL 28,A02,889561,Lamey; Andy M.,0,1,30,30
1746541580300,PHIL 28,A03,889572,Lamey; Andy M.,0,0,30,30
1746541581328,PHIL 35,A00,907839,Staff,13,0,15,2
1746541582356,PHIL 60,A00,889574,Staff,74,0,90,16
1746541583384,PHIL 101,A00,958004,Staff,13,0,15,2
1746541585436,PHIL 136,A00,889582,Fulkerson; Matthew Todd,26,0,45,19
1746541586471,PHIL 163,A01,889601,Staff,21,0,30,9
1746541586471,PHIL 163,B01,889606,Brandt; Reuven A,0,3,0,0
1746541587500,PHIL 164,A00,889610,Staff,16,0,30,14
1746541588525,PHIL 165,A00,889613,Staff,23,0,30,7
1746541589558,PHYS 1A,A00,886431,Staff,26,0,70,44
1746541590586,PHYS 1AL,001,886432,Tsai; Philbert S,0,2,30,30
1746541590586,PHYS 1AL,002,886436,Tsai; Philbert S,11,0,30,19
1746541591613,PHYS 1B,A00,886439,Staff,185,0,240,55
1746541592644,PHYS 1BL,001,886441,Tsai; Philbert S,0,4,30,30
1746541592644,PHYS 1BL,002,886444,Tsai; Philbert S,2,0,30,28
1746541593676,PHYS 1C,A00,896092,Arnold; Kam S,78,0,146,68
1746541594708,PHYS 1CL,001,886448,Tsai; Philbert S,0,0,30,30
1746541594708,PHYS 1CL,002,886449,Tsai; Philbert S,0,0,30,30
1746541594708,PHYS 1CL,003,886450,Tsai; Philbert S,15,0,30,15
1746541594708,PHYS 1CL,004,886451,Tsai; Philbert S,15,0,30,15
1746541595739,PHYS 2B,A01,886457,Staff,69,0,115,46
1746541596769,PHYS 2C,A01,886460,Shotwell; Brian,0,8,65,65
1746541597799,PHYS 2CL,A01,886467,Staff,0,4,28,28
1746541597799,PHYS 2CL,A02,886468,Staff,0,3,28,28
1746541598828,PHYS 2D,A01,886470,Staff,10,0,50,40
1746541599856,PHYS 4B,A01,886475,Grinstein; Benjamin,22,0,40,18
1746541600891,POLI 5,A00,891173,Desposato; Scott,7,0,25,18
1746541601918,POLI 5D,A01,891175,Staff,5,0,5,0
1746541601918,POLI 5D,B01,891178,Staff,5,0,5,0
1746541602943,POLI 11,A00,891179,Ferree; Karen E,2,0,35,33
1746541603987,POLI 12,A00,891180,Staff,16,0,30,14
1746541605015,POLI 27,A01,891182,Staff,12,0,75,63
1746541606044,POLI 30,A00,891183,Staff,9,0,50,41
1746541607071,POLI 100B,A00,891244,Staff,5,1,35,30
1746541608098,POLI 100I,A00,891247,Staff,7,0,30,23
1746541609130,POLI 104J,A00,891248,Nichter; Maysa,14,0,30,16
1746541610159,POLI 104U,A00,891250,Nichter; Maysa,2,0,30,28
1746541612216,POLI 110B,A00,891255,Wiens; David,20,0,25,5
1746541613249,POLI 112A,A00,891256,Wiens; David,6,0,25,19
1746541614278,POLI 114BR,A00,891261,Staff,19,0,30,11
1746541615307,POLI 117R,A00,891262,Forman; Fonna,0,6,50,50
1746541616333,POLI 118,A00,891264,Ingham; Sean,17,0,25,8
1746541617364,POLI 124A,A00,891265,Staff,18,0,20,2
1746541618391,POLI 125D,A00,891266,Nichter; Simeon C,2,0,25,23
1746541619423,POLI 126,A00,891268,Nichter; Simeon C,7,0,25,18
1746541620450,POLI 126AA,A00,891272,Staff,18,0,25,7
1746541621479,POLI 130AA,A00,891273,Staff,15,0,20,5
1746541622507,POLI 134AA,A00,891274,Staff,4,0,20,16
1746541624559,POLI 138,A00,891278,Staff,21,0,25,4
1746541625587,POLI 142K,A00,891280,Staff,11,0,25,14
1746541626618,POLI 142M,A00,891281,Gartzke; Erik,17,0,30,13
1746541627648,POLI 142P,A00,891284,Staff,20,0,30,10
1746541628677,POLI 143,A00,891285,Gartzke; Erik,12,0,30,18
1746541629706,POLI 153,A00,891286,Staff,19,0,20,1
1746541631761,POLI 175,A00,891290,Staff,15,0,20,5
1746541632791,PSYC 1,A00,890674,Steiner; Eric Tomas,0,11,45,45
1746541633818,PSYC 2,A00,890676,Albright; Thomas D,21,0,35,14
1746541634845,PSYC 3,A00,890679,Staff,17,0,20,3
1746541635875,PSYC 6,A00,959858,Staff,20,0,20,0
1746541636902,PSYC 60,A01,890684,Rickard; Timothy C.,0,5,45,45
1746541637928,PSYC 70,A01,890689,Geller; Emma Harlan,7,0,30,23
1746541638958,PSYC 71,A01,959860,Staff,21,0,25,4
1746541639985,PSYC 100,A00,890690,Lacefield; Katharine I,0,50,180,180
1746541641011,PSYC 102,A00,890695,Staff,18,0,40,22
1746541642039,PSYC 105,A00,890699,Geller; Emma Harlan,71,0,100,29
1746541643068,PSYC 106,A00,890701,Gorman; Michael R.,5,0,30,25
1746541644096,PSYC 108,A00,890704,Adrian; Julia Anna,0,28,50,50
1746541645125,PSYC 118,A01,890712,Staff,11,0,30,19
1746541646157,PSYC 124,A00,890716,Chapman; Eddie Nathaniel,25,0,60,35
1746541647185,PSYC 131,A00,890717,Anagnostaras; Stephan,0,7,80,80
1746541648212,PSYC 137,A00,890719,Winkielman; Piotr,0,11,30,30
1746541649240,PSYC 144,A00,890721,Adrian; Julia Anna,0,9,45,45
1746541650266,PSYC 162,A00,890805,Staff,2,0,75,73
1746541651292,PSYC 169,A00,890810,Staff,0,15,30,30
1746541652318,PSYC 172,A00,890814,Gorman; Michael R.,9,0,30,21
1746541653351,PSYC 181,A00,890818,Anagnostaras; Stephan,8,0,200,192
1746541654376,PSYC 184,A00,959861,Staff,170,0,175,5
1746541655401,PSYC 189,A00,890823,Staff,0,1,30,30
1746541656433,PSYC 191,A00,890884,Rickard; Timothy C.,0,11,35,35
1746541657458,PSYC 193,A00,890913,Staff,19,0,30,11
1746541657458,PSYC 193,B00,890914,Chapman; Eddie Nathaniel,24,0,30,6
1746541658491,PSYC 193L,A01,890918,Lowe; Angela Beth,20,0,30,10
1746541658491,PSYC 193L,B01,890921,Hurwitz; Ethan Scott,20,0,30,10
1746541658491,PSYC 193L,C01,890928,Staff,30,0,30,0
1746541659517,RELI 149,A00,886806,Rahimi; Babak,23,0,40,17
1746541660547,SE 9,A01,886814,Staff,7,0,20,13
1746541661575,SE 101B,A01,886816,Chadha; Mayank,4,0,35,31
1746541662610,SE 110B,A00,886818,Zhu; Qiang,4,0,75,71
1746541663648,SE 125,A01,886830,Staff,10,0,30,20
1746541664677,SE 130B,A01,886835,Staff,14,0,40,26
1746541665705,SE 131A,A01,886838,Krysl; Petr,34,0,55,21
1746541666731,SE 154,A00,886840,Staff,30,0,50,20
1746541667760,SE 164GS,A01,886849,Staff,6,0,20,14
1746541668785,SE 167GS,A01,886853,Staff,6,0,20,14
1746541669810,SIO 25,A01,890107,Staff,19,0,30,11
1746541670838,SIO 45,A00,890109,Cook; Geoffrey W,117,0,200,83
1746541671869,SIO 109R,A00,890110,Forman; Fonna,0,16,20,20
1746541672894,SIO 187,A01,890114,Kacev; David,15,0,40,25
1746541673923,SOCI 1,A01,890431,Thorpe; Charles Robert,15,0,30,15
1746541673923,SOCI 1,A02,890518,Thorpe; Charles Robert,30,0,30,0
1746541674950,SOCI 2,A01,957978,Staff,25,0,25,0
1746541674950,SOCI 2,A02,957979,Staff,23,0,25,2
1746541675978,SOCI 20,A01,890523,Calderon-Zaks; Michael Aar,23,0,30,7
1746541675978,SOCI 20,A02,890526,Calderon-Zaks; Michael Aar,29,0,30,1
1746541677004,SOCI 30,A01,890533,Pardo Guerra; Juan Pablo,37,0,40,3
1746541678030,SOCI 40,A01,890535,Staff,27,0,45,18
1746541679101,SOCI 104Q,A00,890559,Staff,18,0,30,12
1746541680129,SOCI 106,A00,890560,Arnal; Maud Marie Leonie,20,0,30,10
1746541681156,SOCI 110,A00,890567,Holkenbrink-Monk; Charlene,19,0,30,11
1746541682182,SOCI 112,A00,890568,Victoria Torres; Pablo,1,0,55,54
1746541683208,SOCI 115,A00,890597,Arnal; Maud Marie Leonie,28,0,45,17
1746541685266,SOCI 121,A00,890604,Pardo Guerra; Juan Pablo,38,0,45,7
1746541686371,SOCI 126,A01,890608,Staff,8,0,10,2
1746541687399,SOCI 127,A00,890609,Staff,18,0,30,12
1746541688428,SOCI 131,A00,890610,Thorpe; Charles Robert,37,0,45,8
1746541689453,SOCI 135,A00,890615,Payne; Christine Anna,14,0,45,31
1746541690478,SOCI 139,A00,890620,Staff,38,0,45,7
1746541691504,SOCI 148E,A00,890622,Calderon-Zaks; Michael Aar,36,0,45,9
1746541692530,SOCI 150,A00,890623,Kohler; Kristopher M.,31,0,45,14
1746541693556,SOCI 157,A00,890625,Jules-Rosette; Bennetta W.,18,0,20,2
1746541694583,SOCI 160,A00,890627,Payne; Christine Anna,21,0,45,24
1746541695613,SYN 1,A00,886855,Fish; Gwendolyn Anne,0,0,0,0
1746541695613,SYN 1,B00,906086,Fish; Gwendolyn Anne,0,1,0,2
1746541696640,SYN 2R,A00,886860,Staff,0,17,15,15
1746541696640,SYN 2R,B00,906106,Atkinson; Arthur Laird,0,16,15,15
1746541697669,SYN 100,A01,886866,Browne; Emily,0,28,20,20
1746541697669,SYN 100,B01,906128,Rock; Martin,0,5,20,20
1746541697669,SYN 100,C01,906140,Deavenport; James Cary,0,3,20,20
1746541697669,SYN 100,D01,907816,Deavenport; James Cary,0,5,20,20
1746541698696,TDAC 1,A00,890286,Walsh; Kim C.,9,0,20,11
1746541699724,TDAC 101,A00,890296,Basso; Beatrice,16,0,20,4
1746541700751,TDDE 131,A00,890297,Staff,47,0,50,3
1746541701777,TDDM 1,A00,890287,Weinberg; Sadie,25,0,30,5
1746541702806,TDGE 11,A00,890288,Fulton; Julia,137,0,200,63
1746541702806,TDGE 11,B00,890289,Castro; Robert Jess,184,0,200,16
1746541703831,TDGE 25,B00,957359,Walsh; Kim C.,3,0,20,17
1746541704859,TDGE 40,A01,890292,Power; Jade Yukana,27,0,30,3
1746541705884,TDGE 124,A00,890298,Havis; Allan,0,0,50,50
1746541706910,TDGE 131R,A00,890299,Burelle; Julie Sara Veronique,15,0,42,27
1746541707937,TDHT 101,A00,890300,Staff,10,0,20,10
1746541708965,TDHT 109,A01,890302,Anderson; Mysia Anyse,31,0,40,9
1746541710007,TDMV 1,A00,890293,Arcidiacono; Kristin,18,0,30,12
1746541711035,TDMV 2,A00,890294,Weinberg; Sadie,23,0,30,7
1746541712061,TDMV 3,A00,957878,Arcidiacono; Kristin,28,0,30,2
1746541714114,TDMV 138,A00,890304,Jun; Grace Shin Hae,25,0,40,15
1746541715146,TDMV 140,A00,890305,Corrales; Joseph Bernales,25,0,30,5
1746541716176,TDMV 142,A00,890307,Caligagan; Tony,32,0,40,8
1746541717205,TDMV 144,A00,890308,Camaya; Michelle Ann,25,0,30,5
1746541718232,TDPW 1,A00,890295,Stein; Deborah Isobel,3,0,20,17
1746541719261,USP 2,A01,890272,Lerner; Amy M,6,0,20,14
1746541720287,USP 3,A01,890274,Staff,12,0,30,18
1746541721313,USP 15,A01,890276,Sun; Feiyang,17,0,30,13
1746541722343,USP 25,A00,890277,Shenkman; Michael Thomas,19,0,25,6
1746541723370,USP 138,A00,890278,Staff,13,0,25,12
1746541724396,USP 143,A00,890279,Staff,21,0,70,49
1746541725426,USP 144,A00,890280,Chowdhury; Muhammed Zohir,16,0,30,14
1746541726453,USP 150,A00,890281,Boomhower; Matthew Charles,4,0,30,26
1746541727480,USP 151,A00,890282,Staff,16,0,20,4
1746541728510,USP 162,A00,890283,Andrews; Abigail Leslie,16,0,20,4
1746541729540,USP 168,A00,920477,Kwak; Nancy,1,0,5,4
1746541730570,USP 181,A00,890284,Staff,3,0,20,17
1746541731595,USP 191A,A00,890285,Staff,13,0,20,7
1746541732627,VIS 101,A00,886512,Staff,25,0,75,50
1746541733657,VIS 103,A00,886513,Cruz; Edwin Teddy,61,0,75,14
1746541734686,VIS 108,A00,886514,Staff,3,0,15,12
1746541735719,VIS 127P,A00,886515,Shen; Kuiyi,80,0,146,66
1746541736751,VIS 149,A00,886516,Yoldas; Pinar,0,0,15,15
1746541737778,VIS 164,A00,886526,Erdmann; Dean,19,0,22,3
1746541738806,VIS 194S,A00,886527,Staff,61,0,75,14
1746541739835,WCWP 10A,C00,886484,Martiniuk; Jill,12,0,15,3
1746541740868,WCWP 10B,A00,886490,Uriarte; Emma,0,0,15,15
1746541740868,WCWP 10B,B00,886491,Dhir; Simrita,11,0,15,4
1746541740868,WCWP 10B,C00,886492,Ornelas; Tricia,0,0,15,15
1746541741897,WCWP 100,A00,886494,Young; Mark T,0,7,15,15
1746541744055,AAS 10,A01,886199,Childs; Dennis R.,0,3,0,0
1746541745083,ANAR 104,A01,886940,Shtienberg; Gilad,27,0,30,3
1746541746113,ANAR 120,A00,886953,Staff,12,0,20,8
1746541747144,ANBI 148,A01,886955,Wilder; Linnea Lorene,30,0,40,10
1746541749198,ANSC 122,A00,886957,Staff,25,0,30,5
1746541750222,ANSC 150,A00,886958,Sloane; Julia Kathryn,3,0,15,12
1746541751251,ANSC 156,A00,886959,Jenkins; Janis A.,0,1,15,15
1746541752280,ANSC 180,A00,886960,Staff,11,0,17,6
1746541753312,ANSC 188,A00,886961,Jassal; Aftab,9,0,25,16
1746541754338,ANSC 190,A00,886962,Jassal; Aftab,14,0,25,11
1746541755368,ANSC 191,A00,886963,Staff,18,0,20,2
1746541756394,ANTH 3,A01,891689,Staff,17,0,20,3
1746541757421,ANTH 5,A00,886933,Semendeferi; Ekaterini,16,0,20,4
1746541758450,ANTH 10,A00,886934,Staff,0,12,30,30
1746541759480,ANTH 21,A01,886936,Staff,40,0,60,20
1746541760517,ANTH 23,A01,886938,Staff,92,0,100,8
1746541761549,ANTH 105,A00,886964,Stewart; Alexander B,84,0,100,16
1746541762620,ANTH 108,A00,886965,Pedersen; David,9,0,20,11
1746541763648,AWP 10,001,886147,Staff,0,0,0,0
1746541763648,AWP 10,002,886148,Staff,0,0,0,0
1746541763648,AWP 10,003,886149,Staff,0,0,0,0
1746541763648,AWP 10,004,886150,Staff,0,0,0,0
1746541763648,AWP 10,005,886151,Staff,0,0,0,0
1746541763648,AWP 10,006,886152,Staff,0,0,0,0
1746541763648,AWP 10,007,886153,Staff,0,0,0,0
1746541763648,AWP 10,008,886154,Staff,0,0,0,0
1746541763648,AWP 10,009,886155,Staff,0,0,0,0
1746541763648,AWP 10,010,886156,Staff,0,0,0,0
1746541763648,AWP 10,011,886158,Staff,0,0,0,0
1746541763648,AWP 10,012,886160,Staff,0,0,0,0
1746541763648,AWP 10,013,886161,Staff,0,0,0,0
1746541763648,AWP 10,014,886162,Staff,0,0,0,0
1746541763648,AWP 10,015,886163,Staff,0,0,0,0
1746541763648,AWP 10,016,886164,Staff,0,0,0,0
1746541763648,AWP 10,017,886165,Staff,0,0,0,0
1746541763648,AWP 10,018,886166,Staff,0,0,0,0
1746541763648,AWP 10,019,886168,Staff,0,0,0,0
1746541763648,AWP 10,020,886170,Staff,0,0,0,0
1746541763648,AWP 10,021,886172,Staff,0,0,0,0
1746541764681,AWP 10R,001,886173,Staff,0,1,0,0
1746541764681,AWP 10R,002,886174,Staff,0,1,0,0
1746541764681,AWP 10R,003,886175,Staff,0,0,0,0
1746541764681,AWP 10R,004,886176,Staff,0,0,0,0
1746541764681,AWP 10R,005,886177,Staff,0,0,0,0
1746541764681,AWP 10R,006,886178,Staff,0,0,0,0
1746541764681,AWP 10R,007,886179,Staff,0,0,0,0
1746541764681,AWP 10R,008,886181,Staff,0,0,0,0
1746541764681,AWP 10R,009,886182,Staff,0,0,0,0
1746541764681,AWP 10R,010,886183,Staff,0,0,0,0
1746541764681,AWP 10R,011,886184,Staff,0,0,0,0
1746541764681,AWP 10R,012,886185,Staff,0,0,0,0
1746541764681,AWP 10R,013,886186,Staff,0,0,0,0
1746541764681,AWP 10R,014,886187,Staff,0,0,0,0
1746541764681,AWP 10R,015,886188,Staff,0,0,0,0
1746541764681,AWP 10R,016,886189,Staff,0,0,0,0
1746541765708,AWP 102R,A00,886190,Staff,0,0,0,0
1746541765708,AWP 102R,B00,886191,Staff,0,0,0,0
1746541766734,BENG 100,A01,886193,Staff,17,0,30,13
1746541767765,BENG 122A,A01,886195,Hasty; Jeff M,13,0,30,17
1746541768793,BENG 166A,A00,886196,Sah; Robert Lie-Yuan,0,1,30,30
1746541769824,BENG 190,A00,958050,Khojah; Reem I,24,0,25,1
1746541770853,BIBC 102,A01,894320,Staff,0,0,46,46
1746541770853,BIBC 102,A02,894321,Staff,1,0,46,45
1746541770853,BIBC 102,A03,894344,Staff,7,0,46,39
1746541770853,BIBC 102,A04,894345,Staff,26,0,47,21
1746541771884,BICD 100R,A01,894365,Smith; Laurie,0,3,58,58
1746541771884,BICD 100R,A02,894366,Smith; Laurie,0,5,58,58
1746541771884,BICD 100R,A03,894367,Smith; Laurie,2,0,59,57
1746541771884,BICD 100R,A04,959869,Smith; Laurie,41,0,59,18
1746541772915,BICD 136,A01,894383,Gustafson-Brown; Cindy,14,0,50,36
1746541773954,BIEB 102,A01,894494,Butler; Shannon Rhey,51,0,130,79
1746541776021,BIEB 150,A01,894617,Wills; Christopher,3,0,20,17
1746541776021,BIEB 150,A02,894631,Wills; Christopher,3,0,20,17
1746541776021,BIEB 150,A03,894937,Wills; Christopher,3,0,20,17
1746541776021,BIEB 150,A04,894946,Wills; Christopher,5,0,20,15
1746541777051,BIEB 194,A00,906141,Kurle; Carolyn M.,6,0,20,14
1746541778079,BILD 1,A01,894154,Staff,2,0,19,17
1746541778079,BILD 1,A02,894155,Staff,14,0,19,5
1746541778079,BILD 1,A03,894160,Staff,13,0,19,6
1746541778079,BILD 1,A04,894161,Staff,15,0,18,3
1746541779107,BILD 2,A01,894168,Staff,0,0,50,50
1746541779107,BILD 2,A02,894169,Staff,0,0,50,50
1746541779107,BILD 2,A03,894179,Staff,4,0,50,46
1746541779107,BILD 2,A04,894203,Staff,27,0,50,23
1746541780138,BILD 3,A01,894213,Staff,22,0,31,9
1746541780138,BILD 3,A02,894214,Staff,26,0,31,5
1746541780138,BILD 3,A03,894235,Staff,28,0,31,3
1746541780138,BILD 3,A04,894236,Staff,28,0,32,4
1746541781167,BILD 4,A01,894253,Reuther; Keefe,5,0,24,19
1746541781167,BILD 4,A02,894258,Reuther; Keefe,16,0,24,8
1746541782195,BILD 5,A01,894276,Reuther; Keefe,35,0,50,15
1746541782195,BILD 5,A02,894277,Reuther; Keefe,45,0,50,5
1746541782195,BILD 5,A03,894290,Reuther; Keefe,44,0,50,6
1746541782195,BILD 5,A04,894291,Reuther; Keefe,48,0,50,2
1746541783223,BILD 24,A01,894297,Pirino; Giorgia,40,0,60,20
1746541784257,BIMM 100,B01,958915,Staff,72,0,100,28
1746541785284,BIMM 101,A01,895017,McDonnell; Lisa Marie,0,5,24,24
1746541785284,BIMM 101,A02,895018,McDonnell; Lisa Marie,0,5,24,24
1746541785284,BIMM 101,B01,895020,McDonnell; Lisa Marie,0,6,24,24
1746541785284,BIMM 101,B02,895021,McDonnell; Lisa Marie,0,4,24,24
1746541786312,BIMM 110,A01,895023,Staff,1,0,25,24
1746541786312,BIMM 110,A02,895024,Staff,9,0,25,16
1746541786312,BIMM 110,A03,895025,Staff,18,0,25,7
1746541786312,BIMM 110,A04,895031,Staff,20,0,25,5
1746541787344,BIMM 120,A01,895114,Gustafson-Brown; Cindy,13,0,28,15
1746541787344,BIMM 120,A02,895126,Gustafson-Brown; Cindy,21,0,27,6
1746541788371,BIPN 100,A01,895130,Yang; Mingyu,1,0,38,37
1746541788371,BIPN 100,A02,895131,Yang; Mingyu,32,0,38,6
1746541788371,BIPN 100,A03,895132,Yang; Mingyu,32,0,38,6
1746541788371,BIPN 100,A04,895133,Yang; Mingyu,27,0,36,9
1746541789404,BIPN 120,A01,895135,Cooke; James Edward,0,3,13,13
1746541789404,BIPN 120,A02,895136,Cooke; James Edward,0,1,13,13
1746541789404,BIPN 120,A03,895137,Cooke; James Edward,0,3,13,13
1746541789404,BIPN 120,A04,895156,Cooke; James Edward,0,2,11,11
1746541790434,BIPN 134,A01,895235,Cooke; James Edward,0,2,25,25
1746541790434,BIPN 134,A02,895237,Cooke; James Edward,0,0,25,25
1746541790434,BIPN 134,A03,895240,Cooke; James Edward,3,0,25,22
1746541790434,BIPN 134,A04,895270,Cooke; James Edward,20,0,25,5
1746541791463,BIPN 189,A00,892103,Staff,0,13,14,14
1746541793517,BISP 194,A00,958008,Staff,0,2,0,0
1746541794545,CAT 124,A01,922009,Staff,0,5,20,20
1746541795584,CAT 125R,A00,886390,Morales; Celeste Georgianna,0,2,20,20
1746541795584,CAT 125R,B00,886391,Irwin; Matthew Joseph,0,3,20,20
1746541795584,CAT 125R,C00,886392,Smith; Lauryn Alissa,0,2,20,20
1746541795584,CAT 125R,D00,886393,Vanderschuit; Maya Alysia,0,2,20,20
1746541795584,CAT 125R,E00,886394,Marchisotto; Jennifer Anne,0,4,20,20
1746541796614,CENG 15,A01,886218,Drews; Aaron,3,0,8,5
1746541797645,CENG 113,A00,886219,Opatkiewicz; Justin Paul,15,0,25,10
1746541798677,CGS 101,A00,887044,Staff,7,0,20,13
1746541799704,CGS 105,A01,887046,Staff,14,0,25,11
1746541800734,CGS 112,A00,887047,Cuong; Marisol,12,0,15,3
1746541801761,CGS 113,A00,887048,Staff,23,0,30,7
1746541802786,CGS 120,A00,887049,Staff,10,0,17,7
1746541803823,CHEM 6A,A01,886336,Lam; Tin Yiu,38,0,50,12
1746541803823,CHEM 6A,A02,886338,Lam; Tin Yiu,37,0,50,13
1746541804853,CHEM 6B,A01,886341,Hopkins; Patrycja Anna,16,0,50,34
1746541804853,CHEM 6B,A02,886343,Hopkins; Patrycja Anna,42,0,50,8
1746541805892,CHEM 6C,A01,886346,Albizati; Kim F.,0,2,50,50
1746541805892,CHEM 6C,A02,886348,Albizati; Kim F.,23,0,50,27
1746541806926,CHEM 40A,A01,886352,Klosterman; Jeremy K,65,0,100,35
1746541807953,CHEM 40B,A01,886356,Klosterman; Jeremy K,0,23,100,100
1746541808987,CHEM 41B,A01,886360,Theodorakis; Emmanuel,25,0,50,25
1746541808987,CHEM 41B,A02,886362,Theodorakis; Emmanuel,47,0,50,3
1746541810038,CHIN 165A,A00,886382,Xu; Li,18,0,20,2
1746541811082,CLAS 120,A00,886387,Myerston Santana; Jacobo,33,0,40,7
1746541812116,COGS 9,A01,886967,Shannon; Kyle Michael,42,0,60,18
1746541813145,COGS 11,A01,886969,Staff,11,0,30,19
1746541814179,COGS 14A,A01,886971,Staff,6,0,60,54
1746541815206,COGS 14B,A01,886973,Hoffman; Drew Ellen,4,0,60,56
1746541816236,COGS 18,A01,886975,Morgan; Eric,35,0,60,25
1746541817263,COGS 20,A01,886977,Staff,4,0,8,4
1746541817263,COGS 20,A02,886978,Staff,5,0,7,2
1746541818296,COGS 100,A01,907783,Staff,0,2,30,30
1746541819324,COGS 101B,A01,886980,Staff,0,3,48,48
1746541820352,COGS 101C,A01,886982,Delgado; Tania,0,5,44,44
1746541821380,COGS 102A,A01,886984,Johnson; Christine M.,4,0,30,26
1746541822406,COGS 118B,A01,886986,Staff,0,3,88,88
1746541823436,COGS 150,A01,886988,Bergen; Benjamin,23,0,50,27
1746541824465,COGS 153,A00,886989,Delgado; Tania,0,2,41,41
1746541825493,COGS 186,A01,886991,Staff,0,0,32,32
1746541826524,COGS 187A,A01,886993,Boyle; Mary E. T.,7,0,30,23
1746541827549,COGS 189,A00,886994,Staff,0,1,30,30
1746541828581,COMM 10,A01,886996,Staff,0,0,20,21
1746541828581,COMM 10,A02,886997,Staff,12,0,20,8
1746541828581,COMM 10,A03,959845,Staff,19,0,20,1
1746541829608,COMM 20,A01,886999,Leuning; Grant Maurstad,24,0,40,16
1746541831659,COMM 100A,A01,887002,Staff,0,0,20,25
1746541831659,COMM 100A,A02,887003,Staff,7,0,20,13
1746541832724,COMM 100B,A01,887005,Staff,0,8,20,24
1746541833752,COMM 106D,A00,887006,Staff,14,0,40,26
1746541834789,COMM 110G,A00,887007,Whitworth-Smith; Andrew C,12,0,40,28
1746541835817,COMM 111B,A00,887008,Staff,31,0,40,9
1746541836853,COMM 113T,A00,887009,Abuelhiga; Soraya Jill,28,0,40,12
1746541836853,COMM 113T,B00,906733,Staff,40,0,40,0
1746541837877,COMM 145,A00,887010,Staff,12,0,40,28
1746541838907,COMM 146,A00,887054,Staff,31,0,40,9
1746541839937,COMM 190,A00,887012,Staff,8,0,23,15
1746541840971,CSE 8A,A50,887015,Cao; Yingjun,57,0,85,28
1746541841998,CSE 11,A01,887017,Cao; Yingjun,12,0,70,58
1746541843025,CSE 20,A01,887019,Staff,30,0,50,20
1746541844059,CSE 21,A01,887021,Staff,78,0,100,22
1746541844059,CSE 21,B01,892583,Braun; Oliver,45,0,50,5
1746541845088,CSE 30,A01,887025,Eldon; John,143,0,200,57
1746541846121,CSE 100,A01,887027,Staff,26,0,50,24
1746541846121,CSE 100,A02,887028,Staff,40,0,50,10
1746541847152,CSE 101,A01,887030,Braun; Oliver,75,0,100,25
1746541847152,CSE 101,B01,887032,Jones; Miles E,0,3,50,50
1746541847152,CSE 101,B02,887033,Jones; Miles E,0,1,50,50
1746541848179,CSE 105,A01,908084,Jones; Miles E,32,0,50,18
1746541848179,CSE 105,A02,908087,Jones; Miles E,33,0,50,17
1746541849204,CSE 135,A01,887035,Powell; Thomas Allan,0,4,50,50
1746541850243,CSE 142,A01,887037,Staff,8,0,60,52
1746541851272,CSE 142L,A01,887039,Staff,34,0,60,26
1746541852299,CSE 151A,A01,887041,Solares; Edwin A,48,0,100,52
1746541853326,CSE 175,A01,887043,Kumar; Rakesh,30,0,30,0
1746541854353,CSS 1,A01,886389,Staff,0,1,40,40
1746541855381,DSC 30,A01,908097,Liao; Soohyun Nam,47,0,75,28
1746541856413,DSC 40A,A01,908099,Shannon; Kyle Michael,30,0,50,20
1746541857439,DSC 40B,A01,908112,Staff,16,0,50,34
1746541858469,DSC 80,A01,908116,Staff,19,0,60,41
1746541859505,DSC 197,001,956863,Eldridge; Justin Matthew,9999,0,9999,0
1746541860534,ECE 5,A01,886400,Morris; Karcher William,2,0,6,4
1746541860534,ECE 5,A02,886401,Morris; Karcher William,3,0,6,3
1746541861566,ECE 148,A01,886403,Silberman; Jack,0,14,14,14
1746541862604,ECON 1,A01,887265,Crane; Meredith Helen,12,0,70,58
1746541862604,ECON 1,B01,887268,Staff,43,0,50,7
1746541863636,ECON 2,A01,887273,Crane; Meredith Helen,56,0,70,14
1746541864674,ECON 3,A01,887279,Rondina; Giacomo,32,0,70,38
1746541865713,ECON 4,A01,887282,Anderson; John Charles,0,2,10,10
1746541866742,ECON 5,A01,887285,Staff,33,0,45,12
1746541866742,ECON 5,B01,887292,Staff,41,0,45,4
1746541867779,ECON 100A,A01,887337,Newhouse; Herbert S,54,0,70,16
1746541867779,ECON 100A,B01,887349,Staff,45,0,50,5
1746541868807,ECON 100B,A01,887361,Du; Songzi,29,0,70,41
1746541869834,ECON 100C,A01,887445,Newhouse; Herbert S,59,0,70,11
1746541870861,ECON 105,A00,887488,Vespa; Emanuel Ignacio,23,0,35,12
1746541871889,ECON 109,A01,887506,Shishkin; Denis,28,0,35,7
1746541872917,ECON 110A,A01,887568,Alon; Titan Michael,0,3,35,35
1746541872917,ECON 110A,B01,907601,Alon; Titan Michael,20,0,35,15
1746541873944,ECON 110B,A01,887598,Levkoff; Steven B.,0,23,70,70
1746541874970,ECON 112,A00,887599,Rondina; Giacomo,19,0,35,16
1746541876008,ECON 120A,A01,887603,Dai; Yinlin,36,0,70,34
1746541877038,ECON 120C,A01,887608,Sun; Yixiao,0,1,35,35
1746541877038,ECON 120C,B01,887614,Sun; Yixiao,0,0,35,35
1746541878068,ECON 138,A00,887621,Bharadwaj; Prashant,0,20,20,20
1746541879097,ECON 144,A00,958007,Squires; Dale E,13,0,35,22
1746541880129,ECON 171,A01,907666,Staff,18,0,35,17
1746541881158,ECON 175,A00,887626,Wu; Pak Yeung,23,0,35,12
1746541882187,ECON 190,A00,887640,Vespa; Emanuel Ignacio,23,0,35,12
1746541883218,EDS 25,A01,888197,Staff,0,0,0,0
1746541883218,EDS 25,A02,888209,Staff,0,0,0,0
1746541883218,EDS 25,A03,888210,Staff,0,0,0,0
1746541883218,EDS 25,A04,888212,Staff,0,0,0,0
1746541883218,EDS 25,A05,888213,Staff,0,0,0,0
1746541883218,EDS 25,A06,888214,Staff,0,0,0,0
1746541883218,EDS 25,A07,888235,Staff,0,2,0,0
1746541883218,EDS 25,A08,888236,Staff,0,0,0,0
1746541883218,EDS 25,A09,888240,Staff,0,0,0,0
1746541883218,EDS 25,A10,888244,Staff,0,0,0,0
1746541883218,EDS 25,B01,888273,Staff,0,0,0,0
1746541883218,EDS 25,B02,888285,Staff,0,0,0,0
1746541883218,EDS 25,B03,888423,Staff,0,0,0,1
1746541883218,EDS 25,B04,888432,Staff,0,0,0,0
1746541883218,EDS 25,B05,888433,Staff,0,0,0,0
1746541883218,EDS 25,B06,888467,Staff,0,0,0,0
1746541883218,EDS 25,B07,888468,Staff,0,0,0,0
1746541883218,EDS 25,B08,888479,Staff,0,0,0,0
1746541883218,EDS 25,B09,888484,Staff,0,0,0,0
1746541883218,EDS 25,B10,888487,Staff,0,0,0,0
1746541884245,EDS 38,A01,907700,Choi; Bailey Miyeon,30,0,30,0
1746541885278,EDS 112,A01,888601,Chapman; Thandeka K,14,0,40,26
1746541886306,EDS 115,A00,888697,Mendez; Kathrina Mendoza,10,0,30,20
1746541887336,EDS 116,A01,888893,Staff,35,0,40,5
1746541889395,EDS 124AR,A00,889133,Staff,29,0,50,21
1746541889395,EDS 124AR,B00,907471,Simon; Elizabeth A,37,0,50,13
1746541890423,EDS 124BR,A00,889134,Simon; Elizabeth A,45,0,100,55
1746541891455,EDS 125,A00,889135,Staff,25,0,30,5
1746541892486,EDS 126,A01,889138,Staff,36,0,40,4
1746541893517,EDS 164R,A01,889142,Wishard Guerra; Alison G.,33,0,50,17
1746541894551,ENG 30,A01,886396,Staff,0,0,0,0
1746541894551,ENG 30,B01,886398,Staff,0,0,0,0
1746541895577,ENVR 102,A00,906150,Montejo; Carolina,23,0,25,2
1746541896609,ETHN 103A,A00,887236,Man; Simeon S,0,3,0,0
1746541897638,ETHN 113,A00,887239,Staff,16,0,30,14
1746541898667,ETHN 116,A00,887240,Staff,16,0,25,9
1746541899695,ETHN 117,A00,887241,Choi; Esther Min,28,0,30,2
1746541900723,ETHN 118,A00,887243,Staff,24,0,30,6
1746541901750,ETHN 127,A00,887248,Cuong; Marisol,11,0,15,4
1746541902776,ETHN 139,A00,887250,Staff,7,0,10,3
1746541903812,ETHN 142,A00,887252,Staff,10,0,30,20
1746541904840,ETHN 161,A00,887253,Browne; Errol Tsekani,24,0,30,6
1746541905866,ETHN 163FR,A00,887255,Burelle; Julie Sara Veronique,0,0,5,5
1746541906895,GLBH 20,A00,889149,Elwardani; Nile Regina,8,0,42,34
1746541908949,GLBH 111,A01,889152,Burgos; Jose L.,17,0,17,0
1746541909975,GLBH 150,A00,889181,Sloane; Julia Kathryn,0,5,15,15
1746541912031,HDS 60,A01,886406,Warstadt; Melissa Fawn,73,0,80,7
1746541913064,HIAF 111,A00,889324,Gyamfi; Bright,25,0,32,7
1746541914089,HIEA 131,A00,889328,Staff,16,0,32,16
1746541915117,HIEA 144,A00,889333,Henry; Todd A.,26,0,32,6
1746541916144,HIEA 154,A00,889336,Henry; Todd A.,24,0,32,8
1746541917169,HIEU 106,A00,889339,Staff,22,0,32,10
1746541919260,HIEU 114,A00,889340,Staff,3,0,32,29
1746541920286,HIEU 135GS,A00,889342,Patterson; Patrick H.,0,0,1,24
1746541921311,HIEU 137,A00,889343,Edington; Claire Ellen,9,0,25,16
1746541922340,HIEU 148,A00,889345,Staff,14,0,32,18
1746541923367,HIEU 154,A00,889346,Biess; Frank Peter,21,0,32,11
1746541924396,HILA 102,A00,889351,Staff,12,0,32,20
1746541925424,HILD 2A,A01,889221,Lewandoski; Julia Mavis,1,10,32,31
1746541926451,HILD 7B,A01,889225,Man; Simeon S,0,13,32,32
1746541927479,HILD 7C,A01,889288,Alvarez; Luis A,0,14,32,32
1746541928508,HILD 30,A01,889323,Staff,0,5,32,32
1746541930572,HISC 119,A00,889383,Golan; Tal,21,0,32,11
1746541931601,HIUS 103,A00,889384,Man; Simeon S,0,0,32,32
1746541932628,HIUS 117,A00,919797,Kwak; Nancy,18,0,32,14
1746541933654,HIUS 142A,A00,919788,Staff,22,0,32,10
1746541935709,HIUS 149,A00,889386,Gyamfi; Bright,27,0,32,5
1746541936740,HIUS 155,A00,889387,Alvarez; Luis A,14,0,32,18
1746541937768,HUM 3,A01,886499,Caldwell; Michael Alan,19,0,50,31
1746541938793,HUM 3GS,A00,886500,Rodriguez; Bretton Sigfred,0,0,0,28
1746541939821,HUM 3R,A01,886502,Markman; Kristina,0,36,50,50
1746541940855,HUM 4,A01,886504,Crum; Matthew Stephen,24,0,50,26
1746541940855,HUM 4,B01,886506,West; Geoffrey Scott,17,0,50,33
1746541941883,HUM 4GS,A00,886507,Staff,0,0,0,19
1746541942911,HUM 5,A01,886509,Staff,32,0,50,18
1746541943937,HUM 5R,A01,886511,Zavodny; Tatiana Sophia,0,39,50,50
1746541944971,JAPN 180,A00,886407,Staff,18,0,40,22
1746541946000,LATI 50,A01,886409,Martin-Cabrera; Luis,4,0,22,18
1746541946000,LATI 50,A02,886410,Martin-Cabrera; Luis,19,0,22,3
1746541946000,LATI 50,A03,886411,Martin-Cabrera; Luis,21,0,22,1
1746541946000,LATI 50,A04,886412,Martin-Cabrera; Luis,9,0,22,13
1746541947029,LAWS 101,A00,907664,Staff,28,0,60,32
1746541948059,LIAB 1A,A00,889388,Saab; Dima,17,0,20,3
1746541949084,LIAB 1AX,A00,889389,El Cheddadi; Youniss,17,0,20,3
1746541950116,LIFR 1C,A00,889391,Van Moer; Vinciane G,8,0,20,12
1746541951147,LIFR 1CX,A00,889392,Van Moer; Vinciane G,7,0,20,13
1746541952175,LIFR 1D,A00,889393,Van Moer; Vinciane G,7,0,20,13
1746541953207,LIFR 1DX,A00,889394,Van Moer; Vinciane G,8,0,20,12
1746541954234,LIGN 7,A00,886923,Staff,24,0,50,26
1746541955264,LIGN 17,A00,886924,Kehler; Andrew Scott,125,0,150,25
1746541956291,LTAM 110,A00,889395,Staff,15,0,30,15
1746541957321,LTAM 110GS,A00,958010,Rodriguez; Bretton Sigfred,0,0,0,28
1746541958353,LTCH 101,A00,889397,Staff,23,0,25,2
1746541959378,LTCS 130,A00,889398,Staff,23,0,25,2
1746541960407,LTEA 138,A00,889399,Staff,24,0,40,16
1746541961437,LTEN 149,A00,889400,Wesling; Megan E.,0,3,25,25
1746541962466,LTEN 169,A00,889401,Staff,20,0,25,5
1746541963492,LTEN 180,A00,889402,Staff,10,0,15,5
1746541964519,LTEN 181,A00,889403,Staff,21,0,25,4
1746541965545,LTWL 100,A00,889404,Myerston Santana; Jacobo,3,0,25,22
1746541966572,LTWL 180GS,A00,889405,Staff,0,0,20,20
1746541967600,LTWL 181,A00,889406,Staff,17,0,25,8
1746541968627,LTWL 184,A00,889475,Mukherjee; Silpa,22,0,25,3
1746541969655,LTWR 102C,A00,889486,Staff,29,0,30,1
1746541970683,LTWR 115W,A00,889491,Staff,0,2,15,15
1746541971708,MAE 8,A01,886905,Staff,0,2,0,0
1746541972734,MAE 11,A00,886906,Bandaru; Prabhakar,0,7,50,50
1746541973764,MAE 20,A00,886907,Evdokimenko; Ekaterina,44,0,70,26
1746541974793,MAE 30B,A00,886909,Ghazinejad; Maziar,26,0,45,19
1746541975822,MAE 101B,A00,886910,Saintillan; David,29,0,45,16
1746541976851,MAE 105,A00,886911,Bandaru; Prabhakar,18,0,50,32
1746541977878,MAE 107,B00,958024,Staff,9,0,50,41
1746541978904,MAE 143B,A00,886913,Bewley; Thomas R,7,0,40,33
1746541979931,MAE 148,A01,886915,Silberman; Jack,0,3,14,14
1746541980956,MAE 160,A00,886916,Evdokimenko; Ekaterina,31,0,60,29
1746541981989,MATH 3C,A01,889681,Staff,0,3,30,30
1746541981989,MATH 3C,A02,960048,Staff,25,0,30,5
1746541983021,MATH 10A,A01,889760,Staff,26,0,30,4
1746541983021,MATH 10A,A02,889783,Staff,29,0,30,1
1746541984055,MATH 10B,A01,889785,Verstraete; Jacques Allan,2,0,35,33
1746541984055,MATH 10B,A02,889795,Verstraete; Jacques Allan,4,0,35,31
1746541984055,MATH 10B,B01,889797,Verstraete; Jacques Allan,3,0,35,32
1746541984055,MATH 10B,B02,889828,Verstraete; Jacques Allan,3,0,35,32
1746541985082,MATH 10C,A01,889849,Habib; Yousaf,9,0,30,21
1746541985082,MATH 10C,A02,889852,Habib; Yousaf,14,0,30,16
1746541985082,MATH 10C,A03,889853,Habib; Yousaf,22,0,30,8
1746541985082,MATH 10C,A04,889858,Habib; Yousaf,20,0,30,10
1746541985082,MATH 10C,B01,889861,Staff,1,0,30,29
1746541985082,MATH 10C,B02,889862,Staff,24,0,30,6
1746541985082,MATH 10C,B03,889863,Staff,27,0,30,3
1746541985082,MATH 10C,B04,889967,Staff,23,0,30,7
1746541986110,MATH 18,A01,889974,Staff,7,0,30,23
1746541986110,MATH 18,A02,889977,Staff,20,0,30,10
1746541986110,MATH 18,B01,889984,Hardiman; Liam,22,0,30,8
1746541986110,MATH 18,B02,889985,Hardiman; Liam,25,0,30,5
1746541987142,MATH 20A,A01,889990,Suk; Andrew Hoon,29,0,35,6
1746541988172,MATH 20B,A01,889993,Ohm; Ko Woon,22,0,30,8
1746541988172,MATH 20B,A02,889994,Ohm; Ko Woon,30,0,30,0
1746541988172,MATH 20B,B01,889996,Ohm; Ko Woon,21,0,30,9
1746541988172,MATH 20B,B02,889997,Ohm; Ko Woon,23,0,30,7
1746541989200,MATH 20C,A01,889999,Hammock; Frances H,17,0,30,13
1746541989200,MATH 20C,A02,890003,Hammock; Frances H,23,0,30,7
1746541989200,MATH 20C,B01,890006,Hammock; Frances H,3,0,30,27
1746541989200,MATH 20C,B02,890007,Hammock; Frances H,11,0,30,19
1746541990226,MATH 20D,A01,890011,Cheng; Hsiao-Bing,1,1,30,29
1746541990226,MATH 20D,A02,890012,Cheng; Hsiao-Bing,14,0,30,16
1746541990226,MATH 20D,B01,890016,Cheng; Hsiao-Bing,13,0,30,17
1746541990226,MATH 20D,B02,890017,Cheng; Hsiao-Bing,13,0,30,17
1746541991254,MATH 20E,A01,890026,Harel; Guershon,1,0,30,29
1746541991254,MATH 20E,A02,890029,Harel; Guershon,23,0,30,7
1746541991254,MATH 20E,B01,890033,Harel; Guershon,7,0,30,23
1746541991254,MATH 20E,B02,890101,Harel; Guershon,21,0,30,9
1746541992281,MATH 102,A01,890104,Staff,17,0,30,13
1746541992281,MATH 102,A02,890105,Staff,27,0,30,3
1746541993306,MATH 103B,A01,890116,Salehi Golsefidy; Alireza,3,0,30,27
1746541993306,MATH 103B,B01,890118,Staff,0,3,34,34
1746541994339,MATH 109,A01,890121,Aliabadi Sr.; Mohsen,1,0,30,29
1746541994339,MATH 109,B01,890124,Upadrashta; Pranav Kumar,18,0,30,12
1746541995370,MATH 120A,A01,890126,Eggers; John Dietrich,13,0,30,17
1746541996400,MATH 142B,A01,890128,Ioana; Adrian,19,0,30,11
1746541996400,MATH 142B,A02,890129,Ioana; Adrian,13,0,30,17
1746541997430,MATH 154,A01,890174,Staff,0,0,30,30
1746541997430,MATH 154,A02,890182,Staff,0,0,30,30
1746541998460,MATH 168A,A01,890197,Dumitriu; Ioana,21,0,35,14
1746541999491,MATH 170A,A01,890240,Nie; Jiawang,1,0,30,29
1746541999491,MATH 170A,A02,890241,Nie; Jiawang,11,0,30,19
1746541999491,MATH 170A,A03,890249,Nie; Jiawang,23,0,30,7
1746542000522,MATH 170B,A01,957891,Nag; Panchali,13,0,35,22
1746542002584,MATH 181A,A01,908025,Staff,0,4,35,35
1746542002584,MATH 181A,A02,960115,Staff,27,0,35,8
1746542003608,MATH 181B,A01,959874,Staff,26,0,30,4
1746542004637,MATH 193B,A01,890265,Staff,0,4,35,35
1746542005668,MGT 4,A01,890311,Anderson; John Charles,42,0,88,46
1746542006693,MGT 5,A00,907740,Staff,13,0,98,85
1746542007718,MGT 12,A00,890312,Lindenberger; Wade Douglas,67,0,98,31
1746542008745,MGT 16,A00,957883,Staff,78,0,98,20
1746542010800,MGT 45,A00,890314,Pecore; Joseph P.,47,0,98,51
1746542011829,MGT 71,A00,890315,Staff,0,11,98,98
1746542012853,MGT 100,A00,890316,Yavorsky; Daniel Ryan,44,0,98,54
1746542013879,MGT 103,A00,890317,Ehrich; Kristine R,73,0,98,25
1746542014905,MGT 105,A00,890356,Bates; Kenneth Walter,0,7,98,98
1746542015934,MGT 112,A00,890360,Ehrich; Kristine R,55,0,98,43
1746542016960,MGT 127R,A00,907732,Zhu; Kevin Xiaoguo,23,0,98,75
1746542017989,MGT 131B,A00,890361,Anderson; John Charles,61,0,98,37
1746542019017,MGT 137,A00,890362,Lindenberger; Wade Douglas,65,0,98,33
1746542020047,MGT 160,A00,890369,Johnson; Erik Barry,9,0,98,89
1746542022105,MGT 164,A00,890372,Zimmermann; Carsten,0,39,98,98
1746542023131,MGT 180,A00,890374,Bliss; Barbara Ann,12,0,98,86
1746542024158,MMW 15,A01,886414,Chang; Edmond Yi-Teh,0,12,28,28
1746542024158,MMW 15,A02,886415,Chang; Edmond Yi-Teh,0,8,28,28
1746542024158,MMW 15,A03,886416,Chang; Edmond Yi-Teh,0,8,28,28
1746542024158,MMW 15,A04,886417,Chang; Edmond Yi-Teh,0,8,28,28
1746542024158,MMW 15,B01,886419,Chang; Edmond Yi-Teh,0,7,28,28
1746542024158,MMW 15,B02,886420,Chang; Edmond Yi-Teh,0,8,28,28
1746542024158,MMW 15,B03,886421,Chang; Edmond Yi-Teh,0,7,28,28
1746542024158,MMW 15,B04,886422,Chang; Edmond Yi-Teh,0,8,28,28
1746542024158,MMW 15,C01,886424,Staff,0,9,28,28
1746542024158,MMW 15,C02,886425,Staff,0,8,28,28
1746542024158,MMW 15,C03,886426,Staff,0,8,28,28
1746542024158,MMW 15,C04,886427,Staff,0,7,28,28
1746542024158,MMW 15,C05,958038,Staff,0,7,28,28
1746542024158,MMW 15,C06,958039,Staff,0,8,28,28
1746542025186,MMW 15GS,A00,906910,Patterson; Patrick H.,4,0,28,24
1746542026214,MMW 122R,A01,886429,Rahimi; Babak,0,13,28,28
1746542026214,MMW 122R,A02,886430,Rahimi; Babak,0,12,28,28
1746542026214,MMW 122R,A03,958040,Rahimi; Babak,0,11,28,28
1746542027241,MUS 1A,A01,890937,Staff,3,0,25,22
1746542027241,MUS 1A,A02,891035,Staff,6,0,25,19
1746542027241,MUS 1A,C01,958912,Staff,24,0,25,1
1746542027241,MUS 1A,C02,958913,Staff,25,0,25,0
1746542029300,MUS 2AK,A00,957092,Ohnishi; Takae,15,0,15,0
1746542030329,MUS 4,A01,891044,Staff,2,0,25,23
1746542030329,MUS 4,A02,891045,Staff,23,0,25,2
1746542030329,MUS 4,B01,891048,Staff,17,0,25,8
1746542030329,MUS 4,B02,891050,Staff,25,0,25,0
1746542031361,MUS 5,A01,957506,Dubnov; Shlomo,0,0,25,25
1746542031361,MUS 5,A02,957622,Dubnov; Shlomo,14,0,25,11
1746542031361,MUS 5,A03,957623,Dubnov; Shlomo,20,0,25,5
1746542032387,MUS 6,A01,891053,Freitas Caetano; Marcelo,24,0,25,1
1746542032387,MUS 6,A02,891054,Freitas Caetano; Marcelo,23,0,25,2
1746542033422,MUS 7,A01,891081,Staff,0,0,25,25
1746542033422,MUS 7,A02,891082,Staff,4,0,25,21
1746542034448,MUS 8GS,A00,891118,Borgo; David Garcia,0,0,25,25
1746542035476,MUS 11,A01,891140,Staff,11,0,25,14
1746542035476,MUS 11,A02,891141,Staff,22,0,25,3
1746542036502,MUS 13,A01,891143,Staff,8,0,25,17
1746542036502,MUS 13,A02,891144,Staff,24,0,25,1
1746542037528,MUS 15,A01,891146,Staff,9,0,25,16
1746542037528,MUS 15,A02,891148,Staff,21,0,25,4
1746542037528,MUS 15,B01,891150,Staff,18,0,25,7
1746542037528,MUS 15,B02,891151,Staff,25,0,25,0
1746542038555,MUS 20,A01,891153,Staff,5,0,20,15
1746542038555,MUS 20,A02,891155,Staff,14,0,20,6
1746542039582,MUS 80,A00,891156,Staff,19,0,25,6
1746542039582,MUS 80,B00,891157,Staff,23,0,25,2
1746542040608,MUS 130,A00,891158,Ohnishi; Takae,35,0,35,0
1746542041633,MUS 150GS,A01,891160,Borgo; David Garcia,0,0,25,25
1746542042659,MUS 170,A01,891162,Freitas Caetano; Marcelo,20,0,25,5
1746542042659,MUS 170,A02,891164,Freitas Caetano; Marcelo,21,0,25,4
1746542043687,NANO 11,A00,886220,Vazquez Mena; Oscar,13,0,15,2
1746542044711,NANO 15,A01,886222,Drews; Aaron,4,0,7,3
1746542045738,NANO 104,A00,886224,Sirbuly; Donald,18,0,25,7
1746542046765,PH 40,A00,886528,Staff,23,0,40,17
1746542047796,PH 45,A01,886799,Staff,35,0,40,5
1746542048824,PH 110,A00,886802,Staff,0,7,40,40
1746542049856,PH 172,A00,906716,Staff,19,0,35,16
1746542050883,PH 191,A00,886803,Staff,6,0,40,34
1746542051912,PHIL 1,A00,889500,Staff,19,0,30,11
1746542052945,PHIL 10,A01,889549,Grush; Rick Scott,15,0,22,7
1746542052945,PHIL 10,A02,889551,Grush; Rick Scott,22,0,22,0
1746542053978,PHIL 28,A01,889559,Lamey; Andy M.,0,1,31,31
1746542053978,PHIL 28,A02,889561,Lamey; Andy M.,0,1,30,30
1746542053978,PHIL 28,A03,889572,Lamey; Andy M.,0,0,30,30
1746542055005,PHIL 35,A00,907839,Staff,13,0,15,2
1746542056035,PHIL 60,A00,889574,Staff,74,0,90,16
1746542057060,PHIL 101,A00,958004,Staff,13,0,15,2
1746542059114,PHIL 136,A00,889582,Fulkerson; Matthew Todd,26,0,45,19
1746542060144,PHIL 163,A01,889601,Staff,21,0,30,9
1746542060144,PHIL 163,B01,889606,Brandt; Reuven A,0,3,0,0
1746542061174,PHIL 164,A00,889610,Staff,16,0,30,14
1746542062200,PHIL 165,A00,889613,Staff,23,0,30,7
1746542063227,PHYS 1A,A00,886431,Staff,26,0,70,44
1746542064253,PHYS 1AL,001,886432,Tsai; Philbert S,0,2,30,30
1746542064253,PHYS 1AL,002,886436,Tsai; Philbert S,11,0,30,19
1746542065281,PHYS 1B,A00,886439,Staff,185,0,240,55
1746542066310,PHYS 1BL,001,886441,Tsai; Philbert S,0,4,30,30
1746542066310,PHYS 1BL,002,886444,Tsai; Philbert S,2,0,30,28
1746542067336,PHYS 1C,A00,896092,Arnold; Kam S,78,0,146,68
1746542068367,PHYS 1CL,001,886448,Tsai; Philbert S,0,0,30,30
1746542068367,PHYS 1CL,002,886449,Tsai; Philbert S,0,0,30,30
1746542068367,PHYS 1CL,003,886450,Tsai; Philbert S,16,0,30,14
1746542068367,PHYS 1CL,004,886451,Tsai; Philbert S,15,0,30,15
1746542069397,PHYS 2B,A01,886457,Staff,69,0,115,46
1746542070424,PHYS 2C,A01,886460,Shotwell; Brian,0,8,65,65
1746542071451,PHYS 2CL,A01,886467,Staff,0,4,28,28
1746542071451,PHYS 2CL,A02,886468,Staff,0,3,28,28
1746542072478,PHYS 2D,A01,886470,Staff,10,0,50,40
1746542073510,PHYS 4B,A01,886475,Grinstein; Benjamin,22,0,40,18
1746542074540,POLI 5,A00,891173,Desposato; Scott,7,0,25,18
1746542075566,POLI 5D,A01,891175,Staff,5,0,5,0
1746542075566,POLI 5D,B01,891178,Staff,5,0,5,0
1746542076596,POLI 11,A00,891179,Ferree; Karen E,2,0,35,33
1746542077621,POLI 12,A00,891180,Staff,16,0,30,14
1746542078648,POLI 27,A01,891182,Staff,12,0,75,63
1746542079676,POLI 30,A00,891183,Staff,9,0,50,41
1746542080704,POLI 100B,A00,891244,Staff,5,1,35,30
1746542081730,POLI 100I,A00,891247,Staff,7,0,30,23
1746542082757,POLI 104J,A00,891248,Nichter; Maysa,14,0,30,16
1746542083785,POLI 104U,A00,891250,Nichter; Maysa,2,0,30,28
1746542085835,POLI 110B,A00,891255,Wiens; David,20,0,25,5
1746542086861,POLI 112A,A00,891256,Wiens; David,6,0,25,19
1746542087890,POLI 114BR,A00,891261,Staff,19,0,30,11
1746542088920,POLI 117R,A00,891262,Forman; Fonna,0,6,50,50
1746542089949,POLI 118,A00,891264,Ingham; Sean,17,0,25,8
1746542090977,POLI 124A,A00,891265,Staff,18,0,20,2
1746542092009,POLI 125D,A00,891266,Nichter; Simeon C,2,0,25,23
1746542093035,POLI 126,A00,891268,Nichter; Simeon C,7,0,25,18
1746542094064,POLI 126AA,A00,891272,Staff,18,0,25,7
1746542095088,POLI 130AA,A00,891273,Staff,15,0,20,5
1746542096118,POLI 134AA,A00,891274,Staff,4,0,20,16
1746542098172,POLI 138,A00,891278,Staff,21,0,25,4
1746542099200,POLI 142K,A00,891280,Staff,11,0,25,14
1746542100226,POLI 142M,A00,891281,Gartzke; Erik,17,0,30,13
1746542101250,POLI 142P,A00,891284,Staff,20,0,30,10
1746542102285,POLI 143,A00,891285,Gartzke; Erik,12,0,30,18
1746542103312,POLI 153,A00,891286,Staff,19,0,20,1
1746542105365,POLI 175,A00,891290,Staff,15,0,20,5
1746542106402,PSYC 1,A00,890674,Steiner; Eric Tomas,0,11,45,45
1746542107428,PSYC 2,A00,890676,Albright; Thomas D,21,0,35,14
1746542108460,PSYC 3,A00,890679,Staff,17,0,20,3
1746542109489,PSYC 6,A00,959858,Staff,20,0,20,0
1746542110519,PSYC 60,A01,890684,Rickard; Timothy C.,0,5,45,45
1746542111555,PSYC 70,A01,890689,Geller; Emma Harlan,7,0,30,23
1746542112582,PSYC 71,A01,959860,Staff,21,0,25,4
1746542113608,PSYC 100,A00,890690,Lacefield; Katharine I,0,50,180,180
1746542114635,PSYC 102,A00,890695,Staff,18,0,40,22
1746542115664,PSYC 105,A00,890699,Geller; Emma Harlan,71,0,100,29
1746542116690,PSYC 106,A00,890701,Gorman; Michael R.,5,0,30,25
1746542117722,PSYC 108,A00,890704,Adrian; Julia Anna,0,28,50,50
1746542118752,PSYC 118,A01,890712,Staff,11,0,30,19
1746542119779,PSYC 124,A00,890716,Chapman; Eddie Nathaniel,25,0,60,35
1746542120808,PSYC 131,A00,890717,Anagnostaras; Stephan,0,7,80,80
1746542121838,PSYC 137,A00,890719,Winkielman; Piotr,0,11,30,30
1746542122865,PSYC 144,A00,890721,Adrian; Julia Anna,0,9,45,45
1746542123896,PSYC 162,A00,890805,Staff,2,0,75,73
1746542124922,PSYC 169,A00,890810,Staff,0,15,30,30
1746542125948,PSYC 172,A00,890814,Gorman; Michael R.,9,0,30,21
1746542126974,PSYC 181,A00,890818,Anagnostaras; Stephan,8,0,200,192
1746542128002,PSYC 184,A00,959861,Staff,170,0,175,5
1746542129032,PSYC 189,A00,890823,Staff,0,1,30,30
1746542130059,PSYC 191,A00,890884,Rickard; Timothy C.,0,11,35,35
1746542131085,PSYC 193,A00,890913,Staff,19,0,30,11
1746542131085,PSYC 193,B00,890914,Chapman; Eddie Nathaniel,24,0,30,6
1746542132117,PSYC 193L,A01,890918,Lowe; Angela Beth,20,0,30,10
1746542132117,PSYC 193L,B01,890921,Hurwitz; Ethan Scott,20,0,30,10
1746542132117,PSYC 193L,C01,890928,Staff,30,0,30,0
1746542133147,RELI 149,A00,886806,Rahimi; Babak,23,0,40,17
1746542134173,SE 9,A01,886814,Staff,7,0,20,13
1746542135200,SE 101B,A01,886816,Chadha; Mayank,4,0,35,31
1746542136226,SE 110B,A00,886818,Zhu; Qiang,4,0,75,71
1746542137252,SE 125,A01,886830,Staff,10,0,30,20
1746542138279,SE 130B,A01,886835,Staff,14,0,40,26
1746542139307,SE 131A,A01,886838,Krysl; Petr,34,0,55,21
1746542140338,SE 154,A00,886840,Staff,30,0,50,20
1746542141366,SE 164GS,A01,886849,Staff,6,0,20,14
1746542142394,SE 167GS,A01,886853,Staff,6,0,20,14
1746542143425,SIO 25,A01,890107,Staff,19,0,30,11
1746542144452,SIO 45,A00,890109,Cook; Geoffrey W,117,0,200,83
1746542145480,SIO 109R,A00,890110,Forman; Fonna,0,16,20,20
1746542146509,SIO 187,A01,890114,Kacev; David,15,0,40,25
1746542147543,SOCI 1,A01,890431,Thorpe; Charles Robert,15,0,30,15
1746542147543,SOCI 1,A02,890518,Thorpe; Charles Robert,30,0,30,0
1746542148575,SOCI 2,A01,957978,Staff,25,0,25,0
1746542148575,SOCI 2,A02,957979,Staff,23,0,25,2
1746542149603,SOCI 20,A01,890523,Calderon-Zaks; Michael Aar,23,0,30,7
1746542149603,SOCI 20,A02,890526,Calderon-Zaks; Michael Aar,29,0,30,1
1746542150629,SOCI 30,A01,890533,Pardo Guerra; Juan Pablo,37,0,40,3
1746542151655,SOCI 40,A01,890535,Staff,27,0,45,18
1746542152684,SOCI 104Q,A00,890559,Staff,18,0,30,12
1746542153715,SOCI 106,A00,890560,Arnal; Maud Marie Leonie,20,0,30,10
1746542154745,SOCI 110,A00,890567,Holkenbrink-Monk; Charlene,19,0,30,11
1746542155771,SOCI 112,A00,890568,Victoria Torres; Pablo,1,0,55,54
1746542156800,SOCI 115,A00,890597,Arnal; Maud Marie Leonie,28,0,45,17
1746542158855,SOCI 121,A00,890604,Pardo Guerra; Juan Pablo,38,0,45,7
1746542159881,SOCI 126,A01,890608,Staff,8,0,10,2
1746542160909,SOCI 127,A00,890609,Staff,18,0,30,12
1746542161934,SOCI 131,A00,890610,Thorpe; Charles Robert,37,0,45,8
1746542162959,SOCI 135,A00,890615,Payne; Christine Anna,14,0,45,31
1746542163988,SOCI 139,A00,890620,Staff,38,0,45,7
1746542165023,SOCI 148E,A00,890622,Calderon-Zaks; Michael Aar,36,0,45,9
1746542166051,SOCI 150,A00,890623,Kohler; Kristopher M.,31,0,45,14
1746542167078,SOCI 157,A00,890625,Jules-Rosette; Bennetta W.,18,0,20,2
1746542168109,SOCI 160,A00,890627,Payne; Christine Anna,21,0,45,24
1746542169136,SYN 1,A00,886855,Fish; Gwendolyn Anne,0,0,0,0
1746542169136,SYN 1,B00,906086,Fish; Gwendolyn Anne,0,1,0,2
1746542170163,SYN 2R,A00,886860,Staff,0,17,15,15
1746542170163,SYN 2R,B00,906106,Atkinson; Arthur Laird,0,16,15,15
1746542171193,SYN 100,A01,886866,Browne; Emily,0,28,20,20
1746542171193,SYN 100,B01,906128,Rock; Martin,0,5,20,20
1746542171193,SYN 100,C01,906140,Deavenport; James Cary,0,3,20,20
1746542171193,SYN 100,D01,907816,Deavenport; James Cary,0,5,20,20
1746542172221,TDAC 1,A00,890286,Walsh; Kim C.,9,0,20,11
1746542173252,TDAC 101,A00,890296,Basso; Beatrice,16,0,20,4
1746542174278,TDDE 131,A00,890297,Staff,47,0,50,3
1746542175305,TDDM 1,A00,890287,Weinberg; Sadie,25,0,30,5
1746542176334,TDGE 11,A00,890288,Fulton; Julia,137,0,200,63
1746542176334,TDGE 11,B00,890289,Castro; Robert Jess,184,0,200,16
1746542177360,TDGE 25,B00,957359,Walsh; Kim C.,3,0,20,17
1746542178389,TDGE 40,A01,890292,Power; Jade Yukana,27,0,30,3
1746542179420,TDGE 124,A00,890298,Havis; Allan,0,0,50,50
1746542180449,TDGE 131R,A00,890299,Burelle; Julie Sara Veronique,15,0,42,27
1746542181475,TDHT 101,A00,890300,Staff,10,0,20,10
1746542182507,TDHT 109,A01,890302,Anderson; Mysia Anyse,31,0,40,9
1746542183536,TDMV 1,A00,890293,Arcidiacono; Kristin,18,0,30,12
1746542184569,TDMV 2,A00,890294,Weinberg; Sadie,23,0,30,7
1746542185593,TDMV 3,A00,957878,Arcidiacono; Kristin,28,0,30,2
1746542187648,TDMV 138,A00,890304,Jun; Grace Shin Hae,25,0,40,15
1746542188679,TDMV 140,A00,890305,Corrales; Joseph Bernales,25,0,30,5
1746542189704,TDMV 142,A00,890307,Caligagan; Tony,32,0,40,8
1746542190733,TDMV 144,A00,890308,Camaya; Michelle Ann,25,0,30,5
1746542191762,TDPW 1,A00,890295,Stein; Deborah Isobel,3,0,20,17
1746542192790,USP 2,A01,890272,Lerner; Amy M,6,0,20,14
1746542193815,USP 3,A01,890274,Staff,12,0,30,18
1746542194848,USP 15,A01,890276,Sun; Feiyang,17,0,30,13
1746542195875,USP 25,A00,890277,Shenkman; Michael Thomas,19,0,25,6
1746542196929,USP 138,A00,890278,Staff,13,0,25,12
1746542197954,USP 143,A00,890279,Staff,21,0,70,49
1746542198983,USP 144,A00,890280,Chowdhury; Muhammed Zohir,16,0,30,14
1746542200020,USP 150,A00,890281,Boomhower; Matthew Charles,4,0,30,26
1746542201046,USP 151,A00,890282,Staff,16,0,20,4
1746542202074,USP 162,A00,890283,Andrews; Abigail Leslie,16,0,20,4
1746542203099,USP 168,A00,920477,Kwak; Nancy,1,0,5,4
1746542204125,USP 181,A00,890284,Staff,3,0,20,17
1746542205153,USP 191A,A00,890285,Staff,13,0,20,7
1746542206184,VIS 101,A00,886512,Staff,25,0,75,50
1746542207210,VIS 103,A00,886513,Cruz; Edwin Teddy,61,0,75,14
1746542208238,VIS 108,A00,886514,Staff,3,0,15,12
1746542209266,VIS 127P,A00,886515,Shen; Kuiyi,80,0,146,66
1746542210292,VIS 149,A00,886516,Yoldas; Pinar,0,0,15,15
1746542211321,VIS 164,A00,886526,Erdmann; Dean,19,0,22,3
1746542212345,VIS 194S,A00,886527,Staff,61,0,75,14
1746542213376,WCWP 10A,C00,886484,Martiniuk; Jill,12,0,15,3
1746542214404,WCWP 10B,A00,886490,Uriarte; Emma,0,0,15,15
1746542214404,WCWP 10B,B00,886491,Dhir; Simrita,11,0,15,4
1746542214404,WCWP 10B,C00,886492,Ornelas; Tricia,0,0,15,15
1746542215439,WCWP 100,A00,886494,Young; Mark T,0,7,15,15
1746542217581,AAS 10,A01,886199,Childs; Dennis R.,0,3,0,0
1746542218609,ANAR 104,A01,886940,Shtienberg; Gilad,27,0,30,3
1746542219634,ANAR 120,A00,886953,Staff,12,0,20,8
1746542220663,ANBI 148,A01,886955,Wilder; Linnea Lorene,30,0,40,10
1746542222712,ANSC 122,A00,886957,Staff,25,0,30,5
1746542223737,ANSC 150,A00,886958,Sloane; Julia Kathryn,3,0,15,12
1746542224773,ANSC 156,A00,886959,Jenkins; Janis A.,0,1,15,15
1746542225802,ANSC 180,A00,886960,Staff,11,0,17,6
1746542226833,ANSC 188,A00,886961,Jassal; Aftab,9,0,25,16
1746542227858,ANSC 190,A00,886962,Jassal; Aftab,14,0,25,11
1746542228888,ANSC 191,A00,886963,Staff,18,0,20,2
1746542229917,ANTH 3,A01,891689,Staff,17,0,20,3
1746542230943,ANTH 5,A00,886933,Semendeferi; Ekaterini,16,0,20,4
1746542231995,ANTH 10,A00,886934,Staff,0,12,30,30
1746542233021,ANTH 21,A01,886936,Staff,40,0,60,20
1746542234047,ANTH 23,A01,886938,Staff,92,0,100,8
1746542235073,ANTH 105,A00,886964,Stewart; Alexander B,84,0,100,16
1746542236102,ANTH 108,A00,886965,Pedersen; David,9,0,20,11
1746542237135,AWP 10,001,886147,Staff,0,0,0,0
1746542237135,AWP 10,002,886148,Staff,0,0,0,0
1746542237135,AWP 10,003,886149,Staff,0,0,0,0
1746542237135,AWP 10,004,886150,Staff,0,0,0,0
1746542237135,AWP 10,005,886151,Staff,0,0,0,0
1746542237135,AWP 10,006,886152,Staff,0,0,0,0
1746542237135,AWP 10,007,886153,Staff,0,0,0,0
1746542237135,AWP 10,008,886154,Staff,0,0,0,0
1746542237135,AWP 10,009,886155,Staff,0,0,0,0
1746542237135,AWP 10,010,886156,Staff,0,0,0,0
1746542237135,AWP 10,011,886158,Staff,0,0,0,0
1746542237135,AWP 10,012,886160,Staff,0,0,0,0
1746542237135,AWP 10,013,886161,Staff,0,0,0,0
1746542237135,AWP 10,014,886162,Staff,0,0,0,0
1746542237135,AWP 10,015,886163,Staff,0,0,0,0
1746542237135,AWP 10,016,886164,Staff,0,0,0,0
1746542237135,AWP 10,017,886165,Staff,0,0,0,0
1746542237135,AWP 10,018,886166,Staff,0,0,0,0
1746542237135,AWP 10,019,886168,Staff,0,0,0,0
1746542237135,AWP 10,020,886170,Staff,0,0,0,0
1746542237135,AWP 10,021,886172,Staff,0,0,0,0
1746542238166,AWP 10R,001,886173,Staff,0,1,0,0
1746542238166,AWP 10R,002,886174,Staff,0,1,0,0
1746542238166,AWP 10R,003,886175,Staff,0,0,0,0
1746542238166,AWP 10R,004,886176,Staff,0,0,0,0
1746542238166,AWP 10R,005,886177,Staff,0,0,0,0
1746542238166,AWP 10R,006,886178,Staff,0,0,0,0
1746542238166,AWP 10R,007,886179,Staff,0,0,0,0
1746542238166,AWP 10R,008,886181,Staff,0,0,0,0
1746542238166,AWP 10R,009,886182,Staff,0,0,0,0
1746542238166,AWP 10R,010,886183,Staff,0,0,0,0
1746542238166,AWP 10R,011,886184,Staff,0,0,0,0
1746542238166,AWP 10R,012,886185,Staff,0,0,0,0
1746542238166,AWP 10R,013,886186,Staff,0,0,0,0
1746542238166,AWP 10R,014,886187,Staff,0,0,0,0
1746542238166,AWP 10R,015,886188,Staff,0,0,0,0
1746542238166,AWP 10R,016,886189,Staff,0,0,0,0
1746542239194,AWP 102R,A00,886190,Staff,0,0,0,0
1746542239194,AWP 102R,B00,886191,Staff,0,0,0,0
1746542240219,BENG 100,A01,886193,Staff,17,0,30,13
1746542241247,BENG 122A,A01,886195,Hasty; Jeff M,13,0,30,17
1746542242272,BENG 166A,A00,886196,Sah; Robert Lie-Yuan,0,1,30,30
1746542243298,BENG 190,A00,958050,Khojah; Reem I,24,0,25,1
1746542244323,BIBC 102,A01,894320,Staff,0,0,46,46
1746542244323,BIBC 102,A02,894321,Staff,0,0,46,46
1746542244323,BIBC 102,A03,894344,Staff,7,0,46,39
1746542244323,BIBC 102,A04,894345,Staff,26,0,47,21
1746542245350,BICD 100R,A01,894365,Smith; Laurie,0,3,58,58
1746542245350,BICD 100R,A02,894366,Smith; Laurie,0,5,58,58
1746542245350,BICD 100R,A03,894367,Smith; Laurie,2,0,59,57
1746542245350,BICD 100R,A04,959869,Smith; Laurie,41,0,59,18
1746542246382,BICD 136,A01,894383,Gustafson-Brown; Cindy,14,0,50,36
1746542247412,BIEB 102,A01,894494,Butler; Shannon Rhey,51,0,130,79
1746542249465,BIEB 150,A01,894617,Wills; Christopher,3,0,20,17
1746542249465,BIEB 150,A02,894631,Wills; Christopher,3,0,20,17
1746542249465,BIEB 150,A03,894937,Wills; Christopher,3,0,20,17
1746542249465,BIEB 150,A04,894946,Wills; Christopher,5,0,20,15
1746542250490,BIEB 194,A00,906141,Kurle; Carolyn M.,6,0,20,14
1746542251522,BILD 1,A01,894154,Staff,2,0,19,17
1746542251522,BILD 1,A02,894155,Staff,14,0,19,5
1746542251522,BILD 1,A03,894160,Staff,13,0,19,6
1746542251522,BILD 1,A04,894161,Staff,15,0,18,3
1746542252549,BILD 2,A01,894168,Staff,0,0,50,50
1746542252549,BILD 2,A02,894169,Staff,0,0,50,50
1746542252549,BILD 2,A03,894179,Staff,4,0,50,46
1746542252549,BILD 2,A04,894203,Staff,27,0,50,23
1746542253574,BILD 3,A01,894213,Staff,22,0,31,9
1746542253574,BILD 3,A02,894214,Staff,26,0,31,5
1746542253574,BILD 3,A03,894235,Staff,28,0,31,3
1746542253574,BILD 3,A04,894236,Staff,28,0,32,4
1746542254600,BILD 4,A01,894253,Reuther; Keefe,5,0,24,19
1746542254600,BILD 4,A02,894258,Reuther; Keefe,16,0,24,8
1746542255625,BILD 5,A01,894276,Reuther; Keefe,35,0,50,15
1746542255625,BILD 5,A02,894277,Reuther; Keefe,45,0,50,5
1746542255625,BILD 5,A03,894290,Reuther; Keefe,44,0,50,6
1746542255625,BILD 5,A04,894291,Reuther; Keefe,48,0,50,2
1746542256654,BILD 24,A01,894297,Pirino; Giorgia,40,0,60,20
1746542257685,BIMM 100,B01,958915,Staff,72,0,100,28
1746542258711,BIMM 101,A01,895017,McDonnell; Lisa Marie,0,5,24,24
1746542258711,BIMM 101,A02,895018,McDonnell; Lisa Marie,0,5,24,24
1746542258711,BIMM 101,B01,895020,McDonnell; Lisa Marie,0,6,24,24
1746542258711,BIMM 101,B02,895021,McDonnell; Lisa Marie,0,4,24,24
1746542259736,BIMM 110,A01,895023,Staff,1,0,25,24
1746542259736,BIMM 110,A02,895024,Staff,9,0,25,16
1746542259736,BIMM 110,A03,895025,Staff,18,0,25,7
1746542259736,BIMM 110,A04,895031,Staff,20,0,25,5
1746542260762,BIMM 120,A01,895114,Gustafson-Brown; Cindy,13,0,28,15
1746542260762,BIMM 120,A02,895126,Gustafson-Brown; Cindy,21,0,27,6
1746542261789,BIPN 100,A01,895130,Yang; Mingyu,1,0,38,37
1746542261789,BIPN 100,A02,895131,Yang; Mingyu,32,0,38,6
1746542261789,BIPN 100,A03,895132,Yang; Mingyu,32,0,38,6
1746542261789,BIPN 100,A04,895133,Yang; Mingyu,27,0,36,9
1746542262815,BIPN 120,A01,895135,Cooke; James Edward,0,3,13,13
1746542262815,BIPN 120,A02,895136,Cooke; James Edward,0,1,13,13
1746542262815,BIPN 120,A03,895137,Cooke; James Edward,0,3,13,13
1746542262815,BIPN 120,A04,895156,Cooke; James Edward,0,2,11,11
1746542263839,BIPN 134,A01,895235,Cooke; James Edward,0,2,25,25
1746542263839,BIPN 134,A02,895237,Cooke; James Edward,0,0,25,25
1746542263839,BIPN 134,A03,895240,Cooke; James Edward,3,0,25,22
1746542263839,BIPN 134,A04,895270,Cooke; James Edward,20,0,25,5
1746542264870,BIPN 189,A00,892103,Staff,0,13,14,14
1746542266926,BISP 194,A00,958008,Staff,0,2,0,0
1746542267952,CAT 124,A01,922009,Staff,0,5,20,20
1746542268982,CAT 125R,A00,886390,Morales; Celeste Georgianna,0,2,20,20
1746542268982,CAT 125R,B00,886391,Irwin; Matthew Joseph,0,3,20,20
1746542268982,CAT 125R,C00,886392,Smith; Lauryn Alissa,0,2,20,20
1746542268982,CAT 125R,D00,886393,Vanderschuit; Maya Alysia,0,2,20,20
1746542268982,CAT 125R,E00,886394,Marchisotto; Jennifer Anne,0,4,20,20
1746542270009,CENG 15,A01,886218,Drews; Aaron,3,0,8,5
1746542271034,CENG 113,A00,886219,Opatkiewicz; Justin Paul,15,0,25,10
1746542272061,CGS 101,A00,887044,Staff,7,0,20,13
1746542273087,CGS 105,A01,887046,Staff,14,0,25,11
1746542274116,CGS 112,A00,887047,Cuong; Marisol,12,0,15,3
1746542275141,CGS 113,A00,887048,Staff,23,0,30,7
1746542276166,CGS 120,A00,887049,Staff,10,0,17,7
1746542277199,CHEM 6A,A01,886336,Lam; Tin Yiu,38,0,50,12
1746542277199,CHEM 6A,A02,886338,Lam; Tin Yiu,37,0,50,13
1746542278226,CHEM 6B,A01,886341,Hopkins; Patrycja Anna,16,0,50,34
1746542278226,CHEM 6B,A02,886343,Hopkins; Patrycja Anna,42,0,50,8
1746542279258,CHEM 6C,A01,886346,Albizati; Kim F.,0,2,50,50
1746542279258,CHEM 6C,A02,886348,Albizati; Kim F.,23,0,50,27
1746542280285,CHEM 40A,A01,886352,Klosterman; Jeremy K,65,0,100,35
1746542281311,CHEM 40B,A01,886356,Klosterman; Jeremy K,0,23,100,100
1746542282338,CHEM 41B,A01,886360,Theodorakis; Emmanuel,25,0,50,25
1746542282338,CHEM 41B,A02,886362,Theodorakis; Emmanuel,47,0,50,3
1746542283366,CHIN 165A,A00,886382,Xu; Li,18,0,20,2
1746542284391,CLAS 120,A00,886387,Myerston Santana; Jacobo,33,0,40,7
1746542285423,COGS 9,A01,886967,Shannon; Kyle Michael,42,0,60,18
1746542286447,COGS 11,A01,886969,Staff,11,0,30,19
1746542287473,COGS 14A,A01,886971,Staff,6,0,60,54
1746542288505,COGS 14B,A01,886973,Hoffman; Drew Ellen,4,0,60,56
1746542289533,COGS 18,A01,886975,Morgan; Eric,35,0,60,25
1746542290560,COGS 20,A01,886977,Staff,4,0,8,4
1746542290560,COGS 20,A02,886978,Staff,5,0,7,2
1746542291585,COGS 100,A01,907783,Staff,0,2,30,30
1746542292612,COGS 101B,A01,886980,Staff,0,3,48,48
1746542293638,COGS 101C,A01,886982,Delgado; Tania,0,5,44,44
1746542294663,COGS 102A,A01,886984,Johnson; Christine M.,4,0,30,26
1746542295709,COGS 118B,A01,886986,Staff,0,3,88,88
1746542296736,COGS 150,A01,886988,Bergen; Benjamin,23,0,50,27
1746542297766,COGS 153,A00,886989,Delgado; Tania,0,2,41,41
1746542298791,COGS 186,A01,886991,Staff,0,0,32,32
1746542299819,COGS 187A,A01,886993,Boyle; Mary E. T.,7,0,30,23
1746542300844,COGS 189,A00,886994,Staff,0,1,30,30
1746542301870,COMM 10,A01,886996,Staff,0,0,20,21
1746542301870,COMM 10,A02,886997,Staff,12,0,20,8
1746542301870,COMM 10,A03,959845,Staff,19,0,20,1
1746542302897,COMM 20,A01,886999,Leuning; Grant Maurstad,24,0,40,16
1746542304950,COMM 100A,A01,887002,Staff,0,0,20,25
1746542304950,COMM 100A,A02,887003,Staff,7,0,20,13
1746542305974,COMM 100B,A01,887005,Staff,0,8,20,24
1746542307002,COMM 106D,A00,887006,Staff,14,0,40,26
1746542308029,COMM 110G,A00,887007,Whitworth-Smith; Andrew C,12,0,40,28
1746542309053,COMM 111B,A00,887008,Staff,31,0,40,9
1746542310093,COMM 113T,A00,887009,Abuelhiga; Soraya Jill,28,0,40,12
1746542310093,COMM 113T,B00,906733,Staff,40,0,40,0
1746542311120,COMM 145,A00,887010,Staff,12,0,40,28
1746542312149,COMM 146,A00,887054,Staff,31,0,40,9
1746542313176,COMM 190,A00,887012,Staff,8,0,23,15
1746542314200,CSE 8A,A50,887015,Cao; Yingjun,57,0,85,28
1746542315225,CSE 11,A01,887017,Cao; Yingjun,12,0,70,58
1746542316251,CSE 20,A01,887019,Staff,30,0,50,20
1746542317282,CSE 21,A01,887021,Staff,78,0,100,22
1746542317282,CSE 21,B01,892583,Braun; Oliver,45,0,50,5
1746542318311,CSE 30,A01,887025,Eldon; John,143,0,200,57
1746542319337,CSE 100,A01,887027,Staff,26,0,50,24
1746542319337,CSE 100,A02,887028,Staff,40,0,50,10
1746542320363,CSE 101,A01,887030,Braun; Oliver,75,0,100,25
1746542320363,CSE 101,B01,887032,Jones; Miles E,0,3,50,50
1746542320363,CSE 101,B02,887033,Jones; Miles E,0,1,50,50
1746542321391,CSE 105,A01,908084,Jones; Miles E,32,0,50,18
1746542321391,CSE 105,A02,908087,Jones; Miles E,33,0,50,17
1746542322427,CSE 135,A01,887035,Powell; Thomas Allan,0,4,50,50
1746542323450,CSE 142,A01,887037,Staff,8,0,60,52
1746542324475,CSE 142L,A01,887039,Staff,34,0,60,26
1746542325502,CSE 151A,A01,887041,Solares; Edwin A,48,0,100,52
1746542326530,CSE 175,A01,887043,Kumar; Rakesh,30,0,30,0
1746542327558,CSS 1,A01,886389,Staff,0,1,40,40
1746542328589,DSC 30,A01,908097,Liao; Soohyun Nam,47,0,75,28
1746542329613,DSC 40A,A01,908099,Shannon; Kyle Michael,30,0,50,20
1746542330637,DSC 40B,A01,908112,Staff,16,0,50,34
1746542331662,DSC 80,A01,908116,Staff,19,0,60,41
1746542332688,DSC 197,001,956863,Eldridge; Justin Matthew,9999,0,9999,0
1746542333716,ECE 5,A01,886400,Morris; Karcher William,2,0,6,4
1746542333716,ECE 5,A02,886401,Morris; Karcher William,3,0,6,3
1746542334743,ECE 148,A01,886403,Silberman; Jack,0,14,14,14
1746542335772,ECON 1,A01,887265,Crane; Meredith Helen,12,0,70,58
1746542335772,ECON 1,B01,887268,Staff,43,0,50,7
1746542336798,ECON 2,A01,887273,Crane; Meredith Helen,56,0,70,14
1746542337826,ECON 3,A01,887279,Rondina; Giacomo,32,0,70,38
1746542338855,ECON 4,A01,887282,Anderson; John Charles,0,2,10,10
1746542339881,ECON 5,A01,887285,Staff,33,0,45,12
1746542339881,ECON 5,B01,887292,Staff,41,0,45,4
1746542340908,ECON 100A,A01,887337,Newhouse; Herbert S,54,0,70,16
1746542340908,ECON 100A,B01,887349,Staff,45,0,50,5
1746542341932,ECON 100B,A01,887361,Du; Songzi,29,0,70,41
1746542342959,ECON 100C,A01,887445,Newhouse; Herbert S,59,0,70,11
1746542343986,ECON 105,A00,887488,Vespa; Emanuel Ignacio,23,0,35,12
1746542345012,ECON 109,A01,887506,Shishkin; Denis,28,0,35,7
1746542346047,ECON 110A,A01,887568,Alon; Titan Michael,0,3,35,35
1746542346047,ECON 110A,B01,907601,Alon; Titan Michael,20,0,35,15
1746542347076,ECON 110B,A01,887598,Levkoff; Steven B.,0,23,70,70
1746542348103,ECON 112,A00,887599,Rondina; Giacomo,19,0,35,16
1746542349128,ECON 120A,A01,887603,Dai; Yinlin,36,0,70,34
1746542350157,ECON 120C,A01,887608,Sun; Yixiao,0,1,35,35
1746542350157,ECON 120C,B01,887614,Sun; Yixiao,0,0,35,35
1746542351183,ECON 138,A00,887621,Bharadwaj; Prashant,0,20,20,20
1746542352215,ECON 144,A00,958007,Squires; Dale E,13,0,35,22
1746542353240,ECON 171,A01,907666,Staff,18,0,35,17
1746542354265,ECON 175,A00,887626,Wu; Pak Yeung,23,0,35,12
1746542355290,ECON 190,A00,887640,Vespa; Emanuel Ignacio,23,0,35,12
1746542356335,EDS 25,A01,888197,Staff,0,0,0,0
1746542356335,EDS 25,A02,888209,Staff,0,0,0,0
1746542356335,EDS 25,A03,888210,Staff,0,0,0,0
1746542356335,EDS 25,A04,888212,Staff,0,0,0,0
1746542356335,EDS 25,A05,888213,Staff,0,0,0,0
1746542356335,EDS 25,A06,888214,Staff,0,0,0,0
1746542356335,EDS 25,A07,888235,Staff,0,2,0,0
1746542356335,EDS 25,A08,888236,Staff,0,0,0,0
1746542356335,EDS 25,A09,888240,Staff,0,0,0,0
1746542356335,EDS 25,A10,888244,Staff,0,0,0,0
1746542356335,EDS 25,B01,888273,Staff,0,0,0,0
1746542356335,EDS 25,B02,888285,Staff,0,0,0,0
1746542356335,EDS 25,B03,888423,Staff,0,0,0,1
1746542356335,EDS 25,B04,888432,Staff,0,0,0,0
1746542356335,EDS 25,B05,888433,Staff,0,0,0,0
1746542356335,EDS 25,B06,888467,Staff,0,0,0,0
1746542356335,EDS 25,B07,888468,Staff,0,0,0,0
1746542356335,EDS 25,B08,888479,Staff,0,0,0,0
1746542356335,EDS 25,B09,888484,Staff,0,0,0,0
1746542356335,EDS 25,B10,888487,Staff,0,0,0,0
1746542357360,EDS 38,A01,907700,Choi; Bailey Miyeon,30,0,30,0
1746542358388,EDS 112,A01,888601,Chapman; Thandeka K,14,0,40,26
1746542359414,EDS 115,A00,888697,Mendez; Kathrina Mendoza,10,0,30,20
1746542360441,EDS 116,A01,888893,Staff,35,0,40,5
1746542362499,EDS 124AR,A00,889133,Staff,29,0,50,21
1746542362499,EDS 124AR,B00,907471,Simon; Elizabeth A,37,0,50,13
1746542363527,EDS 124BR,A00,889134,Simon; Elizabeth A,45,0,100,55
1746542364553,EDS 125,A00,889135,Staff,25,0,30,5
1746542365580,EDS 126,A01,889138,Staff,36,0,40,4
1746542366608,EDS 164R,A01,889142,Wishard Guerra; Alison G.,33,0,50,17
1746542367636,ENG 30,A01,886396,Staff,0,0,0,0
1746542367636,ENG 30,B01,886398,Staff,0,0,0,0
1746542368665,ENVR 102,A00,906150,Montejo; Carolina,23,0,25,2
1746542369695,ETHN 103A,A00,887236,Man; Simeon S,0,3,0,0
1746542370723,ETHN 113,A00,887239,Staff,16,0,30,14
1746542371747,ETHN 116,A00,887240,Staff,16,0,25,9
1746542372773,ETHN 117,A00,887241,Choi; Esther Min,28,0,30,2
1746542373799,ETHN 118,A00,887243,Staff,24,0,30,6
1746542374823,ETHN 127,A00,887248,Cuong; Marisol,11,0,15,4
1746542375852,ETHN 139,A00,887250,Staff,7,0,10,3
1746542376877,ETHN 142,A00,887252,Staff,10,0,30,20
1746542377904,ETHN 161,A00,887253,Browne; Errol Tsekani,24,0,30,6
1746542378931,ETHN 163FR,A00,887255,Burelle; Julie Sara Veronique,0,0,5,5
1746542379958,GLBH 20,A00,889149,Elwardani; Nile Regina,8,0,42,34
1746542382017,GLBH 111,A01,889152,Burgos; Jose L.,17,0,17,0
1746542383043,GLBH 150,A00,889181,Sloane; Julia Kathryn,0,5,15,15
1746542385103,HDS 60,A01,886406,Warstadt; Melissa Fawn,73,0,80,7
1746542386127,HIAF 111,A00,889324,Gyamfi; Bright,25,0,32,7
1746542387153,HIEA 131,A00,889328,Staff,16,0,32,16
1746542388179,HIEA 144,A00,889333,Henry; Todd A.,26,0,32,6
1746542389207,HIEA 154,A00,889336,Henry; Todd A.,24,0,32,8
1746542390232,HIEU 106,A00,889339,Staff,22,0,32,10
1746542392286,HIEU 114,A00,889340,Staff,3,0,32,29
1746542393314,HIEU 135GS,A00,889342,Patterson; Patrick H.,0,0,1,24
1746542394340,HIEU 137,A00,889343,Edington; Claire Ellen,9,0,25,16
1746542395366,HIEU 148,A00,889345,Staff,14,0,32,18
1746542396392,HIEU 154,A00,889346,Biess; Frank Peter,21,0,32,11
1746542397418,HILA 102,A00,889351,Staff,12,0,32,20
1746542398446,HILD 2A,A01,889221,Lewandoski; Julia Mavis,1,10,32,31
1746542399473,HILD 7B,A01,889225,Man; Simeon S,0,13,32,32
1746542400500,HILD 7C,A01,889288,Alvarez; Luis A,0,14,32,32
1746542401527,HILD 30,A01,889323,Staff,0,5,32,32
1746542403601,HISC 119,A00,889383,Golan; Tal,21,0,32,11
1746542404625,HIUS 103,A00,889384,Man; Simeon S,0,0,32,32
1746542405653,HIUS 117,A00,919797,Kwak; Nancy,18,0,32,14
1746542406678,HIUS 142A,A00,919788,Staff,22,0,32,10
1746542408729,HIUS 149,A00,889386,Gyamfi; Bright,27,0,32,5
1746542409759,HIUS 155,A00,889387,Alvarez; Luis A,14,0,32,18
1746542410786,HUM 3,A01,886499,Caldwell; Michael Alan,19,0,50,31
1746542411814,HUM 3GS,A00,886500,Rodriguez; Bretton Sigfred,0,0,0,28
1746542412844,HUM 3R,A01,886502,Markman; Kristina,0,36,50,50
1746542413873,HUM 4,A01,886504,Crum; Matthew Stephen,24,0,50,26
1746542413873,HUM 4,B01,886506,West; Geoffrey Scott,17,0,50,33
1746542414901,HUM 4GS,A00,886507,Staff,0,0,0,19
1746542415930,HUM 5,A01,886509,Staff,32,0,50,18
1746542416960,HUM 5R,A01,886511,Zavodny; Tatiana Sophia,0,39,50,50
1746542417983,JAPN 180,A00,886407,Staff,18,0,40,22
1746542419015,LATI 50,A01,886409,Martin-Cabrera; Luis,4,0,22,18
1746542419015,LATI 50,A02,886410,Martin-Cabrera; Luis,19,0,22,3
1746542419015,LATI 50,A03,886411,Martin-Cabrera; Luis,21,0,22,1
1746542419015,LATI 50,A04,886412,Martin-Cabrera; Luis,9,0,22,13
1746542420040,LAWS 101,A00,907664,Staff,28,0,60,32
1746542421068,LIAB 1A,A00,889388,Saab; Dima,17,0,20,3
1746542422099,LIAB 1AX,A00,889389,El Cheddadi; Youniss,17,0,20,3
1746542423125,LIFR 1C,A00,889391,Van Moer; Vinciane G,8,0,20,12
1746542424154,LIFR 1CX,A00,889392,Van Moer; Vinciane G,7,0,20,13
1746542425182,LIFR 1D,A00,889393,Van Moer; Vinciane G,7,0,20,13
1746542426212,LIFR 1DX,A00,889394,Van Moer; Vinciane G,8,0,20,12
1746542427238,LIGN 7,A00,886923,Staff,24,0,50,26
1746542428263,LIGN 17,A00,886924,Kehler; Andrew Scott,125,0,150,25
1746542429289,LTAM 110,A00,889395,Staff,15,0,30,15
1746542430315,LTAM 110GS,A00,958010,Rodriguez; Bretton Sigfred,0,0,0,28
1746542431341,LTCH 101,A00,889397,Staff,23,0,25,2
1746542432367,LTCS 130,A00,889398,Staff,23,0,25,2
1746542433392,LTEA 138,A00,889399,Staff,24,0,40,16
1746542434419,LTEN 149,A00,889400,Wesling; Megan E.,0,3,25,25
1746542435445,LTEN 169,A00,889401,Staff,20,0,25,5
1746542436473,LTEN 180,A00,889402,Staff,10,0,15,5
1746542437498,LTEN 181,A00,889403,Staff,21,0,25,4
1746542438523,LTWL 100,A00,889404,Myerston Santana; Jacobo,3,0,25,22
1746542439565,LTWL 180GS,A00,889405,Staff,0,0,20,20
1746542440590,LTWL 181,A00,889406,Staff,17,0,25,8
1746542441617,LTWL 184,A00,889475,Mukherjee; Silpa,22,0,25,3
1746542442642,LTWR 102C,A00,889486,Staff,29,0,30,1
1746542443670,LTWR 115W,A00,889491,Staff,0,2,15,15
1746542444699,MAE 8,A01,886905,Staff,0,2,0,0
1746542445727,MAE 11,A00,886906,Bandaru; Prabhakar,0,7,50,50
1746542446753,MAE 20,A00,886907,Evdokimenko; Ekaterina,44,0,70,26
1746542447778,MAE 30B,A00,886909,Ghazinejad; Maziar,26,0,45,19
1746542448803,MAE 101B,A00,886910,Saintillan; David,29,0,45,16
1746542449850,MAE 105,A00,886911,Bandaru; Prabhakar,18,0,50,32
1746542450879,MAE 107,B00,958024,Staff,9,0,50,41
1746542451908,MAE 143B,A00,886913,Bewley; Thomas R,7,0,40,33
1746542452937,MAE 148,A01,886915,Silberman; Jack,0,3,14,14
1746542453961,MAE 160,A00,886916,Evdokimenko; Ekaterina,31,0,60,29
1746542455017,MATH 3C,A01,889681,Staff,0,3,30,30
1746542455017,MATH 3C,A02,960048,Staff,25,0,30,5
1746542456041,MATH 10A,A01,889760,Staff,26,0,30,4
1746542456041,MATH 10A,A02,889783,Staff,29,0,30,1
1746542457070,MATH 10B,A01,889785,Verstraete; Jacques Allan,2,0,35,33
1746542457070,MATH 10B,A02,889795,Verstraete; Jacques Allan,4,0,35,31
1746542457070,MATH 10B,B01,889797,Verstraete; Jacques Allan,3,0,35,32
1746542457070,MATH 10B,B02,889828,Verstraete; Jacques Allan,3,0,35,32
1746542458098,MATH 10C,A01,889849,Habib; Yousaf,9,0,30,21
1746542458098,MATH 10C,A02,889852,Habib; Yousaf,14,0,30,16
1746542458098,MATH 10C,A03,889853,Habib; Yousaf,22,0,30,8
1746542458098,MATH 10C,A04,889858,Habib; Yousaf,20,0,30,10
1746542458098,MATH 10C,B01,889861,Staff,1,0,30,29
1746542458098,MATH 10C,B02,889862,Staff,24,0,30,6
1746542458098,MATH 10C,B03,889863,Staff,27,0,30,3
1746542458098,MATH 10C,B04,889967,Staff,23,0,30,7
1746542459129,MATH 18,A01,889974,Staff,7,0,30,23
1746542459129,MATH 18,A02,889977,Staff,20,0,30,10
1746542459129,MATH 18,B01,889984,Hardiman; Liam,22,0,30,8
1746542459129,MATH 18,B02,889985,Hardiman; Liam,25,0,30,5
1746542460154,MATH 20A,A01,889990,Suk; Andrew Hoon,29,0,35,6
1746542461182,MATH 20B,A01,889993,Ohm; Ko Woon,22,0,30,8
1746542461182,MATH 20B,A02,889994,Ohm; Ko Woon,30,0,30,0
1746542461182,MATH 20B,B01,889996,Ohm; Ko Woon,21,0,30,9
1746542461182,MATH 20B,B02,889997,Ohm; Ko Woon,23,0,30,7
1746542462225,MATH 20C,A01,889999,Hammock; Frances H,17,0,30,13
1746542462225,MATH 20C,A02,890003,Hammock; Frances H,23,0,30,7
1746542462225,MATH 20C,B01,890006,Hammock; Frances H,3,0,30,27
1746542462225,MATH 20C,B02,890007,Hammock; Frances H,11,0,30,19
1746542463250,MATH 20D,A01,890011,Cheng; Hsiao-Bing,1,1,30,29
1746542463250,MATH 20D,A02,890012,Cheng; Hsiao-Bing,14,0,30,16
1746542463250,MATH 20D,B01,890016,Cheng; Hsiao-Bing,13,0,30,17
1746542463250,MATH 20D,B02,890017,Cheng; Hsiao-Bing,13,0,30,17
1746542464276,MATH 20E,A01,890026,Harel; Guershon,1,0,30,29
1746542464276,MATH 20E,A02,890029,Harel; Guershon,23,0,30,7
1746542464276,MATH 20E,B01,890033,Harel; Guershon,7,0,30,23
1746542464276,MATH 20E,B02,890101,Harel; Guershon,21,0,30,9
1746542465304,MATH 102,A01,890104,Staff,17,0,30,13
1746542465304,MATH 102,A02,890105,Staff,27,0,30,3
1746542466330,MATH 103B,A01,890116,Salehi Golsefidy; Alireza,3,0,30,27
1746542466330,MATH 103B,B01,890118,Staff,0,3,34,34
1746542467355,MATH 109,A01,890121,Aliabadi Sr.; Mohsen,1,0,30,29
1746542467355,MATH 109,B01,890124,Upadrashta; Pranav Kumar,18,0,30,12
1746542468381,MATH 120A,A01,890126,Eggers; John Dietrich,13,0,30,17
1746542469404,MATH 142B,A01,890128,Ioana; Adrian,19,0,30,11
1746542469404,MATH 142B,A02,890129,Ioana; Adrian,13,0,30,17
1746542470432,MATH 154,A01,890174,Staff,0,0,30,30
1746542470432,MATH 154,A02,890182,Staff,0,0,30,30
1746542471461,MATH 168A,A01,890197,Dumitriu; Ioana,21,0,35,14
1746542472489,MATH 170A,A01,890240,Nie; Jiawang,1,0,30,29
1746542472489,MATH 170A,A02,890241,Nie; Jiawang,11,0,30,19
1746542472489,MATH 170A,A03,890249,Nie; Jiawang,23,0,30,7
1746542473514,MATH 170B,A01,957891,Nag; Panchali,13,0,35,22
1746542475568,MATH 181A,A01,908025,Staff,0,4,35,35
1746542475568,MATH 181A,A02,960115,Staff,27,0,35,8
1746542476593,MATH 181B,A01,959874,Staff,26,0,30,4
1746542477621,MATH 193B,A01,890265,Staff,0,4,35,35
1746542478649,MGT 4,A01,890311,Anderson; John Charles,42,0,88,46
1746542479675,MGT 5,A00,907740,Staff,13,0,98,85
1746542480701,MGT 12,A00,890312,Lindenberger; Wade Douglas,67,0,98,31
1746542481728,MGT 16,A00,957883,Staff,78,0,98,20
1746542483779,MGT 45,A00,890314,Pecore; Joseph P.,47,0,98,51
1746542484807,MGT 71,A00,890315,Staff,0,11,98,98
1746542485834,MGT 100,A00,890316,Yavorsky; Daniel Ryan,44,0,98,54
1746542486865,MGT 103,A00,890317,Ehrich; Kristine R,73,0,98,25
1746542487893,MGT 105,A00,890356,Bates; Kenneth Walter,0,7,98,98
1746542488923,MGT 112,A00,890360,Ehrich; Kristine R,55,0,98,43
1746542489952,MGT 127R,A00,907732,Zhu; Kevin Xiaoguo,23,0,98,75
1746542490979,MGT 131B,A00,890361,Anderson; John Charles,61,0,98,37
1746542492007,MGT 137,A00,890362,Lindenberger; Wade Douglas,65,0,98,33
1746542493034,MGT 160,A00,890369,Johnson; Erik Barry,9,0,98,89
1746542495091,MGT 164,A00,890372,Zimmermann; Carsten,0,39,98,98
1746542496116,MGT 180,A00,890374,Bliss; Barbara Ann,12,0,98,86
1746542497150,MMW 15,A01,886414,Chang; Edmond Yi-Teh,0,12,28,28
1746542497150,MMW 15,A02,886415,Chang; Edmond Yi-Teh,0,8,28,28
1746542497150,MMW 15,A03,886416,Chang; Edmond Yi-Teh,0,8,28,28
1746542497150,MMW 15,A04,886417,Chang; Edmond Yi-Teh,0,8,28,28
1746542497150,MMW 15,B01,886419,Chang; Edmond Yi-Teh,0,7,28,28
1746542497150,MMW 15,B02,886420,Chang; Edmond Yi-Teh,0,8,28,28
1746542497150,MMW 15,B03,886421,Chang; Edmond Yi-Teh,0,7,28,28
1746542497150,MMW 15,B04,886422,Chang; Edmond Yi-Teh,0,8,28,28
1746542497150,MMW 15,C01,886424,Staff,0,9,28,28
1746542497150,MMW 15,C02,886425,Staff,0,8,28,28
1746542497150,MMW 15,C03,886426,Staff,0,8,28,28
1746542497150,MMW 15,C04,886427,Staff,0,7,28,28
1746542497150,MMW 15,C05,958038,Staff,0,7,28,28
1746542497150,MMW 15,C06,958039,Staff,0,8,28,28
1746542498178,MMW 15GS,A00,906910,Patterson; Patrick H.,4,0,28,24
1746542499206,MMW 122R,A01,886429,Rahimi; Babak,0,13,28,28
1746542499206,MMW 122R,A02,886430,Rahimi; Babak,0,12,28,28
1746542499206,MMW 122R,A03,958040,Rahimi; Babak,0,11,28,28
1746542500231,MUS 1A,A01,890937,Staff,3,0,25,22
1746542500231,MUS 1A,A02,891035,Staff,6,0,25,19
1746542500231,MUS 1A,C01,958912,Staff,24,0,25,1
1746542500231,MUS 1A,C02,958913,Staff,25,0,25,0
1746542502290,MUS 2AK,A00,957092,Ohnishi; Takae,15,0,15,0
1746542503317,MUS 4,A01,891044,Staff,2,0,25,23
1746542503317,MUS 4,A02,891045,Staff,23,0,25,2
1746542503317,MUS 4,B01,891048,Staff,17,0,25,8
1746542503317,MUS 4,B02,891050,Staff,25,0,25,0
1746542504350,MUS 5,A01,957506,Dubnov; Shlomo,0,0,25,25
1746542504350,MUS 5,A02,957622,Dubnov; Shlomo,14,0,25,11
1746542504350,MUS 5,A03,957623,Dubnov; Shlomo,20,0,25,5
1746542505374,MUS 6,A01,891053,Freitas Caetano; Marcelo,24,0,25,1
1746542505374,MUS 6,A02,891054,Freitas Caetano; Marcelo,23,0,25,2
1746542506402,MUS 7,A01,891081,Staff,0,0,25,25
1746542506402,MUS 7,A02,891082,Staff,4,0,25,21
1746542507430,MUS 8GS,A00,891118,Borgo; David Garcia,0,0,25,25
1746542508457,MUS 11,A01,891140,Staff,11,0,25,14
1746542508457,MUS 11,A02,891141,Staff,22,0,25,3
1746542509481,MUS 13,A01,891143,Staff,8,0,25,17
1746542509481,MUS 13,A02,891144,Staff,24,0,25,1
1746542510508,MUS 15,A01,891146,Staff,9,0,25,16
1746542510508,MUS 15,A02,891148,Staff,21,0,25,4
1746542510508,MUS 15,B01,891150,Staff,18,0,25,7
1746542510508,MUS 15,B02,891151,Staff,25,0,25,0
1746542511533,MUS 20,A01,891153,Staff,5,0,20,15
1746542511533,MUS 20,A02,891155,Staff,14,0,20,6
1746542512562,MUS 80,A00,891156,Staff,19,0,25,6
1746542512562,MUS 80,B00,891157,Staff,23,0,25,2
1746542513588,MUS 130,A00,891158,Ohnishi; Takae,35,0,35,0
1746542514613,MUS 150GS,A01,891160,Borgo; David Garcia,0,0,25,25
1746542515638,MUS 170,A01,891162,Freitas Caetano; Marcelo,20,0,25,5
1746542515638,MUS 170,A02,891164,Freitas Caetano; Marcelo,21,0,25,4
1746542516666,NANO 11,A00,886220,Vazquez Mena; Oscar,13,0,15,2
1746542517693,NANO 15,A01,886222,Drews; Aaron,4,0,7,3
1746542518719,NANO 104,A00,886224,Sirbuly; Donald,18,0,25,7
1746542519745,PH 40,A00,886528,Staff,23,0,40,17
1746542520776,PH 45,A01,886799,Staff,35,0,40,5
1746542521802,PH 110,A00,886802,Staff,0,7,40,40
1746542522829,PH 172,A00,906716,Staff,19,0,35,16
1746542523856,PH 191,A00,886803,Staff,6,0,40,34
1746542524882,PHIL 1,A00,889500,Staff,19,0,30,11
1746542525914,PHIL 10,A01,889549,Grush; Rick Scott,15,0,22,7
1746542525914,PHIL 10,A02,889551,Grush; Rick Scott,22,0,22,0
1746542526943,PHIL 28,A01,889559,Lamey; Andy M.,0,1,31,31
1746542526943,PHIL 28,A02,889561,Lamey; Andy M.,0,1,30,30
1746542526943,PHIL 28,A03,889572,Lamey; Andy M.,0,0,30,30
1746542527968,PHIL 35,A00,907839,Staff,13,0,15,2
1746542528994,PHIL 60,A00,889574,Staff,74,0,90,16
1746542530022,PHIL 101,A00,958004,Staff,13,0,15,2
1746542532072,PHIL 136,A00,889582,Fulkerson; Matthew Todd,26,0,45,19
1746542533099,PHIL 163,A01,889601,Staff,21,0,30,9
1746542533099,PHIL 163,B01,889606,Brandt; Reuven A,0,3,0,0
1746542534125,PHIL 164,A00,889610,Staff,16,0,30,14
1746542535153,PHIL 165,A00,889613,Staff,23,0,30,7
1746542536180,PHYS 1A,A00,886431,Staff,26,0,70,44
1746542537207,PHYS 1AL,001,886432,Tsai; Philbert S,0,2,30,30
1746542537207,PHYS 1AL,002,886436,Tsai; Philbert S,11,0,30,19
1746542538235,PHYS 1B,A00,886439,Staff,185,0,240,55
1746542539260,PHYS 1BL,001,886441,Tsai; Philbert S,0,4,30,30
1746542539260,PHYS 1BL,002,886444,Tsai; Philbert S,2,0,30,28
1746542540286,PHYS 1C,A00,896092,Arnold; Kam S,78,0,146,68
1746542541315,PHYS 1CL,001,886448,Tsai; Philbert S,0,0,30,30
1746542541315,PHYS 1CL,002,886449,Tsai; Philbert S,0,0,30,30
1746542541315,PHYS 1CL,003,886450,Tsai; Philbert S,16,0,30,14
1746542541315,PHYS 1CL,004,886451,Tsai; Philbert S,15,0,30,15
1746542542344,PHYS 2B,A01,886457,Staff,69,0,115,46
1746542543370,PHYS 2C,A01,886460,Shotwell; Brian,0,8,65,65
1746542544397,PHYS 2CL,A01,886467,Staff,0,4,28,28
1746542544397,PHYS 2CL,A02,886468,Staff,0,3,28,28
1746542545424,PHYS 2D,A01,886470,Staff,10,0,50,40
1746542546449,PHYS 4B,A01,886475,Grinstein; Benjamin,22,0,40,18
1746542547479,POLI 5,A00,891173,Desposato; Scott,7,0,25,18
1746542548506,POLI 5D,A01,891175,Staff,5,0,5,0
1746542548506,POLI 5D,B01,891178,Staff,5,0,5,0
1746542549535,POLI 11,A00,891179,Ferree; Karen E,2,0,35,33
1746542550562,POLI 12,A00,891180,Staff,16,0,30,14
1746542551591,POLI 27,A01,891182,Staff,12,0,75,63
1746542552618,POLI 30,A00,891183,Staff,9,0,50,41
1746542553645,POLI 100B,A00,891244,Staff,5,1,35,30
1746542554672,POLI 100I,A00,891247,Staff,7,0,30,23
1746542555702,POLI 104J,A00,891248,Nichter; Maysa,14,0,30,16
1746542556728,POLI 104U,A00,891250,Nichter; Maysa,2,0,30,28
1746542558780,POLI 110B,A00,891255,Wiens; David,20,0,25,5
1746542559810,POLI 112A,A00,891256,Wiens; David,6,0,25,19
1746542560853,POLI 114BR,A00,891261,Staff,19,0,30,11
1746542561880,POLI 117R,A00,891262,Forman; Fonna,0,6,50,50
1746542562905,POLI 118,A00,891264,Ingham; Sean,17,0,25,8
1746542563931,POLI 124A,A00,891265,Staff,18,0,20,2
1746542564957,POLI 125D,A00,891266,Nichter; Simeon C,2,0,25,23
1746542565985,POLI 126,A00,891268,Nichter; Simeon C,7,0,25,18
1746542567010,POLI 126AA,A00,891272,Staff,18,0,25,7
1746542568035,POLI 130AA,A00,891273,Staff,15,0,20,5
1746542569060,POLI 134AA,A00,891274,Staff,4,0,20,16
1746542571113,POLI 138,A00,891278,Staff,21,0,25,4
1746542572137,POLI 142K,A00,891280,Staff,11,0,25,14
1746542573166,POLI 142M,A00,891281,Gartzke; Erik,17,0,30,13
1746542574194,POLI 142P,A00,891284,Staff,20,0,30,10
1746542575220,POLI 143,A00,891285,Gartzke; Erik,12,0,30,18
1746542576247,POLI 153,A00,891286,Staff,19,0,20,1
1746542578298,POLI 175,A00,891290,Staff,15,0,20,5
1746542579328,PSYC 1,A00,890674,Steiner; Eric Tomas,0,11,45,45
1746542580359,PSYC 2,A00,890676,Albright; Thomas D,21,0,35,14
1746542581387,PSYC 3,A00,890679,Staff,17,0,20,3
1746542582414,PSYC 6,A00,959858,Staff,20,0,20,0
1746542583439,PSYC 60,A01,890684,Rickard; Timothy C.,0,5,45,45
1746542584464,PSYC 70,A01,890689,Geller; Emma Harlan,7,0,30,23
1746542585491,PSYC 71,A01,959860,Staff,21,0,25,4
1746542586515,PSYC 100,A00,890690,Lacefield; Katharine I,0,50,180,180
1746542587543,PSYC 102,A00,890695,Staff,18,0,40,22
1746542588570,PSYC 105,A00,890699,Geller; Emma Harlan,71,0,100,29
1746542589600,PSYC 106,A00,890701,Gorman; Michael R.,5,0,30,25
1746542590630,PSYC 108,A00,890704,Adrian; Julia Anna,0,28,50,50
1746542591656,PSYC 118,A01,890712,Staff,11,0,30,19
1746542592683,PSYC 124,A00,890716,Chapman; Eddie Nathaniel,25,0,60,35
1746542593713,PSYC 131,A00,890717,Anagnostaras; Stephan,0,7,80,80
1746542594742,PSYC 137,A00,890719,Winkielman; Piotr,0,11,30,30
1746542595768,PSYC 144,A00,890721,Adrian; Julia Anna,0,9,45,45
1746542596795,PSYC 162,A00,890805,Staff,2,0,75,73
1746542597822,PSYC 169,A00,890810,Staff,0,15,30,30
1746542598846,PSYC 172,A00,890814,Gorman; Michael R.,9,0,30,21
1746542599872,PSYC 181,A00,890818,Anagnostaras; Stephan,8,0,200,192
1746542600898,PSYC 184,A00,959861,Staff,170,0,175,5
1746542601924,PSYC 189,A00,890823,Staff,0,1,30,30
1746542602954,PSYC 191,A00,890884,Rickard; Timothy C.,0,11,35,35
1746542603982,PSYC 193,A00,890913,Staff,19,0,30,11
1746542603982,PSYC 193,B00,890914,Chapman; Eddie Nathaniel,24,0,30,6
1746542605018,PSYC 193L,A01,890918,Lowe; Angela Beth,20,0,30,10
1746542605018,PSYC 193L,B01,890921,Hurwitz; Ethan Scott,20,0,30,10
1746542605018,PSYC 193L,C01,890928,Staff,30,0,30,0
1746542606048,RELI 149,A00,886806,Rahimi; Babak,23,0,40,17
1746542607074,SE 9,A01,886814,Staff,7,0,20,13
1746542608099,SE 101B,A01,886816,Chadha; Mayank,4,0,35,31
1746542609124,SE 110B,A00,886818,Zhu; Qiang,4,0,75,71
1746542610149,SE 125,A01,886830,Staff,10,0,30,20
1746542611173,SE 130B,A01,886835,Staff,14,0,40,26
1746542612202,SE 131A,A01,886838,Krysl; Petr,34,0,55,21
1746542613230,SE 154,A00,886840,Staff,30,0,50,20
1746542614255,SE 164GS,A01,886849,Staff,6,0,20,14
1746542615281,SE 167GS,A01,886853,Staff,6,0,20,14
1746542616312,SIO 25,A01,890107,Staff,19,0,30,11
1746542617337,SIO 45,A00,890109,Cook; Geoffrey W,117,0,200,83
1746542618365,SIO 109R,A00,890110,Forman; Fonna,0,16,20,20
1746542619393,SIO 187,A01,890114,Kacev; David,15,0,40,25
1746542620417,SOCI 1,A01,890431,Thorpe; Charles Robert,15,0,30,15
1746542620417,SOCI 1,A02,890518,Thorpe; Charles Robert,30,0,30,0
1746542621445,SOCI 2,A01,957978,Staff,25,0,25,0
1746542621445,SOCI 2,A02,957979,Staff,23,0,25,2
1746542622472,SOCI 20,A01,890523,Calderon-Zaks; Michael Aar,23,0,30,7
1746542622472,SOCI 20,A02,890526,Calderon-Zaks; Michael Aar,29,0,30,1
1746542623498,SOCI 30,A01,890533,Pardo Guerra; Juan Pablo,37,0,40,3
1746542624526,SOCI 40,A01,890535,Staff,27,0,45,18
1746542625552,SOCI 104Q,A00,890559,Staff,18,0,30,12
1746542626577,SOCI 106,A00,890560,Arnal; Maud Marie Leonie,20,0,30,10
1746542627602,SOCI 110,A00,890567,Holkenbrink-Monk; Charlene,19,0,30,11
1746542628642,SOCI 112,A00,890568,Victoria Torres; Pablo,1,0,55,54
1746542629680,SOCI 115,A00,890597,Arnal; Maud Marie Leonie,28,0,45,17
1746542631730,SOCI 121,A00,890604,Pardo Guerra; Juan Pablo,38,0,45,7
1746542632754,SOCI 126,A01,890608,Staff,8,0,10,2
1746542633777,SOCI 127,A00,890609,Staff,18,0,30,12
1746542634801,SOCI 131,A00,890610,Thorpe; Charles Robert,37,0,45,8
1746542635823,SOCI 135,A00,890615,Payne; Christine Anna,14,0,45,31
1746542636851,SOCI 139,A00,890620,Staff,38,0,45,7
1746542637875,SOCI 148E,A00,890622,Calderon-Zaks; Michael Aar,36,0,45,9
1746542638905,SOCI 150,A00,890623,Kohler; Kristopher M.,31,0,45,14
1746542639932,SOCI 157,A00,890625,Jules-Rosette; Bennetta W.,18,0,20,2
1746542640958,SOCI 160,A00,890627,Payne; Christine Anna,21,0,45,24
1746542642013,SYN 1,A00,886855,Fish; Gwendolyn Anne,0,0,0,0
1746542642013,SYN 1,B00,906086,Fish; Gwendolyn Anne,0,1,0,2
1746542643035,SYN 2R,A00,886860,Staff,0,17,15,15
1746542643035,SYN 2R,B00,906106,Atkinson; Arthur Laird,0,16,15,15
1746542644066,SYN 100,A01,886866,Browne; Emily,0,28,20,20
1746542644066,SYN 100,B01,906128,Rock; Martin,0,5,20,20
1746542644066,SYN 100,C01,906140,Deavenport; James Cary,0,3,20,20
1746542644066,SYN 100,D01,907816,Deavenport; James Cary,0,5,20,20
1746542645092,TDAC 1,A00,890286,Walsh; Kim C.,9,0,20,11
1746542646115,TDAC 101,A00,890296,Basso; Beatrice,16,0,20,4
1746542647140,TDDE 131,A00,890297,Staff,47,0,50,3
1746542648166,TDDM 1,A00,890287,Weinberg; Sadie,25,0,30,5
1746542649197,TDGE 11,A00,890288,Fulton; Julia,137,0,200,63
1746542649197,TDGE 11,B00,890289,Castro; Robert Jess,184,0,200,16
1746542650222,TDGE 25,B00,957359,Walsh; Kim C.,3,0,20,17
1746542651250,TDGE 40,A01,890292,Power; Jade Yukana,27,0,30,3
1746542652280,TDGE 124,A00,890298,Havis; Allan,0,0,50,50
1746542653309,TDGE 131R,A00,890299,Burelle; Julie Sara Veronique,15,0,42,27
1746542654339,TDHT 101,A00,890300,Staff,10,0,20,10
1746542655365,TDHT 109,A01,890302,Anderson; Mysia Anyse,31,0,40,9
1746542656393,TDMV 1,A00,890293,Arcidiacono; Kristin,18,0,30,12
1746542657418,TDMV 2,A00,890294,Weinberg; Sadie,23,0,30,7
1746542658444,TDMV 3,A00,957878,Arcidiacono; Kristin,28,0,30,2
1746542660505,TDMV 138,A00,890304,Jun; Grace Shin Hae,25,0,40,15
1746542661530,TDMV 140,A00,890305,Corrales; Joseph Bernales,25,0,30,5
1746542662559,TDMV 142,A00,890307,Caligagan; Tony,32,0,40,8
1746542663587,TDMV 144,A00,890308,Camaya; Michelle Ann,25,0,30,5
1746542664613,TDPW 1,A00,890295,Stein; Deborah Isobel,3,0,20,17
1746542665639,USP 2,A01,890272,Lerner; Amy M,6,0,20,14
1746542666667,USP 3,A01,890274,Staff,12,0,30,18
1746542667693,USP 15,A01,890276,Sun; Feiyang,17,0,30,13
1746542668722,USP 25,A00,890277,Shenkman; Michael Thomas,19,0,25,6
1746542669748,USP 138,A00,890278,Staff,13,0,25,12
1746542670776,USP 143,A00,890279,Staff,21,0,70,49
1746542671804,USP 144,A00,890280,Chowdhury; Muhammed Zohir,16,0,30,14
1746542672832,USP 150,A00,890281,Boomhower; Matthew Charles,4,0,30,26
1746542673857,USP 151,A00,890282,Staff,16,0,20,4
1746542674887,USP 162,A00,890283,Andrews; Abigail Leslie,16,0,20,4
1746542675914,USP 168,A00,920477,Kwak; Nancy,1,0,5,4
1746542676940,USP 181,A00,890284,Staff,3,0,20,17
1746542677970,USP 191A,A00,890285,Staff,13,0,20,7
1746542678999,VIS 101,A00,886512,Staff,25,0,75,50
1746542680029,VIS 103,A00,886513,Cruz; Edwin Teddy,61,0,75,14
1746542681054,VIS 108,A00,886514,Staff,3,0,15,12
1746542682080,VIS 127P,A00,886515,Shen; Kuiyi,80,0,146,66
1746542683130,VIS 149,A00,886516,Yoldas; Pinar,0,0,15,15
1746542684155,VIS 164,A00,886526,Erdmann; Dean,19,0,22,3
1746542685180,VIS 194S,A00,886527,Staff,61,0,75,14
1746542686209,WCWP 10A,C00,886484,Martiniuk; Jill,12,0,15,3
1746542687237,WCWP 10B,A00,886490,Uriarte; Emma,0,0,15,15
1746542687237,WCWP 10B,B00,886491,Dhir; Simrita,11,0,15,4
1746542687237,WCWP 10B,C00,886492,Ornelas; Tricia,0,0,15,15
1746542688263,WCWP 100,A00,886494,Young; Mark T,0,7,15,15
1746542690361,AAS 10,A01,886199,Childs; Dennis R.,0,3,0,0
1746542691386,ANAR 104,A01,886940,Shtienberg; Gilad,27,0,30,3
1746542692423,ANAR 120,A00,886953,Staff,12,0,20,8
1746542693452,ANBI 148,A01,886955,Wilder; Linnea Lorene,30,0,40,10
1746542695505,ANSC 122,A00,886957,Staff,25,0,30,5
1746542696531,ANSC 150,A00,886958,Sloane; Julia Kathryn,3,0,15,12
1746542697558,ANSC 156,A00,886959,Jenkins; Janis A.,0,1,15,15
1746542698583,ANSC 180,A00,886960,Staff,11,0,17,6
1746542699615,ANSC 188,A00,886961,Jassal; Aftab,9,0,25,16
1746542700642,ANSC 190,A00,886962,Jassal; Aftab,14,0,25,11
1746542701669,ANSC 191,A00,886963,Staff,18,0,20,2
1746542702696,ANTH 3,A01,891689,Staff,17,0,20,3
1746542703721,ANTH 5,A00,886933,Semendeferi; Ekaterini,16,0,20,4
1746542704747,ANTH 10,A00,886934,Staff,0,12,30,30
1746542705778,ANTH 21,A01,886936,Staff,40,0,60,20
1746542706807,ANTH 23,A01,886938,Staff,92,0,100,8
1746542707833,ANTH 105,A00,886964,Stewart; Alexander B,84,0,100,16
1746542708858,ANTH 108,A00,886965,Pedersen; David,9,0,20,11
1746542709886,AWP 10,001,886147,Staff,0,0,0,0
1746542709886,AWP 10,002,886148,Staff,0,0,0,0
1746542709886,AWP 10,003,886149,Staff,0,0,0,0
1746542709886,AWP 10,004,886150,Staff,0,0,0,0
1746542709886,AWP 10,005,886151,Staff,0,0,0,0
1746542709886,AWP 10,006,886152,Staff,0,0,0,0
1746542709886,AWP 10,007,886153,Staff,0,0,0,0
1746542709886,AWP 10,008,886154,Staff,0,0,0,0
1746542709886,AWP 10,009,886155,Staff,0,0,0,0
1746542709886,AWP 10,010,886156,Staff,0,0,0,0
1746542709886,AWP 10,011,886158,Staff,0,0,0,0
1746542709886,AWP 10,012,886160,Staff,0,0,0,0
1746542709886,AWP 10,013,886161,Staff,0,0,0,0
1746542709886,AWP 10,014,886162,Staff,0,0,0,0
1746542709886,AWP 10,015,886163,Staff,0,0,0,0
1746542709886,AWP 10,016,886164,Staff,0,0,0,0
1746542709886,AWP 10,017,886165,Staff,0,0,0,0
1746542709886,AWP 10,018,886166,Staff,0,0,0,0
1746542709886,AWP 10,019,886168,Staff,0,0,0,0
1746542709886,AWP 10,020,886170,Staff,0,0,0,0
1746542709886,AWP 10,021,886172,Staff,0,0,0,0
1746542710917,AWP 10R,001,886173,Staff,0,1,0,0
1746542710917,AWP 10R,002,886174,Staff,0,1,0,0
1746542710917,AWP 10R,003,886175,Staff,0,0,0,0
1746542710917,AWP 10R,004,886176,Staff,0,0,0,0
1746542710917,AWP 10R,005,886177,Staff,0,0,0,0
1746542710917,AWP 10R,006,886178,Staff,0,0,0,0
1746542710917,AWP 10R,007,886179,Staff,0,0,0,0
1746542710917,AWP 10R,008,886181,Staff,0,0,0,0
1746542710917,AWP 10R,009,886182,Staff,0,0,0,0
1746542710917,AWP 10R,010,886183,Staff,0,0,0,0
1746542710917,AWP 10R,011,886184,Staff,0,0,0,0
1746542710917,AWP 10R,012,886185,Staff,0,0,0,0
1746542710917,AWP 10R,013,886186,Staff,0,0,0,0
1746542710917,AWP 10R,014,886187,Staff,0,0,0,0
1746542710917,AWP 10R,015,886188,Staff,0,0,0,0
1746542710917,AWP 10R,016,886189,Staff,0,0,0,0
1746542711946,AWP 102R,A00,886190,Staff,0,0,0,0
1746542711946,AWP 102R,B00,886191,Staff,0,0,0,0
1746542712970,BENG 100,A01,886193,Staff,17,0,30,13
1746542714001,BENG 122A,A01,886195,Hasty; Jeff M,13,0,30,17
1746542715028,BENG 166A,A00,886196,Sah; Robert Lie-Yuan,0,1,30,30
1746542716056,BENG 190,A00,958050,Khojah; Reem I,24,0,25,1
1746542717086,BIBC 102,A01,894320,Staff,0,0,46,46
1746542717086,BIBC 102,A02,894321,Staff,0,0,46,46
1746542717086,BIBC 102,A03,894344,Staff,7,0,46,39
1746542717086,BIBC 102,A04,894345,Staff,26,0,47,21
1746542718113,BICD 100R,A01,894365,Smith; Laurie,0,3,58,58
1746542718113,BICD 100R,A02,894366,Smith; Laurie,0,5,58,58
1746542718113,BICD 100R,A03,894367,Smith; Laurie,2,0,59,57
1746542718113,BICD 100R,A04,959869,Smith; Laurie,41,0,59,18
1746542719144,BICD 136,A01,894383,Gustafson-Brown; Cindy,14,0,50,36
1746542720175,BIEB 102,A01,894494,Butler; Shannon Rhey,51,0,130,79
1746542722234,BIEB 150,A01,894617,Wills; Christopher,3,0,20,17
1746542722234,BIEB 150,A02,894631,Wills; Christopher,3,0,20,17
1746542722234,BIEB 150,A03,894937,Wills; Christopher,3,0,20,17
1746542722234,BIEB 150,A04,894946,Wills; Christopher,5,0,20,15
1746542723268,BIEB 194,A00,906141,Kurle; Carolyn M.,6,0,20,14
1746542724294,BILD 1,A01,894154,Staff,2,0,19,17
1746542724294,BILD 1,A02,894155,Staff,14,0,19,5
1746542724294,BILD 1,A03,894160,Staff,13,0,19,6
1746542724294,BILD 1,A04,894161,Staff,15,0,18,3
1746542725320,BILD 2,A01,894168,Staff,0,0,50,50
1746542725320,BILD 2,A02,894169,Staff,0,0,50,50
1746542725320,BILD 2,A03,894179,Staff,4,0,50,46
1746542725320,BILD 2,A04,894203,Staff,27,0,50,23
1746542726350,BILD 3,A01,894213,Staff,22,0,31,9
1746542726350,BILD 3,A02,894214,Staff,26,0,31,5
1746542726350,BILD 3,A03,894235,Staff,28,0,31,3
1746542726350,BILD 3,A04,894236,Staff,28,0,32,4
1746542727376,BILD 4,A01,894253,Reuther; Keefe,5,0,24,19
1746542727376,BILD 4,A02,894258,Reuther; Keefe,16,0,24,8
1746542728406,BILD 5,A01,894276,Reuther; Keefe,35,0,50,15
1746542728406,BILD 5,A02,894277,Reuther; Keefe,45,0,50,5
1746542728406,BILD 5,A03,894290,Reuther; Keefe,44,0,50,6
1746542728406,BILD 5,A04,894291,Reuther; Keefe,48,0,50,2
1746542729436,BILD 24,A01,894297,Pirino; Giorgia,40,0,60,20
1746542730463,BIMM 100,B01,958915,Staff,72,0,100,28
1746542731489,BIMM 101,A01,895017,McDonnell; Lisa Marie,0,5,24,24
1746542731489,BIMM 101,A02,895018,McDonnell; Lisa Marie,0,5,24,24
1746542731489,BIMM 101,B01,895020,McDonnell; Lisa Marie,0,6,24,24
1746542731489,BIMM 101,B02,895021,McDonnell; Lisa Marie,0,4,24,24
1746542732518,BIMM 110,A01,895023,Staff,1,0,25,24
1746542732518,BIMM 110,A02,895024,Staff,9,0,25,16
1746542732518,BIMM 110,A03,895025,Staff,18,0,25,7
1746542732518,BIMM 110,A04,895031,Staff,20,0,25,5
1746542733546,BIMM 120,A01,895114,Gustafson-Brown; Cindy,13,0,28,15
1746542733546,BIMM 120,A02,895126,Gustafson-Brown; Cindy,21,0,27,6
1746542734573,BIPN 100,A01,895130,Yang; Mingyu,1,0,38,37
1746542734573,BIPN 100,A02,895131,Yang; Mingyu,32,0,38,6
1746542734573,BIPN 100,A03,895132,Yang; Mingyu,32,0,38,6
1746542734573,BIPN 100,A04,895133,Yang; Mingyu,27,0,36,9
1746542735600,BIPN 120,A01,895135,Cooke; James Edward,0,3,13,13
1746542735600,BIPN 120,A02,895136,Cooke; James Edward,0,1,13,13
1746542735600,BIPN 120,A03,895137,Cooke; James Edward,0,3,13,13
1746542735600,BIPN 120,A04,895156,Cooke; James Edward,0,2,11,11
1746542736625,BIPN 134,A01,895235,Cooke; James Edward,0,2,25,25
1746542736625,BIPN 134,A02,895237,Cooke; James Edward,0,0,25,25
1746542736625,BIPN 134,A03,895240,Cooke; James Edward,3,0,25,22
1746542736625,BIPN 134,A04,895270,Cooke; James Edward,20,0,25,5
1746542737655,BIPN 189,A00,892103,Staff,0,13,14,14
1746542739710,BISP 194,A00,958008,Staff,0,2,0,0
1746542740737,CAT 124,A01,922009,Staff,0,5,20,20
1746542741767,CAT 125R,A00,886390,Morales; Celeste Georgianna,0,2,20,20
1746542741767,CAT 125R,B00,886391,Irwin; Matthew Joseph,0,3,20,20
1746542741767,CAT 125R,C00,886392,Smith; Lauryn Alissa,0,2,20,20
1746542741767,CAT 125R,D00,886393,Vanderschuit; Maya Alysia,0,2,20,20
1746542741767,CAT 125R,E00,886394,Marchisotto; Jennifer Anne,0,4,20,20
1746542742796,CENG 15,A01,886218,Drews; Aaron,3,0,8,5
1746542743822,CENG 113,A00,886219,Opatkiewicz; Justin Paul,15,0,25,10
1746542744852,CGS 101,A00,887044,Staff,7,0,20,13
1746542745879,CGS 105,A01,887046,Staff,14,0,25,11
1746542746910,CGS 112,A00,887047,Cuong; Marisol,12,0,15,3
1746542747936,CGS 113,A00,887048,Staff,23,0,30,7
1746542748963,CGS 120,A00,887049,Staff,10,0,17,7
1746542749993,CHEM 6A,A01,886336,Lam; Tin Yiu,38,0,50,12
1746542749993,CHEM 6A,A02,886338,Lam; Tin Yiu,37,0,50,13
1746542751018,CHEM 6B,A01,886341,Hopkins; Patrycja Anna,16,0,50,34
1746542751018,CHEM 6B,A02,886343,Hopkins; Patrycja Anna,42,0,50,8
1746542752048,CHEM 6C,A01,886346,Albizati; Kim F.,0,2,50,50
1746542752048,CHEM 6C,A02,886348,Albizati; Kim F.,23,0,50,27
1746542753077,CHEM 40A,A01,886352,Klosterman; Jeremy K,65,0,100,35
1746542754103,CHEM 40B,A01,886356,Klosterman; Jeremy K,0,23,100,100
1746542755130,CHEM 41B,A01,886360,Theodorakis; Emmanuel,25,0,50,25
1746542755130,CHEM 41B,A02,886362,Theodorakis; Emmanuel,47,0,50,3
1746542756156,CHIN 165A,A00,886382,Xu; Li,18,0,20,2
1746542757185,CLAS 120,A00,886387,Myerston Santana; Jacobo,33,0,40,7
1746542758210,COGS 9,A01,886967,Shannon; Kyle Michael,42,0,60,18
1746542759238,COGS 11,A01,886969,Staff,11,0,30,19
1746542760265,COGS 14A,A01,886971,Staff,6,0,60,54
1746542761291,COGS 14B,A01,886973,Hoffman; Drew Ellen,4,0,60,56
1746542762322,COGS 18,A01,886975,Morgan; Eric,35,0,60,25
1746542763351,COGS 20,A01,886977,Staff,4,0,8,4
1746542763351,COGS 20,A02,886978,Staff,5,0,7,2
1746542764379,COGS 100,A01,907783,Staff,0,2,30,30
1746542765407,COGS 101B,A01,886980,Staff,0,3,48,48
1746542766436,COGS 101C,A01,886982,Delgado; Tania,0,5,44,44
1746542767462,COGS 102A,A01,886984,Johnson; Christine M.,4,0,30,26
1746542768487,COGS 118B,A01,886986,Staff,0,3,88,88
1746542769518,COGS 150,A01,886988,Bergen; Benjamin,23,0,50,27
1746542770545,COGS 153,A00,886989,Delgado; Tania,0,2,41,41
1746542771573,COGS 186,A01,886991,Staff,0,0,32,32
1746542772600,COGS 187A,A01,886993,Boyle; Mary E. T.,7,0,30,23
1746542773625,COGS 189,A00,886994,Staff,0,1,30,30
1746542775248,COMM 10,A01,886996,Staff,0,0,20,21
1746542775248,COMM 10,A02,886997,Staff,12,0,20,8
1746542775248,COMM 10,A03,959845,Staff,19,0,20,1
1746542776275,COMM 20,A01,886999,Leuning; Grant Maurstad,24,0,40,16
1746542778330,COMM 100A,A01,887002,Staff,0,0,20,25
1746542778330,COMM 100A,A02,887003,Staff,7,0,20,13
1746542779358,COMM 100B,A01,887005,Staff,0,8,20,24
1746542780386,COMM 106D,A00,887006,Staff,14,0,40,26
1746542781412,COMM 110G,A00,887007,Whitworth-Smith; Andrew C,12,0,40,28
1746542782437,COMM 111B,A00,887008,Staff,31,0,40,9
1746542783466,COMM 113T,A00,887009,Abuelhiga; Soraya Jill,28,0,40,12
1746542783466,COMM 113T,B00,906733,Staff,40,0,40,0
1746542784491,COMM 145,A00,887010,Staff,12,0,40,28
1746542785518,COMM 146,A00,887054,Staff,31,0,40,9
1746542786545,COMM 190,A00,887012,Staff,8,0,23,15
1746542787570,CSE 8A,A50,887015,Cao; Yingjun,57,0,85,28
1746542788596,CSE 11,A01,887017,Cao; Yingjun,12,0,70,58
1746542789623,CSE 20,A01,887019,Staff,30,0,50,20
1746542790649,CSE 21,A01,887021,Staff,78,0,100,22
1746542790649,CSE 21,B01,892583,Braun; Oliver,45,0,50,5
1746542791677,CSE 30,A01,887025,Eldon; John,143,0,200,57
1746542792704,CSE 100,A01,887027,Staff,26,0,50,24
1746542792704,CSE 100,A02,887028,Staff,40,0,50,10
1746542793736,CSE 101,A01,887030,Braun; Oliver,75,0,100,25
1746542793736,CSE 101,B01,887032,Jones; Miles E,0,3,50,50
1746542793736,CSE 101,B02,887033,Jones; Miles E,0,1,50,50
1746542794763,CSE 105,A01,908084,Jones; Miles E,32,0,50,18
1746542794763,CSE 105,A02,908087,Jones; Miles E,33,0,50,17
1746542795788,CSE 135,A01,887035,Powell; Thomas Allan,0,4,50,50
1746542796814,CSE 142,A01,887037,Staff,8,0,60,52
1746542797840,CSE 142L,A01,887039,Staff,34,0,60,26
1746542798869,CSE 151A,A01,887041,Solares; Edwin A,48,0,100,52
1746542799897,CSE 175,A01,887043,Kumar; Rakesh,30,0,30,0
1746542800922,CSS 1,A01,886389,Staff,0,1,40,40
1746542801946,DSC 30,A01,908097,Liao; Soohyun Nam,47,0,75,28
1746542802971,DSC 40A,A01,908099,Shannon; Kyle Michael,30,0,50,20
1746542804000,DSC 40B,A01,908112,Staff,16,0,50,34
1746542805032,DSC 80,A01,908116,Staff,19,0,60,41
1746542806058,DSC 197,001,956863,Eldridge; Justin Matthew,9999,0,9999,0
1746542807086,ECE 5,A01,886400,Morris; Karcher William,2,0,6,4
1746542807086,ECE 5,A02,886401,Morris; Karcher William,3,0,6,3
1746542808116,ECE 148,A01,886403,Silberman; Jack,0,14,14,14
1746542809145,ECON 1,A01,887265,Crane; Meredith Helen,12,0,70,58
1746542809145,ECON 1,B01,887268,Staff,43,0,50,7
1746542810170,ECON 2,A01,887273,Crane; Meredith Helen,56,0,70,14
1746542811198,ECON 3,A01,887279,Rondina; Giacomo,32,0,70,38
1746542812227,ECON 4,A01,887282,Anderson; John Charles,0,2,10,10
1746542813253,ECON 5,A01,887285,Staff,33,0,45,12
1746542813253,ECON 5,B01,887292,Staff,41,0,45,4
1746542814280,ECON 100A,A01,887337,Newhouse; Herbert S,54,0,70,16
1746542814280,ECON 100A,B01,887349,Staff,45,0,50,5
1746542815309,ECON 100B,A01,887361,Du; Songzi,29,0,70,41
1746542816334,ECON 100C,A01,887445,Newhouse; Herbert S,59,0,70,11
1746542817364,ECON 105,A00,887488,Vespa; Emanuel Ignacio,23,0,35,12
1746542818392,ECON 109,A01,887506,Shishkin; Denis,28,0,35,7
1746542819425,ECON 110A,A01,887568,Alon; Titan Michael,0,3,35,35
1746542819425,ECON 110A,B01,907601,Alon; Titan Michael,20,0,35,15
1746542820450,ECON 110B,A01,887598,Levkoff; Steven B.,0,23,70,70
1746542821476,ECON 112,A00,887599,Rondina; Giacomo,19,0,35,16
1746542822506,ECON 120A,A01,887603,Dai; Yinlin,36,0,70,34
1746542823533,ECON 120C,A01,887608,Sun; Yixiao,0,1,35,35
1746542823533,ECON 120C,B01,887614,Sun; Yixiao,0,0,35,35
1746542824561,ECON 138,A00,887621,Bharadwaj; Prashant,0,20,20,20
1746542825591,ECON 144,A00,958007,Squires; Dale E,13,0,35,22
1746542826621,ECON 171,A01,907666,Staff,18,0,35,17
1746542827647,ECON 175,A00,887626,Wu; Pak Yeung,23,0,35,12
1746542828672,ECON 190,A00,887640,Vespa; Emanuel Ignacio,23,0,35,12
1746542829699,EDS 25,A01,888197,Staff,0,0,0,0
1746542829699,EDS 25,A02,888209,Staff,0,0,0,0
1746542829699,EDS 25,A03,888210,Staff,0,0,0,0
1746542829699,EDS 25,A04,888212,Staff,0,0,0,0
1746542829699,EDS 25,A05,888213,Staff,0,0,0,0
1746542829699,EDS 25,A06,888214,Staff,0,0,0,0
1746542829699,EDS 25,A07,888235,Staff,0,2,0,0
1746542829699,EDS 25,A08,888236,Staff,0,0,0,0
1746542829699,EDS 25,A09,888240,Staff,0,0,0,0
1746542829699,EDS 25,A10,888244,Staff,0,0,0,0
1746542829699,EDS 25,B01,888273,Staff,0,0,0,0
1746542829699,EDS 25,B02,888285,Staff,0,0,0,0
1746542829699,EDS 25,B03,888423,Staff,0,0,0,1
1746542829699,EDS 25,B04,888432,Staff,0,0,0,0
1746542829699,EDS 25,B05,888433,Staff,0,0,0,0
1746542829699,EDS 25,B06,888467,Staff,0,0,0,0
1746542829699,EDS 25,B07,888468,Staff,0,0,0,0
1746542829699,EDS 25,B08,888479,Staff,0,0,0,0
1746542829699,EDS 25,B09,888484,Staff,0,0,0,0
1746542829699,EDS 25,B10,888487,Staff,0,0,0,0
1746542830724,EDS 38,A01,907700,Choi; Bailey Miyeon,30,0,30,0
1746542831751,EDS 112,A01,888601,Chapman; Thandeka K,14,0,40,26
1746542832779,EDS 115,A00,888697,Mendez; Kathrina Mendoza,10,0,30,20
1746542833805,EDS 116,A01,888893,Staff,35,0,40,5
1746542835858,EDS 124AR,A00,889133,Staff,29,0,50,21
1746542835858,EDS 124AR,B00,907471,Simon; Elizabeth A,37,0,50,13
1746542836886,EDS 124BR,A00,889134,Simon; Elizabeth A,45,0,100,55
1746542837911,EDS 125,A00,889135,Staff,25,0,30,5
1746542838937,EDS 126,A01,889138,Staff,36,0,40,4
1746542839968,EDS 164R,A01,889142,Wishard Guerra; Alison G.,33,0,50,17
1746542840996,ENG 30,A01,886396,Staff,0,0,0,0
1746542840996,ENG 30,B01,886398,Staff,0,0,0,0
1746542842029,ENVR 102,A00,906150,Montejo; Carolina,23,0,25,2
1746542843057,ETHN 103A,A00,887236,Man; Simeon S,0,3,0,0
1746542844084,ETHN 113,A00,887239,Staff,16,0,30,14
1746542845110,ETHN 116,A00,887240,Staff,16,0,25,9
1746542846137,ETHN 117,A00,887241,Choi; Esther Min,28,0,30,2
1746542847166,ETHN 118,A00,887243,Staff,24,0,30,6
1746542848192,ETHN 127,A00,887248,Cuong; Marisol,11,0,15,4
1746542849218,ETHN 139,A00,887250,Staff,7,0,10,3
1746542850245,ETHN 142,A00,887252,Staff,10,0,30,20
1746542851269,ETHN 161,A00,887253,Browne; Errol Tsekani,24,0,30,6
1746542852295,ETHN 163FR,A00,887255,Burelle; Julie Sara Veronique,0,0,5,5
1746542853335,GLBH 20,A00,889149,Elwardani; Nile Regina,8,0,42,34
1746542855387,GLBH 111,A01,889152,Burgos; Jose L.,17,0,17,0
1746542856412,GLBH 150,A00,889181,Sloane; Julia Kathryn,0,5,15,15
1746542858466,HDS 60,A01,886406,Warstadt; Melissa Fawn,73,0,80,7
1746542859495,HIAF 111,A00,889324,Gyamfi; Bright,25,0,32,7
1746542860523,HIEA 131,A00,889328,Staff,16,0,32,16
1746542861555,HIEA 144,A00,889333,Henry; Todd A.,26,0,32,6
1746542862585,HIEA 154,A00,889336,Henry; Todd A.,24,0,32,8
1746542863611,HIEU 106,A00,889339,Staff,22,0,32,10
1746542865664,HIEU 114,A00,889340,Staff,3,0,32,29
1746542866737,HIEU 135GS,A00,889342,Patterson; Patrick H.,0,0,1,24
1746542867763,HIEU 137,A00,889343,Edington; Claire Ellen,9,0,25,16
1746542868792,HIEU 148,A00,889345,Staff,14,0,32,18
1746542869826,HIEU 154,A00,889346,Biess; Frank Peter,21,0,32,11
1746542870854,HILA 102,A00,889351,Staff,12,0,32,20
1746542871882,HILD 2A,A01,889221,Lewandoski; Julia Mavis,1,10,32,31
1746542872906,HILD 7B,A01,889225,Man; Simeon S,0,13,32,32
1746542873933,HILD 7C,A01,889288,Alvarez; Luis A,0,14,32,32
1746542874959,HILD 30,A01,889323,Staff,0,5,32,32
1746542877016,HISC 119,A00,889383,Golan; Tal,21,0,32,11
1746542878045,HIUS 103,A00,889384,Man; Simeon S,0,0,32,32
1746542879070,HIUS 117,A00,919797,Kwak; Nancy,18,0,32,14
1746542880096,HIUS 142A,A00,919788,Staff,22,0,32,10
1746542882151,HIUS 149,A00,889386,Gyamfi; Bright,27,0,32,5
1746542883175,HIUS 155,A00,889387,Alvarez; Luis A,14,0,32,18
1746542884201,HUM 3,A01,886499,Caldwell; Michael Alan,19,0,50,31
1746542885227,HUM 3GS,A00,886500,Rodriguez; Bretton Sigfred,0,0,0,28
1746542886252,HUM 3R,A01,886502,Markman; Kristina,0,36,50,50
1746542887278,HUM 4,A01,886504,Crum; Matthew Stephen,24,0,50,26
1746542887278,HUM 4,B01,886506,West; Geoffrey Scott,17,0,50,33
1746542888307,HUM 4GS,A00,886507,Staff,0,0,0,19
1746542889333,HUM 5,A01,886509,Staff,32,0,50,18
1746542890360,HUM 5R,A01,886511,Zavodny; Tatiana Sophia,0,39,50,50
1746542891385,JAPN 180,A00,886407,Staff,18,0,40,22
1746542892411,LATI 50,A01,886409,Martin-Cabrera; Luis,4,0,22,18
1746542892411,LATI 50,A02,886410,Martin-Cabrera; Luis,19,0,22,3
1746542892411,LATI 50,A03,886411,Martin-Cabrera; Luis,21,0,22,1
1746542892411,LATI 50,A04,886412,Martin-Cabrera; Luis,9,0,22,13
1746542893436,LAWS 101,A00,907664,Staff,28,0,60,32
1746542894464,LIAB 1A,A00,889388,Saab; Dima,17,0,20,3
1746542895490,LIAB 1AX,A00,889389,El Cheddadi; Youniss,17,0,20,3
1746542896514,LIFR 1C,A00,889391,Van Moer; Vinciane G,8,0,20,12
1746542897543,LIFR 1CX,A00,889392,Van Moer; Vinciane G,7,0,20,13
1746542898570,LIFR 1D,A00,889393,Van Moer; Vinciane G,7,0,20,13
1746542899597,LIFR 1DX,A00,889394,Van Moer; Vinciane G,8,0,20,12
1746542900622,LIGN 7,A00,886923,Staff,24,0,50,26
1746542901653,LIGN 17,A00,886924,Kehler; Andrew Scott,125,0,150,25
1746542902681,LTAM 110,A00,889395,Staff,15,0,30,15
1746542903708,LTAM 110GS,A00,958010,Rodriguez; Bretton Sigfred,0,0,0,28
1746542904735,LTCH 101,A00,889397,Staff,23,0,25,2
1746542905763,LTCS 130,A00,889398,Staff,23,0,25,2
1746542906788,LTEA 138,A00,889399,Staff,24,0,40,16
1746542907814,LTEN 149,A00,889400,Wesling; Megan E.,0,3,25,25
1746542908840,LTEN 169,A00,889401,Staff,20,0,25,5
1746542909866,LTEN 180,A00,889402,Staff,10,0,15,5
1746542910894,LTEN 181,A00,889403,Staff,21,0,25,4
1746542911920,LTWL 100,A00,889404,Myerston Santana; Jacobo,3,0,25,22
1746542912947,LTWL 180GS,A00,889405,Staff,0,0,20,20
1746542913976,LTWL 181,A00,889406,Staff,17,0,25,8
1746542915002,LTWL 184,A00,889475,Mukherjee; Silpa,22,0,25,3
1746542916027,LTWR 102C,A00,889486,Staff,29,0,30,1
1746542917054,LTWR 115W,A00,889491,Staff,0,2,15,15
1746542918081,MAE 8,A01,886905,Staff,0,2,0,0
1746542919107,MAE 11,A00,886906,Bandaru; Prabhakar,0,7,50,50
1746542920133,MAE 20,A00,886907,Evdokimenko; Ekaterina,44,0,70,26
1746542921161,MAE 30B,A00,886909,Ghazinejad; Maziar,26,0,45,19
1746542922192,MAE 101B,A00,886910,Saintillan; David,29,0,45,16
1746542923218,MAE 105,A00,886911,Bandaru; Prabhakar,18,0,50,32
1746542924246,MAE 107,B00,958024,Staff,9,0,50,41
1746542925271,MAE 143B,A00,886913,Bewley; Thomas R,7,0,40,33
1746542926298,MAE 148,A01,886915,Silberman; Jack,0,3,14,14
1746542927329,MAE 160,A00,886916,Evdokimenko; Ekaterina,31,0,60,29
1746542928359,MATH 3C,A01,889681,Staff,0,3,30,30
1746542928359,MATH 3C,A02,960048,Staff,25,0,30,5
1746542929388,MATH 10A,A01,889760,Staff,26,0,30,4
1746542929388,MATH 10A,A02,889783,Staff,29,0,30,1
1746542930415,MATH 10B,A01,889785,Verstraete; Jacques Allan,2,0,35,33
1746542930415,MATH 10B,A02,889795,Verstraete; Jacques Allan,4,0,35,31
1746542930415,MATH 10B,B01,889797,Verstraete; Jacques Allan,3,0,35,32
1746542930415,MATH 10B,B02,889828,Verstraete; Jacques Allan,3,0,35,32
1746542931448,MATH 10C,A01,889849,Habib; Yousaf,9,0,30,21
1746542931448,MATH 10C,A02,889852,Habib; Yousaf,14,0,30,16
1746542931448,MATH 10C,A03,889853,Habib; Yousaf,22,0,30,8
1746542931448,MATH 10C,A04,889858,Habib; Yousaf,20,0,30,10
1746542931448,MATH 10C,B01,889861,Staff,1,0,30,29
1746542931448,MATH 10C,B02,889862,Staff,24,0,30,6
1746542931448,MATH 10C,B03,889863,Staff,27,0,30,3
1746542931448,MATH 10C,B04,889967,Staff,23,0,30,7
1746542932476,MATH 18,A01,889974,Staff,7,0,30,23
1746542932476,MATH 18,A02,889977,Staff,20,0,30,10
1746542932476,MATH 18,B01,889984,Hardiman; Liam,22,0,30,8
1746542932476,MATH 18,B02,889985,Hardiman; Liam,25,0,30,5
1746542933502,MATH 20A,A01,889990,Suk; Andrew Hoon,29,0,35,6
1746542934528,MATH 20B,A01,889993,Ohm; Ko Woon,22,0,30,8
1746542934528,MATH 20B,A02,889994,Ohm; Ko Woon,30,0,30,0
1746542934528,MATH 20B,B01,889996,Ohm; Ko Woon,21,0,30,9
1746542934528,MATH 20B,B02,889997,Ohm; Ko Woon,23,0,30,7
1746542935554,MATH 20C,A01,889999,Hammock; Frances H,17,0,30,13
1746542935554,MATH 20C,A02,890003,Hammock; Frances H,23,0,30,7
1746542935554,MATH 20C,B01,890006,Hammock; Frances H,3,0,30,27
1746542935554,MATH 20C,B02,890007,Hammock; Frances H,11,0,30,19
1746542936580,MATH 20D,A01,890011,Cheng; Hsiao-Bing,1,1,30,29
1746542936580,MATH 20D,A02,890012,Cheng; Hsiao-Bing,14,0,30,16
1746542936580,MATH 20D,B01,890016,Cheng; Hsiao-Bing,13,0,30,17
1746542936580,MATH 20D,B02,890017,Cheng; Hsiao-Bing,13,0,30,17
1746542937611,MATH 20E,A01,890026,Harel; Guershon,1,0,30,29
1746542937611,MATH 20E,A02,890029,Harel; Guershon,23,0,30,7
1746542937611,MATH 20E,B01,890033,Harel; Guershon,7,0,30,23
1746542937611,MATH 20E,B02,890101,Harel; Guershon,21,0,30,9
1746542938638,MATH 102,A01,890104,Staff,17,0,30,13
1746542938638,MATH 102,A02,890105,Staff,27,0,30,3
1746542939665,MATH 103B,A01,890116,Salehi Golsefidy; Alireza,3,0,30,27
1746542939665,MATH 103B,B01,890118,Staff,0,3,34,34
1746542940694,MATH 109,A01,890121,Aliabadi Sr.; Mohsen,1,0,30,29
1746542940694,MATH 109,B01,890124,Upadrashta; Pranav Kumar,18,0,30,12
1746542941726,MATH 120A,A01,890126,Eggers; John Dietrich,13,0,30,17
1746542942756,MATH 142B,A01,890128,Ioana; Adrian,19,0,30,11
1746542942756,MATH 142B,A02,890129,Ioana; Adrian,13,0,30,17
1746542943782,MATH 154,A01,890174,Staff,0,0,30,30
1746542943782,MATH 154,A02,890182,Staff,0,0,30,30
1746542944807,MATH 168A,A01,890197,Dumitriu; Ioana,21,0,35,14
1746542945834,MATH 170A,A01,890240,Nie; Jiawang,1,0,30,29
1746542945834,MATH 170A,A02,890241,Nie; Jiawang,11,0,30,19
1746542945834,MATH 170A,A03,890249,Nie; Jiawang,23,0,30,7
1746542946860,MATH 170B,A01,957891,Nag; Panchali,13,0,35,22
1746542948914,MATH 181A,A01,908025,Staff,0,4,35,35
1746542948914,MATH 181A,A02,960115,Staff,27,0,35,8
1746542949942,MATH 181B,A01,959874,Staff,26,0,30,4
1746542950970,MATH 193B,A01,890265,Staff,0,4,35,35
1746542951995,MGT 4,A01,890311,Anderson; John Charles,42,0,88,46
1746542953024,MGT 5,A00,907740,Staff,13,0,98,85
1746542954048,MGT 12,A00,890312,Lindenberger; Wade Douglas,67,0,98,31
1746542955077,MGT 16,A00,957883,Staff,78,0,98,20
1746542957132,MGT 45,A00,890314,Pecore; Joseph P.,47,0,98,51
1746542958158,MGT 71,A00,890315,Staff,0,11,98,98
1746542959182,MGT 100,A00,890316,Yavorsky; Daniel Ryan,44,0,98,54
1746542960208,MGT 103,A00,890317,Ehrich; Kristine R,73,0,98,25
1746542961237,MGT 105,A00,890356,Bates; Kenneth Walter,0,7,98,98
1746542962265,MGT 112,A00,890360,Ehrich; Kristine R,55,0,98,43
1746542963293,MGT 127R,A00,907732,Zhu; Kevin Xiaoguo,23,0,98,75
1746542964318,MGT 131B,A00,890361,Anderson; John Charles,61,0,98,37
1746542965347,MGT 137,A00,890362,Lindenberger; Wade Douglas,65,0,98,33
1746542966372,MGT 160,A00,890369,Johnson; Erik Barry,9,0,98,89
1746542968428,MGT 164,A00,890372,Zimmermann; Carsten,0,39,98,98
1746542969456,MGT 180,A00,890374,Bliss; Barbara Ann,12,0,98,86
1746542970484,MMW 15,A01,886414,Chang; Edmond Yi-Teh,0,12,28,28
1746542970484,MMW 15,A02,886415,Chang; Edmond Yi-Teh,0,8,28,28
1746542970484,MMW 15,A03,886416,Chang; Edmond Yi-Teh,0,8,28,28
1746542970484,MMW 15,A04,886417,Chang; Edmond Yi-Teh,0,8,28,28
1746542970484,MMW 15,B01,886419,Chang; Edmond Yi-Teh,0,7,28,28
1746542970484,MMW 15,B02,886420,Chang; Edmond Yi-Teh,0,8,28,28
1746542970484,MMW 15,B03,886421,Chang; Edmond Yi-Teh,0,7,28,28
1746542970484,MMW 15,B04,886422,Chang; Edmond Yi-Teh,0,8,28,28
1746542970484,MMW 15,C01,886424,Staff,0,9,28,28
1746542970484,MMW 15,C02,886425,Staff,0,8,28,28
1746542970484,MMW 15,C03,886426,Staff,0,8,28,28
1746542970484,MMW 15,C04,886427,Staff,0,7,28,28
1746542970484,MMW 15,C05,958038,Staff,0,7,28,28
1746542970484,MMW 15,C06,958039,Staff,0,8,28,28
1746542971511,MMW 15GS,A00,906910,Patterson; Patrick H.,4,0,28,24
1746542972537,MMW 122R,A01,886429,Rahimi; Babak,0,13,28,28
1746542972537,MMW 122R,A02,886430,Rahimi; Babak,0,12,28,28
1746542972537,MMW 122R,A03,958040,Rahimi; Babak,0,11,28,28
1746542973567,MUS 1A,A01,890937,Staff,3,0,25,22
1746542973567,MUS 1A,A02,891035,Staff,6,0,25,19
1746542973567,MUS 1A,C01,958912,Staff,24,0,25,1
1746542973567,MUS 1A,C02,958913,Staff,25,0,25,0
1746542975619,MUS 2AK,A00,957092,Ohnishi; Takae,15,0,15,0
1746542976645,MUS 4,A01,891044,Staff,2,0,25,23
1746542976645,MUS 4,A02,891045,Staff,23,0,25,2
1746542976645,MUS 4,B01,891048,Staff,17,0,25,8
1746542976645,MUS 4,B02,891050,Staff,25,0,25,0
1746542977673,MUS 5,A01,957506,Dubnov; Shlomo,0,0,25,25
1746542977673,MUS 5,A02,957622,Dubnov; Shlomo,14,0,25,11
1746542977673,MUS 5,A03,957623,Dubnov; Shlomo,20,0,25,5
1746542978702,MUS 6,A01,891053,Freitas Caetano; Marcelo,24,0,25,1
1746542978702,MUS 6,A02,891054,Freitas Caetano; Marcelo,23,0,25,2
1746542979726,MUS 7,A01,891081,Staff,0,0,25,25
1746542979726,MUS 7,A02,891082,Staff,4,0,25,21
1746542980751,MUS 8GS,A00,891118,Borgo; David Garcia,0,0,25,25
1746542981776,MUS 11,A01,891140,Staff,11,0,25,14
1746542981776,MUS 11,A02,891141,Staff,22,0,25,3
1746542982801,MUS 13,A01,891143,Staff,8,0,25,17
1746542982801,MUS 13,A02,891144,Staff,24,0,25,1
1746542983831,MUS 15,A01,891146,Staff,9,0,25,16
1746542983831,MUS 15,A02,891148,Staff,21,0,25,4
1746542983831,MUS 15,B01,891150,Staff,18,0,25,7
1746542983831,MUS 15,B02,891151,Staff,25,0,25,0
1746542984858,MUS 20,A01,891153,Staff,5,0,20,15
1746542984858,MUS 20,A02,891155,Staff,14,0,20,6
1746542985883,MUS 80,A00,891156,Staff,19,0,25,6
1746542985883,MUS 80,B00,891157,Staff,23,0,25,2
1746542986908,MUS 130,A00,891158,Ohnishi; Takae,35,0,35,0
1746542987934,MUS 150GS,A01,891160,Borgo; David Garcia,0,0,25,25
1746542988961,MUS 170,A01,891162,Freitas Caetano; Marcelo,20,0,25,5
1746542988961,MUS 170,A02,891164,Freitas Caetano; Marcelo,21,0,25,4
1746542989991,NANO 11,A00,886220,Vazquez Mena; Oscar,13,0,15,2
1746542991018,NANO 15,A01,886222,Drews; Aaron,4,0,7,3
1746542992048,NANO 104,A00,886224,Sirbuly; Donald,18,0,25,7
1746542993074,PH 40,A00,886528,Staff,23,0,40,17
1746542994100,PH 45,A01,886799,Staff,35,0,40,5
1746542995129,PH 110,A00,886802,Staff,0,7,40,40
1746542996156,PH 172,A00,906716,Staff,19,0,35,16
1746542997181,PH 191,A00,886803,Staff,6,0,40,34
1746542998209,PHIL 1,A00,889500,Staff,19,0,30,11
1746542999237,PHIL 10,A01,889549,Grush; Rick Scott,15,0,22,7
1746542999237,PHIL 10,A02,889551,Grush; Rick Scott,22,0,22,0
1746543000267,PHIL 28,A01,889559,Lamey; Andy M.,0,1,31,31
1746543000267,PHIL 28,A02,889561,Lamey; Andy M.,0,1,30,30
1746543000267,PHIL 28,A03,889572,Lamey; Andy M.,0,0,30,30
1746543001295,PHIL 35,A00,907839,Staff,13,0,15,2
1746543002322,PHIL 60,A00,889574,Staff,74,0,90,16
1746543003349,PHIL 101,A00,958004,Staff,13,0,15,2
1746543005404,PHIL 136,A00,889582,Fulkerson; Matthew Todd,26,0,45,19
1746543006436,PHIL 163,A01,889601,Staff,21,0,30,9
1746543006436,PHIL 163,B01,889606,Brandt; Reuven A,0,3,0,0
1746543007464,PHIL 164,A00,889610,Staff,16,0,30,14
1746543008491,PHIL 165,A00,889613,Staff,23,0,30,7
1746543009517,PHYS 1A,A00,886431,Staff,26,0,70,44
1746543010545,PHYS 1AL,001,886432,Tsai; Philbert S,0,2,30,30
1746543010545,PHYS 1AL,002,886436,Tsai; Philbert S,11,0,30,19
1746543011573,PHYS 1B,A00,886439,Staff,185,0,240,55
1746543012600,PHYS 1BL,001,886441,Tsai; Philbert S,0,4,30,30
1746543012600,PHYS 1BL,002,886444,Tsai; Philbert S,2,0,30,28
1746543013629,PHYS 1C,A00,896092,Arnold; Kam S,78,0,146,68
1746543014674,PHYS 1CL,001,886448,Tsai; Philbert S,0,0,30,30
1746543014674,PHYS 1CL,002,886449,Tsai; Philbert S,0,0,30,30
1746543014674,PHYS 1CL,003,886450,Tsai; Philbert S,16,0,30,14
1746543014674,PHYS 1CL,004,886451,Tsai; Philbert S,15,0,30,15
1746543015700,PHYS 2B,A01,886457,Staff,69,0,115,46
1746543016727,PHYS 2C,A01,886460,Shotwell; Brian,0,8,65,65
1746543017757,PHYS 2CL,A01,886467,Staff,0,4,28,28
1746543017757,PHYS 2CL,A02,886468,Staff,0,3,28,28
1746543018783,PHYS 2D,A01,886470,Staff,10,0,50,40
1746543019808,PHYS 4B,A01,886475,Grinstein; Benjamin,22,0,40,18
1746543020846,POLI 5,A00,891173,Desposato; Scott,7,0,25,18
1746543021875,POLI 5D,A01,891175,Staff,5,0,5,0
1746543021875,POLI 5D,B01,891178,Staff,5,0,5,0
1746543022906,POLI 11,A00,891179,Ferree; Karen E,2,0,35,33
1746543023932,POLI 12,A00,891180,Staff,16,0,30,14
1746543024961,POLI 27,A01,891182,Staff,12,0,75,63
1746543025987,POLI 30,A00,891183,Staff,9,0,50,41
1746543027013,POLI 100B,A00,891244,Staff,5,1,35,30
1746543028041,POLI 100I,A00,891247,Staff,7,0,30,23
1746543029068,POLI 104J,A00,891248,Nichter; Maysa,14,0,30,16
1746543030097,POLI 104U,A00,891250,Nichter; Maysa,2,0,30,28
1746543032155,POLI 110B,A00,891255,Wiens; David,20,0,25,5
1746543033182,POLI 112A,A00,891256,Wiens; David,6,0,25,19
1746543034207,POLI 114BR,A00,891261,Staff,19,0,30,11
1746543035234,POLI 117R,A00,891262,Forman; Fonna,0,6,50,50
1746543036260,POLI 118,A00,891264,Ingham; Sean,17,0,25,8
1746543037288,POLI 124A,A00,891265,Staff,18,0,20,2
1746543038316,POLI 125D,A00,891266,Nichter; Simeon C,2,0,25,23
1746543039342,POLI 126,A00,891268,Nichter; Simeon C,7,0,25,18
1746543040368,POLI 126AA,A00,891272,Staff,18,0,25,7
1746543041397,POLI 130AA,A00,891273,Staff,15,0,20,5
1746543042422,POLI 134AA,A00,891274,Staff,4,0,20,16
1746543044472,POLI 138,A00,891278,Staff,21,0,25,4
1746543045504,POLI 142K,A00,891280,Staff,11,0,25,14
1746543046529,POLI 142M,A00,891281,Gartzke; Erik,17,0,30,13
1746543047558,POLI 142P,A00,891284,Staff,20,0,30,10
1746543048582,POLI 143,A00,891285,Gartzke; Erik,12,0,30,18
1746543049609,POLI 153,A00,891286,Staff,19,0,20,1
1746543051665,POLI 175,A00,891290,Staff,15,0,20,5
1746543052694,PSYC 1,A00,890674,Steiner; Eric Tomas,0,11,45,45
1746543053726,PSYC 2,A00,890676,Albright; Thomas D,21,0,35,14
1746543054755,PSYC 3,A00,890679,Staff,17,0,20,3
1746543055785,PSYC 6,A00,959858,Staff,20,0,20,0
1746543056816,PSYC 60,A01,890684,Rickard; Timothy C.,0,5,45,45
1746543057842,PSYC 70,A01,890689,Geller; Emma Harlan,7,0,30,23
1746543058869,PSYC 71,A01,959860,Staff,21,0,25,4
1746543059898,PSYC 100,A00,890690,Lacefield; Katharine I,0,50,180,180
1746543060923,PSYC 102,A00,890695,Staff,18,0,40,22
1746543061949,PSYC 105,A00,890699,Geller; Emma Harlan,71,0,100,29
1746543062975,PSYC 106,A00,890701,Gorman; Michael R.,5,0,30,25
1746543064005,PSYC 108,A00,890704,Adrian; Julia Anna,0,28,50,50
1746543065031,PSYC 118,A01,890712,Staff,11,0,30,19
1746543066060,PSYC 124,A00,890716,Chapman; Eddie Nathaniel,25,0,60,35
1746543067086,PSYC 131,A00,890717,Anagnostaras; Stephan,0,7,80,80
1746543068114,PSYC 137,A00,890719,Winkielman; Piotr,0,11,30,30
1746543069145,PSYC 144,A00,890721,Adrian; Julia Anna,0,9,45,45
1746543070172,PSYC 162,A00,890805,Staff,2,0,75,73
1746543071197,PSYC 169,A00,890810,Staff,0,15,30,30
1746543072228,PSYC 172,A00,890814,Gorman; Michael R.,9,0,30,21
1746543073254,PSYC 181,A00,890818,Anagnostaras; Stephan,8,0,200,192
1746543074280,PSYC 184,A00,959861,Staff,170,0,175,5
1746543075311,PSYC 189,A00,890823,Staff,0,1,30,30
1746543076335,PSYC 191,A00,890884,Rickard; Timothy C.,0,11,35,35
1746543077365,PSYC 193,A00,890913,Staff,19,0,30,11
1746543077365,PSYC 193,B00,890914,Chapman; Eddie Nathaniel,24,0,30,6
1746543078392,PSYC 193L,A01,890918,Lowe; Angela Beth,20,0,30,10
1746543078392,PSYC 193L,B01,890921,Hurwitz; Ethan Scott,20,0,30,10
1746543078392,PSYC 193L,C01,890928,Staff,30,0,30,0
1746543079417,RELI 149,A00,886806,Rahimi; Babak,23,0,40,17
1746543080444,SE 9,A01,886814,Staff,7,0,20,13
1746543081470,SE 101B,A01,886816,Chadha; Mayank,4,0,35,31
1746543082495,SE 110B,A00,886818,Zhu; Qiang,4,0,75,71
1746543083521,SE 125,A01,886830,Staff,10,0,30,20
1746543084548,SE 130B,A01,886835,Staff,14,0,40,26
1746543085574,SE 131A,A01,886838,Krysl; Petr,34,0,55,21
1746543086601,SE 154,A00,886840,Staff,30,0,50,20
1746543087626,SE 164GS,A01,886849,Staff,6,0,20,14
1746543088653,SE 167GS,A01,886853,Staff,6,0,20,14
1746543089681,SIO 25,A01,890107,Staff,19,0,30,11
1746543090708,SIO 45,A00,890109,Cook; Geoffrey W,117,0,200,83
1746543091734,SIO 109R,A00,890110,Forman; Fonna,0,16,20,20
1746543092762,SIO 187,A01,890114,Kacev; David,15,0,40,25
1746543093792,SOCI 1,A01,890431,Thorpe; Charles Robert,15,0,30,15
1746543093792,SOCI 1,A02,890518,Thorpe; Charles Robert,30,0,30,0
1746543094819,SOCI 2,A01,957978,Staff,25,0,25,0
1746543094819,SOCI 2,A02,957979,Staff,23,0,25,2
1746543095845,SOCI 20,A01,890523,Calderon-Zaks; Michael Aar,23,0,30,7
1746543095845,SOCI 20,A02,890526,Calderon-Zaks; Michael Aar,29,0,30,1
1746543096871,SOCI 30,A01,890533,Pardo Guerra; Juan Pablo,37,0,40,3
1746543097896,SOCI 40,A01,890535,Staff,27,0,45,18
1746543098922,SOCI 104Q,A00,890559,Staff,18,0,30,12
1746543099965,SOCI 106,A00,890560,Arnal; Maud Marie Leonie,20,0,30,10
1746543100991,SOCI 110,A00,890567,Holkenbrink-Monk; Charlene,19,0,30,11
1746543102018,SOCI 112,A00,890568,Victoria Torres; Pablo,1,0,55,54
1746543103043,SOCI 115,A00,890597,Arnal; Maud Marie Leonie,28,0,45,17
1746543105095,SOCI 121,A00,890604,Pardo Guerra; Juan Pablo,38,0,45,7
1746543106120,SOCI 126,A01,890608,Staff,8,0,10,2
1746543107147,SOCI 127,A00,890609,Staff,18,0,30,12
1746543108174,SOCI 131,A00,890610,Thorpe; Charles Robert,37,0,45,8
1746543109201,SOCI 135,A00,890615,Payne; Christine Anna,14,0,45,31
1746543110228,SOCI 139,A00,890620,Staff,38,0,45,7
1746543111258,SOCI 148E,A00,890622,Calderon-Zaks; Michael Aar,36,0,45,9
1746543112283,SOCI 150,A00,890623,Kohler; Kristopher M.,31,0,45,14
1746543113309,SOCI 157,A00,890625,Jules-Rosette; Bennetta W.,18,0,20,2
1746543114334,SOCI 160,A00,890627,Payne; Christine Anna,21,0,45,24
1746543115360,SYN 1,A00,886855,Fish; Gwendolyn Anne,0,0,0,0
1746543115360,SYN 1,B00,906086,Fish; Gwendolyn Anne,0,1,0,2
1746543116384,SYN 2R,A00,886860,Staff,0,17,15,15
1746543116384,SYN 2R,B00,906106,Atkinson; Arthur Laird,0,16,15,15
1746543117420,SYN 100,A01,886866,Browne; Emily,0,28,20,20
1746543117420,SYN 100,B01,906128,Rock; Martin,0,5,20,20
1746543117420,SYN 100,C01,906140,Deavenport; James Cary,0,3,20,20
1746543117420,SYN 100,D01,907816,Deavenport; James Cary,0,5,20,20
1746543118451,TDAC 1,A00,890286,Walsh; Kim C.,9,0,20,11
1746543119480,TDAC 101,A00,890296,Basso; Beatrice,16,0,20,4
1746543120506,TDDE 131,A00,890297,Staff,47,0,50,3
1746543121535,TDDM 1,A00,890287,Weinberg; Sadie,25,0,30,5
1746543122563,TDGE 11,A00,890288,Fulton; Julia,137,0,200,63
1746543122563,TDGE 11,B00,890289,Castro; Robert Jess,184,0,200,16
1746543123622,TDGE 25,B00,957359,Walsh; Kim C.,3,0,20,17
1746543124648,TDGE 40,A01,890292,Power; Jade Yukana,27,0,30,3
1746543125675,TDGE 124,A00,890298,Havis; Allan,0,0,50,50
1746543126703,TDGE 131R,A00,890299,Burelle; Julie Sara Veronique,15,0,42,27
1746543127727,TDHT 101,A00,890300,Staff,10,0,20,10
1746543128752,TDHT 109,A01,890302,Anderson; Mysia Anyse,31,0,40,9
1746543129790,TDMV 1,A00,890293,Arcidiacono; Kristin,18,0,30,12
1746543130819,TDMV 2,A00,890294,Weinberg; Sadie,23,0,30,7
1746543131850,TDMV 3,A00,957878,Arcidiacono; Kristin,28,0,30,2
1746543133903,TDMV 138,A00,890304,Jun; Grace Shin Hae,25,0,40,15
1746543134928,TDMV 140,A00,890305,Corrales; Joseph Bernales,25,0,30,5
1746543135959,TDMV 142,A00,890307,Caligagan; Tony,32,0,40,8
1746543136989,TDMV 144,A00,890308,Camaya; Michelle Ann,25,0,30,5
1746543138017,TDPW 1,A00,890295,Stein; Deborah Isobel,3,0,20,17
1746543139045,USP 2,A01,890272,Lerner; Amy M,6,0,20,14
1746543140073,USP 3,A01,890274,Staff,12,0,30,18
1746543141104,USP 15,A01,890276,Sun; Feiyang,17,0,30,13
1746543142130,USP 25,A00,890277,Shenkman; Michael Thomas,19,0,25,6
1746543143159,USP 138,A00,890278,Staff,13,0,25,12
1746543144185,USP 143,A00,890279,Staff,21,0,70,49
1746543145212,USP 144,A00,890280,Chowdhury; Muhammed Zohir,16,0,30,14
1746543146240,USP 150,A00,890281,Boomhower; Matthew Charles,4,0,30,26
1746543147268,USP 151,A00,890282,Staff,16,0,20,4
1746543148293,USP 162,A00,890283,Andrews; Abigail Leslie,16,0,20,4
1746543149320,USP 168,A00,920477,Kwak; Nancy,1,0,5,4
1746543150346,USP 181,A00,890284,Staff,3,0,20,17
1746543151374,USP 191A,A00,890285,Staff,13,0,20,7
1746543152414,VIS 101,A00,886512,Staff,25,0,75,50
1746543153439,VIS 103,A00,886513,Cruz; Edwin Teddy,61,0,75,14
1746543154466,VIS 108,A00,886514,Staff,3,0,15,12
1746543155492,VIS 127P,A00,886515,Shen; Kuiyi,80,0,146,66
1746543156518,VIS 149,A00,886516,Yoldas; Pinar,0,0,15,15
1746543157547,VIS 164,A00,886526,Erdmann; Dean,19,0,22,3
1746543158576,VIS 194S,A00,886527,Staff,61,0,75,14
1746543159604,WCWP 10A,C00,886484,Martiniuk; Jill,12,0,15,3
1746543160632,WCWP 10B,A00,886490,Uriarte; Emma,0,0,15,15
1746543160632,WCWP 10B,B00,886491,Dhir; Simrita,11,0,15,4
1746543160632,WCWP 10B,C00,886492,Ornelas; Tricia,0,0,15,15
1746543161660,WCWP 100,A00,886494,Young; Mark T,0,7,15,15
1746543163759,AAS 10,A01,886199,Childs; Dennis R.,0,3,0,0
1746543164787,ANAR 104,A01,886940,Shtienberg; Gilad,27,0,30,3
1746543165812,ANAR 120,A00,886953,Staff,12,0,20,8
1746543166844,ANBI 148,A01,886955,Wilder; Linnea Lorene,30,0,40,10
1746543168900,ANSC 122,A00,886957,Staff,25,0,30,5
1746543169926,ANSC 150,A00,886958,Sloane; Julia Kathryn,3,0,15,12
1746543170953,ANSC 156,A00,886959,Jenkins; Janis A.,0,1,15,15
1746543171980,ANSC 180,A00,886960,Staff,11,0,17,6
1746543173005,ANSC 188,A00,886961,Jassal; Aftab,9,0,25,16
1746543174035,ANSC 190,A00,886962,Jassal; Aftab,14,0,25,11
1746543175065,ANSC 191,A00,886963,Staff,18,0,20,2
1746543176092,ANTH 3,A01,891689,Staff,17,0,20,3
1746543177118,ANTH 5,A00,886933,Semendeferi; Ekaterini,16,0,20,4
1746543178147,ANTH 10,A00,886934,Staff,0,12,30,30
1746543179181,ANTH 21,A01,886936,Staff,40,0,60,20
1746543180209,ANTH 23,A01,886938,Staff,92,0,100,8
1746543181235,ANTH 105,A00,886964,Stewart; Alexander B,84,0,100,16
1746543182273,ANTH 108,A00,886965,Pedersen; David,9,0,20,11
1746543183307,AWP 10,001,886147,Staff,0,0,0,0
1746543183307,AWP 10,002,886148,Staff,0,0,0,0
1746543183307,AWP 10,003,886149,Staff,0,0,0,0
1746543183307,AWP 10,004,886150,Staff,0,0,0,0
1746543183307,AWP 10,005,886151,Staff,0,0,0,0
1746543183307,AWP 10,006,886152,Staff,0,0,0,0
1746543183307,AWP 10,007,886153,Staff,0,0,0,0
1746543183307,AWP 10,008,886154,Staff,0,0,0,0
1746543183307,AWP 10,009,886155,Staff,0,0,0,0
1746543183307,AWP 10,010,886156,Staff,0,0,0,0
1746543183307,AWP 10,011,886158,Staff,0,0,0,0
1746543183307,AWP 10,012,886160,Staff,0,0,0,0
1746543183307,AWP 10,013,886161,Staff,0,0,0,0
1746543183307,AWP 10,014,886162,Staff,0,0,0,0
1746543183307,AWP 10,015,886163,Staff,0,0,0,0
1746543183307,AWP 10,016,886164,Staff,0,0,0,0
1746543183307,AWP 10,017,886165,Staff,0,0,0,0
1746543183307,AWP 10,018,886166,Staff,0,0,0,0
1746543183307,AWP 10,019,886168,Staff,0,0,0,0
1746543183307,AWP 10,020,886170,Staff,0,0,0,0
1746543183307,AWP 10,021,886172,Staff,0,0,0,0
1746543184339,AWP 10R,001,886173,Staff,0,1,0,0
1746543184339,AWP 10R,002,886174,Staff,0,1,0,0
1746543184339,AWP 10R,003,886175,Staff,0,0,0,0
1746543184339,AWP 10R,004,886176,Staff,0,0,0,0
1746543184339,AWP 10R,005,886177,Staff,0,0,0,0
1746543184339,AWP 10R,006,886178,Staff,0,0,0,0
1746543184339,AWP 10R,007,886179,Staff,0,0,0,0
1746543184339,AWP 10R,008,886181,Staff,0,0,0,0
1746543184339,AWP 10R,009,886182,Staff,0,0,0,0
1746543184339,AWP 10R,010,886183,Staff,0,0,0,0
1746543184339,AWP 10R,011,886184,Staff,0,0,0,0
1746543184339,AWP 10R,012,886185,Staff,0,0,0,0
1746543184339,AWP 10R,013,886186,Staff,0,0,0,0
1746543184339,AWP 10R,014,886187,Staff,0,0,0,0
1746543184339,AWP 10R,015,886188,Staff,0,0,0,0
1746543184339,AWP 10R,016,886189,Staff,0,0,0,0
1746543185366,AWP 102R,A00,886190,Staff,0,0,0,0
1746543185366,AWP 102R,B00,886191,Staff,0,0,0,0
1746543186392,BENG 100,A01,886193,Staff,17,0,30,13
1746543187419,BENG 122A,A01,886195,Hasty; Jeff M,13,0,30,17
1746543188450,BENG 166A,A00,886196,Sah; Robert Lie-Yuan,0,1,30,30
1746543189477,BENG 190,A00,958050,Khojah; Reem I,24,0,25,1
1746543190507,BIBC 102,A01,894320,Staff,0,0,46,46
1746543190507,BIBC 102,A02,894321,Staff,0,0,46,46
1746543190507,BIBC 102,A03,894344,Staff,7,0,46,39
1746543190507,BIBC 102,A04,894345,Staff,26,0,47,21
1746543191535,BICD 100R,A01,894365,Smith; Laurie,0,3,58,58
1746543191535,BICD 100R,A02,894366,Smith; Laurie,0,5,58,58
1746543191535,BICD 100R,A03,894367,Smith; Laurie,2,0,59,57
1746543191535,BICD 100R,A04,959869,Smith; Laurie,41,0,59,18
1746543192566,BICD 136,A01,894383,Gustafson-Brown; Cindy,14,0,50,36
1746543193595,BIEB 102,A01,894494,Butler; Shannon Rhey,51,0,130,79
1746543195647,BIEB 150,A01,894617,Wills; Christopher,3,0,20,17
1746543195647,BIEB 150,A02,894631,Wills; Christopher,3,0,20,17
1746543195647,BIEB 150,A03,894937,Wills; Christopher,3,0,20,17
1746543195647,BIEB 150,A04,894946,Wills; Christopher,5,0,20,15
1746543196673,BIEB 194,A00,906141,Kurle; Carolyn M.,6,0,20,14
1746543197699,BILD 1,A01,894154,Staff,2,0,19,17
1746543197699,BILD 1,A02,894155,Staff,14,0,19,5
1746543197699,BILD 1,A03,894160,Staff,13,0,19,6
1746543197699,BILD 1,A04,894161,Staff,15,0,18,3
1746543198729,BILD 2,A01,894168,Staff,0,0,50,50
1746543198729,BILD 2,A02,894169,Staff,0,0,50,50
1746543198729,BILD 2,A03,894179,Staff,4,0,50,46
1746543198729,BILD 2,A04,894203,Staff,27,0,50,23
1746543199755,BILD 3,A01,894213,Staff,22,0,31,9
1746543199755,BILD 3,A02,894214,Staff,26,0,31,5
1746543199755,BILD 3,A03,894235,Staff,28,0,31,3
1746543199755,BILD 3,A04,894236,Staff,28,0,32,4
1746543200785,BILD 4,A01,894253,Reuther; Keefe,5,0,24,19
1746543200785,BILD 4,A02,894258,Reuther; Keefe,16,0,24,8
1746543201812,BILD 5,A01,894276,Reuther; Keefe,35,0,50,15
1746543201812,BILD 5,A02,894277,Reuther; Keefe,45,0,50,5
1746543201812,BILD 5,A03,894290,Reuther; Keefe,44,0,50,6
1746543201812,BILD 5,A04,894291,Reuther; Keefe,48,0,50,2
1746543202838,BILD 24,A01,894297,Pirino; Giorgia,40,0,60,20
1746543203868,BIMM 100,B01,958915,Staff,72,0,100,28
1746543204896,BIMM 101,A01,895017,McDonnell; Lisa Marie,0,5,24,24
1746543204896,BIMM 101,A02,895018,McDonnell; Lisa Marie,0,5,24,24
1746543204896,BIMM 101,B01,895020,McDonnell; Lisa Marie,0,6,24,24
1746543204896,BIMM 101,B02,895021,McDonnell; Lisa Marie,0,4,24,24
1746543205926,BIMM 110,A01,895023,Staff,1,0,25,24
1746543205926,BIMM 110,A02,895024,Staff,9,0,25,16
1746543205926,BIMM 110,A03,895025,Staff,18,0,25,7
1746543205926,BIMM 110,A04,895031,Staff,20,0,25,5
1746543206954,BIMM 120,A01,895114,Gustafson-Brown; Cindy,13,0,28,15
1746543206954,BIMM 120,A02,895126,Gustafson-Brown; Cindy,21,0,27,6
1746543207984,BIPN 100,A01,895130,Yang; Mingyu,1,0,38,37
1746543207984,BIPN 100,A02,895131,Yang; Mingyu,32,0,38,6
1746543207984,BIPN 100,A03,895132,Yang; Mingyu,32,0,38,6
1746543207984,BIPN 100,A04,895133,Yang; Mingyu,27,0,36,9
1746543209008,BIPN 120,A01,895135,Cooke; James Edward,0,3,13,13
1746543209008,BIPN 120,A02,895136,Cooke; James Edward,0,1,13,13
1746543209008,BIPN 120,A03,895137,Cooke; James Edward,0,3,13,13
1746543209008,BIPN 120,A04,895156,Cooke; James Edward,0,2,11,11
1746543210043,BIPN 134,A01,895235,Cooke; James Edward,0,2,25,25
1746543210043,BIPN 134,A02,895237,Cooke; James Edward,0,0,25,25
1746543210043,BIPN 134,A03,895240,Cooke; James Edward,3,0,25,22
1746543210043,BIPN 134,A04,895270,Cooke; James Edward,20,0,25,5
1746543211071,BIPN 189,A00,892103,Staff,0,13,14,14
1746543213123,BISP 194,A00,958008,Staff,0,2,0,0
1746543214150,CAT 124,A01,922009,Staff,0,5,20,20
1746543215182,CAT 125R,A00,886390,Morales; Celeste Georgianna,0,2,20,20
1746543215182,CAT 125R,B00,886391,Irwin; Matthew Joseph,0,3,20,20
1746543215182,CAT 125R,C00,886392,Smith; Lauryn Alissa,0,2,20,20
1746543215182,CAT 125R,D00,886393,Vanderschuit; Maya Alysia,0,2,20,20
1746543215182,CAT 125R,E00,886394,Marchisotto; Jennifer Anne,0,4,20,20
1746543216209,CENG 15,A01,886218,Drews; Aaron,3,0,8,5
1746543217237,CENG 113,A00,886219,Opatkiewicz; Justin Paul,15,0,25,10
1746543218262,CGS 101,A00,887044,Staff,7,0,20,13
1746543219286,CGS 105,A01,887046,Staff,14,0,25,11
1746543220311,CGS 112,A00,887047,Cuong; Marisol,12,0,15,3
1746543221336,CGS 113,A00,887048,Staff,23,0,30,7
1746543222365,CGS 120,A00,887049,Staff,10,0,17,7
1746543223394,CHEM 6A,A01,886336,Lam; Tin Yiu,38,0,50,12
1746543223394,CHEM 6A,A02,886338,Lam; Tin Yiu,37,0,50,13
1746543224421,CHEM 6B,A01,886341,Hopkins; Patrycja Anna,16,0,50,34
1746543224421,CHEM 6B,A02,886343,Hopkins; Patrycja Anna,42,0,50,8
1746543225450,CHEM 6C,A01,886346,Albizati; Kim F.,0,2,50,50
1746543225450,CHEM 6C,A02,886348,Albizati; Kim F.,23,0,50,27
1746543226478,CHEM 40A,A01,886352,Klosterman; Jeremy K,65,0,100,35
1746543227509,CHEM 40B,A01,886356,Klosterman; Jeremy K,0,23,100,100
1746543228535,CHEM 41B,A01,886360,Theodorakis; Emmanuel,25,0,50,25
1746543228535,CHEM 41B,A02,886362,Theodorakis; Emmanuel,47,0,50,3
1746543229563,CHIN 165A,A00,886382,Xu; Li,18,0,20,2
1746543230593,CLAS 120,A00,886387,Myerston Santana; Jacobo,33,0,40,7
1746543231623,COGS 9,A01,886967,Shannon; Kyle Michael,42,0,60,18
1746543232653,COGS 11,A01,886969,Staff,11,0,30,19
1746543233680,COGS 14A,A01,886971,Staff,6,0,60,54
1746543234705,COGS 14B,A01,886973,Hoffman; Drew Ellen,4,0,60,56
1746543235729,COGS 18,A01,886975,Morgan; Eric,35,0,60,25
1746543236755,COGS 20,A01,886977,Staff,4,0,8,4
1746543236755,COGS 20,A02,886978,Staff,5,0,7,2
1746543237781,COGS 100,A01,907783,Staff,0,2,30,30
1746543238809,COGS 101B,A01,886980,Staff,0,3,48,48
1746543239839,COGS 101C,A01,886982,Delgado; Tania,0,5,44,44
1746543240866,COGS 102A,A01,886984,Johnson; Christine M.,4,0,30,26
1746543241891,COGS 118B,A01,886986,Staff,0,3,88,88
1746543242921,COGS 150,A01,886988,Bergen; Benjamin,23,0,50,27
1746543243951,COGS 153,A00,886989,Delgado; Tania,0,2,41,41
1746543244981,COGS 186,A01,886991,Staff,0,0,32,32
1746543246006,COGS 187A,A01,886993,Boyle; Mary E. T.,7,0,30,23
1746543247031,COGS 189,A00,886994,Staff,0,1,30,30
1746543248057,COMM 10,A01,886996,Staff,0,0,20,21
1746543248057,COMM 10,A02,886997,Staff,12,0,20,8
1746543248057,COMM 10,A03,959845,Staff,19,0,20,1
1746543249090,COMM 20,A01,886999,Leuning; Grant Maurstad,24,0,40,16
1746543251144,COMM 100A,A01,887002,Staff,0,0,20,25
1746543251144,COMM 100A,A02,887003,Staff,7,0,20,13
1746543252174,COMM 100B,A01,887005,Staff,0,8,20,24
1746543253198,COMM 106D,A00,887006,Staff,14,0,40,26
1746543254223,COMM 110G,A00,887007,Whitworth-Smith; Andrew C,12,0,40,28
1746543255249,COMM 111B,A00,887008,Staff,31,0,40,9
1746543256280,COMM 113T,A00,887009,Abuelhiga; Soraya Jill,28,0,40,12
1746543256280,COMM 113T,B00,906733,Staff,40,0,40,0
1746543257306,COMM 145,A00,887010,Staff,12,0,40,28
1746543258331,COMM 146,A00,887054,Staff,31,0,40,9
1746543259358,COMM 190,A00,887012,Staff,8,0,23,15
1746543260383,CSE 8A,A50,887015,Cao; Yingjun,57,0,85,28
1746543261408,CSE 11,A01,887017,Cao; Yingjun,12,0,70,58
1746543262435,CSE 20,A01,887019,Staff,30,0,50,20
1746543263463,CSE 21,A01,887021,Staff,78,0,100,22
1746543263463,CSE 21,B01,892583,Braun; Oliver,45,0,50,5
1746543264489,CSE 30,A01,887025,Eldon; John,143,0,200,57
1746543265518,CSE 100,A01,887027,Staff,26,0,50,24
1746543265518,CSE 100,A02,887028,Staff,40,0,50,10
1746543266543,CSE 101,A01,887030,Braun; Oliver,75,0,100,25
1746543266543,CSE 101,B01,887032,Jones; Miles E,0,3,50,50
1746543266543,CSE 101,B02,887033,Jones; Miles E,0,1,50,50
1746543267568,CSE 105,A01,908084,Jones; Miles E,32,0,50,18
1746543267568,CSE 105,A02,908087,Jones; Miles E,33,0,50,17
1746543268593,CSE 135,A01,887035,Powell; Thomas Allan,0,4,50,50
1746543269620,CSE 142,A01,887037,Staff,8,0,60,52
1746543270647,CSE 142L,A01,887039,Staff,34,0,60,26
1746543271672,CSE 151A,A01,887041,Solares; Edwin A,48,0,100,52
1746543272702,CSE 175,A01,887043,Kumar; Rakesh,30,0,30,0
1746543273729,CSS 1,A01,886389,Staff,0,1,40,40
1746543274757,DSC 30,A01,908097,Liao; Soohyun Nam,47,0,75,28
1746543275784,DSC 40A,A01,908099,Shannon; Kyle Michael,30,0,50,20
1746543276810,DSC 40B,A01,908112,Staff,16,0,50,34
1746543277836,DSC 80,A01,908116,Staff,19,0,60,41
1746543278861,DSC 197,001,956863,Eldridge; Justin Matthew,9999,0,9999,0
1746543279888,ECE 5,A01,886400,Morris; Karcher William,2,0,6,4
1746543279888,ECE 5,A02,886401,Morris; Karcher William,3,0,6,3
1746543280914,ECE 148,A01,886403,Silberman; Jack,0,14,14,14
1746543281943,ECON 1,A01,887265,Crane; Meredith Helen,12,0,70,58
1746543281943,ECON 1,B01,887268,Staff,43,0,50,7
1746543282968,ECON 2,A01,887273,Crane; Meredith Helen,56,0,70,14
1746543283998,ECON 3,A01,887279,Rondina; Giacomo,32,0,70,38
1746543285029,ECON 4,A01,887282,Anderson; John Charles,0,2,10,10
1746543286054,ECON 5,A01,887285,Staff,33,0,45,12
1746543286054,ECON 5,B01,887292,Staff,41,0,45,4
1746543287085,ECON 100A,A01,887337,Newhouse; Herbert S,54,0,70,16
1746543287085,ECON 100A,B01,887349,Staff,45,0,50,5
1746543288116,ECON 100B,A01,887361,Du; Songzi,29,0,70,41
1746543289145,ECON 100C,A01,887445,Newhouse; Herbert S,59,0,70,11
1746543290174,ECON 105,A00,887488,Vespa; Emanuel Ignacio,23,0,35,12
1746543291199,ECON 109,A01,887506,Shishkin; Denis,28,0,35,7
1746543292226,ECON 110A,A01,887568,Alon; Titan Michael,0,3,35,35
1746543292226,ECON 110A,B01,907601,Alon; Titan Michael,20,0,35,15
1746543293251,ECON 110B,A01,887598,Levkoff; Steven B.,0,23,70,70
1746543294278,ECON 112,A00,887599,Rondina; Giacomo,19,0,35,16
1746543295302,ECON 120A,A01,887603,Dai; Yinlin,36,0,70,34
1746543296329,ECON 120C,A01,887608,Sun; Yixiao,0,1,35,35
1746543296329,ECON 120C,B01,887614,Sun; Yixiao,0,0,35,35
1746543297358,ECON 138,A00,887621,Bharadwaj; Prashant,0,20,20,20
1746543298383,ECON 144,A00,958007,Squires; Dale E,13,0,35,22
1746543299411,ECON 171,A01,907666,Staff,18,0,35,17
1746543300441,ECON 175,A00,887626,Wu; Pak Yeung,23,0,35,12
1746543301470,ECON 190,A00,887640,Vespa; Emanuel Ignacio,23,0,35,12
1746543302507,EDS 25,A01,888197,Staff,0,0,0,0
1746543302507,EDS 25,A02,888209,Staff,0,0,0,0
1746543302507,EDS 25,A03,888210,Staff,0,0,0,0
1746543302507,EDS 25,A04,888212,Staff,0,0,0,0
1746543302507,EDS 25,A05,888213,Staff,0,0,0,0
1746543302507,EDS 25,A06,888214,Staff,0,0,0,0
1746543302507,EDS 25,A07,888235,Staff,0,2,0,0
1746543302507,EDS 25,A08,888236,Staff,0,0,0,0
1746543302507,EDS 25,A09,888240,Staff,0,0,0,0
1746543302507,EDS 25,A10,888244,Staff,0,0,0,0
1746543302507,EDS 25,B01,888273,Staff,0,0,0,0
1746543302507,EDS 25,B02,888285,Staff,0,0,0,0
1746543302507,EDS 25,B03,888423,Staff,0,0,0,1
1746543302507,EDS 25,B04,888432,Staff,0,0,0,0
1746543302507,EDS 25,B05,888433,Staff,0,0,0,0
1746543302507,EDS 25,B06,888467,Staff,0,0,0,0
1746543302507,EDS 25,B07,888468,Staff,0,0,0,0
1746543302507,EDS 25,B08,888479,Staff,0,0,0,0
1746543302507,EDS 25,B09,888484,Staff,0,0,0,0
1746543302507,EDS 25,B10,888487,Staff,0,0,0,0
1746543303537,EDS 38,A01,907700,Choi; Bailey Miyeon,30,0,30,0
1746543304561,EDS 112,A01,888601,Chapman; Thandeka K,14,0,40,26
1746543305589,EDS 115,A00,888697,Mendez; Kathrina Mendoza,10,0,30,20
1746543306616,EDS 116,A01,888893,Staff,35,0,40,5
1746543308670,EDS 124AR,A00,889133,Staff,29,0,50,21
1746543308670,EDS 124AR,B00,907471,Simon; Elizabeth A,37,0,50,13
1746543309697,EDS 124BR,A00,889134,Simon; Elizabeth A,45,0,100,55
1746543310725,EDS 125,A00,889135,Staff,25,0,30,5
1746543311753,EDS 126,A01,889138,Staff,36,0,40,4
1746543312777,EDS 164R,A01,889142,Wishard Guerra; Alison G.,33,0,50,17
1746543313833,ENG 30,A01,886396,Staff,0,0,0,0
1746543313833,ENG 30,B01,886398,Staff,0,0,0,0
1746543314861,ENVR 102,A00,906150,Montejo; Carolina,23,0,25,2
1746543315942,ETHN 103A,A00,887236,Man; Simeon S,0,3,0,0
1746543316967,ETHN 113,A00,887239,Staff,16,0,30,14
1746543318002,ETHN 116,A00,887240,Staff,16,0,25,9
1746543319031,ETHN 117,A00,887241,Choi; Esther Min,28,0,30,2
1746543320057,ETHN 118,A00,887243,Staff,24,0,30,6
1746543321086,ETHN 127,A00,887248,Cuong; Marisol,11,0,15,4
1746543322113,ETHN 139,A00,887250,Staff,7,0,10,3
1746543323142,ETHN 142,A00,887252,Staff,10,0,30,20
1746543324167,ETHN 161,A00,887253,Browne; Errol Tsekani,24,0,30,6
1746543325193,ETHN 163FR,A00,887255,Burelle; Julie Sara Veronique,0,0,5,5
1746543326220,GLBH 20,A00,889149,Elwardani; Nile Regina,8,0,42,34
1746543328275,GLBH 111,A01,889152,Burgos; Jose L.,17,0,17,0
1746543329301,GLBH 150,A00,889181,Sloane; Julia Kathryn,0,5,15,15
1746543331358,HDS 60,A01,886406,Warstadt; Melissa Fawn,73,0,80,7
1746543332397,HIAF 111,A00,889324,Gyamfi; Bright,25,0,32,7
1746543333422,HIEA 131,A00,889328,Staff,16,0,32,16
1746543334448,HIEA 144,A00,889333,Henry; Todd A.,26,0,32,6
1746543335473,HIEA 154,A00,889336,Henry; Todd A.,24,0,32,8
1746543336500,HIEU 106,A00,889339,Staff,22,0,32,10
1746543338554,HIEU 114,A00,889340,Staff,3,0,32,29
1746543339580,HIEU 135GS,A00,889342,Patterson; Patrick H.,0,0,1,24
1746543340609,HIEU 137,A00,889343,Edington; Claire Ellen,9,0,25,16
1746543341637,HIEU 148,A00,889345,Staff,14,0,32,18
1746543342665,HIEU 154,A00,889346,Biess; Frank Peter,21,0,32,11
1746543343689,HILA 102,A00,889351,Staff,12,0,32,20
1746543344719,HILD 2A,A01,889221,Lewandoski; Julia Mavis,1,10,32,31
1746543345747,HILD 7B,A01,889225,Man; Simeon S,0,13,32,32
1746543346773,HILD 7C,A01,889288,Alvarez; Luis A,0,14,32,32
1746543347797,HILD 30,A01,889323,Staff,0,5,32,32
1746543349848,HISC 119,A00,889383,Golan; Tal,21,0,32,11
1746543350874,HIUS 103,A00,889384,Man; Simeon S,0,0,32,32
1746543351904,HIUS 117,A00,919797,Kwak; Nancy,18,0,32,14
1746543352930,HIUS 142A,A00,919788,Staff,22,0,32,10
1746543354985,HIUS 149,A00,889386,Gyamfi; Bright,27,0,32,5
1746543356010,HIUS 155,A00,889387,Alvarez; Luis A,14,0,32,18
1746543357036,HUM 3,A01,886499,Caldwell; Michael Alan,19,0,50,31
1746543358061,HUM 3GS,A00,886500,Rodriguez; Bretton Sigfred,0,0,0,28
1746543359088,HUM 3R,A01,886502,Markman; Kristina,0,36,50,50
1746543360116,HUM 4,A01,886504,Crum; Matthew Stephen,24,0,50,26
1746543360116,HUM 4,B01,886506,West; Geoffrey Scott,17,0,50,33
1746543361145,HUM 4GS,A00,886507,Staff,0,0,0,19
1746543362173,HUM 5,A01,886509,Staff,32,0,50,18
1746543363198,HUM 5R,A01,886511,Zavodny; Tatiana Sophia,0,39,50,50
1746543364227,JAPN 180,A00,886407,Staff,18,0,40,22
1746543365252,LATI 50,A01,886409,Martin-Cabrera; Luis,4,0,22,18
1746543365252,LATI 50,A02,886410,Martin-Cabrera; Luis,19,0,22,3
1746543365252,LATI 50,A03,886411,Martin-Cabrera; Luis,21,0,22,1
1746543365252,LATI 50,A04,886412,Martin-Cabrera; Luis,9,0,22,13
1746543366280,LAWS 101,A00,907664,Staff,28,0,60,32
1746543367305,LIAB 1A,A00,889388,Saab; Dima,17,0,20,3
1746543368333,LIAB 1AX,A00,889389,El Cheddadi; Youniss,17,0,20,3
1746543369364,LIFR 1C,A00,889391,Van Moer; Vinciane G,8,0,20,12
1746543370390,LIFR 1CX,A00,889392,Van Moer; Vinciane G,7,0,20,13
1746543371417,LIFR 1D,A00,889393,Van Moer; Vinciane G,7,0,20,13
1746543372442,LIFR 1DX,A00,889394,Van Moer; Vinciane G,8,0,20,12
1746543373473,LIGN 7,A00,886923,Staff,24,0,50,26
1746543374528,LIGN 17,A00,886924,Kehler; Andrew Scott,125,0,150,25
1746543375555,LTAM 110,A00,889395,Staff,15,0,30,15
1746543376587,LTAM 110GS,A00,958010,Rodriguez; Bretton Sigfred,0,0,0,28
1746543377616,LTCH 101,A00,889397,Staff,23,0,25,2
1746543378642,LTCS 130,A00,889398,Staff,23,0,25,2
1746543379670,LTEA 138,A00,889399,Staff,24,0,40,16
1746543380703,LTEN 149,A00,889400,Wesling; Megan E.,0,3,25,25
1746543381729,LTEN 169,A00,889401,Staff,20,0,25,5
1746543382756,LTEN 180,A00,889402,Staff,10,0,15,5
1746543383781,LTEN 181,A00,889403,Staff,21,0,25,4
1746543384812,LTWL 100,A00,889404,Myerston Santana; Jacobo,3,0,25,22
1746543385839,LTWL 180GS,A00,889405,Staff,0,0,20,20
1746543386870,LTWL 181,A00,889406,Staff,17,0,25,8
1746543387895,LTWL 184,A00,889475,Mukherjee; Silpa,22,0,25,3
1746543388924,LTWR 102C,A00,889486,Staff,29,0,30,1
1746543389948,LTWR 115W,A00,889491,Staff,0,2,15,15
1746543390976,MAE 8,A01,886905,Staff,0,2,0,0
1746543392006,MAE 11,A00,886906,Bandaru; Prabhakar,0,7,50,50
1746543393037,MAE 20,A00,886907,Evdokimenko; Ekaterina,44,0,70,26
1746543394069,MAE 30B,A00,886909,Ghazinejad; Maziar,26,0,45,19
1746543395099,MAE 101B,A00,886910,Saintillan; David,29,0,45,16
1746543396125,MAE 105,A00,886911,Bandaru; Prabhakar,18,0,50,32
1746543397152,MAE 107,B00,958024,Staff,9,0,50,41
1746543398182,MAE 143B,A00,886913,Bewley; Thomas R,7,0,40,33
1746543399210,MAE 148,A01,886915,Silberman; Jack,0,3,14,14
1746543400237,MAE 160,A00,886916,Evdokimenko; Ekaterina,31,0,60,29
1746543401263,MATH 3C,A01,889681,Staff,0,3,30,30
1746543401263,MATH 3C,A02,960048,Staff,25,0,30,5
1746543402287,MATH 10A,A01,889760,Staff,26,0,30,4
1746543402287,MATH 10A,A02,889783,Staff,29,0,30,1
1746543403314,MATH 10B,A01,889785,Verstraete; Jacques Allan,2,0,35,33
1746543403314,MATH 10B,A02,889795,Verstraete; Jacques Allan,4,0,35,31
1746543403314,MATH 10B,B01,889797,Verstraete; Jacques Allan,3,0,35,32
1746543403314,MATH 10B,B02,889828,Verstraete; Jacques Allan,3,0,35,32
1746543404342,MATH 10C,A01,889849,Habib; Yousaf,9,0,30,21
1746543404342,MATH 10C,A02,889852,Habib; Yousaf,14,0,30,16
1746543404342,MATH 10C,A03,889853,Habib; Yousaf,22,0,30,8
1746543404342,MATH 10C,A04,889858,Habib; Yousaf,20,0,30,10
1746543404342,MATH 10C,B01,889861,Staff,1,0,30,29
1746543404342,MATH 10C,B02,889862,Staff,24,0,30,6
1746543404342,MATH 10C,B03,889863,Staff,27,0,30,3
1746543404342,MATH 10C,B04,889967,Staff,23,0,30,7
1746543405369,MATH 18,A01,889974,Staff,7,0,30,23
1746543405369,MATH 18,A02,889977,Staff,20,0,30,10
1746543405369,MATH 18,B01,889984,Hardiman; Liam,22,0,30,8
1746543405369,MATH 18,B02,889985,Hardiman; Liam,25,0,30,5
1746543406396,MATH 20A,A01,889990,Suk; Andrew Hoon,29,0,35,6
1746543407423,MATH 20B,A01,889993,Ohm; Ko Woon,22,0,30,8
1746543407423,MATH 20B,A02,889994,Ohm; Ko Woon,30,0,30,0
1746543407423,MATH 20B,B01,889996,Ohm; Ko Woon,21,0,30,9
1746543407423,MATH 20B,B02,889997,Ohm; Ko Woon,23,0,30,7
1746543408452,MATH 20C,A01,889999,Hammock; Frances H,17,0,30,13
1746543408452,MATH 20C,A02,890003,Hammock; Frances H,23,0,30,7
1746543408452,MATH 20C,B01,890006,Hammock; Frances H,3,0,30,27
1746543408452,MATH 20C,B02,890007,Hammock; Frances H,11,0,30,19
1746543409484,MATH 20D,A01,890011,Cheng; Hsiao-Bing,1,1,30,29
1746543409484,MATH 20D,A02,890012,Cheng; Hsiao-Bing,14,0,30,16
1746543409484,MATH 20D,B01,890016,Cheng; Hsiao-Bing,13,0,30,17
1746543409484,MATH 20D,B02,890017,Cheng; Hsiao-Bing,13,0,30,17
1746543410517,MATH 20E,A01,890026,Harel; Guershon,1,0,30,29
1746543410517,MATH 20E,A02,890029,Harel; Guershon,23,0,30,7
1746543410517,MATH 20E,B01,890033,Harel; Guershon,7,0,30,23
1746543410517,MATH 20E,B02,890101,Harel; Guershon,21,0,30,9
1746543411542,MATH 102,A01,890104,Staff,17,0,30,13
1746543411542,MATH 102,A02,890105,Staff,27,0,30,3
1746543412569,MATH 103B,A01,890116,Salehi Golsefidy; Alireza,3,0,30,27
1746543412569,MATH 103B,B01,890118,Staff,0,3,34,34
1746543413602,MATH 109,A01,890121,Aliabadi Sr.; Mohsen,1,0,30,29
1746543413602,MATH 109,B01,890124,Upadrashta; Pranav Kumar,18,0,30,12
1746543414634,MATH 120A,A01,890126,Eggers; John Dietrich,13,0,30,17
1746543415661,MATH 142B,A01,890128,Ioana; Adrian,19,0,30,11
1746543415661,MATH 142B,A02,890129,Ioana; Adrian,13,0,30,17
1746543416686,MATH 154,A01,890174,Staff,0,0,30,30
1746543416686,MATH 154,A02,890182,Staff,0,0,30,30
1746543417717,MATH 168A,A01,890197,Dumitriu; Ioana,21,0,35,14
1746543418743,MATH 170A,A01,890240,Nie; Jiawang,1,0,30,29
1746543418743,MATH 170A,A02,890241,Nie; Jiawang,11,0,30,19
1746543418743,MATH 170A,A03,890249,Nie; Jiawang,23,0,30,7
1746543419773,MATH 170B,A01,957891,Nag; Panchali,13,0,35,22
1746543421830,MATH 181A,A01,908025,Staff,0,4,35,35
1746543421830,MATH 181A,A02,960115,Staff,27,0,35,8
1746543422856,MATH 181B,A01,959874,Staff,26,0,30,4
1746543423886,MATH 193B,A01,890265,Staff,0,4,35,35
1746543424919,MGT 4,A01,890311,Anderson; John Charles,42,0,88,46
1746543425944,MGT 5,A00,907740,Staff,13,0,98,85
1746543426972,MGT 12,A00,890312,Lindenberger; Wade Douglas,67,0,98,31
1746543427996,MGT 16,A00,957883,Staff,78,0,98,20
1746543430056,MGT 45,A00,890314,Pecore; Joseph P.,47,0,98,51
1746543431082,MGT 71,A00,890315,Staff,0,11,98,98
1746543432108,MGT 100,A00,890316,Yavorsky; Daniel Ryan,44,0,98,54
1746543433134,MGT 103,A00,890317,Ehrich; Kristine R,73,0,98,25
1746543434159,MGT 105,A00,890356,Bates; Kenneth Walter,0,7,98,98
1746543435188,MGT 112,A00,890360,Ehrich; Kristine R,55,0,98,43
1746543436216,MGT 127R,A00,907732,Zhu; Kevin Xiaoguo,23,0,98,75
1746543437245,MGT 131B,A00,890361,Anderson; John Charles,61,0,98,37
1746543438274,MGT 137,A00,890362,Lindenberger; Wade Douglas,65,0,98,33
1746543439299,MGT 160,A00,890369,Johnson; Erik Barry,9,0,98,89
1746543441352,MGT 164,A00,890372,Zimmermann; Carsten,0,39,98,98
1746543442378,MGT 180,A00,890374,Bliss; Barbara Ann,12,0,98,86
1746543443404,MMW 15,A01,886414,Chang; Edmond Yi-Teh,0,12,28,28
1746543443404,MMW 15,A02,886415,Chang; Edmond Yi-Teh,0,8,28,28
1746543443404,MMW 15,A03,886416,Chang; Edmond Yi-Teh,0,8,28,28
1746543443404,MMW 15,A04,886417,Chang; Edmond Yi-Teh,0,8,28,28
1746543443404,MMW 15,B01,886419,Chang; Edmond Yi-Teh,0,7,28,28
1746543443404,MMW 15,B02,886420,Chang; Edmond Yi-Teh,0,8,28,28
1746543443404,MMW 15,B03,886421,Chang; Edmond Yi-Teh,0,7,28,28
1746543443404,MMW 15,B04,886422,Chang; Edmond Yi-Teh,0,8,28,28
1746543443404,MMW 15,C01,886424,Staff,0,9,28,28
1746543443404,MMW 15,C02,886425,Staff,0,8,28,28
1746543443404,MMW 15,C03,886426,Staff,0,8,28,28
1746543443404,MMW 15,C04,886427,Staff,0,7,28,28
1746543443404,MMW 15,C05,958038,Staff,0,7,28,28
1746543443404,MMW 15,C06,958039,Staff,0,8,28,28
1746543444433,MMW 15GS,A00,906910,Patterson; Patrick H.,4,0,28,24
1746543445463,MMW 122R,A01,886429,Rahimi; Babak,0,13,28,28
1746543445463,MMW 122R,A02,886430,Rahimi; Babak,0,12,28,28
1746543445463,MMW 122R,A03,958040,Rahimi; Babak,0,11,28,28
1746543446497,MUS 1A,A01,890937,Staff,3,0,25,22
1746543446497,MUS 1A,A02,891035,Staff,6,0,25,19
1746543446497,MUS 1A,C01,958912,Staff,24,0,25,1
1746543446497,MUS 1A,C02,958913,Staff,25,0,25,0
1746543448545,MUS 2AK,A00,957092,Ohnishi; Takae,15,0,15,0
1746543449574,MUS 4,A01,891044,Staff,2,0,25,23
1746543449574,MUS 4,A02,891045,Staff,23,0,25,2
1746543449574,MUS 4,B01,891048,Staff,17,0,25,8
1746543449574,MUS 4,B02,891050,Staff,25,0,25,0
1746543450603,MUS 5,A01,957506,Dubnov; Shlomo,0,0,25,25
1746543450603,MUS 5,A02,957622,Dubnov; Shlomo,14,0,25,11
1746543450603,MUS 5,A03,957623,Dubnov; Shlomo,20,0,25,5
1746543451629,MUS 6,A01,891053,Freitas Caetano; Marcelo,24,0,25,1
1746543451629,MUS 6,A02,891054,Freitas Caetano; Marcelo,23,0,25,2
1746543452655,MUS 7,A01,891081,Staff,0,0,25,25
1746543452655,MUS 7,A02,891082,Staff,4,0,25,21
1746543453681,MUS 8GS,A00,891118,Borgo; David Garcia,0,0,25,25
1746543454706,MUS 11,A01,891140,Staff,11,0,25,14
1746543454706,MUS 11,A02,891141,Staff,22,0,25,3
1746543455733,MUS 13,A01,891143,Staff,8,0,25,17
1746543455733,MUS 13,A02,891144,Staff,24,0,25,1
1746543456760,MUS 15,A01,891146,Staff,9,0,25,16
1746543456760,MUS 15,A02,891148,Staff,21,0,25,4
1746543456760,MUS 15,B01,891150,Staff,18,0,25,7
1746543456760,MUS 15,B02,891151,Staff,25,0,25,0
1746543457786,MUS 20,A01,891153,Staff,5,0,20,15
1746543457786,MUS 20,A02,891155,Staff,14,0,20,6
1746543458814,MUS 80,A00,891156,Staff,19,0,25,6
1746543458814,MUS 80,B00,891157,Staff,23,0,25,2
1746543459839,MUS 130,A00,891158,Ohnishi; Takae,35,0,35,0
1746543460867,MUS 150GS,A01,891160,Borgo; David Garcia,0,0,25,25
1746543461898,MUS 170,A01,891162,Freitas Caetano; Marcelo,20,0,25,5
1746543461898,MUS 170,A02,891164,Freitas Caetano; Marcelo,21,0,25,4
1746543462931,NANO 11,A00,886220,Vazquez Mena; Oscar,13,0,15,2
1746543463957,NANO 15,A01,886222,Drews; Aaron,4,0,7,3
1746543464983,NANO 104,A00,886224,Sirbuly; Donald,18,0,25,7
1746543466009,PH 40,A00,886528,Staff,23,0,40,17
1746543467036,PH 45,A01,886799,Staff,35,0,40,5
1746543468061,PH 110,A00,886802,Staff,0,7,40,40
1746543469086,PH 172,A00,906716,Staff,19,0,35,16
1746543470115,PH 191,A00,886803,Staff,6,0,40,34
1746543471145,PHIL 1,A00,889500,Staff,19,0,30,11
1746543472175,PHIL 10,A01,889549,Grush; Rick Scott,15,0,22,7
1746543472175,PHIL 10,A02,889551,Grush; Rick Scott,22,0,22,0
1746543473202,PHIL 28,A01,889559,Lamey; Andy M.,0,1,31,31
1746543473202,PHIL 28,A02,889561,Lamey; Andy M.,0,1,30,30
1746543473202,PHIL 28,A03,889572,Lamey; Andy M.,0,0,30,30
1746543474229,PHIL 35,A00,907839,Staff,13,0,15,2
1746543475255,PHIL 60,A00,889574,Staff,74,0,90,16
1746543476279,PHIL 101,A00,958004,Staff,13,0,15,2
1746543478331,PHIL 136,A00,889582,Fulkerson; Matthew Todd,26,0,45,19
1746543479359,PHIL 163,A01,889601,Staff,21,0,30,9
1746543479359,PHIL 163,B01,889606,Brandt; Reuven A,0,3,0,0
1746543480388,PHIL 164,A00,889610,Staff,16,0,30,14
1746543481413,PHIL 165,A00,889613,Staff,23,0,30,7
1746543482440,PHYS 1A,A00,886431,Staff,26,0,70,44
1746543483469,PHYS 1AL,001,886432,Tsai; Philbert S,0,2,30,30
1746543483469,PHYS 1AL,002,886436,Tsai; Philbert S,11,0,30,19
1746543484494,PHYS 1B,A00,886439,Staff,185,0,240,55
1746543485520,PHYS 1BL,001,886441,Tsai; Philbert S,0,4,30,30
1746543485520,PHYS 1BL,002,886444,Tsai; Philbert S,2,0,30,28
1746543486546,PHYS 1C,A00,896092,Arnold; Kam S,78,0,146,68
1746543487574,PHYS 1CL,001,886448,Tsai; Philbert S,0,0,30,30
1746543487574,PHYS 1CL,002,886449,Tsai; Philbert S,0,0,30,30
1746543487574,PHYS 1CL,003,886450,Tsai; Philbert S,16,0,30,14
1746543487574,PHYS 1CL,004,886451,Tsai; Philbert S,15,0,30,15
1746543488605,PHYS 2B,A01,886457,Staff,69,0,115,46
1746543489632,PHYS 2C,A01,886460,Shotwell; Brian,0,8,65,65
1746543490658,PHYS 2CL,A01,886467,Staff,0,4,28,28
1746543490658,PHYS 2CL,A02,886468,Staff,0,3,28,28
1746543491689,PHYS 2D,A01,886470,Staff,10,0,50,40
1746543492717,PHYS 4B,A01,886475,Grinstein; Benjamin,22,0,40,18
1746543493746,POLI 5,A00,891173,Desposato; Scott,7,0,25,18
1746543494771,POLI 5D,A01,891175,Staff,5,0,5,0
1746543494771,POLI 5D,B01,891178,Staff,5,0,5,0
1746543495798,POLI 11,A00,891179,Ferree; Karen E,2,0,35,33
1746543496824,POLI 12,A00,891180,Staff,16,0,30,14
1746543497851,POLI 27,A01,891182,Staff,12,0,75,63
1746543498877,POLI 30,A00,891183,Staff,9,0,50,41
1746543499905,POLI 100B,A00,891244,Staff,5,1,35,30
1746543500934,POLI 100I,A00,891247,Staff,7,0,30,23
1746543501960,POLI 104J,A00,891248,Nichter; Maysa,14,0,30,16
1746543502989,POLI 104U,A00,891250,Nichter; Maysa,2,0,30,28
1746543505043,POLI 110B,A00,891255,Wiens; David,20,0,25,5
1746543506072,POLI 112A,A00,891256,Wiens; David,6,0,25,19
1746543507101,POLI 114BR,A00,891261,Staff,19,0,30,11
1746543508126,POLI 117R,A00,891262,Forman; Fonna,0,6,50,50
1746543509151,POLI 118,A00,891264,Ingham; Sean,17,0,25,8
1746543510195,POLI 124A,A00,891265,Staff,18,0,20,2
1746543511223,POLI 125D,A00,891266,Nichter; Simeon C,2,0,25,23
1746543512251,POLI 126,A00,891268,Nichter; Simeon C,7,0,25,18
1746543513278,POLI 126AA,A00,891272,Staff,18,0,25,7
1746543514306,POLI 130AA,A00,891273,Staff,15,0,20,5
1746543515332,POLI 134AA,A00,891274,Staff,4,0,20,16
1746543517381,POLI 138,A00,891278,Staff,21,0,25,4
1746543518406,POLI 142K,A00,891280,Staff,11,0,25,14
1746543519434,POLI 142M,A00,891281,Gartzke; Erik,17,0,30,13
1746543520459,POLI 142P,A00,891284,Staff,20,0,30,10
1746543521488,POLI 143,A00,891285,Gartzke; Erik,12,0,30,18
1746543522514,POLI 153,A00,891286,Staff,19,0,20,1
1746543524564,POLI 175,A00,891290,Staff,15,0,20,5
1746543525590,PSYC 1,A00,890674,Steiner; Eric Tomas,0,11,45,45
1746543526620,PSYC 2,A00,890676,Albright; Thomas D,21,0,35,14
1746543527648,PSYC 3,A00,890679,Staff,17,0,20,3
1746543528677,PSYC 6,A00,959858,Staff,20,0,20,0
1746543529702,PSYC 60,A01,890684,Rickard; Timothy C.,0,5,45,45
1746543530727,PSYC 70,A01,890689,Geller; Emma Harlan,7,0,30,23
1746543531752,PSYC 71,A01,959860,Staff,21,0,25,4
1746543532776,PSYC 100,A00,890690,Lacefield; Katharine I,0,50,180,180
1746543533802,PSYC 102,A00,890695,Staff,18,0,40,22
1746543534828,PSYC 105,A00,890699,Geller; Emma Harlan,71,0,100,29
1746543535858,PSYC 106,A00,890701,Gorman; Michael R.,5,0,30,25
1746543536883,PSYC 108,A00,890704,Adrian; Julia Anna,0,28,50,50
1746543537908,PSYC 118,A01,890712,Staff,11,0,30,19
1746543538933,PSYC 124,A00,890716,Chapman; Eddie Nathaniel,25,0,60,35
1746543539963,PSYC 131,A00,890717,Anagnostaras; Stephan,0,7,80,80
1746543540988,PSYC 137,A00,890719,Winkielman; Piotr,0,11,30,30
1746543542016,PSYC 144,A00,890721,Adrian; Julia Anna,0,9,45,45
1746543543043,PSYC 162,A00,890805,Staff,2,0,75,73
1746543544070,PSYC 169,A00,890810,Staff,0,15,30,30
1746543545101,PSYC 172,A00,890814,Gorman; Michael R.,9,0,30,21
1746543546128,PSYC 181,A00,890818,Anagnostaras; Stephan,8,0,200,192
1746543547152,PSYC 184,A00,959861,Staff,170,0,175,5
1746543548176,PSYC 189,A00,890823,Staff,0,1,30,30
1746543549205,PSYC 191,A00,890884,Rickard; Timothy C.,0,11,35,35
1746543550231,PSYC 193,A00,890913,Staff,19,0,30,11
1746543550231,PSYC 193,B00,890914,Chapman; Eddie Nathaniel,24,0,30,6
1746543551258,PSYC 193L,A01,890918,Lowe; Angela Beth,20,0,30,10
1746543551258,PSYC 193L,B01,890921,Hurwitz; Ethan Scott,20,0,30,10
1746543551258,PSYC 193L,C01,890928,Staff,30,0,30,0
1746543552282,RELI 149,A00,886806,Rahimi; Babak,23,0,40,17
1746543553308,SE 9,A01,886814,Staff,7,0,20,13
1746543554332,SE 101B,A01,886816,Chadha; Mayank,4,0,35,31
1746543555358,SE 110B,A00,886818,Zhu; Qiang,4,0,75,71
1746543556383,SE 125,A01,886830,Staff,10,0,30,20
1746543557410,SE 130B,A01,886835,Staff,14,0,40,26
1746543558473,SE 131A,A01,886838,Krysl; Petr,34,0,55,21
1746543559497,SE 154,A00,886840,Staff,30,0,50,20
1746543560522,SE 164GS,A01,886849,Staff,6,0,20,14
1746543561549,SE 167GS,A01,886853,Staff,6,0,20,14
1746543562577,SIO 25,A01,890107,Staff,19,0,30,11
1746543563603,SIO 45,A00,890109,Cook; Geoffrey W,117,0,200,83
1746543564627,SIO 109R,A00,890110,Forman; Fonna,0,16,20,20
1746543565655,SIO 187,A01,890114,Kacev; David,15,0,40,25
1746543566681,SOCI 1,A01,890431,Thorpe; Charles Robert,15,0,30,15
1746543566681,SOCI 1,A02,890518,Thorpe; Charles Robert,30,0,30,0
1746543567709,SOCI 2,A01,957978,Staff,25,0,25,0
1746543567709,SOCI 2,A02,957979,Staff,23,0,25,2
1746543568738,SOCI 20,A01,890523,Calderon-Zaks; Michael Aar,23,0,30,7
1746543568738,SOCI 20,A02,890526,Calderon-Zaks; Michael Aar,29,0,30,1
1746543569771,SOCI 30,A01,890533,Pardo Guerra; Juan Pablo,37,0,40,3
1746543570800,SOCI 40,A01,890535,Staff,27,0,45,18
1746543571828,SOCI 104Q,A00,890559,Staff,18,0,30,12
1746543572855,SOCI 106,A00,890560,Arnal; Maud Marie Leonie,20,0,30,10
1746543573882,SOCI 110,A00,890567,Holkenbrink-Monk; Charlene,19,0,30,11
1746543574909,SOCI 112,A00,890568,Victoria Torres; Pablo,1,0,55,54
1746543575939,SOCI 115,A00,890597,Arnal; Maud Marie Leonie,28,0,45,17
1746543577995,SOCI 121,A00,890604,Pardo Guerra; Juan Pablo,38,0,45,7
1746543579021,SOCI 126,A01,890608,Staff,8,0,10,2
1746543580048,SOCI 127,A00,890609,Staff,18,0,30,12
1746543581073,SOCI 131,A00,890610,Thorpe; Charles Robert,37,0,45,8
1746543582099,SOCI 135,A00,890615,Payne; Christine Anna,14,0,45,31
1746543583125,SOCI 139,A00,890620,Staff,38,0,45,7
1746543584150,SOCI 148E,A00,890622,Calderon-Zaks; Michael Aar,36,0,45,9
1746543585176,SOCI 150,A00,890623,Kohler; Kristopher M.,31,0,45,14
1746543586202,SOCI 157,A00,890625,Jules-Rosette; Bennetta W.,18,0,20,2
1746543587227,SOCI 160,A00,890627,Payne; Christine Anna,21,0,45,24
1746543588253,SYN 1,A00,886855,Fish; Gwendolyn Anne,0,0,0,0
1746543588253,SYN 1,B00,906086,Fish; Gwendolyn Anne,0,1,0,2
1746543589280,SYN 2R,A00,886860,Staff,0,17,15,15
1746543589280,SYN 2R,B00,906106,Atkinson; Arthur Laird,0,16,15,15
1746543590322,SYN 100,A01,886866,Browne; Emily,0,28,20,20
1746543590322,SYN 100,B01,906128,Rock; Martin,0,5,20,20
1746543590322,SYN 100,C01,906140,Deavenport; James Cary,0,3,20,20
1746543590322,SYN 100,D01,907816,Deavenport; James Cary,0,5,20,20
1746543591354,TDAC 1,A00,890286,Walsh; Kim C.,9,0,20,11
1746543592383,TDAC 101,A00,890296,Basso; Beatrice,16,0,20,4
1746543593411,TDDE 131,A00,890297,Staff,47,0,50,3
1746543594437,TDDM 1,A00,890287,Weinberg; Sadie,25,0,30,5
1746543595463,TDGE 11,A00,890288,Fulton; Julia,137,0,200,63
1746543595463,TDGE 11,B00,890289,Castro; Robert Jess,184,0,200,16
1746543596488,TDGE 25,B00,957359,Walsh; Kim C.,3,0,20,17
1746543597516,TDGE 40,A01,890292,Power; Jade Yukana,27,0,30,3
1746543598546,TDGE 124,A00,890298,Havis; Allan,0,0,50,50
1746543599573,TDGE 131R,A00,890299,Burelle; Julie Sara Veronique,15,0,42,27
1746543600601,TDHT 101,A00,890300,Staff,10,0,20,10
1746543601630,TDHT 109,A01,890302,Anderson; Mysia Anyse,31,0,40,9
1746543602663,TDMV 1,A00,890293,Arcidiacono; Kristin,18,0,30,12
1746543603688,TDMV 2,A00,890294,Weinberg; Sadie,23,0,30,7
1746543604716,TDMV 3,A00,957878,Arcidiacono; Kristin,28,0,30,2
1746543606770,TDMV 138,A00,890304,Jun; Grace Shin Hae,25,0,40,15
1746543607796,TDMV 140,A00,890305,Corrales; Joseph Bernales,25,0,30,5
1746543608826,TDMV 142,A00,890307,Caligagan; Tony,32,0,40,8
1746543609853,TDMV 144,A00,890308,Camaya; Michelle Ann,25,0,30,5
1746543610881,TDPW 1,A00,890295,Stein; Deborah Isobel,3,0,20,17
1746543611910,USP 2,A01,890272,Lerner; Amy M,6,0,20,14
1746543612939,USP 3,A01,890274,Staff,12,0,30,18
1746543613967,USP 15,A01,890276,Sun; Feiyang,17,0,30,13
1746543614997,USP 25,A00,890277,Shenkman; Michael Thomas,19,0,25,6
1746543616024,USP 138,A00,890278,Staff,13,0,25,12
1746543617049,USP 143,A00,890279,Staff,21,0,70,49
1746543618075,USP 144,A00,890280,Chowdhury; Muhammed Zohir,16,0,30,14
1746543619106,USP 150,A00,890281,Boomhower; Matthew Charles,4,0,30,26
1746543620135,USP 151,A00,890282,Staff,16,0,20,4
1746543621162,USP 162,A00,890283,Andrews; Abigail Leslie,16,0,20,4
1746543622187,USP 168,A00,920477,Kwak; Nancy,1,0,5,4
1746543623219,USP 181,A00,890284,Staff,3,0,20,17
1746543624244,USP 191A,A00,890285,Staff,13,0,20,7
1746543625272,VIS 101,A00,886512,Staff,25,0,75,50
1746543626297,VIS 103,A00,886513,Cruz; Edwin Teddy,61,0,75,14
1746543627326,VIS 108,A00,886514,Staff,3,0,15,12
1746543628351,VIS 127P,A00,886515,Shen; Kuiyi,80,0,146,66
1746543629380,VIS 149,A00,886516,Yoldas; Pinar,0,0,15,15
1746543630410,VIS 164,A00,886526,Erdmann; Dean,19,0,22,3
1746543631436,VIS 194S,A00,886527,Staff,61,0,75,14
1746543632463,WCWP 10A,C00,886484,Martiniuk; Jill,12,0,15,3
1746543633494,WCWP 10B,A00,886490,Uriarte; Emma,0,0,15,15
1746543633494,WCWP 10B,B00,886491,Dhir; Simrita,11,0,15,4
1746543633494,WCWP 10B,C00,886492,Ornelas; Tricia,0,0,15,15
1746543634523,WCWP 100,A00,886494,Young; Mark T,0,7,15,15
1746543636629,AAS 10,A01,886199,Childs; Dennis R.,0,3,0,0
1746543637655,ANAR 104,A01,886940,Shtienberg; Gilad,27,0,30,3
1746543638685,ANAR 120,A00,886953,Staff,12,0,20,8
1746543639711,ANBI 148,A01,886955,Wilder; Linnea Lorene,30,0,40,10
1746543641765,ANSC 122,A00,886957,Staff,25,0,30,5
1746543642793,ANSC 150,A00,886958,Sloane; Julia Kathryn,3,0,15,12
1746543643823,ANSC 156,A00,886959,Jenkins; Janis A.,0,1,15,15
1746543644852,ANSC 180,A00,886960,Staff,11,0,17,6
1746543645880,ANSC 188,A00,886961,Jassal; Aftab,9,0,25,16
1746543646904,ANSC 190,A00,886962,Jassal; Aftab,14,0,25,11
1746543647933,ANSC 191,A00,886963,Staff,18,0,20,2
1746543648961,ANTH 3,A01,891689,Staff,17,0,20,3
1746543649988,ANTH 5,A00,886933,Semendeferi; Ekaterini,16,0,20,4
1746543651017,ANTH 10,A00,886934,Staff,0,12,30,30
1746543652043,ANTH 21,A01,886936,Staff,40,0,60,20
1746543653072,ANTH 23,A01,886938,Staff,92,0,100,8
1746543654101,ANTH 105,A00,886964,Stewart; Alexander B,84,0,100,16
1746543655126,ANTH 108,A00,886965,Pedersen; David,9,0,20,11
1746543656158,AWP 10,001,886147,Staff,0,0,0,0
1746543656158,AWP 10,002,886148,Staff,0,0,0,0
1746543656158,AWP 10,003,886149,Staff,0,0,0,0
1746543656158,AWP 10,004,886150,Staff,0,0,0,0
1746543656158,AWP 10,005,886151,Staff,0,0,0,0
1746543656158,AWP 10,006,886152,Staff,0,0,0,0
1746543656158,AWP 10,007,886153,Staff,0,0,0,0
1746543656158,AWP 10,008,886154,Staff,0,0,0,0
1746543656158,AWP 10,009,886155,Staff,0,0,0,0
1746543656158,AWP 10,010,886156,Staff,0,0,0,0
1746543656158,AWP 10,011,886158,Staff,0,0,0,0
1746543656158,AWP 10,012,886160,Staff,0,0,0,0
1746543656158,AWP 10,013,886161,Staff,0,0,0,0
1746543656158,AWP 10,014,886162,Staff,0,0,0,0
1746543656158,AWP 10,015,886163,Staff,0,0,0,0
1746543656158,AWP 10,016,886164,Staff,0,0,0,0
1746543656158,AWP 10,017,886165,Staff,0,0,0,0
1746543656158,AWP 10,018,886166,Staff,0,0,0,0
1746543656158,AWP 10,019,886168,Staff,0,0,0,0
1746543656158,AWP 10,020,886170,Staff,0,0,0,0
1746543656158,AWP 10,021,886172,Staff,0,0,0,0
1746543657214,AWP 10R,001,886173,Staff,0,1,0,0
1746543657214,AWP 10R,002,886174,Staff,0,1,0,0
1746543657214,AWP 10R,003,886175,Staff,0,0,0,0
1746543657214,AWP 10R,004,886176,Staff,0,0,0,0
1746543657214,AWP 10R,005,886177,Staff,0,0,0,0
1746543657214,AWP 10R,006,886178,Staff,0,0,0,0
1746543657214,AWP 10R,007,886179,Staff,0,0,0,0
1746543657214,AWP 10R,008,886181,Staff,0,0,0,0
1746543657214,AWP 10R,009,886182,Staff,0,0,0,0
1746543657214,AWP 10R,010,886183,Staff,0,0,0,0
1746543657214,AWP 10R,011,886184,Staff,0,0,0,0
1746543657214,AWP 10R,012,886185,Staff,0,0,0,0
1746543657214,AWP 10R,013,886186,Staff,0,0,0,0
1746543657214,AWP 10R,014,886187,Staff,0,0,0,0
1746543657214,AWP 10R,015,886188,Staff,0,0,0,0
1746543657214,AWP 10R,016,886189,Staff,0,0,0,0
1746543658238,AWP 102R,A00,886190,Staff,0,0,0,0
1746543658238,AWP 102R,B00,886191,Staff,0,0,0,0
1746543659267,BENG 100,A01,886193,Staff,17,0,30,13
1746543660297,BENG 122A,A01,886195,Hasty; Jeff M,13,0,30,17
1746543661323,BENG 166A,A00,886196,Sah; Robert Lie-Yuan,0,1,30,30
1746543662414,BENG 190,A00,958050,Khojah; Reem I,24,0,25,1
1746543663441,BIBC 102,A01,894320,Staff,0,0,46,46
1746543663441,BIBC 102,A02,894321,Staff,0,0,46,46
1746543663441,BIBC 102,A03,894344,Staff,7,0,46,39
1746543663441,BIBC 102,A04,894345,Staff,26,0,47,21
1746543664467,BICD 100R,A01,894365,Smith; Laurie,0,3,58,58
1746543664467,BICD 100R,A02,894366,Smith; Laurie,0,5,58,58
1746543664467,BICD 100R,A03,894367,Smith; Laurie,2,0,59,57
1746543664467,BICD 100R,A04,959869,Smith; Laurie,41,0,59,18
1746543665496,BICD 136,A01,894383,Gustafson-Brown; Cindy,14,0,50,36
1746543666523,BIEB 102,A01,894494,Butler; Shannon Rhey,51,0,130,79
1746543668579,BIEB 150,A01,894617,Wills; Christopher,3,0,20,17
1746543668579,BIEB 150,A02,894631,Wills; Christopher,3,0,20,17
1746543668579,BIEB 150,A03,894937,Wills; Christopher,3,0,20,17
1746543668579,BIEB 150,A04,894946,Wills; Christopher,5,0,20,15
1746543669608,BIEB 194,A00,906141,Kurle; Carolyn M.,6,0,20,14
1746543670640,BILD 1,A01,894154,Staff,2,0,19,17
1746543670640,BILD 1,A02,894155,Staff,14,0,19,5
1746543670640,BILD 1,A03,894160,Staff,13,0,19,6
1746543670640,BILD 1,A04,894161,Staff,15,0,18,3
1746543671670,BILD 2,A01,894168,Staff,0,0,50,50
1746543671670,BILD 2,A02,894169,Staff,0,0,50,50
1746543671670,BILD 2,A03,894179,Staff,4,0,50,46
1746543671670,BILD 2,A04,894203,Staff,27,0,50,23
1746543672698,BILD 3,A01,894213,Staff,22,0,31,9
1746543672698,BILD 3,A02,894214,Staff,26,0,31,5
1746543672698,BILD 3,A03,894235,Staff,28,0,31,3
1746543672698,BILD 3,A04,894236,Staff,28,0,32,4
1746543673730,BILD 4,A01,894253,Reuther; Keefe,5,0,24,19
1746543673730,BILD 4,A02,894258,Reuther; Keefe,16,0,24,8
1746543674760,BILD 5,A01,894276,Reuther; Keefe,35,0,50,15
1746543674760,BILD 5,A02,894277,Reuther; Keefe,45,0,50,5
1746543674760,BILD 5,A03,894290,Reuther; Keefe,44,0,50,6
1746543674760,BILD 5,A04,894291,Reuther; Keefe,48,0,50,2
1746543675789,BILD 24,A01,894297,Pirino; Giorgia,40,0,60,20
1746543676827,BIMM 100,B01,958915,Staff,72,0,100,28
1746543677859,BIMM 101,A01,895017,McDonnell; Lisa Marie,0,5,24,24
1746543677859,BIMM 101,A02,895018,McDonnell; Lisa Marie,0,5,24,24
1746543677859,BIMM 101,B01,895020,McDonnell; Lisa Marie,0,6,24,24
1746543677859,BIMM 101,B02,895021,McDonnell; Lisa Marie,0,4,24,24
1746543678889,BIMM 110,A01,895023,Staff,1,0,25,24
1746543678889,BIMM 110,A02,895024,Staff,9,0,25,16
1746543678889,BIMM 110,A03,895025,Staff,18,0,25,7
1746543678889,BIMM 110,A04,895031,Staff,20,0,25,5
1746543679917,BIMM 120,A01,895114,Gustafson-Brown; Cindy,13,0,28,15
1746543679917,BIMM 120,A02,895126,Gustafson-Brown; Cindy,21,0,27,6
1746543680942,BIPN 100,A01,895130,Yang; Mingyu,1,0,38,37
1746543680942,BIPN 100,A02,895131,Yang; Mingyu,32,0,38,6
1746543680942,BIPN 100,A03,895132,Yang; Mingyu,32,0,38,6
1746543680942,BIPN 100,A04,895133,Yang; Mingyu,27,0,36,9
1746543681968,BIPN 120,A01,895135,Cooke; James Edward,0,3,13,13
1746543681968,BIPN 120,A02,895136,Cooke; James Edward,0,1,13,13
1746543681968,BIPN 120,A03,895137,Cooke; James Edward,0,3,13,13
1746543681968,BIPN 120,A04,895156,Cooke; James Edward,0,2,11,11
1746543682999,BIPN 134,A01,895235,Cooke; James Edward,0,2,25,25
1746543682999,BIPN 134,A02,895237,Cooke; James Edward,0,0,25,25
1746543682999,BIPN 134,A03,895240,Cooke; James Edward,3,0,25,22
1746543682999,BIPN 134,A04,895270,Cooke; James Edward,20,0,25,5
1746543684027,BIPN 189,A00,892103,Staff,0,13,14,14
1746543686082,BISP 194,A00,958008,Staff,0,2,0,0
1746543687108,CAT 124,A01,922009,Staff,0,5,20,20
1746543688139,CAT 125R,A00,886390,Morales; Celeste Georgianna,0,2,20,20
1746543688139,CAT 125R,B00,886391,Irwin; Matthew Joseph,0,3,20,20
1746543688139,CAT 125R,C00,886392,Smith; Lauryn Alissa,0,2,20,20
1746543688139,CAT 125R,D00,886393,Vanderschuit; Maya Alysia,0,2,20,20
1746543688139,CAT 125R,E00,886394,Marchisotto; Jennifer Anne,0,4,20,20
1746543689171,CENG 15,A01,886218,Drews; Aaron,3,0,8,5
1746543690203,CENG 113,A00,886219,Opatkiewicz; Justin Paul,15,0,25,10
1746543691229,CGS 101,A00,887044,Staff,7,0,20,13
1746543692254,CGS 105,A01,887046,Staff,14,0,25,11
1746543693282,CGS 112,A00,887047,Cuong; Marisol,12,0,15,3
1746543694310,CGS 113,A00,887048,Staff,23,0,30,7
1746543695339,CGS 120,A00,887049,Staff,10,0,17,7
1746543696366,CHEM 6A,A01,886336,Lam; Tin Yiu,38,0,50,12
1746543696366,CHEM 6A,A02,886338,Lam; Tin Yiu,37,0,50,13
1746543697395,CHEM 6B,A01,886341,Hopkins; Patrycja Anna,16,0,50,34
1746543697395,CHEM 6B,A02,886343,Hopkins; Patrycja Anna,42,0,50,8
1746543698427,CHEM 6C,A01,886346,Albizati; Kim F.,0,2,50,50
1746543698427,CHEM 6C,A02,886348,Albizati; Kim F.,23,0,50,27
1746543699454,CHEM 40A,A01,886352,Klosterman; Jeremy K,65,0,100,35
1746543700480,CHEM 40B,A01,886356,Klosterman; Jeremy K,0,23,100,100
1746543701510,CHEM 41B,A01,886360,Theodorakis; Emmanuel,25,0,50,25
1746543701510,CHEM 41B,A02,886362,Theodorakis; Emmanuel,47,0,50,3
1746543702541,CHIN 165A,A00,886382,Xu; Li,18,0,20,2
1746543703572,CLAS 120,A00,886387,Myerston Santana; Jacobo,33,0,40,7
1746543704599,COGS 9,A01,886967,Shannon; Kyle Michael,42,0,60,18
1746543705627,COGS 11,A01,886969,Staff,11,0,30,19
1746543706656,COGS 14A,A01,886971,Staff,6,0,60,54
1746543707688,COGS 14B,A01,886973,Hoffman; Drew Ellen,4,0,60,56
1746543708714,COGS 18,A01,886975,Morgan; Eric,35,0,60,25
1746543709740,COGS 20,A01,886977,Staff,4,0,8,4
1746543709740,COGS 20,A02,886978,Staff,5,0,7,2
1746543710767,COGS 100,A01,907783,Staff,0,2,30,30
1746543711798,COGS 101B,A01,886980,Staff,0,3,48,48
1746543712827,COGS 101C,A01,886982,Delgado; Tania,0,5,44,44
1746543713852,COGS 102A,A01,886984,Johnson; Christine M.,4,0,30,26
1746543714882,COGS 118B,A01,886986,Staff,0,3,88,88
1746543715910,COGS 150,A01,886988,Bergen; Benjamin,23,0,50,27
1746543716937,COGS 153,A00,886989,Delgado; Tania,0,2,41,41
1746543717966,COGS 186,A01,886991,Staff,0,0,32,32
1746543718992,COGS 187A,A01,886993,Boyle; Mary E. T.,7,0,30,23
1746543720047,COGS 189,A00,886994,Staff,0,1,30,30
1746543721074,COMM 10,A01,886996,Staff,0,0,20,21
1746543721074,COMM 10,A02,886997,Staff,12,0,20,8
1746543721074,COMM 10,A03,959845,Staff,19,0,20,1
1746543722101,COMM 20,A01,886999,Leuning; Grant Maurstad,24,0,40,16
1746543724153,COMM 100A,A01,887002,Staff,0,0,20,25
1746543724153,COMM 100A,A02,887003,Staff,7,0,20,13
1746543725180,COMM 100B,A01,887005,Staff,0,8,20,24
1746543726208,COMM 106D,A00,887006,Staff,14,0,40,26
1746543727234,COMM 110G,A00,887007,Whitworth-Smith; Andrew C,12,0,40,28
1746543728258,COMM 111B,A00,887008,Staff,31,0,40,9
1746543729284,COMM 113T,A00,887009,Abuelhiga; Soraya Jill,28,0,40,12
1746543729284,COMM 113T,B00,906733,Staff,40,0,40,0
1746543730309,COMM 145,A00,887010,Staff,12,0,40,28
1746543731333,COMM 146,A00,887054,Staff,31,0,40,9
1746543732362,COMM 190,A00,887012,Staff,8,0,23,15
1746543733391,CSE 8A,A50,887015,Cao; Yingjun,57,0,85,28
1746543734419,CSE 11,A01,887017,Cao; Yingjun,12,0,70,58
1746543735443,CSE 20,A01,887019,Staff,30,0,50,20
1746543736475,CSE 21,A01,887021,Staff,78,0,100,22
1746543736475,CSE 21,B01,892583,Braun; Oliver,45,0,50,5
1746543737502,CSE 30,A01,887025,Eldon; John,143,0,200,57
1746543738528,CSE 100,A01,887027,Staff,26,0,50,24
1746543738528,CSE 100,A02,887028,Staff,40,0,50,10
1746543739559,CSE 101,A01,887030,Braun; Oliver,75,0,100,25
1746543739559,CSE 101,B01,887032,Jones; Miles E,0,3,50,50
1746543739559,CSE 101,B02,887033,Jones; Miles E,0,1,50,50
1746543740586,CSE 105,A01,908084,Jones; Miles E,32,0,50,18
1746543740586,CSE 105,A02,908087,Jones; Miles E,33,0,50,17
1746543741614,CSE 135,A01,887035,Powell; Thomas Allan,0,4,50,50
1746543742639,CSE 142,A01,887037,Staff,8,0,60,52
1746543743664,CSE 142L,A01,887039,Staff,34,0,60,26
1746543744696,CSE 151A,A01,887041,Solares; Edwin A,48,0,100,52
1746543745722,CSE 175,A01,887043,Kumar; Rakesh,30,0,30,0
1746543746747,CSS 1,A01,886389,Staff,0,1,40,40
1746543747777,DSC 30,A01,908097,Liao; Soohyun Nam,47,0,75,28
1746543748803,DSC 40A,A01,908099,Shannon; Kyle Michael,30,0,50,20
1746543749830,DSC 40B,A01,908112,Staff,16,0,50,34
1746543750857,DSC 80,A01,908116,Staff,19,0,60,41
1746543751886,DSC 197,001,956863,Eldridge; Justin Matthew,9999,0,9999,0
1746543752916,ECE 5,A01,886400,Morris; Karcher William,2,0,6,4
1746543752916,ECE 5,A02,886401,Morris; Karcher William,3,0,6,3
1746543753942,ECE 148,A01,886403,Silberman; Jack,0,14,14,14
1746543754975,ECON 1,A01,887265,Crane; Meredith Helen,12,0,70,58
1746543754975,ECON 1,B01,887268,Staff,43,0,50,7
1746543756002,ECON 2,A01,887273,Crane; Meredith Helen,56,0,70,14
1746543757032,ECON 3,A01,887279,Rondina; Giacomo,32,0,70,38
1746543758060,ECON 4,A01,887282,Anderson; John Charles,0,2,10,10
1746543759087,ECON 5,A01,887285,Staff,33,0,45,12
1746543759087,ECON 5,B01,887292,Staff,41,0,45,4
1746543760114,ECON 100A,A01,887337,Newhouse; Herbert S,54,0,70,16
1746543760114,ECON 100A,B01,887349,Staff,45,0,50,5
1746543761143,ECON 100B,A01,887361,Du; Songzi,29,0,70,41
1746543762172,ECON 100C,A01,887445,Newhouse; Herbert S,59,0,70,11
1746543763196,ECON 105,A00,887488,Vespa; Emanuel Ignacio,23,0,35,12
1746543764221,ECON 109,A01,887506,Shishkin; Denis,28,0,35,7
1746543765248,ECON 110A,A01,887568,Alon; Titan Michael,0,3,35,35
1746543765248,ECON 110A,B01,907601,Alon; Titan Michael,20,0,35,15
1746543766311,ECON 110B,A01,887598,Levkoff; Steven B.,0,23,70,70
1746543767335,ECON 112,A00,887599,Rondina; Giacomo,19,0,35,16
1746543768361,ECON 120A,A01,887603,Dai; Yinlin,36,0,70,34
1746543769387,ECON 120C,A01,887608,Sun; Yixiao,0,1,35,35
1746543769387,ECON 120C,B01,887614,Sun; Yixiao,0,0,35,35
1746543770412,ECON 138,A00,887621,Bharadwaj; Prashant,0,20,20,20
1746543771437,ECON 144,A00,958007,Squires; Dale E,13,0,35,22
1746543772463,ECON 171,A01,907666,Staff,18,0,35,17
1746543773490,ECON 175,A00,887626,Wu; Pak Yeung,23,0,35,12
1746543774518,ECON 190,A00,887640,Vespa; Emanuel Ignacio,23,0,35,12
1746543775547,EDS 25,A01,888197,Staff,0,0,0,0
1746543775547,EDS 25,A02,888209,Staff,0,0,0,0
1746543775547,EDS 25,A03,888210,Staff,0,0,0,0
1746543775547,EDS 25,A04,888212,Staff,0,0,0,0
1746543775547,EDS 25,A05,888213,Staff,0,0,0,0
1746543775547,EDS 25,A06,888214,Staff,0,0,0,0
1746543775547,EDS 25,A07,888235,Staff,0,2,0,0
1746543775547,EDS 25,A08,888236,Staff,0,0,0,0
1746543775547,EDS 25,A09,888240,Staff,0,0,0,0
1746543775547,EDS 25,A10,888244,Staff,0,0,0,0
1746543775547,EDS 25,B01,888273,Staff,0,0,0,0
1746543775547,EDS 25,B02,888285,Staff,0,0,0,0
1746543775547,EDS 25,B03,888423,Staff,0,0,0,1
1746543775547,EDS 25,B04,888432,Staff,0,0,0,0
1746543775547,EDS 25,B05,888433,Staff,0,0,0,0
1746543775547,EDS 25,B06,888467,Staff,0,0,0,0
1746543775547,EDS 25,B07,888468,Staff,0,0,0,0
1746543775547,EDS 25,B08,888479,Staff,0,0,0,0
1746543775547,EDS 25,B09,888484,Staff,0,0,0,0
1746543775547,EDS 25,B10,888487,Staff,0,0,0,0
1746543776571,EDS 38,A01,907700,Choi; Bailey Miyeon,30,0,30,0
1746543777596,EDS 112,A01,888601,Chapman; Thandeka K,14,0,40,26
1746543778620,EDS 115,A00,888697,Mendez; Kathrina Mendoza,10,0,30,20
1746543779647,EDS 116,A01,888893,Staff,35,0,40,5
1746543781699,EDS 124AR,A00,889133,Staff,29,0,50,21
1746543781699,EDS 124AR,B00,907471,Simon; Elizabeth A,37,0,50,13
1746543782727,EDS 124BR,A00,889134,Simon; Elizabeth A,45,0,100,55
1746543783751,EDS 125,A00,889135,Staff,25,0,30,5
1746543784776,EDS 126,A01,889138,Staff,36,0,40,4
1746543785801,EDS 164R,A01,889142,Wishard Guerra; Alison G.,33,0,50,17
1746543786829,ENG 30,A01,886396,Staff,0,0,0,0
1746543786829,ENG 30,B01,886398,Staff,0,0,0,0
1746543787856,ENVR 102,A00,906150,Montejo; Carolina,23,0,25,2
1746543788882,ETHN 103A,A00,887236,Man; Simeon S,0,3,0,0
1746543789906,ETHN 113,A00,887239,Staff,16,0,30,14
1746543790930,ETHN 116,A00,887240,Staff,16,0,25,9
1746543791956,ETHN 117,A00,887241,Choi; Esther Min,28,0,30,2
1746543792983,ETHN 118,A00,887243,Staff,24,0,30,6
1746543794008,ETHN 127,A00,887248,Cuong; Marisol,11,0,15,4
1746543795035,ETHN 139,A00,887250,Staff,7,0,10,3
1746543796063,ETHN 142,A00,887252,Staff,10,0,30,20
1746543797090,ETHN 161,A00,887253,Browne; Errol Tsekani,24,0,30,6
1746543798118,ETHN 163FR,A00,887255,Burelle; Julie Sara Veronique,0,0,5,5
1746543799144,GLBH 20,A00,889149,Elwardani; Nile Regina,8,0,42,34
1746543801199,GLBH 111,A01,889152,Burgos; Jose L.,17,0,17,0
1746543802227,GLBH 150,A00,889181,Sloane; Julia Kathryn,0,5,15,15
1746543804277,HDS 60,A01,886406,Warstadt; Melissa Fawn,73,0,80,7
1746543805318,HIAF 111,A00,889324,Gyamfi; Bright,25,0,32,7
1746543806344,HIEA 131,A00,889328,Staff,16,0,32,16
1746543807373,HIEA 144,A00,889333,Henry; Todd A.,26,0,32,6
1746543808399,HIEA 154,A00,889336,Henry; Todd A.,24,0,32,8
1746543809426,HIEU 106,A00,889339,Staff,22,0,32,10
1746543811476,HIEU 114,A00,889340,Staff,3,0,32,29
1746543812503,HIEU 135GS,A00,889342,Patterson; Patrick H.,0,0,1,24
1746543813529,HIEU 137,A00,889343,Edington; Claire Ellen,9,0,25,16
1746543814556,HIEU 148,A00,889345,Staff,14,0,32,18
1746543815582,HIEU 154,A00,889346,Biess; Frank Peter,21,0,32,11
1746543816606,HILA 102,A00,889351,Staff,12,0,32,20
1746543817632,HILD 2A,A01,889221,Lewandoski; Julia Mavis,1,10,32,31
1746543818662,HILD 7B,A01,889225,Man; Simeon S,0,13,32,32
1746543819688,HILD 7C,A01,889288,Alvarez; Luis A,0,14,32,32
1746543820714,HILD 30,A01,889323,Staff,0,5,32,32
1746543822772,HISC 119,A00,889383,Golan; Tal,21,0,32,11
1746543823799,HIUS 103,A00,889384,Man; Simeon S,0,0,32,32
1746543824825,HIUS 117,A00,919797,Kwak; Nancy,18,0,32,14
1746543825854,HIUS 142A,A00,919788,Staff,22,0,32,10
1746543827904,HIUS 149,A00,889386,Gyamfi; Bright,27,0,32,5
1746543828932,HIUS 155,A00,889387,Alvarez; Luis A,14,0,32,18
1746543829959,HUM 3,A01,886499,Caldwell; Michael Alan,19,0,50,31
1746543830987,HUM 3GS,A00,886500,Rodriguez; Bretton Sigfred,0,0,0,28
1746543832011,HUM 3R,A01,886502,Markman; Kristina,0,36,50,50
1746543833037,HUM 4,A01,886504,Crum; Matthew Stephen,24,0,50,26
1746543833037,HUM 4,B01,886506,West; Geoffrey Scott,17,0,50,33
1746543834062,HUM 4GS,A00,886507,Staff,0,0,0,19
1746543835090,HUM 5,A01,886509,Staff,32,0,50,18
1746543836118,HUM 5R,A01,886511,Zavodny; Tatiana Sophia,0,39,50,50
1746543837144,JAPN 180,A00,886407,Staff,18,0,40,22
1746543838169,LATI 50,A01,886409,Martin-Cabrera; Luis,4,0,22,18
1746543838169,LATI 50,A02,886410,Martin-Cabrera; Luis,19,0,22,3
1746543838169,LATI 50,A03,886411,Martin-Cabrera; Luis,21,0,22,1
1746543838169,LATI 50,A04,886412,Martin-Cabrera; Luis,9,0,22,13
1746543839196,LAWS 101,A00,907664,Staff,28,0,60,32
1746543840223,LIAB 1A,A00,889388,Saab; Dima,17,0,20,3
1746543841248,LIAB 1AX,A00,889389,El Cheddadi; Youniss,17,0,20,3
1746543842273,LIFR 1C,A00,889391,Van Moer; Vinciane G,8,0,20,12
1746543843299,LIFR 1CX,A00,889392,Van Moer; Vinciane G,7,0,20,13
1746543844323,LIFR 1D,A00,889393,Van Moer; Vinciane G,7,0,20,13
1746543845353,LIFR 1DX,A00,889394,Van Moer; Vinciane G,8,0,20,12
1746543846385,LIGN 7,A00,886923,Staff,24,0,50,26
1746543847412,LIGN 17,A00,886924,Kehler; Andrew Scott,125,0,150,25
1746543848438,LTAM 110,A00,889395,Staff,15,0,30,15
1746543849463,LTAM 110GS,A00,958010,Rodriguez; Bretton Sigfred,0,0,0,28
1746543850496,LTCH 101,A00,889397,Staff,23,0,25,2
1746543851522,LTCS 130,A00,889398,Staff,23,0,25,2
1746543852549,LTEA 138,A00,889399,Staff,24,0,40,16
1746543853575,LTEN 149,A00,889400,Wesling; Megan E.,0,3,25,25
1746543854604,LTEN 169,A00,889401,Staff,20,0,25,5
1746543855632,LTEN 180,A00,889402,Staff,10,0,15,5
1746543856657,LTEN 181,A00,889403,Staff,21,0,25,4
1746543857686,LTWL 100,A00,889404,Myerston Santana; Jacobo,3,0,25,22
1746543858710,LTWL 180GS,A00,889405,Staff,0,0,20,20
1746543859746,LTWL 181,A00,889406,Staff,17,0,25,8
1746543860775,LTWL 184,A00,889475,Mukherjee; Silpa,22,0,25,3
1746543861801,LTWR 102C,A00,889486,Staff,29,0,30,1
1746543862827,LTWR 115W,A00,889491,Staff,0,2,15,15
1746543863856,MAE 8,A01,886905,Staff,0,2,0,0
1746543864886,MAE 11,A00,886906,Bandaru; Prabhakar,0,7,50,50
1746543865914,MAE 20,A00,886907,Evdokimenko; Ekaterina,44,0,70,26
1746543866942,MAE 30B,A00,886909,Ghazinejad; Maziar,26,0,45,19
1746543867966,MAE 101B,A00,886910,Saintillan; David,29,0,45,16
1746543868991,MAE 105,A00,886911,Bandaru; Prabhakar,18,0,50,32
1746543870057,MAE 107,B00,958024,Staff,9,0,50,41
1746543871088,MAE 143B,A00,886913,Bewley; Thomas R,7,0,40,33
1746543872117,MAE 148,A01,886915,Silberman; Jack,0,3,14,14
1746543873143,MAE 160,A00,886916,Evdokimenko; Ekaterina,31,0,60,29
1746543874174,MATH 3C,A01,889681,Staff,0,3,30,30
1746543874174,MATH 3C,A02,960048,Staff,25,0,30,5
1746543875199,MATH 10A,A01,889760,Staff,26,0,30,4
1746543875199,MATH 10A,A02,889783,Staff,29,0,30,1
1746543876231,MATH 10B,A01,889785,Verstraete; Jacques Allan,2,0,35,33
1746543876231,MATH 10B,A02,889795,Verstraete; Jacques Allan,4,0,35,31
1746543876231,MATH 10B,B01,889797,Verstraete; Jacques Allan,3,0,35,32
1746543876231,MATH 10B,B02,889828,Verstraete; Jacques Allan,3,0,35,32
1746543877258,MATH 10C,A01,889849,Habib; Yousaf,9,0,30,21
1746543877258,MATH 10C,A02,889852,Habib; Yousaf,14,0,30,16
1746543877258,MATH 10C,A03,889853,Habib; Yousaf,22,0,30,8
1746543877258,MATH 10C,A04,889858,Habib; Yousaf,20,0,30,10
1746543877258,MATH 10C,B01,889861,Staff,1,0,30,29
1746543877258,MATH 10C,B02,889862,Staff,24,0,30,6
1746543877258,MATH 10C,B03,889863,Staff,27,0,30,3
1746543877258,MATH 10C,B04,889967,Staff,23,0,30,7
1746543878292,MATH 18,A01,889974,Staff,7,0,30,23
1746543878292,MATH 18,A02,889977,Staff,20,0,30,10
1746543878292,MATH 18,B01,889984,Hardiman; Liam,22,0,30,8
1746543878292,MATH 18,B02,889985,Hardiman; Liam,25,0,30,5
1746543879319,MATH 20A,A01,889990,Suk; Andrew Hoon,29,0,35,6
1746543880351,MATH 20B,A01,889993,Ohm; Ko Woon,22,0,30,8
1746543880351,MATH 20B,A02,889994,Ohm; Ko Woon,30,0,30,0
1746543880351,MATH 20B,B01,889996,Ohm; Ko Woon,21,0,30,9
1746543880351,MATH 20B,B02,889997,Ohm; Ko Woon,23,0,30,7
1746543881379,MATH 20C,A01,889999,Hammock; Frances H,17,0,30,13
1746543881379,MATH 20C,A02,890003,Hammock; Frances H,23,0,30,7
1746543881379,MATH 20C,B01,890006,Hammock; Frances H,3,0,30,27
1746543881379,MATH 20C,B02,890007,Hammock; Frances H,11,0,30,19
1746543882406,MATH 20D,A01,890011,Cheng; Hsiao-Bing,1,1,30,29
1746543882406,MATH 20D,A02,890012,Cheng; Hsiao-Bing,14,0,30,16
1746543882406,MATH 20D,B01,890016,Cheng; Hsiao-Bing,13,0,30,17
1746543882406,MATH 20D,B02,890017,Cheng; Hsiao-Bing,13,0,30,17
1746543883430,MATH 20E,A01,890026,Harel; Guershon,1,0,30,29
1746543883430,MATH 20E,A02,890029,Harel; Guershon,23,0,30,7
1746543883430,MATH 20E,B01,890033,Harel; Guershon,7,0,30,23
1746543883430,MATH 20E,B02,890101,Harel; Guershon,21,0,30,9
1746543884458,MATH 102,A01,890104,Staff,17,0,30,13
1746543884458,MATH 102,A02,890105,Staff,27,0,30,3
1746543885485,MATH 103B,A01,890116,Salehi Golsefidy; Alireza,3,0,30,27
1746543885485,MATH 103B,B01,890118,Staff,0,3,34,34
1746543886514,MATH 109,A01,890121,Aliabadi Sr.; Mohsen,1,0,30,29
1746543886514,MATH 109,B01,890124,Upadrashta; Pranav Kumar,18,0,30,12
1746543887544,MATH 120A,A01,890126,Eggers; John Dietrich,13,0,30,17
1746543888574,MATH 142B,A01,890128,Ioana; Adrian,19,0,30,11
1746543888574,MATH 142B,A02,890129,Ioana; Adrian,13,0,30,17
1746543889604,MATH 154,A01,890174,Staff,0,0,30,30
1746543889604,MATH 154,A02,890182,Staff,0,0,30,30
1746543890629,MATH 168A,A01,890197,Dumitriu; Ioana,21,0,35,14
1746543891655,MATH 170A,A01,890240,Nie; Jiawang,1,0,30,29
1746543891655,MATH 170A,A02,890241,Nie; Jiawang,11,0,30,19
1746543891655,MATH 170A,A03,890249,Nie; Jiawang,23,0,30,7
1746543892679,MATH 170B,A01,957891,Nag; Panchali,13,0,35,22
1746543894729,MATH 181A,A01,908025,Staff,0,4,35,35
1746543894729,MATH 181A,A02,960115,Staff,27,0,35,8
1746543895759,MATH 181B,A01,959874,Staff,26,0,30,4
1746543896789,MATH 193B,A01,890265,Staff,0,4,35,35
1746543897821,MGT 4,A01,890311,Anderson; John Charles,42,0,88,46
1746543898850,MGT 5,A00,907740,Staff,13,0,98,85
1746543899878,MGT 12,A00,890312,Lindenberger; Wade Douglas,67,0,98,31
1746543900907,MGT 16,A00,957883,Staff,78,0,98,20
1746543902966,MGT 45,A00,890314,Pecore; Joseph P.,47,0,98,51
1746543903994,MGT 71,A00,890315,Staff,0,11,98,98
1746543905021,MGT 100,A00,890316,Yavorsky; Daniel Ryan,44,0,98,54
1746543906051,MGT 103,A00,890317,Ehrich; Kristine R,73,0,98,25
1746543907081,MGT 105,A00,890356,Bates; Kenneth Walter,0,7,98,98
1746543908109,MGT 112,A00,890360,Ehrich; Kristine R,55,0,98,43
1746543909137,MGT 127R,A00,907732,Zhu; Kevin Xiaoguo,23,0,98,75
1746543910167,MGT 131B,A00,890361,Anderson; John Charles,61,0,98,37
1746543911196,MGT 137,A00,890362,Lindenberger; Wade Douglas,65,0,98,33
1746543912226,MGT 160,A00,890369,Johnson; Erik Barry,9,0,98,89
1746543914299,MGT 164,A00,890372,Zimmermann; Carsten,0,39,98,98
1746543915325,MGT 180,A00,890374,Bliss; Barbara Ann,12,0,98,86
1746543916349,MMW 15,A01,886414,Chang; Edmond Yi-Teh,0,12,28,28
1746543916349,MMW 15,A02,886415,Chang; Edmond Yi-Teh,0,8,28,28
1746543916349,MMW 15,A03,886416,Chang; Edmond Yi-Teh,0,8,28,28
1746543916349,MMW 15,A04,886417,Chang; Edmond Yi-Teh,0,8,28,28
1746543916349,MMW 15,B01,886419,Chang; Edmond Yi-Teh,0,7,28,28
1746543916349,MMW 15,B02,886420,Chang; Edmond Yi-Teh,0,8,28,28
1746543916349,MMW 15,B03,886421,Chang; Edmond Yi-Teh,0,7,28,28
1746543916349,MMW 15,B04,886422,Chang; Edmond Yi-Teh,0,8,28,28
1746543916349,MMW 15,C01,886424,Staff,0,9,28,28
1746543916349,MMW 15,C02,886425,Staff,0,8,28,28
1746543916349,MMW 15,C03,886426,Staff,0,8,28,28
1746543916349,MMW 15,C04,886427,Staff,0,7,28,28
1746543916349,MMW 15,C05,958038,Staff,0,7,28,28
1746543916349,MMW 15,C06,958039,Staff,0,8,28,28
1746543917375,MMW 15GS,A00,906910,Patterson; Patrick H.,4,0,28,24
1746543918399,MMW 122R,A01,886429,Rahimi; Babak,0,13,28,28
1746543918399,MMW 122R,A02,886430,Rahimi; Babak,0,12,28,28
1746543918399,MMW 122R,A03,958040,Rahimi; Babak,0,11,28,28
1746543919429,MUS 1A,A01,890937,Staff,3,0,25,22
1746543919429,MUS 1A,A02,891035,Staff,6,0,25,19
1746543919429,MUS 1A,C01,958912,Staff,24,0,25,1
1746543919429,MUS 1A,C02,958913,Staff,25,0,25,0
1746543921480,MUS 2AK,A00,957092,Ohnishi; Takae,15,0,15,0
1746543922506,MUS 4,A01,891044,Staff,2,0,25,23
1746543922506,MUS 4,A02,891045,Staff,23,0,25,2
1746543922506,MUS 4,B01,891048,Staff,17,0,25,8
1746543922506,MUS 4,B02,891050,Staff,25,0,25,0
1746543923540,MUS 5,A01,957506,Dubnov; Shlomo,0,0,25,25
1746543923540,MUS 5,A02,957622,Dubnov; Shlomo,14,0,25,11
1746543923540,MUS 5,A03,957623,Dubnov; Shlomo,20,0,25,5
1746543924564,MUS 6,A01,891053,Freitas Caetano; Marcelo,24,0,25,1
1746543924564,MUS 6,A02,891054,Freitas Caetano; Marcelo,23,0,25,2
1746543925590,MUS 7,A01,891081,Staff,0,0,25,25
1746543925590,MUS 7,A02,891082,Staff,4,0,25,21
1746543926616,MUS 8GS,A00,891118,Borgo; David Garcia,0,0,25,25
1746543927641,MUS 11,A01,891140,Staff,11,0,25,14
1746543927641,MUS 11,A02,891141,Staff,22,0,25,3
1746543928665,MUS 13,A01,891143,Staff,8,0,25,17
1746543928665,MUS 13,A02,891144,Staff,24,0,25,1
1746543929691,MUS 15,A01,891146,Staff,9,0,25,16
1746543929691,MUS 15,A02,891148,Staff,21,0,25,4
1746543929691,MUS 15,B01,891150,Staff,18,0,25,7
1746543929691,MUS 15,B02,891151,Staff,25,0,25,0
1746543930717,MUS 20,A01,891153,Staff,5,0,20,15
1746543930717,MUS 20,A02,891155,Staff,14,0,20,6
1746543931743,MUS 80,A00,891156,Staff,19,0,25,6
1746543931743,MUS 80,B00,891157,Staff,23,0,25,2
1746543932770,MUS 130,A00,891158,Ohnishi; Takae,35,0,35,0
1746543933793,MUS 150GS,A01,891160,Borgo; David Garcia,0,0,25,25
1746543934822,MUS 170,A01,891162,Freitas Caetano; Marcelo,20,0,25,5
1746543934822,MUS 170,A02,891164,Freitas Caetano; Marcelo,21,0,25,4
1746543935850,NANO 11,A00,886220,Vazquez Mena; Oscar,13,0,15,2
1746543936880,NANO 15,A01,886222,Drews; Aaron,4,0,7,3
1746543937906,NANO 104,A00,886224,Sirbuly; Donald,18,0,25,7
1746543938935,PH 40,A00,886528,Staff,23,0,40,17
1746543939964,PH 45,A01,886799,Staff,35,0,40,5
1746543940992,PH 110,A00,886802,Staff,0,7,40,40
1746543942017,PH 172,A00,906716,Staff,19,0,35,16
1746543943040,PH 191,A00,886803,Staff,6,0,40,34
1746543944067,PHIL 1,A00,889500,Staff,19,0,30,11
1746543945099,PHIL 10,A01,889549,Grush; Rick Scott,15,0,22,7
1746543945099,PHIL 10,A02,889551,Grush; Rick Scott,22,0,22,0
1746543946125,PHIL 28,A01,889559,Lamey; Andy M.,0,1,31,31
1746543946125,PHIL 28,A02,889561,Lamey; Andy M.,0,1,30,30
1746543946125,PHIL 28,A03,889572,Lamey; Andy M.,0,0,30,30
1746543947155,PHIL 35,A00,907839,Staff,13,0,15,2
1746543948182,PHIL 60,A00,889574,Staff,74,0,90,16
1746543949209,PHIL 101,A00,958004,Staff,13,0,15,2
1746543951258,PHIL 136,A00,889582,Fulkerson; Matthew Todd,26,0,45,19
1746543952289,PHIL 163,A01,889601,Staff,21,0,30,9
1746543952289,PHIL 163,B01,889606,Brandt; Reuven A,0,3,0,0
1746543953314,PHIL 164,A00,889610,Staff,16,0,30,14
1746543954340,PHIL 165,A00,889613,Staff,23,0,30,7
1746543955366,PHYS 1A,A00,886431,Staff,26,0,70,44
1746543956392,PHYS 1AL,001,886432,Tsai; Philbert S,0,2,30,30
1746543956392,PHYS 1AL,002,886436,Tsai; Philbert S,11,0,30,19
1746543957419,PHYS 1B,A00,886439,Staff,185,0,240,55
1746543958443,PHYS 1BL,001,886441,Tsai; Philbert S,0,4,30,30
1746543958443,PHYS 1BL,002,886444,Tsai; Philbert S,2,0,30,28
1746543959470,PHYS 1C,A00,896092,Arnold; Kam S,78,0,146,68
1746543960497,PHYS 1CL,001,886448,Tsai; Philbert S,0,0,30,30
1746543960497,PHYS 1CL,002,886449,Tsai; Philbert S,0,0,30,30
1746543960497,PHYS 1CL,003,886450,Tsai; Philbert S,16,0,30,14
1746543960497,PHYS 1CL,004,886451,Tsai; Philbert S,15,0,30,15
1746543961525,PHYS 2B,A01,886457,Staff,69,0,115,46
1746543962551,PHYS 2C,A01,886460,Shotwell; Brian,0,8,65,65
1746543963578,PHYS 2CL,A01,886467,Staff,0,4,28,28
1746543963578,PHYS 2CL,A02,886468,Staff,0,3,28,28
1746543964603,PHYS 2D,A01,886470,Staff,10,0,50,40
1746543965628,PHYS 4B,A01,886475,Grinstein; Benjamin,22,0,40,18
1746543966655,POLI 5,A00,891173,Desposato; Scott,7,0,25,18
1746543967679,POLI 5D,A01,891175,Staff,5,0,5,0
1746543967679,POLI 5D,B01,891178,Staff,5,0,5,0
1746543968709,POLI 11,A00,891179,Ferree; Karen E,2,0,35,33
1746543969736,POLI 12,A00,891180,Staff,16,0,30,14
1746543970764,POLI 27,A01,891182,Staff,12,0,75,63
1746543971811,POLI 30,A00,891183,Staff,9,0,50,41
1746543972839,POLI 100B,A00,891244,Staff,5,1,35,30
1746543973865,POLI 100I,A00,891247,Staff,7,0,30,23
1746543974890,POLI 104J,A00,891248,Nichter; Maysa,14,0,30,16
1746543975919,POLI 104U,A00,891250,Nichter; Maysa,2,0,30,28
1746543977976,POLI 110B,A00,891255,Wiens; David,20,0,25,5
1746543979002,POLI 112A,A00,891256,Wiens; David,6,0,25,19
1746543980031,POLI 114BR,A00,891261,Staff,19,0,30,11
1746543981059,POLI 117R,A00,891262,Forman; Fonna,0,6,50,50
1746543982087,POLI 118,A00,891264,Ingham; Sean,17,0,25,8
1746543983113,POLI 124A,A00,891265,Staff,18,0,20,2
1746543984142,POLI 125D,A00,891266,Nichter; Simeon C,2,0,25,23
1746543985169,POLI 126,A00,891268,Nichter; Simeon C,7,0,25,18
1746543986193,POLI 126AA,A00,891272,Staff,18,0,25,7
1746543987220,POLI 130AA,A00,891273,Staff,15,0,20,5
1746543988248,POLI 134AA,A00,891274,Staff,4,0,20,16
1746543990302,POLI 138,A00,891278,Staff,21,0,25,4
1746543991331,POLI 142K,A00,891280,Staff,11,0,25,14
1746543992359,POLI 142M,A00,891281,Gartzke; Erik,17,0,30,13
1746543993386,POLI 142P,A00,891284,Staff,20,0,30,10
1746543994411,POLI 143,A00,891285,Gartzke; Erik,12,0,30,18
1746543995438,POLI 153,A00,891286,Staff,19,0,20,1
1746543997489,POLI 175,A00,891290,Staff,15,0,20,5
1746543998518,PSYC 1,A00,890674,Steiner; Eric Tomas,0,11,45,45
1746543999545,PSYC 2,A00,890676,Albright; Thomas D,21,0,35,14
1746544000570,PSYC 3,A00,890679,Staff,17,0,20,3
1746544001602,PSYC 6,A00,959858,Staff,20,0,20,0
1746544002626,PSYC 60,A01,890684,Rickard; Timothy C.,0,5,45,45
1746544003651,PSYC 70,A01,890689,Geller; Emma Harlan,7,0,30,23
1746544004677,PSYC 71,A01,959860,Staff,21,0,25,4
1746544005704,PSYC 100,A00,890690,Lacefield; Katharine I,0,50,180,180
1746544006732,PSYC 102,A00,890695,Staff,18,0,40,22
1746544007760,PSYC 105,A00,890699,Geller; Emma Harlan,71,0,100,29
1746544008784,PSYC 106,A00,890701,Gorman; Michael R.,5,0,30,25
1746544009810,PSYC 108,A00,890704,Adrian; Julia Anna,0,28,50,50
1746544010837,PSYC 118,A01,890712,Staff,11,0,30,19
1746544011864,PSYC 124,A00,890716,Chapman; Eddie Nathaniel,25,0,60,35
1746544012887,PSYC 131,A00,890717,Anagnostaras; Stephan,0,7,80,80
1746544013916,PSYC 137,A00,890719,Winkielman; Piotr,0,11,30,30
1746544014941,PSYC 144,A00,890721,Adrian; Julia Anna,0,9,45,45
1746544015966,PSYC 162,A00,890805,Staff,2,0,75,73
1746544016993,PSYC 169,A00,890810,Staff,0,15,30,30
1746544018023,PSYC 172,A00,890814,Gorman; Michael R.,9,0,30,21
1746544019053,PSYC 181,A00,890818,Anagnostaras; Stephan,8,0,200,192
1746544020082,PSYC 184,A00,959861,Staff,170,0,175,5
1746544021107,PSYC 189,A00,890823,Staff,0,1,30,30
1746544022140,PSYC 191,A00,890884,Rickard; Timothy C.,0,11,35,35
1746544023165,PSYC 193,A00,890913,Staff,19,0,30,11
1746544023165,PSYC 193,B00,890914,Chapman; Eddie Nathaniel,24,0,30,6
1746544024195,PSYC 193L,A01,890918,Lowe; Angela Beth,20,0,30,10
1746544024195,PSYC 193L,B01,890921,Hurwitz; Ethan Scott,20,0,30,10
1746544024195,PSYC 193L,C01,890928,Staff,30,0,30,0
1746544025223,RELI 149,A00,886806,Rahimi; Babak,23,0,40,17
1746544026251,SE 9,A01,886814,Staff,7,0,20,13
1746544027276,SE 101B,A01,886816,Chadha; Mayank,4,0,35,31
1746544028307,SE 110B,A00,886818,Zhu; Qiang,4,0,75,71
1746544029332,SE 125,A01,886830,Staff,10,0,30,20
1746544030355,SE 130B,A01,886835,Staff,14,0,40,26
1746544031383,SE 131A,A01,886838,Krysl; Petr,34,0,55,21
1746544032420,SE 154,A00,886840,Staff,30,0,50,20
1746544033447,SE 164GS,A01,886849,Staff,6,0,20,14
1746544034473,SE 167GS,A01,886853,Staff,6,0,20,14
1746544035498,SIO 25,A01,890107,Staff,19,0,30,11
1746544036525,SIO 45,A00,890109,Cook; Geoffrey W,117,0,200,83
1746544037553,SIO 109R,A00,890110,Forman; Fonna,0,16,20,20
1746544038580,SIO 187,A01,890114,Kacev; David,15,0,40,25
1746544039629,SOCI 1,A01,890431,Thorpe; Charles Robert,15,0,30,15
1746544039629,SOCI 1,A02,890518,Thorpe; Charles Robert,30,0,30,0
1746544040658,SOCI 2,A01,957978,Staff,25,0,25,0
1746544040658,SOCI 2,A02,957979,Staff,23,0,25,2
1746544041686,SOCI 20,A01,890523,Calderon-Zaks; Michael Aar,23,0,30,7
1746544041686,SOCI 20,A02,890526,Calderon-Zaks; Michael Aar,29,0,30,1
1746544042714,SOCI 30,A01,890533,Pardo Guerra; Juan Pablo,37,0,40,3
1746544043742,SOCI 40,A01,890535,Staff,27,0,45,18
1746544044774,SOCI 104Q,A00,890559,Staff,18,0,30,12
1746544045798,SOCI 106,A00,890560,Arnal; Maud Marie Leonie,20,0,30,10
1746544046822,SOCI 110,A00,890567,Holkenbrink-Monk; Charlene,19,0,30,11
1746544047849,SOCI 112,A00,890568,Victoria Torres; Pablo,1,0,55,54
1746544048875,SOCI 115,A00,890597,Arnal; Maud Marie Leonie,28,0,45,17
1746544050926,SOCI 121,A00,890604,Pardo Guerra; Juan Pablo,38,0,45,7
1746544051953,SOCI 126,A01,890608,Staff,8,0,10,2
1746544052978,SOCI 127,A00,890609,Staff,18,0,30,12
1746544054007,SOCI 131,A00,890610,Thorpe; Charles Robert,37,0,45,8
1746544055033,SOCI 135,A00,890615,Payne; Christine Anna,14,0,45,31
1746544056057,SOCI 139,A00,890620,Staff,38,0,45,7
1746544057087,SOCI 148E,A00,890622,Calderon-Zaks; Michael Aar,36,0,45,9
1746544058116,SOCI 150,A00,890623,Kohler; Kristopher M.,31,0,45,14
1746544059146,SOCI 157,A00,890625,Jules-Rosette; Bennetta W.,18,0,20,2
1746544060172,SOCI 160,A00,890627,Payne; Christine Anna,21,0,45,24
1746544061199,SYN 1,A00,886855,Fish; Gwendolyn Anne,0,0,0,0
1746544061199,SYN 1,B00,906086,Fish; Gwendolyn Anne,0,1,0,2
1746544062227,SYN 2R,A00,886860,Staff,0,17,15,15
1746544062227,SYN 2R,B00,906106,Atkinson; Arthur Laird,0,16,15,15
1746544063261,SYN 100,A01,886866,Browne; Emily,0,28,20,20
1746544063261,SYN 100,B01,906128,Rock; Martin,0,5,20,20
1746544063261,SYN 100,C01,906140,Deavenport; James Cary,0,3,20,20
1746544063261,SYN 100,D01,907816,Deavenport; James Cary,0,5,20,20
1746544064288,TDAC 1,A00,890286,Walsh; Kim C.,9,0,20,11
1746544065314,TDAC 101,A00,890296,Basso; Beatrice,16,0,20,4
1746544066338,TDDE 131,A00,890297,Staff,47,0,50,3
1746544067367,TDDM 1,A00,890287,Weinberg; Sadie,25,0,30,5
1746544068396,TDGE 11,A00,890288,Fulton; Julia,137,0,200,63
1746544068396,TDGE 11,B00,890289,Castro; Robert Jess,184,0,200,16
1746544069423,TDGE 25,B00,957359,Walsh; Kim C.,3,0,20,17
1746544070452,TDGE 40,A01,890292,Power; Jade Yukana,27,0,30,3
1746544071479,TDGE 124,A00,890298,Havis; Allan,0,0,50,50
1746544072504,TDGE 131R,A00,890299,Burelle; Julie Sara Veronique,15,0,42,27
1746544073531,TDHT 101,A00,890300,Staff,10,0,20,10
1746544074558,TDHT 109,A01,890302,Anderson; Mysia Anyse,31,0,40,9
1746544075622,TDMV 1,A00,890293,Arcidiacono; Kristin,18,0,30,12
1746544076650,TDMV 2,A00,890294,Weinberg; Sadie,23,0,30,7
1746544077675,TDMV 3,A00,957878,Arcidiacono; Kristin,28,0,30,2
1746544079729,TDMV 138,A00,890304,Jun; Grace Shin Hae,25,0,40,15
1746544080756,TDMV 140,A00,890305,Corrales; Joseph Bernales,25,0,30,5
1746544081782,TDMV 142,A00,890307,Caligagan; Tony,32,0,40,8
1746544082811,TDMV 144,A00,890308,Camaya; Michelle Ann,25,0,30,5
1746544083835,TDPW 1,A00,890295,Stein; Deborah Isobel,3,0,20,17
1746544084865,USP 2,A01,890272,Lerner; Amy M,6,0,20,14
1746544085889,USP 3,A01,890274,Staff,12,0,30,18
1746544086919,USP 15,A01,890276,Sun; Feiyang,17,0,30,13
1746544087945,USP 25,A00,890277,Shenkman; Michael Thomas,19,0,25,6
1746544088972,USP 138,A00,890278,Staff,13,0,25,12
1746544090000,USP 143,A00,890279,Staff,21,0,70,49
1746544091028,USP 144,A00,890280,Chowdhury; Muhammed Zohir,16,0,30,14
1746544092054,USP 150,A00,890281,Boomhower; Matthew Charles,4,0,30,26
1746544093080,USP 151,A00,890282,Staff,16,0,20,4
1746544094107,USP 162,A00,890283,Andrews; Abigail Leslie,16,0,20,4
1746544095137,USP 168,A00,920477,Kwak; Nancy,1,0,5,4
1746544096163,USP 181,A00,890284,Staff,3,0,20,17
1746544097189,USP 191A,A00,890285,Staff,13,0,20,7
1746544098217,VIS 101,A00,886512,Staff,25,0,75,50
1746544099243,VIS 103,A00,886513,Cruz; Edwin Teddy,61,0,75,14
1746544100271,VIS 108,A00,886514,Staff,3,0,15,12
1746544101298,VIS 127P,A00,886515,Shen; Kuiyi,80,0,146,66
1746544102327,VIS 149,A00,886516,Yoldas; Pinar,0,0,15,15
1746544103353,VIS 164,A00,886526,Erdmann; Dean,19,0,22,3
1746544104380,VIS 194S,A00,886527,Staff,61,0,75,14
1746544105407,WCWP 10A,C00,886484,Martiniuk; Jill,12,0,15,3
1746544106432,WCWP 10B,A00,886490,Uriarte; Emma,0,0,15,15
1746544106432,WCWP 10B,B00,886491,Dhir; Simrita,11,0,15,4
1746544106432,WCWP 10B,C00,886492,Ornelas; Tricia,0,0,15,15
1746544107460,WCWP 100,A00,886494,Young; Mark T,0,7,15,15
1746544109582,AAS 10,A01,886199,Childs; Dennis R.,0,3,0,0
1746544110608,ANAR 104,A01,886940,Shtienberg; Gilad,27,0,30,3
1746544111632,ANAR 120,A00,886953,Staff,12,0,20,8
1746544112664,ANBI 148,A01,886955,Wilder; Linnea Lorene,30,0,40,10
1746544114718,ANSC 122,A00,886957,Staff,25,0,30,5
1746544115747,ANSC 150,A00,886958,Sloane; Julia Kathryn,3,0,15,12
1746544116775,ANSC 156,A00,886959,Jenkins; Janis A.,0,1,15,15
1746544117799,ANSC 180,A00,886960,Staff,11,0,17,6
1746544118826,ANSC 188,A00,886961,Jassal; Aftab,9,0,25,16
1746544119850,ANSC 190,A00,886962,Jassal; Aftab,14,0,25,11
1746544120877,ANSC 191,A00,886963,Staff,18,0,20,2
1746544121905,ANTH 3,A01,891689,Staff,17,0,20,3
1746544122931,ANTH 5,A00,886933,Semendeferi; Ekaterini,16,0,20,4
1746544123960,ANTH 10,A00,886934,Staff,0,12,30,30
1746544124985,ANTH 21,A01,886936,Staff,40,0,60,20
1746544126013,ANTH 23,A01,886938,Staff,92,0,100,8
1746544127039,ANTH 105,A00,886964,Stewart; Alexander B,84,0,100,16
1746544128067,ANTH 108,A00,886965,Pedersen; David,9,0,20,11
1746544129100,AWP 10,001,886147,Staff,0,0,0,0
1746544129100,AWP 10,002,886148,Staff,0,0,0,0
1746544129100,AWP 10,003,886149,Staff,0,0,0,0
1746544129100,AWP 10,004,886150,Staff,0,0,0,0
1746544129100,AWP 10,005,886151,Staff,0,0,0,0
1746544129100,AWP 10,006,886152,Staff,0,0,0,0
1746544129100,AWP 10,007,886153,Staff,0,0,0,0
1746544129100,AWP 10,008,886154,Staff,0,0,0,0
1746544129100,AWP 10,009,886155,Staff,0,0,0,0
1746544129100,AWP 10,010,886156,Staff,0,0,0,0
1746544129100,AWP 10,011,886158,Staff,0,0,0,0
1746544129100,AWP 10,012,886160,Staff,0,0,0,0
1746544129100,AWP 10,013,886161,Staff,0,0,0,0
1746544129100,AWP 10,014,886162,Staff,0,0,0,0
1746544129100,AWP 10,015,886163,Staff,0,0,0,0
1746544129100,AWP 10,016,886164,Staff,0,0,0,0
1746544129100,AWP 10,017,886165,Staff,0,0,0,0
1746544129100,AWP 10,018,886166,Staff,0,0,0,0
1746544129100,AWP 10,019,886168,Staff,0,0,0,0
1746544129100,AWP 10,020,886170,Staff,0,0,0,0
1746544129100,AWP 10,021,886172,Staff,0,0,0,0
1746544130127,AWP 10R,001,886173,Staff,0,1,0,0
1746544130127,AWP 10R,002,886174,Staff,0,1,0,0
1746544130127,AWP 10R,003,886175,Staff,0,0,0,0
1746544130127,AWP 10R,004,886176,Staff,0,0,0,0
1746544130127,AWP 10R,005,886177,Staff,0,0,0,0
1746544130127,AWP 10R,006,886178,Staff,0,0,0,0
1746544130127,AWP 10R,007,886179,Staff,0,0,0,0
1746544130127,AWP 10R,008,886181,Staff,0,0,0,0
1746544130127,AWP 10R,009,886182,Staff,0,0,0,0
1746544130127,AWP 10R,010,886183,Staff,0,0,0,0
1746544130127,AWP 10R,011,886184,Staff,0,0,0,0
1746544130127,AWP 10R,012,886185,Staff,0,0,0,0
1746544130127,AWP 10R,013,886186,Staff,0,0,0,0
1746544130127,AWP 10R,014,886187,Staff,0,0,0,0
1746544130127,AWP 10R,015,886188,Staff,0,0,0,0
1746544130127,AWP 10R,016,886189,Staff,0,0,0,0
1746544131152,AWP 102R,A00,886190,Staff,0,0,0,0
1746544131152,AWP 102R,B00,886191,Staff,0,0,0,0
1746544132180,BENG 100,A01,886193,Staff,17,0,30,13
1746544133206,BENG 122A,A01,886195,Hasty; Jeff M,13,0,30,17
1746544134234,BENG 166A,A00,886196,Sah; Robert Lie-Yuan,0,1,30,30
1746544135259,BENG 190,A00,958050,Khojah; Reem I,24,0,25,1
1746544136285,BIBC 102,A01,894320,Staff,0,0,46,46
1746544136285,BIBC 102,A02,894321,Staff,0,0,46,46
1746544136285,BIBC 102,A03,894344,Staff,7,0,46,39
1746544136285,BIBC 102,A04,894345,Staff,26,0,47,21
1746544137316,BICD 100R,A01,894365,Smith; Laurie,0,3,58,58
1746544137316,BICD 100R,A02,894366,Smith; Laurie,0,5,58,58
1746544137316,BICD 100R,A03,894367,Smith; Laurie,2,0,59,57
1746544137316,BICD 100R,A04,959869,Smith; Laurie,41,0,59,18
1746544138346,BICD 136,A01,894383,Gustafson-Brown; Cindy,14,0,50,36
1746544139377,BIEB 102,A01,894494,Butler; Shannon Rhey,51,0,130,79
1746544141431,BIEB 150,A01,894617,Wills; Christopher,3,0,20,17
1746544141431,BIEB 150,A02,894631,Wills; Christopher,3,0,20,17
1746544141431,BIEB 150,A03,894937,Wills; Christopher,3,0,20,17
1746544141431,BIEB 150,A04,894946,Wills; Christopher,5,0,20,15
1746544142458,BIEB 194,A00,906141,Kurle; Carolyn M.,6,0,20,14
1746544143486,BILD 1,A01,894154,Staff,2,0,19,17
1746544143486,BILD 1,A02,894155,Staff,14,0,19,5
1746544143486,BILD 1,A03,894160,Staff,13,0,19,6
1746544143486,BILD 1,A04,894161,Staff,15,0,18,3
1746544144511,BILD 2,A01,894168,Staff,0,0,50,50
1746544144511,BILD 2,A02,894169,Staff,0,0,50,50
1746544144511,BILD 2,A03,894179,Staff,4,0,50,46
1746544144511,BILD 2,A04,894203,Staff,27,0,50,23
1746544145537,BILD 3,A01,894213,Staff,22,0,31,9
1746544145537,BILD 3,A02,894214,Staff,26,0,31,5
1746544145537,BILD 3,A03,894235,Staff,28,0,31,3
1746544145537,BILD 3,A04,894236,Staff,28,0,32,4
1746544146562,BILD 4,A01,894253,Reuther; Keefe,5,0,24,19
1746544146562,BILD 4,A02,894258,Reuther; Keefe,16,0,24,8
1746544147593,BILD 5,A01,894276,Reuther; Keefe,35,0,50,15
1746544147593,BILD 5,A02,894277,Reuther; Keefe,45,0,50,5
1746544147593,BILD 5,A03,894290,Reuther; Keefe,44,0,50,6
1746544147593,BILD 5,A04,894291,Reuther; Keefe,48,0,50,2
1746544148621,BILD 24,A01,894297,Pirino; Giorgia,40,0,60,20
1746544149648,BIMM 100,B01,958915,Staff,72,0,100,28
1746544150675,BIMM 101,A01,895017,McDonnell; Lisa Marie,0,5,24,24
1746544150675,BIMM 101,A02,895018,McDonnell; Lisa Marie,0,5,24,24
1746544150675,BIMM 101,B01,895020,McDonnell; Lisa Marie,0,6,24,24
1746544150675,BIMM 101,B02,895021,McDonnell; Lisa Marie,0,4,24,24
1746544151701,BIMM 110,A01,895023,Staff,1,0,25,24
1746544151701,BIMM 110,A02,895024,Staff,9,0,25,16
1746544151701,BIMM 110,A03,895025,Staff,18,0,25,7
1746544151701,BIMM 110,A04,895031,Staff,20,0,25,5
1746544152731,BIMM 120,A01,895114,Gustafson-Brown; Cindy,13,0,28,15
1746544152731,BIMM 120,A02,895126,Gustafson-Brown; Cindy,21,0,27,6
1746544153762,BIPN 100,A01,895130,Yang; Mingyu,1,0,38,37
1746544153762,BIPN 100,A02,895131,Yang; Mingyu,32,0,38,6
1746544153762,BIPN 100,A03,895132,Yang; Mingyu,32,0,38,6
1746544153762,BIPN 100,A04,895133,Yang; Mingyu,27,0,36,9
1746544154790,BIPN 120,A01,895135,Cooke; James Edward,0,3,13,13
1746544154790,BIPN 120,A02,895136,Cooke; James Edward,0,1,13,13
1746544154790,BIPN 120,A03,895137,Cooke; James Edward,0,3,13,13
1746544154790,BIPN 120,A04,895156,Cooke; James Edward,0,2,11,11
1746544155817,BIPN 134,A01,895235,Cooke; James Edward,0,2,25,25
1746544155817,BIPN 134,A02,895237,Cooke; James Edward,0,0,25,25
1746544155817,BIPN 134,A03,895240,Cooke; James Edward,3,0,25,22
1746544155817,BIPN 134,A04,895270,Cooke; James Edward,20,0,25,5
1746544156843,BIPN 189,A00,892103,Staff,0,13,14,14
1746544158896,BISP 194,A00,958008,Staff,0,2,0,0
1746544159925,CAT 124,A01,922009,Staff,0,5,20,20
1746544160952,CAT 125R,A00,886390,Morales; Celeste Georgianna,0,2,20,20
1746544160952,CAT 125R,B00,886391,Irwin; Matthew Joseph,0,3,20,20
1746544160952,CAT 125R,C00,886392,Smith; Lauryn Alissa,0,2,20,20
1746544160952,CAT 125R,D00,886393,Vanderschuit; Maya Alysia,0,2,20,20
1746544160952,CAT 125R,E00,886394,Marchisotto; Jennifer Anne,0,4,20,20
1746544161977,CENG 15,A01,886218,Drews; Aaron,3,0,8,5
1746544163003,CENG 113,A00,886219,Opatkiewicz; Justin Paul,15,0,25,10
1746544164027,CGS 101,A00,887044,Staff,7,0,20,13
1746544165057,CGS 105,A01,887046,Staff,14,0,25,11
1746544166082,CGS 112,A00,887047,Cuong; Marisol,12,0,15,3
1746544167110,CGS 113,A00,887048,Staff,23,0,30,7
1746544168136,CGS 120,A00,887049,Staff,10,0,17,7
1746544169163,CHEM 6A,A01,886336,Lam; Tin Yiu,38,0,50,12
1746544169163,CHEM 6A,A02,886338,Lam; Tin Yiu,37,0,50,13
1746544170194,CHEM 6B,A01,886341,Hopkins; Patrycja Anna,16,0,50,34
1746544170194,CHEM 6B,A02,886343,Hopkins; Patrycja Anna,42,0,50,8
1746544171225,CHEM 6C,A01,886346,Albizati; Kim F.,0,2,50,50
1746544171225,CHEM 6C,A02,886348,Albizati; Kim F.,23,0,50,27
1746544172253,CHEM 40A,A01,886352,Klosterman; Jeremy K,65,0,100,35
1746544173282,CHEM 40B,A01,886356,Klosterman; Jeremy K,0,23,100,100
1746544174306,CHEM 41B,A01,886360,Theodorakis; Emmanuel,25,0,50,25
1746544174306,CHEM 41B,A02,886362,Theodorakis; Emmanuel,47,0,50,3
1746544175333,CHIN 165A,A00,886382,Xu; Li,18,0,20,2
1746544176358,CLAS 120,A00,886387,Myerston Santana; Jacobo,33,0,40,7
1746544177385,COGS 9,A01,886967,Shannon; Kyle Michael,42,0,60,18
1746544178410,COGS 11,A01,886969,Staff,11,0,30,19
1746544179494,COGS 14A,A01,886971,Staff,6,0,60,54
1746544180523,COGS 14B,A01,886973,Hoffman; Drew Ellen,4,0,60,56
1746544181551,COGS 18,A01,886975,Morgan; Eric,35,0,60,25
1746544182578,COGS 20,A01,886977,Staff,4,0,8,4
1746544182578,COGS 20,A02,886978,Staff,5,0,7,2
1746544183605,COGS 100,A01,907783,Staff,0,2,30,30
1746544184630,COGS 101B,A01,886980,Staff,0,3,48,48
1746544185657,COGS 101C,A01,886982,Delgado; Tania,0,5,44,44
1746544186682,COGS 102A,A01,886984,Johnson; Christine M.,4,0,30,26
1746544187713,COGS 118B,A01,886986,Staff,0,3,88,88
1746544188742,COGS 150,A01,886988,Bergen; Benjamin,23,0,50,27
1746544189769,COGS 153,A00,886989,Delgado; Tania,0,2,41,41
1746544190798,COGS 186,A01,886991,Staff,0,0,32,32
1746544191827,COGS 187A,A01,886993,Boyle; Mary E. T.,7,0,30,23
1746544192855,COGS 189,A00,886994,Staff,0,1,30,30
1746544193881,COMM 10,A01,886996,Staff,0,0,20,21
1746544193881,COMM 10,A02,886997,Staff,12,0,20,8
1746544193881,COMM 10,A03,959845,Staff,19,0,20,1
1746544194908,COMM 20,A01,886999,Leuning; Grant Maurstad,24,0,40,16
1746544196962,COMM 100A,A01,887002,Staff,0,0,20,25
1746544196962,COMM 100A,A02,887003,Staff,7,0,20,13
1746544197988,COMM 100B,A01,887005,Staff,0,8,20,24
1746544199013,COMM 106D,A00,887006,Staff,14,0,40,26
1746544200042,COMM 110G,A00,887007,Whitworth-Smith; Andrew C,12,0,40,28
1746544201070,COMM 111B,A00,887008,Staff,31,0,40,9
1746544202097,COMM 113T,A00,887009,Abuelhiga; Soraya Jill,28,0,40,12
1746544202097,COMM 113T,B00,906733,Staff,40,0,40,0
1746544203135,COMM 145,A00,887010,Staff,12,0,40,28
1746544204163,COMM 146,A00,887054,Staff,31,0,40,9
1746544205195,COMM 190,A00,887012,Staff,8,0,23,15
1746544206225,CSE 8A,A50,887015,Cao; Yingjun,57,0,85,28
1746544207253,CSE 11,A01,887017,Cao; Yingjun,12,0,70,58
1746544208278,CSE 20,A01,887019,Staff,30,0,50,20
1746544209305,CSE 21,A01,887021,Staff,78,0,100,22
1746544209305,CSE 21,B01,892583,Braun; Oliver,45,0,50,5
1746544210332,CSE 30,A01,887025,Eldon; John,143,0,200,57
1746544211361,CSE 100,A01,887027,Staff,26,0,50,24
1746544211361,CSE 100,A02,887028,Staff,40,0,50,10
1746544212401,CSE 101,A01,887030,Braun; Oliver,75,0,100,25
1746544212401,CSE 101,B01,887032,Jones; Miles E,0,3,50,50
1746544212401,CSE 101,B02,887033,Jones; Miles E,0,1,50,50
1746544213427,CSE 105,A01,908084,Jones; Miles E,32,0,50,18
1746544213427,CSE 105,A02,908087,Jones; Miles E,33,0,50,17
1746544214454,CSE 135,A01,887035,Powell; Thomas Allan,0,4,50,50
1746544215479,CSE 142,A01,887037,Staff,8,0,60,52
1746544216506,CSE 142L,A01,887039,Staff,34,0,60,26
1746544217531,CSE 151A,A01,887041,Solares; Edwin A,48,0,100,52
1746544218556,CSE 175,A01,887043,Kumar; Rakesh,30,0,30,0
1746544219583,CSS 1,A01,886389,Staff,0,1,40,40
1746544220610,DSC 30,A01,908097,Liao; Soohyun Nam,47,0,75,28
1746544221639,DSC 40A,A01,908099,Shannon; Kyle Michael,30,0,50,20
1746544222665,DSC 40B,A01,908112,Staff,16,0,50,34
1746544223690,DSC 80,A01,908116,Staff,19,0,60,41
1746544224716,DSC 197,001,956863,Eldridge; Justin Matthew,9999,0,9999,0
1746544225744,ECE 5,A01,886400,Morris; Karcher William,2,0,6,4
1746544225744,ECE 5,A02,886401,Morris; Karcher William,3,0,6,3
1746544226769,ECE 148,A01,886403,Silberman; Jack,0,14,14,14
1746544227797,ECON 1,A01,887265,Crane; Meredith Helen,12,0,70,58
1746544227797,ECON 1,B01,887268,Staff,43,0,50,7
1746544228822,ECON 2,A01,887273,Crane; Meredith Helen,56,0,70,14
1746544229851,ECON 3,A01,887279,Rondina; Giacomo,32,0,70,38
1746544230875,ECON 4,A01,887282,Anderson; John Charles,0,2,10,10
1746544231903,ECON 5,A01,887285,Staff,33,0,45,12
1746544231903,ECON 5,B01,887292,Staff,41,0,45,4
1746544232931,ECON 100A,A01,887337,Newhouse; Herbert S,54,0,70,16
1746544232931,ECON 100A,B01,887349,Staff,45,0,50,5
1746544233956,ECON 100B,A01,887361,Du; Songzi,29,0,70,41
1746544234997,ECON 100C,A01,887445,Newhouse; Herbert S,59,0,70,11
1746544236025,ECON 105,A00,887488,Vespa; Emanuel Ignacio,23,0,35,12
1746544237056,ECON 109,A01,887506,Shishkin; Denis,28,0,35,7
1746544238084,ECON 110A,A01,887568,Alon; Titan Michael,0,3,35,35
1746544238084,ECON 110A,B01,907601,Alon; Titan Michael,20,0,35,15
1746544239108,ECON 110B,A01,887598,Levkoff; Steven B.,0,23,70,70
1746544240140,ECON 112,A00,887599,Rondina; Giacomo,19,0,35,16
1746544241167,ECON 120A,A01,887603,Dai; Yinlin,36,0,70,34
1746544242195,ECON 120C,A01,887608,Sun; Yixiao,0,1,35,35
1746544242195,ECON 120C,B01,887614,Sun; Yixiao,0,0,35,35
1746544243225,ECON 138,A00,887621,Bharadwaj; Prashant,0,20,20,20
1746544244250,ECON 144,A00,958007,Squires; Dale E,13,0,35,22
1746544245275,ECON 171,A01,907666,Staff,18,0,35,17
1746544246304,ECON 175,A00,887626,Wu; Pak Yeung,23,0,35,12
1746544247327,ECON 190,A00,887640,Vespa; Emanuel Ignacio,23,0,35,12
1746544248411,EDS 25,A01,888197,Staff,0,0,0,0
1746544248411,EDS 25,A02,888209,Staff,0,0,0,0
1746544248411,EDS 25,A03,888210,Staff,0,0,0,0
1746544248411,EDS 25,A04,888212,Staff,0,0,0,0
1746544248411,EDS 25,A05,888213,Staff,0,0,0,0
1746544248411,EDS 25,A06,888214,Staff,0,0,0,0
1746544248411,EDS 25,A07,888235,Staff,0,2,0,0
1746544248411,EDS 25,A08,888236,Staff,0,0,0,0
1746544248411,EDS 25,A09,888240,Staff,0,0,0,0
1746544248411,EDS 25,A10,888244,Staff,0,0,0,0
1746544248411,EDS 25,B01,888273,Staff,0,0,0,0
1746544248411,EDS 25,B02,888285,Staff,0,0,0,0
1746544248411,EDS 25,B03,888423,Staff,0,0,0,1
1746544248411,EDS 25,B04,888432,Staff,0,0,0,0
1746544248411,EDS 25,B05,888433,Staff,0,0,0,0
1746544248411,EDS 25,B06,888467,Staff,0,0,0,0
1746544248411,EDS 25,B07,888468,Staff,0,0,0,0
1746544248411,EDS 25,B08,888479,Staff,0,0,0,0
1746544248411,EDS 25,B09,888484,Staff,0,0,0,0
1746544248411,EDS 25,B10,888487,Staff,0,0,0,0
1746544249438,EDS 38,A01,907700,Choi; Bailey Miyeon,30,0,30,0
1746544250466,EDS 112,A01,888601,Chapman; Thandeka K,14,0,40,26
1746544251496,EDS 115,A00,888697,Mendez; Kathrina Mendoza,10,0,30,20
1746544252525,EDS 116,A01,888893,Staff,35,0,40,5
1746544254578,EDS 124AR,A00,889133,Staff,29,0,50,21
1746544254578,EDS 124AR,B00,907471,Simon; Elizabeth A,37,0,50,13
1746544255604,EDS 124BR,A00,889134,Simon; Elizabeth A,45,0,100,55
1746544256628,EDS 125,A00,889135,Staff,25,0,30,5
1746544257653,EDS 126,A01,889138,Staff,36,0,40,4
1746544258680,EDS 164R,A01,889142,Wishard Guerra; Alison G.,33,0,50,17
1746544259708,ENG 30,A01,886396,Staff,0,0,0,0
1746544259708,ENG 30,B01,886398,Staff,0,0,0,0
1746544260737,ENVR 102,A00,906150,Montejo; Carolina,23,0,25,2
1746544261764,ETHN 103A,A00,887236,Man; Simeon S,0,3,0,0
1746544262789,ETHN 113,A00,887239,Staff,16,0,30,14
1746544263816,ETHN 116,A00,887240,Staff,16,0,25,9
1746544264847,ETHN 117,A00,887241,Choi; Esther Min,28,0,30,2
1746544265872,ETHN 118,A00,887243,Staff,24,0,30,6
1746544266899,ETHN 127,A00,887248,Cuong; Marisol,11,0,15,4
1746544267926,ETHN 139,A00,887250,Staff,7,0,10,3
1746544268954,ETHN 142,A00,887252,Staff,10,0,30,20
1746544269981,ETHN 161,A00,887253,Browne; Errol Tsekani,24,0,30,6
1746544271007,ETHN 163FR,A00,887255,Burelle; Julie Sara Veronique,0,0,5,5
1746544272038,GLBH 20,A00,889149,Elwardani; Nile Regina,8,0,42,34
1746544274090,GLBH 111,A01,889152,Burgos; Jose L.,17,0,17,0
1746544275115,GLBH 150,A00,889181,Sloane; Julia Kathryn,0,5,15,15
1746544277169,HDS 60,A01,886406,Warstadt; Melissa Fawn,73,0,80,7
1746544278192,HIAF 111,A00,889324,Gyamfi; Bright,25,0,32,7
1746544279218,HIEA 131,A00,889328,Staff,16,0,32,16
1746544280245,HIEA 144,A00,889333,Henry; Todd A.,26,0,32,6
1746544281274,HIEA 154,A00,889336,Henry; Todd A.,24,0,32,8
1746544282302,HIEU 106,A00,889339,Staff,22,0,32,10
1746544284353,HIEU 114,A00,889340,Staff,3,0,32,29
1746544285381,HIEU 135GS,A00,889342,Patterson; Patrick H.,0,0,1,24
1746544286409,HIEU 137,A00,889343,Edington; Claire Ellen,9,0,25,16
1746544287435,HIEU 148,A00,889345,Staff,14,0,32,18
1746544288460,HIEU 154,A00,889346,Biess; Frank Peter,21,0,32,11
1746544289486,HILA 102,A00,889351,Staff,12,0,32,20
1746544290510,HILD 2A,A01,889221,Lewandoski; Julia Mavis,1,10,32,31
1746544291539,HILD 7B,A01,889225,Man; Simeon S,0,13,32,32
1746544292567,HILD 7C,A01,889288,Alvarez; Luis A,0,14,32,32
1746544293595,HILD 30,A01,889323,Staff,0,5,32,32
1746544295645,HISC 119,A00,889383,Golan; Tal,21,0,32,11
1746544296671,HIUS 103,A00,889384,Man; Simeon S,0,0,32,32
1746544297699,HIUS 117,A00,919797,Kwak; Nancy,18,0,32,14
1746544298724,HIUS 142A,A00,919788,Staff,22,0,32,10
1746544300777,HIUS 149,A00,889386,Gyamfi; Bright,27,0,32,5
1746544301801,HIUS 155,A00,889387,Alvarez; Luis A,14,0,32,18
1746544302826,HUM 3,A01,886499,Caldwell; Michael Alan,19,0,50,31
1746544303851,HUM 3GS,A00,886500,Rodriguez; Bretton Sigfred,0,0,0,28
1746544304878,HUM 3R,A01,886502,Markman; Kristina,0,36,50,50
1746544305908,HUM 4,A01,886504,Crum; Matthew Stephen,24,0,50,26
1746544305908,HUM 4,B01,886506,West; Geoffrey Scott,17,0,50,33
1746544306935,HUM 4GS,A00,886507,Staff,0,0,0,19
1746544307963,HUM 5,A01,886509,Staff,32,0,50,18
1746544308988,HUM 5R,A01,886511,Zavodny; Tatiana Sophia,0,39,50,50
1746544310014,JAPN 180,A00,886407,Staff,18,0,40,22
1746544311043,LATI 50,A01,886409,Martin-Cabrera; Luis,4,0,22,18
1746544311043,LATI 50,A02,886410,Martin-Cabrera; Luis,19,0,22,3
1746544311043,LATI 50,A03,886411,Martin-Cabrera; Luis,21,0,22,1
1746544311043,LATI 50,A04,886412,Martin-Cabrera; Luis,9,0,22,13
1746544312070,LAWS 101,A00,907664,Staff,28,0,60,32
1746544313095,LIAB 1A,A00,889388,Saab; Dima,17,0,20,3
1746544314122,LIAB 1AX,A00,889389,El Cheddadi; Youniss,17,0,20,3
1746544315149,LIFR 1C,A00,889391,Van Moer; Vinciane G,8,0,20,12
1746544316175,LIFR 1CX,A00,889392,Van Moer; Vinciane G,7,0,20,13
1746544317202,LIFR 1D,A00,889393,Van Moer; Vinciane G,7,0,20,13
1746544318229,LIFR 1DX,A00,889394,Van Moer; Vinciane G,8,0,20,12
1746544319256,LIGN 7,A00,886923,Staff,24,0,50,26
1746544320284,LIGN 17,A00,886924,Kehler; Andrew Scott,125,0,150,25
1746544321310,LTAM 110,A00,889395,Staff,15,0,30,15
1746544322335,LTAM 110GS,A00,958010,Rodriguez; Bretton Sigfred,0,0,0,28
1746544323361,LTCH 101,A00,889397,Staff,23,0,25,2
1746544324387,LTCS 130,A00,889398,Staff,23,0,25,2
1746544325413,LTEA 138,A00,889399,Staff,24,0,40,16
1746544326443,LTEN 149,A00,889400,Wesling; Megan E.,0,3,25,25
1746544327468,LTEN 169,A00,889401,Staff,20,0,25,5
1746544328497,LTEN 180,A00,889402,Staff,10,0,15,5
1746544329525,LTEN 181,A00,889403,Staff,21,0,25,4
1746544330550,LTWL 100,A00,889404,Myerston Santana; Jacobo,3,0,25,22
1746544331578,LTWL 180GS,A00,889405,Staff,0,0,20,20
1746544332603,LTWL 181,A00,889406,Staff,17,0,25,8
1746544333631,LTWL 184,A00,889475,Mukherjee; Silpa,22,0,25,3
1746544334657,LTWR 102C,A00,889486,Staff,29,0,30,1
1746544335681,LTWR 115W,A00,889491,Staff,0,2,15,15
1746544336706,MAE 8,A01,886905,Staff,0,2,0,0
1746544337732,MAE 11,A00,886906,Bandaru; Prabhakar,0,7,50,50
1746544338760,MAE 20,A00,886907,Evdokimenko; Ekaterina,44,0,70,26
1746544339786,MAE 30B,A00,886909,Ghazinejad; Maziar,26,0,45,19
1746544340814,MAE 101B,A00,886910,Saintillan; David,29,0,45,16
1746544341842,MAE 105,A00,886911,Bandaru; Prabhakar,18,0,50,32
1746544342870,MAE 107,B00,958024,Staff,9,0,50,41
1746544343897,MAE 143B,A00,886913,Bewley; Thomas R,7,0,40,33
1746544344924,MAE 148,A01,886915,Silberman; Jack,0,3,14,14
1746544345991,MAE 160,A00,886916,Evdokimenko; Ekaterina,31,0,60,29
1746544347017,MATH 3C,A01,889681,Staff,0,3,30,30
1746544347017,MATH 3C,A02,960048,Staff,25,0,30,5
1746544348043,MATH 10A,A01,889760,Staff,26,0,30,4
1746544348043,MATH 10A,A02,889783,Staff,29,0,30,1
1746544349073,MATH 10B,A01,889785,Verstraete; Jacques Allan,2,0,35,33
1746544349073,MATH 10B,A02,889795,Verstraete; Jacques Allan,4,0,35,31
1746544349073,MATH 10B,B01,889797,Verstraete; Jacques Allan,3,0,35,32
1746544349073,MATH 10B,B02,889828,Verstraete; Jacques Allan,3,0,35,32
1746544350101,MATH 10C,A01,889849,Habib; Yousaf,9,0,30,21
1746544350101,MATH 10C,A02,889852,Habib; Yousaf,14,0,30,16
1746544350101,MATH 10C,A03,889853,Habib; Yousaf,22,0,30,8
1746544350101,MATH 10C,A04,889858,Habib; Yousaf,20,0,30,10
1746544350101,MATH 10C,B01,889861,Staff,1,0,30,29
1746544350101,MATH 10C,B02,889862,Staff,24,0,30,6
1746544350101,MATH 10C,B03,889863,Staff,27,0,30,3
1746544350101,MATH 10C,B04,889967,Staff,23,0,30,7
1746544351125,MATH 18,A01,889974,Staff,7,0,30,23
1746544351125,MATH 18,A02,889977,Staff,20,0,30,10
1746544351125,MATH 18,B01,889984,Hardiman; Liam,22,0,30,8
1746544351125,MATH 18,B02,889985,Hardiman; Liam,25,0,30,5
1746544352165,MATH 20A,A01,889990,Suk; Andrew Hoon,29,0,35,6
1746544353191,MATH 20B,A01,889993,Ohm; Ko Woon,22,0,30,8
1746544353191,MATH 20B,A02,889994,Ohm; Ko Woon,30,0,30,0
1746544353191,MATH 20B,B01,889996,Ohm; Ko Woon,21,0,30,9
1746544353191,MATH 20B,B02,889997,Ohm; Ko Woon,23,0,30,7
1746544354221,MATH 20C,A01,889999,Hammock; Frances H,17,0,30,13
1746544354221,MATH 20C,A02,890003,Hammock; Frances H,23,0,30,7
1746544354221,MATH 20C,B01,890006,Hammock; Frances H,3,0,30,27
1746544354221,MATH 20C,B02,890007,Hammock; Frances H,11,0,30,19
1746544355249,MATH 20D,A01,890011,Cheng; Hsiao-Bing,1,1,30,29
1746544355249,MATH 20D,A02,890012,Cheng; Hsiao-Bing,14,0,30,16
1746544355249,MATH 20D,B01,890016,Cheng; Hsiao-Bing,13,0,30,17
1746544355249,MATH 20D,B02,890017,Cheng; Hsiao-Bing,13,0,30,17
1746544356277,MATH 20E,A01,890026,Harel; Guershon,1,0,30,29
1746544356277,MATH 20E,A02,890029,Harel; Guershon,23,0,30,7
1746544356277,MATH 20E,B01,890033,Harel; Guershon,7,0,30,23
1746544356277,MATH 20E,B02,890101,Harel; Guershon,21,0,30,9
1746544357306,MATH 102,A01,890104,Staff,17,0,30,13
1746544357306,MATH 102,A02,890105,Staff,27,0,30,3
1746544358332,MATH 103B,A01,890116,Salehi Golsefidy; Alireza,3,0,30,27
1746544358332,MATH 103B,B01,890118,Staff,0,3,34,34
1746544359358,MATH 109,A01,890121,Aliabadi Sr.; Mohsen,1,0,30,29
1746544359358,MATH 109,B01,890124,Upadrashta; Pranav Kumar,18,0,30,12
1746544360385,MATH 120A,A01,890126,Eggers; John Dietrich,13,0,30,17
1746544361413,MATH 142B,A01,890128,Ioana; Adrian,19,0,30,11
1746544361413,MATH 142B,A02,890129,Ioana; Adrian,13,0,30,17
1746544362441,MATH 154,A01,890174,Staff,0,0,30,30
1746544362441,MATH 154,A02,890182,Staff,0,0,30,30
1746544363469,MATH 168A,A01,890197,Dumitriu; Ioana,21,0,35,14
1746544364497,MATH 170A,A01,890240,Nie; Jiawang,1,0,30,29
1746544364497,MATH 170A,A02,890241,Nie; Jiawang,11,0,30,19
1746544364497,MATH 170A,A03,890249,Nie; Jiawang,23,0,30,7
1746544365526,MATH 170B,A01,957891,Nag; Panchali,13,0,35,22
1746544367580,MATH 181A,A01,908025,Staff,0,4,35,35
1746544367580,MATH 181A,A02,960115,Staff,27,0,35,8
1746544368607,MATH 181B,A01,959874,Staff,26,0,30,4
1746544369632,MATH 193B,A01,890265,Staff,0,4,35,35
1746544370661,MGT 4,A01,890311,Anderson; John Charles,42,0,88,46
1746544371688,MGT 5,A00,907740,Staff,13,0,98,85
1746544372717,MGT 12,A00,890312,Lindenberger; Wade Douglas,67,0,98,31
1746544373748,MGT 16,A00,957883,Staff,78,0,98,20
1746544375805,MGT 45,A00,890314,Pecore; Joseph P.,47,0,98,51
1746544376834,MGT 71,A00,890315,Staff,0,11,98,98
1746544377859,MGT 100,A00,890316,Yavorsky; Daniel Ryan,44,0,98,54
1746544378884,MGT 103,A00,890317,Ehrich; Kristine R,73,0,98,25
1746544379938,MGT 105,A00,890356,Bates; Kenneth Walter,0,7,98,98
1746544380963,MGT 112,A00,890360,Ehrich; Kristine R,55,0,98,43
1746544381998,MGT 127R,A00,907732,Zhu; Kevin Xiaoguo,23,0,98,75
1746544383027,MGT 131B,A00,890361,Anderson; John Charles,61,0,98,37
1746544384052,MGT 137,A00,890362,Lindenberger; Wade Douglas,65,0,98,33
1746544385083,MGT 160,A00,890369,Johnson; Erik Barry,9,0,98,89
1746544387136,MGT 164,A00,890372,Zimmermann; Carsten,0,39,98,98
1746544388165,MGT 180,A00,890374,Bliss; Barbara Ann,12,0,98,86
1746544389196,MMW 15,A01,886414,Chang; Edmond Yi-Teh,0,12,28,28
1746544389196,MMW 15,A02,886415,Chang; Edmond Yi-Teh,0,8,28,28
1746544389196,MMW 15,A03,886416,Chang; Edmond Yi-Teh,0,8,28,28
1746544389196,MMW 15,A04,886417,Chang; Edmond Yi-Teh,0,8,28,28
1746544389196,MMW 15,B01,886419,Chang; Edmond Yi-Teh,0,7,28,28
1746544389196,MMW 15,B02,886420,Chang; Edmond Yi-Teh,0,8,28,28
1746544389196,MMW 15,B03,886421,Chang; Edmond Yi-Teh,0,7,28,28
1746544389196,MMW 15,B04,886422,Chang; Edmond Yi-Teh,0,8,28,28
1746544389196,MMW 15,C01,886424,Staff,0,9,28,28
1746544389196,MMW 15,C02,886425,Staff,0,8,28,28
1746544389196,MMW 15,C03,886426,Staff,0,8,28,28
1746544389196,MMW 15,C04,886427,Staff,0,7,28,28
1746544389196,MMW 15,C05,958038,Staff,0,7,28,28
1746544389196,MMW 15,C06,958039,Staff,0,8,28,28
1746544390224,MMW 15GS,A00,906910,Patterson; Patrick H.,4,0,28,24
1746544391251,MMW 122R,A01,886429,Rahimi; Babak,0,13,28,28
1746544391251,MMW 122R,A02,886430,Rahimi; Babak,0,12,28,28
1746544391251,MMW 122R,A03,958040,Rahimi; Babak,0,11,28,28
1746544392276,MUS 1A,A01,890937,Staff,3,0,25,22
1746544392276,MUS 1A,A02,891035,Staff,6,0,25,19
1746544392276,MUS 1A,C01,958912,Staff,24,0,25,1
1746544392276,MUS 1A,C02,958913,Staff,25,0,25,0
1746544394328,MUS 2AK,A00,957092,Ohnishi; Takae,15,0,15,0
1746544395354,MUS 4,A01,891044,Staff,2,0,25,23
1746544395354,MUS 4,A02,891045,Staff,23,0,25,2
1746544395354,MUS 4,B01,891048,Staff,17,0,25,8
1746544395354,MUS 4,B02,891050,Staff,25,0,25,0
1746544396385,MUS 5,A01,957506,Dubnov; Shlomo,0,0,25,25
1746544396385,MUS 5,A02,957622,Dubnov; Shlomo,14,0,25,11
1746544396385,MUS 5,A03,957623,Dubnov; Shlomo,20,0,25,5
1746544397410,MUS 6,A01,891053,Freitas Caetano; Marcelo,24,0,25,1
1746544397410,MUS 6,A02,891054,Freitas Caetano; Marcelo,23,0,25,2
1746544398434,MUS 7,A01,891081,Staff,0,0,25,25
1746544398434,MUS 7,A02,891082,Staff,4,0,25,21
1746544399461,MUS 8GS,A00,891118,Borgo; David Garcia,0,0,25,25
1746544400486,MUS 11,A01,891140,Staff,11,0,25,14
1746544400486,MUS 11,A02,891141,Staff,22,0,25,3
1746544401517,MUS 13,A01,891143,Staff,8,0,25,17
1746544401517,MUS 13,A02,891144,Staff,24,0,25,1
1746544402547,MUS 15,A01,891146,Staff,9,0,25,16
1746544402547,MUS 15,A02,891148,Staff,21,0,25,4
1746544402547,MUS 15,B01,891150,Staff,18,0,25,7
1746544402547,MUS 15,B02,891151,Staff,25,0,25,0
1746544403573,MUS 20,A01,891153,Staff,5,0,20,15
1746544403573,MUS 20,A02,891155,Staff,14,0,20,6
1746544404601,MUS 80,A00,891156,Staff,19,0,25,6
1746544404601,MUS 80,B00,891157,Staff,23,0,25,2
1746544405627,MUS 130,A00,891158,Ohnishi; Takae,35,0,35,0
1746544406655,MUS 150GS,A01,891160,Borgo; David Garcia,0,0,25,25
1746544407680,MUS 170,A01,891162,Freitas Caetano; Marcelo,20,0,25,5
1746544407680,MUS 170,A02,891164,Freitas Caetano; Marcelo,21,0,25,4
1746544408705,NANO 11,A00,886220,Vazquez Mena; Oscar,13,0,15,2
1746544409731,NANO 15,A01,886222,Drews; Aaron,4,0,7,3
1746544410756,NANO 104,A00,886224,Sirbuly; Donald,18,0,25,7
1746544411783,PH 40,A00,886528,Staff,23,0,40,17
1746544412807,PH 45,A01,886799,Staff,35,0,40,5
1746544413831,PH 110,A00,886802,Staff,0,7,40,40
1746544414856,PH 172,A00,906716,Staff,19,0,35,16
1746544415884,PH 191,A00,886803,Staff,6,0,40,34
1746544416936,PHIL 1,A00,889500,Staff,19,0,30,11
1746544417963,PHIL 10,A01,889549,Grush; Rick Scott,15,0,22,7
1746544417963,PHIL 10,A02,889551,Grush; Rick Scott,22,0,22,0
1746544418989,PHIL 28,A01,889559,Lamey; Andy M.,0,1,31,31
1746544418989,PHIL 28,A02,889561,Lamey; Andy M.,0,1,30,30
1746544418989,PHIL 28,A03,889572,Lamey; Andy M.,0,0,30,30
1746544420018,PHIL 35,A00,907839,Staff,13,0,15,2
1746544421046,PHIL 60,A00,889574,Staff,74,0,90,16
1746544422071,PHIL 101,A00,958004,Staff,13,0,15,2
1746544424124,PHIL 136,A00,889582,Fulkerson; Matthew Todd,26,0,45,19
1746544425149,PHIL 163,A01,889601,Staff,21,0,30,9
1746544425149,PHIL 163,B01,889606,Brandt; Reuven A,0,3,0,0
1746544426179,PHIL 164,A00,889610,Staff,16,0,30,14
1746544427203,PHIL 165,A00,889613,Staff,23,0,30,7
1746544428233,PHYS 1A,A00,886431,Staff,26,0,70,44
1746544429264,PHYS 1AL,001,886432,Tsai; Philbert S,0,2,30,30
1746544429264,PHYS 1AL,002,886436,Tsai; Philbert S,11,0,30,19
1746544430291,PHYS 1B,A00,886439,Staff,185,0,240,55
1746544431314,PHYS 1BL,001,886441,Tsai; Philbert S,0,4,30,30
1746544431314,PHYS 1BL,002,886444,Tsai; Philbert S,2,0,30,28
1746544432339,PHYS 1C,A00,896092,Arnold; Kam S,78,0,146,68
1746544433365,PHYS 1CL,001,886448,Tsai; Philbert S,0,0,30,30
1746544433365,PHYS 1CL,002,886449,Tsai; Philbert S,0,0,30,30
1746544433365,PHYS 1CL,003,886450,Tsai; Philbert S,16,0,30,14
1746544433365,PHYS 1CL,004,886451,Tsai; Philbert S,15,0,30,15
1746544434391,PHYS 2B,A01,886457,Staff,69,0,115,46
1746544435417,PHYS 2C,A01,886460,Shotwell; Brian,0,8,65,65
1746544436442,PHYS 2CL,A01,886467,Staff,0,4,28,28
1746544436442,PHYS 2CL,A02,886468,Staff,0,3,28,28
1746544437470,PHYS 2D,A01,886470,Staff,10,0,50,40
1746544438496,PHYS 4B,A01,886475,Grinstein; Benjamin,22,0,40,18
1746544439527,POLI 5,A00,891173,Desposato; Scott,7,0,25,18
1746544440555,POLI 5D,A01,891175,Staff,5,0,5,0
1746544440555,POLI 5D,B01,891178,Staff,5,0,5,0
1746544441587,POLI 11,A00,891179,Ferree; Karen E,2,0,35,33
1746544442613,POLI 12,A00,891180,Staff,16,0,30,14
1746544443638,POLI 27,A01,891182,Staff,12,0,75,63
1746544444667,POLI 30,A00,891183,Staff,9,0,50,41
1746544445695,POLI 100B,A00,891244,Staff,5,1,35,30
1746544446721,POLI 100I,A00,891247,Staff,7,0,30,23
1746544447750,POLI 104J,A00,891248,Nichter; Maysa,14,0,30,16
1746544448774,POLI 104U,A00,891250,Nichter; Maysa,2,0,30,28
1746544450831,POLI 110B,A00,891255,Wiens; David,20,0,25,5
1746544451858,POLI 112A,A00,891256,Wiens; David,6,0,25,19
1746544452885,POLI 114BR,A00,891261,Staff,19,0,30,11
1746544453916,POLI 117R,A00,891262,Forman; Fonna,0,6,50,50
1746544454942,POLI 118,A00,891264,Ingham; Sean,17,0,25,8
1746544455968,POLI 124A,A00,891265,Staff,18,0,20,2
1746544456995,POLI 125D,A00,891266,Nichter; Simeon C,2,0,25,23
1746544458024,POLI 126,A00,891268,Nichter; Simeon C,7,0,25,18
1746544459051,POLI 126AA,A00,891272,Staff,18,0,25,7
1746544460076,POLI 130AA,A00,891273,Staff,15,0,20,5
1746544461104,POLI 134AA,A00,891274,Staff,4,0,20,16
1746544463156,POLI 138,A00,891278,Staff,21,0,25,4
1746544464181,POLI 142K,A00,891280,Staff,11,0,25,14
1746544465208,POLI 142M,A00,891281,Gartzke; Erik,17,0,30,13
1746544466234,POLI 142P,A00,891284,Staff,20,0,30,10
1746544467259,POLI 143,A00,891285,Gartzke; Erik,12,0,30,18
1746544468287,POLI 153,A00,891286,Staff,19,0,20,1
1746544470339,POLI 175,A00,891290,Staff,15,0,20,5
1746544471368,PSYC 1,A00,890674,Steiner; Eric Tomas,0,11,45,45
1746544472407,PSYC 2,A00,890676,Albright; Thomas D,21,0,35,14
1746544473433,PSYC 3,A00,890679,Staff,17,0,20,3
1746544474456,PSYC 6,A00,959858,Staff,20,0,20,0
1746544475482,PSYC 60,A01,890684,Rickard; Timothy C.,0,5,45,45
1746544476507,PSYC 70,A01,890689,Geller; Emma Harlan,7,0,30,23
1746544477533,PSYC 71,A01,959860,Staff,21,0,25,4
1746544478557,PSYC 100,A00,890690,Lacefield; Katharine I,0,50,180,180
1746544479582,PSYC 102,A00,890695,Staff,18,0,40,22
1746544480609,PSYC 105,A00,890699,Geller; Emma Harlan,71,0,100,29
1746544481634,PSYC 106,A00,890701,Gorman; Michael R.,5,0,30,25
1746544482662,PSYC 108,A00,890704,Adrian; Julia Anna,0,28,50,50
1746544483685,PSYC 118,A01,890712,Staff,11,0,30,19
1746544484712,PSYC 124,A00,890716,Chapman; Eddie Nathaniel,25,0,60,35
1746544485743,PSYC 131,A00,890717,Anagnostaras; Stephan,0,7,80,80
1746544486771,PSYC 137,A00,890719,Winkielman; Piotr,0,11,30,30
1746544487799,PSYC 144,A00,890721,Adrian; Julia Anna,0,9,45,45
1746544488829,PSYC 162,A00,890805,Staff,2,0,75,73
1746544489854,PSYC 169,A00,890810,Staff,0,15,30,30
1746544490881,PSYC 172,A00,890814,Gorman; Michael R.,9,0,30,21
1746544491909,PSYC 181,A00,890818,Anagnostaras; Stephan,8,0,200,192
1746544492939,PSYC 184,A00,959861,Staff,170,0,175,5
1746544493967,PSYC 189,A00,890823,Staff,0,1,30,30
1746544494994,PSYC 191,A00,890884,Rickard; Timothy C.,0,11,35,35
1746544496021,PSYC 193,A00,890913,Staff,19,0,30,11
1746544496021,PSYC 193,B00,890914,Chapman; Eddie Nathaniel,24,0,30,6
1746544497053,PSYC 193L,A01,890918,Lowe; Angela Beth,20,0,30,10
1746544497053,PSYC 193L,B01,890921,Hurwitz; Ethan Scott,20,0,30,10
1746544497053,PSYC 193L,C01,890928,Staff,30,0,30,0
1746544498081,RELI 149,A00,886806,Rahimi; Babak,23,0,40,17
1746544499108,SE 9,A01,886814,Staff,7,0,20,13
1746544500136,SE 101B,A01,886816,Chadha; Mayank,4,0,35,31
1746544501162,SE 110B,A00,886818,Zhu; Qiang,4,0,75,71
1746544502199,SE 125,A01,886830,Staff,10,0,30,20
1746544503225,SE 130B,A01,886835,Staff,14,0,40,26
1746544504253,SE 131A,A01,886838,Krysl; Petr,34,0,55,21
1746544505280,SE 154,A00,886840,Staff,30,0,50,20
1746544506306,SE 164GS,A01,886849,Staff,6,0,20,14
1746544507331,SE 167GS,A01,886853,Staff,6,0,20,14
1746544508357,SIO 25,A01,890107,Staff,19,0,30,11
1746544509386,SIO 45,A00,890109,Cook; Geoffrey W,117,0,200,83
1746544510409,SIO 109R,A00,890110,Forman; Fonna,0,16,20,20
1746544511439,SIO 187,A01,890114,Kacev; David,15,0,40,25
1746544512469,SOCI 1,A01,890431,Thorpe; Charles Robert,15,0,30,15
1746544512469,SOCI 1,A02,890518,Thorpe; Charles Robert,30,0,30,0
1746544513496,SOCI 2,A01,957978,Staff,25,0,25,0
1746544513496,SOCI 2,A02,957979,Staff,23,0,25,2
1746544514523,SOCI 20,A01,890523,Calderon-Zaks; Michael Aar,23,0,30,7
1746544514523,SOCI 20,A02,890526,Calderon-Zaks; Michael Aar,29,0,30,1
1746544515554,SOCI 30,A01,890533,Pardo Guerra; Juan Pablo,37,0,40,3
1746544516605,SOCI 40,A01,890535,Staff,27,0,45,18
1746544517635,SOCI 104Q,A00,890559,Staff,18,0,30,12
1746544518667,SOCI 106,A00,890560,Arnal; Maud Marie Leonie,20,0,30,10
1746544519694,SOCI 110,A00,890567,Holkenbrink-Monk; Charlene,19,0,30,11
1746544520719,SOCI 112,A00,890568,Victoria Torres; Pablo,1,0,55,54
1746544521746,SOCI 115,A00,890597,Arnal; Maud Marie Leonie,28,0,45,17
1746544523799,SOCI 121,A00,890604,Pardo Guerra; Juan Pablo,38,0,45,7
1746544524827,SOCI 126,A01,890608,Staff,8,0,10,2
1746544525857,SOCI 127,A00,890609,Staff,18,0,30,12
1746544526885,SOCI 131,A00,890610,Thorpe; Charles Robert,37,0,45,8
1746544527912,SOCI 135,A00,890615,Payne; Christine Anna,14,0,45,31
1746544528937,SOCI 139,A00,890620,Staff,38,0,45,7
1746544529963,SOCI 148E,A00,890622,Calderon-Zaks; Michael Aar,36,0,45,9
1746544530990,SOCI 150,A00,890623,Kohler; Kristopher M.,31,0,45,14
1746544532015,SOCI 157,A00,890625,Jules-Rosette; Bennetta W.,18,0,20,2
1746544533044,SOCI 160,A00,890627,Payne; Christine Anna,21,0,45,24
1746544534070,SYN 1,A00,886855,Fish; Gwendolyn Anne,0,0,0,0
1746544534070,SYN 1,B00,906086,Fish; Gwendolyn Anne,0,1,0,2
1746544535095,SYN 2R,A00,886860,Staff,0,17,15,15
1746544535095,SYN 2R,B00,906106,Atkinson; Arthur Laird,0,16,15,15
1746544536121,SYN 100,A01,886866,Browne; Emily,0,28,20,20
1746544536121,SYN 100,B01,906128,Rock; Martin,0,5,20,20
1746544536121,SYN 100,C01,906140,Deavenport; James Cary,0,3,20,20
1746544536121,SYN 100,D01,907816,Deavenport; James Cary,0,5,20,20
1746544537148,TDAC 1,A00,890286,Walsh; Kim C.,9,0,20,11
1746544538178,TDAC 101,A00,890296,Basso; Beatrice,16,0,20,4
1746544539204,TDDE 131,A00,890297,Staff,47,0,50,3
1746544540228,TDDM 1,A00,890287,Weinberg; Sadie,25,0,30,5
1746544541255,TDGE 11,A00,890288,Fulton; Julia,137,0,200,63
1746544541255,TDGE 11,B00,890289,Castro; Robert Jess,184,0,200,16
1746544542280,TDGE 25,B00,957359,Walsh; Kim C.,3,0,20,17
1746544543304,TDGE 40,A01,890292,Power; Jade Yukana,27,0,30,3
1746544544331,TDGE 124,A00,890298,Havis; Allan,0,0,50,50
1746544545360,TDGE 131R,A00,890299,Burelle; Julie Sara Veronique,15,0,42,27
1746544546391,TDHT 101,A00,890300,Staff,10,0,20,10
1746544547419,TDHT 109,A01,890302,Anderson; Mysia Anyse,31,0,40,9
1746544548445,TDMV 1,A00,890293,Arcidiacono; Kristin,18,0,30,12
1746544549468,TDMV 2,A00,890294,Weinberg; Sadie,23,0,30,7
1746544550497,TDMV 3,A00,957878,Arcidiacono; Kristin,28,0,30,2
1746544552551,TDMV 138,A00,890304,Jun; Grace Shin Hae,25,0,40,15
1746544553577,TDMV 140,A00,890305,Corrales; Joseph Bernales,25,0,30,5
1746544554605,TDMV 142,A00,890307,Caligagan; Tony,32,0,40,8
1746544555634,TDMV 144,A00,890308,Camaya; Michelle Ann,25,0,30,5
1746544556657,TDPW 1,A00,890295,Stein; Deborah Isobel,3,0,20,17
1746544557689,USP 2,A01,890272,Lerner; Amy M,6,0,20,14
1746544558714,USP 3,A01,890274,Staff,12,0,30,18
1746544559744,USP 15,A01,890276,Sun; Feiyang,17,0,30,13
1746544560774,USP 25,A00,890277,Shenkman; Michael Thomas,19,0,25,6
1746544561798,USP 138,A00,890278,Staff,13,0,25,12
1746544562824,USP 143,A00,890279,Staff,21,0,70,49
1746544563852,USP 144,A00,890280,Chowdhury; Muhammed Zohir,16,0,30,14
1746544564877,USP 150,A00,890281,Boomhower; Matthew Charles,4,0,30,26
1746544565902,USP 151,A00,890282,Staff,16,0,20,4
1746544566929,USP 162,A00,890283,Andrews; Abigail Leslie,16,0,20,4
1746544567954,USP 168,A00,920477,Kwak; Nancy,1,0,5,4
1746544568979,USP 181,A00,890284,Staff,3,0,20,17
1746544570005,USP 191A,A00,890285,Staff,13,0,20,7
1746544571032,VIS 101,A00,886512,Staff,25,0,75,50
1746544572057,VIS 103,A00,886513,Cruz; Edwin Teddy,61,0,75,14
1746544573084,VIS 108,A00,886514,Staff,3,0,15,12
1746544574123,VIS 127P,A00,886515,Shen; Kuiyi,80,0,146,66
1746544575152,VIS 149,A00,886516,Yoldas; Pinar,0,0,15,15
1746544576178,VIS 164,A00,886526,Erdmann; Dean,19,0,22,3
1746544577207,VIS 194S,A00,886527,Staff,61,0,75,14
1746544578233,WCWP 10A,C00,886484,Martiniuk; Jill,12,0,15,3
1746544579260,WCWP 10B,A00,886490,Uriarte; Emma,0,0,15,15
1746544579260,WCWP 10B,B00,886491,Dhir; Simrita,11,0,15,4
1746544579260,WCWP 10B,C00,886492,Ornelas; Tricia,0,0,15,15
1746544580291,WCWP 100,A00,886494,Young; Mark T,0,7,15,15
1746544582423,AAS 10,A01,886199,Childs; Dennis R.,0,3,0,0
1746544583450,ANAR 104,A01,886940,Shtienberg; Gilad,27,0,30,3
1746544584477,ANAR 120,A00,886953,Staff,12,0,20,8
1746544585507,ANBI 148,A01,886955,Wilder; Linnea Lorene,30,0,40,10
1746544587558,ANSC 122,A00,886957,Staff,25,0,30,5
1746544588585,ANSC 150,A00,886958,Sloane; Julia Kathryn,3,0,15,12
1746544589614,ANSC 156,A00,886959,Jenkins; Janis A.,0,1,15,15
1746544590640,ANSC 180,A00,886960,Staff,11,0,17,6
1746544591670,ANSC 188,A00,886961,Jassal; Aftab,9,0,25,16
1746544592697,ANSC 190,A00,886962,Jassal; Aftab,14,0,25,11
1746544593723,ANSC 191,A00,886963,Staff,18,0,20,2
1746544594753,ANTH 3,A01,891689,Staff,17,0,20,3
1746544595779,ANTH 5,A00,886933,Semendeferi; Ekaterini,16,0,20,4
1746544596804,ANTH 10,A00,886934,Staff,0,12,30,30
1746544597832,ANTH 21,A01,886936,Staff,40,0,60,20
1746544598858,ANTH 23,A01,886938,Staff,92,0,100,8
1746544599885,ANTH 105,A00,886964,Stewart; Alexander B,84,0,100,16
1746544600912,ANTH 108,A00,886965,Pedersen; David,9,0,20,11
1746544601939,AWP 10,001,886147,Staff,0,0,0,0
1746544601939,AWP 10,002,886148,Staff,0,0,0,0
1746544601939,AWP 10,003,886149,Staff,0,0,0,0
1746544601939,AWP 10,004,886150,Staff,0,0,0,0
1746544601939,AWP 10,005,886151,Staff,0,0,0,0
1746544601939,AWP 10,006,886152,Staff,0,0,0,0
1746544601939,AWP 10,007,886153,Staff,0,0,0,0
1746544601939,AWP 10,008,886154,Staff,0,0,0,0
1746544601939,AWP 10,009,886155,Staff,0,0,0,0
1746544601939,AWP 10,010,886156,Staff,0,0,0,0
1746544601939,AWP 10,011,886158,Staff,0,0,0,0
1746544601939,AWP 10,012,886160,Staff,0,0,0,0
1746544601939,AWP 10,013,886161,Staff,0,0,0,0
1746544601939,AWP 10,014,886162,Staff,0,0,0,0
1746544601939,AWP 10,015,886163,Staff,0,0,0,0
1746544601939,AWP 10,016,886164,Staff,0,0,0,0
1746544601939,AWP 10,017,886165,Staff,0,0,0,0
1746544601939,AWP 10,018,886166,Staff,0,0,0,0
1746544601939,AWP 10,019,886168,Staff,0,0,0,0
1746544601939,AWP 10,020,886170,Staff,0,0,0,0
1746544601939,AWP 10,021,886172,Staff,0,0,0,0
1746544602966,AWP 10R,001,886173,Staff,0,1,0,0
1746544602966,AWP 10R,002,886174,Staff,0,1,0,0
1746544602966,AWP 10R,003,886175,Staff,0,0,0,0
1746544602966,AWP 10R,004,886176,Staff,0,0,0,0
1746544602966,AWP 10R,005,886177,Staff,0,0,0,0
1746544602966,AWP 10R,006,886178,Staff,0,0,0,0
1746544602966,AWP 10R,007,886179,Staff,0,0,0,0
1746544602966,AWP 10R,008,886181,Staff,0,0,0,0
1746544602966,AWP 10R,009,886182,Staff,0,0,0,0
1746544602966,AWP 10R,010,886183,Staff,0,0,0,0
1746544602966,AWP 10R,011,886184,Staff,0,0,0,0
1746544602966,AWP 10R,012,886185,Staff,0,0,0,0
1746544602966,AWP 10R,013,886186,Staff,0,0,0,0
1746544602966,AWP 10R,014,886187,Staff,0,0,0,0
1746544602966,AWP 10R,015,886188,Staff,0,0,0,0
1746544602966,AWP 10R,016,886189,Staff,0,0,0,0
1746544603995,AWP 102R,A00,886190,Staff,0,0,0,0
1746544603995,AWP 102R,B00,886191,Staff,0,0,0,0
1746544605025,BENG 100,A01,886193,Staff,17,0,30,13
1746544606054,BENG 122A,A01,886195,Hasty; Jeff M,13,0,30,17
1746544607084,BENG 166A,A00,886196,Sah; Robert Lie-Yuan,0,1,30,30
1746544608112,BENG 190,A00,958050,Khojah; Reem I,24,0,25,1
1746544609136,BIBC 102,A01,894320,Staff,0,0,46,46
1746544609136,BIBC 102,A02,894321,Staff,0,0,46,46
1746544609136,BIBC 102,A03,894344,Staff,7,0,46,39
1746544609136,BIBC 102,A04,894345,Staff,26,0,47,21
1746544610220,BICD 100R,A01,894365,Smith; Laurie,0,3,58,58
1746544610220,BICD 100R,A02,894366,Smith; Laurie,0,5,58,58
1746544610220,BICD 100R,A03,894367,Smith; Laurie,2,0,59,57
1746544610220,BICD 100R,A04,959869,Smith; Laurie,41,0,59,18
1746544611245,BICD 136,A01,894383,Gustafson-Brown; Cindy,14,0,50,36
1746544612271,BIEB 102,A01,894494,Butler; Shannon Rhey,51,0,130,79
1746544614326,BIEB 150,A01,894617,Wills; Christopher,3,0,20,17
1746544614326,BIEB 150,A02,894631,Wills; Christopher,3,0,20,17
1746544614326,BIEB 150,A03,894937,Wills; Christopher,3,0,20,17
1746544614326,BIEB 150,A04,894946,Wills; Christopher,5,0,20,15
1746544615353,BIEB 194,A00,906141,Kurle; Carolyn M.,6,0,20,14
1746544616384,BILD 1,A01,894154,Staff,2,0,19,17
1746544616384,BILD 1,A02,894155,Staff,14,0,19,5
1746544616384,BILD 1,A03,894160,Staff,13,0,19,6
1746544616384,BILD 1,A04,894161,Staff,15,0,18,3
1746544617411,BILD 2,A01,894168,Staff,0,0,50,50
1746544617411,BILD 2,A02,894169,Staff,0,0,50,50
1746544617411,BILD 2,A03,894179,Staff,4,0,50,46
1746544617411,BILD 2,A04,894203,Staff,27,0,50,23
1746544618443,BILD 3,A01,894213,Staff,22,0,31,9
1746544618443,BILD 3,A02,894214,Staff,26,0,31,5
1746544618443,BILD 3,A03,894235,Staff,28,0,31,3
1746544618443,BILD 3,A04,894236,Staff,28,0,32,4
1746544619474,BILD 4,A01,894253,Reuther; Keefe,5,0,24,19
1746544619474,BILD 4,A02,894258,Reuther; Keefe,16,0,24,8
1746544620499,BILD 5,A01,894276,Reuther; Keefe,35,0,50,15
1746544620499,BILD 5,A02,894277,Reuther; Keefe,45,0,50,5
1746544620499,BILD 5,A03,894290,Reuther; Keefe,44,0,50,6
1746544620499,BILD 5,A04,894291,Reuther; Keefe,48,0,50,2
1746544621526,BILD 24,A01,894297,Pirino; Giorgia,40,0,60,20
1746544622552,BIMM 100,B01,958915,Staff,72,0,100,28
1746544623578,BIMM 101,A01,895017,McDonnell; Lisa Marie,0,5,24,24
1746544623578,BIMM 101,A02,895018,McDonnell; Lisa Marie,0,5,24,24
1746544623578,BIMM 101,B01,895020,McDonnell; Lisa Marie,0,6,24,24
1746544623578,BIMM 101,B02,895021,McDonnell; Lisa Marie,0,4,24,24
1746544624604,BIMM 110,A01,895023,Staff,1,0,25,24
1746544624604,BIMM 110,A02,895024,Staff,9,0,25,16
1746544624604,BIMM 110,A03,895025,Staff,18,0,25,7
1746544624604,BIMM 110,A04,895031,Staff,20,0,25,5
1746544625628,BIMM 120,A01,895114,Gustafson-Brown; Cindy,13,0,28,15
1746544625628,BIMM 120,A02,895126,Gustafson-Brown; Cindy,21,0,27,6
1746544626657,BIPN 100,A01,895130,Yang; Mingyu,1,0,38,37
1746544626657,BIPN 100,A02,895131,Yang; Mingyu,32,0,38,6
1746544626657,BIPN 100,A03,895132,Yang; Mingyu,32,0,38,6
1746544626657,BIPN 100,A04,895133,Yang; Mingyu,27,0,36,9
1746544627683,BIPN 120,A01,895135,Cooke; James Edward,0,3,13,13
1746544627683,BIPN 120,A02,895136,Cooke; James Edward,0,1,13,13
1746544627683,BIPN 120,A03,895137,Cooke; James Edward,0,3,13,13
1746544627683,BIPN 120,A04,895156,Cooke; James Edward,0,2,11,11
1746544628750,BIPN 134,A01,895235,Cooke; James Edward,0,2,25,25
1746544628750,BIPN 134,A02,895237,Cooke; James Edward,0,0,25,25
1746544628750,BIPN 134,A03,895240,Cooke; James Edward,3,0,25,22
1746544628750,BIPN 134,A04,895270,Cooke; James Edward,20,0,25,5
1746544629786,BIPN 189,A00,892103,Staff,0,13,14,14
1746544631835,BISP 194,A00,958008,Staff,0,2,0,0
1746544632862,CAT 124,A01,922009,Staff,0,5,20,20
1746544633893,CAT 125R,A00,886390,Morales; Celeste Georgianna,0,2,20,20
1746544633893,CAT 125R,B00,886391,Irwin; Matthew Joseph,0,3,20,20
1746544633893,CAT 125R,C00,886392,Smith; Lauryn Alissa,0,2,20,20
1746544633893,CAT 125R,D00,886393,Vanderschuit; Maya Alysia,0,2,20,20
1746544633893,CAT 125R,E00,886394,Marchisotto; Jennifer Anne,0,4,20,20
1746544634920,CENG 15,A01,886218,Drews; Aaron,3,0,8,5
1746544635946,CENG 113,A00,886219,Opatkiewicz; Justin Paul,15,0,25,10
1746544636971,CGS 101,A00,887044,Staff,7,0,20,13
1746544638000,CGS 105,A01,887046,Staff,14,0,25,11
1746544639025,CGS 112,A00,887047,Cuong; Marisol,12,0,15,3
1746544640051,CGS 113,A00,887048,Staff,23,0,30,7
1746544641078,CGS 120,A00,887049,Staff,10,0,17,7
1746544642102,CHEM 6A,A01,886336,Lam; Tin Yiu,38,0,50,12
1746544642102,CHEM 6A,A02,886338,Lam; Tin Yiu,37,0,50,13
1746544643133,CHEM 6B,A01,886341,Hopkins; Patrycja Anna,16,0,50,34
1746544643133,CHEM 6B,A02,886343,Hopkins; Patrycja Anna,42,0,50,8
1746544644159,CHEM 6C,A01,886346,Albizati; Kim F.,0,2,50,50
1746544644159,CHEM 6C,A02,886348,Albizati; Kim F.,23,0,50,27
1746544645184,CHEM 40A,A01,886352,Klosterman; Jeremy K,65,0,100,35
1746544646209,CHEM 40B,A01,886356,Klosterman; Jeremy K,0,23,100,100
1746544647236,CHEM 41B,A01,886360,Theodorakis; Emmanuel,25,0,50,25
1746544647236,CHEM 41B,A02,886362,Theodorakis; Emmanuel,47,0,50,3
1746544648264,CHIN 165A,A00,886382,Xu; Li,18,0,20,2
1746544649287,CLAS 120,A00,886387,Myerston Santana; Jacobo,33,0,40,7
1746544650317,COGS 9,A01,886967,Shannon; Kyle Michael,42,0,60,18
1746544651345,COGS 11,A01,886969,Staff,11,0,30,19
1746544652372,COGS 14A,A01,886971,Staff,6,0,60,54
1746544653399,COGS 14B,A01,886973,Hoffman; Drew Ellen,4,0,60,56
1746544654427,COGS 18,A01,886975,Morgan; Eric,35,0,60,25
1746544655451,COGS 20,A01,886977,Staff,4,0,8,4
1746544655451,COGS 20,A02,886978,Staff,5,0,7,2
1746544656477,COGS 100,A01,907783,Staff,0,2,30,30
1746544657501,COGS 101B,A01,886980,Staff,0,3,48,48
1746544658529,COGS 101C,A01,886982,Delgado; Tania,0,5,44,44
1746544659558,COGS 102A,A01,886984,Johnson; Christine M.,4,0,30,26
1746544660582,COGS 118B,A01,886986,Staff,0,3,88,88
1746544661610,COGS 150,A01,886988,Bergen; Benjamin,23,0,50,27
1746544662637,COGS 153,A00,886989,Delgado; Tania,0,2,41,41
1746544663666,COGS 186,A01,886991,Staff,0,0,32,32
1746544664691,COGS 187A,A01,886993,Boyle; Mary E. T.,7,0,30,23
1746544665718,COGS 189,A00,886994,Staff,0,1,30,30
1746544666745,COMM 10,A01,886996,Staff,0,0,20,21
1746544666745,COMM 10,A02,886997,Staff,12,0,20,8
1746544666745,COMM 10,A03,959845,Staff,19,0,20,1
1746544667772,COMM 20,A01,886999,Leuning; Grant Maurstad,24,0,40,16
1746544669828,COMM 100A,A01,887002,Staff,0,0,20,25
1746544669828,COMM 100A,A02,887003,Staff,7,0,20,13
1746544670855,COMM 100B,A01,887005,Staff,0,8,20,24
1746544671881,COMM 106D,A00,887006,Staff,14,0,40,26
1746544672910,COMM 110G,A00,887007,Whitworth-Smith; Andrew C,12,0,40,28
1746544673937,COMM 111B,A00,887008,Staff,31,0,40,9
1746544674966,COMM 113T,A00,887009,Abuelhiga; Soraya Jill,28,0,40,12
1746544674966,COMM 113T,B00,906733,Staff,40,0,40,0
1746544675993,COMM 145,A00,887010,Staff,12,0,40,28
1746544677017,COMM 146,A00,887054,Staff,31,0,40,9
1746544678044,COMM 190,A00,887012,Staff,8,0,23,15
1746544679069,CSE 8A,A50,887015,Cao; Yingjun,57,0,85,28
1746544680098,CSE 11,A01,887017,Cao; Yingjun,12,0,70,58
1746544681125,CSE 20,A01,887019,Staff,30,0,50,20
1746544682151,CSE 21,A01,887021,Staff,78,0,100,22
1746544682151,CSE 21,B01,892583,Braun; Oliver,45,0,50,5
1746544683179,CSE 30,A01,887025,Eldon; John,143,0,200,57
1746544684205,CSE 100,A01,887027,Staff,26,0,50,24
1746544684205,CSE 100,A02,887028,Staff,40,0,50,10
1746544685231,CSE 101,A01,887030,Braun; Oliver,75,0,100,25
1746544685231,CSE 101,B01,887032,Jones; Miles E,0,3,50,50
1746544685231,CSE 101,B02,887033,Jones; Miles E,0,1,50,50
1746544686260,CSE 105,A01,908084,Jones; Miles E,32,0,50,18
1746544686260,CSE 105,A02,908087,Jones; Miles E,33,0,50,17
1746544687283,CSE 135,A01,887035,Powell; Thomas Allan,0,4,50,50
1746544688309,CSE 142,A01,887037,Staff,8,0,60,52
1746544689333,CSE 142L,A01,887039,Staff,34,0,60,26
1746544690362,CSE 151A,A01,887041,Solares; Edwin A,48,0,100,52
1746544691390,CSE 175,A01,887043,Kumar; Rakesh,30,0,30,0
1746544692420,CSS 1,A01,886389,Staff,0,1,40,40
1746544693445,DSC 30,A01,908097,Liao; Soohyun Nam,47,0,75,28
1746544694494,DSC 40A,A01,908099,Shannon; Kyle Michael,30,0,50,20
1746544695520,DSC 40B,A01,908112,Staff,16,0,50,34
1746544696545,DSC 80,A01,908116,Staff,19,0,60,41
1746544697572,DSC 197,001,956863,Eldridge; Justin Matthew,9999,0,9999,0
1746544698604,ECE 5,A01,886400,Morris; Karcher William,2,0,6,4
1746544698604,ECE 5,A02,886401,Morris; Karcher William,3,0,6,3
1746544699629,ECE 148,A01,886403,Silberman; Jack,0,14,14,14
1746544700658,ECON 1,A01,887265,Crane; Meredith Helen,12,0,70,58
1746544700658,ECON 1,B01,887268,Staff,43,0,50,7
1746544701684,ECON 2,A01,887273,Crane; Meredith Helen,56,0,70,14
1746544702712,ECON 3,A01,887279,Rondina; Giacomo,32,0,70,38
1746544703738,ECON 4,A01,887282,Anderson; John Charles,0,2,10,10
1746544704767,ECON 5,A01,887285,Staff,33,0,45,12
1746544704767,ECON 5,B01,887292,Staff,41,0,45,4
1746544705799,ECON 100A,A01,887337,Newhouse; Herbert S,54,0,70,16
1746544705799,ECON 100A,B01,887349,Staff,45,0,50,5
1746544706826,ECON 100B,A01,887361,Du; Songzi,29,0,70,41
1746544707853,ECON 100C,A01,887445,Newhouse; Herbert S,59,0,70,11
1746544708882,ECON 105,A00,887488,Vespa; Emanuel Ignacio,23,0,35,12
1746544709907,ECON 109,A01,887506,Shishkin; Denis,28,0,35,7
1746544710931,ECON 110A,A01,887568,Alon; Titan Michael,0,3,35,35
1746544710931,ECON 110A,B01,907601,Alon; Titan Michael,20,0,35,15
1746544711961,ECON 110B,A01,887598,Levkoff; Steven B.,0,23,70,70
1746544712989,ECON 112,A00,887599,Rondina; Giacomo,19,0,35,16
1746544714015,ECON 120A,A01,887603,Dai; Yinlin,36,0,70,34
1746544715042,ECON 120C,A01,887608,Sun; Yixiao,0,1,35,35
1746544715042,ECON 120C,B01,887614,Sun; Yixiao,0,0,35,35
1746544716066,ECON 138,A00,887621,Bharadwaj; Prashant,0,20,20,20
1746544717092,ECON 144,A00,958007,Squires; Dale E,13,0,35,22
1746544718121,ECON 171,A01,907666,Staff,18,0,35,17
1746544719148,ECON 175,A00,887626,Wu; Pak Yeung,23,0,35,12
1746544720177,ECON 190,A00,887640,Vespa; Emanuel Ignacio,23,0,35,12
1746544721214,EDS 25,A01,888197,Staff,0,0,0,0
1746544721214,EDS 25,A02,888209,Staff,0,0,0,0
1746544721214,EDS 25,A03,888210,Staff,0,0,0,0
1746544721214,EDS 25,A04,888212,Staff,0,0,0,0
1746544721214,EDS 25,A05,888213,Staff,0,0,0,0
1746544721214,EDS 25,A06,888214,Staff,0,0,0,0
1746544721214,EDS 25,A07,888235,Staff,0,2,0,0
1746544721214,EDS 25,A08,888236,Staff,0,0,0,0
1746544721214,EDS 25,A09,888240,Staff,0,0,0,0
1746544721214,EDS 25,A10,888244,Staff,0,0,0,0
1746544721214,EDS 25,B01,888273,Staff,0,0,0,0
1746544721214,EDS 25,B02,888285,Staff,0,0,0,0
1746544721214,EDS 25,B03,888423,Staff,0,0,0,1
1746544721214,EDS 25,B04,888432,Staff,0,0,0,0
1746544721214,EDS 25,B05,888433,Staff,0,0,0,0
1746544721214,EDS 25,B06,888467,Staff,0,0,0,0
1746544721214,EDS 25,B07,888468,Staff,0,0,0,0
1746544721214,EDS 25,B08,888479,Staff,0,0,0,0
1746544721214,EDS 25,B09,888484,Staff,0,0,0,0
1746544721214,EDS 25,B10,888487,Staff,0,0,0,0
1746544722239,EDS 38,A01,907700,Choi; Bailey Miyeon,30,0,30,0
1746544723264,EDS 112,A01,888601,Chapman; Thandeka K,14,0,40,26
1746544724289,EDS 115,A00,888697,Mendez; Kathrina Mendoza,10,0,30,20
1746544725318,EDS 116,A01,888893,Staff,35,0,40,5
1746544727370,EDS 124AR,A00,889133,Staff,29,0,50,21
1746544727370,EDS 124AR,B00,907471,Simon; Elizabeth A,37,0,50,13
1746544728395,EDS 124BR,A00,889134,Simon; Elizabeth A,45,0,100,55
1746544729423,EDS 125,A00,889135,Staff,25,0,30,5
1746544730449,EDS 126,A01,889138,Staff,36,0,40,4
1746544731474,EDS 164R,A01,889142,Wishard Guerra; Alison G.,33,0,50,17
1746544732502,ENG 30,A01,886396,Staff,0,0,0,0
1746544732502,ENG 30,B01,886398,Staff,0,0,0,0
1746544733527,ENVR 102,A00,906150,Montejo; Carolina,23,0,25,2
1746544734553,ETHN 103A,A00,887236,Man; Simeon S,0,3,0,0
1746544735578,ETHN 113,A00,887239,Staff,16,0,30,14
1746544736606,ETHN 116,A00,887240,Staff,16,0,25,9
1746544737630,ETHN 117,A00,887241,Choi; Esther Min,28,0,30,2
1746544738653,ETHN 118,A00,887243,Staff,24,0,30,6
1746544739679,ETHN 127,A00,887248,Cuong; Marisol,11,0,15,4
1746544740703,ETHN 139,A00,887250,Staff,7,0,10,3
1746544741727,ETHN 142,A00,887252,Staff,10,0,30,20
1746544742754,ETHN 161,A00,887253,Browne; Errol Tsekani,24,0,30,6
1746544743781,ETHN 163FR,A00,887255,Burelle; Julie Sara Veronique,0,0,5,5
1746544744809,GLBH 20,A00,889149,Elwardani; Nile Regina,8,0,42,34
1746544746864,GLBH 111,A01,889152,Burgos; Jose L.,17,0,17,0
1746544747890,GLBH 150,A00,889181,Sloane; Julia Kathryn,0,5,15,15
1746544749943,HDS 60,A01,886406,Warstadt; Melissa Fawn,73,0,80,7
1746544750970,HIAF 111,A00,889324,Gyamfi; Bright,25,0,32,7
1746544752000,HIEA 131,A00,889328,Staff,16,0,32,16
1746544753025,HIEA 144,A00,889333,Henry; Todd A.,26,0,32,6
1746544754051,HIEA 154,A00,889336,Henry; Todd A.,24,0,32,8
1746544755078,HIEU 106,A00,889339,Staff,22,0,32,10
1746544757132,HIEU 114,A00,889340,Staff,3,0,32,29
1746544758160,HIEU 135GS,A00,889342,Patterson; Patrick H.,0,0,1,24
1746544759186,HIEU 137,A00,889343,Edington; Claire Ellen,9,0,25,16
1746544760214,HIEU 148,A00,889345,Staff,14,0,32,18
1746544761239,HIEU 154,A00,889346,Biess; Frank Peter,21,0,32,11
1746544762265,HILA 102,A00,889351,Staff,12,0,32,20
1746544763290,HILD 2A,A01,889221,Lewandoski; Julia Mavis,1,10,32,31
1746544764319,HILD 7B,A01,889225,Man; Simeon S,0,13,32,32
1746544765346,HILD 7C,A01,889288,Alvarez; Luis A,0,14,32,32
1746544766374,HILD 30,A01,889323,Staff,0,5,32,32
1746544768426,HISC 119,A00,889383,Golan; Tal,21,0,32,11
1746544769452,HIUS 103,A00,889384,Man; Simeon S,0,0,32,32
1746544770477,HIUS 117,A00,919797,Kwak; Nancy,18,0,32,14
1746544771500,HIUS 142A,A00,919788,Staff,22,0,32,10
1746544773551,HIUS 149,A00,889386,Gyamfi; Bright,27,0,32,5
1746544774578,HIUS 155,A00,889387,Alvarez; Luis A,14,0,32,18
1746544775604,HUM 3,A01,886499,Caldwell; Michael Alan,19,0,50,31
1746544776630,HUM 3GS,A00,886500,Rodriguez; Bretton Sigfred,0,0,0,28
1746544777656,HUM 3R,A01,886502,Markman; Kristina,0,36,50,50
1746544778681,HUM 4,A01,886504,Crum; Matthew Stephen,24,0,50,26
1746544778681,HUM 4,B01,886506,West; Geoffrey Scott,17,0,50,33
1746544779705,HUM 4GS,A00,886507,Staff,0,0,0,19
1746544780731,HUM 5,A01,886509,Staff,32,0,50,18
1746544781759,HUM 5R,A01,886511,Zavodny; Tatiana Sophia,0,39,50,50
1746544782787,JAPN 180,A00,886407,Staff,18,0,40,22
1746544783817,LATI 50,A01,886409,Martin-Cabrera; Luis,4,0,22,18
1746544783817,LATI 50,A02,886410,Martin-Cabrera; Luis,19,0,22,3
1746544783817,LATI 50,A03,886411,Martin-Cabrera; Luis,21,0,22,1
1746544783817,LATI 50,A04,886412,Martin-Cabrera; Luis,9,0,22,13
1746544784843,LAWS 101,A00,907664,Staff,28,0,60,32
1746544785867,LIAB 1A,A00,889388,Saab; Dima,17,0,20,3
1746544786894,LIAB 1AX,A00,889389,El Cheddadi; Youniss,17,0,20,3
1746544787920,LIFR 1C,A00,889391,Van Moer; Vinciane G,8,0,20,12
1746544788946,LIFR 1CX,A00,889392,Van Moer; Vinciane G,7,0,20,13
1746544789974,LIFR 1D,A00,889393,Van Moer; Vinciane G,7,0,20,13
1746544790999,LIFR 1DX,A00,889394,Van Moer; Vinciane G,8,0,20,12
1746544792028,LIGN 7,A00,886923,Staff,24,0,50,26
1746544793054,LIGN 17,A00,886924,Kehler; Andrew Scott,125,0,150,25
1746544794080,LTAM 110,A00,889395,Staff,15,0,30,15
1746544795110,LTAM 110GS,A00,958010,Rodriguez; Bretton Sigfred,0,0,0,28
1746544796141,LTCH 101,A00,889397,Staff,23,0,25,2
1746544797167,LTCS 130,A00,889398,Staff,23,0,25,2
1746544798192,LTEA 138,A00,889399,Staff,24,0,40,16
1746544799217,LTEN 149,A00,889400,Wesling; Megan E.,0,3,25,25
1746544800245,LTEN 169,A00,889401,Staff,20,0,25,5
1746544801270,LTEN 180,A00,889402,Staff,10,0,15,5
1746544802340,LTEN 181,A00,889403,Staff,21,0,25,4
1746544803366,LTWL 100,A00,889404,Myerston Santana; Jacobo,3,0,25,22
1746544804392,LTWL 180GS,A00,889405,Staff,0,0,20,20
1746544805420,LTWL 181,A00,889406,Staff,17,0,25,8
1746544806447,LTWL 184,A00,889475,Mukherjee; Silpa,22,0,25,3
1746544807472,LTWR 102C,A00,889486,Staff,29,0,30,1
1746544808499,LTWR 115W,A00,889491,Staff,0,2,15,15
1746544809525,MAE 8,A01,886905,Staff,0,2,0,0
1746544810550,MAE 11,A00,886906,Bandaru; Prabhakar,0,7,50,50
1746544811577,MAE 20,A00,886907,Evdokimenko; Ekaterina,44,0,70,26
1746544812603,MAE 30B,A00,886909,Ghazinejad; Maziar,26,0,45,19
1746544813631,MAE 101B,A00,886910,Saintillan; David,29,0,45,16
1746544814657,MAE 105,A00,886911,Bandaru; Prabhakar,18,0,50,32
1746544815683,MAE 107,B00,958024,Staff,9,0,50,41
1746544816707,MAE 143B,A00,886913,Bewley; Thomas R,7,0,40,33
1746544817735,MAE 148,A01,886915,Silberman; Jack,0,3,14,14
1746544818759,MAE 160,A00,886916,Evdokimenko; Ekaterina,31,0,60,29
1746544819787,MATH 3C,A01,889681,Staff,0,3,30,30
1746544819787,MATH 3C,A02,960048,Staff,25,0,30,5
1746544820813,MATH 10A,A01,889760,Staff,26,0,30,4
1746544820813,MATH 10A,A02,889783,Staff,29,0,30,1
1746544821844,MATH 10B,A01,889785,Verstraete; Jacques Allan,2,0,35,33
1746544821844,MATH 10B,A02,889795,Verstraete; Jacques Allan,4,0,35,31
1746544821844,MATH 10B,B01,889797,Verstraete; Jacques Allan,3,0,35,32
1746544821844,MATH 10B,B02,889828,Verstraete; Jacques Allan,3,0,35,32
1746544822870,MATH 10C,A01,889849,Habib; Yousaf,9,0,30,21
1746544822870,MATH 10C,A02,889852,Habib; Yousaf,14,0,30,16
1746544822870,MATH 10C,A03,889853,Habib; Yousaf,22,0,30,8
1746544822870,MATH 10C,A04,889858,Habib; Yousaf,20,0,30,10
1746544822870,MATH 10C,B01,889861,Staff,1,0,30,29
1746544822870,MATH 10C,B02,889862,Staff,24,0,30,6
1746544822870,MATH 10C,B03,889863,Staff,27,0,30,3
1746544822870,MATH 10C,B04,889967,Staff,23,0,30,7
1746544823896,MATH 18,A01,889974,Staff,7,0,30,23
1746544823896,MATH 18,A02,889977,Staff,20,0,30,10
1746544823896,MATH 18,B01,889984,Hardiman; Liam,22,0,30,8
1746544823896,MATH 18,B02,889985,Hardiman; Liam,25,0,30,5
1746544824930,MATH 20A,A01,889990,Suk; Andrew Hoon,29,0,35,6
1746544825959,MATH 20B,A01,889993,Ohm; Ko Woon,22,0,30,8
1746544825959,MATH 20B,A02,889994,Ohm; Ko Woon,30,0,30,0
1746544825959,MATH 20B,B01,889996,Ohm; Ko Woon,21,0,30,9
1746544825959,MATH 20B,B02,889997,Ohm; Ko Woon,23,0,30,7
1746544826984,MATH 20C,A01,889999,Hammock; Frances H,17,0,30,13
1746544826984,MATH 20C,A02,890003,Hammock; Frances H,23,0,30,7
1746544826984,MATH 20C,B01,890006,Hammock; Frances H,3,0,30,27
1746544826984,MATH 20C,B02,890007,Hammock; Frances H,11,0,30,19
1746544828017,MATH 20D,A01,890011,Cheng; Hsiao-Bing,1,1,30,29
1746544828017,MATH 20D,A02,890012,Cheng; Hsiao-Bing,14,0,30,16
1746544828017,MATH 20D,B01,890016,Cheng; Hsiao-Bing,13,0,30,17
1746544828017,MATH 20D,B02,890017,Cheng; Hsiao-Bing,13,0,30,17
1746544829049,MATH 20E,A01,890026,Harel; Guershon,1,0,30,29
1746544829049,MATH 20E,A02,890029,Harel; Guershon,23,0,30,7
1746544829049,MATH 20E,B01,890033,Harel; Guershon,7,0,30,23
1746544829049,MATH 20E,B02,890101,Harel; Guershon,21,0,30,9
1746544830075,MATH 102,A01,890104,Staff,17,0,30,13
1746544830075,MATH 102,A02,890105,Staff,27,0,30,3
1746544831101,MATH 103B,A01,890116,Salehi Golsefidy; Alireza,3,0,30,27
1746544831101,MATH 103B,B01,890118,Staff,0,3,34,34
1746544832127,MATH 109,A01,890121,Aliabadi Sr.; Mohsen,1,0,30,29
1746544832127,MATH 109,B01,890124,Upadrashta; Pranav Kumar,18,0,30,12
1746544833156,MATH 120A,A01,890126,Eggers; John Dietrich,13,0,30,17
1746544834180,MATH 142B,A01,890128,Ioana; Adrian,19,0,30,11
1746544834180,MATH 142B,A02,890129,Ioana; Adrian,13,0,30,17
1746544835207,MATH 154,A01,890174,Staff,0,0,30,30
1746544835207,MATH 154,A02,890182,Staff,0,0,30,30
1746544836232,MATH 168A,A01,890197,Dumitriu; Ioana,21,0,35,14
1746544837261,MATH 170A,A01,890240,Nie; Jiawang,1,0,30,29
1746544837261,MATH 170A,A02,890241,Nie; Jiawang,11,0,30,19
1746544837261,MATH 170A,A03,890249,Nie; Jiawang,23,0,30,7
1746544838286,MATH 170B,A01,957891,Nag; Panchali,13,0,35,22
1746544840340,MATH 181A,A01,908025,Staff,0,4,35,35
1746544840340,MATH 181A,A02,960115,Staff,27,0,35,8
1746544841368,MATH 181B,A01,959874,Staff,26,0,30,4
1746544842395,MATH 193B,A01,890265,Staff,0,4,35,35
1746544843421,MGT 4,A01,890311,Anderson; John Charles,42,0,88,46
1746544844450,MGT 5,A00,907740,Staff,13,0,98,85
1746544845494,MGT 12,A00,890312,Lindenberger; Wade Douglas,67,0,98,31
1746544846520,MGT 16,A00,957883,Staff,78,0,98,20
1746544848572,MGT 45,A00,890314,Pecore; Joseph P.,47,0,98,51
1746544849597,MGT 71,A00,890315,Staff,0,11,98,98
1746544850623,MGT 100,A00,890316,Yavorsky; Daniel Ryan,44,0,98,54
1746544851651,MGT 103,A00,890317,Ehrich; Kristine R,73,0,98,25
1746544852677,MGT 105,A00,890356,Bates; Kenneth Walter,0,7,98,98
1746544853702,MGT 112,A00,890360,Ehrich; Kristine R,55,0,98,43
1746544854728,MGT 127R,A00,907732,Zhu; Kevin Xiaoguo,23,0,98,75
1746544855754,MGT 131B,A00,890361,Anderson; John Charles,61,0,98,37
1746544856780,MGT 137,A00,890362,Lindenberger; Wade Douglas,65,0,98,33
1746544857807,MGT 160,A00,890369,Johnson; Erik Barry,9,0,98,89
1746544859856,MGT 164,A00,890372,Zimmermann; Carsten,0,39,98,98
1746544860881,MGT 180,A00,890374,Bliss; Barbara Ann,12,0,98,86
1746544861907,MMW 15,A01,886414,Chang; Edmond Yi-Teh,0,12,28,28
1746544861907,MMW 15,A02,886415,Chang; Edmond Yi-Teh,0,8,28,28
1746544861907,MMW 15,A03,886416,Chang; Edmond Yi-Teh,0,8,28,28
1746544861907,MMW 15,A04,886417,Chang; Edmond Yi-Teh,0,8,28,28
1746544861907,MMW 15,B01,886419,Chang; Edmond Yi-Teh,0,7,28,28
1746544861907,MMW 15,B02,886420,Chang; Edmond Yi-Teh,0,8,28,28
1746544861907,MMW 15,B03,886421,Chang; Edmond Yi-Teh,0,7,28,28
1746544861907,MMW 15,B04,886422,Chang; Edmond Yi-Teh,0,8,28,28
1746544861907,MMW 15,C01,886424,Staff,0,9,28,28
1746544861907,MMW 15,C02,886425,Staff,0,8,28,28
1746544861907,MMW 15,C03,886426,Staff,0,8,28,28
1746544861907,MMW 15,C04,886427,Staff,0,7,28,28
1746544861907,MMW 15,C05,958038,Staff,0,7,28,28
1746544861907,MMW 15,C06,958039,Staff,0,8,28,28
1746544862930,MMW 15GS,A00,906910,Patterson; Patrick H.,4,0,28,24
1746544863956,MMW 122R,A01,886429,Rahimi; Babak,0,13,28,28
1746544863956,MMW 122R,A02,886430,Rahimi; Babak,0,12,28,28
1746544863956,MMW 122R,A03,958040,Rahimi; Babak,0,11,28,28
1746544864983,MUS 1A,A01,890937,Staff,3,0,25,22
1746544864983,MUS 1A,A02,891035,Staff,6,0,25,19
1746544864983,MUS 1A,C01,958912,Staff,24,0,25,1
1746544864983,MUS 1A,C02,958913,Staff,25,0,25,0
1746544867035,MUS 2AK,A00,957092,Ohnishi; Takae,15,0,15,0
1746544868060,MUS 4,A01,891044,Staff,2,0,25,23
1746544868060,MUS 4,A02,891045,Staff,23,0,25,2
1746544868060,MUS 4,B01,891048,Staff,17,0,25,8
1746544868060,MUS 4,B02,891050,Staff,25,0,25,0
1746544869088,MUS 5,A01,957506,Dubnov; Shlomo,0,0,25,25
1746544869088,MUS 5,A02,957622,Dubnov; Shlomo,14,0,25,11
1746544869088,MUS 5,A03,957623,Dubnov; Shlomo,20,0,25,5
1746544870115,MUS 6,A01,891053,Freitas Caetano; Marcelo,24,0,25,1
1746544870115,MUS 6,A02,891054,Freitas Caetano; Marcelo,23,0,25,2
1746544871143,MUS 7,A01,891081,Staff,0,0,25,25
1746544871143,MUS 7,A02,891082,Staff,4,0,25,21
1746544872172,MUS 8GS,A00,891118,Borgo; David Garcia,0,0,25,25
1746544873200,MUS 11,A01,891140,Staff,11,0,25,14
1746544873200,MUS 11,A02,891141,Staff,22,0,25,3
1746544874224,MUS 13,A01,891143,Staff,8,0,25,17
1746544874224,MUS 13,A02,891144,Staff,24,0,25,1
1746544875250,MUS 15,A01,891146,Staff,9,0,25,16
1746544875250,MUS 15,A02,891148,Staff,21,0,25,4
1746544875250,MUS 15,B01,891150,Staff,18,0,25,7
1746544875250,MUS 15,B02,891151,Staff,25,0,25,0
1746544876278,MUS 20,A01,891153,Staff,5,0,20,15
1746544876278,MUS 20,A02,891155,Staff,14,0,20,6
1746544877307,MUS 80,A00,891156,Staff,19,0,25,6
1746544877307,MUS 80,B00,891157,Staff,23,0,25,2
1746544878333,MUS 130,A00,891158,Ohnishi; Takae,35,0,35,0
1746544879358,MUS 150GS,A01,891160,Borgo; David Garcia,0,0,25,25
1746544880384,MUS 170,A01,891162,Freitas Caetano; Marcelo,20,0,25,5
1746544880384,MUS 170,A02,891164,Freitas Caetano; Marcelo,21,0,25,4
1746544881408,NANO 11,A00,886220,Vazquez Mena; Oscar,13,0,15,2
1746544882439,NANO 15,A01,886222,Drews; Aaron,4,0,7,3
1746544883465,NANO 104,A00,886224,Sirbuly; Donald,18,0,25,7
1746544884489,PH 40,A00,886528,Staff,23,0,40,17
1746544885518,PH 45,A01,886799,Staff,35,0,40,5
1746544886547,PH 110,A00,886802,Staff,0,7,40,40
1746544887575,PH 172,A00,906716,Staff,19,0,35,16
1746544888602,PH 191,A00,886803,Staff,6,0,40,34
1746544889630,PHIL 1,A00,889500,Staff,19,0,30,11
1746544890658,PHIL 10,A01,889549,Grush; Rick Scott,15,0,22,7
1746544890658,PHIL 10,A02,889551,Grush; Rick Scott,22,0,22,0
1746544891688,PHIL 28,A01,889559,Lamey; Andy M.,0,1,31,31
1746544891688,PHIL 28,A02,889561,Lamey; Andy M.,0,1,30,30
1746544891688,PHIL 28,A03,889572,Lamey; Andy M.,0,0,30,30
1746544892714,PHIL 35,A00,907839,Staff,13,0,15,2
1746544893738,PHIL 60,A00,889574,Staff,74,0,90,16
1746544894765,PHIL 101,A00,958004,Staff,13,0,15,2
1746544896818,PHIL 136,A00,889582,Fulkerson; Matthew Todd,26,0,45,19
1746544897848,PHIL 163,A01,889601,Staff,21,0,30,9
1746544897848,PHIL 163,B01,889606,Brandt; Reuven A,0,3,0,0
1746544898873,PHIL 164,A00,889610,Staff,16,0,30,14
1746544899900,PHIL 165,A00,889613,Staff,23,0,30,7
1746544900925,PHYS 1A,A00,886431,Staff,26,0,70,44
1746544901949,PHYS 1AL,001,886432,Tsai; Philbert S,0,2,30,30
1746544901949,PHYS 1AL,002,886436,Tsai; Philbert S,11,0,30,19
1746544902976,PHYS 1B,A00,886439,Staff,185,0,240,55
1746544904003,PHYS 1BL,001,886441,Tsai; Philbert S,0,4,30,30
1746544904003,PHYS 1BL,002,886444,Tsai; Philbert S,2,0,30,28
1746544905032,PHYS 1C,A00,896092,Arnold; Kam S,78,0,146,68
1746544906058,PHYS 1CL,001,886448,Tsai; Philbert S,0,0,30,30
1746544906058,PHYS 1CL,002,886449,Tsai; Philbert S,0,0,30,30
1746544906058,PHYS 1CL,003,886450,Tsai; Philbert S,16,0,30,14
1746544906058,PHYS 1CL,004,886451,Tsai; Philbert S,15,0,30,15
1746544907086,PHYS 2B,A01,886457,Staff,69,0,115,46
1746544908113,PHYS 2C,A01,886460,Shotwell; Brian,0,8,65,65
1746544909142,PHYS 2CL,A01,886467,Staff,0,4,28,28
1746544909142,PHYS 2CL,A02,886468,Staff,0,3,28,28
1746544910170,PHYS 2D,A01,886470,Staff,10,0,50,40
1746544911193,PHYS 4B,A01,886475,Grinstein; Benjamin,22,0,40,18
1746544912219,POLI 5,A00,891173,Desposato; Scott,7,0,25,18
1746544913245,POLI 5D,A01,891175,Staff,5,0,5,0
1746544913245,POLI 5D,B01,891178,Staff,5,0,5,0
1746544914270,POLI 11,A00,891179,Ferree; Karen E,2,0,35,33
1746544915298,POLI 12,A00,891180,Staff,16,0,30,14
1746544916322,POLI 27,A01,891182,Staff,12,0,75,63
1746544917349,POLI 30,A00,891183,Staff,8,0,50,42
1746544918374,POLI 100B,A00,891244,Staff,5,1,35,30
1746544919401,POLI 100I,A00,891247,Staff,7,0,30,23
1746544920430,POLI 104J,A00,891248,Nichter; Maysa,14,0,30,16
1746544921453,POLI 104U,A00,891250,Nichter; Maysa,2,0,30,28
1746544923503,POLI 110B,A00,891255,Wiens; David,20,0,25,5
1746544924527,POLI 112A,A00,891256,Wiens; David,6,0,25,19
1746544925553,POLI 114BR,A00,891261,Staff,19,0,30,11
1746544926579,POLI 117R,A00,891262,Forman; Fonna,0,6,50,50
1746544927608,POLI 118,A00,891264,Ingham; Sean,17,0,25,8
1746544928638,POLI 124A,A00,891265,Staff,18,0,20,2
1746544929670,POLI 125D,A00,891266,Nichter; Simeon C,2,0,25,23
1746544930700,POLI 126,A00,891268,Nichter; Simeon C,7,0,25,18
1746544931725,POLI 126AA,A00,891272,Staff,18,0,25,7
1746544932754,POLI 130AA,A00,891273,Staff,15,0,20,5
1746544933779,POLI 134AA,A00,891274,Staff,4,0,20,16
1746544935831,POLI 138,A00,891278,Staff,21,0,25,4
1746544936857,POLI 142K,A00,891280,Staff,11,0,25,14
1746544937884,POLI 142M,A00,891281,Gartzke; Erik,17,0,30,13
1746544938913,POLI 142P,A00,891284,Staff,20,0,30,10
1746544939940,POLI 143,A00,891285,Gartzke; Erik,12,0,30,18
1746544940966,POLI 153,A00,891286,Staff,19,0,20,1
1746544943019,POLI 175,A00,891290,Staff,15,0,20,5
1746544944046,PSYC 1,A00,890674,Steiner; Eric Tomas,0,11,45,45
1746544945072,PSYC 2,A00,890676,Albright; Thomas D,21,0,35,14
1746544946098,PSYC 3,A00,890679,Staff,17,0,20,3
1746544947124,PSYC 6,A00,959858,Staff,20,0,20,0
1746544948154,PSYC 60,A01,890684,Rickard; Timothy C.,0,5,45,45
1746544949182,PSYC 70,A01,890689,Geller; Emma Harlan,7,0,30,23
1746544950208,PSYC 71,A01,959860,Staff,21,0,25,4
1746544951237,PSYC 100,A00,890690,Lacefield; Katharine I,0,50,180,180
1746544952263,PSYC 102,A00,890695,Staff,18,0,40,22
1746544953290,PSYC 105,A00,890699,Geller; Emma Harlan,71,0,100,29
1746544954315,PSYC 106,A00,890701,Gorman; Michael R.,5,0,30,25
1746544955341,PSYC 108,A00,890704,Adrian; Julia Anna,0,28,50,50
1746544956365,PSYC 118,A01,890712,Staff,11,0,30,19
1746544957393,PSYC 124,A00,890716,Chapman; Eddie Nathaniel,25,0,60,35
1746544958418,PSYC 131,A00,890717,Anagnostaras; Stephan,0,7,80,80
1746544959449,PSYC 137,A00,890719,Winkielman; Piotr,0,11,30,30
1746544960474,PSYC 144,A00,890721,Adrian; Julia Anna,0,9,45,45
1746544961498,PSYC 162,A00,890805,Staff,2,0,75,73
1746544962528,PSYC 169,A00,890810,Staff,0,15,30,30
1746544963554,PSYC 172,A00,890814,Gorman; Michael R.,9,0,30,21
1746544964579,PSYC 181,A00,890818,Anagnostaras; Stephan,8,0,200,192
1746544965608,PSYC 184,A00,959861,Staff,170,0,175,5
1746544966635,PSYC 189,A00,890823,Staff,0,1,30,30
1746544967662,PSYC 191,A00,890884,Rickard; Timothy C.,0,11,35,35
1746544968687,PSYC 193,A00,890913,Staff,19,0,30,11
1746544968687,PSYC 193,B00,890914,Chapman; Eddie Nathaniel,24,0,30,6
1746544969713,PSYC 193L,A01,890918,Lowe; Angela Beth,20,0,30,10
1746544969713,PSYC 193L,B01,890921,Hurwitz; Ethan Scott,20,0,30,10
1746544969713,PSYC 193L,C01,890928,Staff,30,0,30,0
1746544970745,RELI 149,A00,886806,Rahimi; Babak,23,0,40,17
1746544971775,SE 9,A01,886814,Staff,7,0,20,13
1746544972803,SE 101B,A01,886816,Chadha; Mayank,4,0,35,31
1746544973889,SE 110B,A00,886818,Zhu; Qiang,4,0,75,71
1746544974914,SE 125,A01,886830,Staff,10,0,30,20
1746544975949,SE 130B,A01,886835,Staff,14,0,40,26
1746544976979,SE 131A,A01,886838,Krysl; Petr,34,0,55,21
1746544978009,SE 154,A00,886840,Staff,30,0,50,20
1746544979033,SE 164GS,A01,886849,Staff,6,0,20,14
1746544980059,SE 167GS,A01,886853,Staff,6,0,20,14
1746544981088,SIO 25,A01,890107,Staff,19,0,30,11
1746544982112,SIO 45,A00,890109,Cook; Geoffrey W,117,0,200,83
1746544983137,SIO 109R,A00,890110,Forman; Fonna,0,16,20,20
1746544984165,SIO 187,A01,890114,Kacev; David,15,0,40,25
1746544985192,SOCI 1,A01,890431,Thorpe; Charles Robert,15,0,30,15
1746544985192,SOCI 1,A02,890518,Thorpe; Charles Robert,30,0,30,0
1746544986222,SOCI 2,A01,957978,Staff,25,0,25,0
1746544986222,SOCI 2,A02,957979,Staff,23,0,25,2
1746544987251,SOCI 20,A01,890523,Calderon-Zaks; Michael Aar,23,0,30,7
1746544987251,SOCI 20,A02,890526,Calderon-Zaks; Michael Aar,29,0,30,1
1746544988276,SOCI 30,A01,890533,Pardo Guerra; Juan Pablo,37,0,40,3
1746544989301,SOCI 40,A01,890535,Staff,27,0,45,18
1746544990326,SOCI 104Q,A00,890559,Staff,18,0,30,12
1746544991356,SOCI 106,A00,890560,Arnal; Maud Marie Leonie,20,0,30,10
1746544992382,SOCI 110,A00,890567,Holkenbrink-Monk; Charlene,19,0,30,11
1746544993407,SOCI 112,A00,890568,Victoria Torres; Pablo,1,0,55,54
1746544994433,SOCI 115,A00,890597,Arnal; Maud Marie Leonie,28,0,45,17
1746544996488,SOCI 121,A00,890604,Pardo Guerra; Juan Pablo,38,0,45,7
1746544997515,SOCI 126,A01,890608,Staff,8,0,10,2
1746544998543,SOCI 127,A00,890609,Staff,18,0,30,12
1746544999573,SOCI 131,A00,890610,Thorpe; Charles Robert,37,0,45,8
1746545000599,SOCI 135,A00,890615,Payne; Christine Anna,14,0,45,31
1746545001626,SOCI 139,A00,890620,Staff,38,0,45,7
1746545002652,SOCI 148E,A00,890622,Calderon-Zaks; Michael Aar,36,0,45,9
1746545003682,SOCI 150,A00,890623,Kohler; Kristopher M.,31,0,45,14
1746545004707,SOCI 157,A00,890625,Jules-Rosette; Bennetta W.,18,0,20,2
1746545005736,SOCI 160,A00,890627,Payne; Christine Anna,21,0,45,24
1746545006768,SYN 1,A00,886855,Fish; Gwendolyn Anne,0,0,0,0
1746545006768,SYN 1,B00,906086,Fish; Gwendolyn Anne,0,1,0,2
1746545007793,SYN 2R,A00,886860,Staff,0,17,15,15
1746545007793,SYN 2R,B00,906106,Atkinson; Arthur Laird,0,16,15,15
1746545008831,SYN 100,A01,886866,Browne; Emily,0,28,20,20
1746545008831,SYN 100,B01,906128,Rock; Martin,0,5,20,20
1746545008831,SYN 100,C01,906140,Deavenport; James Cary,0,3,20,20
1746545008831,SYN 100,D01,907816,Deavenport; James Cary,0,5,20,20
1746545009862,TDAC 1,A00,890286,Walsh; Kim C.,9,0,20,11
1746545010891,TDAC 101,A00,890296,Basso; Beatrice,16,0,20,4
1746545011918,TDDE 131,A00,890297,Staff,47,0,50,3
1746545012947,TDDM 1,A00,890287,Weinberg; Sadie,25,0,30,5
1746545013977,TDGE 11,A00,890288,Fulton; Julia,137,0,200,63
1746545013977,TDGE 11,B00,890289,Castro; Robert Jess,184,0,200,16
1746545015002,TDGE 25,B00,957359,Walsh; Kim C.,3,0,20,17
1746545016027,TDGE 40,A01,890292,Power; Jade Yukana,27,0,30,3
1746545017051,TDGE 124,A00,890298,Havis; Allan,0,0,50,50
1746545018076,TDGE 131R,A00,890299,Burelle; Julie Sara Veronique,15,0,42,27
1746545019104,TDHT 101,A00,890300,Staff,10,0,20,10
1746545020132,TDHT 109,A01,890302,Anderson; Mysia Anyse,31,0,40,9
1746545021157,TDMV 1,A00,890293,Arcidiacono; Kristin,18,0,30,12
1746545022187,TDMV 2,A00,890294,Weinberg; Sadie,23,0,30,7
1746545023216,TDMV 3,A00,957878,Arcidiacono; Kristin,28,0,30,2
1746545025268,TDMV 138,A00,890304,Jun; Grace Shin Hae,25,0,40,15
1746545026295,TDMV 140,A00,890305,Corrales; Joseph Bernales,25,0,30,5
1746545027326,TDMV 142,A00,890307,Caligagan; Tony,32,0,40,8
1746545028352,TDMV 144,A00,890308,Camaya; Michelle Ann,25,0,30,5
1746545029378,TDPW 1,A00,890295,Stein; Deborah Isobel,3,0,20,17
1746545030405,USP 2,A01,890272,Lerner; Amy M,6,0,20,14
1746545031431,USP 3,A01,890274,Staff,12,0,30,18
1746545032462,USP 15,A01,890276,Sun; Feiyang,17,0,30,13
1746545033493,USP 25,A00,890277,Shenkman; Michael Thomas,19,0,25,6
1746545034519,USP 138,A00,890278,Staff,13,0,25,12
1746545035545,USP 143,A00,890279,Staff,21,0,70,49
1746545036572,USP 144,A00,890280,Chowdhury; Muhammed Zohir,16,0,30,14
1746545037599,USP 150,A00,890281,Boomhower; Matthew Charles,4,0,30,26
1746545038624,USP 151,A00,890282,Staff,16,0,20,4
1746545039650,USP 162,A00,890283,Andrews; Abigail Leslie,16,0,20,4
1746545040680,USP 168,A00,920477,Kwak; Nancy,1,0,5,4
1746545041708,USP 181,A00,890284,Staff,3,0,20,17
1746545042733,USP 191A,A00,890285,Staff,13,0,20,7
1746545043762,VIS 101,A00,886512,Staff,25,0,75,50
1746545044794,VIS 103,A00,886513,Cruz; Edwin Teddy,61,0,75,14
1746545045823,VIS 108,A00,886514,Staff,3,0,15,12
1746545046850,VIS 127P,A00,886515,Shen; Kuiyi,80,0,146,66
1746545047881,VIS 149,A00,886516,Yoldas; Pinar,0,0,15,15
1746545048908,VIS 164,A00,886526,Erdmann; Dean,19,0,22,3
1746545049933,VIS 194S,A00,886527,Staff,61,0,75,14
1746545050967,WCWP 10A,C00,886484,Martiniuk; Jill,12,0,15,3
1746545052063,WCWP 10B,A00,886490,Uriarte; Emma,0,0,15,15
1746545052063,WCWP 10B,B00,886491,Dhir; Simrita,11,0,15,4
1746545052063,WCWP 10B,C00,886492,Ornelas; Tricia,0,0,15,15
1746545053096,WCWP 100,A00,886494,Young; Mark T,0,7,15,15
1746545055291,AAS 10,A01,886199,Childs; Dennis R.,0,3,0,0
1746545056318,ANAR 104,A01,886940,Shtienberg; Gilad,27,0,30,3
1746545057346,ANAR 120,A00,886953,Staff,12,0,20,8
1746545058375,ANBI 148,A01,886955,Wilder; Linnea Lorene,30,0,40,10
1746545060427,ANSC 122,A00,886957,Staff,25,0,30,5
1746545061457,ANSC 150,A00,886958,Sloane; Julia Kathryn,3,0,15,12
1746545062483,ANSC 156,A00,886959,Jenkins; Janis A.,0,1,15,15
1746545063508,ANSC 180,A00,886960,Staff,11,0,17,6
1746545064535,ANSC 188,A00,886961,Jassal; Aftab,9,0,25,16
1746545065564,ANSC 190,A00,886962,Jassal; Aftab,14,0,25,11
1746545066591,ANSC 191,A00,886963,Staff,18,0,20,2
1746545067623,ANTH 3,A01,891689,Staff,17,0,20,3
1746545068649,ANTH 5,A00,886933,Semendeferi; Ekaterini,16,0,20,4
1746545069673,ANTH 10,A00,886934,Staff,0,12,30,30
1746545070699,ANTH 21,A01,886936,Staff,40,0,60,20
1746545071726,ANTH 23,A01,886938,Staff,92,0,100,8
1746545072754,ANTH 105,A00,886964,Stewart; Alexander B,84,0,100,16
1746545073784,ANTH 108,A00,886965,Pedersen; David,9,0,20,11
1746545074819,AWP 10,001,886147,Staff,0,0,0,0
1746545074819,AWP 10,002,886148,Staff,0,0,0,0
1746545074819,AWP 10,003,886149,Staff,0,0,0,0
1746545074819,AWP 10,004,886150,Staff,0,0,0,0
1746545074819,AWP 10,005,886151,Staff,0,0,0,0
1746545074819,AWP 10,006,886152,Staff,0,0,0,0
1746545074819,AWP 10,007,886153,Staff,0,0,0,0
1746545074819,AWP 10,008,886154,Staff,0,0,0,0
1746545074819,AWP 10,009,886155,Staff,0,0,0,0
1746545074819,AWP 10,010,886156,Staff,0,0,0,0
1746545074819,AWP 10,011,886158,Staff,0,0,0,0
1746545074819,AWP 10,012,886160,Staff,0,0,0,0
1746545074819,AWP 10,013,886161,Staff,0,0,0,0
1746545074819,AWP 10,014,886162,Staff,0,0,0,0
1746545074819,AWP 10,015,886163,Staff,0,0,0,0
1746545074819,AWP 10,016,886164,Staff,0,0,0,0
1746545074819,AWP 10,017,886165,Staff,0,0,0,0
1746545074819,AWP 10,018,886166,Staff,0,0,0,0
1746545074819,AWP 10,019,886168,Staff,0,0,0,0
1746545074819,AWP 10,020,886170,Staff,0,0,0,0
1746545074819,AWP 10,021,886172,Staff,0,0,0,0
1746545075846,AWP 10R,001,886173,Staff,0,1,0,0
1746545075846,AWP 10R,002,886174,Staff,0,1,0,0
1746545075846,AWP 10R,003,886175,Staff,0,0,0,0
1746545075846,AWP 10R,004,886176,Staff,0,0,0,0
1746545075846,AWP 10R,005,886177,Staff,0,0,0,0
1746545075846,AWP 10R,006,886178,Staff,0,0,0,0
1746545075846,AWP 10R,007,886179,Staff,0,0,0,0
1746545075846,AWP 10R,008,886181,Staff,0,0,0,0
1746545075846,AWP 10R,009,886182,Staff,0,0,0,0
1746545075846,AWP 10R,010,886183,Staff,0,0,0,0
1746545075846,AWP 10R,011,886184,Staff,0,0,0,0
1746545075846,AWP 10R,012,886185,Staff,0,0,0,0
1746545075846,AWP 10R,013,886186,Staff,0,0,0,0
1746545075846,AWP 10R,014,886187,Staff,0,0,0,0
1746545075846,AWP 10R,015,886188,Staff,0,0,0,0
1746545075846,AWP 10R,016,886189,Staff,0,0,0,0
1746545076873,AWP 102R,A00,886190,Staff,0,0,0,0
1746545076873,AWP 102R,B00,886191,Staff,0,0,0,0
1746545077900,BENG 100,A01,886193,Staff,17,0,30,13
1746545078930,BENG 122A,A01,886195,Hasty; Jeff M,13,0,30,17
1746545079956,BENG 166A,A00,886196,Sah; Robert Lie-Yuan,0,1,30,30
1746545080988,BENG 190,A00,958050,Khojah; Reem I,24,0,25,1
1746545082012,BIBC 102,A01,894320,Staff,0,0,46,46
1746545082012,BIBC 102,A02,894321,Staff,0,0,46,46
1746545082012,BIBC 102,A03,894344,Staff,7,0,46,39
1746545082012,BIBC 102,A04,894345,Staff,26,0,47,21
1746545083040,BICD 100R,A01,894365,Smith; Laurie,0,3,58,58
1746545083040,BICD 100R,A02,894366,Smith; Laurie,0,5,58,58
1746545083040,BICD 100R,A03,894367,Smith; Laurie,2,0,59,57
1746545083040,BICD 100R,A04,959869,Smith; Laurie,41,0,59,18
1746545084072,BICD 136,A01,894383,Gustafson-Brown; Cindy,14,0,50,36
1746545085101,BIEB 102,A01,894494,Butler; Shannon Rhey,51,0,130,79
1746545087159,BIEB 150,A01,894617,Wills; Christopher,3,0,20,17
1746545087159,BIEB 150,A02,894631,Wills; Christopher,3,0,20,17
1746545087159,BIEB 150,A03,894937,Wills; Christopher,3,0,20,17
1746545087159,BIEB 150,A04,894946,Wills; Christopher,5,0,20,15
1746545088184,BIEB 194,A00,906141,Kurle; Carolyn M.,6,0,20,14
1746545089214,BILD 1,A01,894154,Staff,2,0,19,17
1746545089214,BILD 1,A02,894155,Staff,14,0,19,5
1746545089214,BILD 1,A03,894160,Staff,13,0,19,6
1746545089214,BILD 1,A04,894161,Staff,15,0,18,3
1746545090239,BILD 2,A01,894168,Staff,0,0,50,50
1746545090239,BILD 2,A02,894169,Staff,0,0,50,50
1746545090239,BILD 2,A03,894179,Staff,4,0,50,46
1746545090239,BILD 2,A04,894203,Staff,27,0,50,23
1746545091267,BILD 3,A01,894213,Staff,22,0,31,9
1746545091267,BILD 3,A02,894214,Staff,26,0,31,5
1746545091267,BILD 3,A03,894235,Staff,28,0,31,3
1746545091267,BILD 3,A04,894236,Staff,28,0,32,4
1746545092293,BILD 4,A01,894253,Reuther; Keefe,5,0,24,19
1746545092293,BILD 4,A02,894258,Reuther; Keefe,16,0,24,8
1746545093321,BILD 5,A01,894276,Reuther; Keefe,35,0,50,15
1746545093321,BILD 5,A02,894277,Reuther; Keefe,45,0,50,5
1746545093321,BILD 5,A03,894290,Reuther; Keefe,44,0,50,6
1746545093321,BILD 5,A04,894291,Reuther; Keefe,48,0,50,2
1746545094353,BILD 24,A01,894297,Pirino; Giorgia,40,0,60,20
1746545095380,BIMM 100,B01,958915,Staff,72,0,100,28
1746545096411,BIMM 101,A01,895017,McDonnell; Lisa Marie,0,5,24,24
1746545096411,BIMM 101,A02,895018,McDonnell; Lisa Marie,0,5,24,24
1746545096411,BIMM 101,B01,895020,McDonnell; Lisa Marie,0,6,24,24
1746545096411,BIMM 101,B02,895021,McDonnell; Lisa Marie,0,4,24,24
1746545097442,BIMM 110,A01,895023,Staff,1,0,25,24
1746545097442,BIMM 110,A02,895024,Staff,9,0,25,16
1746545097442,BIMM 110,A03,895025,Staff,18,0,25,7
1746545097442,BIMM 110,A04,895031,Staff,20,0,25,5
1746545098467,BIMM 120,A01,895114,Gustafson-Brown; Cindy,13,0,28,15
1746545098467,BIMM 120,A02,895126,Gustafson-Brown; Cindy,21,0,27,6
1746545099494,BIPN 100,A01,895130,Yang; Mingyu,1,0,38,37
1746545099494,BIPN 100,A02,895131,Yang; Mingyu,32,0,38,6
1746545099494,BIPN 100,A03,895132,Yang; Mingyu,32,0,38,6
1746545099494,BIPN 100,A04,895133,Yang; Mingyu,27,0,36,9
1746545100523,BIPN 120,A01,895135,Cooke; James Edward,0,3,13,13
1746545100523,BIPN 120,A02,895136,Cooke; James Edward,0,1,13,13
1746545100523,BIPN 120,A03,895137,Cooke; James Edward,0,3,13,13
1746545100523,BIPN 120,A04,895156,Cooke; James Edward,0,2,11,11
1746545101551,BIPN 134,A01,895235,Cooke; James Edward,0,2,25,25
1746545101551,BIPN 134,A02,895237,Cooke; James Edward,0,0,25,25
1746545101551,BIPN 134,A03,895240,Cooke; James Edward,3,0,25,22
1746545101551,BIPN 134,A04,895270,Cooke; James Edward,20,0,25,5
1746545102580,BIPN 189,A00,892103,Staff,0,13,14,14
1746545104637,BISP 194,A00,958008,Staff,0,2,0,0
1746545105669,CAT 124,A01,922009,Staff,0,5,20,20
1746545106706,CAT 125R,A00,886390,Morales; Celeste Georgianna,0,2,20,20
1746545106706,CAT 125R,B00,886391,Irwin; Matthew Joseph,0,3,20,20
1746545106706,CAT 125R,C00,886392,Smith; Lauryn Alissa,0,2,20,20
1746545106706,CAT 125R,D00,886393,Vanderschuit; Maya Alysia,0,2,20,20
1746545106706,CAT 125R,E00,886394,Marchisotto; Jennifer Anne,0,4,20,20
1746545107738,CENG 15,A01,886218,Drews; Aaron,3,0,8,5
1746545108764,CENG 113,A00,886219,Opatkiewicz; Justin Paul,15,0,25,10
1746545109790,CGS 101,A00,887044,Staff,7,0,20,13
1746545110817,CGS 105,A01,887046,Staff,14,0,25,11
1746545111846,CGS 112,A00,887047,Cuong; Marisol,12,0,15,3
1746545112870,CGS 113,A00,887048,Staff,23,0,30,7
1746545113894,CGS 120,A00,887049,Staff,10,0,17,7
1746545114920,CHEM 6A,A01,886336,Lam; Tin Yiu,38,0,50,12
1746545114920,CHEM 6A,A02,886338,Lam; Tin Yiu,37,0,50,13
1746545115950,CHEM 6B,A01,886341,Hopkins; Patrycja Anna,16,0,50,34
1746545115950,CHEM 6B,A02,886343,Hopkins; Patrycja Anna,42,0,50,8
1746545116976,CHEM 6C,A01,886346,Albizati; Kim F.,0,2,50,50
1746545116976,CHEM 6C,A02,886348,Albizati; Kim F.,23,0,50,27
1746545118003,CHEM 40A,A01,886352,Klosterman; Jeremy K,65,0,100,35
1746545119031,CHEM 40B,A01,886356,Klosterman; Jeremy K,0,23,100,100
1746545120061,CHEM 41B,A01,886360,Theodorakis; Emmanuel,25,0,50,25
1746545120061,CHEM 41B,A02,886362,Theodorakis; Emmanuel,47,0,50,3
1746545121088,CHIN 165A,A00,886382,Xu; Li,18,0,20,2
1746545122118,CLAS 120,A00,886387,Myerston Santana; Jacobo,33,0,40,7
1746545123145,COGS 9,A01,886967,Shannon; Kyle Michael,42,0,60,18
1746545124171,COGS 11,A01,886969,Staff,11,0,30,19
1746545125197,COGS 14A,A01,886971,Staff,6,0,60,54
1746545126224,COGS 14B,A01,886973,Hoffman; Drew Ellen,4,0,60,56
1746545127250,COGS 18,A01,886975,Morgan; Eric,35,0,60,25
1746545128274,COGS 20,A01,886977,Staff,4,0,8,4
1746545128274,COGS 20,A02,886978,Staff,5,0,7,2
1746545129303,COGS 100,A01,907783,Staff,0,2,30,30
1746545130327,COGS 101B,A01,886980,Staff,0,3,48,48
1746545131354,COGS 101C,A01,886982,Delgado; Tania,0,5,44,44
1746545132383,COGS 102A,A01,886984,Johnson; Christine M.,4,0,30,26
1746545133409,COGS 118B,A01,886986,Staff,0,3,88,88
1746545134438,COGS 150,A01,886988,Bergen; Benjamin,23,0,50,27
1746545135470,COGS 153,A00,886989,Delgado; Tania,0,2,41,41
1746545136496,COGS 186,A01,886991,Staff,0,0,32,32
1746545137522,COGS 187A,A01,886993,Boyle; Mary E. T.,7,0,30,23
1746545138550,COGS 189,A00,886994,Staff,0,1,30,30
1746545139577,COMM 10,A01,886996,Staff,0,0,20,21
1746545139577,COMM 10,A02,886997,Staff,12,0,20,8
1746545139577,COMM 10,A03,959845,Staff,19,0,20,1
1746545140609,COMM 20,A01,886999,Leuning; Grant Maurstad,24,0,40,16
1746545142664,COMM 100A,A01,887002,Staff,0,0,20,25
1746545142664,COMM 100A,A02,887003,Staff,7,0,20,13
1746545143692,COMM 100B,A01,887005,Staff,0,8,20,24
1746545144716,COMM 106D,A00,887006,Staff,14,0,40,26
1746545145744,COMM 110G,A00,887007,Whitworth-Smith; Andrew C,12,0,40,28
1746545146770,COMM 111B,A00,887008,Staff,31,0,40,9
1746545147801,COMM 113T,A00,887009,Abuelhiga; Soraya Jill,28,0,40,12
1746545147801,COMM 113T,B00,906733,Staff,40,0,40,0
1746545148826,COMM 145,A00,887010,Staff,12,0,40,28
1746545149851,COMM 146,A00,887054,Staff,31,0,40,9
1746545150879,COMM 190,A00,887012,Staff,8,0,23,15
1746545151905,CSE 8A,A50,887015,Cao; Yingjun,57,0,85,28
1746545152932,CSE 11,A01,887017,Cao; Yingjun,12,0,70,58
1746545153959,CSE 20,A01,887019,Staff,30,0,50,20
1746545155015,CSE 21,A01,887021,Staff,78,0,100,22
1746545155015,CSE 21,B01,892583,Braun; Oliver,45,0,50,5
1746545156043,CSE 30,A01,887025,Eldon; John,143,0,200,57
1746545157069,CSE 100,A01,887027,Staff,26,0,50,24
1746545157069,CSE 100,A02,887028,Staff,40,0,50,10
1746545158096,CSE 101,A01,887030,Braun; Oliver,75,0,100,25
1746545158096,CSE 101,B01,887032,Jones; Miles E,0,3,50,50
1746545158096,CSE 101,B02,887033,Jones; Miles E,0,1,50,50
1746545159125,CSE 105,A01,908084,Jones; Miles E,32,0,50,18
1746545159125,CSE 105,A02,908087,Jones; Miles E,33,0,50,17
1746545160156,CSE 135,A01,887035,Powell; Thomas Allan,0,4,50,50
1746545161182,CSE 142,A01,887037,Staff,8,0,60,52
1746545162211,CSE 142L,A01,887039,Staff,34,0,60,26
1746545163242,CSE 151A,A01,887041,Solares; Edwin A,48,0,100,52
1746545164271,CSE 175,A01,887043,Kumar; Rakesh,30,0,30,0
1746545165300,CSS 1,A01,886389,Staff,0,1,40,40
1746545166328,DSC 30,A01,908097,Liao; Soohyun Nam,47,0,75,28
1746545167354,DSC 40A,A01,908099,Shannon; Kyle Michael,30,0,50,20
1746545168379,DSC 40B,A01,908112,Staff,16,0,50,34
1746545169408,DSC 80,A01,908116,Staff,19,0,60,41
1746545170437,DSC 197,001,956863,Eldridge; Justin Matthew,9999,0,9999,0
1746545171464,ECE 5,A01,886400,Morris; Karcher William,2,0,6,4
1746545171464,ECE 5,A02,886401,Morris; Karcher William,3,0,6,3
1746545172490,ECE 148,A01,886403,Silberman; Jack,0,14,14,14
1746545173518,ECON 1,A01,887265,Crane; Meredith Helen,12,0,70,58
1746545173518,ECON 1,B01,887268,Staff,43,0,50,7
1746545174546,ECON 2,A01,887273,Crane; Meredith Helen,56,0,70,14
1746545175573,ECON 3,A01,887279,Rondina; Giacomo,32,0,70,38
1746545176597,ECON 4,A01,887282,Anderson; John Charles,0,2,10,10
1746545177623,ECON 5,A01,887285,Staff,33,0,45,12
1746545177623,ECON 5,B01,887292,Staff,41,0,45,4
1746545178649,ECON 100A,A01,887337,Newhouse; Herbert S,54,0,70,16
1746545178649,ECON 100A,B01,887349,Staff,45,0,50,5
1746545179674,ECON 100B,A01,887361,Du; Songzi,29,0,70,41
1746545180705,ECON 100C,A01,887445,Newhouse; Herbert S,59,0,70,11
1746545181731,ECON 105,A00,887488,Vespa; Emanuel Ignacio,23,0,35,12
1746545182766,ECON 109,A01,887506,Shishkin; Denis,28,0,35,7
1746545183806,ECON 110A,A01,887568,Alon; Titan Michael,0,3,35,35
1746545183806,ECON 110A,B01,907601,Alon; Titan Michael,20,0,35,15
1746545184836,ECON 110B,A01,887598,Levkoff; Steven B.,0,23,70,70
1746545185865,ECON 112,A00,887599,Rondina; Giacomo,19,0,35,16
1746545186890,ECON 120A,A01,887603,Dai; Yinlin,36,0,70,34
1746545187922,ECON 120C,A01,887608,Sun; Yixiao,0,1,35,35
1746545187922,ECON 120C,B01,887614,Sun; Yixiao,0,0,35,35
1746545188951,ECON 138,A00,887621,Bharadwaj; Prashant,0,20,20,20
1746545189978,ECON 144,A00,958007,Squires; Dale E,13,0,35,22
1746545191004,ECON 171,A01,907666,Staff,18,0,35,17
1746545192030,ECON 175,A00,887626,Wu; Pak Yeung,23,0,35,12
1746545193056,ECON 190,A00,887640,Vespa; Emanuel Ignacio,23,0,35,12
1746545194086,EDS 25,A01,888197,Staff,0,0,0,0
1746545194086,EDS 25,A02,888209,Staff,0,0,0,0
1746545194086,EDS 25,A03,888210,Staff,0,0,0,0
1746545194086,EDS 25,A04,888212,Staff,0,0,0,0
1746545194086,EDS 25,A05,888213,Staff,0,0,0,0
1746545194086,EDS 25,A06,888214,Staff,0,0,0,0
1746545194086,EDS 25,A07,888235,Staff,0,2,0,0
1746545194086,EDS 25,A08,888236,Staff,0,0,0,0
1746545194086,EDS 25,A09,888240,Staff,0,0,0,0
1746545194086,EDS 25,A10,888244,Staff,0,0,0,0
1746545194086,EDS 25,B01,888273,Staff,0,0,0,0
1746545194086,EDS 25,B02,888285,Staff,0,0,0,0
1746545194086,EDS 25,B03,888423,Staff,0,0,0,1
1746545194086,EDS 25,B04,888432,Staff,0,0,0,0
1746545194086,EDS 25,B05,888433,Staff,0,0,0,0
1746545194086,EDS 25,B06,888467,Staff,0,0,0,0
1746545194086,EDS 25,B07,888468,Staff,0,0,0,0
1746545194086,EDS 25,B08,888479,Staff,0,0,0,0
1746545194086,EDS 25,B09,888484,Staff,0,0,0,0
1746545194086,EDS 25,B10,888487,Staff,0,0,0,0
1746545195118,EDS 38,A01,907700,Choi; Bailey Miyeon,30,0,30,0
1746545196146,EDS 112,A01,888601,Chapman; Thandeka K,14,0,40,26
1746545197171,EDS 115,A00,888697,Mendez; Kathrina Mendoza,10,0,30,20
1746545198198,EDS 116,A01,888893,Staff,35,0,40,5
1746545200249,EDS 124AR,A00,889133,Staff,29,0,50,21
1746545200249,EDS 124AR,B00,907471,Simon; Elizabeth A,37,0,50,13
1746545201276,EDS 124BR,A00,889134,Simon; Elizabeth A,45,0,100,55
1746545202304,EDS 125,A00,889135,Staff,25,0,30,5
1746545203329,EDS 126,A01,889138,Staff,36,0,40,4
1746545204354,EDS 164R,A01,889142,Wishard Guerra; Alison G.,33,0,50,17
1746545205384,ENG 30,A01,886396,Staff,0,0,0,0
1746545205384,ENG 30,B01,886398,Staff,0,0,0,0
1746545206411,ENVR 102,A00,906150,Montejo; Carolina,23,0,25,2
1746545207438,ETHN 103A,A00,887236,Man; Simeon S,0,3,0,0
1746545208466,ETHN 113,A00,887239,Staff,16,0,30,14
1746545209491,ETHN 116,A00,887240,Staff,16,0,25,9
1746545210517,ETHN 117,A00,887241,Choi; Esther Min,28,0,30,2
1746545211542,ETHN 118,A00,887243,Staff,24,0,30,6
1746545212570,ETHN 127,A00,887248,Cuong; Marisol,11,0,15,4
1746545213595,ETHN 139,A00,887250,Staff,7,0,10,3
1746545214619,ETHN 142,A00,887252,Staff,10,0,30,20
1746545215650,ETHN 161,A00,887253,Browne; Errol Tsekani,24,0,30,6
1746545216682,ETHN 163FR,A00,887255,Burelle; Julie Sara Veronique,0,0,5,5
1746545217708,GLBH 20,A00,889149,Elwardani; Nile Regina,8,0,42,34
1746545219761,GLBH 111,A01,889152,Burgos; Jose L.,17,0,17,0
1746545220786,GLBH 150,A00,889181,Sloane; Julia Kathryn,0,5,15,15
1746545222838,HDS 60,A01,886406,Warstadt; Melissa Fawn,73,0,80,7
1746545223864,HIAF 111,A00,889324,Gyamfi; Bright,25,0,32,7
1746545224889,HIEA 131,A00,889328,Staff,16,0,32,16
1746545225914,HIEA 144,A00,889333,Henry; Todd A.,26,0,32,6
1746545226938,HIEA 154,A00,889336,Henry; Todd A.,24,0,32,8
1746545227964,HIEU 106,A00,889339,Staff,22,0,32,10
1746545230016,HIEU 114,A00,889340,Staff,3,0,32,29
1746545231041,HIEU 135GS,A00,889342,Patterson; Patrick H.,0,0,1,24
1746545232066,HIEU 137,A00,889343,Edington; Claire Ellen,9,0,25,16
1746545233089,HIEU 148,A00,889345,Staff,14,0,32,18
1746545234118,HIEU 154,A00,889346,Biess; Frank Peter,21,0,32,11
1746545235143,HILA 102,A00,889351,Staff,12,0,32,20
1746545236167,HILD 2A,A01,889221,Lewandoski; Julia Mavis,1,10,32,31
1746545237194,HILD 7B,A01,889225,Man; Simeon S,0,13,32,32
1746545238221,HILD 7C,A01,889288,Alvarez; Luis A,0,14,32,32
1746545239247,HILD 30,A01,889323,Staff,0,5,32,32
1746545241304,HISC 119,A00,889383,Golan; Tal,21,0,32,11
1746545242333,HIUS 103,A00,889384,Man; Simeon S,0,0,32,32
1746545243363,HIUS 117,A00,919797,Kwak; Nancy,18,0,32,14
1746545244387,HIUS 142A,A00,919788,Staff,22,0,32,10
1746545246442,HIUS 149,A00,889386,Gyamfi; Bright,27,0,32,5
1746545247470,HIUS 155,A00,889387,Alvarez; Luis A,14,0,32,18
1746545248500,HUM 3,A01,886499,Caldwell; Michael Alan,19,0,50,31
1746545249525,HUM 3GS,A00,886500,Rodriguez; Bretton Sigfred,0,0,0,28
1746545250552,HUM 3R,A01,886502,Markman; Kristina,0,36,50,50
1746545251577,HUM 4,A01,886504,Crum; Matthew Stephen,24,0,50,26
1746545251577,HUM 4,B01,886506,West; Geoffrey Scott,17,0,50,33
1746545252601,HUM 4GS,A00,886507,Staff,0,0,0,19
1746545253630,HUM 5,A01,886509,Staff,32,0,50,18
1746545254655,HUM 5R,A01,886511,Zavodny; Tatiana Sophia,0,39,50,50
1746545255682,JAPN 180,A00,886407,Staff,18,0,40,22
1746545256708,LATI 50,A01,886409,Martin-Cabrera; Luis,4,0,22,18
1746545256708,LATI 50,A02,886410,Martin-Cabrera; Luis,19,0,22,3
1746545256708,LATI 50,A03,886411,Martin-Cabrera; Luis,21,0,22,1
1746545256708,LATI 50,A04,886412,Martin-Cabrera; Luis,9,0,22,13
1746545257736,LAWS 101,A00,907664,Staff,28,0,60,32
1746545258763,LIAB 1A,A00,889388,Saab; Dima,17,0,20,3
1746545259789,LIAB 1AX,A00,889389,El Cheddadi; Youniss,17,0,20,3
1746545260817,LIFR 1C,A00,889391,Van Moer; Vinciane G,8,0,20,12
1746545261842,LIFR 1CX,A00,889392,Van Moer; Vinciane G,7,0,20,13
1746545262867,LIFR 1D,A00,889393,Van Moer; Vinciane G,7,0,20,13
1746545263893,LIFR 1DX,A00,889394,Van Moer; Vinciane G,8,0,20,12
1746545264921,LIGN 7,A00,886923,Staff,24,0,50,26
1746545265949,LIGN 17,A00,886924,Kehler; Andrew Scott,125,0,150,25
1746545266977,LTAM 110,A00,889395,Staff,15,0,30,15
1746545268003,LTAM 110GS,A00,958010,Rodriguez; Bretton Sigfred,0,0,0,28
1746545269027,LTCH 101,A00,889397,Staff,23,0,25,2
1746545270052,LTCS 130,A00,889398,Staff,23,0,25,2
1746545271078,LTEA 138,A00,889399,Staff,24,0,40,16
1746545272105,LTEN 149,A00,889400,Wesling; Megan E.,0,3,25,25
1746545273133,LTEN 169,A00,889401,Staff,20,0,25,5
1746545274156,LTEN 180,A00,889402,Staff,10,0,15,5
1746545275181,LTEN 181,A00,889403,Staff,21,0,25,4
1746545276209,LTWL 100,A00,889404,Myerston Santana; Jacobo,3,0,25,22
1746545277235,LTWL 180GS,A00,889405,Staff,0,0,20,20
1746545278260,LTWL 181,A00,889406,Staff,17,0,25,8
1746545279289,LTWL 184,A00,889475,Mukherjee; Silpa,22,0,25,3
1746545280314,LTWR 102C,A00,889486,Staff,29,0,30,1
1746545281339,LTWR 115W,A00,889491,Staff,0,2,15,15
1746545282368,MAE 8,A01,886905,Staff,0,2,0,0
1746545283399,MAE 11,A00,886906,Bandaru; Prabhakar,0,7,50,50
1746545284428,MAE 20,A00,886907,Evdokimenko; Ekaterina,44,0,70,26
1746545285457,MAE 30B,A00,886909,Ghazinejad; Maziar,26,0,45,19
1746545286488,MAE 101B,A00,886910,Saintillan; David,29,0,45,16
1746545287513,MAE 105,A00,886911,Bandaru; Prabhakar,18,0,50,32
1746545288540,MAE 107,B00,958024,Staff,9,0,50,41
1746545289565,MAE 143B,A00,886913,Bewley; Thomas R,7,0,40,33
1746545290590,MAE 148,A01,886915,Silberman; Jack,0,3,14,14
1746545291618,MAE 160,A00,886916,Evdokimenko; Ekaterina,31,0,60,29
1746545292650,MATH 3C,A01,889681,Staff,0,3,30,30
1746545292650,MATH 3C,A02,960048,Staff,25,0,30,5
1746545293679,MATH 10A,A01,889760,Staff,26,0,30,4
1746545293679,MATH 10A,A02,889783,Staff,29,0,30,1
1746545294712,MATH 10B,A01,889785,Verstraete; Jacques Allan,2,0,35,33
1746545294712,MATH 10B,A02,889795,Verstraete; Jacques Allan,4,0,35,31
1746545294712,MATH 10B,B01,889797,Verstraete; Jacques Allan,3,0,35,32
1746545294712,MATH 10B,B02,889828,Verstraete; Jacques Allan,3,0,35,32
1746545295739,MATH 10C,A01,889849,Habib; Yousaf,9,0,30,21
1746545295739,MATH 10C,A02,889852,Habib; Yousaf,14,0,30,16
1746545295739,MATH 10C,A03,889853,Habib; Yousaf,22,0,30,8
1746545295739,MATH 10C,A04,889858,Habib; Yousaf,20,0,30,10
1746545295739,MATH 10C,B01,889861,Staff,1,0,30,29
1746545295739,MATH 10C,B02,889862,Staff,24,0,30,6
1746545295739,MATH 10C,B03,889863,Staff,27,0,30,3
1746545295739,MATH 10C,B04,889967,Staff,23,0,30,7
1746545296772,MATH 18,A01,889974,Staff,7,0,30,23
1746545296772,MATH 18,A02,889977,Staff,20,0,30,10
1746545296772,MATH 18,B01,889984,Hardiman; Liam,22,0,30,8
1746545296772,MATH 18,B02,889985,Hardiman; Liam,25,0,30,5
1746545297804,MATH 20A,A01,889990,Suk; Andrew Hoon,29,0,35,6
1746545298835,MATH 20B,A01,889993,Ohm; Ko Woon,22,0,30,8
1746545298835,MATH 20B,A02,889994,Ohm; Ko Woon,30,0,30,0
1746545298835,MATH 20B,B01,889996,Ohm; Ko Woon,21,0,30,9
1746545298835,MATH 20B,B02,889997,Ohm; Ko Woon,23,0,30,7
1746545299872,MATH 20C,A01,889999,Hammock; Frances H,17,0,30,13
1746545299872,MATH 20C,A02,890003,Hammock; Frances H,23,0,30,7
1746545299872,MATH 20C,B01,890006,Hammock; Frances H,3,0,30,27
1746545299872,MATH 20C,B02,890007,Hammock; Frances H,11,0,30,19
1746545300905,MATH 20D,A01,890011,Cheng; Hsiao-Bing,1,1,30,29
1746545300905,MATH 20D,A02,890012,Cheng; Hsiao-Bing,14,0,30,16
1746545300905,MATH 20D,B01,890016,Cheng; Hsiao-Bing,13,0,30,17
1746545300905,MATH 20D,B02,890017,Cheng; Hsiao-Bing,13,0,30,17
1746545301933,MATH 20E,A01,890026,Harel; Guershon,1,0,30,29
1746545301933,MATH 20E,A02,890029,Harel; Guershon,23,0,30,7
1746545301933,MATH 20E,B01,890033,Harel; Guershon,7,0,30,23
1746545301933,MATH 20E,B02,890101,Harel; Guershon,21,0,30,9
1746545302958,MATH 102,A01,890104,Staff,17,0,30,13
1746545302958,MATH 102,A02,890105,Staff,27,0,30,3
1746545303987,MATH 103B,A01,890116,Salehi Golsefidy; Alireza,3,0,30,27
1746545303987,MATH 103B,B01,890118,Staff,0,3,34,34
1746545305014,MATH 109,A01,890121,Aliabadi Sr.; Mohsen,1,0,30,29
1746545305014,MATH 109,B01,890124,Upadrashta; Pranav Kumar,18,0,30,12
1746545306045,MATH 120A,A01,890126,Eggers; John Dietrich,13,0,30,17
1746545307075,MATH 142B,A01,890128,Ioana; Adrian,19,0,30,11
1746545307075,MATH 142B,A02,890129,Ioana; Adrian,13,0,30,17
1746545308104,MATH 154,A01,890174,Staff,0,0,30,30
1746545308104,MATH 154,A02,890182,Staff,0,0,30,30
1746545309130,MATH 168A,A01,890197,Dumitriu; Ioana,21,0,35,14
1746545310157,MATH 170A,A01,890240,Nie; Jiawang,1,0,30,29
1746545310157,MATH 170A,A02,890241,Nie; Jiawang,11,0,30,19
1746545310157,MATH 170A,A03,890249,Nie; Jiawang,23,0,30,7
1746545311184,MATH 170B,A01,957891,Nag; Panchali,13,0,35,22
1746545313237,MATH 181A,A01,908025,Staff,0,4,35,35
1746545313237,MATH 181A,A02,960115,Staff,27,0,35,8
1746545314262,MATH 181B,A01,959874,Staff,26,0,30,4
1746545315287,MATH 193B,A01,890265,Staff,0,4,35,35
1746545316312,MGT 4,A01,890311,Anderson; John Charles,42,0,88,46
1746545317338,MGT 5,A00,907740,Staff,13,0,98,85
1746545318366,MGT 12,A00,890312,Lindenberger; Wade Douglas,67,0,98,31
1746545319393,MGT 16,A00,957883,Staff,78,0,98,20
1746545321445,MGT 45,A00,890314,Pecore; Joseph P.,47,0,98,51
1746545322471,MGT 71,A00,890315,Staff,0,11,98,98
1746545323501,MGT 100,A00,890316,Yavorsky; Daniel Ryan,44,0,98,54
1746545324529,MGT 103,A00,890317,Ehrich; Kristine R,73,0,98,25
1746545325558,MGT 105,A00,890356,Bates; Kenneth Walter,0,7,98,98
1746545326588,MGT 112,A00,890360,Ehrich; Kristine R,55,0,98,43
1746545327613,MGT 127R,A00,907732,Zhu; Kevin Xiaoguo,23,0,98,75
1746545328641,MGT 131B,A00,890361,Anderson; John Charles,61,0,98,37
1746545329666,MGT 137,A00,890362,Lindenberger; Wade Douglas,65,0,98,33
1746545330691,MGT 160,A00,890369,Johnson; Erik Barry,9,0,98,89
1746545332746,MGT 164,A00,890372,Zimmermann; Carsten,0,39,98,98
1746545333775,MGT 180,A00,890374,Bliss; Barbara Ann,12,0,98,86
1746545334802,MMW 15,A01,886414,Chang; Edmond Yi-Teh,0,12,28,28
1746545334802,MMW 15,A02,886415,Chang; Edmond Yi-Teh,0,8,28,28
1746545334802,MMW 15,A03,886416,Chang; Edmond Yi-Teh,0,8,28,28
1746545334802,MMW 15,A04,886417,Chang; Edmond Yi-Teh,0,8,28,28
1746545334802,MMW 15,B01,886419,Chang; Edmond Yi-Teh,0,7,28,28
1746545334802,MMW 15,B02,886420,Chang; Edmond Yi-Teh,0,8,28,28
1746545334802,MMW 15,B03,886421,Chang; Edmond Yi-Teh,0,7,28,28
1746545334802,MMW 15,B04,886422,Chang; Edmond Yi-Teh,0,8,28,28
1746545334802,MMW 15,C01,886424,Staff,0,9,28,28
1746545334802,MMW 15,C02,886425,Staff,0,8,28,28
1746545334802,MMW 15,C03,886426,Staff,0,8,28,28
1746545334802,MMW 15,C04,886427,Staff,0,7,28,28
1746545334802,MMW 15,C05,958038,Staff,0,7,28,28
1746545334802,MMW 15,C06,958039,Staff,0,8,28,28
1746545335826,MMW 15GS,A00,906910,Patterson; Patrick H.,4,0,28,24
1746545336852,MMW 122R,A01,886429,Rahimi; Babak,0,13,28,28
1746545336852,MMW 122R,A02,886430,Rahimi; Babak,0,12,28,28
1746545336852,MMW 122R,A03,958040,Rahimi; Babak,0,11,28,28
1746545337880,MUS 1A,A01,890937,Staff,3,0,25,22
1746545337880,MUS 1A,A02,891035,Staff,6,0,25,19
1746545337880,MUS 1A,C01,958912,Staff,24,0,25,1
1746545337880,MUS 1A,C02,958913,Staff,25,0,25,0
1746545339930,MUS 2AK,A00,957092,Ohnishi; Takae,15,0,15,0
1746545340957,MUS 4,A01,891044,Staff,2,0,25,23
1746545340957,MUS 4,A02,891045,Staff,23,0,25,2
1746545340957,MUS 4,B01,891048,Staff,17,0,25,8
1746545340957,MUS 4,B02,891050,Staff,25,0,25,0
1746545341983,MUS 5,A01,957506,Dubnov; Shlomo,0,0,25,25
1746545341983,MUS 5,A02,957622,Dubnov; Shlomo,14,0,25,11
1746545341983,MUS 5,A03,957623,Dubnov; Shlomo,20,0,25,5
1746545343015,MUS 6,A01,891053,Freitas Caetano; Marcelo,24,0,25,1
1746545343015,MUS 6,A02,891054,Freitas Caetano; Marcelo,23,0,25,2
1746545344044,MUS 7,A01,891081,Staff,0,0,25,25
1746545344044,MUS 7,A02,891082,Staff,4,0,25,21
1746545345072,MUS 8GS,A00,891118,Borgo; David Garcia,0,0,25,25
1746545346096,MUS 11,A01,891140,Staff,11,0,25,14
1746545346096,MUS 11,A02,891141,Staff,22,0,25,3
1746545347122,MUS 13,A01,891143,Staff,8,0,25,17
1746545347122,MUS 13,A02,891144,Staff,24,0,25,1
1746545348145,MUS 15,A01,891146,Staff,9,0,25,16
1746545348145,MUS 15,A02,891148,Staff,21,0,25,4
1746545348145,MUS 15,B01,891150,Staff,18,0,25,7
1746545348145,MUS 15,B02,891151,Staff,25,0,25,0
1746545349170,MUS 20,A01,891153,Staff,5,0,20,15
1746545349170,MUS 20,A02,891155,Staff,14,0,20,6
1746545350195,MUS 80,A00,891156,Staff,19,0,25,6
1746545350195,MUS 80,B00,891157,Staff,23,0,25,2
1746545351223,MUS 130,A00,891158,Ohnishi; Takae,35,0,35,0
1746545352247,MUS 150GS,A01,891160,Borgo; David Garcia,0,0,25,25
1746545353276,MUS 170,A01,891162,Freitas Caetano; Marcelo,20,0,25,5
1746545353276,MUS 170,A02,891164,Freitas Caetano; Marcelo,21,0,25,4
1746545354302,NANO 11,A00,886220,Vazquez Mena; Oscar,13,0,15,2
1746545355327,NANO 15,A01,886222,Drews; Aaron,4,0,7,3
1746545356355,NANO 104,A00,886224,Sirbuly; Donald,18,0,25,7
1746545357382,PH 40,A00,886528,Staff,23,0,40,17
1746545358410,PH 45,A01,886799,Staff,35,0,40,5
1746545359434,PH 110,A00,886802,Staff,0,7,40,40
1746545360462,PH 172,A00,906716,Staff,19,0,35,16
1746545361487,PH 191,A00,886803,Staff,6,0,40,34
1746545362510,PHIL 1,A00,889500,Staff,19,0,30,11
1746545363539,PHIL 10,A01,889549,Grush; Rick Scott,15,0,22,7
1746545363539,PHIL 10,A02,889551,Grush; Rick Scott,22,0,22,0
1746545364565,PHIL 28,A01,889559,Lamey; Andy M.,0,1,31,31
1746545364565,PHIL 28,A02,889561,Lamey; Andy M.,0,1,30,30
1746545364565,PHIL 28,A03,889572,Lamey; Andy M.,0,0,30,30
1746545365590,PHIL 35,A00,907839,Staff,13,0,15,2
1746545366616,PHIL 60,A00,889574,Staff,74,0,90,16
1746545367643,PHIL 101,A00,958004,Staff,13,0,15,2
1746545369699,PHIL 136,A00,889582,Fulkerson; Matthew Todd,26,0,45,19
1746545370725,PHIL 163,A01,889601,Staff,21,0,30,9
1746545370725,PHIL 163,B01,889606,Brandt; Reuven A,0,3,0,0
1746545371751,PHIL 164,A00,889610,Staff,16,0,30,14
1746545372777,PHIL 165,A00,889613,Staff,23,0,30,7
1746545373801,PHYS 1A,A00,886431,Staff,26,0,70,44
1746545374829,PHYS 1AL,001,886432,Tsai; Philbert S,0,2,30,30
1746545374829,PHYS 1AL,002,886436,Tsai; Philbert S,11,0,30,19
1746545375855,PHYS 1B,A00,886439,Staff,185,0,240,55
1746545376880,PHYS 1BL,001,886441,Tsai; Philbert S,0,4,30,30
1746545376880,PHYS 1BL,002,886444,Tsai; Philbert S,2,0,30,28
1746545377907,PHYS 1C,A00,896092,Arnold; Kam S,78,0,146,68
1746545378935,PHYS 1CL,001,886448,Tsai; Philbert S,0,0,30,30
1746545378935,PHYS 1CL,002,886449,Tsai; Philbert S,0,0,30,30
1746545378935,PHYS 1CL,003,886450,Tsai; Philbert S,16,0,30,14
1746545378935,PHYS 1CL,004,886451,Tsai; Philbert S,15,0,30,15
1746545379967,PHYS 2B,A01,886457,Staff,69,0,115,46
1746545380993,PHYS 2C,A01,886460,Shotwell; Brian,0,8,65,65
1746545382021,PHYS 2CL,A01,886467,Staff,0,4,28,28
1746545382021,PHYS 2CL,A02,886468,Staff,0,3,28,28
1746545383047,PHYS 2D,A01,886470,Staff,10,0,50,40
1746545384074,PHYS 4B,A01,886475,Grinstein; Benjamin,22,0,40,18
1746545385098,POLI 5,A00,891173,Desposato; Scott,7,0,25,18
1746545386124,POLI 5D,A01,891175,Staff,5,0,5,0
1746545386124,POLI 5D,B01,891178,Staff,5,0,5,0
1746545387152,POLI 11,A00,891179,Ferree; Karen E,2,0,35,33
1746545388178,POLI 12,A00,891180,Staff,16,0,30,14
1746545389206,POLI 27,A01,891182,Staff,12,0,75,63
1746545390233,POLI 30,A00,891183,Staff,8,0,50,42
1746545391260,POLI 100B,A00,891244,Staff,5,1,35,30
1746545392287,POLI 100I,A00,891247,Staff,7,0,30,23
1746545393317,POLI 104J,A00,891248,Nichter; Maysa,14,0,30,16
1746545394343,POLI 104U,A00,891250,Nichter; Maysa,2,0,30,28
1746545396395,POLI 110B,A00,891255,Wiens; David,20,0,25,5
1746545397422,POLI 112A,A00,891256,Wiens; David,6,0,25,19
1746545398444,POLI 114BR,A00,891261,Staff,19,0,30,11
1746545399471,POLI 117R,A00,891262,Forman; Fonna,0,6,50,50
1746545400497,POLI 118,A00,891264,Ingham; Sean,17,0,25,8
1746545401522,POLI 124A,A00,891265,Staff,18,0,20,2
1746545402551,POLI 125D,A00,891266,Nichter; Simeon C,2,0,25,23
1746545403578,POLI 126,A00,891268,Nichter; Simeon C,7,0,25,18
1746545404604,POLI 126AA,A00,891272,Staff,18,0,25,7
1746545405633,POLI 130AA,A00,891273,Staff,15,0,20,5
1746545406658,POLI 134AA,A00,891274,Staff,4,0,20,16
1746545408713,POLI 138,A00,891278,Staff,21,0,25,4
1746545409741,POLI 142K,A00,891280,Staff,11,0,25,14
1746545410768,POLI 142M,A00,891281,Gartzke; Erik,17,0,30,13
1746545411798,POLI 142P,A00,891284,Staff,20,0,30,10
1746545412825,POLI 143,A00,891285,Gartzke; Erik,12,0,30,18
1746545413853,POLI 153,A00,891286,Staff,19,0,20,1
1746545415906,POLI 175,A00,891290,Staff,15,0,20,5
1746545416932,PSYC 1,A00,890674,Steiner; Eric Tomas,0,11,45,45
1746545417957,PSYC 2,A00,890676,Albright; Thomas D,21,0,35,14
1746545418983,PSYC 3,A00,890679,Staff,17,0,20,3
1746545420009,PSYC 6,A00,959858,Staff,20,0,20,0
1746545421034,PSYC 60,A01,890684,Rickard; Timothy C.,0,5,45,45
1746545422065,PSYC 70,A01,890689,Geller; Emma Harlan,7,0,30,23
1746545423093,PSYC 71,A01,959860,Staff,21,0,25,4
1746545424118,PSYC 100,A00,890690,Lacefield; Katharine I,0,50,180,180
1746545425149,PSYC 102,A00,890695,Staff,18,0,40,22
1746545426176,PSYC 105,A00,890699,Geller; Emma Harlan,71,0,100,29
1746545427205,PSYC 106,A00,890701,Gorman; Michael R.,5,0,30,25
1746545428231,PSYC 108,A00,890704,Adrian; Julia Anna,0,28,50,50
1746545429262,PSYC 118,A01,890712,Staff,11,0,30,19
1746545430288,PSYC 124,A00,890716,Chapman; Eddie Nathaniel,25,0,60,35
1746545431318,PSYC 131,A00,890717,Anagnostaras; Stephan,0,7,80,80
1746545432350,PSYC 137,A00,890719,Winkielman; Piotr,0,11,30,30
1746545433375,PSYC 144,A00,890721,Adrian; Julia Anna,0,9,45,45
1746545434404,PSYC 162,A00,890805,Staff,2,0,75,73
1746545435432,PSYC 169,A00,890810,Staff,0,15,30,30
1746545436458,PSYC 172,A00,890814,Gorman; Michael R.,9,0,30,21
1746545437483,PSYC 181,A00,890818,Anagnostaras; Stephan,8,0,200,192
1746545438507,PSYC 184,A00,959861,Staff,170,0,175,5
1746545439534,PSYC 189,A00,890823,Staff,0,1,30,30
1746545440560,PSYC 191,A00,890884,Rickard; Timothy C.,0,11,35,35
1746545441588,PSYC 193,A00,890913,Staff,19,0,30,11
1746545441588,PSYC 193,B00,890914,Chapman; Eddie Nathaniel,24,0,30,6
1746545442613,PSYC 193L,A01,890918,Lowe; Angela Beth,20,0,30,10
1746545442613,PSYC 193L,B01,890921,Hurwitz; Ethan Scott,20,0,30,10
1746545442613,PSYC 193L,C01,890928,Staff,30,0,30,0
1746545443643,RELI 149,A00,886806,Rahimi; Babak,23,0,40,17
1746545444669,SE 9,A01,886814,Staff,7,0,20,13
1746545445696,SE 101B,A01,886816,Chadha; Mayank,4,0,35,31
1746545446726,SE 110B,A00,886818,Zhu; Qiang,4,0,75,71
1746545447752,SE 125,A01,886830,Staff,10,0,30,20
1746545448781,SE 130B,A01,886835,Staff,14,0,40,26
1746545449807,SE 131A,A01,886838,Krysl; Petr,34,0,55,21
1746545450837,SE 154,A00,886840,Staff,30,0,50,20
1746545451862,SE 164GS,A01,886849,Staff,6,0,20,14
1746545452887,SE 167GS,A01,886853,Staff,6,0,20,14
1746545453913,SIO 25,A01,890107,Staff,19,0,30,11
1746545454945,SIO 45,A00,890109,Cook; Geoffrey W,117,0,200,83
1746545455971,SIO 109R,A00,890110,Forman; Fonna,0,16,20,20
1746545456996,SIO 187,A01,890114,Kacev; David,15,0,40,25
1746545458025,SOCI 1,A01,890431,Thorpe; Charles Robert,15,0,30,15
1746545458025,SOCI 1,A02,890518,Thorpe; Charles Robert,30,0,30,0
1746545459054,SOCI 2,A01,957978,Staff,25,0,25,0
1746545459054,SOCI 2,A02,957979,Staff,23,0,25,2
1746545460082,SOCI 20,A01,890523,Calderon-Zaks; Michael Aar,23,0,30,7
1746545460082,SOCI 20,A02,890526,Calderon-Zaks; Michael Aar,29,0,30,1
1746545461108,SOCI 30,A01,890533,Pardo Guerra; Juan Pablo,37,0,40,3
1746545462138,SOCI 40,A01,890535,Staff,27,0,45,18
1746545463165,SOCI 104Q,A00,890559,Staff,18,0,30,12
1746545464194,SOCI 106,A00,890560,Arnal; Maud Marie Leonie,20,0,30,10
1746545465224,SOCI 110,A00,890567,Holkenbrink-Monk; Charlene,19,0,30,11
1746545466254,SOCI 112,A00,890568,Victoria Torres; Pablo,1,0,55,54
1746545467281,SOCI 115,A00,890597,Arnal; Maud Marie Leonie,28,0,45,17
1746545469335,SOCI 121,A00,890604,Pardo Guerra; Juan Pablo,38,0,45,7
1746545470364,SOCI 126,A01,890608,Staff,8,0,10,2
1746545471390,SOCI 127,A00,890609,Staff,18,0,30,12
1746545472415,SOCI 131,A00,890610,Thorpe; Charles Robert,37,0,45,8
1746545473441,SOCI 135,A00,890615,Payne; Christine Anna,14,0,45,31
1746545474467,SOCI 139,A00,890620,Staff,38,0,45,7
1746545475496,SOCI 148E,A00,890622,Calderon-Zaks; Michael Aar,36,0,45,9
1746545476525,SOCI 150,A00,890623,Kohler; Kristopher M.,31,0,45,14
1746545477553,SOCI 157,A00,890625,Jules-Rosette; Bennetta W.,18,0,20,2
1746545478579,SOCI 160,A00,890627,Payne; Christine Anna,21,0,45,24
1746545479607,SYN 1,A00,886855,Fish; Gwendolyn Anne,0,0,0,0
1746545479607,SYN 1,B00,906086,Fish; Gwendolyn Anne,0,1,0,2
1746545480690,SYN 2R,A00,886860,Staff,0,17,15,15
1746545480690,SYN 2R,B00,906106,Atkinson; Arthur Laird,0,16,15,15
1746545481722,SYN 100,A01,886866,Browne; Emily,0,28,20,20
1746545481722,SYN 100,B01,906128,Rock; Martin,0,5,20,20
1746545481722,SYN 100,C01,906140,Deavenport; James Cary,0,3,20,20
1746545481722,SYN 100,D01,907816,Deavenport; James Cary,0,5,20,20
1746545482753,TDAC 1,A00,890286,Walsh; Kim C.,9,0,20,11
1746545483781,TDAC 101,A00,890296,Basso; Beatrice,16,0,20,4
1746545484807,TDDE 131,A00,890297,Staff,47,0,50,3
1746545485838,TDDM 1,A00,890287,Weinberg; Sadie,25,0,30,5
1746545486866,TDGE 11,A00,890288,Fulton; Julia,137,0,200,63
1746545486866,TDGE 11,B00,890289,Castro; Robert Jess,184,0,200,16
1746545487896,TDGE 25,B00,957359,Walsh; Kim C.,3,0,20,17
1746545488923,TDGE 40,A01,890292,Power; Jade Yukana,27,0,30,3
1746545489949,TDGE 124,A00,890298,Havis; Allan,0,0,50,50
1746545490976,TDGE 131R,A00,890299,Burelle; Julie Sara Veronique,15,0,42,27
1746545492003,TDHT 101,A00,890300,Staff,10,0,20,10
1746545493034,TDHT 109,A01,890302,Anderson; Mysia Anyse,31,0,40,9
1746545494060,TDMV 1,A00,890293,Arcidiacono; Kristin,18,0,30,12
1746545495089,TDMV 2,A00,890294,Weinberg; Sadie,23,0,30,7
1746545496114,TDMV 3,A00,957878,Arcidiacono; Kristin,28,0,30,2
1746545498172,TDMV 138,A00,890304,Jun; Grace Shin Hae,25,0,40,15
1746545499201,TDMV 140,A00,890305,Corrales; Joseph Bernales,25,0,30,5
1746545500225,TDMV 142,A00,890307,Caligagan; Tony,32,0,40,8
1746545501256,TDMV 144,A00,890308,Camaya; Michelle Ann,25,0,30,5
1746545502283,TDPW 1,A00,890295,Stein; Deborah Isobel,3,0,20,17
1746545503312,USP 2,A01,890272,Lerner; Amy M,6,0,20,14
1746545504336,USP 3,A01,890274,Staff,12,0,30,18
1746545505361,USP 15,A01,890276,Sun; Feiyang,17,0,30,13
1746545506393,USP 25,A00,890277,Shenkman; Michael Thomas,19,0,25,6
1746545507420,USP 138,A00,890278,Staff,13,0,25,12
1746545508447,USP 143,A00,890279,Staff,21,0,70,49
1746545509472,USP 144,A00,890280,Chowdhury; Muhammed Zohir,16,0,30,14
1746545510499,USP 150,A00,890281,Boomhower; Matthew Charles,4,0,30,26
1746545511529,USP 151,A00,890282,Staff,16,0,20,4
1746545512556,USP 162,A00,890283,Andrews; Abigail Leslie,16,0,20,4
1746545513582,USP 168,A00,920477,Kwak; Nancy,1,0,5,4
1746545514609,USP 181,A00,890284,Staff,3,0,20,17
1746545515636,USP 191A,A00,890285,Staff,13,0,20,7
1746545516664,VIS 101,A00,886512,Staff,25,0,75,50
1746545517693,VIS 103,A00,886513,Cruz; Edwin Teddy,61,0,75,14
1746545518724,VIS 108,A00,886514,Staff,3,0,15,12
1746545519750,VIS 127P,A00,886515,Shen; Kuiyi,80,0,146,66
1746545520781,VIS 149,A00,886516,Yoldas; Pinar,0,0,15,15
1746545521807,VIS 164,A00,886526,Erdmann; Dean,19,0,22,3
1746545522834,VIS 194S,A00,886527,Staff,61,0,75,14
1746545523869,WCWP 10A,C00,886484,Martiniuk; Jill,12,0,15,3
1746545524904,WCWP 10B,A00,886490,Uriarte; Emma,0,0,15,15
1746545524904,WCWP 10B,B00,886491,Dhir; Simrita,11,0,15,4
1746545524904,WCWP 10B,C00,886492,Ornelas; Tricia,0,0,15,15
1746545525935,WCWP 100,A00,886494,Young; Mark T,0,7,15,15
1746545528104,AAS 10,A01,886199,Childs; Dennis R.,0,3,0,0
1746545529137,ANAR 104,A01,886940,Shtienberg; Gilad,27,0,30,3
1746545530168,ANAR 120,A00,886953,Staff,12,0,20,8
1746545531195,ANBI 148,A01,886955,Wilder; Linnea Lorene,30,0,40,10
1746545533249,ANSC 122,A00,886957,Staff,25,0,30,5
1746545534280,ANSC 150,A00,886958,Sloane; Julia Kathryn,3,0,15,12
1746545535307,ANSC 156,A00,886959,Jenkins; Janis A.,0,1,15,15
1746545536333,ANSC 180,A00,886960,Staff,11,0,17,6
1746545537359,ANSC 188,A00,886961,Jassal; Aftab,9,0,25,16
1746545538388,ANSC 190,A00,886962,Jassal; Aftab,14,0,25,11
1746545539412,ANSC 191,A00,886963,Staff,18,0,20,2
1746545540444,ANTH 3,A01,891689,Staff,17,0,20,3
1746545541470,ANTH 5,A00,886933,Semendeferi; Ekaterini,16,0,20,4
1746545542493,ANTH 10,A00,886934,Staff,0,12,30,30
1746545543518,ANTH 21,A01,886936,Staff,40,0,60,20
1746545544547,ANTH 23,A01,886938,Staff,92,0,100,8
1746545545573,ANTH 105,A00,886964,Stewart; Alexander B,84,0,100,16
1746545546600,ANTH 108,A00,886965,Pedersen; David,9,0,20,11
1746545547629,AWP 10,001,886147,Staff,0,0,0,0
1746545547629,AWP 10,002,886148,Staff,0,0,0,0
1746545547629,AWP 10,003,886149,Staff,0,0,0,0
1746545547629,AWP 10,004,886150,Staff,0,0,0,0
1746545547629,AWP 10,005,886151,Staff,0,0,0,0
1746545547629,AWP 10,006,886152,Staff,0,0,0,0
1746545547629,AWP 10,007,886153,Staff,0,0,0,0
1746545547629,AWP 10,008,886154,Staff,0,0,0,0
1746545547629,AWP 10,009,886155,Staff,0,0,0,0
1746545547629,AWP 10,010,886156,Staff,0,0,0,0
1746545547629,AWP 10,011,886158,Staff,0,0,0,0
1746545547629,AWP 10,012,886160,Staff,0,0,0,0
1746545547629,AWP 10,013,886161,Staff,0,0,0,0
1746545547629,AWP 10,014,886162,Staff,0,0,0,0
1746545547629,AWP 10,015,886163,Staff,0,0,0,0
1746545547629,AWP 10,016,886164,Staff,0,0,0,0
1746545547629,AWP 10,017,886165,Staff,0,0,0,0
1746545547629,AWP 10,018,886166,Staff,0,0,0,0
1746545547629,AWP 10,019,886168,Staff,0,0,0,0
1746545547629,AWP 10,020,886170,Staff,0,0,0,0
1746545547629,AWP 10,021,886172,Staff,0,0,0,0
1746545548657,AWP 10R,001,886173,Staff,0,1,0,0
1746545548657,AWP 10R,002,886174,Staff,0,1,0,0
1746545548657,AWP 10R,003,886175,Staff,0,0,0,0
1746545548657,AWP 10R,004,886176,Staff,0,0,0,0
1746545548657,AWP 10R,005,886177,Staff,0,0,0,0
1746545548657,AWP 10R,006,886178,Staff,0,0,0,0
1746545548657,AWP 10R,007,886179,Staff,0,0,0,0
1746545548657,AWP 10R,008,886181,Staff,0,0,0,0
1746545548657,AWP 10R,009,886182,Staff,0,0,0,0
1746545548657,AWP 10R,010,886183,Staff,0,0,0,0
1746545548657,AWP 10R,011,886184,Staff,0,0,0,0
1746545548657,AWP 10R,012,886185,Staff,0,0,0,0
1746545548657,AWP 10R,013,886186,Staff,0,0,0,0
1746545548657,AWP 10R,014,886187,Staff,0,0,0,0
1746545548657,AWP 10R,015,886188,Staff,0,0,0,0
1746545548657,AWP 10R,016,886189,Staff,0,0,0,0
1746545549684,AWP 102R,A00,886190,Staff,0,0,0,0
1746545549684,AWP 102R,B00,886191,Staff,0,0,0,0
1746545550709,BENG 100,A01,886193,Staff,17,0,30,13
1746545551737,BENG 122A,A01,886195,Hasty; Jeff M,13,0,30,17
1746545552763,BENG 166A,A00,886196,Sah; Robert Lie-Yuan,0,1,30,30
1746545553793,BENG 190,A00,958050,Khojah; Reem I,24,0,25,1
1746545554822,BIBC 102,A01,894320,Staff,0,0,46,46
1746545554822,BIBC 102,A02,894321,Staff,0,0,46,46
1746545554822,BIBC 102,A03,894344,Staff,7,0,46,39
1746545554822,BIBC 102,A04,894345,Staff,26,0,47,21
1746545555858,BICD 100R,A01,894365,Smith; Laurie,0,3,58,58
1746545555858,BICD 100R,A02,894366,Smith; Laurie,0,5,58,58
1746545555858,BICD 100R,A03,894367,Smith; Laurie,2,0,59,57
1746545555858,BICD 100R,A04,959869,Smith; Laurie,41,0,59,18
1746545556886,BICD 136,A01,894383,Gustafson-Brown; Cindy,14,0,50,36
1746545557921,BIEB 102,A01,894494,Butler; Shannon Rhey,51,0,130,79
1746545559980,BIEB 150,A01,894617,Wills; Christopher,3,0,20,17
1746545559980,BIEB 150,A02,894631,Wills; Christopher,3,0,20,17
1746545559980,BIEB 150,A03,894937,Wills; Christopher,3,0,20,17
1746545559980,BIEB 150,A04,894946,Wills; Christopher,5,0,20,15
1746545561007,BIEB 194,A00,906141,Kurle; Carolyn M.,6,0,20,14
1746545562039,BILD 1,A01,894154,Staff,2,0,19,17
1746545562039,BILD 1,A02,894155,Staff,14,0,19,5
1746545562039,BILD 1,A03,894160,Staff,13,0,19,6
1746545562039,BILD 1,A04,894161,Staff,15,0,18,3
1746545563064,BILD 2,A01,894168,Staff,0,0,50,50
1746545563064,BILD 2,A02,894169,Staff,0,0,50,50
1746545563064,BILD 2,A03,894179,Staff,4,0,50,46
1746545563064,BILD 2,A04,894203,Staff,27,0,50,23
1746545564089,BILD 3,A01,894213,Staff,22,0,31,9
1746545564089,BILD 3,A02,894214,Staff,26,0,31,5
1746545564089,BILD 3,A03,894235,Staff,28,0,31,3
1746545564089,BILD 3,A04,894236,Staff,28,0,32,4
1746545565121,BILD 4,A01,894253,Reuther; Keefe,5,0,24,19
1746545565121,BILD 4,A02,894258,Reuther; Keefe,16,0,24,8
1746545566151,BILD 5,A01,894276,Reuther; Keefe,35,0,50,15
1746545566151,BILD 5,A02,894277,Reuther; Keefe,45,0,50,5
1746545566151,BILD 5,A03,894290,Reuther; Keefe,44,0,50,6
1746545566151,BILD 5,A04,894291,Reuther; Keefe,48,0,50,2
1746545567178,BILD 24,A01,894297,Pirino; Giorgia,40,0,60,20
1746545568206,BIMM 100,B01,958915,Staff,72,0,100,28
1746545569238,BIMM 101,A01,895017,McDonnell; Lisa Marie,0,5,24,24
1746545569238,BIMM 101,A02,895018,McDonnell; Lisa Marie,0,5,24,24
1746545569238,BIMM 101,B01,895020,McDonnell; Lisa Marie,0,6,24,24
1746545569238,BIMM 101,B02,895021,McDonnell; Lisa Marie,0,4,24,24
1746545570269,BIMM 110,A01,895023,Staff,1,0,25,24
1746545570269,BIMM 110,A02,895024,Staff,9,0,25,16
1746545570269,BIMM 110,A03,895025,Staff,18,0,25,7
1746545570269,BIMM 110,A04,895031,Staff,20,0,25,5
1746545571295,BIMM 120,A01,895114,Gustafson-Brown; Cindy,13,0,28,15
1746545571295,BIMM 120,A02,895126,Gustafson-Brown; Cindy,21,0,27,6
1746545572323,BIPN 100,A01,895130,Yang; Mingyu,1,0,38,37
1746545572323,BIPN 100,A02,895131,Yang; Mingyu,32,0,38,6
1746545572323,BIPN 100,A03,895132,Yang; Mingyu,32,0,38,6
1746545572323,BIPN 100,A04,895133,Yang; Mingyu,27,0,36,9
1746545573356,BIPN 120,A01,895135,Cooke; James Edward,0,3,13,13
1746545573356,BIPN 120,A02,895136,Cooke; James Edward,0,1,13,13
1746545573356,BIPN 120,A03,895137,Cooke; James Edward,0,3,13,13
1746545573356,BIPN 120,A04,895156,Cooke; James Edward,0,2,11,11
1746545574387,BIPN 134,A01,895235,Cooke; James Edward,0,2,25,25
1746545574387,BIPN 134,A02,895237,Cooke; James Edward,0,0,25,25
1746545574387,BIPN 134,A03,895240,Cooke; James Edward,3,0,25,22
1746545574387,BIPN 134,A04,895270,Cooke; James Edward,20,0,25,5
1746545575412,BIPN 189,A00,892103,Staff,0,13,14,14
1746545577466,BISP 194,A00,958008,Staff,0,2,0,0
1746545578496,CAT 124,A01,922009,Staff,0,5,20,20
1746545579541,CAT 125R,A00,886390,Morales; Celeste Georgianna,0,2,20,20
1746545579541,CAT 125R,B00,886391,Irwin; Matthew Joseph,0,3,20,20
1746545579541,CAT 125R,C00,886392,Smith; Lauryn Alissa,0,2,20,20
1746545579541,CAT 125R,D00,886393,Vanderschuit; Maya Alysia,0,2,20,20
1746545579541,CAT 125R,E00,886394,Marchisotto; Jennifer Anne,0,4,20,20
1746545580569,CENG 15,A01,886218,Drews; Aaron,3,0,8,5
1746545581595,CENG 113,A00,886219,Opatkiewicz; Justin Paul,15,0,25,10
1746545582621,CGS 101,A00,887044,Staff,7,0,20,13
1746545583649,CGS 105,A01,887046,Staff,14,0,25,11
1746545584677,CGS 112,A00,887047,Cuong; Marisol,12,0,15,3
1746545585703,CGS 113,A00,887048,Staff,23,0,30,7
1746545586732,CGS 120,A00,887049,Staff,10,0,17,7
1746545587758,CHEM 6A,A01,886336,Lam; Tin Yiu,38,0,50,12
1746545587758,CHEM 6A,A02,886338,Lam; Tin Yiu,37,0,50,13
1746545588784,CHEM 6B,A01,886341,Hopkins; Patrycja Anna,16,0,50,34
1746545588784,CHEM 6B,A02,886343,Hopkins; Patrycja Anna,42,0,50,8
1746545589813,CHEM 6C,A01,886346,Albizati; Kim F.,0,2,50,50
1746545589813,CHEM 6C,A02,886348,Albizati; Kim F.,23,0,50,27
1746545590840,CHEM 40A,A01,886352,Klosterman; Jeremy K,65,0,100,35
1746545591869,CHEM 40B,A01,886356,Klosterman; Jeremy K,0,23,100,100
1746545592901,CHEM 41B,A01,886360,Theodorakis; Emmanuel,25,0,50,25
1746545592901,CHEM 41B,A02,886362,Theodorakis; Emmanuel,47,0,50,3
1746545593927,CHIN 165A,A00,886382,Xu; Li,18,0,20,2
1746545594953,CLAS 120,A00,886387,Myerston Santana; Jacobo,33,0,40,7
1746545595979,COGS 9,A01,886967,Shannon; Kyle Michael,42,0,60,18
1746545597006,COGS 11,A01,886969,Staff,11,0,30,19
1746545598034,COGS 14A,A01,886971,Staff,6,0,60,54
1746545599060,COGS 14B,A01,886973,Hoffman; Drew Ellen,4,0,60,56
1746545600090,COGS 18,A01,886975,Morgan; Eric,35,0,60,25
1746545601119,COGS 20,A01,886977,Staff,4,0,8,4
1746545601119,COGS 20,A02,886978,Staff,5,0,7,2
1746545602146,COGS 100,A01,907783,Staff,0,2,30,30
1746545603174,COGS 101B,A01,886980,Staff,0,3,48,48
1746545604200,COGS 101C,A01,886982,Delgado; Tania,0,5,44,44
1746545605226,COGS 102A,A01,886984,Johnson; Christine M.,4,0,30,26
1746545606254,COGS 118B,A01,886986,Staff,0,3,88,88
1746545607281,COGS 150,A01,886988,Bergen; Benjamin,23,0,50,27
1746545608306,COGS 153,A00,886989,Delgado; Tania,0,2,41,41
1746545609331,COGS 186,A01,886991,Staff,0,0,32,32
1746545610357,COGS 187A,A01,886993,Boyle; Mary E. T.,7,0,30,23
1746545611382,COGS 189,A00,886994,Staff,0,1,30,30
1746545612410,COMM 10,A01,886996,Staff,0,0,20,21
1746545612410,COMM 10,A02,886997,Staff,12,0,20,8
1746545612410,COMM 10,A03,959845,Staff,19,0,20,1
1746545613437,COMM 20,A01,886999,Leuning; Grant Maurstad,24,0,40,16
1746545615484,COMM 100A,A01,887002,Staff,0,0,20,25
1746545615484,COMM 100A,A02,887003,Staff,7,0,20,13
1746545616510,COMM 100B,A01,887005,Staff,0,8,20,24
1746545617534,COMM 106D,A00,887006,Staff,14,0,40,26
1746545618562,COMM 110G,A00,887007,Whitworth-Smith; Andrew C,12,0,40,28
1746545619588,COMM 111B,A00,887008,Staff,31,0,40,9
1746545620614,COMM 113T,A00,887009,Abuelhiga; Soraya Jill,28,0,40,12
1746545620614,COMM 113T,B00,906733,Staff,40,0,40,0
1746545621641,COMM 145,A00,887010,Staff,12,0,40,28
1746545622666,COMM 146,A00,887054,Staff,31,0,40,9
1746545623693,COMM 190,A00,887012,Staff,8,0,23,15
1746545624719,CSE 8A,A50,887015,Cao; Yingjun,57,0,85,28
1746545625749,CSE 11,A01,887017,Cao; Yingjun,12,0,70,58
1746545626774,CSE 20,A01,887019,Staff,30,0,50,20
1746545627801,CSE 21,A01,887021,Staff,78,0,100,22
1746545627801,CSE 21,B01,892583,Braun; Oliver,45,0,50,5
1746545628827,CSE 30,A01,887025,Eldon; John,143,0,200,57
1746545629856,CSE 100,A01,887027,Staff,26,0,50,24
1746545629856,CSE 100,A02,887028,Staff,40,0,50,10
1746545630887,CSE 101,A01,887030,Braun; Oliver,75,0,100,25
1746545630887,CSE 101,B01,887032,Jones; Miles E,0,3,50,50
1746545630887,CSE 101,B02,887033,Jones; Miles E,0,1,50,50
1746545631914,CSE 105,A01,908084,Jones; Miles E,32,0,50,18
1746545631914,CSE 105,A02,908087,Jones; Miles E,33,0,50,17
1746545632940,CSE 135,A01,887035,Powell; Thomas Allan,0,4,50,50
1746545633965,CSE 142,A01,887037,Staff,8,0,60,52
1746545634995,CSE 142L,A01,887039,Staff,34,0,60,26
1746545636022,CSE 151A,A01,887041,Solares; Edwin A,48,0,100,52
1746545637052,CSE 175,A01,887043,Kumar; Rakesh,30,0,30,0
1746545638081,CSS 1,A01,886389,Staff,0,1,40,40
1746545639114,DSC 30,A01,908097,Liao; Soohyun Nam,47,0,75,28
1746545640138,DSC 40A,A01,908099,Shannon; Kyle Michael,30,0,50,20
1746545641162,DSC 40B,A01,908112,Staff,16,0,50,34
1746545642193,DSC 80,A01,908116,Staff,19,0,60,41
1746545643218,DSC 197,001,956863,Eldridge; Justin Matthew,9999,0,9999,0
1746545644244,ECE 5,A01,886400,Morris; Karcher William,2,0,6,4
1746545644244,ECE 5,A02,886401,Morris; Karcher William,3,0,6,3
1746545645267,ECE 148,A01,886403,Silberman; Jack,0,14,14,14
1746545646305,ECON 1,A01,887265,Crane; Meredith Helen,12,0,70,58
1746545646305,ECON 1,B01,887268,Staff,43,0,50,7
1746545647330,ECON 2,A01,887273,Crane; Meredith Helen,56,0,70,14
1746545648361,ECON 3,A01,887279,Rondina; Giacomo,32,0,70,38
1746545649385,ECON 4,A01,887282,Anderson; John Charles,0,2,10,10
1746545650413,ECON 5,A01,887285,Staff,33,0,45,12
1746545650413,ECON 5,B01,887292,Staff,41,0,45,4
1746545651438,ECON 100A,A01,887337,Newhouse; Herbert S,54,0,70,16
1746545651438,ECON 100A,B01,887349,Staff,45,0,50,5
1746545652466,ECON 100B,A01,887361,Du; Songzi,29,0,70,41
1746545653494,ECON 100C,A01,887445,Newhouse; Herbert S,59,0,70,11
1746545654519,ECON 105,A00,887488,Vespa; Emanuel Ignacio,23,0,35,12
1746545655547,ECON 109,A01,887506,Shishkin; Denis,28,0,35,7
1746545656575,ECON 110A,A01,887568,Alon; Titan Michael,0,3,35,35
1746545656575,ECON 110A,B01,907601,Alon; Titan Michael,20,0,35,15
1746545657600,ECON 110B,A01,887598,Levkoff; Steven B.,0,23,70,70
1746545658625,ECON 112,A00,887599,Rondina; Giacomo,19,0,35,16
1746545659654,ECON 120A,A01,887603,Dai; Yinlin,36,0,70,34
1746545660685,ECON 120C,A01,887608,Sun; Yixiao,0,1,35,35
1746545660685,ECON 120C,B01,887614,Sun; Yixiao,0,0,35,35
1746545661713,ECON 138,A00,887621,Bharadwaj; Prashant,0,20,20,20
1746545662740,ECON 144,A00,958007,Squires; Dale E,13,0,35,22
1746545663769,ECON 171,A01,907666,Staff,18,0,35,17
1746545664798,ECON 175,A00,887626,Wu; Pak Yeung,23,0,35,12
1746545665824,ECON 190,A00,887640,Vespa; Emanuel Ignacio,23,0,35,12
1746545666853,EDS 25,A01,888197,Staff,0,0,0,0
1746545666853,EDS 25,A02,888209,Staff,0,0,0,0
1746545666853,EDS 25,A03,888210,Staff,0,0,0,0
1746545666853,EDS 25,A04,888212,Staff,0,0,0,0
1746545666853,EDS 25,A05,888213,Staff,0,0,0,0
1746545666853,EDS 25,A06,888214,Staff,0,0,0,0
1746545666853,EDS 25,A07,888235,Staff,0,2,0,0
1746545666853,EDS 25,A08,888236,Staff,0,0,0,0
1746545666853,EDS 25,A09,888240,Staff,0,0,0,0
1746545666853,EDS 25,A10,888244,Staff,0,0,0,0
1746545666853,EDS 25,B01,888273,Staff,0,0,0,0
1746545666853,EDS 25,B02,888285,Staff,0,0,0,0
1746545666853,EDS 25,B03,888423,Staff,0,0,0,1
1746545666853,EDS 25,B04,888432,Staff,0,0,0,0
1746545666853,EDS 25,B05,888433,Staff,0,0,0,0
1746545666853,EDS 25,B06,888467,Staff,0,0,0,0
1746545666853,EDS 25,B07,888468,Staff,0,0,0,0
1746545666853,EDS 25,B08,888479,Staff,0,0,0,0
1746545666853,EDS 25,B09,888484,Staff,0,0,0,0
1746545666853,EDS 25,B10,888487,Staff,0,0,0,0
1746545667878,EDS 38,A01,907700,Choi; Bailey Miyeon,30,0,30,0
1746545668909,EDS 112,A01,888601,Chapman; Thandeka K,14,0,40,26
1746545669935,EDS 115,A00,888697,Mendez; Kathrina Mendoza,10,0,30,20
1746545670964,EDS 116,A01,888893,Staff,35,0,40,5
1746545673022,EDS 124AR,A00,889133,Staff,29,0,50,21
1746545673022,EDS 124AR,B00,907471,Simon; Elizabeth A,37,0,50,13
1746545674048,EDS 124BR,A00,889134,Simon; Elizabeth A,45,0,100,55
1746545675073,EDS 125,A00,889135,Staff,25,0,30,5
1746545676101,EDS 126,A01,889138,Staff,36,0,40,4
1746545677126,EDS 164R,A01,889142,Wishard Guerra; Alison G.,33,0,50,17
1746545678150,ENG 30,A01,886396,Staff,0,0,0,0
1746545678150,ENG 30,B01,886398,Staff,0,0,0,0
1746545679175,ENVR 102,A00,906150,Montejo; Carolina,23,0,25,2
1746545680202,ETHN 103A,A00,887236,Man; Simeon S,0,3,0,0
1746545681226,ETHN 113,A00,887239,Staff,16,0,30,14
1746545682251,ETHN 116,A00,887240,Staff,16,0,25,9
1746545683276,ETHN 117,A00,887241,Choi; Esther Min,28,0,30,2
1746545684301,ETHN 118,A00,887243,Staff,24,0,30,6
1746545685330,ETHN 127,A00,887248,Cuong; Marisol,11,0,15,4
1746545686358,ETHN 139,A00,887250,Staff,7,0,10,3
1746545687382,ETHN 142,A00,887252,Staff,10,0,30,20
1746545688413,ETHN 161,A00,887253,Browne; Errol Tsekani,24,0,30,6
1746545689439,ETHN 163FR,A00,887255,Burelle; Julie Sara Veronique,0,0,5,5
1746545690464,GLBH 20,A00,889149,Elwardani; Nile Regina,8,0,42,34
1746545692517,GLBH 111,A01,889152,Burgos; Jose L.,17,0,17,0
1746545693553,GLBH 150,A00,889181,Sloane; Julia Kathryn,0,5,15,15
1746545695603,HDS 60,A01,886406,Warstadt; Melissa Fawn,73,0,80,7
1746545696627,HIAF 111,A00,889324,Gyamfi; Bright,25,0,32,7
1746545697656,HIEA 131,A00,889328,Staff,16,0,32,16
1746545698683,HIEA 144,A00,889333,Henry; Todd A.,26,0,32,6
1746545699706,HIEA 154,A00,889336,Henry; Todd A.,24,0,32,8
1746545700735,HIEU 106,A00,889339,Staff,22,0,32,10
1746545702788,HIEU 114,A00,889340,Staff,3,0,32,29
1746545703816,HIEU 135GS,A00,889342,Patterson; Patrick H.,0,0,1,24
1746545704847,HIEU 137,A00,889343,Edington; Claire Ellen,9,0,25,16
1746545705882,HIEU 148,A00,889345,Staff,14,0,32,18
1746545706909,HIEU 154,A00,889346,Biess; Frank Peter,21,0,32,11
1746545707935,HILA 102,A00,889351,Staff,12,0,32,20
1746545708963,HILD 2A,A01,889221,Lewandoski; Julia Mavis,1,10,32,31
1746545709994,HILD 7B,A01,889225,Man; Simeon S,0,13,32,32
1746545711023,HILD 7C,A01,889288,Alvarez; Luis A,0,14,32,32
1746545712048,HILD 30,A01,889323,Staff,0,5,32,32
1746545714108,HISC 119,A00,889383,Golan; Tal,21,0,32,11
1746545715134,HIUS 103,A00,889384,Man; Simeon S,0,0,32,32
1746545716169,HIUS 117,A00,919797,Kwak; Nancy,18,0,32,14
1746545717194,HIUS 142A,A00,919788,Staff,22,0,32,10
1746545719244,HIUS 149,A00,889386,Gyamfi; Bright,27,0,32,5
1746545720269,HIUS 155,A00,889387,Alvarez; Luis A,14,0,32,18
1746545721297,HUM 3,A01,886499,Caldwell; Michael Alan,19,0,50,31
1746545722324,HUM 3GS,A00,886500,Rodriguez; Bretton Sigfred,0,0,0,28
1746545723349,HUM 3R,A01,886502,Markman; Kristina,0,36,50,50
1746545724377,HUM 4,A01,886504,Crum; Matthew Stephen,24,0,50,26
1746545724377,HUM 4,B01,886506,West; Geoffrey Scott,17,0,50,33
1746545725402,HUM 4GS,A00,886507,Staff,0,0,0,19
1746545726430,HUM 5,A01,886509,Staff,32,0,50,18
1746545727458,HUM 5R,A01,886511,Zavodny; Tatiana Sophia,0,39,50,50
1746545728487,JAPN 180,A00,886407,Staff,18,0,40,22
1746545729517,LATI 50,A01,886409,Martin-Cabrera; Luis,4,0,22,18
1746545729517,LATI 50,A02,886410,Martin-Cabrera; Luis,19,0,22,3
1746545729517,LATI 50,A03,886411,Martin-Cabrera; Luis,21,0,22,1
1746545729517,LATI 50,A04,886412,Martin-Cabrera; Luis,9,0,22,13
1746545730542,LAWS 101,A00,907664,Staff,28,0,60,32
1746545731570,LIAB 1A,A00,889388,Saab; Dima,17,0,20,3
1746545732597,LIAB 1AX,A00,889389,El Cheddadi; Youniss,17,0,20,3
1746545733625,LIFR 1C,A00,889391,Van Moer; Vinciane G,8,0,20,12
1746545734649,LIFR 1CX,A00,889392,Van Moer; Vinciane G,7,0,20,13
1746545735678,LIFR 1D,A00,889393,Van Moer; Vinciane G,7,0,20,13
1746545737293,LIFR 1DX,A00,889394,Van Moer; Vinciane G,8,0,20,12
1746545738319,LIGN 7,A00,886923,Staff,24,0,50,26
1746545739350,LIGN 17,A00,886924,Kehler; Andrew Scott,125,0,150,25
1746545740380,LTAM 110,A00,889395,Staff,15,0,30,15
1746545741410,LTAM 110GS,A00,958010,Rodriguez; Bretton Sigfred,0,0,0,28
1746545742438,LTCH 101,A00,889397,Staff,23,0,25,2
1746545743465,LTCS 130,A00,889398,Staff,23,0,25,2
1746545744492,LTEA 138,A00,889399,Staff,24,0,40,16
1746545745521,LTEN 149,A00,889400,Wesling; Megan E.,0,3,25,25
1746545746550,LTEN 169,A00,889401,Staff,20,0,25,5
1746545747580,LTEN 180,A00,889402,Staff,10,0,15,5
1746545748606,LTEN 181,A00,889403,Staff,21,0,25,4
1746545749631,LTWL 100,A00,889404,Myerston Santana; Jacobo,3,0,25,22
1746545750659,LTWL 180GS,A00,889405,Staff,0,0,20,20
1746545751685,LTWL 181,A00,889406,Staff,17,0,25,8
1746545752712,LTWL 184,A00,889475,Mukherjee; Silpa,22,0,25,3
1746545753739,LTWR 102C,A00,889486,Staff,29,0,30,1
1746545754764,LTWR 115W,A00,889491,Staff,0,2,15,15
1746545755789,MAE 8,A01,886905,Staff,0,2,0,0
1746545756815,MAE 11,A00,886906,Bandaru; Prabhakar,0,7,50,50
1746545757842,MAE 20,A00,886907,Evdokimenko; Ekaterina,44,0,70,26
1746545758870,MAE 30B,A00,886909,Ghazinejad; Maziar,26,0,45,19
1746545759895,MAE 101B,A00,886910,Saintillan; David,29,0,45,16
1746545760921,MAE 105,A00,886911,Bandaru; Prabhakar,18,0,50,32
1746545761950,MAE 107,B00,958024,Staff,9,0,50,41
1746545762975,MAE 143B,A00,886913,Bewley; Thomas R,7,0,40,33
1746545764001,MAE 148,A01,886915,Silberman; Jack,0,3,14,14
1746545765026,MAE 160,A00,886916,Evdokimenko; Ekaterina,31,0,60,29
1746545766052,MATH 3C,A01,889681,Staff,0,3,30,30
1746545766052,MATH 3C,A02,960048,Staff,25,0,30,5
1746545767078,MATH 10A,A01,889760,Staff,26,0,30,4
1746545767078,MATH 10A,A02,889783,Staff,29,0,30,1
1746545768104,MATH 10B,A01,889785,Verstraete; Jacques Allan,2,0,35,33
1746545768104,MATH 10B,A02,889795,Verstraete; Jacques Allan,4,0,35,31
1746545768104,MATH 10B,B01,889797,Verstraete; Jacques Allan,3,0,35,32
1746545768104,MATH 10B,B02,889828,Verstraete; Jacques Allan,3,0,35,32
1746545769133,MATH 10C,A01,889849,Habib; Yousaf,9,0,30,21
1746545769133,MATH 10C,A02,889852,Habib; Yousaf,14,0,30,16
1746545769133,MATH 10C,A03,889853,Habib; Yousaf,22,0,30,8
1746545769133,MATH 10C,A04,889858,Habib; Yousaf,20,0,30,10
1746545769133,MATH 10C,B01,889861,Staff,1,0,30,29
1746545769133,MATH 10C,B02,889862,Staff,24,0,30,6
1746545769133,MATH 10C,B03,889863,Staff,27,0,30,3
1746545769133,MATH 10C,B04,889967,Staff,23,0,30,7
1746545770160,MATH 18,A01,889974,Staff,7,0,30,23
1746545770160,MATH 18,A02,889977,Staff,20,0,30,10
1746545770160,MATH 18,B01,889984,Hardiman; Liam,22,0,30,8
1746545770160,MATH 18,B02,889985,Hardiman; Liam,25,0,30,5
1746545771186,MATH 20A,A01,889990,Suk; Andrew Hoon,29,0,35,6
1746545772214,MATH 20B,A01,889993,Ohm; Ko Woon,22,0,30,8
1746545772214,MATH 20B,A02,889994,Ohm; Ko Woon,30,0,30,0
1746545772214,MATH 20B,B01,889996,Ohm; Ko Woon,21,0,30,9
1746545772214,MATH 20B,B02,889997,Ohm; Ko Woon,23,0,30,7
1746545773240,MATH 20C,A01,889999,Hammock; Frances H,17,0,30,13
1746545773240,MATH 20C,A02,890003,Hammock; Frances H,23,0,30,7
1746545773240,MATH 20C,B01,890006,Hammock; Frances H,3,0,30,27
1746545773240,MATH 20C,B02,890007,Hammock; Frances H,11,0,30,19
1746545774274,MATH 20D,A01,890011,Cheng; Hsiao-Bing,1,1,30,29
1746545774274,MATH 20D,A02,890012,Cheng; Hsiao-Bing,14,0,30,16
1746545774274,MATH 20D,B01,890016,Cheng; Hsiao-Bing,13,0,30,17
1746545774274,MATH 20D,B02,890017,Cheng; Hsiao-Bing,13,0,30,17
1746545775307,MATH 20E,A01,890026,Harel; Guershon,1,0,30,29
1746545775307,MATH 20E,A02,890029,Harel; Guershon,23,0,30,7
1746545775307,MATH 20E,B01,890033,Harel; Guershon,7,0,30,23
1746545775307,MATH 20E,B02,890101,Harel; Guershon,21,0,30,9
1746545776331,MATH 102,A01,890104,Staff,17,0,30,13
1746545776331,MATH 102,A02,890105,Staff,27,0,30,3
1746545777360,MATH 103B,A01,890116,Salehi Golsefidy; Alireza,3,0,30,27
1746545777360,MATH 103B,B01,890118,Staff,0,3,34,34
1746545778386,MATH 109,A01,890121,Aliabadi Sr.; Mohsen,1,0,30,29
1746545778386,MATH 109,B01,890124,Upadrashta; Pranav Kumar,18,0,30,12
1746545779412,MATH 120A,A01,890126,Eggers; John Dietrich,13,0,30,17
1746545780437,MATH 142B,A01,890128,Ioana; Adrian,19,0,30,11
1746545780437,MATH 142B,A02,890129,Ioana; Adrian,13,0,30,17
1746545781462,MATH 154,A01,890174,Staff,0,0,30,30
1746545781462,MATH 154,A02,890182,Staff,0,0,30,30
1746545782488,MATH 168A,A01,890197,Dumitriu; Ioana,21,0,35,14
1746545783513,MATH 170A,A01,890240,Nie; Jiawang,1,0,30,29
1746545783513,MATH 170A,A02,890241,Nie; Jiawang,11,0,30,19
1746545783513,MATH 170A,A03,890249,Nie; Jiawang,23,0,30,7
1746545784539,MATH 170B,A01,957891,Nag; Panchali,13,0,35,22
1746545786590,MATH 181A,A01,908025,Staff,0,4,35,35
1746545786590,MATH 181A,A02,960115,Staff,27,0,35,8
1746545787617,MATH 181B,A01,959874,Staff,26,0,30,4
1746545788643,MATH 193B,A01,890265,Staff,0,4,35,35
1746545789673,MGT 4,A01,890311,Anderson; John Charles,42,0,88,46
1746545790701,MGT 5,A00,907740,Staff,13,0,98,85
1746545791725,MGT 12,A00,890312,Lindenberger; Wade Douglas,67,0,98,31
1746545792753,MGT 16,A00,957883,Staff,78,0,98,20
1746545794803,MGT 45,A00,890314,Pecore; Joseph P.,47,0,98,51
1746545795830,MGT 71,A00,890315,Staff,0,11,98,98
1746545796860,MGT 100,A00,890316,Yavorsky; Daniel Ryan,44,0,98,54
1746545797892,MGT 103,A00,890317,Ehrich; Kristine R,73,0,98,25
1746545798918,MGT 105,A00,890356,Bates; Kenneth Walter,0,7,98,98
1746545799945,MGT 112,A00,890360,Ehrich; Kristine R,55,0,98,43
1746545800970,MGT 127R,A00,907732,Zhu; Kevin Xiaoguo,23,0,98,75
1746545801996,MGT 131B,A00,890361,Anderson; John Charles,61,0,98,37
1746545803024,MGT 137,A00,890362,Lindenberger; Wade Douglas,65,0,98,33
1746545804050,MGT 160,A00,890369,Johnson; Erik Barry,9,0,98,89
1746545806101,MGT 164,A00,890372,Zimmermann; Carsten,0,39,98,98
1746545807128,MGT 180,A00,890374,Bliss; Barbara Ann,12,0,98,86
1746545808153,MMW 15,A01,886414,Chang; Edmond Yi-Teh,0,12,28,28
1746545808153,MMW 15,A02,886415,Chang; Edmond Yi-Teh,0,8,28,28
1746545808153,MMW 15,A03,886416,Chang; Edmond Yi-Teh,0,8,28,28
1746545808153,MMW 15,A04,886417,Chang; Edmond Yi-Teh,0,8,28,28
1746545808153,MMW 15,B01,886419,Chang; Edmond Yi-Teh,0,7,28,28
1746545808153,MMW 15,B02,886420,Chang; Edmond Yi-Teh,0,8,28,28
1746545808153,MMW 15,B03,886421,Chang; Edmond Yi-Teh,0,7,28,28
1746545808153,MMW 15,B04,886422,Chang; Edmond Yi-Teh,0,8,28,28
1746545808153,MMW 15,C01,886424,Staff,0,9,28,28
1746545808153,MMW 15,C02,886425,Staff,0,8,28,28
1746545808153,MMW 15,C03,886426,Staff,0,8,28,28
1746545808153,MMW 15,C04,886427,Staff,0,7,28,28
1746545808153,MMW 15,C05,958038,Staff,0,7,28,28
1746545808153,MMW 15,C06,958039,Staff,0,8,28,28
1746545809178,MMW 15GS,A00,906910,Patterson; Patrick H.,4,0,28,24
1746545810203,MMW 122R,A01,886429,Rahimi; Babak,0,13,28,28
1746545810203,MMW 122R,A02,886430,Rahimi; Babak,0,12,28,28
1746545810203,MMW 122R,A03,958040,Rahimi; Babak,0,11,28,28
1746545811230,MUS 1A,A01,890937,Staff,3,0,25,22
1746545811230,MUS 1A,A02,891035,Staff,6,0,25,19
1746545811230,MUS 1A,C01,958912,Staff,24,0,25,1
1746545811230,MUS 1A,C02,958913,Staff,25,0,25,0
1746545813284,MUS 2AK,A00,957092,Ohnishi; Takae,15,0,15,0
1746545814311,MUS 4,A01,891044,Staff,2,0,25,23
1746545814311,MUS 4,A02,891045,Staff,23,0,25,2
1746545814311,MUS 4,B01,891048,Staff,17,0,25,8
1746545814311,MUS 4,B02,891050,Staff,25,0,25,0
1746545815337,MUS 5,A01,957506,Dubnov; Shlomo,0,0,25,25
1746545815337,MUS 5,A02,957622,Dubnov; Shlomo,14,0,25,11
1746545815337,MUS 5,A03,957623,Dubnov; Shlomo,20,0,25,5
1746545816362,MUS 6,A01,891053,Freitas Caetano; Marcelo,24,0,25,1
1746545816362,MUS 6,A02,891054,Freitas Caetano; Marcelo,23,0,25,2
1746545817387,MUS 7,A01,891081,Staff,0,0,25,25
1746545817387,MUS 7,A02,891082,Staff,4,0,25,21
1746545818411,MUS 8GS,A00,891118,Borgo; David Garcia,0,0,25,25
1746545819440,MUS 11,A01,891140,Staff,11,0,25,14
1746545819440,MUS 11,A02,891141,Staff,22,0,25,3
1746545820466,MUS 13,A01,891143,Staff,8,0,25,17
1746545820466,MUS 13,A02,891144,Staff,24,0,25,1
1746545821494,MUS 15,A01,891146,Staff,9,0,25,16
1746545821494,MUS 15,A02,891148,Staff,21,0,25,4
1746545821494,MUS 15,B01,891150,Staff,18,0,25,7
1746545821494,MUS 15,B02,891151,Staff,25,0,25,0
1746545822522,MUS 20,A01,891153,Staff,5,0,20,15
1746545822522,MUS 20,A02,891155,Staff,14,0,20,6
1746545823548,MUS 80,A00,891156,Staff,19,0,25,6
1746545823548,MUS 80,B00,891157,Staff,23,0,25,2
1746545824573,MUS 130,A00,891158,Ohnishi; Takae,35,0,35,0
1746545825600,MUS 150GS,A01,891160,Borgo; David Garcia,0,0,25,25
1746545826667,MUS 170,A01,891162,Freitas Caetano; Marcelo,20,0,25,5
1746545826667,MUS 170,A02,891164,Freitas Caetano; Marcelo,21,0,25,4
1746545827694,NANO 11,A00,886220,Vazquez Mena; Oscar,13,0,15,2
1746545828723,NANO 15,A01,886222,Drews; Aaron,4,0,7,3
1746545829750,NANO 104,A00,886224,Sirbuly; Donald,18,0,25,7
1746545830778,PH 40,A00,886528,Staff,23,0,40,17
1746545831805,PH 45,A01,886799,Staff,35,0,40,5
1746545832833,PH 110,A00,886802,Staff,0,7,40,40
1746545833889,PH 172,A00,906716,Staff,19,0,35,16
1746545834917,PH 191,A00,886803,Staff,6,0,40,34
1746545835943,PHIL 1,A00,889500,Staff,19,0,30,11
1746545836972,PHIL 10,A01,889549,Grush; Rick Scott,15,0,22,7
1746545836972,PHIL 10,A02,889551,Grush; Rick Scott,22,0,22,0
1746545838001,PHIL 28,A01,889559,Lamey; Andy M.,0,1,31,31
1746545838001,PHIL 28,A02,889561,Lamey; Andy M.,0,1,30,30
1746545838001,PHIL 28,A03,889572,Lamey; Andy M.,0,0,30,30
1746545839033,PHIL 35,A00,907839,Staff,13,0,15,2
1746545840057,PHIL 60,A00,889574,Staff,74,0,90,16
1746545841084,PHIL 101,A00,958004,Staff,13,0,15,2
1746545843139,PHIL 136,A00,889582,Fulkerson; Matthew Todd,26,0,45,19
1746545844166,PHIL 163,A01,889601,Staff,21,0,30,9
1746545844166,PHIL 163,B01,889606,Brandt; Reuven A,0,3,0,0
1746545845191,PHIL 164,A00,889610,Staff,16,0,30,14
1746545846219,PHIL 165,A00,889613,Staff,23,0,30,7
1746545847244,PHYS 1A,A00,886431,Staff,26,0,70,44
1746545848269,PHYS 1AL,001,886432,Tsai; Philbert S,0,2,30,30
1746545848269,PHYS 1AL,002,886436,Tsai; Philbert S,11,0,30,19
1746545849293,PHYS 1B,A00,886439,Staff,185,0,240,55
1746545850319,PHYS 1BL,001,886441,Tsai; Philbert S,0,4,30,30
1746545850319,PHYS 1BL,002,886444,Tsai; Philbert S,2,0,30,28
1746545851343,PHYS 1C,A00,896092,Arnold; Kam S,78,0,146,68
1746545852369,PHYS 1CL,001,886448,Tsai; Philbert S,0,0,30,30
1746545852369,PHYS 1CL,002,886449,Tsai; Philbert S,0,0,30,30
1746545852369,PHYS 1CL,003,886450,Tsai; Philbert S,16,0,30,14
1746545852369,PHYS 1CL,004,886451,Tsai; Philbert S,15,0,30,15
1746545853394,PHYS 2B,A01,886457,Staff,69,0,115,46
1746545854423,PHYS 2C,A01,886460,Shotwell; Brian,0,8,65,65
1746545855452,PHYS 2CL,A01,886467,Staff,0,4,28,28
1746545855452,PHYS 2CL,A02,886468,Staff,0,3,28,28
1746545856481,PHYS 2D,A01,886470,Staff,10,0,50,40
1746545857507,PHYS 4B,A01,886475,Grinstein; Benjamin,22,0,40,18
1746545858533,POLI 5,A00,891173,Desposato; Scott,7,0,25,18
1746545859559,POLI 5D,A01,891175,Staff,5,0,5,0
1746545859559,POLI 5D,B01,891178,Staff,5,0,5,0
1746545860589,POLI 11,A00,891179,Ferree; Karen E,2,0,35,33
1746545861615,POLI 12,A00,891180,Staff,16,0,30,14
1746545862641,POLI 27,A01,891182,Staff,12,0,75,63
1746545863670,POLI 30,A00,891183,Staff,8,0,50,42
1746545864697,POLI 100B,A00,891244,Staff,5,1,35,30
1746545865725,POLI 100I,A00,891247,Staff,7,0,30,23
1746545866749,POLI 104J,A00,891248,Nichter; Maysa,14,0,30,16
1746545867773,POLI 104U,A00,891250,Nichter; Maysa,2,0,30,28
1746545869827,POLI 110B,A00,891255,Wiens; David,20,0,25,5
1746545870853,POLI 112A,A00,891256,Wiens; David,6,0,25,19
1746545871882,POLI 114BR,A00,891261,Staff,19,0,30,11
1746545872908,POLI 117R,A00,891262,Forman; Fonna,0,6,50,50
1746545873935,POLI 118,A00,891264,Ingham; Sean,17,0,25,8
1746545874962,POLI 124A,A00,891265,Staff,18,0,20,2
1746545875987,POLI 125D,A00,891266,Nichter; Simeon C,2,0,25,23
1746545877014,POLI 126,A00,891268,Nichter; Simeon C,7,0,25,18
1746545878042,POLI 126AA,A00,891272,Staff,18,0,25,7
1746545879068,POLI 130AA,A00,891273,Staff,15,0,20,5
1746545880092,POLI 134AA,A00,891274,Staff,4,0,20,16
1746545882146,POLI 138,A00,891278,Staff,21,0,25,4
1746545883170,POLI 142K,A00,891280,Staff,11,0,25,14
1746545884198,POLI 142M,A00,891281,Gartzke; Erik,17,0,30,13
1746545885224,POLI 142P,A00,891284,Staff,20,0,30,10
1746545886249,POLI 143,A00,891285,Gartzke; Erik,12,0,30,18
1746545887276,POLI 153,A00,891286,Staff,19,0,20,1
1746545889329,POLI 175,A00,891290,Staff,15,0,20,5
1746545890358,PSYC 1,A00,890674,Steiner; Eric Tomas,0,11,45,45
1746545891387,PSYC 2,A00,890676,Albright; Thomas D,21,0,35,14
1746545892423,PSYC 3,A00,890679,Staff,17,0,20,3
1746545893446,PSYC 6,A00,959858,Staff,20,0,20,0
1746545894475,PSYC 60,A01,890684,Rickard; Timothy C.,0,5,45,45
1746545895505,PSYC 70,A01,890689,Geller; Emma Harlan,7,0,30,23
1746545896532,PSYC 71,A01,959860,Staff,21,0,25,4
1746545897558,PSYC 100,A00,890690,Lacefield; Katharine I,0,50,180,180
1746545898583,PSYC 102,A00,890695,Staff,18,0,40,22
1746545899609,PSYC 105,A00,890699,Geller; Emma Harlan,71,0,100,29
1746545900635,PSYC 106,A00,890701,Gorman; Michael R.,5,0,30,25
1746545901668,PSYC 108,A00,890704,Adrian; Julia Anna,0,28,50,50
1746545902693,PSYC 118,A01,890712,Staff,11,0,30,19
1746545903720,PSYC 124,A00,890716,Chapman; Eddie Nathaniel,25,0,60,35
1746545904748,PSYC 131,A00,890717,Anagnostaras; Stephan,0,7,80,80
1746545905776,PSYC 137,A00,890719,Winkielman; Piotr,0,11,30,30
1746545906802,PSYC 144,A00,890721,Adrian; Julia Anna,0,9,45,45
1746545907829,PSYC 162,A00,890805,Staff,2,0,75,73
1746545908855,PSYC 169,A00,890810,Staff,0,15,30,30
1746545909884,PSYC 172,A00,890814,Gorman; Michael R.,9,0,30,21
1746545910910,PSYC 181,A00,890818,Anagnostaras; Stephan,8,0,200,192
1746545911940,PSYC 184,A00,959861,Staff,170,0,175,5
1746545912970,PSYC 189,A00,890823,Staff,0,1,30,30
1746545914000,PSYC 191,A00,890884,Rickard; Timothy C.,0,11,35,35
1746545915028,PSYC 193,A00,890913,Staff,19,0,30,11
1746545915028,PSYC 193,B00,890914,Chapman; Eddie Nathaniel,24,0,30,6
1746545916059,PSYC 193L,A01,890918,Lowe; Angela Beth,20,0,30,10
1746545916059,PSYC 193L,B01,890921,Hurwitz; Ethan Scott,20,0,30,10
1746545916059,PSYC 193L,C01,890928,Staff,30,0,30,0
1746545917084,RELI 149,A00,886806,Rahimi; Babak,23,0,40,17
1746545918110,SE 9,A01,886814,Staff,7,0,20,13
1746545919139,SE 101B,A01,886816,Chadha; Mayank,4,0,35,31
1746545920165,SE 110B,A00,886818,Zhu; Qiang,4,0,75,71
1746545921194,SE 125,A01,886830,Staff,10,0,30,20
1746545922223,SE 130B,A01,886835,Staff,14,0,40,26
1746545923248,SE 131A,A01,886838,Krysl; Petr,34,0,55,21
1746545924277,SE 154,A00,886840,Staff,30,0,50,20
1746545925304,SE 164GS,A01,886849,Staff,6,0,20,14
1746545926329,SE 167GS,A01,886853,Staff,6,0,20,14
1746545927354,SIO 25,A01,890107,Staff,19,0,30,11
1746545928379,SIO 45,A00,890109,Cook; Geoffrey W,117,0,200,83
1746545929404,SIO 109R,A00,890110,Forman; Fonna,0,16,20,20
1746545930431,SIO 187,A01,890114,Kacev; David,15,0,40,25
1746545931458,SOCI 1,A01,890431,Thorpe; Charles Robert,15,0,30,15
1746545931458,SOCI 1,A02,890518,Thorpe; Charles Robert,30,0,30,0
1746545932486,SOCI 2,A01,957978,Staff,25,0,25,0
1746545932486,SOCI 2,A02,957979,Staff,23,0,25,2
1746545933514,SOCI 20,A01,890523,Calderon-Zaks; Michael Aar,23,0,30,7
1746545933514,SOCI 20,A02,890526,Calderon-Zaks; Michael Aar,29,0,30,1
1746545934543,SOCI 30,A01,890533,Pardo Guerra; Juan Pablo,37,0,40,3
1746545935572,SOCI 40,A01,890535,Staff,27,0,45,18
1746545936599,SOCI 104Q,A00,890559,Staff,18,0,30,12
1746545937625,SOCI 106,A00,890560,Arnal; Maud Marie Leonie,20,0,30,10
1746545938657,SOCI 110,A00,890567,Holkenbrink-Monk; Charlene,19,0,30,11
1746545939682,SOCI 112,A00,890568,Victoria Torres; Pablo,1,0,55,54
1746545940707,SOCI 115,A00,890597,Arnal; Maud Marie Leonie,28,0,45,17
1746545942764,SOCI 121,A00,890604,Pardo Guerra; Juan Pablo,38,0,45,7
1746545943792,SOCI 126,A01,890608,Staff,8,0,10,2
1746545944821,SOCI 127,A00,890609,Staff,18,0,30,12
1746545945850,SOCI 131,A00,890610,Thorpe; Charles Robert,37,0,45,8
1746545946877,SOCI 135,A00,890615,Payne; Christine Anna,14,0,45,31
1746545947903,SOCI 139,A00,890620,Staff,38,0,45,7
1746545948927,SOCI 148E,A00,890622,Calderon-Zaks; Michael Aar,36,0,45,9
1746545949959,SOCI 150,A00,890623,Kohler; Kristopher M.,31,0,45,14
1746545950984,SOCI 157,A00,890625,Jules-Rosette; Bennetta W.,18,0,20,2
1746545952009,SOCI 160,A00,890627,Payne; Christine Anna,21,0,45,24
1746545953033,SYN 1,A00,886855,Fish; Gwendolyn Anne,0,0,0,0
1746545953033,SYN 1,B00,906086,Fish; Gwendolyn Anne,0,1,0,2
1746545954059,SYN 2R,A00,886860,Staff,0,17,15,15
1746545954059,SYN 2R,B00,906106,Atkinson; Arthur Laird,0,16,15,15
1746545955093,SYN 100,A01,886866,Browne; Emily,0,28,20,20
1746545955093,SYN 100,B01,906128,Rock; Martin,0,5,20,20
1746545955093,SYN 100,C01,906140,Deavenport; James Cary,0,3,20,20
1746545955093,SYN 100,D01,907816,Deavenport; James Cary,0,5,20,20
1746545956118,TDAC 1,A00,890286,Walsh; Kim C.,9,0,20,11
1746545957146,TDAC 101,A00,890296,Basso; Beatrice,16,0,20,4
1746545958172,TDDE 131,A00,890297,Staff,47,0,50,3
1746545959203,TDDM 1,A00,890287,Weinberg; Sadie,25,0,30,5
1746545960229,TDGE 11,A00,890288,Fulton; Julia,137,0,200,63
1746545960229,TDGE 11,B00,890289,Castro; Robert Jess,184,0,200,16
1746545961256,TDGE 25,B00,957359,Walsh; Kim C.,3,0,20,17
1746545962284,TDGE 40,A01,890292,Power; Jade Yukana,27,0,30,3
1746545963312,TDGE 124,A00,890298,Havis; Allan,0,0,50,50
1746545964338,TDGE 131R,A00,890299,Burelle; Julie Sara Veronique,15,0,42,27
1746545965363,TDHT 101,A00,890300,Staff,10,0,20,10
1746545966388,TDHT 109,A01,890302,Anderson; Mysia Anyse,31,0,40,9
1746545967415,TDMV 1,A00,890293,Arcidiacono; Kristin,18,0,30,12
1746545968441,TDMV 2,A00,890294,Weinberg; Sadie,23,0,30,7
1746545969469,TDMV 3,A00,957878,Arcidiacono; Kristin,28,0,30,2
1746545971525,TDMV 138,A00,890304,Jun; Grace Shin Hae,25,0,40,15
1746545972553,TDMV 140,A00,890305,Corrales; Joseph Bernales,25,0,30,5
1746545973578,TDMV 142,A00,890307,Caligagan; Tony,32,0,40,8
1746545974606,TDMV 144,A00,890308,Camaya; Michelle Ann,25,0,30,5
1746545975633,TDPW 1,A00,890295,Stein; Deborah Isobel,3,0,20,17
1746545976657,USP 2,A01,890272,Lerner; Amy M,6,0,20,14
1746545977682,USP 3,A01,890274,Staff,12,0,30,18
1746545978708,USP 15,A01,890276,Sun; Feiyang,17,0,30,13
1746545979735,USP 25,A00,890277,Shenkman; Michael Thomas,19,0,25,6
1746545980764,USP 138,A00,890278,Staff,13,0,25,12
1746545981789,USP 143,A00,890279,Staff,21,0,70,49
1746545982815,USP 144,A00,890280,Chowdhury; Muhammed Zohir,16,0,30,14
1746545983839,USP 150,A00,890281,Boomhower; Matthew Charles,4,0,30,26
1746545984865,USP 151,A00,890282,Staff,16,0,20,4
1746545985890,USP 162,A00,890283,Andrews; Abigail Leslie,16,0,20,4
1746545986919,USP 168,A00,920477,Kwak; Nancy,1,0,5,4
1746545987945,USP 181,A00,890284,Staff,3,0,20,17
1746545988974,USP 191A,A00,890285,Staff,13,0,20,7
1746545990001,VIS 101,A00,886512,Staff,25,0,75,50
1746545991033,VIS 103,A00,886513,Cruz; Edwin Teddy,61,0,75,14
1746545992058,VIS 108,A00,886514,Staff,3,0,15,12
1746545993084,VIS 127P,A00,886515,Shen; Kuiyi,80,0,146,66
1746545994112,VIS 149,A00,886516,Yoldas; Pinar,0,0,15,15
1746545995137,VIS 164,A00,886526,Erdmann; Dean,19,0,22,3
1746545996166,VIS 194S,A00,886527,Staff,61,0,75,14
1746545997195,WCWP 10A,C00,886484,Martiniuk; Jill,12,0,15,3
1746545998221,WCWP 10B,A00,886490,Uriarte; Emma,0,0,15,15
1746545998221,WCWP 10B,B00,886491,Dhir; Simrita,11,0,15,4
1746545998221,WCWP 10B,C00,886492,Ornelas; Tricia,0,0,15,15
1746545999247,WCWP 100,A00,886494,Young; Mark T,0,7,15,15
1746546001370,AAS 10,A01,886199,Childs; Dennis R.,0,3,0,0
1746546002408,ANAR 104,A01,886940,Shtienberg; Gilad,27,0,30,3
1746546003435,ANAR 120,A00,886953,Staff,12,0,20,8
1746546004460,ANBI 148,A01,886955,Wilder; Linnea Lorene,30,0,40,10
1746546006514,ANSC 122,A00,886957,Staff,25,0,30,5
1746546007544,ANSC 150,A00,886958,Sloane; Julia Kathryn,3,0,15,12
1746546008570,ANSC 156,A00,886959,Jenkins; Janis A.,0,1,15,15
1746546009593,ANSC 180,A00,886960,Staff,11,0,17,6
1746546010620,ANSC 188,A00,886961,Jassal; Aftab,9,0,25,16
1746546011645,ANSC 190,A00,886962,Jassal; Aftab,14,0,25,11
1746546012670,ANSC 191,A00,886963,Staff,18,0,20,2
1746546013699,ANTH 3,A01,891689,Staff,17,0,20,3
1746546014728,ANTH 5,A00,886933,Semendeferi; Ekaterini,16,0,20,4
1746546015754,ANTH 10,A00,886934,Staff,0,12,30,30
1746546016782,ANTH 21,A01,886936,Staff,40,0,60,20
1746546017809,ANTH 23,A01,886938,Staff,92,0,100,8
1746546018836,ANTH 105,A00,886964,Stewart; Alexander B,84,0,100,16
1746546019862,ANTH 108,A00,886965,Pedersen; David,9,0,20,11
1746546020895,AWP 10,001,886147,Staff,0,0,0,0
1746546020895,AWP 10,002,886148,Staff,0,0,0,0
1746546020895,AWP 10,003,886149,Staff,0,0,0,0
1746546020895,AWP 10,004,886150,Staff,0,0,0,0
1746546020895,AWP 10,005,886151,Staff,0,0,0,0
1746546020895,AWP 10,006,886152,Staff,0,0,0,0
1746546020895,AWP 10,007,886153,Staff,0,0,0,0
1746546020895,AWP 10,008,886154,Staff,0,0,0,0
1746546020895,AWP 10,009,886155,Staff,0,0,0,0
1746546020895,AWP 10,010,886156,Staff,0,0,0,0
1746546020895,AWP 10,011,886158,Staff,0,0,0,0
1746546020895,AWP 10,012,886160,Staff,0,0,0,0
1746546020895,AWP 10,013,886161,Staff,0,0,0,0
1746546020895,AWP 10,014,886162,Staff,0,0,0,0
1746546020895,AWP 10,015,886163,Staff,0,0,0,0
1746546020895,AWP 10,016,886164,Staff,0,0,0,0
1746546020895,AWP 10,017,886165,Staff,0,0,0,0
1746546020895,AWP 10,018,886166,Staff,0,0,0,0
1746546020895,AWP 10,019,886168,Staff,0,0,0,0
1746546020895,AWP 10,020,886170,Staff,0,0,0,0
1746546020895,AWP 10,021,886172,Staff,0,0,0,0
1746546021928,AWP 10R,001,886173,Staff,0,1,0,0
1746546021928,AWP 10R,002,886174,Staff,0,1,0,0
1746546021928,AWP 10R,003,886175,Staff,0,0,0,0
1746546021928,AWP 10R,004,886176,Staff,0,0,0,0
1746546021928,AWP 10R,005,886177,Staff,0,0,0,0
1746546021928,AWP 10R,006,886178,Staff,0,0,0,0
1746546021928,AWP 10R,007,886179,Staff,0,0,0,0
1746546021928,AWP 10R,008,886181,Staff,0,0,0,0
1746546021928,AWP 10R,009,886182,Staff,0,0,0,0
1746546021928,AWP 10R,010,886183,Staff,0,0,0,0
1746546021928,AWP 10R,011,886184,Staff,0,0,0,0
1746546021928,AWP 10R,012,886185,Staff,0,0,0,0
1746546021928,AWP 10R,013,886186,Staff,0,0,0,0
1746546021928,AWP 10R,014,886187,Staff,0,0,0,0
1746546021928,AWP 10R,015,886188,Staff,0,0,0,0
1746546021928,AWP 10R,016,886189,Staff,0,0,0,0
1746546022953,AWP 102R,A00,886190,Staff,0,0,0,0
1746546022953,AWP 102R,B00,886191,Staff,0,0,0,0
1746546023981,BENG 100,A01,886193,Staff,17,0,30,13
1746546025007,BENG 122A,A01,886195,Hasty; Jeff M,13,0,30,17
1746546026034,BENG 166A,A00,886196,Sah; Robert Lie-Yuan,0,1,30,30
1746546027058,BENG 190,A00,958050,Khojah; Reem I,24,0,25,1
1746546028087,BIBC 102,A01,894320,Staff,0,0,46,46
1746546028087,BIBC 102,A02,894321,Staff,0,0,46,46
1746546028087,BIBC 102,A03,894344,Staff,7,0,46,39
1746546028087,BIBC 102,A04,894345,Staff,26,0,47,21
1746546029114,BICD 100R,A01,894365,Smith; Laurie,0,3,58,58
1746546029114,BICD 100R,A02,894366,Smith; Laurie,0,5,58,58
1746546029114,BICD 100R,A03,894367,Smith; Laurie,2,0,59,57
1746546029114,BICD 100R,A04,959869,Smith; Laurie,41,0,59,18
1746546030144,BICD 136,A01,894383,Gustafson-Brown; Cindy,14,0,50,36
1746546031172,BIEB 102,A01,894494,Butler; Shannon Rhey,51,0,130,79
1746546033227,BIEB 150,A01,894617,Wills; Christopher,3,0,20,17
1746546033227,BIEB 150,A02,894631,Wills; Christopher,3,0,20,17
1746546033227,BIEB 150,A03,894937,Wills; Christopher,3,0,20,17
1746546033227,BIEB 150,A04,894946,Wills; Christopher,5,0,20,15
1746546034257,BIEB 194,A00,906141,Kurle; Carolyn M.,6,0,20,14
1746546035283,BILD 1,A01,894154,Staff,2,0,19,17
1746546035283,BILD 1,A02,894155,Staff,14,0,19,5
1746546035283,BILD 1,A03,894160,Staff,13,0,19,6
1746546035283,BILD 1,A04,894161,Staff,15,0,18,3
1746546036313,BILD 2,A01,894168,Staff,0,0,50,50
1746546036313,BILD 2,A02,894169,Staff,0,0,50,50
1746546036313,BILD 2,A03,894179,Staff,4,0,50,46
1746546036313,BILD 2,A04,894203,Staff,27,0,50,23
1746546037338,BILD 3,A01,894213,Staff,22,0,31,9
1746546037338,BILD 3,A02,894214,Staff,26,0,31,5
1746546037338,BILD 3,A03,894235,Staff,28,0,31,3
1746546037338,BILD 3,A04,894236,Staff,28,0,32,4
1746546038363,BILD 4,A01,894253,Reuther; Keefe,5,0,24,19
1746546038363,BILD 4,A02,894258,Reuther; Keefe,16,0,24,8
1746546039388,BILD 5,A01,894276,Reuther; Keefe,35,0,50,15
1746546039388,BILD 5,A02,894277,Reuther; Keefe,45,0,50,5
1746546039388,BILD 5,A03,894290,Reuther; Keefe,44,0,50,6
1746546039388,BILD 5,A04,894291,Reuther; Keefe,48,0,50,2
1746546040414,BILD 24,A01,894297,Pirino; Giorgia,40,0,60,20
1746546041439,BIMM 100,B01,958915,Staff,72,0,100,28
1746546042466,BIMM 101,A01,895017,McDonnell; Lisa Marie,0,5,24,24
1746546042466,BIMM 101,A02,895018,McDonnell; Lisa Marie,0,5,24,24
1746546042466,BIMM 101,B01,895020,McDonnell; Lisa Marie,0,6,24,24
1746546042466,BIMM 101,B02,895021,McDonnell; Lisa Marie,0,4,24,24
1746546043491,BIMM 110,A01,895023,Staff,1,0,25,24
1746546043491,BIMM 110,A02,895024,Staff,9,0,25,16
1746546043491,BIMM 110,A03,895025,Staff,18,0,25,7
1746546043491,BIMM 110,A04,895031,Staff,20,0,25,5
1746546044521,BIMM 120,A01,895114,Gustafson-Brown; Cindy,13,0,28,15
1746546044521,BIMM 120,A02,895126,Gustafson-Brown; Cindy,21,0,27,6
1746546062125,BIPN 100,A01,895130,Yang; Mingyu,1,0,38,37
1746546062125,BIPN 100,A02,895131,Yang; Mingyu,32,0,38,6
1746546062125,BIPN 100,A03,895132,Yang; Mingyu,32,0,38,6
1746546062125,BIPN 100,A04,895133,Yang; Mingyu,27,0,36,9
1746546063151,BIPN 120,A01,895135,Cooke; James Edward,0,3,13,13
1746546063151,BIPN 120,A02,895136,Cooke; James Edward,0,1,13,13
1746546063151,BIPN 120,A03,895137,Cooke; James Edward,0,3,13,13
1746546063151,BIPN 120,A04,895156,Cooke; James Edward,0,2,11,11
1746546064179,BIPN 134,A01,895235,Cooke; James Edward,0,2,25,25
1746546064179,BIPN 134,A02,895237,Cooke; James Edward,0,0,25,25
1746546064179,BIPN 134,A03,895240,Cooke; James Edward,3,0,25,22
1746546064179,BIPN 134,A04,895270,Cooke; James Edward,20,0,25,5
1746546065204,BIPN 189,A00,892103,Staff,0,13,14,14
1746546067258,BISP 194,A00,958008,Staff,0,2,0,0
1746546068286,CAT 124,A01,922009,Staff,0,5,20,20
1746546069313,CAT 125R,A00,886390,Morales; Celeste Georgianna,0,2,20,20
1746546069313,CAT 125R,B00,886391,Irwin; Matthew Joseph,0,3,20,20
1746546069313,CAT 125R,C00,886392,Smith; Lauryn Alissa,0,2,20,20
1746546069313,CAT 125R,D00,886393,Vanderschuit; Maya Alysia,0,2,20,20
1746546069313,CAT 125R,E00,886394,Marchisotto; Jennifer Anne,0,4,20,20
1746546070341,CENG 15,A01,886218,Drews; Aaron,3,0,8,5
1746546071369,CENG 113,A00,886219,Opatkiewicz; Justin Paul,15,0,25,10
1746546072399,CGS 101,A00,887044,Staff,7,0,20,13
1746546073427,CGS 105,A01,887046,Staff,14,0,25,11
1746546074454,CGS 112,A00,887047,Cuong; Marisol,12,0,15,3
1746546075478,CGS 113,A00,887048,Staff,23,0,30,7
1746546076503,CGS 120,A00,887049,Staff,10,0,17,7
1746546077528,CHEM 6A,A01,886336,Lam; Tin Yiu,38,0,50,12
1746546077528,CHEM 6A,A02,886338,Lam; Tin Yiu,37,0,50,13
1746546078553,CHEM 6B,A01,886341,Hopkins; Patrycja Anna,16,0,50,34
1746546078553,CHEM 6B,A02,886343,Hopkins; Patrycja Anna,42,0,50,8
1746546079578,CHEM 6C,A01,886346,Albizati; Kim F.,0,2,50,50
1746546079578,CHEM 6C,A02,886348,Albizati; Kim F.,23,0,50,27
1746546080606,CHEM 40A,A01,886352,Klosterman; Jeremy K,65,0,100,35
1746546081633,CHEM 40B,A01,886356,Klosterman; Jeremy K,0,23,100,100
1746546082657,CHEM 41B,A01,886360,Theodorakis; Emmanuel,25,0,50,25
1746546082657,CHEM 41B,A02,886362,Theodorakis; Emmanuel,47,0,50,3
1746546083686,CHIN 165A,A00,886382,Xu; Li,18,0,20,2
1746546084714,CLAS 120,A00,886387,Myerston Santana; Jacobo,33,0,40,7
1746546085743,COGS 9,A01,886967,Shannon; Kyle Michael,42,0,60,18
1746546086771,COGS 11,A01,886969,Staff,11,0,30,19
1746546087797,COGS 14A,A01,886971,Staff,6,0,60,54
1746546088822,COGS 14B,A01,886973,Hoffman; Drew Ellen,4,0,60,56
1746546089849,COGS 18,A01,886975,Morgan; Eric,35,0,60,25
1746546090876,COGS 20,A01,886977,Staff,4,0,8,4
1746546090876,COGS 20,A02,886978,Staff,5,0,7,2
1746546091900,COGS 100,A01,907783,Staff,0,2,30,30
1746546092927,COGS 101B,A01,886980,Staff,0,3,48,48
1746546093954,COGS 101C,A01,886982,Delgado; Tania,0,5,44,44
1746546094997,COGS 102A,A01,886984,Johnson; Christine M.,4,0,30,26
1746546096023,COGS 118B,A01,886986,Staff,0,3,88,88
1746546097049,COGS 150,A01,886988,Bergen; Benjamin,23,0,50,27
1746546098078,COGS 153,A00,886989,Delgado; Tania,0,2,41,41
1746546099105,COGS 186,A01,886991,Staff,0,0,32,32
1746546100132,COGS 187A,A01,886993,Boyle; Mary E. T.,7,0,30,23
1746546101161,COGS 189,A00,886994,Staff,0,1,30,30
1746546102208,COMM 10,A01,886996,Staff,0,0,20,21
1746546102208,COMM 10,A02,886997,Staff,12,0,20,8
1746546102208,COMM 10,A03,959845,Staff,19,0,20,1
1746546103234,COMM 20,A01,886999,Leuning; Grant Maurstad,24,0,40,16
1746546105287,COMM 100A,A01,887002,Staff,0,0,20,25
1746546105287,COMM 100A,A02,887003,Staff,7,0,20,13
1746546106313,COMM 100B,A01,887005,Staff,0,8,20,24
1746546107340,COMM 106D,A00,887006,Staff,14,0,40,26
1746546108366,COMM 110G,A00,887007,Whitworth-Smith; Andrew C,12,0,40,28
1746546109391,COMM 111B,A00,887008,Staff,31,0,40,9
1746546110416,COMM 113T,A00,887009,Abuelhiga; Soraya Jill,28,0,40,12
1746546110416,COMM 113T,B00,906733,Staff,40,0,40,0
1746546111442,COMM 145,A00,887010,Staff,12,0,40,28
1746546112466,COMM 146,A00,887054,Staff,31,0,40,9
1746546113494,COMM 190,A00,887012,Staff,8,0,23,15
1746546114524,CSE 8A,A50,887015,Cao; Yingjun,57,0,85,28
1746546115548,CSE 11,A01,887017,Cao; Yingjun,12,0,70,58
1746546116575,CSE 20,A01,887019,Staff,30,0,50,20
1746546117603,CSE 21,A01,887021,Staff,78,0,100,22
1746546117603,CSE 21,B01,892583,Braun; Oliver,45,0,50,5
1746546118629,CSE 30,A01,887025,Eldon; John,143,0,200,57
1746546119656,CSE 100,A01,887027,Staff,26,0,50,24
1746546119656,CSE 100,A02,887028,Staff,40,0,50,10
1746546120683,CSE 101,A01,887030,Braun; Oliver,75,0,100,25
1746546120683,CSE 101,B01,887032,Jones; Miles E,0,3,50,50
1746546120683,CSE 101,B02,887033,Jones; Miles E,0,1,50,50
1746546121709,CSE 105,A01,908084,Jones; Miles E,32,0,50,18
1746546121709,CSE 105,A02,908087,Jones; Miles E,33,0,50,17
1746546122737,CSE 135,A01,887035,Powell; Thomas Allan,0,4,50,50
1746546123762,CSE 142,A01,887037,Staff,8,0,60,52
1746546124790,CSE 142L,A01,887039,Staff,34,0,60,26
1746546125817,CSE 151A,A01,887041,Solares; Edwin A,48,0,100,52
1746546126841,CSE 175,A01,887043,Kumar; Rakesh,30,0,30,0
1746546127867,CSS 1,A01,886389,Staff,0,1,40,40
1746546128894,DSC 30,A01,908097,Liao; Soohyun Nam,47,0,75,28
1746546129921,DSC 40A,A01,908099,Shannon; Kyle Michael,30,0,50,20
1746546130951,DSC 40B,A01,908112,Staff,16,0,50,34
1746546131978,DSC 80,A01,908116,Staff,19,0,60,41
1746546133008,DSC 197,001,956863,Eldridge; Justin Matthew,9999,0,9999,0
1746546134033,ECE 5,A01,886400,Morris; Karcher William,2,0,6,4
1746546134033,ECE 5,A02,886401,Morris; Karcher William,3,0,6,3
1746546135061,ECE 148,A01,886403,Silberman; Jack,0,14,14,14
1746546136090,ECON 1,A01,887265,Crane; Meredith Helen,12,0,70,58
1746546136090,ECON 1,B01,887268,Staff,43,0,50,7
1746546137114,ECON 2,A01,887273,Crane; Meredith Helen,56,0,70,14
1746546138143,ECON 3,A01,887279,Rondina; Giacomo,32,0,70,38
1746546139171,ECON 4,A01,887282,Anderson; John Charles,0,2,10,10
1746546140198,ECON 5,A01,887285,Staff,33,0,45,12
1746546140198,ECON 5,B01,887292,Staff,41,0,45,4
1746546141227,ECON 100A,A01,887337,Newhouse; Herbert S,54,0,70,16
1746546141227,ECON 100A,B01,887349,Staff,45,0,50,5
1746546142256,ECON 100B,A01,887361,Du; Songzi,29,0,70,41
1746546143282,ECON 100C,A01,887445,Newhouse; Herbert S,59,0,70,11
1746546144308,ECON 105,A00,887488,Vespa; Emanuel Ignacio,23,0,35,12
1746546145333,ECON 109,A01,887506,Shishkin; Denis,28,0,35,7
1746546146358,ECON 110A,A01,887568,Alon; Titan Michael,0,3,35,35
1746546146358,ECON 110A,B01,907601,Alon; Titan Michael,20,0,35,15
1746546147381,ECON 110B,A01,887598,Levkoff; Steven B.,0,23,70,70
1746546148407,ECON 112,A00,887599,Rondina; Giacomo,19,0,35,16
1746546149437,ECON 120A,A01,887603,Dai; Yinlin,36,0,70,34
1746546150465,ECON 120C,A01,887608,Sun; Yixiao,0,1,35,35
1746546150465,ECON 120C,B01,887614,Sun; Yixiao,0,0,35,35
1746546151493,ECON 138,A00,887621,Bharadwaj; Prashant,0,20,20,20
1746546152517,ECON 144,A00,958007,Squires; Dale E,13,0,35,22
1746546153542,ECON 171,A01,907666,Staff,18,0,35,17
1746546154566,ECON 175,A00,887626,Wu; Pak Yeung,23,0,35,12
1746546155593,ECON 190,A00,887640,Vespa; Emanuel Ignacio,23,0,35,12
1746546156621,EDS 25,A01,888197,Staff,0,0,0,0
1746546156621,EDS 25,A02,888209,Staff,0,0,0,0
1746546156621,EDS 25,A03,888210,Staff,0,0,0,0
1746546156621,EDS 25,A04,888212,Staff,0,0,0,0
1746546156621,EDS 25,A05,888213,Staff,0,0,0,0
1746546156621,EDS 25,A06,888214,Staff,0,0,0,0
1746546156621,EDS 25,A07,888235,Staff,0,2,0,0
1746546156621,EDS 25,A08,888236,Staff,0,0,0,0
1746546156621,EDS 25,A09,888240,Staff,0,0,0,0
1746546156621,EDS 25,A10,888244,Staff,0,0,0,0
1746546156621,EDS 25,B01,888273,Staff,0,0,0,0
1746546156621,EDS 25,B02,888285,Staff,0,0,0,0
1746546156621,EDS 25,B03,888423,Staff,0,0,0,1
1746546156621,EDS 25,B04,888432,Staff,0,0,0,0
1746546156621,EDS 25,B05,888433,Staff,0,0,0,0
1746546156621,EDS 25,B06,888467,Staff,0,0,0,0
1746546156621,EDS 25,B07,888468,Staff,0,0,0,0
1746546156621,EDS 25,B08,888479,Staff,0,0,0,0
1746546156621,EDS 25,B09,888484,Staff,0,0,0,0
1746546156621,EDS 25,B10,888487,Staff,0,0,0,0
1746546157650,EDS 38,A01,907700,Choi; Bailey Miyeon,30,0,30,0
1746546158677,EDS 112,A01,888601,Chapman; Thandeka K,14,0,40,26
1746546159706,EDS 115,A00,888697,Mendez; Kathrina Mendoza,10,0,30,20
1746546160735,EDS 116,A01,888893,Staff,35,0,40,5
1746546162792,EDS 124AR,A00,889133,Staff,29,0,50,21
1746546162792,EDS 124AR,B00,907471,Simon; Elizabeth A,37,0,50,13
1746546163820,EDS 124BR,A00,889134,Simon; Elizabeth A,45,0,100,55
1746546164847,EDS 125,A00,889135,Staff,25,0,30,5
1746546165879,EDS 126,A01,889138,Staff,36,0,40,4
1746546166903,EDS 164R,A01,889142,Wishard Guerra; Alison G.,33,0,50,17
1746546167930,ENG 30,A01,886396,Staff,0,0,0,0
1746546167930,ENG 30,B01,886398,Staff,0,0,0,0
1746546168962,ENVR 102,A00,906150,Montejo; Carolina,23,0,25,2
1746546169990,ETHN 103A,A00,887236,Man; Simeon S,0,3,0,0
1746546171015,ETHN 113,A00,887239,Staff,16,0,30,14
1746546172046,ETHN 116,A00,887240,Staff,16,0,25,9
1746546173073,ETHN 117,A00,887241,Choi; Esther Min,28,0,30,2
1746546174099,ETHN 118,A00,887243,Staff,24,0,30,6
1746546175130,ETHN 127,A00,887248,Cuong; Marisol,11,0,15,4
1746546176157,ETHN 139,A00,887250,Staff,7,0,10,3
1746546177187,ETHN 142,A00,887252,Staff,10,0,30,20
1746546178210,ETHN 161,A00,887253,Browne; Errol Tsekani,24,0,30,6
1746546179255,ETHN 163FR,A00,887255,Burelle; Julie Sara Veronique,0,0,5,5
1746546180279,GLBH 20,A00,889149,Elwardani; Nile Regina,8,0,42,34
1746546182334,GLBH 111,A01,889152,Burgos; Jose L.,17,0,17,0
1746546183364,GLBH 150,A00,889181,Sloane; Julia Kathryn,0,5,15,15
1746546185413,HDS 60,A01,886406,Warstadt; Melissa Fawn,73,0,80,7
1746546186443,HIAF 111,A00,889324,Gyamfi; Bright,25,0,32,7
1746546187469,HIEA 131,A00,889328,Staff,16,0,32,16
1746546188495,HIEA 144,A00,889333,Henry; Todd A.,26,0,32,6
1746546189523,HIEA 154,A00,889336,Henry; Todd A.,24,0,32,8
1746546190551,HIEU 106,A00,889339,Staff,22,0,32,10
1746546192603,HIEU 114,A00,889340,Staff,3,0,32,29
1746546193630,HIEU 135GS,A00,889342,Patterson; Patrick H.,0,0,1,24
1746546194655,HIEU 137,A00,889343,Edington; Claire Ellen,9,0,25,16
1746546195683,HIEU 148,A00,889345,Staff,14,0,32,18
1746546196710,HIEU 154,A00,889346,Biess; Frank Peter,21,0,32,11
1746546197735,HILA 102,A00,889351,Staff,12,0,32,20
1746546198762,HILD 2A,A01,889221,Lewandoski; Julia Mavis,1,10,32,31
1746546199789,HILD 7B,A01,889225,Man; Simeon S,0,13,32,32
1746546200816,HILD 7C,A01,889288,Alvarez; Luis A,0,14,32,32
1746546201841,HILD 30,A01,889323,Staff,0,5,32,32
1746546203894,HISC 119,A00,889383,Golan; Tal,21,0,32,11
1746546204921,HIUS 103,A00,889384,Man; Simeon S,0,0,32,32
1746546205948,HIUS 117,A00,919797,Kwak; Nancy,18,0,32,14
1746546206972,HIUS 142A,A00,919788,Staff,22,0,32,10
1746546209022,HIUS 149,A00,889386,Gyamfi; Bright,27,0,32,5
1746546210050,HIUS 155,A00,889387,Alvarez; Luis A,14,0,32,18
1746546211075,HUM 3,A01,886499,Caldwell; Michael Alan,19,0,50,31
1746546212101,HUM 3GS,A00,886500,Rodriguez; Bretton Sigfred,0,0,0,28
1746546213126,HUM 3R,A01,886502,Markman; Kristina,0,36,50,50
1746546214156,HUM 4,A01,886504,Crum; Matthew Stephen,24,0,50,26
1746546214156,HUM 4,B01,886506,West; Geoffrey Scott,17,0,50,33
1746546215182,HUM 4GS,A00,886507,Staff,0,0,0,19
1746546216211,HUM 5,A01,886509,Staff,32,0,50,18
1746546217240,HUM 5R,A01,886511,Zavodny; Tatiana Sophia,0,39,50,50
1746546218265,JAPN 180,A00,886407,Staff,18,0,40,22
1746546219294,LATI 50,A01,886409,Martin-Cabrera; Luis,4,0,22,18
1746546219294,LATI 50,A02,886410,Martin-Cabrera; Luis,19,0,22,3
1746546219294,LATI 50,A03,886411,Martin-Cabrera; Luis,21,0,22,1
1746546219294,LATI 50,A04,886412,Martin-Cabrera; Luis,9,0,22,13
1746546220323,LAWS 101,A00,907664,Staff,28,0,60,32
1746546221353,LIAB 1A,A00,889388,Saab; Dima,17,0,20,3
1746546222383,LIAB 1AX,A00,889389,El Cheddadi; Youniss,17,0,20,3
1746546223413,LIFR 1C,A00,889391,Van Moer; Vinciane G,8,0,20,12
1746546224441,LIFR 1CX,A00,889392,Van Moer; Vinciane G,7,0,20,13
1746546225467,LIFR 1D,A00,889393,Van Moer; Vinciane G,7,0,20,13
1746546226495,LIFR 1DX,A00,889394,Van Moer; Vinciane G,8,0,20,12
1746546227520,LIGN 7,A00,886923,Staff,24,0,50,26
1746546228547,LIGN 17,A00,886924,Kehler; Andrew Scott,125,0,150,25
1746546229575,LTAM 110,A00,889395,Staff,15,0,30,15
1746546230600,LTAM 110GS,A00,958010,Rodriguez; Bretton Sigfred,0,0,0,28
1746546231627,LTCH 101,A00,889397,Staff,23,0,25,2
1746546232655,LTCS 130,A00,889398,Staff,23,0,25,2
1746546233679,LTEA 138,A00,889399,Staff,24,0,40,16
1746546234706,LTEN 149,A00,889400,Wesling; Megan E.,0,3,25,25
1746546235733,LTEN 169,A00,889401,Staff,20,0,25,5
1746546236759,LTEN 180,A00,889402,Staff,10,0,15,5
1746546237787,LTEN 181,A00,889403,Staff,21,0,25,4
1746546238813,LTWL 100,A00,889404,Myerston Santana; Jacobo,3,0,25,22
1746546239841,LTWL 180GS,A00,889405,Staff,0,0,20,20
1746546240868,LTWL 181,A00,889406,Staff,17,0,25,8
1746546241893,LTWL 184,A00,889475,Mukherjee; Silpa,22,0,25,3
1746546242918,LTWR 102C,A00,889486,Staff,29,0,30,1
1746546243949,LTWR 115W,A00,889491,Staff,0,2,15,15
1746546244976,MAE 8,A01,886905,Staff,0,2,0,0
1746546246002,MAE 11,A00,886906,Bandaru; Prabhakar,0,7,50,50
1746546247026,MAE 20,A00,886907,Evdokimenko; Ekaterina,44,0,70,26
1746546248052,MAE 30B,A00,886909,Ghazinejad; Maziar,26,0,45,19
1746546249077,MAE 101B,A00,886910,Saintillan; David,29,0,45,16
1746546250110,MAE 105,A00,886911,Bandaru; Prabhakar,18,0,50,32
1746546251135,MAE 107,B00,958024,Staff,9,0,50,41
1746546252184,MAE 143B,A00,886913,Bewley; Thomas R,7,0,40,33
1746546253208,MAE 148,A01,886915,Silberman; Jack,0,3,14,14
1746546254235,MAE 160,A00,886916,Evdokimenko; Ekaterina,31,0,60,29
1746546255260,MATH 3C,A01,889681,Staff,0,3,30,30
1746546255260,MATH 3C,A02,960048,Staff,25,0,30,5
1746546256284,MATH 10A,A01,889760,Staff,26,0,30,4
1746546256284,MATH 10A,A02,889783,Staff,29,0,30,1
1746546257309,MATH 10B,A01,889785,Verstraete; Jacques Allan,2,0,35,33
1746546257309,MATH 10B,A02,889795,Verstraete; Jacques Allan,4,0,35,31
1746546257309,MATH 10B,B01,889797,Verstraete; Jacques Allan,3,0,35,32
1746546257309,MATH 10B,B02,889828,Verstraete; Jacques Allan,3,0,35,32
1746546258334,MATH 10C,A01,889849,Habib; Yousaf,9,0,30,21
1746546258334,MATH 10C,A02,889852,Habib; Yousaf,14,0,30,16
1746546258334,MATH 10C,A03,889853,Habib; Yousaf,22,0,30,8
1746546258334,MATH 10C,A04,889858,Habib; Yousaf,20,0,30,10
1746546258334,MATH 10C,B01,889861,Staff,1,0,30,29
1746546258334,MATH 10C,B02,889862,Staff,24,0,30,6
1746546258334,MATH 10C,B03,889863,Staff,27,0,30,3
1746546258334,MATH 10C,B04,889967,Staff,23,0,30,7
1746546259358,MATH 18,A01,889974,Staff,7,0,30,23
1746546259358,MATH 18,A02,889977,Staff,20,0,30,10
1746546259358,MATH 18,B01,889984,Hardiman; Liam,22,0,30,8
1746546259358,MATH 18,B02,889985,Hardiman; Liam,25,0,30,5
1746546260382,MATH 20A,A01,889990,Suk; Andrew Hoon,29,0,35,6
1746546261412,MATH 20B,A01,889993,Ohm; Ko Woon,22,0,30,8
1746546261412,MATH 20B,A02,889994,Ohm; Ko Woon,30,0,30,0
1746546261412,MATH 20B,B01,889996,Ohm; Ko Woon,21,0,30,9
1746546261412,MATH 20B,B02,889997,Ohm; Ko Woon,23,0,30,7
1746546262442,MATH 20C,A01,889999,Hammock; Frances H,17,0,30,13
1746546262442,MATH 20C,A02,890003,Hammock; Frances H,23,0,30,7
1746546262442,MATH 20C,B01,890006,Hammock; Frances H,3,0,30,27
1746546262442,MATH 20C,B02,890007,Hammock; Frances H,11,0,30,19
1746546263470,MATH 20D,A01,890011,Cheng; Hsiao-Bing,1,1,30,29
1746546263470,MATH 20D,A02,890012,Cheng; Hsiao-Bing,14,0,30,16
1746546263470,MATH 20D,B01,890016,Cheng; Hsiao-Bing,13,0,30,17
1746546263470,MATH 20D,B02,890017,Cheng; Hsiao-Bing,13,0,30,17
1746546264494,MATH 20E,A01,890026,Harel; Guershon,1,0,30,29
1746546264494,MATH 20E,A02,890029,Harel; Guershon,23,0,30,7
1746546264494,MATH 20E,B01,890033,Harel; Guershon,7,0,30,23
1746546264494,MATH 20E,B02,890101,Harel; Guershon,21,0,30,9
1746546265533,MATH 102,A01,890104,Staff,17,0,30,13
1746546265533,MATH 102,A02,890105,Staff,27,0,30,3
1746546266557,MATH 103B,A01,890116,Salehi Golsefidy; Alireza,3,0,30,27
1746546266557,MATH 103B,B01,890118,Staff,0,3,34,34
1746546267583,MATH 109,A01,890121,Aliabadi Sr.; Mohsen,1,0,30,29
1746546267583,MATH 109,B01,890124,Upadrashta; Pranav Kumar,18,0,30,12
1746546269223,MATH 120A,A01,890126,Eggers; John Dietrich,13,0,30,17
1746546270250,MATH 142B,A01,890128,Ioana; Adrian,19,0,30,11
1746546270250,MATH 142B,A02,890129,Ioana; Adrian,13,0,30,17
1746546271280,MATH 154,A01,890174,Staff,0,0,30,30
1746546271280,MATH 154,A02,890182,Staff,0,0,30,30
1746546272306,MATH 168A,A01,890197,Dumitriu; Ioana,21,0,35,14
1746546273331,MATH 170A,A01,890240,Nie; Jiawang,1,0,30,29
1746546273331,MATH 170A,A02,890241,Nie; Jiawang,11,0,30,19
1746546273331,MATH 170A,A03,890249,Nie; Jiawang,23,0,30,7
1746546274357,MATH 170B,A01,957891,Nag; Panchali,13,0,35,22
1746546276407,MATH 181A,A01,908025,Staff,0,4,35,35
1746546276407,MATH 181A,A02,960115,Staff,27,0,35,8
1746546277433,MATH 181B,A01,959874,Staff,26,0,30,4
1746546278458,MATH 193B,A01,890265,Staff,0,4,35,35
1746546279484,MGT 4,A01,890311,Anderson; John Charles,42,0,88,46
1746546280508,MGT 5,A00,907740,Staff,13,0,98,85
1746546281535,MGT 12,A00,890312,Lindenberger; Wade Douglas,67,0,98,31
1746546282562,MGT 16,A00,957883,Staff,78,0,98,20
1746546284612,MGT 45,A00,890314,Pecore; Joseph P.,47,0,98,51
1746546285639,MGT 71,A00,890315,Staff,0,11,98,98
1746546286667,MGT 100,A00,890316,Yavorsky; Daniel Ryan,44,0,98,54
1746546287691,MGT 103,A00,890317,Ehrich; Kristine R,73,0,98,25
1746546288719,MGT 105,A00,890356,Bates; Kenneth Walter,0,7,98,98
1746546289747,MGT 112,A00,890360,Ehrich; Kristine R,55,0,98,43
1746546290773,MGT 127R,A00,907732,Zhu; Kevin Xiaoguo,23,0,98,75
1746546291798,MGT 131B,A00,890361,Anderson; John Charles,61,0,98,37
1746546292822,MGT 137,A00,890362,Lindenberger; Wade Douglas,65,0,98,33
1746546293855,MGT 160,A00,890369,Johnson; Erik Barry,9,0,98,89
1746546295904,MGT 164,A00,890372,Zimmermann; Carsten,0,39,98,98
1746546296934,MGT 180,A00,890374,Bliss; Barbara Ann,12,0,98,86
1746546297961,MMW 15,A01,886414,Chang; Edmond Yi-Teh,0,12,28,28
1746546297961,MMW 15,A02,886415,Chang; Edmond Yi-Teh,0,8,28,28
1746546297961,MMW 15,A03,886416,Chang; Edmond Yi-Teh,0,8,28,28
1746546297961,MMW 15,A04,886417,Chang; Edmond Yi-Teh,0,8,28,28
1746546297961,MMW 15,B01,886419,Chang; Edmond Yi-Teh,0,7,28,28
1746546297961,MMW 15,B02,886420,Chang; Edmond Yi-Teh,0,8,28,28
1746546297961,MMW 15,B03,886421,Chang; Edmond Yi-Teh,0,7,28,28
1746546297961,MMW 15,B04,886422,Chang; Edmond Yi-Teh,0,8,28,28
1746546297961,MMW 15,C01,886424,Staff,0,9,28,28
1746546297961,MMW 15,C02,886425,Staff,0,8,28,28
1746546297961,MMW 15,C03,886426,Staff,0,8,28,28
1746546297961,MMW 15,C04,886427,Staff,0,7,28,28
1746546297961,MMW 15,C05,958038,Staff,0,7,28,28
1746546297961,MMW 15,C06,958039,Staff,0,8,28,28
1746546298986,MMW 15GS,A00,906910,Patterson; Patrick H.,4,0,28,24
1746546300013,MMW 122R,A01,886429,Rahimi; Babak,0,13,28,28
1746546300013,MMW 122R,A02,886430,Rahimi; Babak,0,12,28,28
1746546300013,MMW 122R,A03,958040,Rahimi; Babak,0,11,28,28
1746546301042,MUS 1A,A01,890937,Staff,3,0,25,22
1746546301042,MUS 1A,A02,891035,Staff,6,0,25,19
1746546301042,MUS 1A,C01,958912,Staff,24,0,25,1
1746546301042,MUS 1A,C02,958913,Staff,25,0,25,0
1746546303098,MUS 2AK,A00,957092,Ohnishi; Takae,15,0,15,0
1746546304125,MUS 4,A01,891044,Staff,2,0,25,23
1746546304125,MUS 4,A02,891045,Staff,23,0,25,2
1746546304125,MUS 4,B01,891048,Staff,17,0,25,8
1746546304125,MUS 4,B02,891050,Staff,25,0,25,0
1746546305151,MUS 5,A01,957506,Dubnov; Shlomo,0,0,25,25
1746546305151,MUS 5,A02,957622,Dubnov; Shlomo,14,0,25,11
1746546305151,MUS 5,A03,957623,Dubnov; Shlomo,20,0,25,5
1746546306181,MUS 6,A01,891053,Freitas Caetano; Marcelo,24,0,25,1
1746546306181,MUS 6,A02,891054,Freitas Caetano; Marcelo,23,0,25,2
1746546307209,MUS 7,A01,891081,Staff,0,0,25,25
1746546307209,MUS 7,A02,891082,Staff,4,0,25,21
1746546308232,MUS 8GS,A00,891118,Borgo; David Garcia,0,0,25,25
1746546309257,MUS 11,A01,891140,Staff,11,0,25,14
1746546309257,MUS 11,A02,891141,Staff,22,0,25,3
1746546310285,MUS 13,A01,891143,Staff,8,0,25,17
1746546310285,MUS 13,A02,891144,Staff,24,0,25,1
1746546311310,MUS 15,A01,891146,Staff,9,0,25,16
1746546311310,MUS 15,A02,891148,Staff,21,0,25,4
1746546311310,MUS 15,B01,891150,Staff,18,0,25,7
1746546311310,MUS 15,B02,891151,Staff,25,0,25,0
1746546312335,MUS 20,A01,891153,Staff,5,0,20,15
1746546312335,MUS 20,A02,891155,Staff,14,0,20,6
1746546313359,MUS 80,A00,891156,Staff,19,0,25,6
1746546313359,MUS 80,B00,891157,Staff,23,0,25,2
1746546314389,MUS 130,A00,891158,Ohnishi; Takae,35,0,35,0
1746546315416,MUS 150GS,A01,891160,Borgo; David Garcia,0,0,25,25
1746546316442,MUS 170,A01,891162,Freitas Caetano; Marcelo,20,0,25,5
1746546316442,MUS 170,A02,891164,Freitas Caetano; Marcelo,21,0,25,4
1746546317472,NANO 11,A00,886220,Vazquez Mena; Oscar,13,0,15,2
1746546318500,NANO 15,A01,886222,Drews; Aaron,4,0,7,3
1746546319524,NANO 104,A00,886224,Sirbuly; Donald,18,0,25,7
1746546320553,PH 40,A00,886528,Staff,23,0,40,17
1746546321578,PH 45,A01,886799,Staff,35,0,40,5
1746546322605,PH 110,A00,886802,Staff,0,7,40,40
1746546323630,PH 172,A00,906716,Staff,19,0,35,16
1746546324654,PH 191,A00,886803,Staff,6,0,40,34
1746546325682,PHIL 1,A00,889500,Staff,19,0,30,11
1746546326711,PHIL 10,A01,889549,Grush; Rick Scott,15,0,22,7
1746546326711,PHIL 10,A02,889551,Grush; Rick Scott,22,0,22,0
1746546327741,PHIL 28,A01,889559,Lamey; Andy M.,0,1,31,31
1746546327741,PHIL 28,A02,889561,Lamey; Andy M.,0,1,30,30
1746546327741,PHIL 28,A03,889572,Lamey; Andy M.,0,0,30,30
1746546328767,PHIL 35,A00,907839,Staff,13,0,15,2
1746546329793,PHIL 60,A00,889574,Staff,74,0,90,16
1746546330821,PHIL 101,A00,958004,Staff,13,0,15,2
1746546332871,PHIL 136,A00,889582,Fulkerson; Matthew Todd,26,0,45,19
1746546333898,PHIL 163,A01,889601,Staff,21,0,30,9
1746546333898,PHIL 163,B01,889606,Brandt; Reuven A,0,3,0,0
1746546334927,PHIL 164,A00,889610,Staff,16,0,30,14
1746546335954,PHIL 165,A00,889613,Staff,23,0,30,7
1746546336980,PHYS 1A,A00,886431,Staff,26,0,70,44
1746546338006,PHYS 1AL,001,886432,Tsai; Philbert S,0,2,30,30
1746546338006,PHYS 1AL,002,886436,Tsai; Philbert S,11,0,30,19
1746546339030,PHYS 1B,A00,886439,Staff,185,0,240,55
1746546340056,PHYS 1BL,001,886441,Tsai; Philbert S,0,4,30,30
1746546340056,PHYS 1BL,002,886444,Tsai; Philbert S,2,0,30,28
1746546341085,PHYS 1C,A00,896092,Arnold; Kam S,78,0,146,68
1746546342112,PHYS 1CL,001,886448,Tsai; Philbert S,0,0,30,30
1746546342112,PHYS 1CL,002,886449,Tsai; Philbert S,0,0,30,30
1746546342112,PHYS 1CL,003,886450,Tsai; Philbert S,16,0,30,14
1746546342112,PHYS 1CL,004,886451,Tsai; Philbert S,15,0,30,15
1746546343141,PHYS 2B,A01,886457,Staff,69,0,115,46
1746546344165,PHYS 2C,A01,886460,Shotwell; Brian,0,8,65,65
1746546345190,PHYS 2CL,A01,886467,Staff,0,4,28,28
1746546345190,PHYS 2CL,A02,886468,Staff,0,3,28,28
1746546346218,PHYS 2D,A01,886470,Staff,10,0,50,40
1746546347242,PHYS 4B,A01,886475,Grinstein; Benjamin,22,0,40,18
1746546348269,POLI 5,A00,891173,Desposato; Scott,7,0,25,18
1746546349293,POLI 5D,A01,891175,Staff,5,0,5,0
1746546349293,POLI 5D,B01,891178,Staff,5,0,5,0
1746546350322,POLI 11,A00,891179,Ferree; Karen E,2,0,35,33
1746546351347,POLI 12,A00,891180,Staff,16,0,30,14
1746546352382,POLI 27,A01,891182,Staff,12,0,75,63
1746546353409,POLI 30,A00,891183,Staff,8,0,50,42
1746546354436,POLI 100B,A00,891244,Staff,5,1,35,30
1746546355463,POLI 100I,A00,891247,Staff,7,0,30,23
1746546356489,POLI 104J,A00,891248,Nichter; Maysa,14,0,30,16
1746546357514,POLI 104U,A00,891250,Nichter; Maysa,2,0,30,28
1746546359572,POLI 110B,A00,891255,Wiens; David,20,0,25,5
1746546360599,POLI 112A,A00,891256,Wiens; David,6,0,25,19
1746546361627,POLI 114BR,A00,891261,Staff,19,0,30,11
1746546362652,POLI 117R,A00,891262,Forman; Fonna,0,6,50,50
1746546363677,POLI 118,A00,891264,Ingham; Sean,17,0,25,8
1746546364701,POLI 124A,A00,891265,Staff,18,0,20,2
1746546365728,POLI 125D,A00,891266,Nichter; Simeon C,2,0,25,23
1746546366756,POLI 126,A00,891268,Nichter; Simeon C,7,0,25,18
1746546367784,POLI 126AA,A00,891272,Staff,18,0,25,7
1746546368810,POLI 130AA,A00,891273,Staff,15,0,20,5
1746546369836,POLI 134AA,A00,891274,Staff,4,0,20,16
1746546371885,POLI 138,A00,891278,Staff,21,0,25,4
1746546372909,POLI 142K,A00,891280,Staff,11,0,25,14
1746546373933,POLI 142M,A00,891281,Gartzke; Erik,17,0,30,13
1746546374959,POLI 142P,A00,891284,Staff,20,0,30,10
1746546375987,POLI 143,A00,891285,Gartzke; Erik,12,0,30,18
1746546377014,POLI 153,A00,891286,Staff,19,0,20,1
1746546379069,POLI 175,A00,891290,Staff,15,0,20,5
1746546380096,PSYC 1,A00,890674,Steiner; Eric Tomas,0,11,45,45
1746546381121,PSYC 2,A00,890676,Albright; Thomas D,21,0,35,14
1746546382149,PSYC 3,A00,890679,Staff,17,0,20,3
1746546383176,PSYC 6,A00,959858,Staff,20,0,20,0
1746546384201,PSYC 60,A01,890684,Rickard; Timothy C.,0,5,45,45
1746546385226,PSYC 70,A01,890689,Geller; Emma Harlan,7,0,30,23
1746546386250,PSYC 71,A01,959860,Staff,21,0,25,4
1746546387276,PSYC 100,A00,890690,Lacefield; Katharine I,0,50,180,180
1746546388302,PSYC 102,A00,890695,Staff,18,0,40,22
1746546389328,PSYC 105,A00,890699,Geller; Emma Harlan,71,0,100,29
1746546390353,PSYC 106,A00,890701,Gorman; Michael R.,5,0,30,25
1746546391378,PSYC 108,A00,890704,Adrian; Julia Anna,0,28,50,50
1746546392414,PSYC 118,A01,890712,Staff,11,0,30,19
1746546393439,PSYC 124,A00,890716,Chapman; Eddie Nathaniel,25,0,60,35
1746546394463,PSYC 131,A00,890717,Anagnostaras; Stephan,0,7,80,80
1746546395491,PSYC 137,A00,890719,Winkielman; Piotr,0,11,30,30
1746546396516,PSYC 144,A00,890721,Adrian; Julia Anna,0,9,45,45
1746546397541,PSYC 162,A00,890805,Staff,2,0,75,73
1746546398566,PSYC 169,A00,890810,Staff,0,15,30,30
1746546399591,PSYC 172,A00,890814,Gorman; Michael R.,9,0,30,21
1746546400617,PSYC 181,A00,890818,Anagnostaras; Stephan,8,0,200,192
1746546401644,PSYC 184,A00,959861,Staff,170,0,175,5
1746546402671,PSYC 189,A00,890823,Staff,0,1,30,30
1746546403697,PSYC 191,A00,890884,Rickard; Timothy C.,0,11,35,35
1746546404722,PSYC 193,A00,890913,Staff,19,0,30,11
1746546404722,PSYC 193,B00,890914,Chapman; Eddie Nathaniel,24,0,30,6
1746546405751,PSYC 193L,A01,890918,Lowe; Angela Beth,20,0,30,10
1746546405751,PSYC 193L,B01,890921,Hurwitz; Ethan Scott,20,0,30,10
1746546405751,PSYC 193L,C01,890928,Staff,30,0,30,0
1746546406780,RELI 149,A00,886806,Rahimi; Babak,23,0,40,17
1746546407805,SE 9,A01,886814,Staff,7,0,20,13
1746546408830,SE 101B,A01,886816,Chadha; Mayank,4,0,35,31
1746546409856,SE 110B,A00,886818,Zhu; Qiang,4,0,75,71
1746546410885,SE 125,A01,886830,Staff,10,0,30,20
1746546411910,SE 130B,A01,886835,Staff,14,0,40,26
1746546412940,SE 131A,A01,886838,Krysl; Petr,34,0,55,21
1746546413966,SE 154,A00,886840,Staff,30,0,50,20
1746546414991,SE 164GS,A01,886849,Staff,6,0,20,14
1746546416018,SE 167GS,A01,886853,Staff,6,0,20,14
1746546417045,SIO 25,A01,890107,Staff,19,0,30,11
1746546418070,SIO 45,A00,890109,Cook; Geoffrey W,117,0,200,83
1746546419097,SIO 109R,A00,890110,Forman; Fonna,0,16,20,20
1746546420161,SIO 187,A01,890114,Kacev; David,15,0,40,25
1746546421187,SOCI 1,A01,890431,Thorpe; Charles Robert,15,0,30,15
1746546421187,SOCI 1,A02,890518,Thorpe; Charles Robert,30,0,30,0
1746546422257,SOCI 2,A01,957978,Staff,25,0,25,0
1746546422257,SOCI 2,A02,957979,Staff,23,0,25,2
1746546423285,SOCI 20,A01,890523,Calderon-Zaks; Michael Aar,23,0,30,7
1746546423285,SOCI 20,A02,890526,Calderon-Zaks; Michael Aar,29,0,30,1
1746546424309,SOCI 30,A01,890533,Pardo Guerra; Juan Pablo,37,0,40,3
1746546425339,SOCI 40,A01,890535,Staff,27,0,45,18
1746546426366,SOCI 104Q,A00,890559,Staff,18,0,30,12
1746546427394,SOCI 106,A00,890560,Arnal; Maud Marie Leonie,20,0,30,10
1746546428421,SOCI 110,A00,890567,Holkenbrink-Monk; Charlene,19,0,30,11
1746546429446,SOCI 112,A00,890568,Victoria Torres; Pablo,1,0,55,54
1746546430471,SOCI 115,A00,890597,Arnal; Maud Marie Leonie,28,0,45,17
1746546432526,SOCI 121,A00,890604,Pardo Guerra; Juan Pablo,38,0,45,7
1746546433550,SOCI 126,A01,890608,Staff,8,0,10,2
1746546434576,SOCI 127,A00,890609,Staff,18,0,30,12
1746546435602,SOCI 131,A00,890610,Thorpe; Charles Robert,37,0,45,8
1746546436628,SOCI 135,A00,890615,Payne; Christine Anna,14,0,45,31
1746546437652,SOCI 139,A00,890620,Staff,38,0,45,7
1746546438676,SOCI 148E,A00,890622,Calderon-Zaks; Michael Aar,36,0,45,9
1746546439701,SOCI 150,A00,890623,Kohler; Kristopher M.,31,0,45,14
1746546440725,SOCI 157,A00,890625,Jules-Rosette; Bennetta W.,18,0,20,2
1746546441752,SOCI 160,A00,890627,Payne; Christine Anna,21,0,45,24
1746546442778,SYN 1,A00,886855,Fish; Gwendolyn Anne,0,0,0,0
1746546442778,SYN 1,B00,906086,Fish; Gwendolyn Anne,0,1,0,2
1746546443803,SYN 2R,A00,886860,Staff,0,17,15,15
1746546443803,SYN 2R,B00,906106,Atkinson; Arthur Laird,0,16,15,15
1746546444835,SYN 100,A01,886866,Browne; Emily,0,28,20,20
1746546444835,SYN 100,B01,906128,Rock; Martin,0,5,20,20
1746546444835,SYN 100,C01,906140,Deavenport; James Cary,0,3,20,20
1746546444835,SYN 100,D01,907816,Deavenport; James Cary,0,5,20,20
1746546445862,TDAC 1,A00,890286,Walsh; Kim C.,9,0,20,11
1746546446889,TDAC 101,A00,890296,Basso; Beatrice,16,0,20,4
1746546447913,TDDE 131,A00,890297,Staff,47,0,50,3
1746546448938,TDDM 1,A00,890287,Weinberg; Sadie,25,0,30,5
1746546449966,TDGE 11,A00,890288,Fulton; Julia,137,0,200,63
1746546449966,TDGE 11,B00,890289,Castro; Robert Jess,184,0,200,16
1746546450991,TDGE 25,B00,957359,Walsh; Kim C.,3,0,20,17
1746546452015,TDGE 40,A01,890292,Power; Jade Yukana,27,0,30,3
1746546453043,TDGE 124,A00,890298,Havis; Allan,0,0,50,50
1746546454068,TDGE 131R,A00,890299,Burelle; Julie Sara Veronique,15,0,42,27
1746546455092,TDHT 101,A00,890300,Staff,10,0,20,10
1746546456117,TDHT 109,A01,890302,Anderson; Mysia Anyse,31,0,40,9
1746546457145,TDMV 1,A00,890293,Arcidiacono; Kristin,18,0,30,12
1746546458170,TDMV 2,A00,890294,Weinberg; Sadie,23,0,30,7
1746546459197,TDMV 3,A00,957878,Arcidiacono; Kristin,28,0,30,2
1746546461252,TDMV 138,A00,890304,Jun; Grace Shin Hae,25,0,40,15
1746546462278,TDMV 140,A00,890305,Corrales; Joseph Bernales,25,0,30,5
1746546463303,TDMV 142,A00,890307,Caligagan; Tony,32,0,40,8
1746546464328,TDMV 144,A00,890308,Camaya; Michelle Ann,25,0,30,5
1746546465354,TDPW 1,A00,890295,Stein; Deborah Isobel,3,0,20,17
1746546466381,USP 2,A01,890272,Lerner; Amy M,6,0,20,14
1746546467407,USP 3,A01,890274,Staff,12,0,30,18
1746546468434,USP 15,A01,890276,Sun; Feiyang,17,0,30,13
1746546469457,USP 25,A00,890277,Shenkman; Michael Thomas,19,0,25,6
1746546470484,USP 138,A00,890278,Staff,13,0,25,12
1746546471510,USP 143,A00,890279,Staff,21,0,70,49
1746546472538,USP 144,A00,890280,Chowdhury; Muhammed Zohir,16,0,30,14
1746546473562,USP 150,A00,890281,Boomhower; Matthew Charles,4,0,30,26
1746546474588,USP 151,A00,890282,Staff,16,0,20,4
1746546475612,USP 162,A00,890283,Andrews; Abigail Leslie,16,0,20,4
1746546476639,USP 168,A00,920477,Kwak; Nancy,1,0,5,4
1746546477664,USP 181,A00,890284,Staff,3,0,20,17
1746546478690,USP 191A,A00,890285,Staff,13,0,20,7
1746546479717,VIS 101,A00,886512,Staff,25,0,75,50
1746546480744,VIS 103,A00,886513,Cruz; Edwin Teddy,61,0,75,14
1746546481773,VIS 108,A00,886514,Staff,3,0,15,12
1746546482803,VIS 127P,A00,886515,Shen; Kuiyi,80,0,146,66
1746546483831,VIS 149,A00,886516,Yoldas; Pinar,0,0,15,15
1746546484861,VIS 164,A00,886526,Erdmann; Dean,19,0,22,3
1746546485886,VIS 194S,A00,886527,Staff,61,0,75,14
1746546486913,WCWP 10A,C00,886484,Martiniuk; Jill,12,0,15,3
1746546487941,WCWP 10B,A00,886490,Uriarte; Emma,0,0,15,15
1746546487941,WCWP 10B,B00,886491,Dhir; Simrita,11,0,15,4
1746546487941,WCWP 10B,C00,886492,Ornelas; Tricia,0,0,15,15
1746546488980,WCWP 100,A00,886494,Young; Mark T,0,7,15,15
1746546491172,AAS 10,A01,886199,Childs; Dennis R.,0,3,0,0
1746546492201,ANAR 104,A01,886940,Shtienberg; Gilad,27,0,30,3
1746546493228,ANAR 120,A00,886953,Staff,12,0,20,8
1746546494251,ANBI 148,A01,886955,Wilder; Linnea Lorene,30,0,40,10
1746546496297,ANSC 122,A00,886957,Staff,25,0,30,5
1746546497324,ANSC 150,A00,886958,Sloane; Julia Kathryn,3,0,15,12
1746546498350,ANSC 156,A00,886959,Jenkins; Janis A.,0,1,15,15
1746546499379,ANSC 180,A00,886960,Staff,11,0,17,6
1746546500405,ANSC 188,A00,886961,Jassal; Aftab,9,0,25,16
1746546501430,ANSC 190,A00,886962,Jassal; Aftab,14,0,25,11
1746546502463,ANSC 191,A00,886963,Staff,18,0,20,2
1746546503489,ANTH 3,A01,891689,Staff,17,0,20,3
1746546504513,ANTH 5,A00,886933,Semendeferi; Ekaterini,16,0,20,4
1746546505540,ANTH 10,A00,886934,Staff,0,12,30,30
1746546506569,ANTH 21,A01,886936,Staff,40,0,60,20
1746546507596,ANTH 23,A01,886938,Staff,92,0,100,8
1746546508621,ANTH 105,A00,886964,Stewart; Alexander B,84,0,100,16
1746546509651,ANTH 108,A00,886965,Pedersen; David,9,0,20,11
1746546510686,AWP 10,001,886147,Staff,0,0,0,0
1746546510686,AWP 10,002,886148,Staff,0,0,0,0
1746546510686,AWP 10,003,886149,Staff,0,0,0,0
1746546510686,AWP 10,004,886150,Staff,0,0,0,0
1746546510686,AWP 10,005,886151,Staff,0,0,0,0
1746546510686,AWP 10,006,886152,Staff,0,0,0,0
1746546510686,AWP 10,007,886153,Staff,0,0,0,0
1746546510686,AWP 10,008,886154,Staff,0,0,0,0
1746546510686,AWP 10,009,886155,Staff,0,0,0,0
1746546510686,AWP 10,010,886156,Staff,0,0,0,0
1746546510686,AWP 10,011,886158,Staff,0,0,0,0
1746546510686,AWP 10,012,886160,Staff,0,0,0,0
1746546510686,AWP 10,013,886161,Staff,0,0,0,0
1746546510686,AWP 10,014,886162,Staff,0,0,0,0
1746546510686,AWP 10,015,886163,Staff,0,0,0,0
1746546510686,AWP 10,016,886164,Staff,0,0,0,0
1746546510686,AWP 10,017,886165,Staff,0,0,0,0
1746546510686,AWP 10,018,886166,Staff,0,0,0,0
1746546510686,AWP 10,019,886168,Staff,0,0,0,0
1746546510686,AWP 10,020,886170,Staff,0,0,0,0
1746546510686,AWP 10,021,886172,Staff,0,0,0,0
1746546511715,AWP 10R,001,886173,Staff,0,1,0,0
1746546511715,AWP 10R,002,886174,Staff,0,1,0,0
1746546511715,AWP 10R,003,886175,Staff,0,0,0,0
1746546511715,AWP 10R,004,886176,Staff,0,0,0,0
1746546511715,AWP 10R,005,886177,Staff,0,0,0,0
1746546511715,AWP 10R,006,886178,Staff,0,0,0,0
1746546511715,AWP 10R,007,886179,Staff,0,0,0,0
1746546511715,AWP 10R,008,886181,Staff,0,0,0,0
1746546511715,AWP 10R,009,886182,Staff,0,0,0,0
1746546511715,AWP 10R,010,886183,Staff,0,0,0,0
1746546511715,AWP 10R,011,886184,Staff,0,0,0,0
1746546511715,AWP 10R,012,886185,Staff,0,0,0,0
1746546511715,AWP 10R,013,886186,Staff,0,0,0,0
1746546511715,AWP 10R,014,886187,Staff,0,0,0,0
1746546511715,AWP 10R,015,886188,Staff,0,0,0,0
1746546511715,AWP 10R,016,886189,Staff,0,0,0,0
1746546512739,AWP 102R,A00,886190,Staff,0,0,0,0
1746546512739,AWP 102R,B00,886191,Staff,0,0,0,0
1746546513768,BENG 100,A01,886193,Staff,17,0,30,13
1746546514793,BENG 122A,A01,886195,Hasty; Jeff M,13,0,30,17
1746546515818,BENG 166A,A00,886196,Sah; Robert Lie-Yuan,0,1,30,30
1746546516841,BENG 190,A00,958050,Khojah; Reem I,24,0,25,1
1746546517868,BIBC 102,A01,894320,Staff,0,0,46,46
1746546517868,BIBC 102,A02,894321,Staff,0,0,46,46
1746546517868,BIBC 102,A03,894344,Staff,7,0,46,39
1746546517868,BIBC 102,A04,894345,Staff,26,0,47,21
1746546518893,BICD 100R,A01,894365,Smith; Laurie,0,3,58,58
1746546518893,BICD 100R,A02,894366,Smith; Laurie,0,5,58,58
1746546518893,BICD 100R,A03,894367,Smith; Laurie,2,0,59,57
1746546518893,BICD 100R,A04,959869,Smith; Laurie,41,0,59,18
1746546519918,BICD 136,A01,894383,Gustafson-Brown; Cindy,14,0,50,36
1746546520947,BIEB 102,A01,894494,Butler; Shannon Rhey,51,0,130,79
1746546522998,BIEB 150,A01,894617,Wills; Christopher,3,0,20,17
1746546522998,BIEB 150,A02,894631,Wills; Christopher,3,0,20,17
1746546522998,BIEB 150,A03,894937,Wills; Christopher,3,0,20,17
1746546522998,BIEB 150,A04,894946,Wills; Christopher,5,0,20,15
1746546524023,BIEB 194,A00,906141,Kurle; Carolyn M.,6,0,20,14
1746546525051,BILD 1,A01,894154,Staff,2,0,19,17
1746546525051,BILD 1,A02,894155,Staff,14,0,19,5
1746546525051,BILD 1,A03,894160,Staff,13,0,19,6
1746546525051,BILD 1,A04,894161,Staff,15,0,18,3
1746546526077,BILD 2,A01,894168,Staff,0,0,50,50
1746546526077,BILD 2,A02,894169,Staff,0,0,50,50
1746546526077,BILD 2,A03,894179,Staff,4,0,50,46
1746546526077,BILD 2,A04,894203,Staff,27,0,50,23
1746546527103,BILD 3,A01,894213,Staff,22,0,31,9
1746546527103,BILD 3,A02,894214,Staff,26,0,31,5
1746546527103,BILD 3,A03,894235,Staff,28,0,31,3
1746546527103,BILD 3,A04,894236,Staff,28,0,32,4
1746546528129,BILD 4,A01,894253,Reuther; Keefe,5,0,24,19
1746546528129,BILD 4,A02,894258,Reuther; Keefe,16,0,24,8
1746546529155,BILD 5,A01,894276,Reuther; Keefe,35,0,50,15
1746546529155,BILD 5,A02,894277,Reuther; Keefe,45,0,50,5
1746546529155,BILD 5,A03,894290,Reuther; Keefe,44,0,50,6
1746546529155,BILD 5,A04,894291,Reuther; Keefe,48,0,50,2
1746546530184,BILD 24,A01,894297,Pirino; Giorgia,40,0,60,20
1746546531211,BIMM 100,B01,958915,Staff,72,0,100,28
1746546532237,BIMM 101,A01,895017,McDonnell; Lisa Marie,0,5,24,24
1746546532237,BIMM 101,A02,895018,McDonnell; Lisa Marie,0,5,24,24
1746546532237,BIMM 101,B01,895020,McDonnell; Lisa Marie,0,6,24,24
1746546532237,BIMM 101,B02,895021,McDonnell; Lisa Marie,0,4,24,24
1746546533267,BIMM 110,A01,895023,Staff,1,0,25,24
1746546533267,BIMM 110,A02,895024,Staff,9,0,25,16
1746546533267,BIMM 110,A03,895025,Staff,18,0,25,7
1746546533267,BIMM 110,A04,895031,Staff,20,0,25,5
1746546534296,BIMM 120,A01,895114,Gustafson-Brown; Cindy,13,0,28,15
1746546534296,BIMM 120,A02,895126,Gustafson-Brown; Cindy,21,0,27,6
1746546535322,BIPN 100,A01,895130,Yang; Mingyu,1,0,38,37
1746546535322,BIPN 100,A02,895131,Yang; Mingyu,32,0,38,6
1746546535322,BIPN 100,A03,895132,Yang; Mingyu,32,0,38,6
1746546535322,BIPN 100,A04,895133,Yang; Mingyu,27,0,36,9
1746546536353,BIPN 120,A01,895135,Cooke; James Edward,0,3,13,13
1746546536353,BIPN 120,A02,895136,Cooke; James Edward,0,1,13,13
1746546536353,BIPN 120,A03,895137,Cooke; James Edward,0,3,13,13
1746546536353,BIPN 120,A04,895156,Cooke; James Edward,0,2,11,11
1746546537381,BIPN 134,A01,895235,Cooke; James Edward,0,2,25,25
1746546537381,BIPN 134,A02,895237,Cooke; James Edward,0,0,25,25
1746546537381,BIPN 134,A03,895240,Cooke; James Edward,3,0,25,22
1746546537381,BIPN 134,A04,895270,Cooke; James Edward,20,0,25,5
1746546538406,BIPN 189,A00,892103,Staff,0,13,14,14
1746546540460,BISP 194,A00,958008,Staff,0,2,0,0
1746546541486,CAT 124,A01,922009,Staff,0,5,20,20
1746546542515,CAT 125R,A00,886390,Morales; Celeste Georgianna,0,2,20,20
1746546542515,CAT 125R,B00,886391,Irwin; Matthew Joseph,0,3,20,20
1746546542515,CAT 125R,C00,886392,Smith; Lauryn Alissa,0,2,20,20
1746546542515,CAT 125R,D00,886393,Vanderschuit; Maya Alysia,0,2,20,20
1746546542515,CAT 125R,E00,886394,Marchisotto; Jennifer Anne,0,4,20,20
1746546543540,CENG 15,A01,886218,Drews; Aaron,3,0,8,5
1746546544564,CENG 113,A00,886219,Opatkiewicz; Justin Paul,15,0,25,10
1746546545590,CGS 101,A00,887044,Staff,7,0,20,13
1746546546617,CGS 105,A01,887046,Staff,14,0,25,11
1746546547643,CGS 112,A00,887047,Cuong; Marisol,12,0,15,3
1746546548672,CGS 113,A00,887048,Staff,23,0,30,7
1746546549701,CGS 120,A00,887049,Staff,10,0,17,7
1746546550729,CHEM 6A,A01,886336,Lam; Tin Yiu,38,0,50,12
1746546550729,CHEM 6A,A02,886338,Lam; Tin Yiu,37,0,50,13
1746546551753,CHEM 6B,A01,886341,Hopkins; Patrycja Anna,16,0,50,34
1746546551753,CHEM 6B,A02,886343,Hopkins; Patrycja Anna,42,0,50,8
1746546552782,CHEM 6C,A01,886346,Albizati; Kim F.,0,2,50,50
1746546552782,CHEM 6C,A02,886348,Albizati; Kim F.,23,0,50,27
1746546553807,CHEM 40A,A01,886352,Klosterman; Jeremy K,65,0,100,35
1746546554835,CHEM 40B,A01,886356,Klosterman; Jeremy K,0,23,100,100
1746546555859,CHEM 41B,A01,886360,Theodorakis; Emmanuel,25,0,50,25
1746546555859,CHEM 41B,A02,886362,Theodorakis; Emmanuel,47,0,50,3
1746546556884,CHIN 165A,A00,886382,Xu; Li,18,0,20,2
1746546557912,CLAS 120,A00,886387,Myerston Santana; Jacobo,33,0,40,7
1746546558998,COGS 9,A01,886967,Shannon; Kyle Michael,42,0,60,18
1746546560030,COGS 11,A01,886969,Staff,11,0,30,19
1746546561056,COGS 14A,A01,886971,Staff,6,0,60,54
1746546562086,COGS 14B,A01,886973,Hoffman; Drew Ellen,4,0,60,56
1746546563116,COGS 18,A01,886975,Morgan; Eric,35,0,60,25
1746546564142,COGS 20,A01,886977,Staff,4,0,8,4
1746546564142,COGS 20,A02,886978,Staff,5,0,7,2
1746546565166,COGS 100,A01,907783,Staff,0,2,30,30
1746546566192,COGS 101B,A01,886980,Staff,0,3,48,48
1746546567220,COGS 101C,A01,886982,Delgado; Tania,0,5,44,44
1746546568247,COGS 102A,A01,886984,Johnson; Christine M.,4,0,30,26
1746546569275,COGS 118B,A01,886986,Staff,0,3,88,88
1746546570303,COGS 150,A01,886988,Bergen; Benjamin,23,0,50,27
1746546571327,COGS 153,A00,886989,Delgado; Tania,0,2,41,41
1746546572354,COGS 186,A01,886991,Staff,0,0,32,32
1746546573380,COGS 187A,A01,886993,Boyle; Mary E. T.,7,0,30,23
1746546574407,COGS 189,A00,886994,Staff,0,1,30,30
1746546575433,COMM 10,A01,886996,Staff,0,0,20,21
1746546575433,COMM 10,A02,886997,Staff,12,0,20,8
1746546575433,COMM 10,A03,959845,Staff,19,0,20,1
1746546576458,COMM 20,A01,886999,Leuning; Grant Maurstad,24,0,40,16
1746546578511,COMM 100A,A01,887002,Staff,0,0,20,25
1746546578511,COMM 100A,A02,887003,Staff,7,0,20,13
1746546579537,COMM 100B,A01,887005,Staff,0,8,20,24
1746546580562,COMM 106D,A00,887006,Staff,14,0,40,26
1746546581586,COMM 110G,A00,887007,Whitworth-Smith; Andrew C,12,0,40,28
1746546582619,COMM 111B,A00,887008,Staff,31,0,40,9
1746546583645,COMM 113T,A00,887009,Abuelhiga; Soraya Jill,28,0,40,12
1746546583645,COMM 113T,B00,906733,Staff,40,0,40,0
1746546584670,COMM 145,A00,887010,Staff,12,0,40,28
1746546585697,COMM 146,A00,887054,Staff,31,0,40,9
1746546586722,COMM 190,A00,887012,Staff,8,0,23,15
1746546587748,CSE 8A,A50,887015,Cao; Yingjun,57,0,85,28
1746546588775,CSE 11,A01,887017,Cao; Yingjun,12,0,70,58
1746546589802,CSE 20,A01,887019,Staff,30,0,50,20
1746546590831,CSE 21,A01,887021,Staff,78,0,100,22
1746546590831,CSE 21,B01,892583,Braun; Oliver,45,0,50,5
1746546591858,CSE 30,A01,887025,Eldon; John,143,0,200,57
1746546592884,CSE 100,A01,887027,Staff,26,0,50,24
1746546592884,CSE 100,A02,887028,Staff,40,0,50,10
1746546593913,CSE 101,A01,887030,Braun; Oliver,75,0,100,25
1746546593913,CSE 101,B01,887032,Jones; Miles E,0,3,50,50
1746546593913,CSE 101,B02,887033,Jones; Miles E,0,1,50,50
1746546594938,CSE 105,A01,908084,Jones; Miles E,32,0,50,18
1746546594938,CSE 105,A02,908087,Jones; Miles E,33,0,50,17
1746546595965,CSE 135,A01,887035,Powell; Thomas Allan,0,4,50,50
1746546596992,CSE 142,A01,887037,Staff,8,0,60,52
1746546598018,CSE 142L,A01,887039,Staff,34,0,60,26
1746546599047,CSE 151A,A01,887041,Solares; Edwin A,48,0,100,52
1746546600073,CSE 175,A01,887043,Kumar; Rakesh,30,0,30,0
1746546601096,CSS 1,A01,886389,Staff,0,1,40,40
1746546602121,DSC 30,A01,908097,Liao; Soohyun Nam,47,0,75,28
1746546603150,DSC 40A,A01,908099,Shannon; Kyle Michael,30,0,50,20
1746546604233,DSC 40B,A01,908112,Staff,16,0,50,34
1746546605259,DSC 80,A01,908116,Staff,19,0,60,41
1746546606285,DSC 197,001,956863,Eldridge; Justin Matthew,9999,0,9999,0
1746546607314,ECE 5,A01,886400,Morris; Karcher William,2,0,6,4
1746546607314,ECE 5,A02,886401,Morris; Karcher William,3,0,6,3
1746546608339,ECE 148,A01,886403,Silberman; Jack,0,14,14,14
1746546609365,ECON 1,A01,887265,Crane; Meredith Helen,12,0,70,58
1746546609365,ECON 1,B01,887268,Staff,43,0,50,7
1746546610391,ECON 2,A01,887273,Crane; Meredith Helen,56,0,70,14
1746546611416,ECON 3,A01,887279,Rondina; Giacomo,32,0,70,38
1746546612441,ECON 4,A01,887282,Anderson; John Charles,0,2,10,10
1746546613468,ECON 5,A01,887285,Staff,33,0,45,12
1746546613468,ECON 5,B01,887292,Staff,41,0,45,4
1746546614497,ECON 100A,A01,887337,Newhouse; Herbert S,54,0,70,16
1746546614497,ECON 100A,B01,887349,Staff,45,0,50,5
1746546615527,ECON 100B,A01,887361,Du; Songzi,29,0,70,41
1746546616551,ECON 100C,A01,887445,Newhouse; Herbert S,59,0,70,11
1746546617578,ECON 105,A00,887488,Vespa; Emanuel Ignacio,23,0,35,12
1746546618606,ECON 109,A01,887506,Shishkin; Denis,28,0,35,7
1746546619630,ECON 110A,A01,887568,Alon; Titan Michael,0,3,35,35
1746546619630,ECON 110A,B01,907601,Alon; Titan Michael,20,0,35,15
1746546620655,ECON 110B,A01,887598,Levkoff; Steven B.,0,23,70,70
1746546621681,ECON 112,A00,887599,Rondina; Giacomo,19,0,35,16
1746546622709,ECON 120A,A01,887603,Dai; Yinlin,36,0,70,34
1746546623735,ECON 120C,A01,887608,Sun; Yixiao,0,1,35,35
1746546623735,ECON 120C,B01,887614,Sun; Yixiao,0,0,35,35
1746546624761,ECON 138,A00,887621,Bharadwaj; Prashant,0,20,20,20
1746546625785,ECON 144,A00,958007,Squires; Dale E,13,0,35,22
1746546626811,ECON 171,A01,907666,Staff,18,0,35,17
1746546627835,ECON 175,A00,887626,Wu; Pak Yeung,23,0,35,12
1746546628863,ECON 190,A00,887640,Vespa; Emanuel Ignacio,23,0,35,12
1746546629896,EDS 25,A01,888197,Staff,0,0,0,0
1746546629896,EDS 25,A02,888209,Staff,0,0,0,0
1746546629896,EDS 25,A03,888210,Staff,0,0,0,0
1746546629896,EDS 25,A04,888212,Staff,0,0,0,0
1746546629896,EDS 25,A05,888213,Staff,0,0,0,0
1746546629896,EDS 25,A06,888214,Staff,0,0,0,0
1746546629896,EDS 25,A07,888235,Staff,0,2,0,0
1746546629896,EDS 25,A08,888236,Staff,0,0,0,0
1746546629896,EDS 25,A09,888240,Staff,0,0,0,0
1746546629896,EDS 25,A10,888244,Staff,0,0,0,0
1746546629896,EDS 25,B01,888273,Staff,0,0,0,0
1746546629896,EDS 25,B02,888285,Staff,0,0,0,0
1746546629896,EDS 25,B03,888423,Staff,0,0,0,1
1746546629896,EDS 25,B04,888432,Staff,0,0,0,0
1746546629896,EDS 25,B05,888433,Staff,0,0,0,0
1746546629896,EDS 25,B06,888467,Staff,0,0,0,0
1746546629896,EDS 25,B07,888468,Staff,0,0,0,0
1746546629896,EDS 25,B08,888479,Staff,0,0,0,0
1746546629896,EDS 25,B09,888484,Staff,0,0,0,0
1746546629896,EDS 25,B10,888487,Staff,0,0,0,0
1746546630922,EDS 38,A01,907700,Choi; Bailey Miyeon,30,0,30,0
1746546631951,EDS 112,A01,888601,Chapman; Thandeka K,14,0,40,26
1746546632979,EDS 115,A00,888697,Mendez; Kathrina Mendoza,10,0,30,20
1746546634008,EDS 116,A01,888893,Staff,35,0,40,5
1746546636064,EDS 124AR,A00,889133,Staff,29,0,50,21
1746546636064,EDS 124AR,B00,907471,Simon; Elizabeth A,37,0,50,13
1746546637092,EDS 124BR,A00,889134,Simon; Elizabeth A,45,0,100,55
1746546638120,EDS 125,A00,889135,Staff,25,0,30,5
1746546639144,EDS 126,A01,889138,Staff,36,0,40,4
1746546640172,EDS 164R,A01,889142,Wishard Guerra; Alison G.,33,0,50,17
1746546641197,ENG 30,A01,886396,Staff,0,0,0,0
1746546641197,ENG 30,B01,886398,Staff,0,0,0,0
1746546642226,ENVR 102,A00,906150,Montejo; Carolina,23,0,25,2
1746546643250,ETHN 103A,A00,887236,Man; Simeon S,0,3,0,0
1746546644276,ETHN 113,A00,887239,Staff,16,0,30,14
1746546645304,ETHN 116,A00,887240,Staff,16,0,25,9
1746546646329,ETHN 117,A00,887241,Choi; Esther Min,28,0,30,2
1746546647353,ETHN 118,A00,887243,Staff,24,0,30,6
1746546648379,ETHN 127,A00,887248,Cuong; Marisol,11,0,15,4
1746546649403,ETHN 139,A00,887250,Staff,7,0,10,3
1746546650429,ETHN 142,A00,887252,Staff,10,0,30,20
1746546651457,ETHN 161,A00,887253,Browne; Errol Tsekani,24,0,30,6
1746546652482,ETHN 163FR,A00,887255,Burelle; Julie Sara Veronique,0,0,5,5
1746546653508,GLBH 20,A00,889149,Elwardani; Nile Regina,8,0,42,34
1746546655559,GLBH 111,A01,889152,Burgos; Jose L.,17,0,17,0
1746546656587,GLBH 150,A00,889181,Sloane; Julia Kathryn,0,5,15,15
1746546658639,HDS 60,A01,886406,Warstadt; Melissa Fawn,73,0,80,7
1746546659664,HIAF 111,A00,889324,Gyamfi; Bright,25,0,32,7
1746546660691,HIEA 131,A00,889328,Staff,16,0,32,16
1746546661720,HIEA 144,A00,889333,Henry; Todd A.,26,0,32,6
1746546662787,HIEA 154,A00,889336,Henry; Todd A.,24,0,32,8
1746546663816,HIEU 106,A00,889339,Staff,22,0,32,10
1746546665866,HIEU 114,A00,889340,Staff,3,0,32,29
1746546666893,HIEU 135GS,A00,889342,Patterson; Patrick H.,0,0,1,24
1746546667920,HIEU 137,A00,889343,Edington; Claire Ellen,9,0,25,16
1746546668948,HIEU 148,A00,889345,Staff,14,0,32,18
1746546669972,HIEU 154,A00,889346,Biess; Frank Peter,21,0,32,11
1746546670997,HILA 102,A00,889351,Staff,12,0,32,20
1746546672021,HILD 2A,A01,889221,Lewandoski; Julia Mavis,1,10,32,31
1746546673045,HILD 7B,A01,889225,Man; Simeon S,0,13,32,32
1746546674069,HILD 7C,A01,889288,Alvarez; Luis A,0,14,32,32
1746546675099,HILD 30,A01,889323,Staff,0,5,32,32
1746546677165,HISC 119,A00,889383,Golan; Tal,21,0,32,11
1746546678190,HIUS 103,A00,889384,Man; Simeon S,0,0,32,32
1746546679216,HIUS 117,A00,919797,Kwak; Nancy,18,0,32,14
1746546680239,HIUS 142A,A00,919788,Staff,22,0,32,10
1746546682288,HIUS 149,A00,889386,Gyamfi; Bright,27,0,32,5
1746546683312,HIUS 155,A00,889387,Alvarez; Luis A,14,0,32,18
1746546684338,HUM 3,A01,886499,Caldwell; Michael Alan,19,0,50,31
1746546685361,HUM 3GS,A00,886500,Rodriguez; Bretton Sigfred,0,0,0,28
1746546686386,HUM 3R,A01,886502,Markman; Kristina,0,36,50,50
1746546687411,HUM 4,A01,886504,Crum; Matthew Stephen,24,0,50,26
1746546687411,HUM 4,B01,886506,West; Geoffrey Scott,17,0,50,33
1746546688438,HUM 4GS,A00,886507,Staff,0,0,0,19
1746546689466,HUM 5,A01,886509,Staff,32,0,50,18
1746546690489,HUM 5R,A01,886511,Zavodny; Tatiana Sophia,0,39,50,50
1746546691514,JAPN 180,A00,886407,Staff,18,0,40,22
1746546692545,LATI 50,A01,886409,Martin-Cabrera; Luis,4,0,22,18
1746546692545,LATI 50,A02,886410,Martin-Cabrera; Luis,19,0,22,3
1746546692545,LATI 50,A03,886411,Martin-Cabrera; Luis,21,0,22,1
1746546692545,LATI 50,A04,886412,Martin-Cabrera; Luis,9,0,22,13
1746546693573,LAWS 101,A00,907664,Staff,28,0,60,32
1746546694601,LIAB 1A,A00,889388,Saab; Dima,17,0,20,3
1746546695626,LIAB 1AX,A00,889389,El Cheddadi; Youniss,17,0,20,3
1746546696650,LIFR 1C,A00,889391,Van Moer; Vinciane G,8,0,20,12
1746546697678,LIFR 1CX,A00,889392,Van Moer; Vinciane G,7,0,20,13
1746546698704,LIFR 1D,A00,889393,Van Moer; Vinciane G,7,0,20,13
1746546699734,LIFR 1DX,A00,889394,Van Moer; Vinciane G,8,0,20,12
1746546700762,LIGN 7,A00,886923,Staff,24,0,50,26
1746546701787,LIGN 17,A00,886924,Kehler; Andrew Scott,125,0,150,25
1746546702811,LTAM 110,A00,889395,Staff,15,0,30,15
1746546703838,LTAM 110GS,A00,958010,Rodriguez; Bretton Sigfred,0,0,0,28
1746546704865,LTCH 101,A00,889397,Staff,23,0,25,2
1746546705892,LTCS 130,A00,889398,Staff,23,0,25,2
1746546706919,LTEA 138,A00,889399,Staff,24,0,40,16
1746546707944,LTEN 149,A00,889400,Wesling; Megan E.,0,3,25,25
1746546708967,LTEN 169,A00,889401,Staff,20,0,25,5
1746546709995,LTEN 180,A00,889402,Staff,10,0,15,5
1746546711026,LTEN 181,A00,889403,Staff,21,0,25,4
1746546712051,LTWL 100,A00,889404,Myerston Santana; Jacobo,3,0,25,22
1746546713079,LTWL 180GS,A00,889405,Staff,0,0,20,20
1746546714104,LTWL 181,A00,889406,Staff,17,0,25,8
1746546715132,LTWL 184,A00,889475,Mukherjee; Silpa,22,0,25,3
1746546716159,LTWR 102C,A00,889486,Staff,29,0,30,1
1746546717184,LTWR 115W,A00,889491,Staff,0,2,15,15
1746546718208,MAE 8,A01,886905,Staff,0,2,0,0
1746546719232,MAE 11,A00,886906,Bandaru; Prabhakar,0,7,50,50
1746546720258,MAE 20,A00,886907,Evdokimenko; Ekaterina,44,0,70,26
1746546721281,MAE 30B,A00,886909,Ghazinejad; Maziar,26,0,45,19
1746546722306,MAE 101B,A00,886910,Saintillan; David,29,0,45,16
1746546723334,MAE 105,A00,886911,Bandaru; Prabhakar,18,0,50,32
1746546724390,MAE 107,B00,958024,Staff,9,0,50,41
1746546725416,MAE 143B,A00,886913,Bewley; Thomas R,7,0,40,33
1746546726445,MAE 148,A01,886915,Silberman; Jack,0,3,14,14
1746546727469,MAE 160,A00,886916,Evdokimenko; Ekaterina,31,0,60,29
1746546728494,MATH 3C,A01,889681,Staff,0,3,30,30
1746546728494,MATH 3C,A02,960048,Staff,25,0,30,5
1746546729522,MATH 10A,A01,889760,Staff,26,0,30,4
1746546729522,MATH 10A,A02,889783,Staff,29,0,30,1
1746546730549,MATH 10B,A01,889785,Verstraete; Jacques Allan,2,0,35,33
1746546730549,MATH 10B,A02,889795,Verstraete; Jacques Allan,4,0,35,31
1746546730549,MATH 10B,B01,889797,Verstraete; Jacques Allan,3,0,35,32
1746546730549,MATH 10B,B02,889828,Verstraete; Jacques Allan,3,0,35,32
1746546731578,MATH 10C,A01,889849,Habib; Yousaf,9,0,30,21
1746546731578,MATH 10C,A02,889852,Habib; Yousaf,14,0,30,16
1746546731578,MATH 10C,A03,889853,Habib; Yousaf,22,0,30,8
1746546731578,MATH 10C,A04,889858,Habib; Yousaf,20,0,30,10
1746546731578,MATH 10C,B01,889861,Staff,1,0,30,29
1746546731578,MATH 10C,B02,889862,Staff,24,0,30,6
1746546731578,MATH 10C,B03,889863,Staff,27,0,30,3
1746546731578,MATH 10C,B04,889967,Staff,23,0,30,7
1746546732606,MATH 18,A01,889974,Staff,7,0,30,23
1746546732606,MATH 18,A02,889977,Staff,20,0,30,10
1746546732606,MATH 18,B01,889984,Hardiman; Liam,22,0,30,8
1746546732606,MATH 18,B02,889985,Hardiman; Liam,25,0,30,5
1746546733634,MATH 20A,A01,889990,Suk; Andrew Hoon,29,0,35,6
1746546734661,MATH 20B,A01,889993,Ohm; Ko Woon,22,0,30,8
1746546734661,MATH 20B,A02,889994,Ohm; Ko Woon,30,0,30,0
1746546734661,MATH 20B,B01,889996,Ohm; Ko Woon,21,0,30,9
1746546734661,MATH 20B,B02,889997,Ohm; Ko Woon,23,0,30,7
1746546735691,MATH 20C,A01,889999,Hammock; Frances H,17,0,30,13
1746546735691,MATH 20C,A02,890003,Hammock; Frances H,23,0,30,7
1746546735691,MATH 20C,B01,890006,Hammock; Frances H,3,0,30,27
1746546735691,MATH 20C,B02,890007,Hammock; Frances H,11,0,30,19
1746546736716,MATH 20D,A01,890011,Cheng; Hsiao-Bing,1,1,30,29
1746546736716,MATH 20D,A02,890012,Cheng; Hsiao-Bing,14,0,30,16
1746546736716,MATH 20D,B01,890016,Cheng; Hsiao-Bing,13,0,30,17
1746546736716,MATH 20D,B02,890017,Cheng; Hsiao-Bing,13,0,30,17
1746546737742,MATH 20E,A01,890026,Harel; Guershon,1,0,30,29
1746546737742,MATH 20E,A02,890029,Harel; Guershon,23,0,30,7
1746546737742,MATH 20E,B01,890033,Harel; Guershon,7,0,30,23
1746546737742,MATH 20E,B02,890101,Harel; Guershon,21,0,30,9
1746546738769,MATH 102,A01,890104,Staff,17,0,30,13
1746546738769,MATH 102,A02,890105,Staff,27,0,30,3
1746546739800,MATH 103B,A01,890116,Salehi Golsefidy; Alireza,3,0,30,27
1746546739800,MATH 103B,B01,890118,Staff,0,3,34,34
1746546740825,MATH 109,A01,890121,Aliabadi Sr.; Mohsen,1,0,30,29
1746546740825,MATH 109,B01,890124,Upadrashta; Pranav Kumar,18,0,30,12
1746546741852,MATH 120A,A01,890126,Eggers; John Dietrich,13,0,30,17
1746546742878,MATH 142B,A01,890128,Ioana; Adrian,19,0,30,11
1746546742878,MATH 142B,A02,890129,Ioana; Adrian,13,0,30,17
1746546743908,MATH 154,A01,890174,Staff,0,0,30,30
1746546743908,MATH 154,A02,890182,Staff,0,0,30,30
1746546744933,MATH 168A,A01,890197,Dumitriu; Ioana,21,0,35,14
1746546745959,MATH 170A,A01,890240,Nie; Jiawang,1,0,30,29
1746546745959,MATH 170A,A02,890241,Nie; Jiawang,11,0,30,19
1746546745959,MATH 170A,A03,890249,Nie; Jiawang,23,0,30,7
1746546746986,MATH 170B,A01,957891,Nag; Panchali,13,0,35,22
1746546749038,MATH 181A,A01,908025,Staff,0,4,35,35
1746546749038,MATH 181A,A02,960115,Staff,27,0,35,8
1746546750064,MATH 181B,A01,959874,Staff,26,0,30,4
1746546751089,MATH 193B,A01,890265,Staff,0,4,35,35
1746546752115,MGT 4,A01,890311,Anderson; John Charles,42,0,88,46
1746546753140,MGT 5,A00,907740,Staff,13,0,98,85
1746546754166,MGT 12,A00,890312,Lindenberger; Wade Douglas,67,0,98,31
1746546755193,MGT 16,A00,957883,Staff,78,0,98,20
1746546757244,MGT 45,A00,890314,Pecore; Joseph P.,47,0,98,51
1746546758268,MGT 71,A00,890315,Staff,0,11,98,98
1746546759292,MGT 100,A00,890316,Yavorsky; Daniel Ryan,44,0,98,54
1746546760318,MGT 103,A00,890317,Ehrich; Kristine R,73,0,98,25
1746546761343,MGT 105,A00,890356,Bates; Kenneth Walter,0,7,98,98
1746546762369,MGT 112,A00,890360,Ehrich; Kristine R,55,0,98,43
1746546763395,MGT 127R,A00,907732,Zhu; Kevin Xiaoguo,23,0,98,75
1746546764423,MGT 131B,A00,890361,Anderson; John Charles,61,0,98,37
1746546765447,MGT 137,A00,890362,Lindenberger; Wade Douglas,65,0,98,33
1746546766473,MGT 160,A00,890369,Johnson; Erik Barry,9,0,98,89
1746546768523,MGT 164,A00,890372,Zimmermann; Carsten,0,39,98,98
1746546769551,MGT 180,A00,890374,Bliss; Barbara Ann,12,0,98,86
1746546770578,MMW 15,A01,886414,Chang; Edmond Yi-Teh,0,12,28,28
1746546770578,MMW 15,A02,886415,Chang; Edmond Yi-Teh,0,8,28,28
1746546770578,MMW 15,A03,886416,Chang; Edmond Yi-Teh,0,8,28,28
1746546770578,MMW 15,A04,886417,Chang; Edmond Yi-Teh,0,8,28,28
1746546770578,MMW 15,B01,886419,Chang; Edmond Yi-Teh,0,7,28,28
1746546770578,MMW 15,B02,886420,Chang; Edmond Yi-Teh,0,8,28,28
1746546770578,MMW 15,B03,886421,Chang; Edmond Yi-Teh,0,7,28,28
1746546770578,MMW 15,B04,886422,Chang; Edmond Yi-Teh,0,8,28,28
1746546770578,MMW 15,C01,886424,Staff,0,9,28,28
1746546770578,MMW 15,C02,886425,Staff,0,8,28,28
1746546770578,MMW 15,C03,886426,Staff,0,8,28,28
1746546770578,MMW 15,C04,886427,Staff,0,7,28,28
1746546770578,MMW 15,C05,958038,Staff,0,7,28,28
1746546770578,MMW 15,C06,958039,Staff,0,8,28,28
1746546771605,MMW 15GS,A00,906910,Patterson; Patrick H.,4,0,28,24
1746546772632,MMW 122R,A01,886429,Rahimi; Babak,0,13,28,28
1746546772632,MMW 122R,A02,886430,Rahimi; Babak,0,12,28,28
1746546772632,MMW 122R,A03,958040,Rahimi; Babak,0,11,28,28
1746546773663,MUS 1A,A01,890937,Staff,3,0,25,22
1746546773663,MUS 1A,A02,891035,Staff,6,0,25,19
1746546773663,MUS 1A,C01,958912,Staff,24,0,25,1
1746546773663,MUS 1A,C02,958913,Staff,25,0,25,0
1746546775718,MUS 2AK,A00,957092,Ohnishi; Takae,15,0,15,0
1746546776743,MUS 4,A01,891044,Staff,2,0,25,23
1746546776743,MUS 4,A02,891045,Staff,23,0,25,2
1746546776743,MUS 4,B01,891048,Staff,17,0,25,8
1746546776743,MUS 4,B02,891050,Staff,25,0,25,0
1746546777770,MUS 5,A01,957506,Dubnov; Shlomo,0,0,25,25
1746546777770,MUS 5,A02,957622,Dubnov; Shlomo,14,0,25,11
1746546777770,MUS 5,A03,957623,Dubnov; Shlomo,20,0,25,5
1746546778797,MUS 6,A01,891053,Freitas Caetano; Marcelo,24,0,25,1
1746546778797,MUS 6,A02,891054,Freitas Caetano; Marcelo,23,0,25,2
1746546779827,MUS 7,A01,891081,Staff,0,0,25,25
1746546779827,MUS 7,A02,891082,Staff,4,0,25,21
1746546780852,MUS 8GS,A00,891118,Borgo; David Garcia,0,0,25,25
1746546781879,MUS 11,A01,891140,Staff,11,0,25,14
1746546781879,MUS 11,A02,891141,Staff,22,0,25,3
1746546782909,MUS 13,A01,891143,Staff,8,0,25,17
1746546782909,MUS 13,A02,891144,Staff,24,0,25,1
1746546783939,MUS 15,A01,891146,Staff,9,0,25,16
1746546783939,MUS 15,A02,891148,Staff,21,0,25,4
1746546783939,MUS 15,B01,891150,Staff,18,0,25,7
1746546783939,MUS 15,B02,891151,Staff,25,0,25,0
1746546784966,MUS 20,A01,891153,Staff,5,0,20,15
1746546784966,MUS 20,A02,891155,Staff,14,0,20,6
1746546785992,MUS 80,A00,891156,Staff,19,0,25,6
1746546785992,MUS 80,B00,891157,Staff,23,0,25,2
1746546787020,MUS 130,A00,891158,Ohnishi; Takae,35,0,35,0
1746546788046,MUS 150GS,A01,891160,Borgo; David Garcia,0,0,25,25
1746546789071,MUS 170,A01,891162,Freitas Caetano; Marcelo,20,0,25,5
1746546789071,MUS 170,A02,891164,Freitas Caetano; Marcelo,21,0,25,4
1746546790098,NANO 11,A00,886220,Vazquez Mena; Oscar,13,0,15,2
1746546791124,NANO 15,A01,886222,Drews; Aaron,4,0,7,3
1746546792152,NANO 104,A00,886224,Sirbuly; Donald,18,0,25,7
1746546793179,PH 40,A00,886528,Staff,23,0,40,17
1746546794205,PH 45,A01,886799,Staff,35,0,40,5
1746546795231,PH 110,A00,886802,Staff,0,7,40,40
1746546796260,PH 172,A00,906716,Staff,19,0,35,16
1746546797289,PH 191,A00,886803,Staff,6,0,40,34
1746546798315,PHIL 1,A00,889500,Staff,19,0,30,11
1746546799341,PHIL 10,A01,889549,Grush; Rick Scott,15,0,22,7
1746546799341,PHIL 10,A02,889551,Grush; Rick Scott,22,0,22,0
1746546800368,PHIL 28,A01,889559,Lamey; Andy M.,0,1,31,31
1746546800368,PHIL 28,A02,889561,Lamey; Andy M.,0,1,30,30
1746546800368,PHIL 28,A03,889572,Lamey; Andy M.,0,0,30,30
1746546801393,PHIL 35,A00,907839,Staff,13,0,15,2
1746546802418,PHIL 60,A00,889574,Staff,74,0,90,16
1746546803445,PHIL 101,A00,958004,Staff,13,0,15,2
1746546805496,PHIL 136,A00,889582,Fulkerson; Matthew Todd,26,0,45,19
1746546806523,PHIL 163,A01,889601,Staff,21,0,30,9
1746546806523,PHIL 163,B01,889606,Brandt; Reuven A,0,3,0,0
1746546807549,PHIL 164,A00,889610,Staff,16,0,30,14
1746546808574,PHIL 165,A00,889613,Staff,23,0,30,7
1746546809598,PHYS 1A,A00,886431,Staff,26,0,70,44
1746546810623,PHYS 1AL,001,886432,Tsai; Philbert S,0,2,30,30
1746546810623,PHYS 1AL,002,886436,Tsai; Philbert S,11,0,30,19
1746546811651,PHYS 1B,A00,886439,Staff,185,0,240,55
1746546812679,PHYS 1BL,001,886441,Tsai; Philbert S,0,4,30,30
1746546812679,PHYS 1BL,002,886444,Tsai; Philbert S,2,0,30,28
1746546813705,PHYS 1C,A00,896092,Arnold; Kam S,78,0,146,68
1746546814734,PHYS 1CL,001,886448,Tsai; Philbert S,0,0,30,30
1746546814734,PHYS 1CL,002,886449,Tsai; Philbert S,0,0,30,30
1746546814734,PHYS 1CL,003,886450,Tsai; Philbert S,16,0,30,14
1746546814734,PHYS 1CL,004,886451,Tsai; Philbert S,15,0,30,15
1746546815758,PHYS 2B,A01,886457,Staff,69,0,115,46
1746546816785,PHYS 2C,A01,886460,Shotwell; Brian,0,8,65,65
1746546817810,PHYS 2CL,A01,886467,Staff,0,4,28,28
1746546817810,PHYS 2CL,A02,886468,Staff,0,3,28,28
1746546818837,PHYS 2D,A01,886470,Staff,10,0,50,40
1746546819866,PHYS 4B,A01,886475,Grinstein; Benjamin,22,0,40,18
1746546820890,POLI 5,A00,891173,Desposato; Scott,7,0,25,18
1746546821918,POLI 5D,A01,891175,Staff,5,0,5,0
1746546821918,POLI 5D,B01,891178,Staff,5,0,5,0
1746546822947,POLI 11,A00,891179,Ferree; Karen E,2,0,35,33
1746546823979,POLI 12,A00,891180,Staff,16,0,30,14
1746546825004,POLI 27,A01,891182,Staff,12,0,75,63
1746546826031,POLI 30,A00,891183,Staff,8,0,50,42
1746546827056,POLI 100B,A00,891244,Staff,5,1,35,30
1746546828083,POLI 100I,A00,891247,Staff,7,0,30,23
1746546829108,POLI 104J,A00,891248,Nichter; Maysa,14,0,30,16
1746546830137,POLI 104U,A00,891250,Nichter; Maysa,2,0,30,28
1746546832189,POLI 110B,A00,891255,Wiens; David,20,0,25,5
1746546833216,POLI 112A,A00,891256,Wiens; David,6,0,25,19
1746546834241,POLI 114BR,A00,891261,Staff,19,0,30,11
1746546835270,POLI 117R,A00,891262,Forman; Fonna,0,6,50,50
1746546836296,POLI 118,A00,891264,Ingham; Sean,17,0,25,8
1746546837322,POLI 124A,A00,891265,Staff,18,0,20,2
1746546838347,POLI 125D,A00,891266,Nichter; Simeon C,2,0,25,23
1746546839374,POLI 126,A00,891268,Nichter; Simeon C,7,0,25,18
1746546840401,POLI 126AA,A00,891272,Staff,18,0,25,7
1746546841428,POLI 130AA,A00,891273,Staff,15,0,20,5
1746546842455,POLI 134AA,A00,891274,Staff,4,0,20,16
1746546844504,POLI 138,A00,891278,Staff,21,0,25,4
1746546845530,POLI 142K,A00,891280,Staff,11,0,25,14
1746546846559,POLI 142M,A00,891281,Gartzke; Erik,17,0,30,13
1746546847586,POLI 142P,A00,891284,Staff,20,0,30,10
1746546848612,POLI 143,A00,891285,Gartzke; Erik,12,0,30,18
1746546849637,POLI 153,A00,891286,Staff,19,0,20,1
1746546851691,POLI 175,A00,891290,Staff,15,0,20,5
1746546852716,PSYC 1,A00,890674,Steiner; Eric Tomas,0,11,45,45
1746546853742,PSYC 2,A00,890676,Albright; Thomas D,21,0,35,14
1746546854767,PSYC 3,A00,890679,Staff,17,0,20,3
1746546855793,PSYC 6,A00,959858,Staff,20,0,20,0
1746546856820,PSYC 60,A01,890684,Rickard; Timothy C.,0,5,45,45
1746546857843,PSYC 70,A01,890689,Geller; Emma Harlan,7,0,30,23
1746546858871,PSYC 71,A01,959860,Staff,21,0,25,4
1746546859896,PSYC 100,A00,890690,Lacefield; Katharine I,0,50,180,180
1746546860940,PSYC 102,A00,890695,Staff,18,0,40,22
1746546861964,PSYC 105,A00,890699,Geller; Emma Harlan,71,0,100,29
1746546862989,PSYC 106,A00,890701,Gorman; Michael R.,5,0,30,25
1746546864020,PSYC 108,A00,890704,Adrian; Julia Anna,0,28,50,50
1746546865047,PSYC 118,A01,890712,Staff,11,0,30,19
1746546866073,PSYC 124,A00,890716,Chapman; Eddie Nathaniel,25,0,60,35
1746546867097,PSYC 131,A00,890717,Anagnostaras; Stephan,0,7,80,80
1746546868127,PSYC 137,A00,890719,Winkielman; Piotr,0,11,30,30
1746546869155,PSYC 144,A00,890721,Adrian; Julia Anna,0,9,45,45
1746546870179,PSYC 162,A00,890805,Staff,2,0,75,73
1746546871202,PSYC 169,A00,890810,Staff,0,15,30,30
1746546872231,PSYC 172,A00,890814,Gorman; Michael R.,9,0,30,21
1746546873254,PSYC 181,A00,890818,Anagnostaras; Stephan,8,0,200,192
1746546874281,PSYC 184,A00,959861,Staff,170,0,175,5
1746546875304,PSYC 189,A00,890823,Staff,0,1,30,30
1746546876328,PSYC 191,A00,890884,Rickard; Timothy C.,0,11,35,35
1746546877351,PSYC 193,A00,890913,Staff,19,0,30,11
1746546877351,PSYC 193,B00,890914,Chapman; Eddie Nathaniel,24,0,30,6
1746546878379,PSYC 193L,A01,890918,Lowe; Angela Beth,20,0,30,10
1746546878379,PSYC 193L,B01,890921,Hurwitz; Ethan Scott,20,0,30,10
1746546878379,PSYC 193L,C01,890928,Staff,30,0,30,0
1746546879408,RELI 149,A00,886806,Rahimi; Babak,23,0,40,17
1746546880433,SE 9,A01,886814,Staff,7,0,20,13
1746546881459,SE 101B,A01,886816,Chadha; Mayank,4,0,35,31
1746546882489,SE 110B,A00,886818,Zhu; Qiang,4,0,75,71
1746546883513,SE 125,A01,886830,Staff,10,0,30,20
1746546884540,SE 130B,A01,886835,Staff,14,0,40,26
1746546885567,SE 131A,A01,886838,Krysl; Petr,34,0,55,21
1746546886595,SE 154,A00,886840,Staff,30,0,50,20
1746546887620,SE 164GS,A01,886849,Staff,6,0,20,14
1746546888645,SE 167GS,A01,886853,Staff,6,0,20,14
1746546889674,SIO 25,A01,890107,Staff,19,0,30,11
1746546890700,SIO 45,A00,890109,Cook; Geoffrey W,117,0,200,83
1746546891726,SIO 109R,A00,890110,Forman; Fonna,0,16,20,20
1746546892752,SIO 187,A01,890114,Kacev; David,15,0,40,25
1746546893778,SOCI 1,A01,890431,Thorpe; Charles Robert,15,0,30,15
1746546893778,SOCI 1,A02,890518,Thorpe; Charles Robert,30,0,30,0
1746546894830,SOCI 2,A01,957978,Staff,25,0,25,0
1746546894830,SOCI 2,A02,957979,Staff,23,0,25,2
1746546895859,SOCI 20,A01,890523,Calderon-Zaks; Michael Aar,23,0,30,7
1746546895859,SOCI 20,A02,890526,Calderon-Zaks; Michael Aar,29,0,30,1
1746546896889,SOCI 30,A01,890533,Pardo Guerra; Juan Pablo,37,0,40,3
1746546897913,SOCI 40,A01,890535,Staff,27,0,45,18
1746546898941,SOCI 104Q,A00,890559,Staff,18,0,30,12
1746546899965,SOCI 106,A00,890560,Arnal; Maud Marie Leonie,20,0,30,10
1746546900991,SOCI 110,A00,890567,Holkenbrink-Monk; Charlene,19,0,30,11
1746546902025,SOCI 112,A00,890568,Victoria Torres; Pablo,1,0,55,54
1746546903052,SOCI 115,A00,890597,Arnal; Maud Marie Leonie,28,0,45,17
1746546905104,SOCI 121,A00,890604,Pardo Guerra; Juan Pablo,38,0,45,7
1746546906131,SOCI 126,A01,890608,Staff,8,0,10,2
1746546907157,SOCI 127,A00,890609,Staff,18,0,30,12
1746546908184,SOCI 131,A00,890610,Thorpe; Charles Robert,37,0,45,8
1746546909213,SOCI 135,A00,890615,Payne; Christine Anna,14,0,45,31
1746546910239,SOCI 139,A00,890620,Staff,38,0,45,7
1746546911264,SOCI 148E,A00,890622,Calderon-Zaks; Michael Aar,36,0,45,9
1746546912290,SOCI 150,A00,890623,Kohler; Kristopher M.,31,0,45,14
1746546913314,SOCI 157,A00,890625,Jules-Rosette; Bennetta W.,18,0,20,2
1746546914343,SOCI 160,A00,890627,Payne; Christine Anna,21,0,45,24
1746546915371,SYN 1,A00,886855,Fish; Gwendolyn Anne,0,0,0,0
1746546915371,SYN 1,B00,906086,Fish; Gwendolyn Anne,0,1,0,2
1746546916400,SYN 2R,A00,886860,Staff,0,17,15,15
1746546916400,SYN 2R,B00,906106,Atkinson; Arthur Laird,0,16,15,15
1746546917432,SYN 100,A01,886866,Browne; Emily,0,28,20,20
1746546917432,SYN 100,B01,906128,Rock; Martin,0,5,20,20
1746546917432,SYN 100,C01,906140,Deavenport; James Cary,0,3,20,20
1746546917432,SYN 100,D01,907816,Deavenport; James Cary,0,5,20,20
1746546918459,TDAC 1,A00,890286,Walsh; Kim C.,9,0,20,11
1746546919483,TDAC 101,A00,890296,Basso; Beatrice,16,0,20,4
1746546920508,TDDE 131,A00,890297,Staff,47,0,50,3
1746546921536,TDDM 1,A00,890287,Weinberg; Sadie,25,0,30,5
1746546922561,TDGE 11,A00,890288,Fulton; Julia,137,0,200,63
1746546922561,TDGE 11,B00,890289,Castro; Robert Jess,184,0,200,16
1746546923590,TDGE 25,B00,957359,Walsh; Kim C.,3,0,20,17
1746546924617,TDGE 40,A01,890292,Power; Jade Yukana,27,0,30,3
1746546925644,TDGE 124,A00,890298,Havis; Allan,0,0,50,50
1746546926670,TDGE 131R,A00,890299,Burelle; Julie Sara Veronique,15,0,42,27
1746546927694,TDHT 101,A00,890300,Staff,10,0,20,10
1746546928721,TDHT 109,A01,890302,Anderson; Mysia Anyse,31,0,40,9
1746546929748,TDMV 1,A00,890293,Arcidiacono; Kristin,18,0,30,12
1746546930773,TDMV 2,A00,890294,Weinberg; Sadie,23,0,30,7
1746546931797,TDMV 3,A00,957878,Arcidiacono; Kristin,28,0,30,2
1746546933853,TDMV 138,A00,890304,Jun; Grace Shin Hae,25,0,40,15
1746546934876,TDMV 140,A00,890305,Corrales; Joseph Bernales,25,0,30,5
1746546935902,TDMV 142,A00,890307,Caligagan; Tony,32,0,40,8
1746546936928,TDMV 144,A00,890308,Camaya; Michelle Ann,25,0,30,5
1746546937956,TDPW 1,A00,890295,Stein; Deborah Isobel,3,0,20,17
1746546938983,USP 2,A01,890272,Lerner; Amy M,6,0,20,14
1746546940014,USP 3,A01,890274,Staff,12,0,30,18
1746546941038,USP 15,A01,890276,Sun; Feiyang,17,0,30,13
1746546942065,USP 25,A00,890277,Shenkman; Michael Thomas,19,0,25,6
1746546943090,USP 138,A00,890278,Staff,13,0,25,12
1746546944115,USP 143,A00,890279,Staff,21,0,70,49
1746546945139,USP 144,A00,890280,Chowdhury; Muhammed Zohir,16,0,30,14
1746546946166,USP 150,A00,890281,Boomhower; Matthew Charles,4,0,30,26
1746546947191,USP 151,A00,890282,Staff,16,0,20,4
1746546948215,USP 162,A00,890283,Andrews; Abigail Leslie,16,0,20,4
1746546949240,USP 168,A00,920477,Kwak; Nancy,1,0,5,4
1746546950266,USP 181,A00,890284,Staff,3,0,20,17
1746546951295,USP 191A,A00,890285,Staff,13,0,20,7
1746546952319,VIS 101,A00,886512,Staff,25,0,75,50
1746546953347,VIS 103,A00,886513,Cruz; Edwin Teddy,61,0,75,14
1746546954372,VIS 108,A00,886514,Staff,3,0,15,12
1746546955399,VIS 127P,A00,886515,Shen; Kuiyi,80,0,146,66
1746546956423,VIS 149,A00,886516,Yoldas; Pinar,0,0,15,15
1746546957450,VIS 164,A00,886526,Erdmann; Dean,19,0,22,3
1746546958474,VIS 194S,A00,886527,Staff,61,0,75,14
1746546959499,WCWP 10A,C00,886484,Martiniuk; Jill,12,0,15,3
1746546960525,WCWP 10B,A00,886490,Uriarte; Emma,0,0,15,15
1746546960525,WCWP 10B,B00,886491,Dhir; Simrita,11,0,15,4
1746546960525,WCWP 10B,C00,886492,Ornelas; Tricia,0,0,15,15
1746546961551,WCWP 100,A00,886494,Young; Mark T,0,7,15,15
1746546963667,AAS 10,A01,886199,Childs; Dennis R.,0,3,0,0
1746546964696,ANAR 104,A01,886940,Shtienberg; Gilad,27,0,30,3
1746546965724,ANAR 120,A00,886953,Staff,12,0,20,8
1746546966749,ANBI 148,A01,886955,Wilder; Linnea Lorene,30,0,40,10
1746546968799,ANSC 122,A00,886957,Staff,25,0,30,5
1746546969824,ANSC 150,A00,886958,Sloane; Julia Kathryn,3,0,15,12
1746546970854,ANSC 156,A00,886959,Jenkins; Janis A.,0,1,15,15
1746546971878,ANSC 180,A00,886960,Staff,11,0,17,6
1746546972902,ANSC 188,A00,886961,Jassal; Aftab,9,0,25,16
1746546973969,ANSC 190,A00,886962,Jassal; Aftab,14,0,25,11
1746546974995,ANSC 191,A00,886963,Staff,18,0,20,2
1746546976020,ANTH 3,A01,891689,Staff,17,0,20,3
1746546977046,ANTH 5,A00,886933,Semendeferi; Ekaterini,16,0,20,4
1746546978072,ANTH 10,A00,886934,Staff,0,12,30,30
1746546979101,ANTH 21,A01,886936,Staff,40,0,60,20
1746546980130,ANTH 23,A01,886938,Staff,92,0,100,8
1746546981155,ANTH 105,A00,886964,Stewart; Alexander B,84,0,100,16
1746546982184,ANTH 108,A00,886965,Pedersen; David,9,0,20,11
1746546983210,AWP 10,001,886147,Staff,0,0,0,0
1746546983210,AWP 10,002,886148,Staff,0,0,0,0
1746546983210,AWP 10,003,886149,Staff,0,0,0,0
1746546983210,AWP 10,004,886150,Staff,0,0,0,0
1746546983210,AWP 10,005,886151,Staff,0,0,0,0
1746546983210,AWP 10,006,886152,Staff,0,0,0,0
1746546983210,AWP 10,007,886153,Staff,0,0,0,0
1746546983210,AWP 10,008,886154,Staff,0,0,0,0
1746546983210,AWP 10,009,886155,Staff,0,0,0,0
1746546983210,AWP 10,010,886156,Staff,0,0,0,0
1746546983210,AWP 10,011,886158,Staff,0,0,0,0
1746546983210,AWP 10,012,886160,Staff,0,0,0,0
1746546983210,AWP 10,013,886161,Staff,0,0,0,0
1746546983210,AWP 10,014,886162,Staff,0,0,0,0
1746546983210,AWP 10,015,886163,Staff,0,0,0,0
1746546983210,AWP 10,016,886164,Staff,0,0,0,0
1746546983210,AWP 10,017,886165,Staff,0,0,0,0
1746546983210,AWP 10,018,886166,Staff,0,0,0,0
1746546983210,AWP 10,019,886168,Staff,0,0,0,0
1746546983210,AWP 10,020,886170,Staff,0,0,0,0
1746546983210,AWP 10,021,886172,Staff,0,0,0,0
1746546984239,AWP 10R,001,886173,Staff,0,1,0,0
1746546984239,AWP 10R,002,886174,Staff,0,1,0,0
1746546984239,AWP 10R,003,886175,Staff,0,0,0,0
1746546984239,AWP 10R,004,886176,Staff,0,0,0,0
1746546984239,AWP 10R,005,886177,Staff,0,0,0,0
1746546984239,AWP 10R,006,886178,Staff,0,0,0,0
1746546984239,AWP 10R,007,886179,Staff,0,0,0,0
1746546984239,AWP 10R,008,886181,Staff,0,0,0,0
1746546984239,AWP 10R,009,886182,Staff,0,0,0,0
1746546984239,AWP 10R,010,886183,Staff,0,0,0,0
1746546984239,AWP 10R,011,886184,Staff,0,0,0,0
1746546984239,AWP 10R,012,886185,Staff,0,0,0,0
1746546984239,AWP 10R,013,886186,Staff,0,0,0,0
1746546984239,AWP 10R,014,886187,Staff,0,0,0,0
1746546984239,AWP 10R,015,886188,Staff,0,0,0,0
1746546984239,AWP 10R,016,886189,Staff,0,0,0,0
1746546985265,AWP 102R,A00,886190,Staff,0,0,0,0
1746546985265,AWP 102R,B00,886191,Staff,0,0,0,0
1746546986290,BENG 100,A01,886193,Staff,17,0,30,13
1746546987317,BENG 122A,A01,886195,Hasty; Jeff M,13,0,30,17
1746546988342,BENG 166A,A00,886196,Sah; Robert Lie-Yuan,0,1,30,30
1746546989370,BENG 190,A00,958050,Khojah; Reem I,24,0,25,1
1746546990396,BIBC 102,A01,894320,Staff,0,0,46,46
1746546990396,BIBC 102,A02,894321,Staff,0,0,46,46
1746546990396,BIBC 102,A03,894344,Staff,7,0,46,39
1746546990396,BIBC 102,A04,894345,Staff,26,0,47,21
1746546991424,BICD 100R,A01,894365,Smith; Laurie,0,3,58,58
1746546991424,BICD 100R,A02,894366,Smith; Laurie,0,5,58,58
1746546991424,BICD 100R,A03,894367,Smith; Laurie,2,0,59,57
1746546991424,BICD 100R,A04,959869,Smith; Laurie,41,0,59,18
1746546992453,BICD 136,A01,894383,Gustafson-Brown; Cindy,14,0,50,36
1746546993482,BIEB 102,A01,894494,Butler; Shannon Rhey,51,0,130,79
1746546995533,BIEB 150,A01,894617,Wills; Christopher,3,0,20,17
1746546995533,BIEB 150,A02,894631,Wills; Christopher,3,0,20,17
1746546995533,BIEB 150,A03,894937,Wills; Christopher,3,0,20,17
1746546995533,BIEB 150,A04,894946,Wills; Christopher,5,0,20,15
1746546996559,BIEB 194,A00,906141,Kurle; Carolyn M.,6,0,20,14
1746546997584,BILD 1,A01,894154,Staff,2,0,19,17
1746546997584,BILD 1,A02,894155,Staff,14,0,19,5
1746546997584,BILD 1,A03,894160,Staff,13,0,19,6
1746546997584,BILD 1,A04,894161,Staff,15,0,18,3
1746546998610,BILD 2,A01,894168,Staff,0,0,50,50
1746546998610,BILD 2,A02,894169,Staff,0,0,50,50
1746546998610,BILD 2,A03,894179,Staff,4,0,50,46
1746546998610,BILD 2,A04,894203,Staff,27,0,50,23
1746546999637,BILD 3,A01,894213,Staff,22,0,31,9
1746546999637,BILD 3,A02,894214,Staff,26,0,31,5
1746546999637,BILD 3,A03,894235,Staff,28,0,31,3
1746546999637,BILD 3,A04,894236,Staff,28,0,32,4
1746547000661,BILD 4,A01,894253,Reuther; Keefe,5,0,24,19
1746547000661,BILD 4,A02,894258,Reuther; Keefe,16,0,24,8
1746547001687,BILD 5,A01,894276,Reuther; Keefe,35,0,50,15
1746547001687,BILD 5,A02,894277,Reuther; Keefe,45,0,50,5
1746547001687,BILD 5,A03,894290,Reuther; Keefe,44,0,50,6
1746547001687,BILD 5,A04,894291,Reuther; Keefe,48,0,50,2
1746547002714,BILD 24,A01,894297,Pirino; Giorgia,40,0,60,20
1746547003738,BIMM 100,B01,958915,Staff,72,0,100,28
1746547004765,BIMM 101,A01,895017,McDonnell; Lisa Marie,0,5,24,24
1746547004765,BIMM 101,A02,895018,McDonnell; Lisa Marie,0,5,24,24
1746547004765,BIMM 101,B01,895020,McDonnell; Lisa Marie,0,6,24,24
1746547004765,BIMM 101,B02,895021,McDonnell; Lisa Marie,0,4,24,24
1746547005790,BIMM 110,A01,895023,Staff,1,0,25,24
1746547005790,BIMM 110,A02,895024,Staff,9,0,25,16
1746547005790,BIMM 110,A03,895025,Staff,18,0,25,7
1746547005790,BIMM 110,A04,895031,Staff,20,0,25,5
1746547006819,BIMM 120,A01,895114,Gustafson-Brown; Cindy,13,0,28,15
1746547006819,BIMM 120,A02,895126,Gustafson-Brown; Cindy,21,0,27,6
1746547007844,BIPN 100,A01,895130,Yang; Mingyu,1,0,38,37
1746547007844,BIPN 100,A02,895131,Yang; Mingyu,32,0,38,6
1746547007844,BIPN 100,A03,895132,Yang; Mingyu,32,0,38,6
1746547007844,BIPN 100,A04,895133,Yang; Mingyu,27,0,36,9
1746547008873,BIPN 120,A01,895135,Cooke; James Edward,0,3,13,13
1746547008873,BIPN 120,A02,895136,Cooke; James Edward,0,1,13,13
1746547008873,BIPN 120,A03,895137,Cooke; James Edward,0,3,13,13
1746547008873,BIPN 120,A04,895156,Cooke; James Edward,0,2,11,11
1746547009898,BIPN 134,A01,895235,Cooke; James Edward,0,2,25,25
1746547009898,BIPN 134,A02,895237,Cooke; James Edward,0,0,25,25
1746547009898,BIPN 134,A03,895240,Cooke; James Edward,3,0,25,22
1746547009898,BIPN 134,A04,895270,Cooke; James Edward,20,0,25,5
1746547010922,BIPN 189,A00,892103,Staff,0,13,14,14
1746547012974,BISP 194,A00,958008,Staff,0,2,0,0
1746547013999,CAT 124,A01,922009,Staff,0,5,20,20
1746547015032,CAT 125R,A00,886390,Morales; Celeste Georgianna,0,2,20,20
1746547015032,CAT 125R,B00,886391,Irwin; Matthew Joseph,0,3,20,20
1746547015032,CAT 125R,C00,886392,Smith; Lauryn Alissa,0,2,20,20
1746547015032,CAT 125R,D00,886393,Vanderschuit; Maya Alysia,0,2,20,20
1746547015032,CAT 125R,E00,886394,Marchisotto; Jennifer Anne,0,4,20,20
1746547016059,CENG 15,A01,886218,Drews; Aaron,3,0,8,5
1746547017087,CENG 113,A00,886219,Opatkiewicz; Justin Paul,15,0,25,10
1746547018112,CGS 101,A00,887044,Staff,7,0,20,13
1746547019153,CGS 105,A01,887046,Staff,14,0,25,11
1746547020178,CGS 112,A00,887047,Cuong; Marisol,12,0,15,3
1746547021201,CGS 113,A00,887048,Staff,23,0,30,7
1746547022228,CGS 120,A00,887049,Staff,10,0,17,7
1746547023254,CHEM 6A,A01,886336,Lam; Tin Yiu,38,0,50,12
1746547023254,CHEM 6A,A02,886338,Lam; Tin Yiu,37,0,50,13
1746547024278,CHEM 6B,A01,886341,Hopkins; Patrycja Anna,16,0,50,34
1746547024278,CHEM 6B,A02,886343,Hopkins; Patrycja Anna,42,0,50,8
1746547025307,CHEM 6C,A01,886346,Albizati; Kim F.,0,2,50,50
1746547025307,CHEM 6C,A02,886348,Albizati; Kim F.,23,0,50,27
1746547026334,CHEM 40A,A01,886352,Klosterman; Jeremy K,65,0,100,35
1746547027359,CHEM 40B,A01,886356,Klosterman; Jeremy K,0,23,100,100
1746547028389,CHEM 41B,A01,886360,Theodorakis; Emmanuel,25,0,50,25
1746547028389,CHEM 41B,A02,886362,Theodorakis; Emmanuel,47,0,50,3
1746547029417,CHIN 165A,A00,886382,Xu; Li,18,0,20,2
1746547030441,CLAS 120,A00,886387,Myerston Santana; Jacobo,33,0,40,7
1746547031469,COGS 9,A01,886967,Shannon; Kyle Michael,42,0,60,18
1746547032496,COGS 11,A01,886969,Staff,11,0,30,19
1746547033522,COGS 14A,A01,886971,Staff,6,0,60,54
1746547034546,COGS 14B,A01,886973,Hoffman; Drew Ellen,4,0,60,56
1746547035575,COGS 18,A01,886975,Morgan; Eric,35,0,60,25
1746547036602,COGS 20,A01,886977,Staff,4,0,8,4
1746547036602,COGS 20,A02,886978,Staff,5,0,7,2
1746547037628,COGS 100,A01,907783,Staff,0,2,30,30
1746547038654,COGS 101B,A01,886980,Staff,0,3,48,48
1746547039682,COGS 101C,A01,886982,Delgado; Tania,0,5,44,44
1746547040753,COGS 102A,A01,886984,Johnson; Christine M.,4,0,30,26
1746547041782,COGS 118B,A01,886986,Staff,0,3,88,88
1746547042810,COGS 150,A01,886988,Bergen; Benjamin,23,0,50,27
1746547043835,COGS 153,A00,886989,Delgado; Tania,0,2,41,41
1746547044863,COGS 186,A01,886991,Staff,0,0,32,32
1746547045889,COGS 187A,A01,886993,Boyle; Mary E. T.,7,0,30,23
1746547046933,COGS 189,A00,886994,Staff,0,1,30,30
1746547047961,COMM 10,A01,886996,Staff,0,0,20,21
1746547047961,COMM 10,A02,886997,Staff,12,0,20,8
1746547047961,COMM 10,A03,959845,Staff,19,0,20,1
1746547048988,COMM 20,A01,886999,Leuning; Grant Maurstad,24,0,40,16
1746547051042,COMM 100A,A01,887002,Staff,0,0,20,25
1746547051042,COMM 100A,A02,887003,Staff,7,0,20,13
1746547052068,COMM 100B,A01,887005,Staff,0,8,20,24
1746547053091,COMM 106D,A00,887006,Staff,14,0,40,26
1746547054116,COMM 110G,A00,887007,Whitworth-Smith; Andrew C,12,0,40,28
1746547055143,COMM 111B,A00,887008,Staff,31,0,40,9
1746547056169,COMM 113T,A00,887009,Abuelhiga; Soraya Jill,28,0,40,12
1746547056169,COMM 113T,B00,906733,Staff,40,0,40,0
1746547057194,COMM 145,A00,887010,Staff,12,0,40,28
1746547058224,COMM 146,A00,887054,Staff,31,0,40,9
1746547059251,COMM 190,A00,887012,Staff,8,0,23,15
1746547060280,CSE 8A,A50,887015,Cao; Yingjun,57,0,85,28
1746547061309,CSE 11,A01,887017,Cao; Yingjun,12,0,70,58
1746547062333,CSE 20,A01,887019,Staff,30,0,50,20
1746547063369,CSE 21,A01,887021,Staff,78,0,100,22
1746547063369,CSE 21,B01,892583,Braun; Oliver,45,0,50,5
1746547064396,CSE 30,A01,887025,Eldon; John,143,0,200,57
1746547065428,CSE 100,A01,887027,Staff,26,0,50,24
1746547065428,CSE 100,A02,887028,Staff,40,0,50,10
1746547066453,CSE 101,A01,887030,Braun; Oliver,75,0,100,25
1746547066453,CSE 101,B01,887032,Jones; Miles E,0,3,50,50
1746547066453,CSE 101,B02,887033,Jones; Miles E,0,1,50,50
1746547067481,CSE 105,A01,908084,Jones; Miles E,32,0,50,18
1746547067481,CSE 105,A02,908087,Jones; Miles E,33,0,50,17
1746547068506,CSE 135,A01,887035,Powell; Thomas Allan,0,4,50,50
1746547069529,CSE 142,A01,887037,Staff,8,0,60,52
1746547070555,CSE 142L,A01,887039,Staff,34,0,60,26
1746547071579,CSE 151A,A01,887041,Solares; Edwin A,48,0,100,52
1746547072604,CSE 175,A01,887043,Kumar; Rakesh,30,0,30,0
1746547073629,CSS 1,A01,886389,Staff,0,1,40,40
1746547074659,DSC 30,A01,908097,Liao; Soohyun Nam,47,0,75,28
1746547075687,DSC 40A,A01,908099,Shannon; Kyle Michael,30,0,50,20
1746547076713,DSC 40B,A01,908112,Staff,16,0,50,34
1746547077739,DSC 80,A01,908116,Staff,19,0,60,41
1746547078764,DSC 197,001,956863,Eldridge; Justin Matthew,9999,0,9999,0
1746547079790,ECE 5,A01,886400,Morris; Karcher William,2,0,6,4
1746547079790,ECE 5,A02,886401,Morris; Karcher William,3,0,6,3
1746547080816,ECE 148,A01,886403,Silberman; Jack,0,14,14,14
1746547081841,ECON 1,A01,887265,Crane; Meredith Helen,12,0,70,58
1746547081841,ECON 1,B01,887268,Staff,43,0,50,7
1746547082869,ECON 2,A01,887273,Crane; Meredith Helen,56,0,70,14
1746547083896,ECON 3,A01,887279,Rondina; Giacomo,32,0,70,38
1746547084923,ECON 4,A01,887282,Anderson; John Charles,0,2,10,10
1746547085952,ECON 5,A01,887285,Staff,33,0,45,12
1746547085952,ECON 5,B01,887292,Staff,41,0,45,4
1746547086981,ECON 100A,A01,887337,Newhouse; Herbert S,54,0,70,16
1746547086981,ECON 100A,B01,887349,Staff,45,0,50,5
1746547088007,ECON 100B,A01,887361,Du; Songzi,29,0,70,41
1746547089035,ECON 100C,A01,887445,Newhouse; Herbert S,59,0,70,11
1746547090072,ECON 105,A00,887488,Vespa; Emanuel Ignacio,23,0,35,12
1746547091101,ECON 109,A01,887506,Shishkin; Denis,28,0,35,7
1746547092132,ECON 110A,A01,887568,Alon; Titan Michael,0,3,35,35
1746547092132,ECON 110A,B01,907601,Alon; Titan Michael,20,0,35,15
1746547093158,ECON 110B,A01,887598,Levkoff; Steven B.,0,23,70,70
1746547094183,ECON 112,A00,887599,Rondina; Giacomo,19,0,35,16
1746547095208,ECON 120A,A01,887603,Dai; Yinlin,36,0,70,34
1746547096234,ECON 120C,A01,887608,Sun; Yixiao,0,1,35,35
1746547096234,ECON 120C,B01,887614,Sun; Yixiao,0,0,35,35
1746547097259,ECON 138,A00,887621,Bharadwaj; Prashant,0,20,20,20
1746547098288,ECON 144,A00,958007,Squires; Dale E,13,0,35,22
1746547099316,ECON 171,A01,907666,Staff,18,0,35,17
1746547100343,ECON 175,A00,887626,Wu; Pak Yeung,23,0,35,12
1746547101370,ECON 190,A00,887640,Vespa; Emanuel Ignacio,23,0,35,12
1746547102411,EDS 25,A01,888197,Staff,0,0,0,0
1746547102411,EDS 25,A02,888209,Staff,0,0,0,0
1746547102411,EDS 25,A03,888210,Staff,0,0,0,0
1746547102411,EDS 25,A04,888212,Staff,0,0,0,0
1746547102411,EDS 25,A05,888213,Staff,0,0,0,0
1746547102411,EDS 25,A06,888214,Staff,0,0,0,0
1746547102411,EDS 25,A07,888235,Staff,0,2,0,0
1746547102411,EDS 25,A08,888236,Staff,0,0,0,0
1746547102411,EDS 25,A09,888240,Staff,0,0,0,0
1746547102411,EDS 25,A10,888244,Staff,0,0,0,0
1746547102411,EDS 25,B01,888273,Staff,0,0,0,0
1746547102411,EDS 25,B02,888285,Staff,0,0,0,0
1746547102411,EDS 25,B03,888423,Staff,0,0,0,1
1746547102411,EDS 25,B04,888432,Staff,0,0,0,0
1746547102411,EDS 25,B05,888433,Staff,0,0,0,0
1746547102411,EDS 25,B06,888467,Staff,0,0,0,0
1746547102411,EDS 25,B07,888468,Staff,0,0,0,0
1746547102411,EDS 25,B08,888479,Staff,0,0,0,0
1746547102411,EDS 25,B09,888484,Staff,0,0,0,0
1746547102411,EDS 25,B10,888487,Staff,0,0,0,0
1746547103438,EDS 38,A01,907700,Choi; Bailey Miyeon,30,0,30,0
1746547104466,EDS 112,A01,888601,Chapman; Thandeka K,14,0,40,26
1746547105492,EDS 115,A00,888697,Mendez; Kathrina Mendoza,10,0,30,20
1746547106518,EDS 116,A01,888893,Staff,35,0,40,5
1746547108576,EDS 124AR,A00,889133,Staff,29,0,50,21
1746547108576,EDS 124AR,B00,907471,Simon; Elizabeth A,37,0,50,13
1746547109604,EDS 124BR,A00,889134,Simon; Elizabeth A,45,0,100,55
1746547110629,EDS 125,A00,889135,Staff,25,0,30,5
1746547111654,EDS 126,A01,889138,Staff,36,0,40,4
1746547112681,EDS 164R,A01,889142,Wishard Guerra; Alison G.,33,0,50,17
1746547113709,ENG 30,A01,886396,Staff,0,0,0,0
1746547113709,ENG 30,B01,886398,Staff,0,0,0,0
1746547114735,ENVR 102,A00,906150,Montejo; Carolina,23,0,25,2
1746547115760,ETHN 103A,A00,887236,Man; Simeon S,0,3,0,0
1746547116787,ETHN 113,A00,887239,Staff,16,0,30,14
1746547117813,ETHN 116,A00,887240,Staff,16,0,25,9
1746547118840,ETHN 117,A00,887241,Choi; Esther Min,28,0,30,2
1746547119868,ETHN 118,A00,887243,Staff,24,0,30,6
1746547120893,ETHN 127,A00,887248,Cuong; Marisol,11,0,15,4
1746547121917,ETHN 139,A00,887250,Staff,7,0,10,3
1746547122943,ETHN 142,A00,887252,Staff,10,0,30,20
1746547123966,ETHN 161,A00,887253,Browne; Errol Tsekani,24,0,30,6
1746547124994,ETHN 163FR,A00,887255,Burelle; Julie Sara Veronique,0,0,5,5
1746547126021,GLBH 20,A00,889149,Elwardani; Nile Regina,8,0,42,34
1746547128073,GLBH 111,A01,889152,Burgos; Jose L.,17,0,17,0
1746547129098,GLBH 150,A00,889181,Sloane; Julia Kathryn,0,5,15,15
1746547131148,HDS 60,A01,886406,Warstadt; Melissa Fawn,73,0,80,7
1746547132174,HIAF 111,A00,889324,Gyamfi; Bright,25,0,32,7
1746547133199,HIEA 131,A00,889328,Staff,16,0,32,16
1746547134223,HIEA 144,A00,889333,Henry; Todd A.,26,0,32,6
1746547135245,HIEA 154,A00,889336,Henry; Todd A.,24,0,32,8
1746547136273,HIEU 106,A00,889339,Staff,22,0,32,10
1746547138328,HIEU 114,A00,889340,Staff,3,0,32,29
1746547139353,HIEU 135GS,A00,889342,Patterson; Patrick H.,0,0,1,24
1746547140378,HIEU 137,A00,889343,Edington; Claire Ellen,9,0,25,16
1746547141421,HIEU 148,A00,889345,Staff,14,0,32,18
1746547142448,HIEU 154,A00,889346,Biess; Frank Peter,21,0,32,11
1746547143474,HILA 102,A00,889351,Staff,12,0,32,20
1746547144502,HILD 2A,A01,889221,Lewandoski; Julia Mavis,1,10,32,31
1746547145528,HILD 7B,A01,889225,Man; Simeon S,0,13,32,32
1746547146555,HILD 7C,A01,889288,Alvarez; Luis A,0,14,32,32
1746547147580,HILD 30,A01,889323,Staff,0,5,32,32
1746547149632,HISC 119,A00,889383,Golan; Tal,21,0,32,11
1746547150662,HIUS 103,A00,889384,Man; Simeon S,0,0,32,32
1746547151686,HIUS 117,A00,919797,Kwak; Nancy,18,0,32,14
1746547152712,HIUS 142A,A00,919788,Staff,22,0,32,10
1746547154763,HIUS 149,A00,889386,Gyamfi; Bright,27,0,32,5
1746547155789,HIUS 155,A00,889387,Alvarez; Luis A,14,0,32,18
1746547156814,HUM 3,A01,886499,Caldwell; Michael Alan,19,0,50,31
1746547157843,HUM 3GS,A00,886500,Rodriguez; Bretton Sigfred,0,0,0,28
1746547158875,HUM 3R,A01,886502,Markman; Kristina,0,36,50,50
1746547159906,HUM 4,A01,886504,Crum; Matthew Stephen,24,0,50,26
1746547159906,HUM 4,B01,886506,West; Geoffrey Scott,17,0,50,33
1746547160932,HUM 4GS,A00,886507,Staff,0,0,0,19
1746547161958,HUM 5,A01,886509,Staff,32,0,50,18
1746547163002,HUM 5R,A01,886511,Zavodny; Tatiana Sophia,0,39,50,50
1746547164028,JAPN 180,A00,886407,Staff,18,0,40,22
1746547165058,LATI 50,A01,886409,Martin-Cabrera; Luis,4,0,22,18
1746547165058,LATI 50,A02,886410,Martin-Cabrera; Luis,19,0,22,3
1746547165058,LATI 50,A03,886411,Martin-Cabrera; Luis,21,0,22,1
1746547165058,LATI 50,A04,886412,Martin-Cabrera; Luis,9,0,22,13
1746547166086,LAWS 101,A00,907664,Staff,28,0,60,32
1746547167117,LIAB 1A,A00,889388,Saab; Dima,17,0,20,3
1746547168143,LIAB 1AX,A00,889389,El Cheddadi; Youniss,17,0,20,3
1746547169167,LIFR 1C,A00,889391,Van Moer; Vinciane G,8,0,20,12
1746547170194,LIFR 1CX,A00,889392,Van Moer; Vinciane G,7,0,20,13
1746547171219,LIFR 1D,A00,889393,Van Moer; Vinciane G,7,0,20,13
1746547172244,LIFR 1DX,A00,889394,Van Moer; Vinciane G,8,0,20,12
1746547173272,LIGN 7,A00,886923,Staff,24,0,50,26
1746547174304,LIGN 17,A00,886924,Kehler; Andrew Scott,125,0,150,25
1746547175334,LTAM 110,A00,889395,Staff,15,0,30,15
1746547176361,LTAM 110GS,A00,958010,Rodriguez; Bretton Sigfred,0,0,0,28
1746547177385,LTCH 101,A00,889397,Staff,23,0,25,2
1746547178424,LTCS 130,A00,889398,Staff,23,0,25,2
1746547179452,LTEA 138,A00,889399,Staff,24,0,40,16
1746547180477,LTEN 149,A00,889400,Wesling; Megan E.,0,3,25,25
1746547181501,LTEN 169,A00,889401,Staff,20,0,25,5
1746547182526,LTEN 180,A00,889402,Staff,10,0,15,5
1746547183554,LTEN 181,A00,889403,Staff,21,0,25,4
1746547184579,LTWL 100,A00,889404,Myerston Santana; Jacobo,3,0,25,22
1746547185604,LTWL 180GS,A00,889405,Staff,0,0,20,20
1746547186627,LTWL 181,A00,889406,Staff,17,0,25,8
1746547187652,LTWL 184,A00,889475,Mukherjee; Silpa,22,0,25,3
1746547188678,LTWR 102C,A00,889486,Staff,29,0,30,1
1746547189704,LTWR 115W,A00,889491,Staff,0,2,15,15
1746547190728,MAE 8,A01,886905,Staff,0,2,0,0
1746547191758,MAE 11,A00,886906,Bandaru; Prabhakar,0,7,50,50
1746547192782,MAE 20,A00,886907,Evdokimenko; Ekaterina,44,0,70,26
1746547193810,MAE 30B,A00,886909,Ghazinejad; Maziar,26,0,45,19
1746547194835,MAE 101B,A00,886910,Saintillan; David,29,0,45,16
1746547195862,MAE 105,A00,886911,Bandaru; Prabhakar,18,0,50,32
1746547196888,MAE 107,B00,958024,Staff,9,0,50,41
1746547197913,MAE 143B,A00,886913,Bewley; Thomas R,7,0,40,33
1746547198937,MAE 148,A01,886915,Silberman; Jack,0,3,14,14
1746547199964,MAE 160,A00,886916,Evdokimenko; Ekaterina,31,0,60,29
1746547200993,MATH 3C,A01,889681,Staff,0,3,30,30
1746547200993,MATH 3C,A02,960048,Staff,25,0,30,5
1746547202018,MATH 10A,A01,889760,Staff,26,0,30,4
1746547202018,MATH 10A,A02,889783,Staff,29,0,30,1
1746547203043,MATH 10B,A01,889785,Verstraete; Jacques Allan,2,0,35,33
1746547203043,MATH 10B,A02,889795,Verstraete; Jacques Allan,4,0,35,31
1746547203043,MATH 10B,B01,889797,Verstraete; Jacques Allan,3,0,35,32
1746547203043,MATH 10B,B02,889828,Verstraete; Jacques Allan,3,0,35,32
1746547204079,MATH 10C,A01,889849,Habib; Yousaf,9,0,30,21
1746547204079,MATH 10C,A02,889852,Habib; Yousaf,14,0,30,16
1746547204079,MATH 10C,A03,889853,Habib; Yousaf,22,0,30,8
1746547204079,MATH 10C,A04,889858,Habib; Yousaf,20,0,30,10
1746547204079,MATH 10C,B01,889861,Staff,1,0,30,29
1746547204079,MATH 10C,B02,889862,Staff,24,0,30,6
1746547204079,MATH 10C,B03,889863,Staff,27,0,30,3
1746547204079,MATH 10C,B04,889967,Staff,23,0,30,7
1746547205103,MATH 18,A01,889974,Staff,7,0,30,23
1746547205103,MATH 18,A02,889977,Staff,20,0,30,10
1746547205103,MATH 18,B01,889984,Hardiman; Liam,22,0,30,8
1746547205103,MATH 18,B02,889985,Hardiman; Liam,25,0,30,5
1746547206128,MATH 20A,A01,889990,Suk; Andrew Hoon,29,0,35,6
1746547207160,MATH 20B,A01,889993,Ohm; Ko Woon,22,0,30,8
1746547207160,MATH 20B,A02,889994,Ohm; Ko Woon,30,0,30,0
1746547207160,MATH 20B,B01,889996,Ohm; Ko Woon,21,0,30,9
1746547207160,MATH 20B,B02,889997,Ohm; Ko Woon,23,0,30,7
1746547208186,MATH 20C,A01,889999,Hammock; Frances H,17,0,30,13
1746547208186,MATH 20C,A02,890003,Hammock; Frances H,23,0,30,7
1746547208186,MATH 20C,B01,890006,Hammock; Frances H,3,0,30,27
1746547208186,MATH 20C,B02,890007,Hammock; Frances H,11,0,30,19
1746547209215,MATH 20D,A01,890011,Cheng; Hsiao-Bing,1,1,30,29
1746547209215,MATH 20D,A02,890012,Cheng; Hsiao-Bing,14,0,30,16
1746547209215,MATH 20D,B01,890016,Cheng; Hsiao-Bing,13,0,30,17
1746547209215,MATH 20D,B02,890017,Cheng; Hsiao-Bing,13,0,30,17
1746547210241,MATH 20E,A01,890026,Harel; Guershon,1,0,30,29
1746547210241,MATH 20E,A02,890029,Harel; Guershon,23,0,30,7
1746547210241,MATH 20E,B01,890033,Harel; Guershon,7,0,30,23
1746547210241,MATH 20E,B02,890101,Harel; Guershon,21,0,30,9
1746547211265,MATH 102,A01,890104,Staff,17,0,30,13
1746547211265,MATH 102,A02,890105,Staff,27,0,30,3
1746547212290,MATH 103B,A01,890116,Salehi Golsefidy; Alireza,3,0,30,27
1746547212290,MATH 103B,B01,890118,Staff,0,3,34,34
1746547213320,MATH 109,A01,890121,Aliabadi Sr.; Mohsen,1,0,30,29
1746547213320,MATH 109,B01,890124,Upadrashta; Pranav Kumar,18,0,30,12
1746547214345,MATH 120A,A01,890126,Eggers; John Dietrich,13,0,30,17
1746547215371,MATH 142B,A01,890128,Ioana; Adrian,19,0,30,11
1746547215371,MATH 142B,A02,890129,Ioana; Adrian,13,0,30,17
1746547216399,MATH 154,A01,890174,Staff,0,0,30,30
1746547216399,MATH 154,A02,890182,Staff,0,0,30,30
1746547217428,MATH 168A,A01,890197,Dumitriu; Ioana,21,0,35,14
1746547218456,MATH 170A,A01,890240,Nie; Jiawang,1,0,30,29
1746547218456,MATH 170A,A02,890241,Nie; Jiawang,11,0,30,19
1746547218456,MATH 170A,A03,890249,Nie; Jiawang,23,0,30,7
1746547219480,MATH 170B,A01,957891,Nag; Panchali,13,0,35,22
1746547221543,MATH 181A,A01,908025,Staff,0,4,35,35
1746547221543,MATH 181A,A02,960115,Staff,27,0,35,8
1746547222568,MATH 181B,A01,959874,Staff,26,0,30,4
1746547223596,MATH 193B,A01,890265,Staff,0,4,35,35
1746547224620,MGT 4,A01,890311,Anderson; John Charles,42,0,88,46
1746547225644,MGT 5,A00,907740,Staff,13,0,98,85
1746547226670,MGT 12,A00,890312,Lindenberger; Wade Douglas,67,0,98,31
1746547227698,MGT 16,A00,957883,Staff,78,0,98,20
1746547229755,MGT 45,A00,890314,Pecore; Joseph P.,47,0,98,51
1746547230785,MGT 71,A00,890315,Staff,0,11,98,98
1746547231810,MGT 100,A00,890316,Yavorsky; Daniel Ryan,44,0,98,54
1746547232836,MGT 103,A00,890317,Ehrich; Kristine R,73,0,98,25
1746547233861,MGT 105,A00,890356,Bates; Kenneth Walter,0,7,98,98
1746547234885,MGT 112,A00,890360,Ehrich; Kristine R,55,0,98,43
1746547235913,MGT 127R,A00,907732,Zhu; Kevin Xiaoguo,23,0,98,75
1746547236938,MGT 131B,A00,890361,Anderson; John Charles,61,0,98,37
1746547237965,MGT 137,A00,890362,Lindenberger; Wade Douglas,65,0,98,33
1746547238992,MGT 160,A00,890369,Johnson; Erik Barry,9,0,98,89
1746547241042,MGT 164,A00,890372,Zimmermann; Carsten,0,39,98,98
1746547242069,MGT 180,A00,890374,Bliss; Barbara Ann,12,0,98,86
1746547243096,MMW 15,A01,886414,Chang; Edmond Yi-Teh,0,12,28,28
1746547243096,MMW 15,A02,886415,Chang; Edmond Yi-Teh,0,8,28,28
1746547243096,MMW 15,A03,886416,Chang; Edmond Yi-Teh,0,8,28,28
1746547243096,MMW 15,A04,886417,Chang; Edmond Yi-Teh,0,8,28,28
1746547243096,MMW 15,B01,886419,Chang; Edmond Yi-Teh,0,7,28,28
1746547243096,MMW 15,B02,886420,Chang; Edmond Yi-Teh,0,8,28,28
1746547243096,MMW 15,B03,886421,Chang; Edmond Yi-Teh,0,7,28,28
1746547243096,MMW 15,B04,886422,Chang; Edmond Yi-Teh,0,8,28,28
1746547243096,MMW 15,C01,886424,Staff,0,9,28,28
1746547243096,MMW 15,C02,886425,Staff,0,8,28,28
1746547243096,MMW 15,C03,886426,Staff,0,8,28,28
1746547243096,MMW 15,C04,886427,Staff,0,7,28,28
1746547243096,MMW 15,C05,958038,Staff,0,7,28,28
1746547243096,MMW 15,C06,958039,Staff,0,8,28,28
1746547244119,MMW 15GS,A00,906910,Patterson; Patrick H.,4,0,28,24
1746547245143,MMW 122R,A01,886429,Rahimi; Babak,0,13,28,28
1746547245143,MMW 122R,A02,886430,Rahimi; Babak,0,12,28,28
1746547245143,MMW 122R,A03,958040,Rahimi; Babak,0,11,28,28
1746547246170,MUS 1A,A01,890937,Staff,3,0,25,22
1746547246170,MUS 1A,A02,891035,Staff,6,0,25,19
1746547246170,MUS 1A,C01,958912,Staff,24,0,25,1
1746547246170,MUS 1A,C02,958913,Staff,25,0,25,0
1746547248222,MUS 2AK,A00,957092,Ohnishi; Takae,15,0,15,0
1746547249269,MUS 4,A01,891044,Staff,2,0,25,23
1746547249269,MUS 4,A02,891045,Staff,23,0,25,2
1746547249269,MUS 4,B01,891048,Staff,17,0,25,8
1746547249269,MUS 4,B02,891050,Staff,25,0,25,0
1746547250297,MUS 5,A01,957506,Dubnov; Shlomo,0,0,25,25
1746547250297,MUS 5,A02,957622,Dubnov; Shlomo,14,0,25,11
1746547250297,MUS 5,A03,957623,Dubnov; Shlomo,20,0,25,5
1746547251327,MUS 6,A01,891053,Freitas Caetano; Marcelo,24,0,25,1
1746547251327,MUS 6,A02,891054,Freitas Caetano; Marcelo,23,0,25,2
1746547252352,MUS 7,A01,891081,Staff,0,0,25,25
1746547252352,MUS 7,A02,891082,Staff,4,0,25,21
1746547253381,MUS 8GS,A00,891118,Borgo; David Garcia,0,0,25,25
1746547254406,MUS 11,A01,891140,Staff,11,0,25,14
1746547254406,MUS 11,A02,891141,Staff,22,0,25,3
1746547255432,MUS 13,A01,891143,Staff,8,0,25,17
1746547255432,MUS 13,A02,891144,Staff,24,0,25,1
1746547256458,MUS 15,A01,891146,Staff,9,0,25,16
1746547256458,MUS 15,A02,891148,Staff,21,0,25,4
1746547256458,MUS 15,B01,891150,Staff,18,0,25,7
1746547256458,MUS 15,B02,891151,Staff,25,0,25,0
1746547257486,MUS 20,A01,891153,Staff,5,0,20,15
1746547257486,MUS 20,A02,891155,Staff,14,0,20,6
1746547258511,MUS 80,A00,891156,Staff,19,0,25,6
1746547258511,MUS 80,B00,891157,Staff,23,0,25,2
1746547259539,MUS 130,A00,891158,Ohnishi; Takae,35,0,35,0
1746547260567,MUS 150GS,A01,891160,Borgo; David Garcia,0,0,25,25
1746547261592,MUS 170,A01,891162,Freitas Caetano; Marcelo,20,0,25,5
1746547261592,MUS 170,A02,891164,Freitas Caetano; Marcelo,21,0,25,4
1746547262624,NANO 11,A00,886220,Vazquez Mena; Oscar,13,0,15,2
1746547263648,NANO 15,A01,886222,Drews; Aaron,4,0,7,3
1746547264674,NANO 104,A00,886224,Sirbuly; Donald,18,0,25,7
1746547265698,PH 40,A00,886528,Staff,23,0,40,17
1746547266725,PH 45,A01,886799,Staff,35,0,40,5
1746547267754,PH 110,A00,886802,Staff,0,7,40,40
1746547268779,PH 172,A00,906716,Staff,19,0,35,16
1746547269803,PH 191,A00,886803,Staff,6,0,40,34
1746547270832,PHIL 1,A00,889500,Staff,19,0,30,11
1746547271857,PHIL 10,A01,889549,Grush; Rick Scott,15,0,22,7
1746547271857,PHIL 10,A02,889551,Grush; Rick Scott,22,0,22,0
1746547272885,PHIL 28,A01,889559,Lamey; Andy M.,0,1,31,31
1746547272885,PHIL 28,A02,889561,Lamey; Andy M.,0,1,30,30
1746547272885,PHIL 28,A03,889572,Lamey; Andy M.,0,0,30,30
1746547273913,PHIL 35,A00,907839,Staff,13,0,15,2
1746547274937,PHIL 60,A00,889574,Staff,74,0,90,16
1746547275961,PHIL 101,A00,958004,Staff,13,0,15,2
1746547278017,PHIL 136,A00,889582,Fulkerson; Matthew Todd,26,0,45,19
1746547279045,PHIL 163,A01,889601,Staff,21,0,30,9
1746547279045,PHIL 163,B01,889606,Brandt; Reuven A,0,3,0,0
1746547280070,PHIL 164,A00,889610,Staff,16,0,30,14
1746547281097,PHIL 165,A00,889613,Staff,23,0,30,7
1746547282123,PHYS 1A,A00,886431,Staff,26,0,70,44
1746547283148,PHYS 1AL,001,886432,Tsai; Philbert S,0,2,30,30
1746547283148,PHYS 1AL,002,886436,Tsai; Philbert S,11,0,30,19
1746547284176,PHYS 1B,A00,886439,Staff,185,0,240,55
1746547285201,PHYS 1BL,001,886441,Tsai; Philbert S,0,4,30,30
1746547285201,PHYS 1BL,002,886444,Tsai; Philbert S,2,0,30,28
1746547286227,PHYS 1C,A00,896092,Arnold; Kam S,78,0,146,68
1746547287252,PHYS 1CL,001,886448,Tsai; Philbert S,0,0,30,30
1746547287252,PHYS 1CL,002,886449,Tsai; Philbert S,0,0,30,30
1746547287252,PHYS 1CL,003,886450,Tsai; Philbert S,16,0,30,14
1746547287252,PHYS 1CL,004,886451,Tsai; Philbert S,15,0,30,15
1746547288279,PHYS 2B,A01,886457,Staff,69,0,115,46
1746547289306,PHYS 2C,A01,886460,Shotwell; Brian,0,8,65,65
1746547290330,PHYS 2CL,A01,886467,Staff,0,4,28,28
1746547290330,PHYS 2CL,A02,886468,Staff,0,3,28,28
1746547291358,PHYS 2D,A01,886470,Staff,10,0,50,40
1746547292397,PHYS 4B,A01,886475,Grinstein; Benjamin,22,0,40,18
1746547293422,POLI 5,A00,891173,Desposato; Scott,7,0,25,18
1746547294450,POLI 5D,A01,891175,Staff,5,0,5,0
1746547294450,POLI 5D,B01,891178,Staff,5,0,5,0
1746547295477,POLI 11,A00,891179,Ferree; Karen E,2,0,35,33
1746547296506,POLI 12,A00,891180,Staff,16,0,30,14
1746547297533,POLI 27,A01,891182,Staff,12,0,75,63
1746547298560,POLI 30,A00,891183,Staff,8,0,50,42
1746547299592,POLI 100B,A00,891244,Staff,5,1,35,30
1746547300617,POLI 100I,A00,891247,Staff,7,0,30,23
1746547301646,POLI 104J,A00,891248,Nichter; Maysa,14,0,30,16
1746547302674,POLI 104U,A00,891250,Nichter; Maysa,2,0,30,28
1746547304729,POLI 110B,A00,891255,Wiens; David,20,0,25,5
1746547305754,POLI 112A,A00,891256,Wiens; David,6,0,25,19
1746547306778,POLI 114BR,A00,891261,Staff,19,0,30,11
1746547307804,POLI 117R,A00,891262,Forman; Fonna,0,6,50,50
1746547308857,POLI 118,A00,891264,Ingham; Sean,17,0,25,8
1746547309887,POLI 124A,A00,891265,Staff,18,0,20,2
1746547310912,POLI 125D,A00,891266,Nichter; Simeon C,2,0,25,23
1746547311937,POLI 126,A00,891268,Nichter; Simeon C,7,0,25,18
1746547312962,POLI 126AA,A00,891272,Staff,18,0,25,7
1746547313987,POLI 130AA,A00,891273,Staff,15,0,20,5
1746547315020,POLI 134AA,A00,891274,Staff,4,0,20,16
1746547317071,POLI 138,A00,891278,Staff,21,0,25,4
1746547318097,POLI 142K,A00,891280,Staff,11,0,25,14
1746547319122,POLI 142M,A00,891281,Gartzke; Erik,17,0,30,13
1746547320147,POLI 142P,A00,891284,Staff,20,0,30,10
1746547321173,POLI 143,A00,891285,Gartzke; Erik,12,0,30,18
1746547322197,POLI 153,A00,891286,Staff,19,0,20,1
1746547324252,POLI 175,A00,891290,Staff,15,0,20,5
1746547325277,PSYC 1,A00,890674,Steiner; Eric Tomas,0,11,45,45
1746547326304,PSYC 2,A00,890676,Albright; Thomas D,21,0,35,14
1746547327354,PSYC 3,A00,890679,Staff,17,0,20,3
1746547328378,PSYC 6,A00,959858,Staff,20,0,20,0
1746547329403,PSYC 60,A01,890684,Rickard; Timothy C.,0,5,45,45
1746547330428,PSYC 70,A01,890689,Geller; Emma Harlan,7,0,30,23
1746547331455,PSYC 71,A01,959860,Staff,21,0,25,4
1746547332480,PSYC 100,A00,890690,Lacefield; Katharine I,0,50,180,180
1746547333504,PSYC 102,A00,890695,Staff,18,0,40,22
1746547334531,PSYC 105,A00,890699,Geller; Emma Harlan,71,0,100,29
1746547335557,PSYC 106,A00,890701,Gorman; Michael R.,5,0,30,25
1746547336585,PSYC 108,A00,890704,Adrian; Julia Anna,0,28,50,50
1746547337611,PSYC 118,A01,890712,Staff,11,0,30,19
1746547338639,PSYC 124,A00,890716,Chapman; Eddie Nathaniel,25,0,60,35
1746547339665,PSYC 131,A00,890717,Anagnostaras; Stephan,0,7,80,80
1746547340693,PSYC 137,A00,890719,Winkielman; Piotr,0,11,30,30
1746547341722,PSYC 144,A00,890721,Adrian; Julia Anna,0,9,45,45
1746547342748,PSYC 162,A00,890805,Staff,2,0,75,73
1746547343773,PSYC 169,A00,890810,Staff,0,15,30,30
1746547344798,PSYC 172,A00,890814,Gorman; Michael R.,9,0,30,21
1746547345822,PSYC 181,A00,890818,Anagnostaras; Stephan,8,0,200,192
1746547346847,PSYC 184,A00,959861,Staff,170,0,175,5
1746547347874,PSYC 189,A00,890823,Staff,0,1,30,30
1746547348900,PSYC 191,A00,890884,Rickard; Timothy C.,0,11,35,35
1746547349926,PSYC 193,A00,890913,Staff,19,0,30,11
1746547349926,PSYC 193,B00,890914,Chapman; Eddie Nathaniel,24,0,30,6
1746547350952,PSYC 193L,A01,890918,Lowe; Angela Beth,20,0,30,10
1746547350952,PSYC 193L,B01,890921,Hurwitz; Ethan Scott,20,0,30,10
1746547350952,PSYC 193L,C01,890928,Staff,30,0,30,0
1746547351978,RELI 149,A00,886806,Rahimi; Babak,23,0,40,17
1746547353005,SE 9,A01,886814,Staff,7,0,20,13
1746547354028,SE 101B,A01,886816,Chadha; Mayank,4,0,35,31
1746547355054,SE 110B,A00,886818,Zhu; Qiang,4,0,75,71
1746547356078,SE 125,A01,886830,Staff,10,0,30,20
1746547357103,SE 130B,A01,886835,Staff,14,0,40,26
1746547358130,SE 131A,A01,886838,Krysl; Petr,34,0,55,21
1746547359157,SE 154,A00,886840,Staff,30,0,50,20
1746547360184,SE 164GS,A01,886849,Staff,6,0,20,14
1746547361210,SE 167GS,A01,886853,Staff,6,0,20,14
1746547362236,SIO 25,A01,890107,Staff,19,0,30,11
1746547363265,SIO 45,A00,890109,Cook; Geoffrey W,117,0,200,83
1746547364290,SIO 109R,A00,890110,Forman; Fonna,0,16,20,20
1746547365318,SIO 187,A01,890114,Kacev; David,15,0,40,25
1746547366349,SOCI 1,A01,890431,Thorpe; Charles Robert,15,0,30,15
1746547366349,SOCI 1,A02,890518,Thorpe; Charles Robert,30,0,30,0
1746547367375,SOCI 2,A01,957978,Staff,25,0,25,0
1746547367375,SOCI 2,A02,957979,Staff,23,0,25,2
1746547368399,SOCI 20,A01,890523,Calderon-Zaks; Michael Aar,23,0,30,7
1746547368399,SOCI 20,A02,890526,Calderon-Zaks; Michael Aar,29,0,30,1
1746547369424,SOCI 30,A01,890533,Pardo Guerra; Juan Pablo,37,0,40,3
1746547370450,SOCI 40,A01,890535,Staff,27,0,45,18
1746547371480,SOCI 104Q,A00,890559,Staff,18,0,30,12
1746547372508,SOCI 106,A00,890560,Arnal; Maud Marie Leonie,20,0,30,10
1746547373532,SOCI 110,A00,890567,Holkenbrink-Monk; Charlene,19,0,30,11
1746547374561,SOCI 112,A00,890568,Victoria Torres; Pablo,1,0,55,54
1746547375588,SOCI 115,A00,890597,Arnal; Maud Marie Leonie,28,0,45,17
1746547377643,SOCI 121,A00,890604,Pardo Guerra; Juan Pablo,38,0,45,7
1746547378671,SOCI 126,A01,890608,Staff,8,0,10,2
1746547379698,SOCI 127,A00,890609,Staff,18,0,30,12
1746547380726,SOCI 131,A00,890610,Thorpe; Charles Robert,37,0,45,8
1746547381751,SOCI 135,A00,890615,Payne; Christine Anna,14,0,45,31
1746547382807,SOCI 139,A00,890620,Staff,38,0,45,7
1746547383831,SOCI 148E,A00,890622,Calderon-Zaks; Michael Aar,36,0,45,9
1746547384856,SOCI 150,A00,890623,Kohler; Kristopher M.,31,0,45,14
1746547385880,SOCI 157,A00,890625,Jules-Rosette; Bennetta W.,18,0,20,2
1746547386906,SOCI 160,A00,890627,Payne; Christine Anna,21,0,45,24
1746547387929,SYN 1,A00,886855,Fish; Gwendolyn Anne,0,0,0,0
1746547387929,SYN 1,B00,906086,Fish; Gwendolyn Anne,0,1,0,2
1746547388954,SYN 2R,A00,886860,Staff,0,17,15,15
1746547388954,SYN 2R,B00,906106,Atkinson; Arthur Laird,0,16,15,15
1746547389994,SYN 100,A01,886866,Browne; Emily,0,28,20,20
1746547389994,SYN 100,B01,906128,Rock; Martin,0,5,20,20
1746547389994,SYN 100,C01,906140,Deavenport; James Cary,0,3,20,20
1746547389994,SYN 100,D01,907816,Deavenport; James Cary,0,5,20,20
1746547391019,TDAC 1,A00,890286,Walsh; Kim C.,9,0,20,11
1746547392045,TDAC 101,A00,890296,Basso; Beatrice,16,0,20,4
1746547393070,TDDE 131,A00,890297,Staff,47,0,50,3
1746547394097,TDDM 1,A00,890287,Weinberg; Sadie,25,0,30,5
1746547395126,TDGE 11,A00,890288,Fulton; Julia,137,0,200,63
1746547395126,TDGE 11,B00,890289,Castro; Robert Jess,184,0,200,16
1746547396152,TDGE 25,B00,957359,Walsh; Kim C.,3,0,20,17
1746547397179,TDGE 40,A01,890292,Power; Jade Yukana,27,0,30,3
1746547398208,TDGE 124,A00,890298,Havis; Allan,0,0,50,50
1746547399232,TDGE 131R,A00,890299,Burelle; Julie Sara Veronique,15,0,42,27
1746547400256,TDHT 101,A00,890300,Staff,10,0,20,10
1746547401282,TDHT 109,A01,890302,Anderson; Mysia Anyse,31,0,40,9
1746547402305,TDMV 1,A00,890293,Arcidiacono; Kristin,18,0,30,12
1746547403333,TDMV 2,A00,890294,Weinberg; Sadie,23,0,30,7
1746547404361,TDMV 3,A00,957878,Arcidiacono; Kristin,28,0,30,2
1746547406410,TDMV 138,A00,890304,Jun; Grace Shin Hae,25,0,40,15
1746547407437,TDMV 140,A00,890305,Corrales; Joseph Bernales,25,0,30,5
1746547408463,TDMV 142,A00,890307,Caligagan; Tony,32,0,40,8
1746547409490,TDMV 144,A00,890308,Camaya; Michelle Ann,25,0,30,5
1746547410516,TDPW 1,A00,890295,Stein; Deborah Isobel,3,0,20,17
1746547411541,USP 2,A01,890272,Lerner; Amy M,6,0,20,14
1746547412565,USP 3,A01,890274,Staff,12,0,30,18
1746547413591,USP 15,A01,890276,Sun; Feiyang,17,0,30,13
1746547414616,USP 25,A00,890277,Shenkman; Michael Thomas,19,0,25,6
1746547415641,USP 138,A00,890278,Staff,13,0,25,12
1746547416668,USP 143,A00,890279,Staff,21,0,70,49
1746547417695,USP 144,A00,890280,Chowdhury; Muhammed Zohir,16,0,30,14
1746547418719,USP 150,A00,890281,Boomhower; Matthew Charles,4,0,30,26
1746547419748,USP 151,A00,890282,Staff,16,0,20,4
1746547420775,USP 162,A00,890283,Andrews; Abigail Leslie,16,0,20,4
1746547421802,USP 168,A00,920477,Kwak; Nancy,1,0,5,4
1746547422829,USP 181,A00,890284,Staff,3,0,20,17
1746547423854,USP 191A,A00,890285,Staff,13,0,20,7
1746547424881,VIS 101,A00,886512,Staff,25,0,75,50
1746547425907,VIS 103,A00,886513,Cruz; Edwin Teddy,61,0,75,14
1746547426939,VIS 108,A00,886514,Staff,3,0,15,12
1746547427966,VIS 127P,A00,886515,Shen; Kuiyi,80,0,146,66
1746547428989,VIS 149,A00,886516,Yoldas; Pinar,0,0,15,15
1746547430016,VIS 164,A00,886526,Erdmann; Dean,19,0,22,3
1746547431043,VIS 194S,A00,886527,Staff,61,0,75,14
1746547432069,WCWP 10A,C00,886484,Martiniuk; Jill,12,0,15,3
1746547433094,WCWP 10B,A00,886490,Uriarte; Emma,0,0,15,15
1746547433094,WCWP 10B,B00,886491,Dhir; Simrita,10,0,15,5
1746547433094,WCWP 10B,C00,886492,Ornelas; Tricia,0,0,15,15
1746547434123,WCWP 100,A00,886494,Young; Mark T,0,7,15,15
1746547436237,AAS 10,A01,886199,Childs; Dennis R.,0,3,0,0
1746547437265,ANAR 104,A01,886940,Shtienberg; Gilad,27,0,30,3
1746547438290,ANAR 120,A00,886953,Staff,12,0,20,8
1746547439318,ANBI 148,A01,886955,Wilder; Linnea Lorene,30,0,40,10
1746547441366,ANSC 122,A00,886957,Staff,25,0,30,5
1746547442391,ANSC 150,A00,886958,Sloane; Julia Kathryn,3,0,15,12
1746547443420,ANSC 156,A00,886959,Jenkins; Janis A.,0,1,15,15
1746547444444,ANSC 180,A00,886960,Staff,11,0,17,6
1746547445467,ANSC 188,A00,886961,Jassal; Aftab,9,0,25,16
1746547446495,ANSC 190,A00,886962,Jassal; Aftab,14,0,25,11
1746547447519,ANSC 191,A00,886963,Staff,18,0,20,2
1746547448545,ANTH 3,A01,891689,Staff,17,0,20,3
1746547449571,ANTH 5,A00,886933,Semendeferi; Ekaterini,16,0,20,4
1746547450596,ANTH 10,A00,886934,Staff,0,12,30,30
1746547451622,ANTH 21,A01,886936,Staff,40,0,60,20
1746547452647,ANTH 23,A01,886938,Staff,92,0,100,8
1746547453671,ANTH 105,A00,886964,Stewart; Alexander B,84,0,100,16
1746547454698,ANTH 108,A00,886965,Pedersen; David,9,0,20,11
1746547455729,AWP 10,001,886147,Staff,0,0,0,0
1746547455729,AWP 10,002,886148,Staff,0,0,0,0
1746547455729,AWP 10,003,886149,Staff,0,0,0,0
1746547455729,AWP 10,004,886150,Staff,0,0,0,0
1746547455729,AWP 10,005,886151,Staff,0,0,0,0
1746547455729,AWP 10,006,886152,Staff,0,0,0,0
1746547455729,AWP 10,007,886153,Staff,0,0,0,0
1746547455729,AWP 10,008,886154,Staff,0,0,0,0
1746547455729,AWP 10,009,886155,Staff,0,0,0,0
1746547455729,AWP 10,010,886156,Staff,0,0,0,0
1746547455729,AWP 10,011,886158,Staff,0,0,0,0
1746547455729,AWP 10,012,886160,Staff,0,0,0,0
1746547455729,AWP 10,013,886161,Staff,0,0,0,0
1746547455729,AWP 10,014,886162,Staff,0,0,0,0
1746547455729,AWP 10,015,886163,Staff,0,0,0,0
1746547455729,AWP 10,016,886164,Staff,0,0,0,0
1746547455729,AWP 10,017,886165,Staff,0,0,0,0
1746547455729,AWP 10,018,886166,Staff,0,0,0,0
1746547455729,AWP 10,019,886168,Staff,0,0,0,0
1746547455729,AWP 10,020,886170,Staff,0,0,0,0
1746547455729,AWP 10,021,886172,Staff,0,0,0,0
1746547456757,AWP 10R,001,886173,Staff,0,1,0,0
1746547456757,AWP 10R,002,886174,Staff,0,1,0,0
1746547456757,AWP 10R,003,886175,Staff,0,0,0,0
1746547456757,AWP 10R,004,886176,Staff,0,0,0,0
1746547456757,AWP 10R,005,886177,Staff,0,0,0,0
1746547456757,AWP 10R,006,886178,Staff,0,0,0,0
1746547456757,AWP 10R,007,886179,Staff,0,0,0,0
1746547456757,AWP 10R,008,886181,Staff,0,0,0,0
1746547456757,AWP 10R,009,886182,Staff,0,0,0,0
1746547456757,AWP 10R,010,886183,Staff,0,0,0,0
1746547456757,AWP 10R,011,886184,Staff,0,0,0,0
1746547456757,AWP 10R,012,886185,Staff,0,0,0,0
1746547456757,AWP 10R,013,886186,Staff,0,0,0,0
1746547456757,AWP 10R,014,886187,Staff,0,0,0,0
1746547456757,AWP 10R,015,886188,Staff,0,0,0,0
1746547456757,AWP 10R,016,886189,Staff,0,0,0,0
1746547457785,AWP 102R,A00,886190,Staff,0,0,0,0
1746547457785,AWP 102R,B00,886191,Staff,0,0,0,0
1746547458809,BENG 100,A01,886193,Staff,17,0,30,13
1746547459834,BENG 122A,A01,886195,Hasty; Jeff M,13,0,30,17
1746547460916,BENG 166A,A00,886196,Sah; Robert Lie-Yuan,0,1,30,30
1746547461941,BENG 190,A00,958050,Khojah; Reem I,24,0,25,1
1746547462966,BIBC 102,A01,894320,Staff,0,0,46,46
1746547462966,BIBC 102,A02,894321,Staff,0,0,46,46
1746547462966,BIBC 102,A03,894344,Staff,7,0,46,39
1746547462966,BIBC 102,A04,894345,Staff,26,0,47,21
1746547463991,BICD 100R,A01,894365,Smith; Laurie,0,3,58,58
1746547463991,BICD 100R,A02,894366,Smith; Laurie,0,5,58,58
1746547463991,BICD 100R,A03,894367,Smith; Laurie,2,0,59,57
1746547463991,BICD 100R,A04,959869,Smith; Laurie,41,0,59,18
1746547465017,BICD 136,A01,894383,Gustafson-Brown; Cindy,14,0,50,36
1746547466045,BIEB 102,A01,894494,Butler; Shannon Rhey,51,0,130,79
1746547468103,BIEB 150,A01,894617,Wills; Christopher,3,0,20,17
1746547468103,BIEB 150,A02,894631,Wills; Christopher,3,0,20,17
1746547468103,BIEB 150,A03,894937,Wills; Christopher,3,0,20,17
1746547468103,BIEB 150,A04,894946,Wills; Christopher,5,0,20,15
1746547469131,BIEB 194,A00,906141,Kurle; Carolyn M.,6,0,20,14
1746547470160,BILD 1,A01,894154,Staff,2,0,19,17
1746547470160,BILD 1,A02,894155,Staff,14,0,19,5
1746547470160,BILD 1,A03,894160,Staff,13,0,19,6
1746547470160,BILD 1,A04,894161,Staff,15,0,18,3
1746547471184,BILD 2,A01,894168,Staff,0,0,50,50
1746547471184,BILD 2,A02,894169,Staff,0,0,50,50
1746547471184,BILD 2,A03,894179,Staff,4,0,50,46
1746547471184,BILD 2,A04,894203,Staff,27,0,50,23
1746547472211,BILD 3,A01,894213,Staff,22,0,31,9
1746547472211,BILD 3,A02,894214,Staff,26,0,31,5
1746547472211,BILD 3,A03,894235,Staff,28,0,31,3
1746547472211,BILD 3,A04,894236,Staff,28,0,32,4
1746547473238,BILD 4,A01,894253,Reuther; Keefe,5,0,24,19
1746547473238,BILD 4,A02,894258,Reuther; Keefe,16,0,24,8
1746547474263,BILD 5,A01,894276,Reuther; Keefe,35,0,50,15
1746547474263,BILD 5,A02,894277,Reuther; Keefe,45,0,50,5
1746547474263,BILD 5,A03,894290,Reuther; Keefe,44,0,50,6
1746547474263,BILD 5,A04,894291,Reuther; Keefe,48,0,50,2
1746547475294,BILD 24,A01,894297,Pirino; Giorgia,40,0,60,20
1746547476322,BIMM 100,B01,958915,Staff,72,0,100,28
1746547477348,BIMM 101,A01,895017,McDonnell; Lisa Marie,0,5,24,24
1746547477348,BIMM 101,A02,895018,McDonnell; Lisa Marie,0,5,24,24
1746547477348,BIMM 101,B01,895020,McDonnell; Lisa Marie,0,6,24,24
1746547477348,BIMM 101,B02,895021,McDonnell; Lisa Marie,0,4,24,24
1746547478376,BIMM 110,A01,895023,Staff,1,0,25,24
1746547478376,BIMM 110,A02,895024,Staff,9,0,25,16
1746547478376,BIMM 110,A03,895025,Staff,18,0,25,7
1746547478376,BIMM 110,A04,895031,Staff,20,0,25,5
1746547479402,BIMM 120,A01,895114,Gustafson-Brown; Cindy,13,0,28,15
1746547479402,BIMM 120,A02,895126,Gustafson-Brown; Cindy,21,0,27,6
1746547480426,BIPN 100,A01,895130,Yang; Mingyu,1,0,38,37
1746547480426,BIPN 100,A02,895131,Yang; Mingyu,32,0,38,6
1746547480426,BIPN 100,A03,895132,Yang; Mingyu,32,0,38,6
1746547480426,BIPN 100,A04,895133,Yang; Mingyu,27,0,36,9
1746547481456,BIPN 120,A01,895135,Cooke; James Edward,0,3,13,13
1746547481456,BIPN 120,A02,895136,Cooke; James Edward,0,1,13,13
1746547481456,BIPN 120,A03,895137,Cooke; James Edward,0,3,13,13
1746547481456,BIPN 120,A04,895156,Cooke; James Edward,0,2,11,11
1746547482482,BIPN 134,A01,895235,Cooke; James Edward,0,2,25,25
1746547482482,BIPN 134,A02,895237,Cooke; James Edward,0,0,25,25
1746547482482,BIPN 134,A03,895240,Cooke; James Edward,3,0,25,22
1746547482482,BIPN 134,A04,895270,Cooke; James Edward,20,0,25,5
1746547483509,BIPN 189,A00,892103,Staff,0,13,14,14
1746547485562,BISP 194,A00,958008,Staff,0,2,0,0
1746547486586,CAT 124,A01,922009,Staff,0,5,20,20
1746547487613,CAT 125R,A00,886390,Morales; Celeste Georgianna,0,2,20,20
1746547487613,CAT 125R,B00,886391,Irwin; Matthew Joseph,0,3,20,20
1746547487613,CAT 125R,C00,886392,Smith; Lauryn Alissa,0,2,20,20
1746547487613,CAT 125R,D00,886393,Vanderschuit; Maya Alysia,0,2,20,20
1746547487613,CAT 125R,E00,886394,Marchisotto; Jennifer Anne,0,4,20,20
1746547488642,CENG 15,A01,886218,Drews; Aaron,3,0,8,5
1746547489669,CENG 113,A00,886219,Opatkiewicz; Justin Paul,15,0,25,10
1746547490695,CGS 101,A00,887044,Staff,7,0,20,13
1746547491720,CGS 105,A01,887046,Staff,14,0,25,11
1746547492745,CGS 112,A00,887047,Cuong; Marisol,12,0,15,3
1746547493774,CGS 113,A00,887048,Staff,23,0,30,7
1746547494802,CGS 120,A00,887049,Staff,10,0,17,7
1746547495832,CHEM 6A,A01,886336,Lam; Tin Yiu,38,0,50,12
1746547495832,CHEM 6A,A02,886338,Lam; Tin Yiu,37,0,50,13
1746547496858,CHEM 6B,A01,886341,Hopkins; Patrycja Anna,16,0,50,34
1746547496858,CHEM 6B,A02,886343,Hopkins; Patrycja Anna,42,0,50,8
1746547497888,CHEM 6C,A01,886346,Albizati; Kim F.,0,2,50,50
1746547497888,CHEM 6C,A02,886348,Albizati; Kim F.,23,0,50,27
1746547498917,CHEM 40A,A01,886352,Klosterman; Jeremy K,65,0,100,35
1746547499943,CHEM 40B,A01,886356,Klosterman; Jeremy K,0,23,100,100
1746547500969,CHEM 41B,A01,886360,Theodorakis; Emmanuel,25,0,50,25
1746547500969,CHEM 41B,A02,886362,Theodorakis; Emmanuel,47,0,50,3
1746547501998,CHIN 165A,A00,886382,Xu; Li,18,0,20,2
1746547503026,CLAS 120,A00,886387,Myerston Santana; Jacobo,33,0,40,7
1746547504055,COGS 9,A01,886967,Shannon; Kyle Michael,42,0,60,18
1746547505084,COGS 11,A01,886969,Staff,11,0,30,19
1746547506110,COGS 14A,A01,886971,Staff,6,0,60,54
1746547507135,COGS 14B,A01,886973,Hoffman; Drew Ellen,4,0,60,56
1746547508160,COGS 18,A01,886975,Morgan; Eric,35,0,60,25
1746547509186,COGS 20,A01,886977,Staff,4,0,8,4
1746547509186,COGS 20,A02,886978,Staff,5,0,7,2
1746547510210,COGS 100,A01,907783,Staff,0,2,30,30
1746547511235,COGS 101B,A01,886980,Staff,0,3,48,48
1746547512267,COGS 101C,A01,886982,Delgado; Tania,0,5,44,44
1746547513295,COGS 102A,A01,886984,Johnson; Christine M.,4,0,30,26
1746547514321,COGS 118B,A01,886986,Staff,0,3,88,88
1746547515352,COGS 150,A01,886988,Bergen; Benjamin,23,0,50,27
1746547516378,COGS 153,A00,886989,Delgado; Tania,0,2,41,41
1746547517404,COGS 186,A01,886991,Staff,0,0,32,32
1746547518429,COGS 187A,A01,886993,Boyle; Mary E. T.,7,0,30,23
1746547519455,COGS 189,A00,886994,Staff,0,1,30,30
1746547520481,COMM 10,A01,886996,Staff,0,0,20,21
1746547520481,COMM 10,A02,886997,Staff,12,0,20,8
1746547520481,COMM 10,A03,959845,Staff,19,0,20,1
1746547521510,COMM 20,A01,886999,Leuning; Grant Maurstad,24,0,40,16
1746547523565,COMM 100A,A01,887002,Staff,0,0,20,25
1746547523565,COMM 100A,A02,887003,Staff,7,0,20,13
1746547524589,COMM 100B,A01,887005,Staff,0,8,20,24
1746547525613,COMM 106D,A00,887006,Staff,14,0,40,26
1746547526639,COMM 110G,A00,887007,Whitworth-Smith; Andrew C,12,0,40,28
1746547527666,COMM 111B,A00,887008,Staff,31,0,40,9
1746547528693,COMM 113T,A00,887009,Abuelhiga; Soraya Jill,28,0,40,12
1746547528693,COMM 113T,B00,906733,Staff,40,0,40,0
1746547529718,COMM 145,A00,887010,Staff,12,0,40,28
1746547530743,COMM 146,A00,887054,Staff,31,0,40,9
1746547531769,COMM 190,A00,887012,Staff,8,0,23,15
1746547532792,CSE 8A,A50,887015,Cao; Yingjun,57,0,85,28
1746547533820,CSE 11,A01,887017,Cao; Yingjun,12,0,70,58
1746547534844,CSE 20,A01,887019,Staff,30,0,50,20
1746547535870,CSE 21,A01,887021,Staff,78,0,100,22
1746547535870,CSE 21,B01,892583,Braun; Oliver,45,0,50,5
1746547536896,CSE 30,A01,887025,Eldon; John,143,0,200,57
1746547537921,CSE 100,A01,887027,Staff,26,0,50,24
1746547537921,CSE 100,A02,887028,Staff,40,0,50,10
1746547538950,CSE 101,A01,887030,Braun; Oliver,75,0,100,25
1746547538950,CSE 101,B01,887032,Jones; Miles E,0,3,50,50
1746547538950,CSE 101,B02,887033,Jones; Miles E,0,1,50,50
1746547539976,CSE 105,A01,908084,Jones; Miles E,32,0,50,18
1746547539976,CSE 105,A02,908087,Jones; Miles E,33,0,50,17
1746547541001,CSE 135,A01,887035,Powell; Thomas Allan,0,4,50,50
1746547542029,CSE 142,A01,887037,Staff,8,0,60,52
1746547543055,CSE 142L,A01,887039,Staff,34,0,60,26
1746547544085,CSE 151A,A01,887041,Solares; Edwin A,48,0,100,52
1746547545113,CSE 175,A01,887043,Kumar; Rakesh,30,0,30,0
1746547546140,CSS 1,A01,886389,Staff,0,1,40,40
1746547547168,DSC 30,A01,908097,Liao; Soohyun Nam,47,0,75,28
1746547548197,DSC 40A,A01,908099,Shannon; Kyle Michael,30,0,50,20
1746547549222,DSC 40B,A01,908112,Staff,16,0,50,34
1746547550250,DSC 80,A01,908116,Staff,19,0,60,41
1746547551276,DSC 197,001,956863,Eldridge; Justin Matthew,9999,0,9999,0
1746547552300,ECE 5,A01,886400,Morris; Karcher William,2,0,6,4
1746547552300,ECE 5,A02,886401,Morris; Karcher William,3,0,6,3
1746547553330,ECE 148,A01,886403,Silberman; Jack,0,14,14,14
1746547554360,ECON 1,A01,887265,Crane; Meredith Helen,12,0,70,58
1746547554360,ECON 1,B01,887268,Staff,43,0,50,7
1746547555385,ECON 2,A01,887273,Crane; Meredith Helen,56,0,70,14
1746547556413,ECON 3,A01,887279,Rondina; Giacomo,32,0,70,38
1746547557441,ECON 4,A01,887282,Anderson; John Charles,0,2,10,10
1746547558466,ECON 5,A01,887285,Staff,33,0,45,12
1746547558466,ECON 5,B01,887292,Staff,41,0,45,4
1746547559493,ECON 100A,A01,887337,Newhouse; Herbert S,54,0,70,16
1746547559493,ECON 100A,B01,887349,Staff,45,0,50,5
1746547560519,ECON 100B,A01,887361,Du; Songzi,29,0,70,41
1746547561548,ECON 100C,A01,887445,Newhouse; Herbert S,59,0,70,11
1746547562573,ECON 105,A00,887488,Vespa; Emanuel Ignacio,23,0,35,12
1746547563597,ECON 109,A01,887506,Shishkin; Denis,28,0,35,7
1746547564670,ECON 110A,A01,887568,Alon; Titan Michael,0,3,35,35
1746547564670,ECON 110A,B01,907601,Alon; Titan Michael,20,0,35,15
1746547565697,ECON 110B,A01,887598,Levkoff; Steven B.,0,23,70,70
1746547566725,ECON 112,A00,887599,Rondina; Giacomo,19,0,35,16
1746547567753,ECON 120A,A01,887603,Dai; Yinlin,36,0,70,34
1746547568779,ECON 120C,A01,887608,Sun; Yixiao,0,1,35,35
1746547568779,ECON 120C,B01,887614,Sun; Yixiao,0,0,35,35
1746547569808,ECON 138,A00,887621,Bharadwaj; Prashant,0,20,20,20
1746547570837,ECON 144,A00,958007,Squires; Dale E,13,0,35,22
1746547571862,ECON 171,A01,907666,Staff,18,0,35,17
1746547572889,ECON 175,A00,887626,Wu; Pak Yeung,23,0,35,12
1746547573914,ECON 190,A00,887640,Vespa; Emanuel Ignacio,23,0,35,12
1746547574967,EDS 25,A01,888197,Staff,0,0,0,0
1746547574967,EDS 25,A02,888209,Staff,0,0,0,0
1746547574967,EDS 25,A03,888210,Staff,0,0,0,0
1746547574967,EDS 25,A04,888212,Staff,0,0,0,0
1746547574967,EDS 25,A05,888213,Staff,0,0,0,0
1746547574967,EDS 25,A06,888214,Staff,0,0,0,0
1746547574967,EDS 25,A07,888235,Staff,0,2,0,0
1746547574967,EDS 25,A08,888236,Staff,0,0,0,0
1746547574967,EDS 25,A09,888240,Staff,0,0,0,0
1746547574967,EDS 25,A10,888244,Staff,0,0,0,0
1746547574967,EDS 25,B01,888273,Staff,0,0,0,0
1746547574967,EDS 25,B02,888285,Staff,0,0,0,0
1746547574967,EDS 25,B03,888423,Staff,0,0,0,1
1746547574967,EDS 25,B04,888432,Staff,0,0,0,0
1746547574967,EDS 25,B05,888433,Staff,0,0,0,0
1746547574967,EDS 25,B06,888467,Staff,0,0,0,0
1746547574967,EDS 25,B07,888468,Staff,0,0,0,0
1746547574967,EDS 25,B08,888479,Staff,0,0,0,0
1746547574967,EDS 25,B09,888484,Staff,0,0,0,0
1746547574967,EDS 25,B10,888487,Staff,0,0,0,0
1746547575993,EDS 38,A01,907700,Choi; Bailey Miyeon,30,0,30,0
1746547577016,EDS 112,A01,888601,Chapman; Thandeka K,14,0,40,26
1746547578042,EDS 115,A00,888697,Mendez; Kathrina Mendoza,10,0,30,20
1746547579067,EDS 116,A01,888893,Staff,35,0,40,5
1746547581127,EDS 124AR,A00,889133,Staff,29,0,50,21
1746547581127,EDS 124AR,B00,907471,Simon; Elizabeth A,37,0,50,13
1746547582153,EDS 124BR,A00,889134,Simon; Elizabeth A,45,0,100,55
1746547583179,EDS 125,A00,889135,Staff,25,0,30,5
1746547584204,EDS 126,A01,889138,Staff,36,0,40,4
1746547585231,EDS 164R,A01,889142,Wishard Guerra; Alison G.,33,0,50,17
1746547586260,ENG 30,A01,886396,Staff,0,0,0,0
1746547586260,ENG 30,B01,886398,Staff,0,0,0,0
1746547587289,ENVR 102,A00,906150,Montejo; Carolina,23,0,25,2
1746547588314,ETHN 103A,A00,887236,Man; Simeon S,0,3,0,0
1746547589338,ETHN 113,A00,887239,Staff,16,0,30,14
1746547590365,ETHN 116,A00,887240,Staff,16,0,25,9
1746547591391,ETHN 117,A00,887241,Choi; Esther Min,28,0,30,2
1746547592417,ETHN 118,A00,887243,Staff,24,0,30,6
1746547593442,ETHN 127,A00,887248,Cuong; Marisol,11,0,15,4
1746547594471,ETHN 139,A00,887250,Staff,7,0,10,3
1746547595499,ETHN 142,A00,887252,Staff,10,0,30,20
1746547596528,ETHN 161,A00,887253,Browne; Errol Tsekani,24,0,30,6
1746547597557,ETHN 163FR,A00,887255,Burelle; Julie Sara Veronique,0,0,5,5
1746547598582,GLBH 20,A00,889149,Elwardani; Nile Regina,8,0,42,34
1746547600637,GLBH 111,A01,889152,Burgos; Jose L.,17,0,17,0
1746547601667,GLBH 150,A00,889181,Sloane; Julia Kathryn,0,5,15,15
1746547603721,HDS 60,A01,886406,Warstadt; Melissa Fawn,73,0,80,7
1746547604745,HIAF 111,A00,889324,Gyamfi; Bright,25,0,32,7
1746547605771,HIEA 131,A00,889328,Staff,16,0,32,16
1746547606797,HIEA 144,A00,889333,Henry; Todd A.,26,0,32,6
1746547607823,HIEA 154,A00,889336,Henry; Todd A.,24,0,32,8
1746547608850,HIEU 106,A00,889339,Staff,22,0,32,10
1746547610903,HIEU 114,A00,889340,Staff,3,0,32,29
1746547611926,HIEU 135GS,A00,889342,Patterson; Patrick H.,0,0,1,24
1746547612954,HIEU 137,A00,889343,Edington; Claire Ellen,9,0,25,16
1746547613978,HIEU 148,A00,889345,Staff,14,0,32,18
1746547615003,HIEU 154,A00,889346,Biess; Frank Peter,21,0,32,11
1746547616029,HILA 102,A00,889351,Staff,12,0,32,20
1746547617054,HILD 2A,A01,889221,Lewandoski; Julia Mavis,1,10,32,31
1746547618078,HILD 7B,A01,889225,Man; Simeon S,0,13,32,32
1746547619106,HILD 7C,A01,889288,Alvarez; Luis A,0,14,32,32
1746547620131,HILD 30,A01,889323,Staff,0,5,32,32
1746547622183,HISC 119,A00,889383,Golan; Tal,21,0,32,11
1746547623209,HIUS 103,A00,889384,Man; Simeon S,0,0,32,32
1746547624235,HIUS 117,A00,919797,Kwak; Nancy,18,0,32,14
1746547625259,HIUS 142A,A00,919788,Staff,22,0,32,10
1746547627308,HIUS 149,A00,889386,Gyamfi; Bright,27,0,32,5
1746547628332,HIUS 155,A00,889387,Alvarez; Luis A,14,0,32,18
1746547629360,HUM 3,A01,886499,Caldwell; Michael Alan,19,0,50,31
1746547630384,HUM 3GS,A00,886500,Rodriguez; Bretton Sigfred,0,0,0,28
1746547631407,HUM 3R,A01,886502,Markman; Kristina,0,36,50,50
1746547632436,HUM 4,A01,886504,Crum; Matthew Stephen,24,0,50,26
1746547632436,HUM 4,B01,886506,West; Geoffrey Scott,17,0,50,33
1746547633460,HUM 4GS,A00,886507,Staff,0,0,0,19
1746547634488,HUM 5,A01,886509,Staff,32,0,50,18
1746547635516,HUM 5R,A01,886511,Zavodny; Tatiana Sophia,0,39,50,50
1746547636542,JAPN 180,A00,886407,Staff,18,0,40,22
1746547637567,LATI 50,A01,886409,Martin-Cabrera; Luis,4,0,22,18
1746547637567,LATI 50,A02,886410,Martin-Cabrera; Luis,19,0,22,3
1746547637567,LATI 50,A03,886411,Martin-Cabrera; Luis,21,0,22,1
1746547637567,LATI 50,A04,886412,Martin-Cabrera; Luis,9,0,22,13
1746547638607,LAWS 101,A00,907664,Staff,28,0,60,32
1746547639631,LIAB 1A,A00,889388,Saab; Dima,17,0,20,3
1746547640658,LIAB 1AX,A00,889389,El Cheddadi; Youniss,17,0,20,3
1746547641682,LIFR 1C,A00,889391,Van Moer; Vinciane G,8,0,20,12
1746547642708,LIFR 1CX,A00,889392,Van Moer; Vinciane G,7,0,20,13
1746547643735,LIFR 1D,A00,889393,Van Moer; Vinciane G,7,0,20,13
1746547644760,LIFR 1DX,A00,889394,Van Moer; Vinciane G,8,0,20,12
1746547645785,LIGN 7,A00,886923,Staff,24,0,50,26
1746547646810,LIGN 17,A00,886924,Kehler; Andrew Scott,125,0,150,25
1746547647833,LTAM 110,A00,889395,Staff,15,0,30,15
1746547648860,LTAM 110GS,A00,958010,Rodriguez; Bretton Sigfred,0,0,0,28
1746547649888,LTCH 101,A00,889397,Staff,23,0,25,2
1746547650914,LTCS 130,A00,889398,Staff,23,0,25,2
1746547651938,LTEA 138,A00,889399,Staff,24,0,40,16
1746547652964,LTEN 149,A00,889400,Wesling; Megan E.,0,3,25,25
1746547653992,LTEN 169,A00,889401,Staff,20,0,25,5
1746547655020,LTEN 180,A00,889402,Staff,10,0,15,5
1746547656047,LTEN 181,A00,889403,Staff,21,0,25,4
1746547657074,LTWL 100,A00,889404,Myerston Santana; Jacobo,3,0,25,22
1746547658099,LTWL 180GS,A00,889405,Staff,0,0,20,20
1746547659128,LTWL 181,A00,889406,Staff,17,0,25,8
1746547660156,LTWL 184,A00,889475,Mukherjee; Silpa,22,0,25,3
1746547661182,LTWR 102C,A00,889486,Staff,29,0,30,1
1746547662208,LTWR 115W,A00,889491,Staff,0,2,15,15
1746547663235,MAE 8,A01,886905,Staff,0,2,0,0
1746547664265,MAE 11,A00,886906,Bandaru; Prabhakar,0,7,50,50
1746547665291,MAE 20,A00,886907,Evdokimenko; Ekaterina,44,0,70,26
1746547666319,MAE 30B,A00,886909,Ghazinejad; Maziar,26,0,45,19
1746547667347,MAE 101B,A00,886910,Saintillan; David,29,0,45,16
1746547668375,MAE 105,A00,886911,Bandaru; Prabhakar,18,0,50,32
1746547669400,MAE 107,B00,958024,Staff,9,0,50,41
1746547670428,MAE 143B,A00,886913,Bewley; Thomas R,7,0,40,33
1746547671453,MAE 148,A01,886915,Silberman; Jack,0,3,14,14
1746547672479,MAE 160,A00,886916,Evdokimenko; Ekaterina,31,0,60,29
1746547673508,MATH 3C,A01,889681,Staff,0,3,30,30
1746547673508,MATH 3C,A02,960048,Staff,25,0,30,5
1746547674534,MATH 10A,A01,889760,Staff,26,0,30,4
1746547674534,MATH 10A,A02,889783,Staff,29,0,30,1
1746547675565,MATH 10B,A01,889785,Verstraete; Jacques Allan,2,0,35,33
1746547675565,MATH 10B,A02,889795,Verstraete; Jacques Allan,4,0,35,31
1746547675565,MATH 10B,B01,889797,Verstraete; Jacques Allan,3,0,35,32
1746547675565,MATH 10B,B02,889828,Verstraete; Jacques Allan,3,0,35,32
1746547676592,MATH 10C,A01,889849,Habib; Yousaf,9,0,30,21
1746547676592,MATH 10C,A02,889852,Habib; Yousaf,14,0,30,16
1746547676592,MATH 10C,A03,889853,Habib; Yousaf,22,0,30,8
1746547676592,MATH 10C,A04,889858,Habib; Yousaf,20,0,30,10
1746547676592,MATH 10C,B01,889861,Staff,1,0,30,29
1746547676592,MATH 10C,B02,889862,Staff,24,0,30,6
1746547676592,MATH 10C,B03,889863,Staff,27,0,30,3
1746547676592,MATH 10C,B04,889967,Staff,23,0,30,7
1746547677623,MATH 18,A01,889974,Staff,7,0,30,23
1746547677623,MATH 18,A02,889977,Staff,20,0,30,10
1746547677623,MATH 18,B01,889984,Hardiman; Liam,22,0,30,8
1746547677623,MATH 18,B02,889985,Hardiman; Liam,25,0,30,5
1746547678651,MATH 20A,A01,889990,Suk; Andrew Hoon,29,0,35,6
1746547679682,MATH 20B,A01,889993,Ohm; Ko Woon,22,0,30,8
1746547679682,MATH 20B,A02,889994,Ohm; Ko Woon,30,0,30,0
1746547679682,MATH 20B,B01,889996,Ohm; Ko Woon,21,0,30,9
1746547679682,MATH 20B,B02,889997,Ohm; Ko Woon,23,0,30,7
1746547680706,MATH 20C,A01,889999,Hammock; Frances H,17,0,30,13
1746547680706,MATH 20C,A02,890003,Hammock; Frances H,23,0,30,7
1746547680706,MATH 20C,B01,890006,Hammock; Frances H,3,0,30,27
1746547680706,MATH 20C,B02,890007,Hammock; Frances H,11,0,30,19
1746547681734,MATH 20D,A01,890011,Cheng; Hsiao-Bing,1,1,30,29
1746547681734,MATH 20D,A02,890012,Cheng; Hsiao-Bing,14,0,30,16
1746547681734,MATH 20D,B01,890016,Cheng; Hsiao-Bing,13,0,30,17
1746547681734,MATH 20D,B02,890017,Cheng; Hsiao-Bing,13,0,30,17
1746547682764,MATH 20E,A01,890026,Harel; Guershon,1,0,30,29
1746547682764,MATH 20E,A02,890029,Harel; Guershon,23,0,30,7
1746547682764,MATH 20E,B01,890033,Harel; Guershon,7,0,30,23
1746547682764,MATH 20E,B02,890101,Harel; Guershon,21,0,30,9
1746547683788,MATH 102,A01,890104,Staff,17,0,30,13
1746547683788,MATH 102,A02,890105,Staff,27,0,30,3
1746547684816,MATH 103B,A01,890116,Salehi Golsefidy; Alireza,3,0,30,27
1746547684816,MATH 103B,B01,890118,Staff,0,3,34,34
1746547685841,MATH 109,A01,890121,Aliabadi Sr.; Mohsen,1,0,30,29
1746547685841,MATH 109,B01,890124,Upadrashta; Pranav Kumar,18,0,30,12
1746547686867,MATH 120A,A01,890126,Eggers; John Dietrich,13,0,30,17
1746547687895,MATH 142B,A01,890128,Ioana; Adrian,19,0,30,11
1746547687895,MATH 142B,A02,890129,Ioana; Adrian,13,0,30,17
1746547688920,MATH 154,A01,890174,Staff,0,0,30,30
1746547688920,MATH 154,A02,890182,Staff,0,0,30,30
1746547689948,MATH 168A,A01,890197,Dumitriu; Ioana,21,0,35,14
1746547690974,MATH 170A,A01,890240,Nie; Jiawang,1,0,30,29
1746547690974,MATH 170A,A02,890241,Nie; Jiawang,11,0,30,19
1746547690974,MATH 170A,A03,890249,Nie; Jiawang,23,0,30,7
1746547692002,MATH 170B,A01,957891,Nag; Panchali,13,0,35,22
1746547694053,MATH 181A,A01,908025,Staff,0,4,35,35
1746547694053,MATH 181A,A02,960115,Staff,27,0,35,8
1746547695086,MATH 181B,A01,959874,Staff,26,0,30,4
1746547696111,MATH 193B,A01,890265,Staff,0,4,35,35
1746547697137,MGT 4,A01,890311,Anderson; John Charles,42,0,88,46
1746547698164,MGT 5,A00,907740,Staff,13,0,98,85
1746547699188,MGT 12,A00,890312,Lindenberger; Wade Douglas,67,0,98,31
1746547700213,MGT 16,A00,957883,Staff,78,0,98,20
1746547702266,MGT 45,A00,890314,Pecore; Joseph P.,47,0,98,51
1746547703293,MGT 71,A00,890315,Staff,0,11,98,98
1746547704317,MGT 100,A00,890316,Yavorsky; Daniel Ryan,44,0,98,54
1746547705344,MGT 103,A00,890317,Ehrich; Kristine R,73,0,98,25
1746547706370,MGT 105,A00,890356,Bates; Kenneth Walter,0,7,98,98
1746547707400,MGT 112,A00,890360,Ehrich; Kristine R,55,0,98,43
1746547708428,MGT 127R,A00,907732,Zhu; Kevin Xiaoguo,23,0,98,75
1746547709457,MGT 131B,A00,890361,Anderson; John Charles,61,0,98,37
1746547710482,MGT 137,A00,890362,Lindenberger; Wade Douglas,65,0,98,33
1746547711507,MGT 160,A00,890369,Johnson; Erik Barry,9,0,98,89
1746547713561,MGT 164,A00,890372,Zimmermann; Carsten,0,39,98,98
1746547714587,MGT 180,A00,890374,Bliss; Barbara Ann,12,0,98,86
1746547715614,MMW 15,A01,886414,Chang; Edmond Yi-Teh,0,12,28,28
1746547715614,MMW 15,A02,886415,Chang; Edmond Yi-Teh,0,8,28,28
1746547715614,MMW 15,A03,886416,Chang; Edmond Yi-Teh,0,8,28,28
1746547715614,MMW 15,A04,886417,Chang; Edmond Yi-Teh,0,8,28,28
1746547715614,MMW 15,B01,886419,Chang; Edmond Yi-Teh,0,7,28,28
1746547715614,MMW 15,B02,886420,Chang; Edmond Yi-Teh,0,8,28,28
1746547715614,MMW 15,B03,886421,Chang; Edmond Yi-Teh,0,7,28,28
1746547715614,MMW 15,B04,886422,Chang; Edmond Yi-Teh,0,8,28,28
1746547715614,MMW 15,C01,886424,Staff,0,9,28,28
1746547715614,MMW 15,C02,886425,Staff,0,8,28,28
1746547715614,MMW 15,C03,886426,Staff,0,8,28,28
1746547715614,MMW 15,C04,886427,Staff,0,7,28,28
1746547715614,MMW 15,C05,958038,Staff,0,7,28,28
1746547715614,MMW 15,C06,958039,Staff,0,8,28,28
1746547716641,MMW 15GS,A00,906910,Patterson; Patrick H.,4,0,28,24
1746547717666,MMW 122R,A01,886429,Rahimi; Babak,0,13,28,28
1746547717666,MMW 122R,A02,886430,Rahimi; Babak,0,12,28,28
1746547717666,MMW 122R,A03,958040,Rahimi; Babak,0,11,28,28
1746547718692,MUS 1A,A01,890937,Staff,3,0,25,22
1746547718692,MUS 1A,A02,891035,Staff,6,0,25,19
1746547718692,MUS 1A,C01,958912,Staff,24,0,25,1
1746547718692,MUS 1A,C02,958913,Staff,25,0,25,0
1746547720745,MUS 2AK,A00,957092,Ohnishi; Takae,15,0,15,0
1746547721775,MUS 4,A01,891044,Staff,2,0,25,23
1746547721775,MUS 4,A02,891045,Staff,23,0,25,2
1746547721775,MUS 4,B01,891048,Staff,17,0,25,8
1746547721775,MUS 4,B02,891050,Staff,25,0,25,0
1746547722799,MUS 5,A01,957506,Dubnov; Shlomo,0,0,25,25
1746547722799,MUS 5,A02,957622,Dubnov; Shlomo,14,0,25,11
1746547722799,MUS 5,A03,957623,Dubnov; Shlomo,20,0,25,5
1746547723829,MUS 6,A01,891053,Freitas Caetano; Marcelo,24,0,25,1
1746547723829,MUS 6,A02,891054,Freitas Caetano; Marcelo,23,0,25,2
1746547724859,MUS 7,A01,891081,Staff,0,0,25,25
1746547724859,MUS 7,A02,891082,Staff,4,0,25,21
1746547725884,MUS 8GS,A00,891118,Borgo; David Garcia,0,0,25,25
1746547726911,MUS 11,A01,891140,Staff,11,0,25,14
1746547726911,MUS 11,A02,891141,Staff,22,0,25,3
1746547727938,MUS 13,A01,891143,Staff,8,0,25,17
1746547727938,MUS 13,A02,891144,Staff,24,0,25,1
1746547728964,MUS 15,A01,891146,Staff,9,0,25,16
1746547728964,MUS 15,A02,891148,Staff,21,0,25,4
1746547728964,MUS 15,B01,891150,Staff,18,0,25,7
1746547728964,MUS 15,B02,891151,Staff,25,0,25,0
1746547729993,MUS 20,A01,891153,Staff,5,0,20,15
1746547729993,MUS 20,A02,891155,Staff,14,0,20,6
1746547731023,MUS 80,A00,891156,Staff,19,0,25,6
1746547731023,MUS 80,B00,891157,Staff,23,0,25,2
1746547732050,MUS 130,A00,891158,Ohnishi; Takae,35,0,35,0
1746547733075,MUS 150GS,A01,891160,Borgo; David Garcia,0,0,25,25
1746547734105,MUS 170,A01,891162,Freitas Caetano; Marcelo,20,0,25,5
1746547734105,MUS 170,A02,891164,Freitas Caetano; Marcelo,21,0,25,4
1746547735130,NANO 11,A00,886220,Vazquez Mena; Oscar,13,0,15,2
1746547736154,NANO 15,A01,886222,Drews; Aaron,4,0,7,3
1746547737178,NANO 104,A00,886224,Sirbuly; Donald,18,0,25,7
1746547738202,PH 40,A00,886528,Staff,23,0,40,17
1746547739230,PH 45,A01,886799,Staff,35,0,40,5
1746547740255,PH 110,A00,886802,Staff,0,7,40,40
1746547741283,PH 172,A00,906716,Staff,19,0,35,16
1746547742310,PH 191,A00,886803,Staff,6,0,40,34
1746547743336,PHIL 1,A00,889500,Staff,19,0,30,11
1746547744365,PHIL 10,A01,889549,Grush; Rick Scott,15,0,22,7
1746547744365,PHIL 10,A02,889551,Grush; Rick Scott,22,0,22,0
1746547745391,PHIL 28,A01,889559,Lamey; Andy M.,0,1,31,31
1746547745391,PHIL 28,A02,889561,Lamey; Andy M.,0,1,30,30
1746547745391,PHIL 28,A03,889572,Lamey; Andy M.,0,0,30,30
1746547746417,PHIL 35,A00,907839,Staff,13,0,15,2
1746547747444,PHIL 60,A00,889574,Staff,74,0,90,16
1746547748469,PHIL 101,A00,958004,Staff,13,0,15,2
1746547750523,PHIL 136,A00,889582,Fulkerson; Matthew Todd,26,0,45,19
1746547751551,PHIL 163,A01,889601,Staff,21,0,30,9
1746547751551,PHIL 163,B01,889606,Brandt; Reuven A,0,3,0,0
1746547752578,PHIL 164,A00,889610,Staff,16,0,30,14
1746547753602,PHIL 165,A00,889613,Staff,23,0,30,7
1746547754628,PHYS 1A,A00,886431,Staff,26,0,70,44
1746547755658,PHYS 1AL,001,886432,Tsai; Philbert S,0,2,30,30
1746547755658,PHYS 1AL,002,886436,Tsai; Philbert S,11,0,30,19
1746547756684,PHYS 1B,A00,886439,Staff,185,0,240,55
1746547757711,PHYS 1BL,001,886441,Tsai; Philbert S,0,4,30,30
1746547757711,PHYS 1BL,002,886444,Tsai; Philbert S,2,0,30,28
1746547758737,PHYS 1C,A00,896092,Arnold; Kam S,78,0,146,68
1746547759774,PHYS 1CL,001,886448,Tsai; Philbert S,0,0,30,30
1746547759774,PHYS 1CL,002,886449,Tsai; Philbert S,0,0,30,30
1746547759774,PHYS 1CL,003,886450,Tsai; Philbert S,16,0,30,14
1746547759774,PHYS 1CL,004,886451,Tsai; Philbert S,15,0,30,15
1746547760800,PHYS 2B,A01,886457,Staff,69,0,115,46
1746547761824,PHYS 2C,A01,886460,Shotwell; Brian,0,8,65,65
1746547762852,PHYS 2CL,A01,886467,Staff,0,4,28,28
1746547762852,PHYS 2CL,A02,886468,Staff,0,3,28,28
1746547763899,PHYS 2D,A01,886470,Staff,10,0,50,40
1746547764924,PHYS 4B,A01,886475,Grinstein; Benjamin,22,0,40,18
1746547765953,POLI 5,A00,891173,Desposato; Scott,7,0,25,18
1746547766980,POLI 5D,A01,891175,Staff,5,0,5,0
1746547766980,POLI 5D,B01,891178,Staff,5,0,5,0
1746547768006,POLI 11,A00,891179,Ferree; Karen E,2,0,35,33
1746547769034,POLI 12,A00,891180,Staff,16,0,30,14
1746547770058,POLI 27,A01,891182,Staff,12,0,75,63
1746547771084,POLI 30,A00,891183,Staff,8,0,50,42
1746547772109,POLI 100B,A00,891244,Staff,5,1,35,30
1746547773138,POLI 100I,A00,891247,Staff,7,0,30,23
1746547774163,POLI 104J,A00,891248,Nichter; Maysa,14,0,30,16
1746547775189,POLI 104U,A00,891250,Nichter; Maysa,2,0,30,28
1746547777239,POLI 110B,A00,891255,Wiens; David,20,0,25,5
1746547778267,POLI 112A,A00,891256,Wiens; David,6,0,25,19
1746547779301,POLI 114BR,A00,891261,Staff,19,0,30,11
1746547780326,POLI 117R,A00,891262,Forman; Fonna,0,6,50,50
1746547781357,POLI 118,A00,891264,Ingham; Sean,17,0,25,8
1746547782384,POLI 124A,A00,891265,Staff,18,0,20,2
1746547783407,POLI 125D,A00,891266,Nichter; Simeon C,2,0,25,23
1746547784435,POLI 126,A00,891268,Nichter; Simeon C,7,0,25,18
1746547785462,POLI 126AA,A00,891272,Staff,18,0,25,7
1746547786485,POLI 130AA,A00,891273,Staff,15,0,20,5
1746547787509,POLI 134AA,A00,891274,Staff,4,0,20,16
1746547789560,POLI 138,A00,891278,Staff,21,0,25,4
1746547790586,POLI 142K,A00,891280,Staff,11,0,25,14
1746547791612,POLI 142M,A00,891281,Gartzke; Erik,17,0,30,13
1746547792637,POLI 142P,A00,891284,Staff,20,0,30,10
1746547793661,POLI 143,A00,891285,Gartzke; Erik,12,0,30,18
1746547794688,POLI 153,A00,891286,Staff,19,0,20,1
1746547796743,POLI 175,A00,891290,Staff,15,0,20,5
1746547797768,PSYC 1,A00,890674,Steiner; Eric Tomas,0,11,45,45
1746547798792,PSYC 2,A00,890676,Albright; Thomas D,21,0,35,14
1746547799818,PSYC 3,A00,890679,Staff,17,0,20,3
1746547800847,PSYC 6,A00,959858,Staff,20,0,20,0
1746547801874,PSYC 60,A01,890684,Rickard; Timothy C.,0,5,45,45
1746547802905,PSYC 70,A01,890689,Geller; Emma Harlan,7,0,30,23
1746547803932,PSYC 71,A01,959860,Staff,21,0,25,4
1746547804959,PSYC 100,A00,890690,Lacefield; Katharine I,0,50,180,180
1746547805987,PSYC 102,A00,890695,Staff,18,0,40,22
1746547807013,PSYC 105,A00,890699,Geller; Emma Harlan,71,0,100,29
1746547808039,PSYC 106,A00,890701,Gorman; Michael R.,5,0,30,25
1746547809070,PSYC 108,A00,890704,Adrian; Julia Anna,0,28,50,50
1746547810094,PSYC 118,A01,890712,Staff,11,0,30,19
1746547811119,PSYC 124,A00,890716,Chapman; Eddie Nathaniel,25,0,60,35
1746547812144,PSYC 131,A00,890717,Anagnostaras; Stephan,0,7,80,80
1746547813168,PSYC 137,A00,890719,Winkielman; Piotr,0,11,30,30
1746547814197,PSYC 144,A00,890721,Adrian; Julia Anna,0,9,45,45
1746547815222,PSYC 162,A00,890805,Staff,2,0,75,73
1746547816249,PSYC 169,A00,890810,Staff,0,15,30,30
1746547817275,PSYC 172,A00,890814,Gorman; Michael R.,9,0,30,21
1746547818303,PSYC 181,A00,890818,Anagnostaras; Stephan,8,0,200,192
1746547819329,PSYC 184,A00,959861,Staff,170,0,175,5
1746547820359,PSYC 189,A00,890823,Staff,0,1,30,30
1746547821384,PSYC 191,A00,890884,Rickard; Timothy C.,0,11,35,35
1746547822413,PSYC 193,A00,890913,Staff,19,0,30,11
1746547822413,PSYC 193,B00,890914,Chapman; Eddie Nathaniel,24,0,30,6
1746547823445,PSYC 193L,A01,890918,Lowe; Angela Beth,20,0,30,10
1746547823445,PSYC 193L,B01,890921,Hurwitz; Ethan Scott,20,0,30,10
1746547823445,PSYC 193L,C01,890928,Staff,30,0,30,0
1746547824469,RELI 149,A00,886806,Rahimi; Babak,23,0,40,17
1746547825499,SE 9,A01,886814,Staff,7,0,20,13
1746547826556,SE 101B,A01,886816,Chadha; Mayank,4,0,35,31
1746547827585,SE 110B,A00,886818,Zhu; Qiang,4,0,75,71
1746547828611,SE 125,A01,886830,Staff,10,0,30,20
1746547829640,SE 130B,A01,886835,Staff,14,0,40,26
1746547830665,SE 131A,A01,886838,Krysl; Petr,34,0,55,21
1746547831690,SE 154,A00,886840,Staff,30,0,50,20
1746547832717,SE 164GS,A01,886849,Staff,6,0,20,14
1746547833743,SE 167GS,A01,886853,Staff,6,0,20,14
1746547834773,SIO 25,A01,890107,Staff,19,0,30,11
1746547835821,SIO 45,A00,890109,Cook; Geoffrey W,117,0,200,83
1746547836848,SIO 109R,A00,890110,Forman; Fonna,0,16,20,20
1746547837873,SIO 187,A01,890114,Kacev; David,15,0,40,25
1746547838898,SOCI 1,A01,890431,Thorpe; Charles Robert,15,0,30,15
1746547838898,SOCI 1,A02,890518,Thorpe; Charles Robert,30,0,30,0
1746547839922,SOCI 2,A01,957978,Staff,25,0,25,0
1746547839922,SOCI 2,A02,957979,Staff,23,0,25,2
1746547840947,SOCI 20,A01,890523,Calderon-Zaks; Michael Aar,23,0,30,7
1746547840947,SOCI 20,A02,890526,Calderon-Zaks; Michael Aar,29,0,30,1
1746547841972,SOCI 30,A01,890533,Pardo Guerra; Juan Pablo,37,0,40,3
1746547842997,SOCI 40,A01,890535,Staff,27,0,45,18
1746547844021,SOCI 104Q,A00,890559,Staff,18,0,30,12
1746547845046,SOCI 106,A00,890560,Arnal; Maud Marie Leonie,20,0,30,10
1746547846071,SOCI 110,A00,890567,Holkenbrink-Monk; Charlene,19,0,30,11
1746547847117,SOCI 112,A00,890568,Victoria Torres; Pablo,1,0,55,54
1746547848142,SOCI 115,A00,890597,Arnal; Maud Marie Leonie,28,0,45,17
1746547850192,SOCI 121,A00,890604,Pardo Guerra; Juan Pablo,38,0,45,7
1746547851217,SOCI 126,A01,890608,Staff,8,0,10,2
1746547852242,SOCI 127,A00,890609,Staff,18,0,30,12
1746547853267,SOCI 131,A00,890610,Thorpe; Charles Robert,37,0,45,8
1746547854297,SOCI 135,A00,890615,Payne; Christine Anna,14,0,45,31
1746547855321,SOCI 139,A00,890620,Staff,38,0,45,7
1746547856344,SOCI 148E,A00,890622,Calderon-Zaks; Michael Aar,36,0,45,9
1746547857369,SOCI 150,A00,890623,Kohler; Kristopher M.,31,0,45,14
1746547858394,SOCI 157,A00,890625,Jules-Rosette; Bennetta W.,18,0,20,2
1746547859419,SOCI 160,A00,890627,Payne; Christine Anna,21,0,45,24
1746547860448,SYN 1,A00,886855,Fish; Gwendolyn Anne,0,0,0,0
1746547860448,SYN 1,B00,906086,Fish; Gwendolyn Anne,0,1,0,2
1746547861474,SYN 2R,A00,886860,Staff,0,17,15,15
1746547861474,SYN 2R,B00,906106,Atkinson; Arthur Laird,0,16,15,15
1746547862502,SYN 100,A01,886866,Browne; Emily,0,28,20,20
1746547862502,SYN 100,B01,906128,Rock; Martin,0,5,20,20
1746547862502,SYN 100,C01,906140,Deavenport; James Cary,0,3,20,20
1746547862502,SYN 100,D01,907816,Deavenport; James Cary,0,5,20,20
1746547863528,TDAC 1,A00,890286,Walsh; Kim C.,9,0,20,11
1746547864552,TDAC 101,A00,890296,Basso; Beatrice,16,0,20,4
1746547865582,TDDE 131,A00,890297,Staff,47,0,50,3
1746547866611,TDDM 1,A00,890287,Weinberg; Sadie,25,0,30,5
1746547867637,TDGE 11,A00,890288,Fulton; Julia,137,0,200,63
1746547867637,TDGE 11,B00,890289,Castro; Robert Jess,184,0,200,16
1746547868664,TDGE 25,B00,957359,Walsh; Kim C.,3,0,20,17
1746547869691,TDGE 40,A01,890292,Power; Jade Yukana,27,0,30,3
1746547870720,TDGE 124,A00,890298,Havis; Allan,0,0,50,50
1746547871746,TDGE 131R,A00,890299,Burelle; Julie Sara Veronique,15,0,42,27
1746547872770,TDHT 101,A00,890300,Staff,10,0,20,10
1746547873796,TDHT 109,A01,890302,Anderson; Mysia Anyse,31,0,40,9
1746547874822,TDMV 1,A00,890293,Arcidiacono; Kristin,18,0,30,12
1746547875849,TDMV 2,A00,890294,Weinberg; Sadie,23,0,30,7
1746547876877,TDMV 3,A00,957878,Arcidiacono; Kristin,28,0,30,2
1746547878928,TDMV 138,A00,890304,Jun; Grace Shin Hae,25,0,40,15
1746547879955,TDMV 140,A00,890305,Corrales; Joseph Bernales,25,0,30,5
1746547880983,TDMV 142,A00,890307,Caligagan; Tony,32,0,40,8
1746547882007,TDMV 144,A00,890308,Camaya; Michelle Ann,25,0,30,5
1746547883032,TDPW 1,A00,890295,Stein; Deborah Isobel,3,0,20,17
1746547884058,USP 2,A01,890272,Lerner; Amy M,6,0,20,14
1746547885085,USP 3,A01,890274,Staff,12,0,30,18
1746547886114,USP 15,A01,890276,Sun; Feiyang,17,0,30,13
1746547887140,USP 25,A00,890277,Shenkman; Michael Thomas,19,0,25,6
1746547888166,USP 138,A00,890278,Staff,13,0,25,12
1746547889196,USP 143,A00,890279,Staff,21,0,70,49
1746547890221,USP 144,A00,890280,Chowdhury; Muhammed Zohir,16,0,30,14
1746547891248,USP 150,A00,890281,Boomhower; Matthew Charles,4,0,30,26
1746547892273,USP 151,A00,890282,Staff,16,0,20,4
1746547893300,USP 162,A00,890283,Andrews; Abigail Leslie,16,0,20,4
1746547894327,USP 168,A00,920477,Kwak; Nancy,1,0,5,4
1746547895355,USP 181,A00,890284,Staff,3,0,20,17
1746547896380,USP 191A,A00,890285,Staff,13,0,20,7
1746547897406,VIS 101,A00,886512,Staff,25,0,75,50
1746547898432,VIS 103,A00,886513,Cruz; Edwin Teddy,61,0,75,14
1746547899458,VIS 108,A00,886514,Staff,3,0,15,12
1746547900483,VIS 127P,A00,886515,Shen; Kuiyi,80,0,146,66
1746547901512,VIS 149,A00,886516,Yoldas; Pinar,0,0,15,15
1746547902537,VIS 164,A00,886526,Erdmann; Dean,19,0,22,3
1746547903566,VIS 194S,A00,886527,Staff,61,0,75,14
1746547904592,WCWP 10A,C00,886484,Martiniuk; Jill,12,0,15,3
1746547905617,WCWP 10B,A00,886490,Uriarte; Emma,0,0,15,15
1746547905617,WCWP 10B,B00,886491,Dhir; Simrita,10,0,15,5
1746547905617,WCWP 10B,C00,886492,Ornelas; Tricia,0,0,15,15
1746547906643,WCWP 100,A00,886494,Young; Mark T,0,6,15,15
1746547908769,AAS 10,A01,886199,Childs; Dennis R.,0,3,0,0
1746547909794,ANAR 104,A01,886940,Shtienberg; Gilad,27,0,30,3
1746547910822,ANAR 120,A00,886953,Staff,12,0,20,8
1746547911848,ANBI 148,A01,886955,Wilder; Linnea Lorene,30,0,40,10
1746547913898,ANSC 122,A00,886957,Staff,25,0,30,5
1746547914922,ANSC 150,A00,886958,Sloane; Julia Kathryn,3,0,15,12
1746547915946,ANSC 156,A00,886959,Jenkins; Janis A.,0,1,15,15
1746547916973,ANSC 180,A00,886960,Staff,11,0,17,6
1746547918008,ANSC 188,A00,886961,Jassal; Aftab,9,0,25,16
1746547919035,ANSC 190,A00,886962,Jassal; Aftab,14,0,25,11
1746547920061,ANSC 191,A00,886963,Staff,18,0,20,2
1746547921088,ANTH 3,A01,891689,Staff,17,0,20,3
1746547922113,ANTH 5,A00,886933,Semendeferi; Ekaterini,16,0,20,4
1746547923141,ANTH 10,A00,886934,Staff,0,12,30,30
1746547924165,ANTH 21,A01,886936,Staff,40,0,60,20
1746547925189,ANTH 23,A01,886938,Staff,92,0,100,8
1746547926216,ANTH 105,A00,886964,Stewart; Alexander B,84,0,100,16
1746547927239,ANTH 108,A00,886965,Pedersen; David,9,0,20,11
1746547928263,AWP 10,001,886147,Staff,0,0,0,0
1746547928263,AWP 10,002,886148,Staff,0,0,0,0
1746547928263,AWP 10,003,886149,Staff,0,0,0,0
1746547928263,AWP 10,004,886150,Staff,0,0,0,0
1746547928263,AWP 10,005,886151,Staff,0,0,0,0
1746547928263,AWP 10,006,886152,Staff,0,0,0,0
1746547928263,AWP 10,007,886153,Staff,0,0,0,0
1746547928263,AWP 10,008,886154,Staff,0,0,0,0
1746547928263,AWP 10,009,886155,Staff,0,0,0,0
1746547928263,AWP 10,010,886156,Staff,0,0,0,0
1746547928263,AWP 10,011,886158,Staff,0,0,0,0
1746547928263,AWP 10,012,886160,Staff,0,0,0,0
1746547928263,AWP 10,013,886161,Staff,0,0,0,0
1746547928263,AWP 10,014,886162,Staff,0,0,0,0
1746547928263,AWP 10,015,886163,Staff,0,0,0,0
1746547928263,AWP 10,016,886164,Staff,0,0,0,0
1746547928263,AWP 10,017,886165,Staff,0,0,0,0
1746547928263,AWP 10,018,886166,Staff,0,0,0,0
1746547928263,AWP 10,019,886168,Staff,0,0,0,0
1746547928263,AWP 10,020,886170,Staff,0,0,0,0
1746547928263,AWP 10,021,886172,Staff,0,0,0,0
1746547929290,AWP 10R,001,886173,Staff,0,1,0,0
1746547929290,AWP 10R,002,886174,Staff,0,1,0,0
1746547929290,AWP 10R,003,886175,Staff,0,0,0,0
1746547929290,AWP 10R,004,886176,Staff,0,0,0,0
1746547929290,AWP 10R,005,886177,Staff,0,0,0,0
1746547929290,AWP 10R,006,886178,Staff,0,0,0,0
1746547929290,AWP 10R,007,886179,Staff,0,0,0,0
1746547929290,AWP 10R,008,886181,Staff,0,0,0,0
1746547929290,AWP 10R,009,886182,Staff,0,0,0,0
1746547929290,AWP 10R,010,886183,Staff,0,0,0,0
1746547929290,AWP 10R,011,886184,Staff,0,0,0,0
1746547929290,AWP 10R,012,886185,Staff,0,0,0,0
1746547929290,AWP 10R,013,886186,Staff,0,0,0,0
1746547929290,AWP 10R,014,886187,Staff,0,0,0,0
1746547929290,AWP 10R,015,886188,Staff,0,0,0,0
1746547929290,AWP 10R,016,886189,Staff,0,0,0,0
1746547930318,AWP 102R,A00,886190,Staff,0,0,0,0
1746547930318,AWP 102R,B00,886191,Staff,0,0,0,0
1746547931342,BENG 100,A01,886193,Staff,17,0,30,13
1746547932366,BENG 122A,A01,886195,Hasty; Jeff M,13,0,30,17
1746547933391,BENG 166A,A00,886196,Sah; Robert Lie-Yuan,0,1,30,30
1746547934417,BENG 190,A00,958050,Khojah; Reem I,24,0,25,1
1746547935446,BIBC 102,A01,894320,Staff,0,0,46,46
1746547935446,BIBC 102,A02,894321,Staff,0,0,46,46
1746547935446,BIBC 102,A03,894344,Staff,7,0,46,39
1746547935446,BIBC 102,A04,894345,Staff,26,0,47,21
1746547936473,BICD 100R,A01,894365,Smith; Laurie,0,3,58,58
1746547936473,BICD 100R,A02,894366,Smith; Laurie,0,5,58,58
1746547936473,BICD 100R,A03,894367,Smith; Laurie,2,0,59,57
1746547936473,BICD 100R,A04,959869,Smith; Laurie,41,0,59,18
1746547937499,BICD 136,A01,894383,Gustafson-Brown; Cindy,14,0,50,36
1746547938528,BIEB 102,A01,894494,Butler; Shannon Rhey,51,0,130,79
1746547940589,BIEB 150,A01,894617,Wills; Christopher,3,0,20,17
1746547940589,BIEB 150,A02,894631,Wills; Christopher,3,0,20,17
1746547940589,BIEB 150,A03,894937,Wills; Christopher,3,0,20,17
1746547940589,BIEB 150,A04,894946,Wills; Christopher,5,0,20,15
1746547941616,BIEB 194,A00,906141,Kurle; Carolyn M.,6,0,20,14
1746547942642,BILD 1,A01,894154,Staff,2,0,19,17
1746547942642,BILD 1,A02,894155,Staff,14,0,19,5
1746547942642,BILD 1,A03,894160,Staff,13,0,19,6
1746547942642,BILD 1,A04,894161,Staff,15,0,18,3
1746547943666,BILD 2,A01,894168,Staff,0,0,50,50
1746547943666,BILD 2,A02,894169,Staff,0,0,50,50
1746547943666,BILD 2,A03,894179,Staff,4,0,50,46
1746547943666,BILD 2,A04,894203,Staff,27,0,50,23
1746547944692,BILD 3,A01,894213,Staff,22,0,31,9
1746547944692,BILD 3,A02,894214,Staff,26,0,31,5
1746547944692,BILD 3,A03,894235,Staff,28,0,31,3
1746547944692,BILD 3,A04,894236,Staff,28,0,32,4
1746547945718,BILD 4,A01,894253,Reuther; Keefe,5,0,24,19
1746547945718,BILD 4,A02,894258,Reuther; Keefe,16,0,24,8
1746547946747,BILD 5,A01,894276,Reuther; Keefe,35,0,50,15
1746547946747,BILD 5,A02,894277,Reuther; Keefe,45,0,50,5
1746547946747,BILD 5,A03,894290,Reuther; Keefe,44,0,50,6
1746547946747,BILD 5,A04,894291,Reuther; Keefe,48,0,50,2
1746547947772,BILD 24,A01,894297,Pirino; Giorgia,40,0,60,20
1746547948800,BIMM 100,B01,958915,Staff,72,0,100,28
1746547949827,BIMM 101,A01,895017,McDonnell; Lisa Marie,0,5,24,24
1746547949827,BIMM 101,A02,895018,McDonnell; Lisa Marie,0,5,24,24
1746547949827,BIMM 101,B01,895020,McDonnell; Lisa Marie,0,6,24,24
1746547949827,BIMM 101,B02,895021,McDonnell; Lisa Marie,0,4,24,24
1746547950854,BIMM 110,A01,895023,Staff,1,0,25,24
1746547950854,BIMM 110,A02,895024,Staff,9,0,25,16
1746547950854,BIMM 110,A03,895025,Staff,18,0,25,7
1746547950854,BIMM 110,A04,895031,Staff,20,0,25,5
1746547951883,BIMM 120,A01,895114,Gustafson-Brown; Cindy,13,0,28,15
1746547951883,BIMM 120,A02,895126,Gustafson-Brown; Cindy,21,0,27,6
1746547952911,BIPN 100,A01,895130,Yang; Mingyu,1,0,38,37
1746547952911,BIPN 100,A02,895131,Yang; Mingyu,32,0,38,6
1746547952911,BIPN 100,A03,895132,Yang; Mingyu,32,0,38,6
1746547952911,BIPN 100,A04,895133,Yang; Mingyu,27,0,36,9
1746547953937,BIPN 120,A01,895135,Cooke; James Edward,0,3,13,13
1746547953937,BIPN 120,A02,895136,Cooke; James Edward,0,1,13,13
1746547953937,BIPN 120,A03,895137,Cooke; James Edward,0,3,13,13
1746547953937,BIPN 120,A04,895156,Cooke; James Edward,0,2,11,11
1746547954963,BIPN 134,A01,895235,Cooke; James Edward,0,2,25,25
1746547954963,BIPN 134,A02,895237,Cooke; James Edward,0,0,25,25
1746547954963,BIPN 134,A03,895240,Cooke; James Edward,3,0,25,22
1746547954963,BIPN 134,A04,895270,Cooke; James Edward,20,0,25,5
1746547955990,BIPN 189,A00,892103,Staff,0,13,14,14
1746547958044,BISP 194,A00,958008,Staff,0,2,0,0
1746547959071,CAT 124,A01,922009,Staff,0,5,20,20
1746547960103,CAT 125R,A00,886390,Morales; Celeste Georgianna,0,2,20,20
1746547960103,CAT 125R,B00,886391,Irwin; Matthew Joseph,0,3,20,20
1746547960103,CAT 125R,C00,886392,Smith; Lauryn Alissa,0,2,20,20
1746547960103,CAT 125R,D00,886393,Vanderschuit; Maya Alysia,0,2,20,20
1746547960103,CAT 125R,E00,886394,Marchisotto; Jennifer Anne,0,4,20,20
1746547961129,CENG 15,A01,886218,Drews; Aaron,3,0,8,5
1746547962155,CENG 113,A00,886219,Opatkiewicz; Justin Paul,15,0,25,10
1746547963182,CGS 101,A00,887044,Staff,7,0,20,13
1746547964209,CGS 105,A01,887046,Staff,14,0,25,11
1746547965234,CGS 112,A00,887047,Cuong; Marisol,12,0,15,3
1746547966260,CGS 113,A00,887048,Staff,23,0,30,7
1746547967287,CGS 120,A00,887049,Staff,10,0,17,7
1746547968314,CHEM 6A,A01,886336,Lam; Tin Yiu,38,0,50,12
1746547968314,CHEM 6A,A02,886338,Lam; Tin Yiu,37,0,50,13
1746547969339,CHEM 6B,A01,886341,Hopkins; Patrycja Anna,16,0,50,34
1746547969339,CHEM 6B,A02,886343,Hopkins; Patrycja Anna,42,0,50,8
1746547970364,CHEM 6C,A01,886346,Albizati; Kim F.,0,2,50,50
1746547970364,CHEM 6C,A02,886348,Albizati; Kim F.,23,0,50,27
1746547971392,CHEM 40A,A01,886352,Klosterman; Jeremy K,65,0,100,35
1746547972423,CHEM 40B,A01,886356,Klosterman; Jeremy K,0,23,100,100
1746547973455,CHEM 41B,A01,886360,Theodorakis; Emmanuel,25,0,50,25
1746547973455,CHEM 41B,A02,886362,Theodorakis; Emmanuel,47,0,50,3
1746547974479,CHIN 165A,A00,886382,Xu; Li,18,0,20,2
1746547975508,CLAS 120,A00,886387,Myerston Santana; Jacobo,33,0,40,7
1746547976538,COGS 9,A01,886967,Shannon; Kyle Michael,42,0,60,18
1746547977564,COGS 11,A01,886969,Staff,11,0,30,19
1746547978592,COGS 14A,A01,886971,Staff,6,0,60,54
1746547979617,COGS 14B,A01,886973,Hoffman; Drew Ellen,4,0,60,56
1746547980643,COGS 18,A01,886975,Morgan; Eric,35,0,60,25
1746547981667,COGS 20,A01,886977,Staff,4,0,8,4
1746547981667,COGS 20,A02,886978,Staff,5,0,7,2
1746547982696,COGS 100,A01,907783,Staff,0,2,30,30
1746547983720,COGS 101B,A01,886980,Staff,0,3,48,48
1746547984744,COGS 101C,A01,886982,Delgado; Tania,0,5,44,44
1746547985769,COGS 102A,A01,886984,Johnson; Christine M.,4,0,30,26
1746547986800,COGS 118B,A01,886986,Staff,0,3,88,88
1746547987828,COGS 150,A01,886988,Bergen; Benjamin,23,0,50,27
1746547988853,COGS 153,A00,886989,Delgado; Tania,0,2,41,41
1746547989881,COGS 186,A01,886991,Staff,0,0,32,32
1746547990904,COGS 187A,A01,886993,Boyle; Mary E. T.,7,0,30,23
1746547991930,COGS 189,A00,886994,Staff,0,1,30,30
1746547992958,COMM 10,A01,886996,Staff,0,0,20,21
1746547992958,COMM 10,A02,886997,Staff,12,0,20,8
1746547992958,COMM 10,A03,959845,Staff,19,0,20,1
1746547993986,COMM 20,A01,886999,Leuning; Grant Maurstad,24,0,40,16
1746547996038,COMM 100A,A01,887002,Staff,0,0,20,25
1746547996038,COMM 100A,A02,887003,Staff,7,0,20,13
1746547997064,COMM 100B,A01,887005,Staff,0,8,20,24
1746547998090,COMM 106D,A00,887006,Staff,14,0,40,26
1746547999117,COMM 110G,A00,887007,Whitworth-Smith; Andrew C,12,0,40,28
1746548000143,COMM 111B,A00,887008,Staff,31,0,40,9
1746548001173,COMM 113T,A00,887009,Abuelhiga; Soraya Jill,28,0,40,12
1746548001173,COMM 113T,B00,906733,Staff,40,0,40,0
1746548002199,COMM 145,A00,887010,Staff,12,0,40,28
1746548003228,COMM 146,A00,887054,Staff,31,0,40,9
1746548004253,COMM 190,A00,887012,Staff,8,0,23,15
1746548005278,CSE 8A,A50,887015,Cao; Yingjun,57,0,85,28
1746548006304,CSE 11,A01,887017,Cao; Yingjun,12,0,70,58
1746548007330,CSE 20,A01,887019,Staff,30,0,50,20
1746548008357,CSE 21,A01,887021,Staff,78,0,100,22
1746548008357,CSE 21,B01,892583,Braun; Oliver,45,0,50,5
1746548009384,CSE 30,A01,887025,Eldon; John,143,0,200,57
1746548010410,CSE 100,A01,887027,Staff,26,0,50,24
1746548010410,CSE 100,A02,887028,Staff,40,0,50,10
1746548011439,CSE 101,A01,887030,Braun; Oliver,75,0,100,25
1746548011439,CSE 101,B01,887032,Jones; Miles E,0,3,50,50
1746548011439,CSE 101,B02,887033,Jones; Miles E,0,1,50,50
1746548012466,CSE 105,A01,908084,Jones; Miles E,32,0,50,18
1746548012466,CSE 105,A02,908087,Jones; Miles E,33,0,50,17
1746548013491,CSE 135,A01,887035,Powell; Thomas Allan,0,4,50,50
1746548014516,CSE 142,A01,887037,Staff,8,0,60,52
1746548015542,CSE 142L,A01,887039,Staff,34,0,60,26
1746548016571,CSE 151A,A01,887041,Solares; Edwin A,48,0,100,52
1746548017600,CSE 175,A01,887043,Kumar; Rakesh,30,0,30,0
1746548018628,CSS 1,A01,886389,Staff,0,1,40,40
1746548019656,DSC 30,A01,908097,Liao; Soohyun Nam,47,0,75,28
1746548020683,DSC 40A,A01,908099,Shannon; Kyle Michael,30,0,50,20
1746548021713,DSC 40B,A01,908112,Staff,16,0,50,34
1746548022738,DSC 80,A01,908116,Staff,19,0,60,41
1746548023764,DSC 197,001,956863,Eldridge; Justin Matthew,9999,0,9999,0
1746548024789,ECE 5,A01,886400,Morris; Karcher William,2,0,6,4
1746548024789,ECE 5,A02,886401,Morris; Karcher William,3,0,6,3
1746548025818,ECE 148,A01,886403,Silberman; Jack,0,14,14,14
1746548026845,ECON 1,A01,887265,Crane; Meredith Helen,12,0,70,58
1746548026845,ECON 1,B01,887268,Staff,43,0,50,7
1746548027874,ECON 2,A01,887273,Crane; Meredith Helen,56,0,70,14
1746548028899,ECON 3,A01,887279,Rondina; Giacomo,32,0,70,38
1746548029923,ECON 4,A01,887282,Anderson; John Charles,0,2,10,10
1746548030950,ECON 5,A01,887285,Staff,33,0,45,12
1746548030950,ECON 5,B01,887292,Staff,41,0,45,4
1746548031976,ECON 100A,A01,887337,Newhouse; Herbert S,54,0,70,16
1746548031976,ECON 100A,B01,887349,Staff,45,0,50,5
1746548033004,ECON 100B,A01,887361,Du; Songzi,29,0,70,41
1746548034033,ECON 100C,A01,887445,Newhouse; Herbert S,59,0,70,11
1746548035060,ECON 105,A00,887488,Vespa; Emanuel Ignacio,23,0,35,12
1746548036089,ECON 109,A01,887506,Shishkin; Denis,28,0,35,7
1746548037116,ECON 110A,A01,887568,Alon; Titan Michael,0,3,35,35
1746548037116,ECON 110A,B01,907601,Alon; Titan Michael,20,0,35,15
1746548038143,ECON 110B,A01,887598,Levkoff; Steven B.,0,23,70,70
1746548039172,ECON 112,A00,887599,Rondina; Giacomo,19,0,35,16
1746548040197,ECON 120A,A01,887603,Dai; Yinlin,36,0,70,34
1746548041225,ECON 120C,A01,887608,Sun; Yixiao,0,1,35,35
1746548041225,ECON 120C,B01,887614,Sun; Yixiao,0,0,35,35
1746548042249,ECON 138,A00,887621,Bharadwaj; Prashant,0,20,20,20
1746548043278,ECON 144,A00,958007,Squires; Dale E,13,0,35,22
1746548044304,ECON 171,A01,907666,Staff,18,0,35,17
1746548045330,ECON 175,A00,887626,Wu; Pak Yeung,23,0,35,12
1746548046357,ECON 190,A00,887640,Vespa; Emanuel Ignacio,23,0,35,12
1746548047386,EDS 25,A01,888197,Staff,0,0,0,0
1746548047386,EDS 25,A02,888209,Staff,0,0,0,0
1746548047386,EDS 25,A03,888210,Staff,0,0,0,0
1746548047386,EDS 25,A04,888212,Staff,0,0,0,0
1746548047386,EDS 25,A05,888213,Staff,0,0,0,0
1746548047386,EDS 25,A06,888214,Staff,0,0,0,0
1746548047386,EDS 25,A07,888235,Staff,0,2,0,0
1746548047386,EDS 25,A08,888236,Staff,0,0,0,0
1746548047386,EDS 25,A09,888240,Staff,0,0,0,0
1746548047386,EDS 25,A10,888244,Staff,0,0,0,0
1746548047386,EDS 25,B01,888273,Staff,0,0,0,0
1746548047386,EDS 25,B02,888285,Staff,0,0,0,0
1746548047386,EDS 25,B03,888423,Staff,0,0,0,1
1746548047386,EDS 25,B04,888432,Staff,0,0,0,0
1746548047386,EDS 25,B05,888433,Staff,0,0,0,0
1746548047386,EDS 25,B06,888467,Staff,0,0,0,0
1746548047386,EDS 25,B07,888468,Staff,0,0,0,0
1746548047386,EDS 25,B08,888479,Staff,0,0,0,0
1746548047386,EDS 25,B09,888484,Staff,0,0,0,0
1746548047386,EDS 25,B10,888487,Staff,0,0,0,0
1746548048417,EDS 38,A01,907700,Choi; Bailey Miyeon,30,0,30,0
1746548049444,EDS 112,A01,888601,Chapman; Thandeka K,14,0,40,26
1746548050472,EDS 115,A00,888697,Mendez; Kathrina Mendoza,10,0,30,20
1746548051497,EDS 116,A01,888893,Staff,35,0,40,5
1746548053551,EDS 124AR,A00,889133,Staff,29,0,50,21
1746548053551,EDS 124AR,B00,907471,Simon; Elizabeth A,37,0,50,13
1746548054579,EDS 124BR,A00,889134,Simon; Elizabeth A,45,0,100,55
1746548055606,EDS 125,A00,889135,Staff,25,0,30,5
1746548056633,EDS 126,A01,889138,Staff,36,0,40,4
1746548057656,EDS 164R,A01,889142,Wishard Guerra; Alison G.,33,0,50,17
1746548058683,ENG 30,A01,886396,Staff,0,0,0,0
1746548058683,ENG 30,B01,886398,Staff,0,0,0,0
1746548059710,ENVR 102,A00,906150,Montejo; Carolina,23,0,25,2
1746548060735,ETHN 103A,A00,887236,Man; Simeon S,0,3,0,0
1746548061763,ETHN 113,A00,887239,Staff,16,0,30,14
1746548062790,ETHN 116,A00,887240,Staff,16,0,25,9
1746548063814,ETHN 117,A00,887241,Choi; Esther Min,28,0,30,2
1746548064838,ETHN 118,A00,887243,Staff,24,0,30,6
1746548065864,ETHN 127,A00,887248,Cuong; Marisol,11,0,15,4
1746548066893,ETHN 139,A00,887250,Staff,7,0,10,3
1746548067918,ETHN 142,A00,887252,Staff,10,0,30,20
1746548068942,ETHN 161,A00,887253,Browne; Errol Tsekani,24,0,30,6
1746548069969,ETHN 163FR,A00,887255,Burelle; Julie Sara Veronique,0,0,5,5
1746548070993,GLBH 20,A00,889149,Elwardani; Nile Regina,8,0,42,34
1746548073046,GLBH 111,A01,889152,Burgos; Jose L.,17,0,17,0
1746548074072,GLBH 150,A00,889181,Sloane; Julia Kathryn,0,5,15,15
1746548076123,HDS 60,A01,886406,Warstadt; Melissa Fawn,73,0,80,7
1746548077153,HIAF 111,A00,889324,Gyamfi; Bright,25,0,32,7
1746548078181,HIEA 131,A00,889328,Staff,16,0,32,16
1746548079209,HIEA 144,A00,889333,Henry; Todd A.,26,0,32,6
1746548080234,HIEA 154,A00,889336,Henry; Todd A.,24,0,32,8
1746548081261,HIEU 106,A00,889339,Staff,22,0,32,10
1746548083314,HIEU 114,A00,889340,Staff,3,0,32,29
1746548084339,HIEU 135GS,A00,889342,Patterson; Patrick H.,0,0,1,24
1746548085366,HIEU 137,A00,889343,Edington; Claire Ellen,9,0,25,16
1746548086392,HIEU 148,A00,889345,Staff,14,0,32,18
1746548087420,HIEU 154,A00,889346,Biess; Frank Peter,21,0,32,11
1746548088449,HILA 102,A00,889351,Staff,12,0,32,20
1746548089477,HILD 2A,A01,889221,Lewandoski; Julia Mavis,1,10,32,31
1746548090503,HILD 7B,A01,889225,Man; Simeon S,0,13,32,32
1746548091528,HILD 7C,A01,889288,Alvarez; Luis A,0,14,32,32
1746548092556,HILD 30,A01,889323,Staff,0,5,32,32
1746548094609,HISC 119,A00,889383,Golan; Tal,21,0,32,11
1746548095637,HIUS 103,A00,889384,Man; Simeon S,0,0,32,32
1746548096664,HIUS 117,A00,919797,Kwak; Nancy,18,0,32,14
1746548097692,HIUS 142A,A00,919788,Staff,22,0,32,10
1746548099746,HIUS 149,A00,889386,Gyamfi; Bright,27,0,32,5
1746548100772,HIUS 155,A00,889387,Alvarez; Luis A,14,0,32,18
1746548101801,HUM 3,A01,886499,Caldwell; Michael Alan,19,0,50,31
1746548102830,HUM 3GS,A00,886500,Rodriguez; Bretton Sigfred,0,0,0,28
1746548103856,HUM 3R,A01,886502,Markman; Kristina,0,36,50,50
1746548104886,HUM 4,A01,886504,Crum; Matthew Stephen,24,0,50,26
1746548104886,HUM 4,B01,886506,West; Geoffrey Scott,17,0,50,33
1746548105912,HUM 4GS,A00,886507,Staff,0,0,0,19
1746548106937,HUM 5,A01,886509,Staff,32,0,50,18
1746548107967,HUM 5R,A01,886511,Zavodny; Tatiana Sophia,0,39,50,50
1746548108992,JAPN 180,A00,886407,Staff,18,0,40,22
1746548110024,LATI 50,A01,886409,Martin-Cabrera; Luis,4,0,22,18
1746548110024,LATI 50,A02,886410,Martin-Cabrera; Luis,19,0,22,3
1746548110024,LATI 50,A03,886411,Martin-Cabrera; Luis,21,0,22,1
1746548110024,LATI 50,A04,886412,Martin-Cabrera; Luis,9,0,22,13
1746548111050,LAWS 101,A00,907664,Staff,28,0,60,32
1746548112077,LIAB 1A,A00,889388,Saab; Dima,17,0,20,3
1746548113102,LIAB 1AX,A00,889389,El Cheddadi; Youniss,17,0,20,3
1746548114131,LIFR 1C,A00,889391,Van Moer; Vinciane G,8,0,20,12
1746548115157,LIFR 1CX,A00,889392,Van Moer; Vinciane G,7,0,20,13
1746548116183,LIFR 1D,A00,889393,Van Moer; Vinciane G,7,0,20,13
1746548117208,LIFR 1DX,A00,889394,Van Moer; Vinciane G,8,0,20,12
1746548118236,LIGN 7,A00,886923,Staff,24,0,50,26
1746548119262,LIGN 17,A00,886924,Kehler; Andrew Scott,125,0,150,25
1746548120291,LTAM 110,A00,889395,Staff,15,0,30,15
1746548121317,LTAM 110GS,A00,958010,Rodriguez; Bretton Sigfred,0,0,0,28
1746548122346,LTCH 101,A00,889397,Staff,23,0,25,2
1746548123373,LTCS 130,A00,889398,Staff,23,0,25,2
1746548124399,LTEA 138,A00,889399,Staff,24,0,40,16
1746548125427,LTEN 149,A00,889400,Wesling; Megan E.,0,3,25,25
1746548126454,LTEN 169,A00,889401,Staff,20,0,25,5
1746548127480,LTEN 180,A00,889402,Staff,10,0,15,5
1746548128507,LTEN 181,A00,889403,Staff,21,0,25,4
1746548129532,LTWL 100,A00,889404,Myerston Santana; Jacobo,3,0,25,22
1746548130559,LTWL 180GS,A00,889405,Staff,0,0,20,20
1746548131584,LTWL 181,A00,889406,Staff,17,0,25,8
1746548132608,LTWL 184,A00,889475,Mukherjee; Silpa,22,0,25,3
1746548133633,LTWR 102C,A00,889486,Staff,29,0,30,1
1746548134658,LTWR 115W,A00,889491,Staff,0,2,15,15
1746548135684,MAE 8,A01,886905,Staff,0,2,0,0
1746548136713,MAE 11,A00,886906,Bandaru; Prabhakar,0,7,50,50
1746548137741,MAE 20,A00,886907,Evdokimenko; Ekaterina,44,0,70,26
1746548138767,MAE 30B,A00,886909,Ghazinejad; Maziar,26,0,45,19
1746548139797,MAE 101B,A00,886910,Saintillan; David,29,0,45,16
1746548140825,MAE 105,A00,886911,Bandaru; Prabhakar,18,0,50,32
1746548141851,MAE 107,B00,958024,Staff,8,0,50,42
1746548142877,MAE 143B,A00,886913,Bewley; Thomas R,7,0,40,33
1746548143904,MAE 148,A01,886915,Silberman; Jack,0,3,14,14
1746548144929,MAE 160,A00,886916,Evdokimenko; Ekaterina,31,0,60,29
1746548145962,MATH 3C,A01,889681,Staff,0,3,30,30
1746548145962,MATH 3C,A02,960048,Staff,25,0,30,5
1746548146989,MATH 10A,A01,889760,Staff,26,0,30,4
1746548146989,MATH 10A,A02,889783,Staff,29,0,30,1
1746548148015,MATH 10B,A01,889785,Verstraete; Jacques Allan,2,0,35,33
1746548148015,MATH 10B,A02,889795,Verstraete; Jacques Allan,4,0,35,31
1746548148015,MATH 10B,B01,889797,Verstraete; Jacques Allan,3,0,35,32
1746548148015,MATH 10B,B02,889828,Verstraete; Jacques Allan,3,0,35,32
1746548149042,MATH 10C,A01,889849,Habib; Yousaf,9,0,30,21
1746548149042,MATH 10C,A02,889852,Habib; Yousaf,14,0,30,16
1746548149042,MATH 10C,A03,889853,Habib; Yousaf,22,0,30,8
1746548149042,MATH 10C,A04,889858,Habib; Yousaf,20,0,30,10
1746548149042,MATH 10C,B01,889861,Staff,1,0,30,29
1746548149042,MATH 10C,B02,889862,Staff,24,0,30,6
1746548149042,MATH 10C,B03,889863,Staff,27,0,30,3
1746548149042,MATH 10C,B04,889967,Staff,23,0,30,7
1746548150068,MATH 18,A01,889974,Staff,7,0,30,23
1746548150068,MATH 18,A02,889977,Staff,20,0,30,10
1746548150068,MATH 18,B01,889984,Hardiman; Liam,22,0,30,8
1746548150068,MATH 18,B02,889985,Hardiman; Liam,25,0,30,5
1746548151098,MATH 20A,A01,889990,Suk; Andrew Hoon,29,0,35,6
1746548152124,MATH 20B,A01,889993,Ohm; Ko Woon,22,0,30,8
1746548152124,MATH 20B,A02,889994,Ohm; Ko Woon,30,0,30,0
1746548152124,MATH 20B,B01,889996,Ohm; Ko Woon,21,0,30,9
1746548152124,MATH 20B,B02,889997,Ohm; Ko Woon,23,0,30,7
1746548153156,MATH 20C,A01,889999,Hammock; Frances H,17,0,30,13
1746548153156,MATH 20C,A02,890003,Hammock; Frances H,23,0,30,7
1746548153156,MATH 20C,B01,890006,Hammock; Frances H,3,0,30,27
1746548153156,MATH 20C,B02,890007,Hammock; Frances H,11,0,30,19
1746548154186,MATH 20D,A01,890011,Cheng; Hsiao-Bing,1,1,30,29
1746548154186,MATH 20D,A02,890012,Cheng; Hsiao-Bing,14,0,30,16
1746548154186,MATH 20D,B01,890016,Cheng; Hsiao-Bing,13,0,30,17
1746548154186,MATH 20D,B02,890017,Cheng; Hsiao-Bing,13,0,30,17
1746548155215,MATH 20E,A01,890026,Harel; Guershon,1,0,30,29
1746548155215,MATH 20E,A02,890029,Harel; Guershon,23,0,30,7
1746548155215,MATH 20E,B01,890033,Harel; Guershon,7,0,30,23
1746548155215,MATH 20E,B02,890101,Harel; Guershon,21,0,30,9
1746548156240,MATH 102,A01,890104,Staff,17,0,30,13
1746548156240,MATH 102,A02,890105,Staff,27,0,30,3
1746548157270,MATH 103B,A01,890116,Salehi Golsefidy; Alireza,3,0,30,27
1746548157270,MATH 103B,B01,890118,Staff,0,3,34,34
1746548158296,MATH 109,A01,890121,Aliabadi Sr.; Mohsen,1,0,30,29
1746548158296,MATH 109,B01,890124,Upadrashta; Pranav Kumar,18,0,30,12
1746548159321,MATH 120A,A01,890126,Eggers; John Dietrich,13,0,30,17
1746548160346,MATH 142B,A01,890128,Ioana; Adrian,19,0,30,11
1746548160346,MATH 142B,A02,890129,Ioana; Adrian,13,0,30,17
1746548161371,MATH 154,A01,890174,Staff,0,0,30,30
1746548161371,MATH 154,A02,890182,Staff,0,0,30,30
1746548162408,MATH 168A,A01,890197,Dumitriu; Ioana,21,0,35,14
1746548163436,MATH 170A,A01,890240,Nie; Jiawang,1,0,30,29
1746548163436,MATH 170A,A02,890241,Nie; Jiawang,11,0,30,19
1746548163436,MATH 170A,A03,890249,Nie; Jiawang,23,0,30,7
1746548164465,MATH 170B,A01,957891,Nag; Panchali,13,0,35,22
1746548166517,MATH 181A,A01,908025,Staff,0,4,35,35
1746548166517,MATH 181A,A02,960115,Staff,27,0,35,8
1746548167541,MATH 181B,A01,959874,Staff,26,0,30,4
1746548168568,MATH 193B,A01,890265,Staff,0,4,35,35
1746548169594,MGT 4,A01,890311,Anderson; John Charles,42,0,88,46
1746548170619,MGT 5,A00,907740,Staff,13,0,98,85
1746548171644,MGT 12,A00,890312,Lindenberger; Wade Douglas,67,0,98,31
1746548172672,MGT 16,A00,957883,Staff,78,0,98,20
1746548174728,MGT 45,A00,890314,Pecore; Joseph P.,47,0,98,51
1746548175753,MGT 71,A00,890315,Staff,0,11,98,98
1746548176779,MGT 100,A00,890316,Yavorsky; Daniel Ryan,44,0,98,54
1746548177806,MGT 103,A00,890317,Ehrich; Kristine R,73,0,98,25
1746548178834,MGT 105,A00,890356,Bates; Kenneth Walter,0,7,98,98
1746548179861,MGT 112,A00,890360,Ehrich; Kristine R,55,0,98,43
1746548180890,MGT 127R,A00,907732,Zhu; Kevin Xiaoguo,23,0,98,75
1746548181917,MGT 131B,A00,890361,Anderson; John Charles,61,0,98,37
1746548182943,MGT 137,A00,890362,Lindenberger; Wade Douglas,65,0,98,33
1746548183968,MGT 160,A00,890369,Johnson; Erik Barry,9,0,98,89
1746548186031,MGT 164,A00,890372,Zimmermann; Carsten,0,39,98,98
1746548187061,MGT 180,A00,890374,Bliss; Barbara Ann,12,0,98,86
1746548188087,MMW 15,A01,886414,Chang; Edmond Yi-Teh,0,12,28,28
1746548188087,MMW 15,A02,886415,Chang; Edmond Yi-Teh,0,8,28,28
1746548188087,MMW 15,A03,886416,Chang; Edmond Yi-Teh,0,8,28,28
1746548188087,MMW 15,A04,886417,Chang; Edmond Yi-Teh,0,8,28,28
1746548188087,MMW 15,B01,886419,Chang; Edmond Yi-Teh,0,7,28,28
1746548188087,MMW 15,B02,886420,Chang; Edmond Yi-Teh,0,8,28,28
1746548188087,MMW 15,B03,886421,Chang; Edmond Yi-Teh,0,7,28,28
1746548188087,MMW 15,B04,886422,Chang; Edmond Yi-Teh,0,8,28,28
1746548188087,MMW 15,C01,886424,Staff,0,9,28,28
1746548188087,MMW 15,C02,886425,Staff,0,8,28,28
1746548188087,MMW 15,C03,886426,Staff,0,8,28,28
1746548188087,MMW 15,C04,886427,Staff,0,7,28,28
1746548188087,MMW 15,C05,958038,Staff,0,7,28,28
1746548188087,MMW 15,C06,958039,Staff,0,8,28,28
1746548189114,MMW 15GS,A00,906910,Patterson; Patrick H.,4,0,28,24
1746548190144,MMW 122R,A01,886429,Rahimi; Babak,0,13,28,28
1746548190144,MMW 122R,A02,886430,Rahimi; Babak,0,12,28,28
1746548190144,MMW 122R,A03,958040,Rahimi; Babak,0,11,28,28
1746548191175,MUS 1A,A01,890937,Staff,3,0,25,22
1746548191175,MUS 1A,A02,891035,Staff,6,0,25,19
1746548191175,MUS 1A,C01,958912,Staff,24,0,25,1
1746548191175,MUS 1A,C02,958913,Staff,25,0,25,0
1746548193225,MUS 2AK,A00,957092,Ohnishi; Takae,15,0,15,0
1746548194252,MUS 4,A01,891044,Staff,2,0,25,23
1746548194252,MUS 4,A02,891045,Staff,23,0,25,2
1746548194252,MUS 4,B01,891048,Staff,17,0,25,8
1746548194252,MUS 4,B02,891050,Staff,25,0,25,0
1746548195278,MUS 5,A01,957506,Dubnov; Shlomo,0,0,25,25
1746548195278,MUS 5,A02,957622,Dubnov; Shlomo,14,0,25,11
1746548195278,MUS 5,A03,957623,Dubnov; Shlomo,20,0,25,5
1746548196307,MUS 6,A01,891053,Freitas Caetano; Marcelo,24,0,25,1
1746548196307,MUS 6,A02,891054,Freitas Caetano; Marcelo,23,0,25,2
1746548197332,MUS 7,A01,891081,Staff,0,0,25,25
1746548197332,MUS 7,A02,891082,Staff,4,0,25,21
1746548198358,MUS 8GS,A00,891118,Borgo; David Garcia,0,0,25,25
1746548199384,MUS 11,A01,891140,Staff,11,0,25,14
1746548199384,MUS 11,A02,891141,Staff,22,0,25,3
1746548200413,MUS 13,A01,891143,Staff,8,0,25,17
1746548200413,MUS 13,A02,891144,Staff,24,0,25,1
1746548201441,MUS 15,A01,891146,Staff,9,0,25,16
1746548201441,MUS 15,A02,891148,Staff,21,0,25,4
1746548201441,MUS 15,B01,891150,Staff,18,0,25,7
1746548201441,MUS 15,B02,891151,Staff,25,0,25,0
1746548202469,MUS 20,A01,891153,Staff,5,0,20,15
1746548202469,MUS 20,A02,891155,Staff,14,0,20,6
1746548203496,MUS 80,A00,891156,Staff,19,0,25,6
1746548203496,MUS 80,B00,891157,Staff,23,0,25,2
1746548204523,MUS 130,A00,891158,Ohnishi; Takae,35,0,35,0
1746548205549,MUS 150GS,A01,891160,Borgo; David Garcia,0,0,25,25
1746548206576,MUS 170,A01,891162,Freitas Caetano; Marcelo,20,0,25,5
1746548206576,MUS 170,A02,891164,Freitas Caetano; Marcelo,21,0,25,4
1746548207601,NANO 11,A00,886220,Vazquez Mena; Oscar,13,0,15,2
1746548208627,NANO 15,A01,886222,Drews; Aaron,4,0,7,3
1746548209656,NANO 104,A00,886224,Sirbuly; Donald,18,0,25,7
1746548210681,PH 40,A00,886528,Staff,23,0,40,17
1746548211708,PH 45,A01,886799,Staff,35,0,40,5
1746548212733,PH 110,A00,886802,Staff,0,7,40,40
1746548213758,PH 172,A00,906716,Staff,19,0,35,16
1746548214786,PH 191,A00,886803,Staff,6,0,40,34
1746548215813,PHIL 1,A00,889500,Staff,19,0,30,11
1746548216841,PHIL 10,A01,889549,Grush; Rick Scott,15,0,22,7
1746548216841,PHIL 10,A02,889551,Grush; Rick Scott,22,0,22,0
1746548217867,PHIL 28,A01,889559,Lamey; Andy M.,0,1,31,31
1746548217867,PHIL 28,A02,889561,Lamey; Andy M.,0,1,30,30
1746548217867,PHIL 28,A03,889572,Lamey; Andy M.,0,0,30,30
1746548218896,PHIL 35,A00,907839,Staff,13,0,15,2
1746548219925,PHIL 60,A00,889574,Staff,74,0,90,16
1746548220955,PHIL 101,A00,958004,Staff,13,0,15,2
1746548223006,PHIL 136,A00,889582,Fulkerson; Matthew Todd,26,0,45,19
1746548224033,PHIL 163,A01,889601,Staff,21,0,30,9
1746548224033,PHIL 163,B01,889606,Brandt; Reuven A,0,3,0,0
1746548225060,PHIL 164,A00,889610,Staff,16,0,30,14
1746548226089,PHIL 165,A00,889613,Staff,23,0,30,7
1746548227120,PHYS 1A,A00,886431,Staff,26,0,70,44
1746548228146,PHYS 1AL,001,886432,Tsai; Philbert S,0,2,30,30
1746548228146,PHYS 1AL,002,886436,Tsai; Philbert S,11,0,30,19
1746548229172,PHYS 1B,A00,886439,Staff,185,0,240,55
1746548230196,PHYS 1BL,001,886441,Tsai; Philbert S,0,4,30,30
1746548230196,PHYS 1BL,002,886444,Tsai; Philbert S,2,0,30,28
1746548231224,PHYS 1C,A00,896092,Arnold; Kam S,78,0,146,68
1746548232249,PHYS 1CL,001,886448,Tsai; Philbert S,0,0,30,30
1746548232249,PHYS 1CL,002,886449,Tsai; Philbert S,0,0,30,30
1746548232249,PHYS 1CL,003,886450,Tsai; Philbert S,16,0,30,14
1746548232249,PHYS 1CL,004,886451,Tsai; Philbert S,15,0,30,15
1746548233276,PHYS 2B,A01,886457,Staff,69,0,115,46
1746548234304,PHYS 2C,A01,886460,Shotwell; Brian,0,8,65,65
1746548235331,PHYS 2CL,A01,886467,Staff,0,4,28,28
1746548235331,PHYS 2CL,A02,886468,Staff,0,3,28,28
1746548236357,PHYS 2D,A01,886470,Staff,10,0,50,40
1746548237387,PHYS 4B,A01,886475,Grinstein; Benjamin,22,0,40,18
1746548238410,POLI 5,A00,891173,Desposato; Scott,7,0,25,18
1746548239437,POLI 5D,A01,891175,Staff,5,0,5,0
1746548239437,POLI 5D,B01,891178,Staff,5,0,5,0
1746548240488,POLI 11,A00,891179,Ferree; Karen E,2,0,35,33
1746548241514,POLI 12,A00,891180,Staff,16,0,30,14
1746548242541,POLI 27,A01,891182,Staff,12,0,75,63
1746548243566,POLI 30,A00,891183,Staff,8,0,50,42
1746548244594,POLI 100B,A00,891244,Staff,5,1,35,30
1746548245621,POLI 100I,A00,891247,Staff,7,0,30,23
1746548246645,POLI 104J,A00,891248,Nichter; Maysa,14,0,30,16
1746548247672,POLI 104U,A00,891250,Nichter; Maysa,2,0,30,28
1746548249721,POLI 110B,A00,891255,Wiens; David,20,0,25,5
1746548250748,POLI 112A,A00,891256,Wiens; David,6,0,25,19
1746548251776,POLI 114BR,A00,891261,Staff,19,0,30,11
1746548252804,POLI 117R,A00,891262,Forman; Fonna,0,6,50,50
1746548253828,POLI 118,A00,891264,Ingham; Sean,17,0,25,8
1746548254854,POLI 124A,A00,891265,Staff,18,0,20,2
1746548255880,POLI 125D,A00,891266,Nichter; Simeon C,2,0,25,23
1746548256908,POLI 126,A00,891268,Nichter; Simeon C,7,0,25,18
1746548257932,POLI 126AA,A00,891272,Staff,18,0,25,7
1746548258957,POLI 130AA,A00,891273,Staff,15,0,20,5
1746548259985,POLI 134AA,A00,891274,Staff,4,0,20,16
1746548262035,POLI 138,A00,891278,Staff,21,0,25,4
1746548263059,POLI 142K,A00,891280,Staff,11,0,25,14
1746548264083,POLI 142M,A00,891281,Gartzke; Erik,17,0,30,13
1746548265110,POLI 142P,A00,891284,Staff,20,0,30,10
1746548266137,POLI 143,A00,891285,Gartzke; Erik,12,0,30,18
1746548267163,POLI 153,A00,891286,Staff,19,0,20,1
1746548269213,POLI 175,A00,891290,Staff,15,0,20,5
1746548270237,PSYC 1,A00,890674,Steiner; Eric Tomas,0,11,45,45
1746548271261,PSYC 2,A00,890676,Albright; Thomas D,21,0,35,14
1746548272289,PSYC 3,A00,890679,Staff,17,0,20,3
1746548273317,PSYC 6,A00,959858,Staff,20,0,20,0
1746548274348,PSYC 60,A01,890684,Rickard; Timothy C.,0,5,45,45
1746548275372,PSYC 70,A01,890689,Geller; Emma Harlan,7,0,30,23
1746548276401,PSYC 71,A01,959860,Staff,21,0,25,4
1746548277433,PSYC 100,A00,890690,Lacefield; Katharine I,0,50,180,180
1746548278458,PSYC 102,A00,890695,Staff,18,0,40,22
1746548279484,PSYC 105,A00,890699,Geller; Emma Harlan,71,0,100,29
1746548280508,PSYC 106,A00,890701,Gorman; Michael R.,5,0,30,25
1746548281534,PSYC 108,A00,890704,Adrian; Julia Anna,0,28,50,50
1746548282559,PSYC 118,A01,890712,Staff,11,0,30,19
1746548283584,PSYC 124,A00,890716,Chapman; Eddie Nathaniel,25,0,60,35
1746548284609,PSYC 131,A00,890717,Anagnostaras; Stephan,0,7,80,80
1746548285634,PSYC 137,A00,890719,Winkielman; Piotr,0,11,30,30
1746548286660,PSYC 144,A00,890721,Adrian; Julia Anna,0,9,45,45
1746548287687,PSYC 162,A00,890805,Staff,2,0,75,73
1746548288716,PSYC 169,A00,890810,Staff,0,15,30,30
1746548289744,PSYC 172,A00,890814,Gorman; Michael R.,9,0,30,21
1746548290772,PSYC 181,A00,890818,Anagnostaras; Stephan,8,0,200,192
1746548291798,PSYC 184,A00,959861,Staff,170,0,175,5
1746548292822,PSYC 189,A00,890823,Staff,0,1,30,30
1746548293860,PSYC 191,A00,890884,Rickard; Timothy C.,0,11,35,35
1746548294885,PSYC 193,A00,890913,Staff,19,0,30,11
1746548294885,PSYC 193,B00,890914,Chapman; Eddie Nathaniel,24,0,30,6
1746548295910,PSYC 193L,A01,890918,Lowe; Angela Beth,20,0,30,10
1746548295910,PSYC 193L,B01,890921,Hurwitz; Ethan Scott,20,0,30,10
1746548295910,PSYC 193L,C01,890928,Staff,30,0,30,0
1746548296933,RELI 149,A00,886806,Rahimi; Babak,23,0,40,17
1746548297958,SE 9,A01,886814,Staff,7,0,20,13
1746548298986,SE 101B,A01,886816,Chadha; Mayank,4,0,35,31
1746548300020,SE 110B,A00,886818,Zhu; Qiang,4,0,75,71
1746548301050,SE 125,A01,886830,Staff,10,0,30,20
1746548302100,SE 130B,A01,886835,Staff,14,0,40,26
1746548303126,SE 131A,A01,886838,Krysl; Petr,34,0,55,21
1746548304151,SE 154,A00,886840,Staff,30,0,50,20
1746548305176,SE 164GS,A01,886849,Staff,6,0,20,14
1746548306199,SE 167GS,A01,886853,Staff,6,0,20,14
1746548307225,SIO 25,A01,890107,Staff,19,0,30,11
1746548308251,SIO 45,A00,890109,Cook; Geoffrey W,117,0,200,83
1746548309274,SIO 109R,A00,890110,Forman; Fonna,0,16,20,20
1746548310303,SIO 187,A01,890114,Kacev; David,15,0,40,25
1746548311327,SOCI 1,A01,890431,Thorpe; Charles Robert,15,0,30,15
1746548311327,SOCI 1,A02,890518,Thorpe; Charles Robert,30,0,30,0
1746548312351,SOCI 2,A01,957978,Staff,25,0,25,0
1746548312351,SOCI 2,A02,957979,Staff,23,0,25,2
1746548313376,SOCI 20,A01,890523,Calderon-Zaks; Michael Aar,23,0,30,7
1746548313376,SOCI 20,A02,890526,Calderon-Zaks; Michael Aar,29,0,30,1
1746548314406,SOCI 30,A01,890533,Pardo Guerra; Juan Pablo,37,0,40,3
1746548315433,SOCI 40,A01,890535,Staff,27,0,45,18
1746548316459,SOCI 104Q,A00,890559,Staff,18,0,30,12
1746548317483,SOCI 106,A00,890560,Arnal; Maud Marie Leonie,20,0,30,10
1746548318509,SOCI 110,A00,890567,Holkenbrink-Monk; Charlene,19,0,30,11
1746548319539,SOCI 112,A00,890568,Victoria Torres; Pablo,1,0,55,54
1746548320563,SOCI 115,A00,890597,Arnal; Maud Marie Leonie,28,0,45,17
1746548322619,SOCI 121,A00,890604,Pardo Guerra; Juan Pablo,38,0,45,7
1746548323645,SOCI 126,A01,890608,Staff,8,0,10,2
1746548324673,SOCI 127,A00,890609,Staff,18,0,30,12
1746548325700,SOCI 131,A00,890610,Thorpe; Charles Robert,37,0,45,8
1746548326729,SOCI 135,A00,890615,Payne; Christine Anna,14,0,45,31
1746548327755,SOCI 139,A00,890620,Staff,38,0,45,7
1746548328782,SOCI 148E,A00,890622,Calderon-Zaks; Michael Aar,36,0,45,9
1746548329807,SOCI 150,A00,890623,Kohler; Kristopher M.,31,0,45,14
1746548330833,SOCI 157,A00,890625,Jules-Rosette; Bennetta W.,18,0,20,2
1746548331859,SOCI 160,A00,890627,Payne; Christine Anna,21,0,45,24
1746548332886,SYN 1,A00,886855,Fish; Gwendolyn Anne,0,0,0,0
1746548332886,SYN 1,B00,906086,Fish; Gwendolyn Anne,0,1,0,2
1746548333912,SYN 2R,A00,886860,Staff,0,17,15,15
1746548333912,SYN 2R,B00,906106,Atkinson; Arthur Laird,0,16,15,15
1746548334937,SYN 100,A01,886866,Browne; Emily,0,28,20,20
1746548334937,SYN 100,B01,906128,Rock; Martin,0,5,20,20
1746548334937,SYN 100,C01,906140,Deavenport; James Cary,0,3,20,20
1746548334937,SYN 100,D01,907816,Deavenport; James Cary,0,5,20,20
1746548335963,TDAC 1,A00,890286,Walsh; Kim C.,9,0,20,11
1746548336992,TDAC 101,A00,890296,Basso; Beatrice,16,0,20,4
1746548338017,TDDE 131,A00,890297,Staff,47,0,50,3
1746548339041,TDDM 1,A00,890287,Weinberg; Sadie,25,0,30,5
1746548340068,TDGE 11,A00,890288,Fulton; Julia,137,0,200,63
1746548340068,TDGE 11,B00,890289,Castro; Robert Jess,184,0,200,16
1746548341095,TDGE 25,B00,957359,Walsh; Kim C.,3,0,20,17
1746548342119,TDGE 40,A01,890292,Power; Jade Yukana,27,0,30,3
1746548343146,TDGE 124,A00,890298,Havis; Allan,0,0,50,50
1746548344172,TDGE 131R,A00,890299,Burelle; Julie Sara Veronique,15,0,42,27
1746548345201,TDHT 101,A00,890300,Staff,10,0,20,10
1746548346230,TDHT 109,A01,890302,Anderson; Mysia Anyse,31,0,40,9
1746548347253,TDMV 1,A00,890293,Arcidiacono; Kristin,18,0,30,12
1746548348278,TDMV 2,A00,890294,Weinberg; Sadie,23,0,30,7
1746548349302,TDMV 3,A00,957878,Arcidiacono; Kristin,28,0,30,2
1746548351356,TDMV 138,A00,890304,Jun; Grace Shin Hae,25,0,40,15
1746548352380,TDMV 140,A00,890305,Corrales; Joseph Bernales,25,0,30,5
1746548353406,TDMV 142,A00,890307,Caligagan; Tony,32,0,40,8
1746548354431,TDMV 144,A00,890308,Camaya; Michelle Ann,25,0,30,5
1746548355455,TDPW 1,A00,890295,Stein; Deborah Isobel,3,0,20,17
1746548356483,USP 2,A01,890272,Lerner; Amy M,6,0,20,14
1746548357508,USP 3,A01,890274,Staff,12,0,30,18
1746548358537,USP 15,A01,890276,Sun; Feiyang,17,0,30,13
1746548359564,USP 25,A00,890277,Shenkman; Michael Thomas,19,0,25,6
1746548360589,USP 138,A00,890278,Staff,13,0,25,12
1746548361613,USP 143,A00,890279,Staff,21,0,70,49
1746548362639,USP 144,A00,890280,Chowdhury; Muhammed Zohir,16,0,30,14
1746548363666,USP 150,A00,890281,Boomhower; Matthew Charles,4,0,30,26
1746548364693,USP 151,A00,890282,Staff,16,0,20,4
1746548365720,USP 162,A00,890283,Andrews; Abigail Leslie,16,0,20,4
1746548366745,USP 168,A00,920477,Kwak; Nancy,1,0,5,4
1746548367769,USP 181,A00,890284,Staff,3,0,20,17
1746548368797,USP 191A,A00,890285,Staff,13,0,20,7
1746548369823,VIS 101,A00,886512,Staff,25,0,75,50
1746548370855,VIS 103,A00,886513,Cruz; Edwin Teddy,61,0,75,14
1746548371882,VIS 108,A00,886514,Staff,3,0,15,12
1746548372908,VIS 127P,A00,886515,Shen; Kuiyi,80,0,146,66
1746548373933,VIS 149,A00,886516,Yoldas; Pinar,0,0,15,15
1746548374960,VIS 164,A00,886526,Erdmann; Dean,19,0,22,3
1746548375987,VIS 194S,A00,886527,Staff,61,0,75,14
1746548377015,WCWP 10A,C00,886484,Martiniuk; Jill,12,0,15,3
1746548378046,WCWP 10B,A00,886490,Uriarte; Emma,0,0,15,15
1746548378046,WCWP 10B,B00,886491,Dhir; Simrita,10,0,15,5
1746548378046,WCWP 10B,C00,886492,Ornelas; Tricia,0,0,15,15
1746548379075,WCWP 100,A00,886494,Young; Mark T,0,6,15,15
1746548381152,AAS 10,A01,886199,Childs; Dennis R.,0,3,0,0
1746548382176,ANAR 104,A01,886940,Shtienberg; Gilad,27,0,30,3
1746548383203,ANAR 120,A00,886953,Staff,12,0,20,8
1746548384230,ANBI 148,A01,886955,Wilder; Linnea Lorene,30,0,40,10
1746548386279,ANSC 122,A00,886957,Staff,25,0,30,5
1746548387302,ANSC 150,A00,886958,Sloane; Julia Kathryn,3,0,15,12
1746548388326,ANSC 156,A00,886959,Jenkins; Janis A.,0,1,15,15
1746548389351,ANSC 180,A00,886960,Staff,11,0,17,6
1746548390375,ANSC 188,A00,886961,Jassal; Aftab,9,0,25,16
1746548391401,ANSC 190,A00,886962,Jassal; Aftab,14,0,25,11
1746548392428,ANSC 191,A00,886963,Staff,18,0,20,2
1746548393454,ANTH 3,A01,891689,Staff,17,0,20,3
1746548394478,ANTH 5,A00,886933,Semendeferi; Ekaterini,16,0,20,4
1746548395504,ANTH 10,A00,886934,Staff,0,12,30,30
1746548396533,ANTH 21,A01,886936,Staff,40,0,60,20
1746548397558,ANTH 23,A01,886938,Staff,92,0,100,8
1746548398587,ANTH 105,A00,886964,Stewart; Alexander B,84,0,100,16
1746548399612,ANTH 108,A00,886965,Pedersen; David,9,0,20,11
1746548400642,AWP 10,001,886147,Staff,0,0,0,0
1746548400642,AWP 10,002,886148,Staff,0,0,0,0
1746548400642,AWP 10,003,886149,Staff,0,0,0,0
1746548400642,AWP 10,004,886150,Staff,0,0,0,0
1746548400642,AWP 10,005,886151,Staff,0,0,0,0
1746548400642,AWP 10,006,886152,Staff,0,0,0,0
1746548400642,AWP 10,007,886153,Staff,0,0,0,0
1746548400642,AWP 10,008,886154,Staff,0,0,0,0
1746548400642,AWP 10,009,886155,Staff,0,0,0,0
1746548400642,AWP 10,010,886156,Staff,0,0,0,0
1746548400642,AWP 10,011,886158,Staff,0,0,0,0
1746548400642,AWP 10,012,886160,Staff,0,0,0,0
1746548400642,AWP 10,013,886161,Staff,0,0,0,0
1746548400642,AWP 10,014,886162,Staff,0,0,0,0
1746548400642,AWP 10,015,886163,Staff,0,0,0,0
1746548400642,AWP 10,016,886164,Staff,0,0,0,0
1746548400642,AWP 10,017,886165,Staff,0,0,0,0
1746548400642,AWP 10,018,886166,Staff,0,0,0,0
1746548400642,AWP 10,019,886168,Staff,0,0,0,0
1746548400642,AWP 10,020,886170,Staff,0,0,0,0
1746548400642,AWP 10,021,886172,Staff,0,0,0,0
1746548401676,AWP 10R,001,886173,Staff,0,1,0,0
1746548401676,AWP 10R,002,886174,Staff,0,1,0,0
1746548401676,AWP 10R,003,886175,Staff,0,0,0,0
1746548401676,AWP 10R,004,886176,Staff,0,0,0,0
1746548401676,AWP 10R,005,886177,Staff,0,0,0,0
1746548401676,AWP 10R,006,886178,Staff,0,0,0,0
1746548401676,AWP 10R,007,886179,Staff,0,0,0,0
1746548401676,AWP 10R,008,886181,Staff,0,0,0,0
1746548401676,AWP 10R,009,886182,Staff,0,0,0,0
1746548401676,AWP 10R,010,886183,Staff,0,0,0,0
1746548401676,AWP 10R,011,886184,Staff,0,0,0,0
1746548401676,AWP 10R,012,886185,Staff,0,0,0,0
1746548401676,AWP 10R,013,886186,Staff,0,0,0,0
1746548401676,AWP 10R,014,886187,Staff,0,0,0,0
1746548401676,AWP 10R,015,886188,Staff,0,0,0,0
1746548401676,AWP 10R,016,886189,Staff,0,0,0,0
1746548402701,AWP 102R,A00,886190,Staff,0,0,0,0
1746548402701,AWP 102R,B00,886191,Staff,0,0,0,0
1746548403728,BENG 100,A01,886193,Staff,17,0,30,13
1746548404752,BENG 122A,A01,886195,Hasty; Jeff M,13,0,30,17
1746548405780,BENG 166A,A00,886196,Sah; Robert Lie-Yuan,0,1,30,30
1746548406805,BENG 190,A00,958050,Khojah; Reem I,24,0,25,1
1746548407833,BIBC 102,A01,894320,Staff,0,0,46,46
1746548407833,BIBC 102,A02,894321,Staff,0,0,46,46
1746548407833,BIBC 102,A03,894344,Staff,7,0,46,39
1746548407833,BIBC 102,A04,894345,Staff,26,0,47,21
1746548408860,BICD 100R,A01,894365,Smith; Laurie,0,3,58,58
1746548408860,BICD 100R,A02,894366,Smith; Laurie,0,5,58,58
1746548408860,BICD 100R,A03,894367,Smith; Laurie,2,0,59,57
1746548408860,BICD 100R,A04,959869,Smith; Laurie,41,0,59,18
1746548409886,BICD 136,A01,894383,Gustafson-Brown; Cindy,14,0,50,36
1746548410911,BIEB 102,A01,894494,Butler; Shannon Rhey,51,0,130,79
1746548412963,BIEB 150,A01,894617,Wills; Christopher,3,0,20,17
1746548412963,BIEB 150,A02,894631,Wills; Christopher,3,0,20,17
1746548412963,BIEB 150,A03,894937,Wills; Christopher,3,0,20,17
1746548412963,BIEB 150,A04,894946,Wills; Christopher,5,0,20,15
1746548413990,BIEB 194,A00,906141,Kurle; Carolyn M.,6,0,20,14
1746548415016,BILD 1,A01,894154,Staff,2,0,19,17
1746548415016,BILD 1,A02,894155,Staff,14,0,19,5
1746548415016,BILD 1,A03,894160,Staff,13,0,19,6
1746548415016,BILD 1,A04,894161,Staff,15,0,18,3
1746548416045,BILD 2,A01,894168,Staff,0,0,50,50
1746548416045,BILD 2,A02,894169,Staff,0,0,50,50
1746548416045,BILD 2,A03,894179,Staff,4,0,50,46
1746548416045,BILD 2,A04,894203,Staff,27,0,50,23
1746548417073,BILD 3,A01,894213,Staff,22,0,31,9
1746548417073,BILD 3,A02,894214,Staff,26,0,31,5
1746548417073,BILD 3,A03,894235,Staff,28,0,31,3
1746548417073,BILD 3,A04,894236,Staff,28,0,32,4
1746548418102,BILD 4,A01,894253,Reuther; Keefe,5,0,24,19
1746548418102,BILD 4,A02,894258,Reuther; Keefe,16,0,24,8
1746548419132,BILD 5,A01,894276,Reuther; Keefe,35,0,50,15
1746548419132,BILD 5,A02,894277,Reuther; Keefe,45,0,50,5
1746548419132,BILD 5,A03,894290,Reuther; Keefe,44,0,50,6
1746548419132,BILD 5,A04,894291,Reuther; Keefe,48,0,50,2
1746548420155,BILD 24,A01,894297,Pirino; Giorgia,40,0,60,20
1746548421183,BIMM 100,B01,958915,Staff,72,0,100,28
1746548422210,BIMM 101,A01,895017,McDonnell; Lisa Marie,0,5,24,24
1746548422210,BIMM 101,A02,895018,McDonnell; Lisa Marie,0,5,24,24
1746548422210,BIMM 101,B01,895020,McDonnell; Lisa Marie,0,6,24,24
1746548422210,BIMM 101,B02,895021,McDonnell; Lisa Marie,0,4,24,24
1746548423235,BIMM 110,A01,895023,Staff,1,0,25,24
1746548423235,BIMM 110,A02,895024,Staff,9,0,25,16
1746548423235,BIMM 110,A03,895025,Staff,18,0,25,7
1746548423235,BIMM 110,A04,895031,Staff,20,0,25,5
1746548424265,BIMM 120,A01,895114,Gustafson-Brown; Cindy,13,0,28,15
1746548424265,BIMM 120,A02,895126,Gustafson-Brown; Cindy,21,0,27,6
1746548425290,BIPN 100,A01,895130,Yang; Mingyu,1,0,38,37
1746548425290,BIPN 100,A02,895131,Yang; Mingyu,32,0,38,6
1746548425290,BIPN 100,A03,895132,Yang; Mingyu,32,0,38,6
1746548425290,BIPN 100,A04,895133,Yang; Mingyu,27,0,36,9
1746548426316,BIPN 120,A01,895135,Cooke; James Edward,0,3,13,13
1746548426316,BIPN 120,A02,895136,Cooke; James Edward,0,1,13,13
1746548426316,BIPN 120,A03,895137,Cooke; James Edward,0,3,13,13
1746548426316,BIPN 120,A04,895156,Cooke; James Edward,0,2,11,11
1746548427346,BIPN 134,A01,895235,Cooke; James Edward,0,2,25,25
1746548427346,BIPN 134,A02,895237,Cooke; James Edward,0,0,25,25
1746548427346,BIPN 134,A03,895240,Cooke; James Edward,3,0,25,22
1746548427346,BIPN 134,A04,895270,Cooke; James Edward,20,0,25,5
1746548428370,BIPN 189,A00,892103,Staff,0,13,14,14
1746548430445,BISP 194,A00,958008,Staff,0,2,0,0
1746548431472,CAT 124,A01,922009,Staff,0,5,20,20
1746548432500,CAT 125R,A00,886390,Morales; Celeste Georgianna,0,2,20,20
1746548432500,CAT 125R,B00,886391,Irwin; Matthew Joseph,0,3,20,20
1746548432500,CAT 125R,C00,886392,Smith; Lauryn Alissa,0,2,20,20
1746548432500,CAT 125R,D00,886393,Vanderschuit; Maya Alysia,0,2,20,20
1746548432500,CAT 125R,E00,886394,Marchisotto; Jennifer Anne,0,4,20,20
1746548433525,CENG 15,A01,886218,Drews; Aaron,3,0,8,5
1746548434548,CENG 113,A00,886219,Opatkiewicz; Justin Paul,15,0,25,10
1746548435575,CGS 101,A00,887044,Staff,7,0,20,13
1746548436602,CGS 105,A01,887046,Staff,14,0,25,11
1746548437626,CGS 112,A00,887047,Cuong; Marisol,12,0,15,3
1746548438653,CGS 113,A00,887048,Staff,23,0,30,7
1746548439684,CGS 120,A00,887049,Staff,10,0,17,7
1746548440711,CHEM 6A,A01,886336,Lam; Tin Yiu,38,0,50,12
1746548440711,CHEM 6A,A02,886338,Lam; Tin Yiu,37,0,50,13
1746548441738,CHEM 6B,A01,886341,Hopkins; Patrycja Anna,16,0,50,34
1746548441738,CHEM 6B,A02,886343,Hopkins; Patrycja Anna,42,0,50,8
1746548442763,CHEM 6C,A01,886346,Albizati; Kim F.,0,2,50,50
1746548442763,CHEM 6C,A02,886348,Albizati; Kim F.,23,0,50,27
1746548443813,CHEM 40A,A01,886352,Klosterman; Jeremy K,65,0,100,35
1746548444848,CHEM 40B,A01,886356,Klosterman; Jeremy K,0,23,100,100
1746548445877,CHEM 41B,A01,886360,Theodorakis; Emmanuel,25,0,50,25
1746548445877,CHEM 41B,A02,886362,Theodorakis; Emmanuel,47,0,50,3
1746548446906,CHIN 165A,A00,886382,Xu; Li,18,0,20,2
1746548447933,CLAS 120,A00,886387,Myerston Santana; Jacobo,33,0,40,7
1746548448959,COGS 9,A01,886967,Shannon; Kyle Michael,42,0,60,18
1746548449985,COGS 11,A01,886969,Staff,11,0,30,19
1746548451011,COGS 14A,A01,886971,Staff,6,0,60,54
1746548452041,COGS 14B,A01,886973,Hoffman; Drew Ellen,4,0,60,56
1746548453068,COGS 18,A01,886975,Morgan; Eric,35,0,60,25
1746548454092,COGS 20,A01,886977,Staff,4,0,8,4
1746548454092,COGS 20,A02,886978,Staff,5,0,7,2
1746548455118,COGS 100,A01,907783,Staff,0,2,30,30
1746548456149,COGS 101B,A01,886980,Staff,0,3,48,48
1746548457178,COGS 101C,A01,886982,Delgado; Tania,0,5,44,44
1746548458206,COGS 102A,A01,886984,Johnson; Christine M.,4,0,30,26
1746548459232,COGS 118B,A01,886986,Staff,0,3,88,88
1746548460261,COGS 150,A01,886988,Bergen; Benjamin,23,0,50,27
1746548461287,COGS 153,A00,886989,Delgado; Tania,0,2,41,41
1746548462313,COGS 186,A01,886991,Staff,0,0,32,32
1746548463340,COGS 187A,A01,886993,Boyle; Mary E. T.,7,0,30,23
1746548464364,COGS 189,A00,886994,Staff,0,1,30,30
1746548465394,COMM 10,A01,886996,Staff,0,0,20,21
1746548465394,COMM 10,A02,886997,Staff,12,0,20,8
1746548465394,COMM 10,A03,959845,Staff,19,0,20,1
1746548466419,COMM 20,A01,886999,Leuning; Grant Maurstad,24,0,40,16
1746548468469,COMM 100A,A01,887002,Staff,0,0,20,25
1746548468469,COMM 100A,A02,887003,Staff,7,0,20,13
1746548469496,COMM 100B,A01,887005,Staff,0,8,20,24
1746548470521,COMM 106D,A00,887006,Staff,14,0,40,26
1746548471545,COMM 110G,A00,887007,Whitworth-Smith; Andrew C,12,0,40,28
1746548472572,COMM 111B,A00,887008,Staff,31,0,40,9
1746548473596,COMM 113T,A00,887009,Abuelhiga; Soraya Jill,28,0,40,12
1746548473596,COMM 113T,B00,906733,Staff,40,0,40,0
1746548474663,COMM 145,A00,887010,Staff,12,0,40,28
1746548475688,COMM 146,A00,887054,Staff,31,0,40,9
1746548476713,COMM 190,A00,887012,Staff,8,0,23,15
1746548477738,CSE 8A,A50,887015,Cao; Yingjun,57,0,85,28
1746548478764,CSE 11,A01,887017,Cao; Yingjun,12,0,70,58
1746548479792,CSE 20,A01,887019,Staff,30,0,50,20
1746548480819,CSE 21,A01,887021,Staff,78,0,100,22
1746548480819,CSE 21,B01,892583,Braun; Oliver,45,0,50,5
1746548481845,CSE 30,A01,887025,Eldon; John,143,0,200,57
1746548482874,CSE 100,A01,887027,Staff,26,0,50,24
1746548482874,CSE 100,A02,887028,Staff,40,0,50,10
1746548483904,CSE 101,A01,887030,Braun; Oliver,75,0,100,25
1746548483904,CSE 101,B01,887032,Jones; Miles E,0,3,50,50
1746548483904,CSE 101,B02,887033,Jones; Miles E,0,1,50,50
1746548484933,CSE 105,A01,908084,Jones; Miles E,32,0,50,18
1746548484933,CSE 105,A02,908087,Jones; Miles E,33,0,50,17
1746548485960,CSE 135,A01,887035,Powell; Thomas Allan,0,4,50,50
1746548486984,CSE 142,A01,887037,Staff,8,0,60,52
1746548488012,CSE 142L,A01,887039,Staff,34,0,60,26
1746548489037,CSE 151A,A01,887041,Solares; Edwin A,48,0,100,52
1746548490062,CSE 175,A01,887043,Kumar; Rakesh,30,0,30,0
1746548491087,CSS 1,A01,886389,Staff,0,1,40,40
1746548492115,DSC 30,A01,908097,Liao; Soohyun Nam,47,0,75,28
1746548493140,DSC 40A,A01,908099,Shannon; Kyle Michael,30,0,50,20
1746548494165,DSC 40B,A01,908112,Staff,16,0,50,34
1746548495192,DSC 80,A01,908116,Staff,19,0,60,41
1746548496220,DSC 197,001,956863,Eldridge; Justin Matthew,9999,0,9999,0
1746548497244,ECE 5,A01,886400,Morris; Karcher William,2,0,6,4
1746548497244,ECE 5,A02,886401,Morris; Karcher William,3,0,6,3
1746548498269,ECE 148,A01,886403,Silberman; Jack,0,14,14,14
1746548499298,ECON 1,A01,887265,Crane; Meredith Helen,12,0,70,58
1746548499298,ECON 1,B01,887268,Staff,43,0,50,7
1746548500324,ECON 2,A01,887273,Crane; Meredith Helen,56,0,70,14
1746548501354,ECON 3,A01,887279,Rondina; Giacomo,32,0,70,38
1746548502381,ECON 4,A01,887282,Anderson; John Charles,0,2,10,10
1746548503408,ECON 5,A01,887285,Staff,33,0,45,12
1746548503408,ECON 5,B01,887292,Staff,41,0,45,4
1746548504433,ECON 100A,A01,887337,Newhouse; Herbert S,54,0,70,16
1746548504433,ECON 100A,B01,887349,Staff,45,0,50,5
1746548505461,ECON 100B,A01,887361,Du; Songzi,29,0,70,41
1746548506485,ECON 100C,A01,887445,Newhouse; Herbert S,59,0,70,11
1746548507512,ECON 105,A00,887488,Vespa; Emanuel Ignacio,23,0,35,12
1746548508540,ECON 109,A01,887506,Shishkin; Denis,28,0,35,7
1746548509567,ECON 110A,A01,887568,Alon; Titan Michael,0,3,35,35
1746548509567,ECON 110A,B01,907601,Alon; Titan Michael,20,0,35,15
1746548510592,ECON 110B,A01,887598,Levkoff; Steven B.,0,23,70,70
1746548511617,ECON 112,A00,887599,Rondina; Giacomo,19,0,35,16
1746548512641,ECON 120A,A01,887603,Dai; Yinlin,36,0,70,34
1746548513667,ECON 120C,A01,887608,Sun; Yixiao,0,1,35,35
1746548513667,ECON 120C,B01,887614,Sun; Yixiao,0,0,35,35
1746548514695,ECON 138,A00,887621,Bharadwaj; Prashant,0,20,20,20
1746548515808,ECON 144,A00,958007,Squires; Dale E,13,0,35,22
1746548516836,ECON 171,A01,907666,Staff,18,0,35,17
1746548517861,ECON 175,A00,887626,Wu; Pak Yeung,23,0,35,12
1746548518888,ECON 190,A00,887640,Vespa; Emanuel Ignacio,23,0,35,12
1746548519913,EDS 25,A01,888197,Staff,0,0,0,0
1746548519913,EDS 25,A02,888209,Staff,0,0,0,0
1746548519913,EDS 25,A03,888210,Staff,0,0,0,0
1746548519913,EDS 25,A04,888212,Staff,0,0,0,0
1746548519913,EDS 25,A05,888213,Staff,0,0,0,0
1746548519913,EDS 25,A06,888214,Staff,0,0,0,0
1746548519913,EDS 25,A07,888235,Staff,0,2,0,0
1746548519913,EDS 25,A08,888236,Staff,0,0,0,0
1746548519913,EDS 25,A09,888240,Staff,0,0,0,0
1746548519913,EDS 25,A10,888244,Staff,0,0,0,0
1746548519913,EDS 25,B01,888273,Staff,0,0,0,0
1746548519913,EDS 25,B02,888285,Staff,0,0,0,0
1746548519913,EDS 25,B03,888423,Staff,0,0,0,1
1746548519913,EDS 25,B04,888432,Staff,0,0,0,0
1746548519913,EDS 25,B05,888433,Staff,0,0,0,0
1746548519913,EDS 25,B06,888467,Staff,0,0,0,0
1746548519913,EDS 25,B07,888468,Staff,0,0,0,0
1746548519913,EDS 25,B08,888479,Staff,0,0,0,0
1746548519913,EDS 25,B09,888484,Staff,0,0,0,0
1746548519913,EDS 25,B10,888487,Staff,0,0,0,0
1746548520940,EDS 38,A01,907700,Choi; Bailey Miyeon,30,0,30,0
1746548521968,EDS 112,A01,888601,Chapman; Thandeka K,14,0,40,26
1746548522996,EDS 115,A00,888697,Mendez; Kathrina Mendoza,10,0,30,20
1746548524019,EDS 116,A01,888893,Staff,35,0,40,5
1746548526073,EDS 124AR,A00,889133,Staff,29,0,50,21
1746548526073,EDS 124AR,B00,907471,Simon; Elizabeth A,37,0,50,13
1746548527099,EDS 124BR,A00,889134,Simon; Elizabeth A,45,0,100,55
1746548528124,EDS 125,A00,889135,Staff,25,0,30,5
1746548529150,EDS 126,A01,889138,Staff,36,0,40,4
1746548530175,EDS 164R,A01,889142,Wishard Guerra; Alison G.,33,0,50,17
1746548531203,ENG 30,A01,886396,Staff,0,0,0,0
1746548531203,ENG 30,B01,886398,Staff,0,0,0,0
1746548532227,ENVR 102,A00,906150,Montejo; Carolina,23,0,25,2
1746548533251,ETHN 103A,A00,887236,Man; Simeon S,0,3,0,0
1746548534276,ETHN 113,A00,887239,Staff,16,0,30,14
1746548535303,ETHN 116,A00,887240,Staff,16,0,25,9
1746548536327,ETHN 117,A00,887241,Choi; Esther Min,28,0,30,2
1746548537350,ETHN 118,A00,887243,Staff,24,0,30,6
1746548538376,ETHN 127,A00,887248,Cuong; Marisol,11,0,15,4
1746548539402,ETHN 139,A00,887250,Staff,7,0,10,3
1746548540429,ETHN 142,A00,887252,Staff,10,0,30,20
1746548541457,ETHN 161,A00,887253,Browne; Errol Tsekani,24,0,30,6
1746548542480,ETHN 163FR,A00,887255,Burelle; Julie Sara Veronique,0,0,5,5
1746548543559,GLBH 20,A00,889149,Elwardani; Nile Regina,8,0,42,34
1746548545613,GLBH 111,A01,889152,Burgos; Jose L.,17,0,17,0
1746548546637,GLBH 150,A00,889181,Sloane; Julia Kathryn,0,5,15,15
1746548548689,HDS 60,A01,886406,Warstadt; Melissa Fawn,73,0,80,7
1746548549716,HIAF 111,A00,889324,Gyamfi; Bright,25,0,32,7
1746548550743,HIEA 131,A00,889328,Staff,16,0,32,16
1746548551767,HIEA 144,A00,889333,Henry; Todd A.,26,0,32,6
1746548552796,HIEA 154,A00,889336,Henry; Todd A.,24,0,32,8
1746548553821,HIEU 106,A00,889339,Staff,22,0,32,10
1746548555874,HIEU 114,A00,889340,Staff,3,0,32,29
1746548556898,HIEU 135GS,A00,889342,Patterson; Patrick H.,0,0,1,24
1746548557922,HIEU 137,A00,889343,Edington; Claire Ellen,9,0,25,16
1746548558949,HIEU 148,A00,889345,Staff,14,0,32,18
1746548559975,HIEU 154,A00,889346,Biess; Frank Peter,21,0,32,11
1746548561001,HILA 102,A00,889351,Staff,12,0,32,20
1746548562025,HILD 2A,A01,889221,Lewandoski; Julia Mavis,1,10,32,31
1746548563050,HILD 7B,A01,889225,Man; Simeon S,0,13,32,32
1746548564078,HILD 7C,A01,889288,Alvarez; Luis A,0,14,32,32
1746548565105,HILD 30,A01,889323,Staff,0,5,32,32
1746548567158,HISC 119,A00,889383,Golan; Tal,21,0,32,11
1746548568183,HIUS 103,A00,889384,Man; Simeon S,0,0,32,32
1746548569211,HIUS 117,A00,919797,Kwak; Nancy,18,0,32,14
1746548570238,HIUS 142A,A00,919788,Staff,22,0,32,10
1746548572340,HIUS 149,A00,889386,Gyamfi; Bright,27,0,32,5
1746548573367,HIUS 155,A00,889387,Alvarez; Luis A,14,0,32,18
1746548574393,HUM 3,A01,886499,Caldwell; Michael Alan,19,0,50,31
1746548575417,HUM 3GS,A00,886500,Rodriguez; Bretton Sigfred,0,0,0,28
1746548576441,HUM 3R,A01,886502,Markman; Kristina,0,36,50,50
1746548577469,HUM 4,A01,886504,Crum; Matthew Stephen,24,0,50,26
1746548577469,HUM 4,B01,886506,West; Geoffrey Scott,17,0,50,33
1746548578497,HUM 4GS,A00,886507,Staff,0,0,0,19
1746548579525,HUM 5,A01,886509,Staff,32,0,50,18
1746548580552,HUM 5R,A01,886511,Zavodny; Tatiana Sophia,0,39,50,50
1746548581578,JAPN 180,A00,886407,Staff,18,0,40,22
1746548582602,LATI 50,A01,886409,Martin-Cabrera; Luis,4,0,22,18
1746548582602,LATI 50,A02,886410,Martin-Cabrera; Luis,19,0,22,3
1746548582602,LATI 50,A03,886411,Martin-Cabrera; Luis,21,0,22,1
1746548582602,LATI 50,A04,886412,Martin-Cabrera; Luis,9,0,22,13
1746548583630,LAWS 101,A00,907664,Staff,28,0,60,32
1746548584657,LIAB 1A,A00,889388,Saab; Dima,17,0,20,3
1746548585686,LIAB 1AX,A00,889389,El Cheddadi; Youniss,17,0,20,3
1746548586711,LIFR 1C,A00,889391,Van Moer; Vinciane G,8,0,20,12
1746548587738,LIFR 1CX,A00,889392,Van Moer; Vinciane G,7,0,20,13
1746548588765,LIFR 1D,A00,889393,Van Moer; Vinciane G,7,0,20,13
1746548589791,LIFR 1DX,A00,889394,Van Moer; Vinciane G,8,0,20,12
1746548590819,LIGN 7,A00,886923,Staff,24,0,50,26
1746548591843,LIGN 17,A00,886924,Kehler; Andrew Scott,125,0,150,25
1746548592873,LTAM 110,A00,889395,Staff,15,0,30,15
1746548593898,LTAM 110GS,A00,958010,Rodriguez; Bretton Sigfred,0,0,0,28
1746548594928,LTCH 101,A00,889397,Staff,23,0,25,2
1746548595952,LTCS 130,A00,889398,Staff,23,0,25,2
1746548596976,LTEA 138,A00,889399,Staff,24,0,40,16
1746548598004,LTEN 149,A00,889400,Wesling; Megan E.,0,3,25,25
1746548599030,LTEN 169,A00,889401,Staff,20,0,25,5
1746548600057,LTEN 180,A00,889402,Staff,10,0,15,5
1746548601081,LTEN 181,A00,889403,Staff,21,0,25,4
1746548602110,LTWL 100,A00,889404,Myerston Santana; Jacobo,3,0,25,22
1746548603137,LTWL 180GS,A00,889405,Staff,0,0,20,20
1746548604162,LTWL 181,A00,889406,Staff,17,0,25,8
1746548605187,LTWL 184,A00,889475,Mukherjee; Silpa,22,0,25,3
1746548606215,LTWR 102C,A00,889486,Staff,29,0,30,1
1746548607239,LTWR 115W,A00,889491,Staff,0,2,15,15
1746548608263,MAE 8,A01,886905,Staff,0,2,0,0
1746548609288,MAE 11,A00,886906,Bandaru; Prabhakar,0,7,50,50
1746548610316,MAE 20,A00,886907,Evdokimenko; Ekaterina,44,0,70,26
1746548611344,MAE 30B,A00,886909,Ghazinejad; Maziar,26,0,45,19
1746548612369,MAE 101B,A00,886910,Saintillan; David,29,0,45,16
1746548613393,MAE 105,A00,886911,Bandaru; Prabhakar,18,0,50,32
1746548614421,MAE 107,B00,958024,Staff,8,0,50,42
1746548615448,MAE 143B,A00,886913,Bewley; Thomas R,7,0,40,33
1746548616472,MAE 148,A01,886915,Silberman; Jack,0,3,14,14
1746548617553,MAE 160,A00,886916,Evdokimenko; Ekaterina,31,0,60,29
1746548618578,MATH 3C,A01,889681,Staff,0,3,30,30
1746548618578,MATH 3C,A02,960048,Staff,25,0,30,5
1746548619604,MATH 10A,A01,889760,Staff,26,0,30,4
1746548619604,MATH 10A,A02,889783,Staff,29,0,30,1
1746548620628,MATH 10B,A01,889785,Verstraete; Jacques Allan,2,0,35,33
1746548620628,MATH 10B,A02,889795,Verstraete; Jacques Allan,4,0,35,31
1746548620628,MATH 10B,B01,889797,Verstraete; Jacques Allan,3,0,35,32
1746548620628,MATH 10B,B02,889828,Verstraete; Jacques Allan,3,0,35,32
1746548621659,MATH 10C,A01,889849,Habib; Yousaf,9,0,30,21
1746548621659,MATH 10C,A02,889852,Habib; Yousaf,14,0,30,16
1746548621659,MATH 10C,A03,889853,Habib; Yousaf,22,0,30,8
1746548621659,MATH 10C,A04,889858,Habib; Yousaf,20,0,30,10
1746548621659,MATH 10C,B01,889861,Staff,1,0,30,29
1746548621659,MATH 10C,B02,889862,Staff,24,0,30,6
1746548621659,MATH 10C,B03,889863,Staff,27,0,30,3
1746548621659,MATH 10C,B04,889967,Staff,23,0,30,7
1746548622690,MATH 18,A01,889974,Staff,7,0,30,23
1746548622690,MATH 18,A02,889977,Staff,20,0,30,10
1746548622690,MATH 18,B01,889984,Hardiman; Liam,22,0,30,8
1746548622690,MATH 18,B02,889985,Hardiman; Liam,25,0,30,5
1746548623714,MATH 20A,A01,889990,Suk; Andrew Hoon,29,0,35,6
1746548624743,MATH 20B,A01,889993,Ohm; Ko Woon,22,0,30,8
1746548624743,MATH 20B,A02,889994,Ohm; Ko Woon,30,0,30,0
1746548624743,MATH 20B,B01,889996,Ohm; Ko Woon,21,0,30,9
1746548624743,MATH 20B,B02,889997,Ohm; Ko Woon,23,0,30,7
1746548625768,MATH 20C,A01,889999,Hammock; Frances H,17,0,30,13
1746548625768,MATH 20C,A02,890003,Hammock; Frances H,23,0,30,7
1746548625768,MATH 20C,B01,890006,Hammock; Frances H,3,0,30,27
1746548625768,MATH 20C,B02,890007,Hammock; Frances H,11,0,30,19
1746548626796,MATH 20D,A01,890011,Cheng; Hsiao-Bing,1,1,30,29
1746548626796,MATH 20D,A02,890012,Cheng; Hsiao-Bing,14,0,30,16
1746548626796,MATH 20D,B01,890016,Cheng; Hsiao-Bing,13,0,30,17
1746548626796,MATH 20D,B02,890017,Cheng; Hsiao-Bing,13,0,30,17
1746548627823,MATH 20E,A01,890026,Harel; Guershon,1,0,30,29
1746548627823,MATH 20E,A02,890029,Harel; Guershon,23,0,30,7
1746548627823,MATH 20E,B01,890033,Harel; Guershon,7,0,30,23
1746548627823,MATH 20E,B02,890101,Harel; Guershon,21,0,30,9
1746548628849,MATH 102,A01,890104,Staff,17,0,30,13
1746548628849,MATH 102,A02,890105,Staff,27,0,30,3
1746548629875,MATH 103B,A01,890116,Salehi Golsefidy; Alireza,3,0,30,27
1746548629875,MATH 103B,B01,890118,Staff,0,3,34,34
1746548630907,MATH 109,A01,890121,Aliabadi Sr.; Mohsen,1,0,30,29
1746548630907,MATH 109,B01,890124,Upadrashta; Pranav Kumar,18,0,30,12
1746548631933,MATH 120A,A01,890126,Eggers; John Dietrich,13,0,30,17
1746548632963,MATH 142B,A01,890128,Ioana; Adrian,19,0,30,11
1746548632963,MATH 142B,A02,890129,Ioana; Adrian,13,0,30,17
1746548633989,MATH 154,A01,890174,Staff,0,0,30,30
1746548633989,MATH 154,A02,890182,Staff,0,0,30,30
1746548635015,MATH 168A,A01,890197,Dumitriu; Ioana,21,0,35,14
1746548636041,MATH 170A,A01,890240,Nie; Jiawang,1,0,30,29
1746548636041,MATH 170A,A02,890241,Nie; Jiawang,11,0,30,19
1746548636041,MATH 170A,A03,890249,Nie; Jiawang,23,0,30,7
1746548637065,MATH 170B,A01,957891,Nag; Panchali,13,0,35,22
1746548639117,MATH 181A,A01,908025,Staff,0,4,35,35
1746548639117,MATH 181A,A02,960115,Staff,27,0,35,8
1746548640143,MATH 181B,A01,959874,Staff,26,0,30,4
1746548641170,MATH 193B,A01,890265,Staff,0,4,35,35
1746548642196,MGT 4,A01,890311,Anderson; John Charles,42,0,88,46
1746548643222,MGT 5,A00,907740,Staff,13,0,98,85
1746548644252,MGT 12,A00,890312,Lindenberger; Wade Douglas,67,0,98,31
1746548645280,MGT 16,A00,957883,Staff,78,0,98,20
1746548647399,MGT 45,A00,890314,Pecore; Joseph P.,47,0,98,51
1746548648423,MGT 71,A00,890315,Staff,0,11,98,98
1746548649450,MGT 100,A00,890316,Yavorsky; Daniel Ryan,44,0,98,54
1746548650473,MGT 103,A00,890317,Ehrich; Kristine R,73,0,98,25
1746548651501,MGT 105,A00,890356,Bates; Kenneth Walter,0,7,98,98
1746548652525,MGT 112,A00,890360,Ehrich; Kristine R,55,0,98,43
1746548653552,MGT 127R,A00,907732,Zhu; Kevin Xiaoguo,23,0,98,75
1746548654580,MGT 131B,A00,890361,Anderson; John Charles,61,0,98,37
1746548655605,MGT 137,A00,890362,Lindenberger; Wade Douglas,65,0,98,33
1746548656631,MGT 160,A00,890369,Johnson; Erik Barry,9,0,98,89
1746548658683,MGT 164,A00,890372,Zimmermann; Carsten,0,39,98,98
1746548659708,MGT 180,A00,890374,Bliss; Barbara Ann,12,0,98,86
1746548660735,MMW 15,A01,886414,Chang; Edmond Yi-Teh,0,12,28,28
1746548660735,MMW 15,A02,886415,Chang; Edmond Yi-Teh,0,8,28,28
1746548660735,MMW 15,A03,886416,Chang; Edmond Yi-Teh,0,8,28,28
1746548660735,MMW 15,A04,886417,Chang; Edmond Yi-Teh,0,8,28,28
1746548660735,MMW 15,B01,886419,Chang; Edmond Yi-Teh,0,7,28,28
1746548660735,MMW 15,B02,886420,Chang; Edmond Yi-Teh,0,8,28,28
1746548660735,MMW 15,B03,886421,Chang; Edmond Yi-Teh,0,7,28,28
1746548660735,MMW 15,B04,886422,Chang; Edmond Yi-Teh,0,8,28,28
1746548660735,MMW 15,C01,886424,Staff,0,9,28,28
1746548660735,MMW 15,C02,886425,Staff,0,8,28,28
1746548660735,MMW 15,C03,886426,Staff,0,8,28,28
1746548660735,MMW 15,C04,886427,Staff,0,7,28,28
1746548660735,MMW 15,C05,958038,Staff,0,7,28,28
1746548660735,MMW 15,C06,958039,Staff,0,8,28,28
1746548661762,MMW 15GS,A00,906910,Patterson; Patrick H.,4,0,28,24
1746548662791,MMW 122R,A01,886429,Rahimi; Babak,0,13,28,28
1746548662791,MMW 122R,A02,886430,Rahimi; Babak,0,12,28,28
1746548662791,MMW 122R,A03,958040,Rahimi; Babak,0,11,28,28
1746548663821,MUS 1A,A01,890937,Staff,3,0,25,22
1746548663821,MUS 1A,A02,891035,Staff,6,0,25,19
1746548663821,MUS 1A,C01,958912,Staff,24,0,25,1
1746548663821,MUS 1A,C02,958913,Staff,25,0,25,0
1746548665876,MUS 2AK,A00,957092,Ohnishi; Takae,15,0,15,0
1746548666902,MUS 4,A01,891044,Staff,2,0,25,23
1746548666902,MUS 4,A02,891045,Staff,23,0,25,2
1746548666902,MUS 4,B01,891048,Staff,17,0,25,8
1746548666902,MUS 4,B02,891050,Staff,25,0,25,0
1746548667931,MUS 5,A01,957506,Dubnov; Shlomo,0,0,25,25
1746548667931,MUS 5,A02,957622,Dubnov; Shlomo,14,0,25,11
1746548667931,MUS 5,A03,957623,Dubnov; Shlomo,20,0,25,5
1746548668958,MUS 6,A01,891053,Freitas Caetano; Marcelo,24,0,25,1
1746548668958,MUS 6,A02,891054,Freitas Caetano; Marcelo,23,0,25,2
1746548669990,MUS 7,A01,891081,Staff,0,0,25,25
1746548669990,MUS 7,A02,891082,Staff,4,0,25,21
1746548671015,MUS 8GS,A00,891118,Borgo; David Garcia,0,0,25,25
1746548672041,MUS 11,A01,891140,Staff,11,0,25,14
1746548672041,MUS 11,A02,891141,Staff,22,0,25,3
1746548673068,MUS 13,A01,891143,Staff,8,0,25,17
1746548673068,MUS 13,A02,891144,Staff,24,0,25,1
1746548674092,MUS 15,A01,891146,Staff,9,0,25,16
1746548674092,MUS 15,A02,891148,Staff,21,0,25,4
1746548674092,MUS 15,B01,891150,Staff,18,0,25,7
1746548674092,MUS 15,B02,891151,Staff,25,0,25,0
1746548675118,MUS 20,A01,891153,Staff,5,0,20,15
1746548675118,MUS 20,A02,891155,Staff,14,0,20,6
1746548676145,MUS 80,A00,891156,Staff,19,0,25,6
1746548676145,MUS 80,B00,891157,Staff,23,0,25,2
1746548677171,MUS 130,A00,891158,Ohnishi; Takae,35,0,35,0
1746548678197,MUS 150GS,A01,891160,Borgo; David Garcia,0,0,25,25
1746548679225,MUS 170,A01,891162,Freitas Caetano; Marcelo,20,0,25,5
1746548679225,MUS 170,A02,891164,Freitas Caetano; Marcelo,21,0,25,4
1746548680254,NANO 11,A00,886220,Vazquez Mena; Oscar,13,0,15,2
1746548681278,NANO 15,A01,886222,Drews; Aaron,4,0,7,3
1746548682304,NANO 104,A00,886224,Sirbuly; Donald,18,0,25,7
1746548683330,PH 40,A00,886528,Staff,23,0,40,17
1746548684355,PH 45,A01,886799,Staff,35,0,40,5
1746548685383,PH 110,A00,886802,Staff,0,7,40,40
1746548686409,PH 172,A00,906716,Staff,19,0,35,16
1746548687434,PH 191,A00,886803,Staff,6,0,40,34
1746548688460,PHIL 1,A00,889500,Staff,19,0,30,11
1746548689485,PHIL 10,A01,889549,Grush; Rick Scott,15,0,22,7
1746548689485,PHIL 10,A02,889551,Grush; Rick Scott,22,0,22,0
1746548690510,PHIL 28,A01,889559,Lamey; Andy M.,0,1,31,31
1746548690510,PHIL 28,A02,889561,Lamey; Andy M.,0,1,30,30
1746548690510,PHIL 28,A03,889572,Lamey; Andy M.,0,0,30,30
1746548691535,PHIL 35,A00,907839,Staff,13,0,15,2
1746548692563,PHIL 60,A00,889574,Staff,74,0,90,16
1746548693589,PHIL 101,A00,958004,Staff,13,0,15,2
1746548695642,PHIL 136,A00,889582,Fulkerson; Matthew Todd,26,0,45,19
1746548696667,PHIL 163,A01,889601,Staff,21,0,30,9
1746548696667,PHIL 163,B01,889606,Brandt; Reuven A,0,3,0,0
1746548697691,PHIL 164,A00,889610,Staff,16,0,30,14
1746548698717,PHIL 165,A00,889613,Staff,23,0,30,7
1746548699745,PHYS 1A,A00,886431,Staff,26,0,70,44
1746548700774,PHYS 1AL,001,886432,Tsai; Philbert S,0,2,30,30
1746548700774,PHYS 1AL,002,886436,Tsai; Philbert S,11,0,30,19
1746548701803,PHYS 1B,A00,886439,Staff,185,0,240,55
1746548702832,PHYS 1BL,001,886441,Tsai; Philbert S,0,4,30,30
1746548702832,PHYS 1BL,002,886444,Tsai; Philbert S,2,0,30,28
1746548703857,PHYS 1C,A00,896092,Arnold; Kam S,78,0,146,68
1746548704883,PHYS 1CL,001,886448,Tsai; Philbert S,0,0,30,30
1746548704883,PHYS 1CL,002,886449,Tsai; Philbert S,0,0,30,30
1746548704883,PHYS 1CL,003,886450,Tsai; Philbert S,16,0,30,14
1746548704883,PHYS 1CL,004,886451,Tsai; Philbert S,15,0,30,15
1746548705908,PHYS 2B,A01,886457,Staff,69,0,115,46
1746548706931,PHYS 2C,A01,886460,Shotwell; Brian,0,8,65,65
1746548707957,PHYS 2CL,A01,886467,Staff,0,4,28,28
1746548707957,PHYS 2CL,A02,886468,Staff,0,3,28,28
1746548708986,PHYS 2D,A01,886470,Staff,10,0,50,40
1746548710013,PHYS 4B,A01,886475,Grinstein; Benjamin,22,0,40,18
1746548711038,POLI 5,A00,891173,Desposato; Scott,7,0,25,18
1746548712063,POLI 5D,A01,891175,Staff,5,0,5,0
1746548712063,POLI 5D,B01,891178,Staff,5,0,5,0
1746548713088,POLI 11,A00,891179,Ferree; Karen E,2,0,35,33
1746548714114,POLI 12,A00,891180,Staff,16,0,30,14
1746548715145,POLI 27,A01,891182,Staff,12,0,75,63
1746548716170,POLI 30,A00,891183,Staff,8,0,50,42
1746548717195,POLI 100B,A00,891244,Staff,5,1,35,30
1746548718222,POLI 100I,A00,891247,Staff,7,0,30,23
1746548719246,POLI 104J,A00,891248,Nichter; Maysa,14,0,30,16
1746548720272,POLI 104U,A00,891250,Nichter; Maysa,2,0,30,28
1746548722323,POLI 110B,A00,891255,Wiens; David,20,0,25,5
1746548723354,POLI 112A,A00,891256,Wiens; David,6,0,25,19
1746548724383,POLI 114BR,A00,891261,Staff,19,0,30,11
1746548725409,POLI 117R,A00,891262,Forman; Fonna,0,6,50,50
1746548726433,POLI 118,A00,891264,Ingham; Sean,17,0,25,8
1746548727461,POLI 124A,A00,891265,Staff,18,0,20,2
1746548728488,POLI 125D,A00,891266,Nichter; Simeon C,2,0,25,23
1746548729515,POLI 126,A00,891268,Nichter; Simeon C,7,0,25,18
1746548730545,POLI 126AA,A00,891272,Staff,18,0,25,7
1746548731569,POLI 130AA,A00,891273,Staff,15,0,20,5
1746548732593,POLI 134AA,A00,891274,Staff,4,0,20,16
1746548734643,POLI 138,A00,891278,Staff,21,0,25,4
1746548735667,POLI 142K,A00,891280,Staff,11,0,25,14
1746548736692,POLI 142M,A00,891281,Gartzke; Erik,17,0,30,13
1746548737718,POLI 142P,A00,891284,Staff,20,0,30,10
1746548738745,POLI 143,A00,891285,Gartzke; Erik,12,0,30,18
1746548739770,POLI 153,A00,891286,Staff,19,0,20,1
1746548741820,POLI 175,A00,891290,Staff,15,0,20,5
1746548742844,PSYC 1,A00,890674,Steiner; Eric Tomas,0,11,45,45
1746548743871,PSYC 2,A00,890676,Albright; Thomas D,21,0,35,14
1746548744895,PSYC 3,A00,890679,Staff,17,0,20,3
1746548745919,PSYC 6,A00,959858,Staff,20,0,20,0
1746548746949,PSYC 60,A01,890684,Rickard; Timothy C.,0,5,45,45
1746548747975,PSYC 70,A01,890689,Geller; Emma Harlan,7,0,30,23
1746548748999,PSYC 71,A01,959860,Staff,21,0,25,4
1746548750028,PSYC 100,A00,890690,Lacefield; Katharine I,0,50,180,180
1746548751055,PSYC 102,A00,890695,Staff,18,0,40,22
1746548752083,PSYC 105,A00,890699,Geller; Emma Harlan,71,0,100,29
1746548753111,PSYC 106,A00,890701,Gorman; Michael R.,5,0,30,25
1746548754140,PSYC 108,A00,890704,Adrian; Julia Anna,0,28,50,50
1746548755164,PSYC 118,A01,890712,Staff,11,0,30,19
1746548756189,PSYC 124,A00,890716,Chapman; Eddie Nathaniel,25,0,60,35
1746548757216,PSYC 131,A00,890717,Anagnostaras; Stephan,0,7,80,80
1746548758243,PSYC 137,A00,890719,Winkielman; Piotr,0,11,30,30
1746548759268,PSYC 144,A00,890721,Adrian; Julia Anna,0,9,45,45
1746548760291,PSYC 162,A00,890805,Staff,2,0,75,73
1746548761314,PSYC 169,A00,890810,Staff,0,15,30,30
1746548762341,PSYC 172,A00,890814,Gorman; Michael R.,9,0,30,21
1746548763367,PSYC 181,A00,890818,Anagnostaras; Stephan,8,0,200,192
1746548764391,PSYC 184,A00,959861,Staff,170,0,175,5
1746548765415,PSYC 189,A00,890823,Staff,0,1,30,30
1746548766444,PSYC 191,A00,890884,Rickard; Timothy C.,0,11,35,35
1746548767469,PSYC 193,A00,890913,Staff,19,0,30,11
1746548767469,PSYC 193,B00,890914,Chapman; Eddie Nathaniel,24,0,30,6
1746548768494,PSYC 193L,A01,890918,Lowe; Angela Beth,20,0,30,10
1746548768494,PSYC 193L,B01,890921,Hurwitz; Ethan Scott,20,0,30,10
1746548768494,PSYC 193L,C01,890928,Staff,30,0,30,0
1746548769521,RELI 149,A00,886806,Rahimi; Babak,23,0,40,17
1746548770545,SE 9,A01,886814,Staff,7,0,20,13
1746548771570,SE 101B,A01,886816,Chadha; Mayank,4,0,35,31
1746548772596,SE 110B,A00,886818,Zhu; Qiang,4,0,75,71
1746548773620,SE 125,A01,886830,Staff,10,0,30,20
1746548774648,SE 130B,A01,886835,Staff,14,0,40,26
1746548775677,SE 131A,A01,886838,Krysl; Petr,34,0,55,21
1746548776704,SE 154,A00,886840,Staff,30,0,50,20
1746548777731,SE 164GS,A01,886849,Staff,6,0,20,14
1746548778756,SE 167GS,A01,886853,Staff,6,0,20,14
1746548779785,SIO 25,A01,890107,Staff,19,0,30,11
1746548780811,SIO 45,A00,890109,Cook; Geoffrey W,117,0,200,83
1746548781839,SIO 109R,A00,890110,Forman; Fonna,0,16,20,20
1746548782864,SIO 187,A01,890114,Kacev; David,15,0,40,25
1746548783891,SOCI 1,A01,890431,Thorpe; Charles Robert,15,0,30,15
1746548783891,SOCI 1,A02,890518,Thorpe; Charles Robert,30,0,30,0
1746548784916,SOCI 2,A01,957978,Staff,25,0,25,0
1746548784916,SOCI 2,A02,957979,Staff,23,0,25,2
1746548785941,SOCI 20,A01,890523,Calderon-Zaks; Michael Aar,23,0,30,7
1746548785941,SOCI 20,A02,890526,Calderon-Zaks; Michael Aar,29,0,30,1
1746548786966,SOCI 30,A01,890533,Pardo Guerra; Juan Pablo,37,0,40,3
1746548787994,SOCI 40,A01,890535,Staff,27,0,45,18
1746548789019,SOCI 104Q,A00,890559,Staff,18,0,30,12
1746548790044,SOCI 106,A00,890560,Arnal; Maud Marie Leonie,20,0,30,10
1746548791071,SOCI 110,A00,890567,Holkenbrink-Monk; Charlene,19,0,30,11
1746548792095,SOCI 112,A00,890568,Victoria Torres; Pablo,1,0,55,54
1746548793121,SOCI 115,A00,890597,Arnal; Maud Marie Leonie,28,0,45,17
1746548795178,SOCI 121,A00,890604,Pardo Guerra; Juan Pablo,38,0,45,7
1746548796206,SOCI 126,A01,890608,Staff,8,0,10,2
1746548797231,SOCI 127,A00,890609,Staff,18,0,30,12
1746548798257,SOCI 131,A00,890610,Thorpe; Charles Robert,37,0,45,8
1746548799282,SOCI 135,A00,890615,Payne; Christine Anna,14,0,45,31
1746548800310,SOCI 139,A00,890620,Staff,38,0,45,7
1746548801336,SOCI 148E,A00,890622,Calderon-Zaks; Michael Aar,36,0,45,9
1746548802362,SOCI 150,A00,890623,Kohler; Kristopher M.,31,0,45,14
1746548803389,SOCI 157,A00,890625,Jules-Rosette; Bennetta W.,18,0,20,2
1746548804417,SOCI 160,A00,890627,Payne; Christine Anna,21,0,45,24
1746548805445,SYN 1,A00,886855,Fish; Gwendolyn Anne,0,0,0,0
1746548805445,SYN 1,B00,906086,Fish; Gwendolyn Anne,0,1,0,2
1746548806468,SYN 2R,A00,886860,Staff,0,17,15,15
1746548806468,SYN 2R,B00,906106,Atkinson; Arthur Laird,0,16,15,15
1746548807497,SYN 100,A01,886866,Browne; Emily,0,28,20,20
1746548807497,SYN 100,B01,906128,Rock; Martin,0,5,20,20
1746548807497,SYN 100,C01,906140,Deavenport; James Cary,0,3,20,20
1746548807497,SYN 100,D01,907816,Deavenport; James Cary,0,5,20,20
1746548808521,TDAC 1,A00,890286,Walsh; Kim C.,9,0,20,11
1746548809546,TDAC 101,A00,890296,Basso; Beatrice,16,0,20,4
1746548810571,TDDE 131,A00,890297,Staff,47,0,50,3
1746548811596,TDDM 1,A00,890287,Weinberg; Sadie,25,0,30,5
1746548812626,TDGE 11,A00,890288,Fulton; Julia,137,0,200,63
1746548812626,TDGE 11,B00,890289,Castro; Robert Jess,184,0,200,16
1746548813654,TDGE 25,B00,957359,Walsh; Kim C.,3,0,20,17
1746548814678,TDGE 40,A01,890292,Power; Jade Yukana,27,0,30,3
1746548815704,TDGE 124,A00,890298,Havis; Allan,0,0,50,50
1746548816728,TDGE 131R,A00,890299,Burelle; Julie Sara Veronique,15,0,42,27
1746548817756,TDHT 101,A00,890300,Staff,10,0,20,10
1746548818782,TDHT 109,A01,890302,Anderson; Mysia Anyse,31,0,40,9
1746548819807,TDMV 1,A00,890293,Arcidiacono; Kristin,18,0,30,12
1746548820832,TDMV 2,A00,890294,Weinberg; Sadie,23,0,30,7
1746548821857,TDMV 3,A00,957878,Arcidiacono; Kristin,28,0,30,2
1746548823910,TDMV 138,A00,890304,Jun; Grace Shin Hae,25,0,40,15
1746548824938,TDMV 140,A00,890305,Corrales; Joseph Bernales,25,0,30,5
1746548825962,TDMV 142,A00,890307,Caligagan; Tony,32,0,40,8
1746548826990,TDMV 144,A00,890308,Camaya; Michelle Ann,25,0,30,5
1746548828016,TDPW 1,A00,890295,Stein; Deborah Isobel,3,0,20,17
1746548829042,USP 2,A01,890272,Lerner; Amy M,6,0,20,14
1746548830069,USP 3,A01,890274,Staff,12,0,30,18
1746548831093,USP 15,A01,890276,Sun; Feiyang,17,0,30,13
1746548832120,USP 25,A00,890277,Shenkman; Michael Thomas,19,0,25,6
1746548833149,USP 138,A00,890278,Staff,13,0,25,12
1746548834176,USP 143,A00,890279,Staff,21,0,70,49
1746548835203,USP 144,A00,890280,Chowdhury; Muhammed Zohir,16,0,30,14
1746548836231,USP 150,A00,890281,Boomhower; Matthew Charles,4,0,30,26
1746548837259,USP 151,A00,890282,Staff,16,0,20,4
1746548838287,USP 162,A00,890283,Andrews; Abigail Leslie,16,0,20,4
1746548839310,USP 168,A00,920477,Kwak; Nancy,1,0,5,4
1746548840337,USP 181,A00,890284,Staff,3,0,20,17
1746548841364,USP 191A,A00,890285,Staff,13,0,20,7
1746548842391,VIS 101,A00,886512,Staff,25,0,75,50
1746548843415,VIS 103,A00,886513,Cruz; Edwin Teddy,61,0,75,14
1746548844444,VIS 108,A00,886514,Staff,3,0,15,12
1746548845471,VIS 127P,A00,886515,Shen; Kuiyi,80,0,146,66
1746548846498,VIS 149,A00,886516,Yoldas; Pinar,0,0,15,15
1746548847523,VIS 164,A00,886526,Erdmann; Dean,19,0,22,3
1746548848549,VIS 194S,A00,886527,Staff,61,0,75,14
1746548849578,WCWP 10A,C00,886484,Martiniuk; Jill,12,0,15,3
1746548850606,WCWP 10B,A00,886490,Uriarte; Emma,0,0,15,15
1746548850606,WCWP 10B,B00,886491,Dhir; Simrita,10,0,15,5
1746548850606,WCWP 10B,C00,886492,Ornelas; Tricia,0,0,15,15
1746548851631,WCWP 100,A00,886494,Young; Mark T,0,6,15,15
1746548853728,AAS 10,A01,886199,Childs; Dennis R.,0,3,0,0
1746548854752,ANAR 104,A01,886940,Shtienberg; Gilad,27,0,30,3
1746548855777,ANAR 120,A00,886953,Staff,12,0,20,8
1746548856801,ANBI 148,A01,886955,Wilder; Linnea Lorene,30,0,40,10
1746548858864,ANSC 122,A00,886957,Staff,25,0,30,5
1746548859888,ANSC 150,A00,886958,Sloane; Julia Kathryn,3,0,15,12
1746548860918,ANSC 156,A00,886959,Jenkins; Janis A.,0,1,15,15
1746548861945,ANSC 180,A00,886960,Staff,11,0,17,6
1746548862970,ANSC 188,A00,886961,Jassal; Aftab,9,0,25,16
1746548863996,ANSC 190,A00,886962,Jassal; Aftab,14,0,25,11
1746548865023,ANSC 191,A00,886963,Staff,18,0,20,2
1746548866049,ANTH 3,A01,891689,Staff,17,0,20,3
1746548867073,ANTH 5,A00,886933,Semendeferi; Ekaterini,16,0,20,4
1746548868099,ANTH 10,A00,886934,Staff,0,12,30,30
1746548869125,ANTH 21,A01,886936,Staff,40,0,60,20
1746548870157,ANTH 23,A01,886938,Staff,92,0,100,8
1746548871182,ANTH 105,A00,886964,Stewart; Alexander B,84,0,100,16
1746548872207,ANTH 108,A00,886965,Pedersen; David,9,0,20,11
1746548873240,AWP 10,001,886147,Staff,0,0,0,0
1746548873240,AWP 10,002,886148,Staff,0,0,0,0
1746548873240,AWP 10,003,886149,Staff,0,0,0,0
1746548873240,AWP 10,004,886150,Staff,0,0,0,0
1746548873240,AWP 10,005,886151,Staff,0,0,0,0
1746548873240,AWP 10,006,886152,Staff,0,0,0,0
1746548873240,AWP 10,007,886153,Staff,0,0,0,0
1746548873240,AWP 10,008,886154,Staff,0,0,0,0
1746548873240,AWP 10,009,886155,Staff,0,0,0,0
1746548873240,AWP 10,010,886156,Staff,0,0,0,0
1746548873240,AWP 10,011,886158,Staff,0,0,0,0
1746548873240,AWP 10,012,886160,Staff,0,0,0,0
1746548873240,AWP 10,013,886161,Staff,0,0,0,0
1746548873240,AWP 10,014,886162,Staff,0,0,0,0
1746548873240,AWP 10,015,886163,Staff,0,0,0,0
1746548873240,AWP 10,016,886164,Staff,0,0,0,0
1746548873240,AWP 10,017,886165,Staff,0,0,0,0
1746548873240,AWP 10,018,886166,Staff,0,0,0,0
1746548873240,AWP 10,019,886168,Staff,0,0,0,0
1746548873240,AWP 10,020,886170,Staff,0,0,0,0
1746548873240,AWP 10,021,886172,Staff,0,0,0,0
1746548874266,AWP 10R,001,886173,Staff,0,1,0,0
1746548874266,AWP 10R,002,886174,Staff,0,1,0,0
1746548874266,AWP 10R,003,886175,Staff,0,0,0,0
1746548874266,AWP 10R,004,886176,Staff,0,0,0,0
1746548874266,AWP 10R,005,886177,Staff,0,0,0,0
1746548874266,AWP 10R,006,886178,Staff,0,0,0,0
1746548874266,AWP 10R,007,886179,Staff,0,0,0,0
1746548874266,AWP 10R,008,886181,Staff,0,0,0,0
1746548874266,AWP 10R,009,886182,Staff,0,0,0,0
1746548874266,AWP 10R,010,886183,Staff,0,0,0,0
1746548874266,AWP 10R,011,886184,Staff,0,0,0,0
1746548874266,AWP 10R,012,886185,Staff,0,0,0,0
1746548874266,AWP 10R,013,886186,Staff,0,0,0,0
1746548874266,AWP 10R,014,886187,Staff,0,0,0,0
1746548874266,AWP 10R,015,886188,Staff,0,0,0,0
1746548874266,AWP 10R,016,886189,Staff,0,0,0,0
1746548875294,AWP 102R,A00,886190,Staff,0,0,0,0
1746548875294,AWP 102R,B00,886191,Staff,0,0,0,0
1746548876321,BENG 100,A01,886193,Staff,17,0,30,13
1746548877348,BENG 122A,A01,886195,Hasty; Jeff M,13,0,30,17
1746548878371,BENG 166A,A00,886196,Sah; Robert Lie-Yuan,0,1,30,30
1746548879394,BENG 190,A00,958050,Khojah; Reem I,24,0,25,1
1746548880420,BIBC 102,A01,894320,Staff,0,0,46,46
1746548880420,BIBC 102,A02,894321,Staff,0,0,46,46
1746548880420,BIBC 102,A03,894344,Staff,7,0,46,39
1746548880420,BIBC 102,A04,894345,Staff,26,0,47,21
1746548881447,BICD 100R,A01,894365,Smith; Laurie,0,3,58,58
1746548881447,BICD 100R,A02,894366,Smith; Laurie,0,5,58,58
1746548881447,BICD 100R,A03,894367,Smith; Laurie,2,0,59,57
1746548881447,BICD 100R,A04,959869,Smith; Laurie,41,0,59,18
1746548882473,BICD 136,A01,894383,Gustafson-Brown; Cindy,14,0,50,36
1746548883501,BIEB 102,A01,894494,Butler; Shannon Rhey,51,0,130,79
1746548885556,BIEB 150,A01,894617,Wills; Christopher,3,0,20,17
1746548885556,BIEB 150,A02,894631,Wills; Christopher,3,0,20,17
1746548885556,BIEB 150,A03,894937,Wills; Christopher,3,0,20,17
1746548885556,BIEB 150,A04,894946,Wills; Christopher,5,0,20,15
1746548886583,BIEB 194,A00,906141,Kurle; Carolyn M.,6,0,20,14
1746548887611,BILD 1,A01,894154,Staff,2,0,19,17
1746548887611,BILD 1,A02,894155,Staff,14,0,19,5
1746548887611,BILD 1,A03,894160,Staff,13,0,19,6
1746548887611,BILD 1,A04,894161,Staff,15,0,18,3
1746548888637,BILD 2,A01,894168,Staff,0,0,50,50
1746548888637,BILD 2,A02,894169,Staff,0,0,50,50
1746548888637,BILD 2,A03,894179,Staff,4,0,50,46
1746548888637,BILD 2,A04,894203,Staff,27,0,50,23
1746548889662,BILD 3,A01,894213,Staff,22,0,31,9
1746548889662,BILD 3,A02,894214,Staff,26,0,31,5
1746548889662,BILD 3,A03,894235,Staff,28,0,31,3
1746548889662,BILD 3,A04,894236,Staff,28,0,32,4
1746548890691,BILD 4,A01,894253,Reuther; Keefe,5,0,24,19
1746548890691,BILD 4,A02,894258,Reuther; Keefe,16,0,24,8
1746548891720,BILD 5,A01,894276,Reuther; Keefe,35,0,50,15
1746548891720,BILD 5,A02,894277,Reuther; Keefe,45,0,50,5
1746548891720,BILD 5,A03,894290,Reuther; Keefe,44,0,50,6
1746548891720,BILD 5,A04,894291,Reuther; Keefe,48,0,50,2
1746548892746,BILD 24,A01,894297,Pirino; Giorgia,40,0,60,20
1746548893774,BIMM 100,B01,958915,Staff,72,0,100,28
1746548894800,BIMM 101,A01,895017,McDonnell; Lisa Marie,0,5,24,24
1746548894800,BIMM 101,A02,895018,McDonnell; Lisa Marie,0,5,24,24
1746548894800,BIMM 101,B01,895020,McDonnell; Lisa Marie,0,6,24,24
1746548894800,BIMM 101,B02,895021,McDonnell; Lisa Marie,0,4,24,24
1746548895825,BIMM 110,A01,895023,Staff,1,0,25,24
1746548895825,BIMM 110,A02,895024,Staff,9,0,25,16
1746548895825,BIMM 110,A03,895025,Staff,18,0,25,7
1746548895825,BIMM 110,A04,895031,Staff,20,0,25,5
1746548896853,BIMM 120,A01,895114,Gustafson-Brown; Cindy,13,0,28,15
1746548896853,BIMM 120,A02,895126,Gustafson-Brown; Cindy,21,0,27,6
1746548897881,BIPN 100,A01,895130,Yang; Mingyu,1,0,38,37
1746548897881,BIPN 100,A02,895131,Yang; Mingyu,32,0,38,6
1746548897881,BIPN 100,A03,895132,Yang; Mingyu,32,0,38,6
1746548897881,BIPN 100,A04,895133,Yang; Mingyu,27,0,36,9
1746548898907,BIPN 120,A01,895135,Cooke; James Edward,0,3,13,13
1746548898907,BIPN 120,A02,895136,Cooke; James Edward,0,1,13,13
1746548898907,BIPN 120,A03,895137,Cooke; James Edward,0,3,13,13
1746548898907,BIPN 120,A04,895156,Cooke; James Edward,0,2,11,11
1746548899937,BIPN 134,A01,895235,Cooke; James Edward,0,2,25,25
1746548899937,BIPN 134,A02,895237,Cooke; James Edward,0,0,25,25
1746548899937,BIPN 134,A03,895240,Cooke; James Edward,3,0,25,22
1746548899937,BIPN 134,A04,895270,Cooke; James Edward,20,0,25,5
1746548900961,BIPN 189,A00,892103,Staff,0,13,14,14
1746548903011,BISP 194,A00,958008,Staff,0,2,0,0
1746548904038,CAT 124,A01,922009,Staff,0,5,20,20
1746548905066,CAT 125R,A00,886390,Morales; Celeste Georgianna,0,2,20,20
1746548905066,CAT 125R,B00,886391,Irwin; Matthew Joseph,0,3,20,20
1746548905066,CAT 125R,C00,886392,Smith; Lauryn Alissa,0,2,20,20
1746548905066,CAT 125R,D00,886393,Vanderschuit; Maya Alysia,0,2,20,20
1746548905066,CAT 125R,E00,886394,Marchisotto; Jennifer Anne,0,4,20,20
1746548906093,CENG 15,A01,886218,Drews; Aaron,3,0,8,5
1746548907120,CENG 113,A00,886219,Opatkiewicz; Justin Paul,15,0,25,10
1746548908148,CGS 101,A00,887044,Staff,7,0,20,13
1746548909175,CGS 105,A01,887046,Staff,14,0,25,11
1746548910199,CGS 112,A00,887047,Cuong; Marisol,12,0,15,3
1746548911226,CGS 113,A00,887048,Staff,23,0,30,7
1746548912251,CGS 120,A00,887049,Staff,10,0,17,7
1746548913280,CHEM 6A,A01,886336,Lam; Tin Yiu,38,0,50,12
1746548913280,CHEM 6A,A02,886338,Lam; Tin Yiu,37,0,50,13
1746548914303,CHEM 6B,A01,886341,Hopkins; Patrycja Anna,16,0,50,34
1746548914303,CHEM 6B,A02,886343,Hopkins; Patrycja Anna,42,0,50,8
1746548915329,CHEM 6C,A01,886346,Albizati; Kim F.,0,2,50,50
1746548915329,CHEM 6C,A02,886348,Albizati; Kim F.,23,0,50,27
1746548916354,CHEM 40A,A01,886352,Klosterman; Jeremy K,65,0,100,35
1746548917382,CHEM 40B,A01,886356,Klosterman; Jeremy K,0,23,100,100
1746548918409,CHEM 41B,A01,886360,Theodorakis; Emmanuel,25,0,50,25
1746548918409,CHEM 41B,A02,886362,Theodorakis; Emmanuel,47,0,50,3
1746548919434,CHIN 165A,A00,886382,Xu; Li,18,0,20,2
1746548920459,CLAS 120,A00,886387,Myerston Santana; Jacobo,33,0,40,7
1746548921483,COGS 9,A01,886967,Shannon; Kyle Michael,42,0,60,18
1746548922508,COGS 11,A01,886969,Staff,11,0,30,19
1746548923532,COGS 14A,A01,886971,Staff,6,0,60,54
1746548924559,COGS 14B,A01,886973,Hoffman; Drew Ellen,4,0,60,56
1746548925584,COGS 18,A01,886975,Morgan; Eric,35,0,60,25
1746548926613,COGS 20,A01,886977,Staff,4,0,8,4
1746548926613,COGS 20,A02,886978,Staff,5,0,7,2
1746548927640,COGS 100,A01,907783,Staff,0,2,30,30
1746548928674,COGS 101B,A01,886980,Staff,0,3,48,48
1746548929702,COGS 101C,A01,886982,Delgado; Tania,0,5,44,44
1746548930726,COGS 102A,A01,886984,Johnson; Christine M.,4,0,30,26
1746548931750,COGS 118B,A01,886986,Staff,0,3,88,88
1746548932774,COGS 150,A01,886988,Bergen; Benjamin,23,0,50,27
1746548933802,COGS 153,A00,886989,Delgado; Tania,0,2,41,41
1746548934827,COGS 186,A01,886991,Staff,0,0,32,32
1746548935851,COGS 187A,A01,886993,Boyle; Mary E. T.,7,0,30,23
1746548936903,COGS 189,A00,886994,Staff,0,1,30,30
1746548937927,COMM 10,A01,886996,Staff,0,0,20,21
1746548937927,COMM 10,A02,886997,Staff,12,0,20,8
1746548937927,COMM 10,A03,959845,Staff,19,0,20,1
1746548938952,COMM 20,A01,886999,Leuning; Grant Maurstad,24,0,40,16
1746548941002,COMM 100A,A01,887002,Staff,0,0,20,25
1746548941002,COMM 100A,A02,887003,Staff,7,0,20,13
1746548942029,COMM 100B,A01,887005,Staff,0,8,20,24
1746548943053,COMM 106D,A00,887006,Staff,14,0,40,26
1746548944078,COMM 110G,A00,887007,Whitworth-Smith; Andrew C,12,0,40,28
1746548945103,COMM 111B,A00,887008,Staff,31,0,40,9
1746548946129,COMM 113T,A00,887009,Abuelhiga; Soraya Jill,28,0,40,12
1746548946129,COMM 113T,B00,906733,Staff,40,0,40,0
1746548947156,COMM 145,A00,887010,Staff,12,0,40,28
1746548948182,COMM 146,A00,887054,Staff,31,0,40,9
1746548949207,COMM 190,A00,887012,Staff,8,0,23,15
1746548950234,CSE 8A,A50,887015,Cao; Yingjun,57,0,85,28
1746548951261,CSE 11,A01,887017,Cao; Yingjun,12,0,70,58
1746548952287,CSE 20,A01,887019,Staff,30,0,50,20
1746548953316,CSE 21,A01,887021,Staff,78,0,100,22
1746548953316,CSE 21,B01,892583,Braun; Oliver,45,0,50,5
1746548954343,CSE 30,A01,887025,Eldon; John,143,0,200,57
1746548955368,CSE 100,A01,887027,Staff,26,0,50,24
1746548955368,CSE 100,A02,887028,Staff,40,0,50,10
1746548956391,CSE 101,A01,887030,Braun; Oliver,75,0,100,25
1746548956391,CSE 101,B01,887032,Jones; Miles E,0,3,50,50
1746548956391,CSE 101,B02,887033,Jones; Miles E,0,1,50,50
1746548957419,CSE 105,A01,908084,Jones; Miles E,32,0,50,18
1746548957419,CSE 105,A02,908087,Jones; Miles E,33,0,50,17
1746548958444,CSE 135,A01,887035,Powell; Thomas Allan,0,4,50,50
1746548959471,CSE 142,A01,887037,Staff,8,0,60,52
1746548960496,CSE 142L,A01,887039,Staff,34,0,60,26
1746548961522,CSE 151A,A01,887041,Solares; Edwin A,48,0,100,52
1746548962551,CSE 175,A01,887043,Kumar; Rakesh,30,0,30,0
1746548963579,CSS 1,A01,886389,Staff,0,1,40,40
1746548964604,DSC 30,A01,908097,Liao; Soohyun Nam,47,0,75,28
1746548965631,DSC 40A,A01,908099,Shannon; Kyle Michael,30,0,50,20
1746548966657,DSC 40B,A01,908112,Staff,16,0,50,34
1746548967682,DSC 80,A01,908116,Staff,19,0,60,41
1746548968707,DSC 197,001,956863,Eldridge; Justin Matthew,9999,0,9999,0
1746548969732,ECE 5,A01,886400,Morris; Karcher William,2,0,6,4
1746548969732,ECE 5,A02,886401,Morris; Karcher William,3,0,6,3
1746548970757,ECE 148,A01,886403,Silberman; Jack,0,14,14,14
1746548971784,ECON 1,A01,887265,Crane; Meredith Helen,12,0,70,58
1746548971784,ECON 1,B01,887268,Staff,43,0,50,7
1746548972813,ECON 2,A01,887273,Crane; Meredith Helen,56,0,70,14
1746548973840,ECON 3,A01,887279,Rondina; Giacomo,32,0,70,38
1746548974865,ECON 4,A01,887282,Anderson; John Charles,0,2,10,10
1746548975891,ECON 5,A01,887285,Staff,33,0,45,12
1746548975891,ECON 5,B01,887292,Staff,41,0,45,4
1746548976915,ECON 100A,A01,887337,Newhouse; Herbert S,54,0,70,16
1746548976915,ECON 100A,B01,887349,Staff,45,0,50,5
1746548977939,ECON 100B,A01,887361,Du; Songzi,29,0,70,41
1746548978964,ECON 100C,A01,887445,Newhouse; Herbert S,59,0,70,11
1746548979992,ECON 105,A00,887488,Vespa; Emanuel Ignacio,23,0,35,12
1746548981015,ECON 109,A01,887506,Shishkin; Denis,28,0,35,7
1746548982039,ECON 110A,A01,887568,Alon; Titan Michael,0,3,35,35
1746548982039,ECON 110A,B01,907601,Alon; Titan Michael,20,0,35,15
1746548983062,ECON 110B,A01,887598,Levkoff; Steven B.,0,23,70,70
1746548984089,ECON 112,A00,887599,Rondina; Giacomo,19,0,35,16
1746548985117,ECON 120A,A01,887603,Dai; Yinlin,36,0,70,34
1746548986142,ECON 120C,A01,887608,Sun; Yixiao,0,1,35,35
1746548986142,ECON 120C,B01,887614,Sun; Yixiao,0,0,35,35
1746548987170,ECON 138,A00,887621,Bharadwaj; Prashant,0,20,20,20
1746548988197,ECON 144,A00,958007,Squires; Dale E,13,0,35,22
1746548989220,ECON 171,A01,907666,Staff,18,0,35,17
1746548990244,ECON 175,A00,887626,Wu; Pak Yeung,23,0,35,12
1746548991273,ECON 190,A00,887640,Vespa; Emanuel Ignacio,23,0,35,12
1746548992309,EDS 25,A01,888197,Staff,0,0,0,0
1746548992309,EDS 25,A02,888209,Staff,0,0,0,0
1746548992309,EDS 25,A03,888210,Staff,0,0,0,0
1746548992309,EDS 25,A04,888212,Staff,0,0,0,0
1746548992309,EDS 25,A05,888213,Staff,0,0,0,0
1746548992309,EDS 25,A06,888214,Staff,0,0,0,0
1746548992309,EDS 25,A07,888235,Staff,0,2,0,0
1746548992309,EDS 25,A08,888236,Staff,0,0,0,0
1746548992309,EDS 25,A09,888240,Staff,0,0,0,0
1746548992309,EDS 25,A10,888244,Staff,0,0,0,0
1746548992309,EDS 25,B01,888273,Staff,0,0,0,0
1746548992309,EDS 25,B02,888285,Staff,0,0,0,0
1746548992309,EDS 25,B03,888423,Staff,0,0,0,1
1746548992309,EDS 25,B04,888432,Staff,0,0,0,0
1746548992309,EDS 25,B05,888433,Staff,0,0,0,0
1746548992309,EDS 25,B06,888467,Staff,0,0,0,0
1746548992309,EDS 25,B07,888468,Staff,0,0,0,0
1746548992309,EDS 25,B08,888479,Staff,0,0,0,0
1746548992309,EDS 25,B09,888484,Staff,0,0,0,0
1746548992309,EDS 25,B10,888487,Staff,0,0,0,0
1746548993331,EDS 38,A01,907700,Choi; Bailey Miyeon,30,0,30,0
1746548994354,EDS 112,A01,888601,Chapman; Thandeka K,14,0,40,26
1746548995379,EDS 115,A00,888697,Mendez; Kathrina Mendoza,10,0,30,20
1746548996468,EDS 116,A01,888893,Staff,35,0,40,5
1746548998518,EDS 124AR,A00,889133,Staff,29,0,50,21
1746548998518,EDS 124AR,B00,907471,Simon; Elizabeth A,37,0,50,13
1746548999542,EDS 124BR,A00,889134,Simon; Elizabeth A,45,0,100,55
1746549000568,EDS 125,A00,889135,Staff,25,0,30,5
1746549001592,EDS 126,A01,889138,Staff,36,0,40,4
1746549002621,EDS 164R,A01,889142,Wishard Guerra; Alison G.,33,0,50,17
1746549003650,ENG 30,A01,886396,Staff,0,0,0,0
1746549003650,ENG 30,B01,886398,Staff,0,0,0,0
1746549004676,ENVR 102,A00,906150,Montejo; Carolina,23,0,25,2
1746549005702,ETHN 103A,A00,887236,Man; Simeon S,0,3,0,0
1746549006727,ETHN 113,A00,887239,Staff,16,0,30,14
1746549007752,ETHN 116,A00,887240,Staff,16,0,25,9
1746549008778,ETHN 117,A00,887241,Choi; Esther Min,28,0,30,2
1746549009806,ETHN 118,A00,887243,Staff,24,0,30,6
1746549010832,ETHN 127,A00,887248,Cuong; Marisol,11,0,15,4
1746549011872,ETHN 139,A00,887250,Staff,7,0,10,3
1746549012898,ETHN 142,A00,887252,Staff,10,0,30,20
1746549013932,ETHN 161,A00,887253,Browne; Errol Tsekani,24,0,30,6
1746549014959,ETHN 163FR,A00,887255,Burelle; Julie Sara Veronique,0,0,5,5
1746549015983,GLBH 20,A00,889149,Elwardani; Nile Regina,8,0,42,34
1746549018037,GLBH 111,A01,889152,Burgos; Jose L.,17,0,17,0
1746549019063,GLBH 150,A00,889181,Sloane; Julia Kathryn,0,5,15,15
1746549021116,HDS 60,A01,886406,Warstadt; Melissa Fawn,73,0,80,7
1746549022142,HIAF 111,A00,889324,Gyamfi; Bright,25,0,32,7
1746549023169,HIEA 131,A00,889328,Staff,16,0,32,16
1746549024196,HIEA 144,A00,889333,Henry; Todd A.,26,0,32,6
1746549025223,HIEA 154,A00,889336,Henry; Todd A.,24,0,32,8
1746549026247,HIEU 106,A00,889339,Staff,22,0,32,10
1746549028299,HIEU 114,A00,889340,Staff,3,0,32,29
1746549029324,HIEU 135GS,A00,889342,Patterson; Patrick H.,0,0,1,24
1746549030351,HIEU 137,A00,889343,Edington; Claire Ellen,9,0,25,16
1746549031375,HIEU 148,A00,889345,Staff,14,0,32,18
1746549032402,HIEU 154,A00,889346,Biess; Frank Peter,21,0,32,11
1746549033428,HILA 102,A00,889351,Staff,12,0,32,20
1746549034453,HILD 2A,A01,889221,Lewandoski; Julia Mavis,1,10,32,31
1746549035478,HILD 7B,A01,889225,Man; Simeon S,0,13,32,32
1746549036505,HILD 7C,A01,889288,Alvarez; Luis A,0,14,32,32
1746549037528,HILD 30,A01,889323,Staff,0,5,32,32
1746549039577,HISC 119,A00,889383,Golan; Tal,21,0,32,11
1746549040602,HIUS 103,A00,889384,Man; Simeon S,0,0,32,32
1746549041628,HIUS 117,A00,919797,Kwak; Nancy,18,0,32,14
1746549042652,HIUS 142A,A00,919788,Staff,22,0,32,10
1746549044701,HIUS 149,A00,889386,Gyamfi; Bright,27,0,32,5
1746549045734,HIUS 155,A00,889387,Alvarez; Luis A,14,0,32,18
1746549046760,HUM 3,A01,886499,Caldwell; Michael Alan,19,0,50,31
1746549047788,HUM 3GS,A00,886500,Rodriguez; Bretton Sigfred,0,0,0,28
1746549048870,HUM 3R,A01,886502,Markman; Kristina,0,36,50,50
1746549049896,HUM 4,A01,886504,Crum; Matthew Stephen,24,0,50,26
1746549049896,HUM 4,B01,886506,West; Geoffrey Scott,17,0,50,33
1746549050921,HUM 4GS,A00,886507,Staff,0,0,0,19
1746549051948,HUM 5,A01,886509,Staff,32,0,50,18
1746549052976,HUM 5R,A01,886511,Zavodny; Tatiana Sophia,0,39,50,50
1746549054002,JAPN 180,A00,886407,Staff,18,0,40,22
1746549055031,LATI 50,A01,886409,Martin-Cabrera; Luis,4,0,22,18
1746549055031,LATI 50,A02,886410,Martin-Cabrera; Luis,19,0,22,3
1746549055031,LATI 50,A03,886411,Martin-Cabrera; Luis,21,0,22,1
1746549055031,LATI 50,A04,886412,Martin-Cabrera; Luis,9,0,22,13
1746549056056,LAWS 101,A00,907664,Staff,28,0,60,32
1746549057084,LIAB 1A,A00,889388,Saab; Dima,17,0,20,3
1746549058110,LIAB 1AX,A00,889389,El Cheddadi; Youniss,17,0,20,3
1746549059143,LIFR 1C,A00,889391,Van Moer; Vinciane G,8,0,20,12
1746549060172,LIFR 1CX,A00,889392,Van Moer; Vinciane G,7,0,20,13
1746549061201,LIFR 1D,A00,889393,Van Moer; Vinciane G,7,0,20,13
1746549062234,LIFR 1DX,A00,889394,Van Moer; Vinciane G,8,0,20,12
1746549063261,LIGN 7,A00,886923,Staff,24,0,50,26
1746549064285,LIGN 17,A00,886924,Kehler; Andrew Scott,125,0,150,25
1746549065308,LTAM 110,A00,889395,Staff,15,0,30,15
1746549066332,LTAM 110GS,A00,958010,Rodriguez; Bretton Sigfred,0,0,0,28
1746549067360,LTCH 101,A00,889397,Staff,23,0,25,2
1746549068384,LTCS 130,A00,889398,Staff,23,0,25,2
1746549069409,LTEA 138,A00,889399,Staff,24,0,40,16
1746549070432,LTEN 149,A00,889400,Wesling; Megan E.,0,3,25,25
1746549071459,LTEN 169,A00,889401,Staff,20,0,25,5
1746549072486,LTEN 180,A00,889402,Staff,10,0,15,5
1746549073513,LTEN 181,A00,889403,Staff,21,0,25,4
1746549074540,LTWL 100,A00,889404,Myerston Santana; Jacobo,3,0,25,22
1746549075564,LTWL 180GS,A00,889405,Staff,0,0,20,20
1746549076592,LTWL 181,A00,889406,Staff,17,0,25,8
1746549077616,LTWL 184,A00,889475,Mukherjee; Silpa,22,0,25,3
1746549078644,LTWR 102C,A00,889486,Staff,29,0,30,1
1746549079672,LTWR 115W,A00,889491,Staff,0,2,15,15
1746549080696,MAE 8,A01,886905,Staff,0,2,0,0
1746549081723,MAE 11,A00,886906,Bandaru; Prabhakar,0,7,50,50
1746549082752,MAE 20,A00,886907,Evdokimenko; Ekaterina,44,0,70,26
1746549083777,MAE 30B,A00,886909,Ghazinejad; Maziar,26,0,45,19
1746549084803,MAE 101B,A00,886910,Saintillan; David,29,0,45,16
1746549085828,MAE 105,A00,886911,Bandaru; Prabhakar,18,0,50,32
1746549086854,MAE 107,B00,958024,Staff,8,0,50,42
1746549087883,MAE 143B,A00,886913,Bewley; Thomas R,7,0,40,33
1746549088908,MAE 148,A01,886915,Silberman; Jack,0,3,14,14
1746549089936,MAE 160,A00,886916,Evdokimenko; Ekaterina,31,0,60,29
1746549090963,MATH 3C,A01,889681,Staff,0,3,30,30
1746549090963,MATH 3C,A02,960048,Staff,25,0,30,5
1746549091989,MATH 10A,A01,889760,Staff,26,0,30,4
1746549091989,MATH 10A,A02,889783,Staff,29,0,30,1
1746549093014,MATH 10B,A01,889785,Verstraete; Jacques Allan,2,0,35,33
1746549093014,MATH 10B,A02,889795,Verstraete; Jacques Allan,4,0,35,31
1746549093014,MATH 10B,B01,889797,Verstraete; Jacques Allan,3,0,35,32
1746549093014,MATH 10B,B02,889828,Verstraete; Jacques Allan,3,0,35,32
1746549094040,MATH 10C,A01,889849,Habib; Yousaf,9,0,30,21
1746549094040,MATH 10C,A02,889852,Habib; Yousaf,14,0,30,16
1746549094040,MATH 10C,A03,889853,Habib; Yousaf,22,0,30,8
1746549094040,MATH 10C,A04,889858,Habib; Yousaf,20,0,30,10
1746549094040,MATH 10C,B01,889861,Staff,1,0,30,29
1746549094040,MATH 10C,B02,889862,Staff,24,0,30,6
1746549094040,MATH 10C,B03,889863,Staff,27,0,30,3
1746549094040,MATH 10C,B04,889967,Staff,23,0,30,7
1746549095063,MATH 18,A01,889974,Staff,7,0,30,23
1746549095063,MATH 18,A02,889977,Staff,20,0,30,10
1746549095063,MATH 18,B01,889984,Hardiman; Liam,22,0,30,8
1746549095063,MATH 18,B02,889985,Hardiman; Liam,25,0,30,5
1746549096090,MATH 20A,A01,889990,Suk; Andrew Hoon,29,0,35,6
1746549097120,MATH 20B,A01,889993,Ohm; Ko Woon,22,0,30,8
1746549097120,MATH 20B,A02,889994,Ohm; Ko Woon,30,0,30,0
1746549097120,MATH 20B,B01,889996,Ohm; Ko Woon,21,0,30,9
1746549097120,MATH 20B,B02,889997,Ohm; Ko Woon,23,0,30,7
1746549098147,MATH 20C,A01,889999,Hammock; Frances H,17,0,30,13
1746549098147,MATH 20C,A02,890003,Hammock; Frances H,23,0,30,7
1746549098147,MATH 20C,B01,890006,Hammock; Frances H,3,0,30,27
1746549098147,MATH 20C,B02,890007,Hammock; Frances H,11,0,30,19
1746549099178,MATH 20D,A01,890011,Cheng; Hsiao-Bing,1,1,30,29
1746549099178,MATH 20D,A02,890012,Cheng; Hsiao-Bing,14,0,30,16
1746549099178,MATH 20D,B01,890016,Cheng; Hsiao-Bing,13,0,30,17
1746549099178,MATH 20D,B02,890017,Cheng; Hsiao-Bing,13,0,30,17
1746549100202,MATH 20E,A01,890026,Harel; Guershon,1,0,30,29
1746549100202,MATH 20E,A02,890029,Harel; Guershon,23,0,30,7
1746549100202,MATH 20E,B01,890033,Harel; Guershon,7,0,30,23
1746549100202,MATH 20E,B02,890101,Harel; Guershon,21,0,30,9
1746549101230,MATH 102,A01,890104,Staff,17,0,30,13
1746549101230,MATH 102,A02,890105,Staff,27,0,30,3
1746549102257,MATH 103B,A01,890116,Salehi Golsefidy; Alireza,3,0,30,27
1746549102257,MATH 103B,B01,890118,Staff,0,3,34,34
1746549103281,MATH 109,A01,890121,Aliabadi Sr.; Mohsen,1,0,30,29
1746549103281,MATH 109,B01,890124,Upadrashta; Pranav Kumar,18,0,30,12
1746549104308,MATH 120A,A01,890126,Eggers; John Dietrich,13,0,30,17
1746549105333,MATH 142B,A01,890128,Ioana; Adrian,19,0,30,11
1746549105333,MATH 142B,A02,890129,Ioana; Adrian,13,0,30,17
1746549106359,MATH 154,A01,890174,Staff,0,0,30,30
1746549106359,MATH 154,A02,890182,Staff,0,0,30,30
1746549107385,MATH 168A,A01,890197,Dumitriu; Ioana,21,0,35,14
1746549108411,MATH 170A,A01,890240,Nie; Jiawang,1,0,30,29
1746549108411,MATH 170A,A02,890241,Nie; Jiawang,11,0,30,19
1746549108411,MATH 170A,A03,890249,Nie; Jiawang,23,0,30,7
1746549109437,MATH 170B,A01,957891,Nag; Panchali,13,0,35,22
1746549111491,MATH 181A,A01,908025,Staff,0,4,35,35
1746549111491,MATH 181A,A02,960115,Staff,27,0,35,8
1746549112516,MATH 181B,A01,959874,Staff,26,0,30,4
1746549113541,MATH 193B,A01,890265,Staff,0,4,35,35
1746549114566,MGT 4,A01,890311,Anderson; John Charles,42,0,88,46
1746549115591,MGT 5,A00,907740,Staff,13,0,98,85
1746549116618,MGT 12,A00,890312,Lindenberger; Wade Douglas,67,0,98,31
1746549117642,MGT 16,A00,957883,Staff,78,0,98,20
1746549119691,MGT 45,A00,890314,Pecore; Joseph P.,47,0,98,51
1746549120719,MGT 71,A00,890315,Staff,0,11,98,98
1746549121746,MGT 100,A00,890316,Yavorsky; Daniel Ryan,44,0,98,54
1746549122772,MGT 103,A00,890317,Ehrich; Kristine R,73,0,98,25
1746549123796,MGT 105,A00,890356,Bates; Kenneth Walter,0,7,98,98
1746549124821,MGT 112,A00,890360,Ehrich; Kristine R,55,0,98,43
1746549125851,MGT 127R,A00,907732,Zhu; Kevin Xiaoguo,23,0,98,75
1746549126875,MGT 131B,A00,890361,Anderson; John Charles,61,0,98,37
1746549127904,MGT 137,A00,890362,Lindenberger; Wade Douglas,65,0,98,33
1746549128929,MGT 160,A00,890369,Johnson; Erik Barry,9,0,98,89
1746549130982,MGT 164,A00,890372,Zimmermann; Carsten,0,39,98,98
1746549132007,MGT 180,A00,890374,Bliss; Barbara Ann,12,0,98,86
1746549133034,MMW 15,A01,886414,Chang; Edmond Yi-Teh,0,12,28,28
1746549133034,MMW 15,A02,886415,Chang; Edmond Yi-Teh,0,8,28,28
1746549133034,MMW 15,A03,886416,Chang; Edmond Yi-Teh,0,8,28,28
1746549133034,MMW 15,A04,886417,Chang; Edmond Yi-Teh,0,8,28,28
1746549133034,MMW 15,B01,886419,Chang; Edmond Yi-Teh,0,7,28,28
1746549133034,MMW 15,B02,886420,Chang; Edmond Yi-Teh,0,8,28,28
1746549133034,MMW 15,B03,886421,Chang; Edmond Yi-Teh,0,7,28,28
1746549133034,MMW 15,B04,886422,Chang; Edmond Yi-Teh,0,8,28,28
1746549133034,MMW 15,C01,886424,Staff,0,9,28,28
1746549133034,MMW 15,C02,886425,Staff,0,8,28,28
1746549133034,MMW 15,C03,886426,Staff,0,8,28,28
1746549133034,MMW 15,C04,886427,Staff,0,7,28,28
1746549133034,MMW 15,C05,958038,Staff,0,7,28,28
1746549133034,MMW 15,C06,958039,Staff,0,8,28,28
1746549134061,MMW 15GS,A00,906910,Patterson; Patrick H.,4,0,28,24
1746549135086,MMW 122R,A01,886429,Rahimi; Babak,0,13,28,28
1746549135086,MMW 122R,A02,886430,Rahimi; Babak,0,12,28,28
1746549135086,MMW 122R,A03,958040,Rahimi; Babak,0,11,28,28
1746549136114,MUS 1A,A01,890937,Staff,3,0,25,22
1746549136114,MUS 1A,A02,891035,Staff,6,0,25,19
1746549136114,MUS 1A,C01,958912,Staff,24,0,25,1
1746549136114,MUS 1A,C02,958913,Staff,25,0,25,0
1746549138163,MUS 2AK,A00,957092,Ohnishi; Takae,15,0,15,0
1746549139189,MUS 4,A01,891044,Staff,2,0,25,23
1746549139189,MUS 4,A02,891045,Staff,23,0,25,2
1746549139189,MUS 4,B01,891048,Staff,17,0,25,8
1746549139189,MUS 4,B02,891050,Staff,25,0,25,0
1746549140217,MUS 5,A01,957506,Dubnov; Shlomo,0,0,25,25
1746549140217,MUS 5,A02,957622,Dubnov; Shlomo,14,0,25,11
1746549140217,MUS 5,A03,957623,Dubnov; Shlomo,20,0,25,5
1746549141241,MUS 6,A01,891053,Freitas Caetano; Marcelo,24,0,25,1
1746549141241,MUS 6,A02,891054,Freitas Caetano; Marcelo,23,0,25,2
1746549142269,MUS 7,A01,891081,Staff,0,0,25,25
1746549142269,MUS 7,A02,891082,Staff,4,0,25,21
1746549143296,MUS 8GS,A00,891118,Borgo; David Garcia,0,0,25,25
1746549144322,MUS 11,A01,891140,Staff,11,0,25,14
1746549144322,MUS 11,A02,891141,Staff,22,0,25,3
1746549145347,MUS 13,A01,891143,Staff,8,0,25,17
1746549145347,MUS 13,A02,891144,Staff,24,0,25,1
1746549146373,MUS 15,A01,891146,Staff,9,0,25,16
1746549146373,MUS 15,A02,891148,Staff,21,0,25,4
1746549146373,MUS 15,B01,891150,Staff,18,0,25,7
1746549146373,MUS 15,B02,891151,Staff,25,0,25,0
1746549147399,MUS 20,A01,891153,Staff,5,0,20,15
1746549147399,MUS 20,A02,891155,Staff,14,0,20,6
1746549148423,MUS 80,A00,891156,Staff,19,0,25,6
1746549148423,MUS 80,B00,891157,Staff,23,0,25,2
1746549149448,MUS 130,A00,891158,Ohnishi; Takae,35,0,35,0
1746549150475,MUS 150GS,A01,891160,Borgo; David Garcia,0,0,25,25
1746549151501,MUS 170,A01,891162,Freitas Caetano; Marcelo,20,0,25,5
1746549151501,MUS 170,A02,891164,Freitas Caetano; Marcelo,21,0,25,4
1746549152527,NANO 11,A00,886220,Vazquez Mena; Oscar,13,0,15,2
1746549153553,NANO 15,A01,886222,Drews; Aaron,4,0,7,3
1746549154579,NANO 104,A00,886224,Sirbuly; Donald,18,0,25,7
1746549155608,PH 40,A00,886528,Staff,23,0,40,17
1746549156635,PH 45,A01,886799,Staff,35,0,40,5
1746549157661,PH 110,A00,886802,Staff,0,7,40,40
1746549158686,PH 172,A00,906716,Staff,19,0,35,16
1746549159712,PH 191,A00,886803,Staff,6,0,40,34
1746549160738,PHIL 1,A00,889500,Staff,19,0,30,11
1746549161764,PHIL 10,A01,889549,Grush; Rick Scott,15,0,22,7
1746549161764,PHIL 10,A02,889551,Grush; Rick Scott,22,0,22,0
1746549162789,PHIL 28,A01,889559,Lamey; Andy M.,0,1,31,31
1746549162789,PHIL 28,A02,889561,Lamey; Andy M.,0,1,30,30
1746549162789,PHIL 28,A03,889572,Lamey; Andy M.,0,0,30,30
1746549163814,PHIL 35,A00,907839,Staff,13,0,15,2
1746549164838,PHIL 60,A00,889574,Staff,74,0,90,16
1746549165862,PHIL 101,A00,958004,Staff,13,0,15,2
1746549167911,PHIL 136,A00,889582,Fulkerson; Matthew Todd,26,0,45,19
1746549168936,PHIL 163,A01,889601,Staff,21,0,30,9
1746549168936,PHIL 163,B01,889606,Brandt; Reuven A,0,3,0,0
1746549169960,PHIL 164,A00,889610,Staff,16,0,30,14
1746549170985,PHIL 165,A00,889613,Staff,23,0,30,7
1746549172012,PHYS 1A,A00,886431,Staff,26,0,70,44
1746549173039,PHYS 1AL,001,886432,Tsai; Philbert S,0,2,30,30
1746549173039,PHYS 1AL,002,886436,Tsai; Philbert S,11,0,30,19
1746549174065,PHYS 1B,A00,886439,Staff,185,0,240,55
1746549175090,PHYS 1BL,001,886441,Tsai; Philbert S,0,4,30,30
1746549175090,PHYS 1BL,002,886444,Tsai; Philbert S,2,0,30,28
1746549176117,PHYS 1C,A00,896092,Arnold; Kam S,78,0,146,68
1746549177146,PHYS 1CL,001,886448,Tsai; Philbert S,0,0,30,30
1746549177146,PHYS 1CL,002,886449,Tsai; Philbert S,0,0,30,30
1746549177146,PHYS 1CL,003,886450,Tsai; Philbert S,16,0,30,14
1746549177146,PHYS 1CL,004,886451,Tsai; Philbert S,15,0,30,15
1746549178175,PHYS 2B,A01,886457,Staff,69,0,115,46
1746549179201,PHYS 2C,A01,886460,Shotwell; Brian,0,8,65,65
1746549180228,PHYS 2CL,A01,886467,Staff,0,4,28,28
1746549180228,PHYS 2CL,A02,886468,Staff,0,3,28,28
1746549181253,PHYS 2D,A01,886470,Staff,10,0,50,40
1746549182278,PHYS 4B,A01,886475,Grinstein; Benjamin,22,0,40,18
1746549183304,POLI 5,A00,891173,Desposato; Scott,7,0,25,18
1746549184329,POLI 5D,A01,891175,Staff,5,0,5,0
1746549184329,POLI 5D,B01,891178,Staff,5,0,5,0
1746549185358,POLI 11,A00,891179,Ferree; Karen E,2,0,35,33
1746549186382,POLI 12,A00,891180,Staff,16,0,30,14
1746549187406,POLI 27,A01,891182,Staff,12,0,75,63
1746549188433,POLI 30,A00,891183,Staff,8,0,50,42
1746549189456,POLI 100B,A00,891244,Staff,5,1,35,30
1746549190480,POLI 100I,A00,891247,Staff,7,0,30,23
1746549191505,POLI 104J,A00,891248,Nichter; Maysa,14,0,30,16
1746549192535,POLI 104U,A00,891250,Nichter; Maysa,2,0,30,28
1746549194587,POLI 110B,A00,891255,Wiens; David,20,0,25,5
1746549195615,POLI 112A,A00,891256,Wiens; David,6,0,25,19
1746549196638,POLI 114BR,A00,891261,Staff,19,0,30,11
1746549197663,POLI 117R,A00,891262,Forman; Fonna,0,6,50,50
1746549198692,POLI 118,A00,891264,Ingham; Sean,17,0,25,8
1746549199716,POLI 124A,A00,891265,Staff,18,0,20,2
1746549200744,POLI 125D,A00,891266,Nichter; Simeon C,2,0,25,23
1746549201768,POLI 126,A00,891268,Nichter; Simeon C,7,0,25,18
1746549202792,POLI 126AA,A00,891272,Staff,17,0,25,8
1746549203821,POLI 130AA,A00,891273,Staff,15,0,20,5
1746549204849,POLI 134AA,A00,891274,Staff,4,0,20,16
1746549206900,POLI 138,A00,891278,Staff,21,0,25,4
1746549207925,POLI 142K,A00,891280,Staff,11,0,25,14
1746549208951,POLI 142M,A00,891281,Gartzke; Erik,17,0,30,13
1746549209978,POLI 142P,A00,891284,Staff,20,0,30,10
1746549211006,POLI 143,A00,891285,Gartzke; Erik,12,0,30,18
1746549212030,POLI 153,A00,891286,Staff,19,0,20,1
1746549214082,POLI 175,A00,891290,Staff,15,0,20,5
1746549215111,PSYC 1,A00,890674,Steiner; Eric Tomas,0,11,45,45
1746549216137,PSYC 2,A00,890676,Albright; Thomas D,21,0,35,14
1746549217169,PSYC 3,A00,890679,Staff,17,0,20,3
1746549218197,PSYC 6,A00,959858,Staff,20,0,20,0
1746549219223,PSYC 60,A01,890684,Rickard; Timothy C.,0,5,45,45
1746549220269,PSYC 70,A01,890689,Geller; Emma Harlan,7,0,30,23
1746549221298,PSYC 71,A01,959860,Staff,21,0,25,4
1746549222322,PSYC 100,A00,890690,Lacefield; Katharine I,0,50,180,180
1746549223347,PSYC 102,A00,890695,Staff,18,0,40,22
1746549224372,PSYC 105,A00,890699,Geller; Emma Harlan,71,0,100,29
1746549225399,PSYC 106,A00,890701,Gorman; Michael R.,5,0,30,25
1746549226425,PSYC 108,A00,890704,Adrian; Julia Anna,0,28,50,50
1746549227449,PSYC 118,A01,890712,Staff,11,0,30,19
1746549228473,PSYC 124,A00,890716,Chapman; Eddie Nathaniel,25,0,60,35
1746549229498,PSYC 131,A00,890717,Anagnostaras; Stephan,0,7,80,80
1746549230524,PSYC 137,A00,890719,Winkielman; Piotr,0,11,30,30
1746549231550,PSYC 144,A00,890721,Adrian; Julia Anna,0,9,45,45
1746549232576,PSYC 162,A00,890805,Staff,2,0,75,73
1746549233602,PSYC 169,A00,890810,Staff,0,15,30,30
1746549234628,PSYC 172,A00,890814,Gorman; Michael R.,9,0,30,21
1746549235653,PSYC 181,A00,890818,Anagnostaras; Stephan,8,0,200,192
1746549236678,PSYC 184,A00,959861,Staff,170,0,175,5
1746549237702,PSYC 189,A00,890823,Staff,0,1,30,30
1746549238727,PSYC 191,A00,890884,Rickard; Timothy C.,0,11,35,35
1746549239751,PSYC 193,A00,890913,Staff,19,0,30,11
1746549239751,PSYC 193,B00,890914,Chapman; Eddie Nathaniel,24,0,30,6
1746549240778,PSYC 193L,A01,890918,Lowe; Angela Beth,20,0,30,10
1746549240778,PSYC 193L,B01,890921,Hurwitz; Ethan Scott,20,0,30,10
1746549240778,PSYC 193L,C01,890928,Staff,30,0,30,0
1746549241810,RELI 149,A00,886806,Rahimi; Babak,23,0,40,17
1746549242834,SE 9,A01,886814,Staff,7,0,20,13
1746549243857,SE 101B,A01,886816,Chadha; Mayank,4,0,35,31
1746549244880,SE 110B,A00,886818,Zhu; Qiang,4,0,75,71
1746549245904,SE 125,A01,886830,Staff,10,0,30,20
1746549246929,SE 130B,A01,886835,Staff,14,0,40,26
1746549247953,SE 131A,A01,886838,Krysl; Petr,34,0,55,21
1746549248978,SE 154,A00,886840,Staff,30,0,50,20
1746549250002,SE 164GS,A01,886849,Staff,6,0,20,14
1746549251030,SE 167GS,A01,886853,Staff,6,0,20,14
1746549252057,SIO 25,A01,890107,Staff,19,0,30,11
1746549253081,SIO 45,A00,890109,Cook; Geoffrey W,117,0,200,83
1746549254111,SIO 109R,A00,890110,Forman; Fonna,0,16,20,20
1746549255137,SIO 187,A01,890114,Kacev; David,15,0,40,25
1746549256165,SOCI 1,A01,890431,Thorpe; Charles Robert,15,0,30,15
1746549256165,SOCI 1,A02,890518,Thorpe; Charles Robert,30,0,30,0
1746549257191,SOCI 2,A01,957978,Staff,25,0,25,0
1746549257191,SOCI 2,A02,957979,Staff,23,0,25,2
1746549258218,SOCI 20,A01,890523,Calderon-Zaks; Michael Aar,23,0,30,7
1746549258218,SOCI 20,A02,890526,Calderon-Zaks; Michael Aar,29,0,30,1
1746549259245,SOCI 30,A01,890533,Pardo Guerra; Juan Pablo,37,0,40,3
1746549260270,SOCI 40,A01,890535,Staff,27,0,45,18
1746549261299,SOCI 104Q,A00,890559,Staff,18,0,30,12
1746549262324,SOCI 106,A00,890560,Arnal; Maud Marie Leonie,20,0,30,10
1746549263350,SOCI 110,A00,890567,Holkenbrink-Monk; Charlene,19,0,30,11
1746549264377,SOCI 112,A00,890568,Victoria Torres; Pablo,1,0,55,54
1746549265401,SOCI 115,A00,890597,Arnal; Maud Marie Leonie,28,0,45,17
1746549267453,SOCI 121,A00,890604,Pardo Guerra; Juan Pablo,38,0,45,7
1746549268481,SOCI 126,A01,890608,Staff,8,0,10,2
1746549269507,SOCI 127,A00,890609,Staff,18,0,30,12
1746549270534,SOCI 131,A00,890610,Thorpe; Charles Robert,37,0,45,8
1746549271559,SOCI 135,A00,890615,Payne; Christine Anna,14,0,45,31
1746549272584,SOCI 139,A00,890620,Staff,38,0,45,7
1746549273609,SOCI 148E,A00,890622,Calderon-Zaks; Michael Aar,36,0,45,9
1746549274638,SOCI 150,A00,890623,Kohler; Kristopher M.,31,0,45,14
1746549275662,SOCI 157,A00,890625,Jules-Rosette; Bennetta W.,18,0,20,2
1746549276690,SOCI 160,A00,890627,Payne; Christine Anna,21,0,45,24
1746549277714,SYN 1,A00,886855,Fish; Gwendolyn Anne,0,0,0,0
1746549277714,SYN 1,B00,906086,Fish; Gwendolyn Anne,0,1,0,2
1746549278740,SYN 2R,A00,886860,Staff,0,17,15,15
1746549278740,SYN 2R,B00,906106,Atkinson; Arthur Laird,0,16,15,15
1746549279766,SYN 100,A01,886866,Browne; Emily,0,28,20,20
1746549279766,SYN 100,B01,906128,Rock; Martin,0,5,20,20
1746549279766,SYN 100,C01,906140,Deavenport; James Cary,0,3,20,20
1746549279766,SYN 100,D01,907816,Deavenport; James Cary,0,5,20,20
1746549280793,TDAC 1,A00,890286,Walsh; Kim C.,9,0,20,11
1746549281819,TDAC 101,A00,890296,Basso; Beatrice,16,0,20,4
1746549282842,TDDE 131,A00,890297,Staff,47,0,50,3
1746549283873,TDDM 1,A00,890287,Weinberg; Sadie,25,0,30,5
1746549284904,TDGE 11,A00,890288,Fulton; Julia,137,0,200,63
1746549284904,TDGE 11,B00,890289,Castro; Robert Jess,184,0,200,16
1746549285931,TDGE 25,B00,957359,Walsh; Kim C.,3,0,20,17
1746549286958,TDGE 40,A01,890292,Power; Jade Yukana,27,0,30,3
1746549287983,TDGE 124,A00,890298,Havis; Allan,0,0,50,50
1746549289010,TDGE 131R,A00,890299,Burelle; Julie Sara Veronique,15,0,42,27
1746549290036,TDHT 101,A00,890300,Staff,10,0,20,10
1746549291064,TDHT 109,A01,890302,Anderson; Mysia Anyse,31,0,40,9
1746549292093,TDMV 1,A00,890293,Arcidiacono; Kristin,18,0,30,12
1746549293116,TDMV 2,A00,890294,Weinberg; Sadie,23,0,30,7
1746549294143,TDMV 3,A00,957878,Arcidiacono; Kristin,28,0,30,2
1746549296193,TDMV 138,A00,890304,Jun; Grace Shin Hae,25,0,40,15
1746549297220,TDMV 140,A00,890305,Corrales; Joseph Bernales,25,0,30,5
1746549298249,TDMV 142,A00,890307,Caligagan; Tony,32,0,40,8
1746549299275,TDMV 144,A00,890308,Camaya; Michelle Ann,25,0,30,5
1746549300304,TDPW 1,A00,890295,Stein; Deborah Isobel,3,0,20,17
1746549301331,USP 2,A01,890272,Lerner; Amy M,6,0,20,14
1746549302359,USP 3,A01,890274,Staff,12,0,30,18
1746549303386,USP 15,A01,890276,Sun; Feiyang,17,0,30,13
1746549304418,USP 25,A00,890277,Shenkman; Michael Thomas,19,0,25,6
1746549305444,USP 138,A00,890278,Staff,13,0,25,12
1746549306469,USP 143,A00,890279,Staff,21,0,70,49
1746549307493,USP 144,A00,890280,Chowdhury; Muhammed Zohir,16,0,30,14
1746549308521,USP 150,A00,890281,Boomhower; Matthew Charles,4,0,30,26
1746549309546,USP 151,A00,890282,Staff,16,0,20,4
1746549310569,USP 162,A00,890283,Andrews; Abigail Leslie,16,0,20,4
1746549311596,USP 168,A00,920477,Kwak; Nancy,1,0,5,4
1746549312620,USP 181,A00,890284,Staff,3,0,20,17
1746549313644,USP 191A,A00,890285,Staff,13,0,20,7
1746549314669,VIS 101,A00,886512,Staff,25,0,75,50
1746549315694,VIS 103,A00,886513,Cruz; Edwin Teddy,61,0,75,14
1746549316722,VIS 108,A00,886514,Staff,3,0,15,12
1746549317750,VIS 127P,A00,886515,Shen; Kuiyi,80,0,146,66
1746549318777,VIS 149,A00,886516,Yoldas; Pinar,0,0,15,15
1746549319803,VIS 164,A00,886526,Erdmann; Dean,19,0,22,3
1746549320829,VIS 194S,A00,886527,Staff,61,0,75,14
1746549321855,WCWP 10A,C00,886484,Martiniuk; Jill,12,0,15,3
1746549322883,WCWP 10B,A00,886490,Uriarte; Emma,0,0,15,15
1746549322883,WCWP 10B,B00,886491,Dhir; Simrita,10,0,15,5
1746549322883,WCWP 10B,C00,886492,Ornelas; Tricia,0,0,15,15
1746549323911,WCWP 100,A00,886494,Young; Mark T,0,6,15,15
1746549325988,AAS 10,A01,886199,Childs; Dennis R.,0,3,0,0
1746549327014,ANAR 104,A01,886940,Shtienberg; Gilad,27,0,30,3
1746549328039,ANAR 120,A00,886953,Staff,12,0,20,8
1746549329066,ANBI 148,A01,886955,Wilder; Linnea Lorene,30,0,40,10
1746549331119,ANSC 122,A00,886957,Staff,25,0,30,5
1746549332145,ANSC 150,A00,886958,Sloane; Julia Kathryn,3,0,15,12
1746549333171,ANSC 156,A00,886959,Jenkins; Janis A.,0,1,15,15
1746549334197,ANSC 180,A00,886960,Staff,11,0,17,6
1746549335224,ANSC 188,A00,886961,Jassal; Aftab,9,0,25,16
1746549336250,ANSC 190,A00,886962,Jassal; Aftab,14,0,25,11
1746549337279,ANSC 191,A00,886963,Staff,18,0,20,2
1746549338303,ANTH 3,A01,891689,Staff,17,0,20,3
1746549339331,ANTH 5,A00,886933,Semendeferi; Ekaterini,16,0,20,4
1746549340357,ANTH 10,A00,886934,Staff,0,12,30,30
1746549341383,ANTH 21,A01,886936,Staff,40,0,60,20
1746549342410,ANTH 23,A01,886938,Staff,92,0,100,8
1746549343434,ANTH 105,A00,886964,Stewart; Alexander B,84,0,100,16
1746549344465,ANTH 108,A00,886965,Pedersen; David,9,0,20,11
1746549345499,AWP 10,001,886147,Staff,0,0,0,0
1746549345499,AWP 10,002,886148,Staff,0,0,0,0
1746549345499,AWP 10,003,886149,Staff,0,0,0,0
1746549345499,AWP 10,004,886150,Staff,0,0,0,0
1746549345499,AWP 10,005,886151,Staff,0,0,0,0
1746549345499,AWP 10,006,886152,Staff,0,0,0,0
1746549345499,AWP 10,007,886153,Staff,0,0,0,0
1746549345499,AWP 10,008,886154,Staff,0,0,0,0
1746549345499,AWP 10,009,886155,Staff,0,0,0,0
1746549345499,AWP 10,010,886156,Staff,0,0,0,0
1746549345499,AWP 10,011,886158,Staff,0,0,0,0
1746549345499,AWP 10,012,886160,Staff,0,0,0,0
1746549345499,AWP 10,013,886161,Staff,0,0,0,0
1746549345499,AWP 10,014,886162,Staff,0,0,0,0
1746549345499,AWP 10,015,886163,Staff,0,0,0,0
1746549345499,AWP 10,016,886164,Staff,0,0,0,0
1746549345499,AWP 10,017,886165,Staff,0,0,0,0
1746549345499,AWP 10,018,886166,Staff,0,0,0,0
1746549345499,AWP 10,019,886168,Staff,0,0,0,0
1746549345499,AWP 10,020,886170,Staff,0,0,0,0
1746549345499,AWP 10,021,886172,Staff,0,0,0,0
1746549346524,AWP 10R,001,886173,Staff,0,1,0,0
1746549346524,AWP 10R,002,886174,Staff,0,1,0,0
1746549346524,AWP 10R,003,886175,Staff,0,0,0,0
1746549346524,AWP 10R,004,886176,Staff,0,0,0,0
1746549346524,AWP 10R,005,886177,Staff,0,0,0,0
1746549346524,AWP 10R,006,886178,Staff,0,0,0,0
1746549346524,AWP 10R,007,886179,Staff,0,0,0,0
1746549346524,AWP 10R,008,886181,Staff,0,0,0,0
1746549346524,AWP 10R,009,886182,Staff,0,0,0,0
1746549346524,AWP 10R,010,886183,Staff,0,0,0,0
1746549346524,AWP 10R,011,886184,Staff,0,0,0,0
1746549346524,AWP 10R,012,886185,Staff,0,0,0,0
1746549346524,AWP 10R,013,886186,Staff,0,0,0,0
1746549346524,AWP 10R,014,886187,Staff,0,0,0,0
1746549346524,AWP 10R,015,886188,Staff,0,0,0,0
1746549346524,AWP 10R,016,886189,Staff,0,0,0,0
1746549347547,AWP 102R,A00,886190,Staff,0,0,0,0
1746549347547,AWP 102R,B00,886191,Staff,0,0,0,0
1746549348570,BENG 100,A01,886193,Staff,17,0,30,13
1746549349596,BENG 122A,A01,886195,Hasty; Jeff M,13,0,30,17
1746549350622,BENG 166A,A00,886196,Sah; Robert Lie-Yuan,0,1,30,30
1746549351647,BENG 190,A00,958050,Khojah; Reem I,24,0,25,1
1746549352673,BIBC 102,A01,894320,Staff,0,0,46,46
1746549352673,BIBC 102,A02,894321,Staff,0,0,46,46
1746549352673,BIBC 102,A03,894344,Staff,7,0,46,39
1746549352673,BIBC 102,A04,894345,Staff,26,0,47,21
1746549353700,BICD 100R,A01,894365,Smith; Laurie,0,3,58,58
1746549353700,BICD 100R,A02,894366,Smith; Laurie,0,5,58,58
1746549353700,BICD 100R,A03,894367,Smith; Laurie,2,0,59,57
1746549353700,BICD 100R,A04,959869,Smith; Laurie,41,0,59,18
1746549354729,BICD 136,A01,894383,Gustafson-Brown; Cindy,14,0,50,36
1746549355757,BIEB 102,A01,894494,Butler; Shannon Rhey,51,0,130,79
1746549357826,BIEB 150,A01,894617,Wills; Christopher,3,0,20,17
1746549357826,BIEB 150,A02,894631,Wills; Christopher,3,0,20,17
1746549357826,BIEB 150,A03,894937,Wills; Christopher,3,0,20,17
1746549357826,BIEB 150,A04,894946,Wills; Christopher,5,0,20,15
1746549358855,BIEB 194,A00,906141,Kurle; Carolyn M.,6,0,20,14
1746549359884,BILD 1,A01,894154,Staff,2,0,19,17
1746549359884,BILD 1,A02,894155,Staff,14,0,19,5
1746549359884,BILD 1,A03,894160,Staff,13,0,19,6
1746549359884,BILD 1,A04,894161,Staff,15,0,18,3
1746549360910,BILD 2,A01,894168,Staff,0,0,50,50
1746549360910,BILD 2,A02,894169,Staff,0,0,50,50
1746549360910,BILD 2,A03,894179,Staff,4,0,50,46
1746549360910,BILD 2,A04,894203,Staff,27,0,50,23
1746549361933,BILD 3,A01,894213,Staff,22,0,31,9
1746549361933,BILD 3,A02,894214,Staff,26,0,31,5
1746549361933,BILD 3,A03,894235,Staff,28,0,31,3
1746549361933,BILD 3,A04,894236,Staff,28,0,32,4
1746549362959,BILD 4,A01,894253,Reuther; Keefe,5,0,24,19
1746549362959,BILD 4,A02,894258,Reuther; Keefe,16,0,24,8
1746549363986,BILD 5,A01,894276,Reuther; Keefe,35,0,50,15
1746549363986,BILD 5,A02,894277,Reuther; Keefe,45,0,50,5
1746549363986,BILD 5,A03,894290,Reuther; Keefe,44,0,50,6
1746549363986,BILD 5,A04,894291,Reuther; Keefe,48,0,50,2
1746549365017,BILD 24,A01,894297,Pirino; Giorgia,40,0,60,20
1746549366046,BIMM 100,B01,958915,Staff,72,0,100,28
1746549367071,BIMM 101,A01,895017,McDonnell; Lisa Marie,0,5,24,24
1746549367071,BIMM 101,A02,895018,McDonnell; Lisa Marie,0,5,24,24
1746549367071,BIMM 101,B01,895020,McDonnell; Lisa Marie,0,6,24,24
1746549367071,BIMM 101,B02,895021,McDonnell; Lisa Marie,0,4,24,24
1746549368095,BIMM 110,A01,895023,Staff,1,0,25,24
1746549368095,BIMM 110,A02,895024,Staff,9,0,25,16
1746549368095,BIMM 110,A03,895025,Staff,18,0,25,7
1746549368095,BIMM 110,A04,895031,Staff,20,0,25,5
1746549369125,BIMM 120,A01,895114,Gustafson-Brown; Cindy,13,0,28,15
1746549369125,BIMM 120,A02,895126,Gustafson-Brown; Cindy,21,0,27,6
1746549370151,BIPN 100,A01,895130,Yang; Mingyu,1,0,38,37
1746549370151,BIPN 100,A02,895131,Yang; Mingyu,32,0,38,6
1746549370151,BIPN 100,A03,895132,Yang; Mingyu,32,0,38,6
1746549370151,BIPN 100,A04,895133,Yang; Mingyu,27,0,36,9
1746549371176,BIPN 120,A01,895135,Cooke; James Edward,0,3,13,13
1746549371176,BIPN 120,A02,895136,Cooke; James Edward,0,1,13,13
1746549371176,BIPN 120,A03,895137,Cooke; James Edward,0,3,13,13
1746549371176,BIPN 120,A04,895156,Cooke; James Edward,0,2,11,11
1746549372203,BIPN 134,A01,895235,Cooke; James Edward,0,2,25,25
1746549372203,BIPN 134,A02,895237,Cooke; James Edward,0,0,25,25
1746549372203,BIPN 134,A03,895240,Cooke; James Edward,3,0,25,22
1746549372203,BIPN 134,A04,895270,Cooke; James Edward,20,0,25,5
1746549373231,BIPN 189,A00,892103,Staff,0,13,14,14
1746549375285,BISP 194,A00,958008,Staff,0,2,0,0
1746549376309,CAT 124,A01,922009,Staff,0,5,20,20
1746549377340,CAT 125R,A00,886390,Morales; Celeste Georgianna,0,2,20,20
1746549377340,CAT 125R,B00,886391,Irwin; Matthew Joseph,0,3,20,20
1746549377340,CAT 125R,C00,886392,Smith; Lauryn Alissa,0,2,20,20
1746549377340,CAT 125R,D00,886393,Vanderschuit; Maya Alysia,0,2,20,20
1746549377340,CAT 125R,E00,886394,Marchisotto; Jennifer Anne,0,4,20,20
1746549378366,CENG 15,A01,886218,Drews; Aaron,3,0,8,5
1746549379390,CENG 113,A00,886219,Opatkiewicz; Justin Paul,15,0,25,10
1746549380414,CGS 101,A00,887044,Staff,7,0,20,13
1746549381441,CGS 105,A01,887046,Staff,14,0,25,11
1746549382469,CGS 112,A00,887047,Cuong; Marisol,12,0,15,3
1746549383496,CGS 113,A00,887048,Staff,23,0,30,7
1746549384521,CGS 120,A00,887049,Staff,10,0,17,7
1746549385546,CHEM 6A,A01,886336,Lam; Tin Yiu,38,0,50,12
1746549385546,CHEM 6A,A02,886338,Lam; Tin Yiu,37,0,50,13
1746549386573,CHEM 6B,A01,886341,Hopkins; Patrycja Anna,16,0,50,34
1746549386573,CHEM 6B,A02,886343,Hopkins; Patrycja Anna,42,0,50,8
1746549387603,CHEM 6C,A01,886346,Albizati; Kim F.,0,2,50,50
1746549387603,CHEM 6C,A02,886348,Albizati; Kim F.,23,0,50,27
1746549388628,CHEM 40A,A01,886352,Klosterman; Jeremy K,65,0,100,35
1746549389656,CHEM 40B,A01,886356,Klosterman; Jeremy K,0,23,100,100
1746549390680,CHEM 41B,A01,886360,Theodorakis; Emmanuel,25,0,50,25
1746549390680,CHEM 41B,A02,886362,Theodorakis; Emmanuel,47,0,50,3
1746549391705,CHIN 165A,A00,886382,Xu; Li,18,0,20,2
1746549392776,CLAS 120,A00,886387,Myerston Santana; Jacobo,33,0,40,7
1746549393802,COGS 9,A01,886967,Shannon; Kyle Michael,42,0,60,18
1746549394829,COGS 11,A01,886969,Staff,11,0,30,19
1746549395857,COGS 14A,A01,886971,Staff,6,0,60,54
1746549396886,COGS 14B,A01,886973,Hoffman; Drew Ellen,4,0,60,56
1746549397910,COGS 18,A01,886975,Morgan; Eric,35,0,60,25
1746549398939,COGS 20,A01,886977,Staff,4,0,8,4
1746549398939,COGS 20,A02,886978,Staff,5,0,7,2
1746549399964,COGS 100,A01,907783,Staff,0,2,30,30
1746549400989,COGS 101B,A01,886980,Staff,0,3,48,48
1746549402017,COGS 101C,A01,886982,Delgado; Tania,0,5,44,44
1746549403042,COGS 102A,A01,886984,Johnson; Christine M.,4,0,30,26
1746549404067,COGS 118B,A01,886986,Staff,0,3,88,88
1746549405091,COGS 150,A01,886988,Bergen; Benjamin,23,0,50,27
1746549406116,COGS 153,A00,886989,Delgado; Tania,0,2,41,41
1746549407140,COGS 186,A01,886991,Staff,0,0,32,32
1746549408171,COGS 187A,A01,886993,Boyle; Mary E. T.,7,0,30,23
1746549409197,COGS 189,A00,886994,Staff,0,1,30,30
1746549410226,COMM 10,A01,886996,Staff,0,0,20,21
1746549410226,COMM 10,A02,886997,Staff,12,0,20,8
1746549410226,COMM 10,A03,959845,Staff,19,0,20,1
1746549411250,COMM 20,A01,886999,Leuning; Grant Maurstad,24,0,40,16
1746549413303,COMM 100A,A01,887002,Staff,0,0,20,25
1746549413303,COMM 100A,A02,887003,Staff,7,0,20,13
1746549414330,COMM 100B,A01,887005,Staff,0,8,20,24
1746549415355,COMM 106D,A00,887006,Staff,14,0,40,26
1746549416381,COMM 110G,A00,887007,Whitworth-Smith; Andrew C,12,0,40,28
1746549417406,COMM 111B,A00,887008,Staff,31,0,40,9
1746549418432,COMM 113T,A00,887009,Abuelhiga; Soraya Jill,28,0,40,12
1746549418432,COMM 113T,B00,906733,Staff,40,0,40,0
1746549419458,COMM 145,A00,887010,Staff,12,0,40,28
1746549420484,COMM 146,A00,887054,Staff,31,0,40,9
1746549421508,COMM 190,A00,887012,Staff,8,0,23,15
1746549422535,CSE 8A,A50,887015,Cao; Yingjun,57,0,85,28
1746549423563,CSE 11,A01,887017,Cao; Yingjun,12,0,70,58
1746549424587,CSE 20,A01,887019,Staff,30,0,50,20
1746549425615,CSE 21,A01,887021,Staff,78,0,100,22
1746549425615,CSE 21,B01,892583,Braun; Oliver,45,0,50,5
1746549426640,CSE 30,A01,887025,Eldon; John,143,0,200,57
1746549427675,CSE 100,A01,887027,Staff,26,0,50,24
1746549427675,CSE 100,A02,887028,Staff,40,0,50,10
1746549428701,CSE 101,A01,887030,Braun; Oliver,75,0,100,25
1746549428701,CSE 101,B01,887032,Jones; Miles E,0,3,50,50
1746549428701,CSE 101,B02,887033,Jones; Miles E,0,1,50,50
1746549429729,CSE 105,A01,908084,Jones; Miles E,32,0,50,18
1746549429729,CSE 105,A02,908087,Jones; Miles E,33,0,50,17
1746549430754,CSE 135,A01,887035,Powell; Thomas Allan,0,4,50,50
1746549431782,CSE 142,A01,887037,Staff,8,0,60,52
1746549432805,CSE 142L,A01,887039,Staff,34,0,60,26
1746549433831,CSE 151A,A01,887041,Solares; Edwin A,47,0,100,53
1746549434856,CSE 175,A01,887043,Kumar; Rakesh,30,0,30,0
1746549435880,CSS 1,A01,886389,Staff,0,1,40,40
1746549436908,DSC 30,A01,908097,Liao; Soohyun Nam,47,0,75,28
1746549437932,DSC 40A,A01,908099,Shannon; Kyle Michael,30,0,50,20
1746549438961,DSC 40B,A01,908112,Staff,16,0,50,34
1746549439985,DSC 80,A01,908116,Staff,19,0,60,41
1746549441010,DSC 197,001,956863,Eldridge; Justin Matthew,9999,0,9999,0
1746549442039,ECE 5,A01,886400,Morris; Karcher William,2,0,6,4
1746549442039,ECE 5,A02,886401,Morris; Karcher William,3,0,6,3
1746549443065,ECE 148,A01,886403,Silberman; Jack,0,14,14,14
1746549444089,ECON 1,A01,887265,Crane; Meredith Helen,12,0,70,58
1746549444089,ECON 1,B01,887268,Staff,43,0,50,7
1746549445116,ECON 2,A01,887273,Crane; Meredith Helen,56,0,70,14
1746549446143,ECON 3,A01,887279,Rondina; Giacomo,32,0,70,38
1746549447170,ECON 4,A01,887282,Anderson; John Charles,0,2,10,10
1746549448196,ECON 5,A01,887285,Staff,33,0,45,12
1746549448196,ECON 5,B01,887292,Staff,41,0,45,4
1746549449220,ECON 100A,A01,887337,Newhouse; Herbert S,54,0,70,16
1746549449220,ECON 100A,B01,887349,Staff,45,0,50,5
1746549450245,ECON 100B,A01,887361,Du; Songzi,29,0,70,41
1746549451269,ECON 100C,A01,887445,Newhouse; Herbert S,59,0,70,11
1746549452293,ECON 105,A00,887488,Vespa; Emanuel Ignacio,23,0,35,12
1746549453317,ECON 109,A01,887506,Shishkin; Denis,28,0,35,7
1746549454341,ECON 110A,A01,887568,Alon; Titan Michael,0,3,35,35
1746549454341,ECON 110A,B01,907601,Alon; Titan Michael,20,0,35,15
1746549455366,ECON 110B,A01,887598,Levkoff; Steven B.,0,23,70,70
1746549456391,ECON 112,A00,887599,Rondina; Giacomo,19,0,35,16
1746549457418,ECON 120A,A01,887603,Dai; Yinlin,36,0,70,34
1746549458444,ECON 120C,A01,887608,Sun; Yixiao,0,1,35,35
1746549458444,ECON 120C,B01,887614,Sun; Yixiao,0,0,35,35
1746549459472,ECON 138,A00,887621,Bharadwaj; Prashant,0,20,20,20
1746549460501,ECON 144,A00,958007,Squires; Dale E,13,0,35,22
1746549461526,ECON 171,A01,907666,Staff,18,0,35,17
1746549462551,ECON 175,A00,887626,Wu; Pak Yeung,23,0,35,12
1746549463576,ECON 190,A00,887640,Vespa; Emanuel Ignacio,23,0,35,12
1746549464603,EDS 25,A01,888197,Staff,0,0,0,0
1746549464603,EDS 25,A02,888209,Staff,0,0,0,0
1746549464603,EDS 25,A03,888210,Staff,0,0,0,0
1746549464603,EDS 25,A04,888212,Staff,0,0,0,0
1746549464603,EDS 25,A05,888213,Staff,0,0,0,0
1746549464603,EDS 25,A06,888214,Staff,0,0,0,0
1746549464603,EDS 25,A07,888235,Staff,0,2,0,0
1746549464603,EDS 25,A08,888236,Staff,0,0,0,0
1746549464603,EDS 25,A09,888240,Staff,0,0,0,0
1746549464603,EDS 25,A10,888244,Staff,0,0,0,0
1746549464603,EDS 25,B01,888273,Staff,0,0,0,0
1746549464603,EDS 25,B02,888285,Staff,0,0,0,0
1746549464603,EDS 25,B03,888423,Staff,0,0,0,1
1746549464603,EDS 25,B04,888432,Staff,0,0,0,0
1746549464603,EDS 25,B05,888433,Staff,0,0,0,0
1746549464603,EDS 25,B06,888467,Staff,0,0,0,0
1746549464603,EDS 25,B07,888468,Staff,0,0,0,0
1746549464603,EDS 25,B08,888479,Staff,0,0,0,0
1746549464603,EDS 25,B09,888484,Staff,0,0,0,0
1746549464603,EDS 25,B10,888487,Staff,0,0,0,0
1746549465630,EDS 38,A01,907700,Choi; Bailey Miyeon,30,0,30,0
1746549466655,EDS 112,A01,888601,Chapman; Thandeka K,14,0,40,26
1746549467685,EDS 115,A00,888697,Mendez; Kathrina Mendoza,10,0,30,20
1746549468710,EDS 116,A01,888893,Staff,35,0,40,5
1746549470764,EDS 124AR,A00,889133,Staff,29,0,50,21
1746549470764,EDS 124AR,B00,907471,Simon; Elizabeth A,37,0,50,13
1746549471789,EDS 124BR,A00,889134,Simon; Elizabeth A,45,0,100,55
1746549472813,EDS 125,A00,889135,Staff,25,0,30,5
1746549473839,EDS 126,A01,889138,Staff,36,0,40,4
1746549474867,EDS 164R,A01,889142,Wishard Guerra; Alison G.,33,0,50,17
1746549475893,ENG 30,A01,886396,Staff,0,0,0,0
1746549475893,ENG 30,B01,886398,Staff,0,0,0,0
1746549476918,ENVR 102,A00,906150,Montejo; Carolina,23,0,25,2
1746549477943,ETHN 103A,A00,887236,Man; Simeon S,0,3,0,0
1746549478971,ETHN 113,A00,887239,Staff,16,0,30,14
1746549479997,ETHN 116,A00,887240,Staff,16,0,25,9
1746549481027,ETHN 117,A00,887241,Choi; Esther Min,28,0,30,2
1746549482053,ETHN 118,A00,887243,Staff,24,0,30,6
1746549483080,ETHN 127,A00,887248,Cuong; Marisol,11,0,15,4
1746549484105,ETHN 139,A00,887250,Staff,7,0,10,3
1746549485134,ETHN 142,A00,887252,Staff,10,0,30,20
1746549486159,ETHN 161,A00,887253,Browne; Errol Tsekani,24,0,30,6
1746549487184,ETHN 163FR,A00,887255,Burelle; Julie Sara Veronique,0,0,5,5
1746549488211,GLBH 20,A00,889149,Elwardani; Nile Regina,8,0,42,34
1746549490263,GLBH 111,A01,889152,Burgos; Jose L.,17,0,17,0
1746549491287,GLBH 150,A00,889181,Sloane; Julia Kathryn,0,5,15,15
1746549493337,HDS 60,A01,886406,Warstadt; Melissa Fawn,73,0,80,7
1746549494362,HIAF 111,A00,889324,Gyamfi; Bright,25,0,32,7
1746549495386,HIEA 131,A00,889328,Staff,16,0,32,16
1746549496414,HIEA 144,A00,889333,Henry; Todd A.,26,0,32,6
1746549497441,HIEA 154,A00,889336,Henry; Todd A.,24,0,32,8
1746549498465,HIEU 106,A00,889339,Staff,22,0,32,10
1746549500522,HIEU 114,A00,889340,Staff,3,0,32,29
1746549501546,HIEU 135GS,A00,889342,Patterson; Patrick H.,0,0,1,24
1746549502574,HIEU 137,A00,889343,Edington; Claire Ellen,9,0,25,16
1746549503597,HIEU 148,A00,889345,Staff,14,0,32,18
1746549504624,HIEU 154,A00,889346,Biess; Frank Peter,21,0,32,11
1746549505650,HILA 102,A00,889351,Staff,12,0,32,20
1746549506680,HILD 2A,A01,889221,Lewandoski; Julia Mavis,1,10,32,31
1746549507706,HILD 7B,A01,889225,Man; Simeon S,0,13,32,32
1746549508731,HILD 7C,A01,889288,Alvarez; Luis A,0,14,32,32
1746549509756,HILD 30,A01,889323,Staff,0,5,32,32
1746549511810,HISC 119,A00,889383,Golan; Tal,21,0,32,11
1746549512836,HIUS 103,A00,889384,Man; Simeon S,0,0,32,32
1746549513865,HIUS 117,A00,919797,Kwak; Nancy,18,0,32,14
1746549514890,HIUS 142A,A00,919788,Staff,22,0,32,10
1746549516941,HIUS 149,A00,889386,Gyamfi; Bright,27,0,32,5
1746549517968,HIUS 155,A00,889387,Alvarez; Luis A,14,0,32,18
1746549518997,HUM 3,A01,886499,Caldwell; Michael Alan,19,0,50,31
1746549520024,HUM 3GS,A00,886500,Rodriguez; Bretton Sigfred,0,0,0,28
1746549521055,HUM 3R,A01,886502,Markman; Kristina,0,36,50,50
1746549522085,HUM 4,A01,886504,Crum; Matthew Stephen,24,0,50,26
1746549522085,HUM 4,B01,886506,West; Geoffrey Scott,17,0,50,33
1746549523109,HUM 4GS,A00,886507,Staff,0,0,0,19
1746549524133,HUM 5,A01,886509,Staff,32,0,50,18
1746549525157,HUM 5R,A01,886511,Zavodny; Tatiana Sophia,0,39,50,50
1746549526187,JAPN 180,A00,886407,Staff,18,0,40,22
1746549527211,LATI 50,A01,886409,Martin-Cabrera; Luis,4,0,22,18
1746549527211,LATI 50,A02,886410,Martin-Cabrera; Luis,19,0,22,3
1746549527211,LATI 50,A03,886411,Martin-Cabrera; Luis,21,0,22,1
1746549527211,LATI 50,A04,886412,Martin-Cabrera; Luis,9,0,22,13
1746549528238,LAWS 101,A00,907664,Staff,28,0,60,32
1746549529265,LIAB 1A,A00,889388,Saab; Dima,17,0,20,3
1746549530289,LIAB 1AX,A00,889389,El Cheddadi; Youniss,17,0,20,3
1746549531315,LIFR 1C,A00,889391,Van Moer; Vinciane G,8,0,20,12
1746549532341,LIFR 1CX,A00,889392,Van Moer; Vinciane G,7,0,20,13
1746549533365,LIFR 1D,A00,889393,Van Moer; Vinciane G,7,0,20,13
1746549534392,LIFR 1DX,A00,889394,Van Moer; Vinciane G,8,0,20,12
1746549535418,LIGN 7,A00,886923,Staff,24,0,50,26
1746549536444,LIGN 17,A00,886924,Kehler; Andrew Scott,125,0,150,25
1746549537472,LTAM 110,A00,889395,Staff,15,0,30,15
1746549538500,LTAM 110GS,A00,958010,Rodriguez; Bretton Sigfred,0,0,0,28
1746549539529,LTCH 101,A00,889397,Staff,23,0,25,2
1746549540557,LTCS 130,A00,889398,Staff,23,0,25,2
1746549541584,LTEA 138,A00,889399,Staff,24,0,40,16
1746549542614,LTEN 149,A00,889400,Wesling; Megan E.,0,3,25,25
1746549543644,LTEN 169,A00,889401,Staff,20,0,25,5
1746549544668,LTEN 180,A00,889402,Staff,10,0,15,5
1746549545692,LTEN 181,A00,889403,Staff,21,0,25,4
1746549546719,LTWL 100,A00,889404,Myerston Santana; Jacobo,3,0,25,22
1746549547745,LTWL 180GS,A00,889405,Staff,0,0,20,20
1746549548773,LTWL 181,A00,889406,Staff,17,0,25,8
1746549549799,LTWL 184,A00,889475,Mukherjee; Silpa,22,0,25,3
1746549550826,LTWR 102C,A00,889486,Staff,29,0,30,1
1746549551853,LTWR 115W,A00,889491,Staff,0,2,15,15
1746549552878,MAE 8,A01,886905,Staff,0,2,0,0
1746549553903,MAE 11,A00,886906,Bandaru; Prabhakar,0,7,50,50
1746549554930,MAE 20,A00,886907,Evdokimenko; Ekaterina,44,0,70,26
1746549555956,MAE 30B,A00,886909,Ghazinejad; Maziar,26,0,45,19
1746549556984,MAE 101B,A00,886910,Saintillan; David,29,0,45,16
1746549558012,MAE 105,A00,886911,Bandaru; Prabhakar,18,0,50,32
1746549559037,MAE 107,B00,958024,Staff,8,0,50,42
1746549560064,MAE 143B,A00,886913,Bewley; Thomas R,7,0,40,33
1746549561093,MAE 148,A01,886915,Silberman; Jack,0,3,14,14
1746549562118,MAE 160,A00,886916,Evdokimenko; Ekaterina,31,0,60,29
1746549563142,MATH 3C,A01,889681,Staff,0,3,30,30
1746549563142,MATH 3C,A02,960048,Staff,25,0,30,5
1746549564166,MATH 10A,A01,889760,Staff,26,0,30,4
1746549564166,MATH 10A,A02,889783,Staff,29,0,30,1
1746549565192,MATH 10B,A01,889785,Verstraete; Jacques Allan,2,0,35,33
1746549565192,MATH 10B,A02,889795,Verstraete; Jacques Allan,4,0,35,31
1746549565192,MATH 10B,B01,889797,Verstraete; Jacques Allan,3,0,35,32
1746549565192,MATH 10B,B02,889828,Verstraete; Jacques Allan,3,0,35,32
1746549566219,MATH 10C,A01,889849,Habib; Yousaf,9,0,30,21
1746549566219,MATH 10C,A02,889852,Habib; Yousaf,14,0,30,16
1746549566219,MATH 10C,A03,889853,Habib; Yousaf,22,0,30,8
1746549566219,MATH 10C,A04,889858,Habib; Yousaf,20,0,30,10
1746549566219,MATH 10C,B01,889861,Staff,1,0,30,29
1746549566219,MATH 10C,B02,889862,Staff,24,0,30,6
1746549566219,MATH 10C,B03,889863,Staff,27,0,30,3
1746549566219,MATH 10C,B04,889967,Staff,23,0,30,7
1746549567244,MATH 18,A01,889974,Staff,7,0,30,23
1746549567244,MATH 18,A02,889977,Staff,20,0,30,10
1746549567244,MATH 18,B01,889984,Hardiman; Liam,22,0,30,8
1746549567244,MATH 18,B02,889985,Hardiman; Liam,25,0,30,5
1746549568272,MATH 20A,A01,889990,Suk; Andrew Hoon,29,0,35,6
1746549569298,MATH 20B,A01,889993,Ohm; Ko Woon,22,0,30,8
1746549569298,MATH 20B,A02,889994,Ohm; Ko Woon,30,0,30,0
1746549569298,MATH 20B,B01,889996,Ohm; Ko Woon,21,0,30,9
1746549569298,MATH 20B,B02,889997,Ohm; Ko Woon,23,0,30,7
1746549570324,MATH 20C,A01,889999,Hammock; Frances H,17,0,30,13
1746549570324,MATH 20C,A02,890003,Hammock; Frances H,23,0,30,7
1746549570324,MATH 20C,B01,890006,Hammock; Frances H,3,0,30,27
1746549570324,MATH 20C,B02,890007,Hammock; Frances H,11,0,30,19
1746549571353,MATH 20D,A01,890011,Cheng; Hsiao-Bing,1,1,30,29
1746549571353,MATH 20D,A02,890012,Cheng; Hsiao-Bing,14,0,30,16
1746549571353,MATH 20D,B01,890016,Cheng; Hsiao-Bing,13,0,30,17
1746549571353,MATH 20D,B02,890017,Cheng; Hsiao-Bing,13,0,30,17
1746549572382,MATH 20E,A01,890026,Harel; Guershon,1,0,30,29
1746549572382,MATH 20E,A02,890029,Harel; Guershon,23,0,30,7
1746549572382,MATH 20E,B01,890033,Harel; Guershon,7,0,30,23
1746549572382,MATH 20E,B02,890101,Harel; Guershon,21,0,30,9
1746549573408,MATH 102,A01,890104,Staff,17,0,30,13
1746549573408,MATH 102,A02,890105,Staff,27,0,30,3
1746549574433,MATH 103B,A01,890116,Salehi Golsefidy; Alireza,3,0,30,27
1746549574433,MATH 103B,B01,890118,Staff,0,3,34,34
1746549575463,MATH 109,A01,890121,Aliabadi Sr.; Mohsen,1,0,30,29
1746549575463,MATH 109,B01,890124,Upadrashta; Pranav Kumar,18,0,30,12
1746549576487,MATH 120A,A01,890126,Eggers; John Dietrich,13,0,30,17
1746549577516,MATH 142B,A01,890128,Ioana; Adrian,19,0,30,11
1746549577516,MATH 142B,A02,890129,Ioana; Adrian,13,0,30,17
1746549578544,MATH 154,A01,890174,Staff,0,0,30,30
1746549578544,MATH 154,A02,890182,Staff,0,0,30,30
1746549579569,MATH 168A,A01,890197,Dumitriu; Ioana,21,0,35,14
1746549580595,MATH 170A,A01,890240,Nie; Jiawang,1,0,30,29
1746549580595,MATH 170A,A02,890241,Nie; Jiawang,11,0,30,19
1746549580595,MATH 170A,A03,890249,Nie; Jiawang,23,0,30,7
1746549581621,MATH 170B,A01,957891,Nag; Panchali,13,0,35,22
1746549583675,MATH 181A,A01,908025,Staff,0,4,35,35
1746549583675,MATH 181A,A02,960115,Staff,27,0,35,8
1746549584702,MATH 181B,A01,959874,Staff,26,0,30,4
1746549585728,MATH 193B,A01,890265,Staff,0,4,35,35
1746549586757,MGT 4,A01,890311,Anderson; John Charles,42,0,88,46
1746549587784,MGT 5,A00,907740,Staff,13,0,98,85
1746549588810,MGT 12,A00,890312,Lindenberger; Wade Douglas,67,0,98,31
1746549589836,MGT 16,A00,957883,Staff,78,0,98,20
1746549591889,MGT 45,A00,890314,Pecore; Joseph P.,47,0,98,51
1746549592913,MGT 71,A00,890315,Staff,0,11,98,98
1746549593941,MGT 100,A00,890316,Yavorsky; Daniel Ryan,44,0,98,54
1746549594967,MGT 103,A00,890317,Ehrich; Kristine R,73,0,98,25
1746549595997,MGT 105,A00,890356,Bates; Kenneth Walter,0,7,98,98
1746549597024,MGT 112,A00,890360,Ehrich; Kristine R,55,0,98,43
1746549598051,MGT 127R,A00,907732,Zhu; Kevin Xiaoguo,23,0,98,75
1746549599077,MGT 131B,A00,890361,Anderson; John Charles,61,0,98,37
1746549600103,MGT 137,A00,890362,Lindenberger; Wade Douglas,65,0,98,33
1746549601130,MGT 160,A00,890369,Johnson; Erik Barry,9,0,98,89
1746549603202,MGT 164,A00,890372,Zimmermann; Carsten,0,39,98,98
1746549604226,MGT 180,A00,890374,Bliss; Barbara Ann,12,0,98,86
1746549605252,MMW 15,A01,886414,Chang; Edmond Yi-Teh,0,12,28,28
1746549605252,MMW 15,A02,886415,Chang; Edmond Yi-Teh,0,8,28,28
1746549605252,MMW 15,A03,886416,Chang; Edmond Yi-Teh,0,8,28,28
1746549605252,MMW 15,A04,886417,Chang; Edmond Yi-Teh,0,8,28,28
1746549605252,MMW 15,B01,886419,Chang; Edmond Yi-Teh,0,7,28,28
1746549605252,MMW 15,B02,886420,Chang; Edmond Yi-Teh,0,8,28,28
1746549605252,MMW 15,B03,886421,Chang; Edmond Yi-Teh,0,7,28,28
1746549605252,MMW 15,B04,886422,Chang; Edmond Yi-Teh,0,8,28,28
1746549605252,MMW 15,C01,886424,Staff,0,9,28,28
1746549605252,MMW 15,C02,886425,Staff,0,8,28,28
1746549605252,MMW 15,C03,886426,Staff,0,8,28,28
1746549605252,MMW 15,C04,886427,Staff,0,7,28,28
1746549605252,MMW 15,C05,958038,Staff,0,7,28,28
1746549605252,MMW 15,C06,958039,Staff,0,8,28,28
1746549606279,MMW 15GS,A00,906910,Patterson; Patrick H.,4,0,28,24
1746549607304,MMW 122R,A01,886429,Rahimi; Babak,0,13,28,28
1746549607304,MMW 122R,A02,886430,Rahimi; Babak,0,12,28,28
1746549607304,MMW 122R,A03,958040,Rahimi; Babak,0,11,28,28
1746549608335,MUS 1A,A01,890937,Staff,3,0,25,22
1746549608335,MUS 1A,A02,891035,Staff,6,0,25,19
1746549608335,MUS 1A,C01,958912,Staff,24,0,25,1
1746549608335,MUS 1A,C02,958913,Staff,25,0,25,0
1746549610386,MUS 2AK,A00,957092,Ohnishi; Takae,15,0,15,0
1746549611411,MUS 4,A01,891044,Staff,2,0,25,23
1746549611411,MUS 4,A02,891045,Staff,23,0,25,2
1746549611411,MUS 4,B01,891048,Staff,17,0,25,8
1746549611411,MUS 4,B02,891050,Staff,25,0,25,0
1746549612438,MUS 5,A01,957506,Dubnov; Shlomo,0,0,25,25
1746549612438,MUS 5,A02,957622,Dubnov; Shlomo,14,0,25,11
1746549612438,MUS 5,A03,957623,Dubnov; Shlomo,20,0,25,5
1746549613466,MUS 6,A01,891053,Freitas Caetano; Marcelo,24,0,25,1
1746549613466,MUS 6,A02,891054,Freitas Caetano; Marcelo,23,0,25,2
1746549614493,MUS 7,A01,891081,Staff,0,0,25,25
1746549614493,MUS 7,A02,891082,Staff,4,0,25,21
1746549615519,MUS 8GS,A00,891118,Borgo; David Garcia,0,0,25,25
1746549616545,MUS 11,A01,891140,Staff,11,0,25,14
1746549616545,MUS 11,A02,891141,Staff,22,0,25,3
1746549617570,MUS 13,A01,891143,Staff,8,0,25,17
1746549617570,MUS 13,A02,891144,Staff,24,0,25,1
1746549618599,MUS 15,A01,891146,Staff,9,0,25,16
1746549618599,MUS 15,A02,891148,Staff,21,0,25,4
1746549618599,MUS 15,B01,891150,Staff,18,0,25,7
1746549618599,MUS 15,B02,891151,Staff,25,0,25,0
1746549619624,MUS 20,A01,891153,Staff,5,0,20,15
1746549619624,MUS 20,A02,891155,Staff,14,0,20,6
1746549620651,MUS 80,A00,891156,Staff,19,0,25,6
1746549620651,MUS 80,B00,891157,Staff,23,0,25,2
1746549621678,MUS 130,A00,891158,Ohnishi; Takae,35,0,35,0
1746549622705,MUS 150GS,A01,891160,Borgo; David Garcia,0,0,25,25
1746549623735,MUS 170,A01,891162,Freitas Caetano; Marcelo,20,0,25,5
1746549623735,MUS 170,A02,891164,Freitas Caetano; Marcelo,21,0,25,4
1746549624766,NANO 11,A00,886220,Vazquez Mena; Oscar,13,0,15,2
1746549625794,NANO 15,A01,886222,Drews; Aaron,4,0,7,3
1746549626818,NANO 104,A00,886224,Sirbuly; Donald,18,0,25,7
1746549627847,PH 40,A00,886528,Staff,23,0,40,17
1746549628873,PH 45,A01,886799,Staff,35,0,40,5
1746549629904,PH 110,A00,886802,Staff,0,7,40,40
1746549630929,PH 172,A00,906716,Staff,19,0,35,16
1746549631956,PH 191,A00,886803,Staff,6,0,40,34
1746549632983,PHIL 1,A00,889500,Staff,19,0,30,11
1746549634008,PHIL 10,A01,889549,Grush; Rick Scott,15,0,22,7
1746549634008,PHIL 10,A02,889551,Grush; Rick Scott,22,0,22,0
1746549635088,PHIL 28,A01,889559,Lamey; Andy M.,0,1,31,31
1746549635088,PHIL 28,A02,889561,Lamey; Andy M.,0,1,30,30
1746549635088,PHIL 28,A03,889572,Lamey; Andy M.,0,0,30,30
1746549636114,PHIL 35,A00,907839,Staff,13,0,15,2
1746549637138,PHIL 60,A00,889574,Staff,74,0,90,16
1746549638166,PHIL 101,A00,958004,Staff,13,0,15,2
1746549640223,PHIL 136,A00,889582,Fulkerson; Matthew Todd,26,0,45,19
1746549641250,PHIL 163,A01,889601,Staff,21,0,30,9
1746549641250,PHIL 163,B01,889606,Brandt; Reuven A,0,3,0,0
1746549642275,PHIL 164,A00,889610,Staff,16,0,30,14
1746549643302,PHIL 165,A00,889613,Staff,23,0,30,7
1746549644330,PHYS 1A,A00,886431,Staff,26,0,70,44
1746549645354,PHYS 1AL,001,886432,Tsai; Philbert S,0,2,30,30
1746549645354,PHYS 1AL,002,886436,Tsai; Philbert S,11,0,30,19
1746549646380,PHYS 1B,A00,886439,Staff,185,0,240,55
1746549647405,PHYS 1BL,001,886441,Tsai; Philbert S,0,4,30,30
1746549647405,PHYS 1BL,002,886444,Tsai; Philbert S,2,0,30,28
1746549648434,PHYS 1C,A00,896092,Arnold; Kam S,78,0,146,68
1746549649459,PHYS 1CL,001,886448,Tsai; Philbert S,0,0,30,30
1746549649459,PHYS 1CL,002,886449,Tsai; Philbert S,0,0,30,30
1746549649459,PHYS 1CL,003,886450,Tsai; Philbert S,16,0,30,14
1746549649459,PHYS 1CL,004,886451,Tsai; Philbert S,15,0,30,15
1746549650488,PHYS 2B,A01,886457,Staff,69,0,115,46
1746549651514,PHYS 2C,A01,886460,Shotwell; Brian,0,8,65,65
1746549652540,PHYS 2CL,A01,886467,Staff,0,4,28,28
1746549652540,PHYS 2CL,A02,886468,Staff,0,3,28,28
1746549653569,PHYS 2D,A01,886470,Staff,10,0,50,40
1746549654597,PHYS 4B,A01,886475,Grinstein; Benjamin,22,0,40,18
1746549655625,POLI 5,A00,891173,Desposato; Scott,7,0,25,18
1746549656651,POLI 5D,A01,891175,Staff,5,0,5,0
1746549656651,POLI 5D,B01,891178,Staff,5,0,5,0
1746549657677,POLI 11,A00,891179,Ferree; Karen E,2,0,35,33
1746549658705,POLI 12,A00,891180,Staff,16,0,30,14
1746549659734,POLI 27,A01,891182,Staff,12,0,75,63
1746549660760,POLI 30,A00,891183,Staff,8,0,50,42
1746549661784,POLI 100B,A00,891244,Staff,5,1,35,30
1746549662809,POLI 100I,A00,891247,Staff,7,0,30,23
1746549663834,POLI 104J,A00,891248,Nichter; Maysa,14,0,30,16
1746549664863,POLI 104U,A00,891250,Nichter; Maysa,2,0,30,28
1746549666915,POLI 110B,A00,891255,Wiens; David,20,0,25,5
1746549667941,POLI 112A,A00,891256,Wiens; David,6,0,25,19
1746549668967,POLI 114BR,A00,891261,Staff,19,0,30,11
1746549669991,POLI 117R,A00,891262,Forman; Fonna,0,6,50,50
1746549671016,POLI 118,A00,891264,Ingham; Sean,17,0,25,8
1746549672043,POLI 124A,A00,891265,Staff,18,0,20,2
1746549673069,POLI 125D,A00,891266,Nichter; Simeon C,2,0,25,23
1746549674110,POLI 126,A00,891268,Nichter; Simeon C,7,0,25,18
1746549675139,POLI 126AA,A00,891272,Staff,17,0,25,8
1746549676163,POLI 130AA,A00,891273,Staff,15,0,20,5
1746549677189,POLI 134AA,A00,891274,Staff,4,0,20,16
1746549679238,POLI 138,A00,891278,Staff,21,0,25,4
1746549680264,POLI 142K,A00,891280,Staff,11,0,25,14
1746549681290,POLI 142M,A00,891281,Gartzke; Erik,17,0,30,13
1746549682315,POLI 142P,A00,891284,Staff,20,0,30,10
1746549683345,POLI 143,A00,891285,Gartzke; Erik,12,0,30,18
1746549684371,POLI 153,A00,891286,Staff,19,0,20,1
1746549686420,POLI 175,A00,891290,Staff,15,0,20,5
1746549687449,PSYC 1,A00,890674,Steiner; Eric Tomas,0,11,45,45
1746549688479,PSYC 2,A00,890676,Albright; Thomas D,21,0,35,14
1746549689507,PSYC 3,A00,890679,Staff,17,0,20,3
1746549690533,PSYC 6,A00,959858,Staff,20,0,20,0
1746549691562,PSYC 60,A01,890684,Rickard; Timothy C.,0,5,45,45
1746549692586,PSYC 70,A01,890689,Geller; Emma Harlan,7,0,30,23
1746549693613,PSYC 71,A01,959860,Staff,21,0,25,4
1746549694637,PSYC 100,A00,890690,Lacefield; Katharine I,0,50,180,180
1746549695664,PSYC 102,A00,890695,Staff,18,0,40,22
1746549696693,PSYC 105,A00,890699,Geller; Emma Harlan,71,0,100,29
1746549697722,PSYC 106,A00,890701,Gorman; Michael R.,5,0,30,25
1746549698748,PSYC 108,A00,890704,Adrian; Julia Anna,0,28,50,50
1746549699777,PSYC 118,A01,890712,Staff,11,0,30,19
1746549700802,PSYC 124,A00,890716,Chapman; Eddie Nathaniel,25,0,60,35
1746549701829,PSYC 131,A00,890717,Anagnostaras; Stephan,0,7,80,80
1746549702856,PSYC 137,A00,890719,Winkielman; Piotr,0,11,30,30
1746549703884,PSYC 144,A00,890721,Adrian; Julia Anna,0,9,45,45
1746549704919,PSYC 162,A00,890805,Staff,2,0,75,73
1746549705944,PSYC 169,A00,890810,Staff,0,15,30,30
1746549706974,PSYC 172,A00,890814,Gorman; Michael R.,9,0,30,21
1746549708003,PSYC 181,A00,890818,Anagnostaras; Stephan,8,0,200,192
1746549709029,PSYC 184,A00,959861,Staff,170,0,175,5
1746549710054,PSYC 189,A00,890823,Staff,0,1,30,30
1746549711079,PSYC 191,A00,890884,Rickard; Timothy C.,0,11,35,35
1746549712104,PSYC 193,A00,890913,Staff,19,0,30,11
1746549712104,PSYC 193,B00,890914,Chapman; Eddie Nathaniel,24,0,30,6
1746549713131,PSYC 193L,A01,890918,Lowe; Angela Beth,20,0,30,10
1746549713131,PSYC 193L,B01,890921,Hurwitz; Ethan Scott,20,0,30,10
1746549713131,PSYC 193L,C01,890928,Staff,30,0,30,0
1746549714156,RELI 149,A00,886806,Rahimi; Babak,23,0,40,17
1746549715182,SE 9,A01,886814,Staff,7,0,20,13
1746549716210,SE 101B,A01,886816,Chadha; Mayank,4,0,35,31
1746549717237,SE 110B,A00,886818,Zhu; Qiang,4,0,75,71
1746549718262,SE 125,A01,886830,Staff,10,0,30,20
1746549719290,SE 130B,A01,886835,Staff,14,0,40,26
1746549720316,SE 131A,A01,886838,Krysl; Petr,34,0,55,21
1746549721344,SE 154,A00,886840,Staff,30,0,50,20
1746549722369,SE 164GS,A01,886849,Staff,6,0,20,14
1746549723393,SE 167GS,A01,886853,Staff,6,0,20,14
1746549724419,SIO 25,A01,890107,Staff,19,0,30,11
1746549725446,SIO 45,A00,890109,Cook; Geoffrey W,117,0,200,83
1746549726470,SIO 109R,A00,890110,Forman; Fonna,0,16,20,20
1746549727496,SIO 187,A01,890114,Kacev; David,15,0,40,25
1746549728524,SOCI 1,A01,890431,Thorpe; Charles Robert,15,0,30,15
1746549728524,SOCI 1,A02,890518,Thorpe; Charles Robert,30,0,30,0
1746549729549,SOCI 2,A01,957978,Staff,25,0,25,0
1746549729549,SOCI 2,A02,957979,Staff,23,0,25,2
1746549730573,SOCI 20,A01,890523,Calderon-Zaks; Michael Aar,23,0,30,7
1746549730573,SOCI 20,A02,890526,Calderon-Zaks; Michael Aar,29,0,30,1
1746549731597,SOCI 30,A01,890533,Pardo Guerra; Juan Pablo,37,0,40,3
1746549732625,SOCI 40,A01,890535,Staff,27,0,45,18
1746549733650,SOCI 104Q,A00,890559,Staff,18,0,30,12
1746549734676,SOCI 106,A00,890560,Arnal; Maud Marie Leonie,20,0,30,10
1746549735705,SOCI 110,A00,890567,Holkenbrink-Monk; Charlene,19,0,30,11
1746549736731,SOCI 112,A00,890568,Victoria Torres; Pablo,1,0,55,54
1746549737759,SOCI 115,A00,890597,Arnal; Maud Marie Leonie,28,0,45,17
1746549739851,SOCI 121,A00,890604,Pardo Guerra; Juan Pablo,38,0,45,7
1746549740878,SOCI 126,A01,890608,Staff,8,0,10,2
1746549741903,SOCI 127,A00,890609,Staff,18,0,30,12
1746549742928,SOCI 131,A00,890610,Thorpe; Charles Robert,37,0,45,8
1746549743952,SOCI 135,A00,890615,Payne; Christine Anna,14,0,45,31
1746549744978,SOCI 139,A00,890620,Staff,38,0,45,7
1746549746003,SOCI 148E,A00,890622,Calderon-Zaks; Michael Aar,36,0,45,9
1746549747032,SOCI 150,A00,890623,Kohler; Kristopher M.,31,0,45,14
1746549748057,SOCI 157,A00,890625,Jules-Rosette; Bennetta W.,18,0,20,2
1746549749084,SOCI 160,A00,890627,Payne; Christine Anna,21,0,45,24
1746549750109,SYN 1,A00,886855,Fish; Gwendolyn Anne,0,0,0,0
1746549750109,SYN 1,B00,906086,Fish; Gwendolyn Anne,0,1,0,2
1746549751132,SYN 2R,A00,886860,Staff,0,17,15,15
1746549751132,SYN 2R,B00,906106,Atkinson; Arthur Laird,0,16,15,15
1746549752164,SYN 100,A01,886866,Browne; Emily,0,28,20,20
1746549752164,SYN 100,B01,906128,Rock; Martin,0,5,20,20
1746549752164,SYN 100,C01,906140,Deavenport; James Cary,0,3,20,20
1746549752164,SYN 100,D01,907816,Deavenport; James Cary,0,5,20,20
1746549753191,TDAC 1,A00,890286,Walsh; Kim C.,9,0,20,11
1746549754215,TDAC 101,A00,890296,Basso; Beatrice,16,0,20,4
1746549755240,TDDE 131,A00,890297,Staff,47,0,50,3
1746549756264,TDDM 1,A00,890287,Weinberg; Sadie,25,0,30,5
1746549757290,TDGE 11,A00,890288,Fulton; Julia,137,0,200,63
1746549757290,TDGE 11,B00,890289,Castro; Robert Jess,184,0,200,16
1746549758315,TDGE 25,B00,957359,Walsh; Kim C.,3,0,20,17
1746549759342,TDGE 40,A01,890292,Power; Jade Yukana,27,0,30,3
1746549760367,TDGE 124,A00,890298,Havis; Allan,0,1,50,50
1746549761393,TDGE 131R,A00,890299,Burelle; Julie Sara Veronique,15,0,42,27
1746549762419,TDHT 101,A00,890300,Staff,10,0,20,10
1746549763443,TDHT 109,A01,890302,Anderson; Mysia Anyse,31,0,40,9
1746549764468,TDMV 1,A00,890293,Arcidiacono; Kristin,18,0,30,12
1746549765492,TDMV 2,A00,890294,Weinberg; Sadie,23,0,30,7
1746549766521,TDMV 3,A00,957878,Arcidiacono; Kristin,28,0,30,2
1746549768573,TDMV 138,A00,890304,Jun; Grace Shin Hae,25,0,40,15
1746549769596,TDMV 140,A00,890305,Corrales; Joseph Bernales,25,0,30,5
1746549770622,TDMV 142,A00,890307,Caligagan; Tony,32,0,40,8
1746549771648,TDMV 144,A00,890308,Camaya; Michelle Ann,25,0,30,5
1746549772673,TDPW 1,A00,890295,Stein; Deborah Isobel,3,0,20,17
1746549773698,USP 2,A01,890272,Lerner; Amy M,6,0,20,14
1746549774726,USP 3,A01,890274,Staff,12,0,30,18
1746549775752,USP 15,A01,890276,Sun; Feiyang,17,0,30,13
1746549776776,USP 25,A00,890277,Shenkman; Michael Thomas,19,0,25,6
1746549777804,USP 138,A00,890278,Staff,13,0,25,12
1746549778833,USP 143,A00,890279,Staff,21,0,70,49
1746549779859,USP 144,A00,890280,Chowdhury; Muhammed Zohir,16,0,30,14
1746549780887,USP 150,A00,890281,Boomhower; Matthew Charles,4,0,30,26
1746549781916,USP 151,A00,890282,Staff,16,0,20,4
1746549782942,USP 162,A00,890283,Andrews; Abigail Leslie,16,0,20,4
1746549783968,USP 168,A00,920477,Kwak; Nancy,1,0,5,4
1746549785025,USP 181,A00,890284,Staff,3,0,20,17
1746549786051,USP 191A,A00,890285,Staff,13,0,20,7
1746549787077,VIS 101,A00,886512,Staff,25,0,75,50
1746549788105,VIS 103,A00,886513,Cruz; Edwin Teddy,61,0,75,14
1746549789128,VIS 108,A00,886514,Staff,3,0,15,12
1746549790155,VIS 127P,A00,886515,Shen; Kuiyi,80,0,146,66
1746549791179,VIS 149,A00,886516,Yoldas; Pinar,0,0,15,15
1746549792204,VIS 164,A00,886526,Erdmann; Dean,19,0,22,3
1746549793228,VIS 194S,A00,886527,Staff,61,0,75,14
1746549794254,WCWP 10A,C00,886484,Martiniuk; Jill,12,0,15,3
1746549795278,WCWP 10B,A00,886490,Uriarte; Emma,0,0,15,15
1746549795278,WCWP 10B,B00,886491,Dhir; Simrita,10,0,15,5
1746549795278,WCWP 10B,C00,886492,Ornelas; Tricia,0,0,15,15
1746549796302,WCWP 100,A00,886494,Young; Mark T,0,6,15,15
1746549798406,AAS 10,A01,886199,Childs; Dennis R.,0,3,0,0
1746549799432,ANAR 104,A01,886940,Shtienberg; Gilad,27,0,30,3
1746549800458,ANAR 120,A00,886953,Staff,12,0,20,8
1746549801486,ANBI 148,A01,886955,Wilder; Linnea Lorene,30,0,40,10
1746549803540,ANSC 122,A00,886957,Staff,25,0,30,5
1746549804569,ANSC 150,A00,886958,Sloane; Julia Kathryn,3,0,15,12
1746549805596,ANSC 156,A00,886959,Jenkins; Janis A.,0,1,15,15
1746549806624,ANSC 180,A00,886960,Staff,11,0,17,6
1746549807652,ANSC 188,A00,886961,Jassal; Aftab,9,0,25,16
1746549808676,ANSC 190,A00,886962,Jassal; Aftab,14,0,25,11
1746549809704,ANSC 191,A00,886963,Staff,18,0,20,2
1746549810729,ANTH 3,A01,891689,Staff,17,0,20,3
1746549811754,ANTH 5,A00,886933,Semendeferi; Ekaterini,16,0,20,4
1746549812781,ANTH 10,A00,886934,Staff,0,12,30,30
1746549813810,ANTH 21,A01,886936,Staff,40,0,60,20
1746549814834,ANTH 23,A01,886938,Staff,92,0,100,8
1746549815861,ANTH 105,A00,886964,Stewart; Alexander B,84,0,100,16
1746549816887,ANTH 108,A00,886965,Pedersen; David,9,0,20,11
1746549817916,AWP 10,001,886147,Staff,0,0,0,0
1746549817916,AWP 10,002,886148,Staff,0,0,0,0
1746549817916,AWP 10,003,886149,Staff,0,0,0,0
1746549817916,AWP 10,004,886150,Staff,0,0,0,0
1746549817916,AWP 10,005,886151,Staff,0,0,0,0
1746549817916,AWP 10,006,886152,Staff,0,0,0,0
1746549817916,AWP 10,007,886153,Staff,0,0,0,0
1746549817916,AWP 10,008,886154,Staff,0,0,0,0
1746549817916,AWP 10,009,886155,Staff,0,0,0,0
1746549817916,AWP 10,010,886156,Staff,0,0,0,0
1746549817916,AWP 10,011,886158,Staff,0,0,0,0
1746549817916,AWP 10,012,886160,Staff,0,0,0,0
1746549817916,AWP 10,013,886161,Staff,0,0,0,0
1746549817916,AWP 10,014,886162,Staff,0,0,0,0
1746549817916,AWP 10,015,886163,Staff,0,0,0,0
1746549817916,AWP 10,016,886164,Staff,0,0,0,0
1746549817916,AWP 10,017,886165,Staff,0,0,0,0
1746549817916,AWP 10,018,886166,Staff,0,0,0,0
1746549817916,AWP 10,019,886168,Staff,0,0,0,0
1746549817916,AWP 10,020,886170,Staff,0,0,0,0
1746549817916,AWP 10,021,886172,Staff,0,0,0,0
1746549818946,AWP 10R,001,886173,Staff,0,1,0,0
1746549818946,AWP 10R,002,886174,Staff,0,1,0,0
1746549818946,AWP 10R,003,886175,Staff,0,0,0,0
1746549818946,AWP 10R,004,886176,Staff,0,0,0,0
1746549818946,AWP 10R,005,886177,Staff,0,0,0,0
1746549818946,AWP 10R,006,886178,Staff,0,0,0,0
1746549818946,AWP 10R,007,886179,Staff,0,0,0,0
1746549818946,AWP 10R,008,886181,Staff,0,0,0,0
1746549818946,AWP 10R,009,886182,Staff,0,0,0,0
1746549818946,AWP 10R,010,886183,Staff,0,0,0,0
1746549818946,AWP 10R,011,886184,Staff,0,0,0,0
1746549818946,AWP 10R,012,886185,Staff,0,0,0,0
1746549818946,AWP 10R,013,886186,Staff,0,0,0,0
1746549818946,AWP 10R,014,886187,Staff,0,0,0,0
1746549818946,AWP 10R,015,886188,Staff,0,0,0,0
1746549818946,AWP 10R,016,886189,Staff,0,0,0,0
1746549819972,AWP 102R,A00,886190,Staff,0,0,0,0
1746549819972,AWP 102R,B00,886191,Staff,0,0,0,0
1746549820998,BENG 100,A01,886193,Staff,17,0,30,13
1746549822024,BENG 122A,A01,886195,Hasty; Jeff M,13,0,30,17
1746549823052,BENG 166A,A00,886196,Sah; Robert Lie-Yuan,0,1,30,30
1746549824081,BENG 190,A00,958050,Khojah; Reem I,24,0,25,1
1746549825106,BIBC 102,A01,894320,Staff,0,0,46,46
1746549825106,BIBC 102,A02,894321,Staff,0,0,46,46
1746549825106,BIBC 102,A03,894344,Staff,7,0,46,39
1746549825106,BIBC 102,A04,894345,Staff,26,0,47,21
1746549826133,BICD 100R,A01,894365,Smith; Laurie,0,3,58,58
1746549826133,BICD 100R,A02,894366,Smith; Laurie,0,5,58,58
1746549826133,BICD 100R,A03,894367,Smith; Laurie,2,0,59,57
1746549826133,BICD 100R,A04,959869,Smith; Laurie,41,0,59,18
1746549827159,BICD 136,A01,894383,Gustafson-Brown; Cindy,14,0,50,36
1746549828187,BIEB 102,A01,894494,Butler; Shannon Rhey,51,0,130,79
1746549830239,BIEB 150,A01,894617,Wills; Christopher,3,0,20,17
1746549830239,BIEB 150,A02,894631,Wills; Christopher,3,0,20,17
1746549830239,BIEB 150,A03,894937,Wills; Christopher,3,0,20,17
1746549830239,BIEB 150,A04,894946,Wills; Christopher,5,0,20,15
1746549831264,BIEB 194,A00,906141,Kurle; Carolyn M.,6,0,20,14
1746549832293,BILD 1,A01,894154,Staff,2,0,19,17
1746549832293,BILD 1,A02,894155,Staff,14,0,19,5
1746549832293,BILD 1,A03,894160,Staff,13,0,19,6
1746549832293,BILD 1,A04,894161,Staff,15,0,18,3
1746549833320,BILD 2,A01,894168,Staff,0,0,50,50
1746549833320,BILD 2,A02,894169,Staff,0,0,50,50
1746549833320,BILD 2,A03,894179,Staff,4,0,50,46
1746549833320,BILD 2,A04,894203,Staff,27,0,50,23
1746549834347,BILD 3,A01,894213,Staff,22,0,31,9
1746549834347,BILD 3,A02,894214,Staff,26,0,31,5
1746549834347,BILD 3,A03,894235,Staff,28,0,31,3
1746549834347,BILD 3,A04,894236,Staff,28,0,32,4
1746549835375,BILD 4,A01,894253,Reuther; Keefe,5,0,24,19
1746549835375,BILD 4,A02,894258,Reuther; Keefe,16,0,24,8
1746549836401,BILD 5,A01,894276,Reuther; Keefe,35,0,50,15
1746549836401,BILD 5,A02,894277,Reuther; Keefe,45,0,50,5
1746549836401,BILD 5,A03,894290,Reuther; Keefe,44,0,50,6
1746549836401,BILD 5,A04,894291,Reuther; Keefe,48,0,50,2
1746549837429,BILD 24,A01,894297,Pirino; Giorgia,40,0,60,20
1746549838456,BIMM 100,B01,958915,Staff,72,0,100,28
1746549839485,BIMM 101,A01,895017,McDonnell; Lisa Marie,0,5,24,24
1746549839485,BIMM 101,A02,895018,McDonnell; Lisa Marie,0,5,24,24
1746549839485,BIMM 101,B01,895020,McDonnell; Lisa Marie,0,6,24,24
1746549839485,BIMM 101,B02,895021,McDonnell; Lisa Marie,0,4,24,24
1746549840516,BIMM 110,A01,895023,Staff,1,0,25,24
1746549840516,BIMM 110,A02,895024,Staff,9,0,25,16
1746549840516,BIMM 110,A03,895025,Staff,18,0,25,7
1746549840516,BIMM 110,A04,895031,Staff,20,0,25,5
1746549841541,BIMM 120,A01,895114,Gustafson-Brown; Cindy,13,0,28,15
1746549841541,BIMM 120,A02,895126,Gustafson-Brown; Cindy,21,0,27,6
1746549842609,BIPN 100,A01,895130,Yang; Mingyu,1,0,38,37
1746549842609,BIPN 100,A02,895131,Yang; Mingyu,32,0,38,6
1746549842609,BIPN 100,A03,895132,Yang; Mingyu,32,0,38,6
1746549842609,BIPN 100,A04,895133,Yang; Mingyu,27,0,36,9
1746549843633,BIPN 120,A01,895135,Cooke; James Edward,0,3,13,13
1746549843633,BIPN 120,A02,895136,Cooke; James Edward,0,1,13,13
1746549843633,BIPN 120,A03,895137,Cooke; James Edward,0,3,13,13
1746549843633,BIPN 120,A04,895156,Cooke; James Edward,0,2,11,11
1746549844662,BIPN 134,A01,895235,Cooke; James Edward,0,2,25,25
1746549844662,BIPN 134,A02,895237,Cooke; James Edward,0,0,25,25
1746549844662,BIPN 134,A03,895240,Cooke; James Edward,3,0,25,22
1746549844662,BIPN 134,A04,895270,Cooke; James Edward,20,0,25,5
1746549845687,BIPN 189,A00,892103,Staff,0,13,14,14
1746549847740,BISP 194,A00,958008,Staff,0,2,0,0
1746549848768,CAT 124,A01,922009,Staff,0,5,20,20
1746549849799,CAT 125R,A00,886390,Morales; Celeste Georgianna,0,2,20,20
1746549849799,CAT 125R,B00,886391,Irwin; Matthew Joseph,0,3,20,20
1746549849799,CAT 125R,C00,886392,Smith; Lauryn Alissa,0,2,20,20
1746549849799,CAT 125R,D00,886393,Vanderschuit; Maya Alysia,0,2,20,20
1746549849799,CAT 125R,E00,886394,Marchisotto; Jennifer Anne,0,4,20,20
1746549850826,CENG 15,A01,886218,Drews; Aaron,3,0,8,5
1746549851851,CENG 113,A00,886219,Opatkiewicz; Justin Paul,15,0,25,10
1746549852878,CGS 101,A00,887044,Staff,7,0,20,13
1746549853906,CGS 105,A01,887046,Staff,14,0,25,11
1746549854934,CGS 112,A00,887047,Cuong; Marisol,12,0,15,3
1746549855963,CGS 113,A00,887048,Staff,23,0,30,7
1746549856987,CGS 120,A00,887049,Staff,10,0,17,7
1746549858017,CHEM 6A,A01,886336,Lam; Tin Yiu,38,0,50,12
1746549858017,CHEM 6A,A02,886338,Lam; Tin Yiu,37,0,50,13
1746549859042,CHEM 6B,A01,886341,Hopkins; Patrycja Anna,16,0,50,34
1746549859042,CHEM 6B,A02,886343,Hopkins; Patrycja Anna,42,0,50,8
1746549860067,CHEM 6C,A01,886346,Albizati; Kim F.,0,2,50,50
1746549860067,CHEM 6C,A02,886348,Albizati; Kim F.,23,0,50,27
1746549861092,CHEM 40A,A01,886352,Klosterman; Jeremy K,65,0,100,35
1746549862118,CHEM 40B,A01,886356,Klosterman; Jeremy K,0,23,100,100
1746549863146,CHEM 41B,A01,886360,Theodorakis; Emmanuel,25,0,50,25
1746549863146,CHEM 41B,A02,886362,Theodorakis; Emmanuel,47,0,50,3
1746549864174,CHIN 165A,A00,886382,Xu; Li,18,0,20,2
1746549865203,CLAS 120,A00,886387,Myerston Santana; Jacobo,33,0,40,7
1746549866231,COGS 9,A01,886967,Shannon; Kyle Michael,42,0,60,18
1746549867260,COGS 11,A01,886969,Staff,11,0,30,19
1746549868285,COGS 14A,A01,886971,Staff,6,0,60,54
1746549869313,COGS 14B,A01,886973,Hoffman; Drew Ellen,4,0,60,56
1746549870337,COGS 18,A01,886975,Morgan; Eric,35,0,60,25
1746549871362,COGS 20,A01,886977,Staff,4,0,8,4
1746549871362,COGS 20,A02,886978,Staff,5,0,7,2
1746549872399,COGS 100,A01,907783,Staff,0,2,30,30
1746549873427,COGS 101B,A01,886980,Staff,0,3,48,48
1746549874451,COGS 101C,A01,886982,Delgado; Tania,0,5,44,44
1746549875480,COGS 102A,A01,886984,Johnson; Christine M.,4,0,30,26
1746549876511,COGS 118B,A01,886986,Staff,0,3,88,88
1746549877536,COGS 150,A01,886988,Bergen; Benjamin,23,0,50,27
1746549878564,COGS 153,A00,886989,Delgado; Tania,0,2,41,41
1746549879589,COGS 186,A01,886991,Staff,0,0,32,32
1746549880617,COGS 187A,A01,886993,Boyle; Mary E. T.,7,0,30,23
1746549881643,COGS 189,A00,886994,Staff,0,1,30,30
1746549882671,COMM 10,A01,886996,Staff,0,0,20,21
1746549882671,COMM 10,A02,886997,Staff,12,0,20,8
1746549882671,COMM 10,A03,959845,Staff,19,0,20,1
1746549883699,COMM 20,A01,886999,Leuning; Grant Maurstad,24,0,40,16
1746549885754,COMM 100A,A01,887002,Staff,0,0,20,25
1746549885754,COMM 100A,A02,887003,Staff,7,0,20,13
1746549886780,COMM 100B,A01,887005,Staff,0,8,20,24
1746549887807,COMM 106D,A00,887006,Staff,14,0,40,26
1746549888833,COMM 110G,A00,887007,Whitworth-Smith; Andrew C,12,0,40,28
1746549889858,COMM 111B,A00,887008,Staff,31,0,40,9
1746549890888,COMM 113T,A00,887009,Abuelhiga; Soraya Jill,28,0,40,12
1746549890888,COMM 113T,B00,906733,Staff,40,0,40,0
1746549891912,COMM 145,A00,887010,Staff,12,0,40,28
1746549892940,COMM 146,A00,887054,Staff,31,0,40,9
1746549893964,COMM 190,A00,887012,Staff,8,0,23,15
1746549894991,CSE 8A,A50,887015,Cao; Yingjun,57,0,85,28
1746549896019,CSE 11,A01,887017,Cao; Yingjun,12,0,70,58
1746549897046,CSE 20,A01,887019,Staff,30,0,50,20
1746549898071,CSE 21,A01,887021,Staff,78,0,100,22
1746549898071,CSE 21,B01,892583,Braun; Oliver,45,0,50,5
1746549899096,CSE 30,A01,887025,Eldon; John,143,0,200,57
1746549900126,CSE 100,A01,887027,Staff,26,0,50,24
1746549900126,CSE 100,A02,887028,Staff,40,0,50,10
1746549901156,CSE 101,A01,887030,Braun; Oliver,75,0,100,25
1746549901156,CSE 101,B01,887032,Jones; Miles E,0,3,50,50
1746549901156,CSE 101,B02,887033,Jones; Miles E,0,1,50,50
1746549902180,CSE 105,A01,908084,Jones; Miles E,32,0,50,18
1746549902180,CSE 105,A02,908087,Jones; Miles E,33,0,50,17
1746549903205,CSE 135,A01,887035,Powell; Thomas Allan,0,4,50,50
1746549904235,CSE 142,A01,887037,Staff,8,0,60,52
1746549905261,CSE 142L,A01,887039,Staff,34,0,60,26
1746549906291,CSE 151A,A01,887041,Solares; Edwin A,47,0,100,53
1746549907316,CSE 175,A01,887043,Kumar; Rakesh,30,0,30,0
1746549908342,CSS 1,A01,886389,Staff,0,1,40,40
1746549909368,DSC 30,A01,908097,Liao; Soohyun Nam,47,0,75,28
1746549910393,DSC 40A,A01,908099,Shannon; Kyle Michael,30,0,50,20
1746549911420,DSC 40B,A01,908112,Staff,16,0,50,34
1746549912445,DSC 80,A01,908116,Staff,19,0,60,41
1746549913471,DSC 197,001,956863,Eldridge; Justin Matthew,9999,0,9999,0
1746549914500,ECE 5,A01,886400,Morris; Karcher William,2,0,6,4
1746549914500,ECE 5,A02,886401,Morris; Karcher William,3,0,6,3
1746549915525,ECE 148,A01,886403,Silberman; Jack,0,14,14,14
1746549916550,ECON 1,A01,887265,Crane; Meredith Helen,12,0,70,58
1746549916550,ECON 1,B01,887268,Staff,43,0,50,7
1746549917602,ECON 2,A01,887273,Crane; Meredith Helen,56,0,70,14
1746549918625,ECON 3,A01,887279,Rondina; Giacomo,32,0,70,38
1746549919651,ECON 4,A01,887282,Anderson; John Charles,0,2,10,10
1746549920677,ECON 5,A01,887285,Staff,33,0,45,12
1746549920677,ECON 5,B01,887292,Staff,41,0,45,4
1746549921704,ECON 100A,A01,887337,Newhouse; Herbert S,54,0,70,16
1746549921704,ECON 100A,B01,887349,Staff,45,0,50,5
1746549922729,ECON 100B,A01,887361,Du; Songzi,29,0,70,41
1746549923755,ECON 100C,A01,887445,Newhouse; Herbert S,59,0,70,11
1746549924780,ECON 105,A00,887488,Vespa; Emanuel Ignacio,23,0,35,12
1746549925806,ECON 109,A01,887506,Shishkin; Denis,28,0,35,7
1746549926834,ECON 110A,A01,887568,Alon; Titan Michael,0,3,35,35
1746549926834,ECON 110A,B01,907601,Alon; Titan Michael,20,0,35,15
1746549927859,ECON 110B,A01,887598,Levkoff; Steven B.,0,23,70,70
1746549928884,ECON 112,A00,887599,Rondina; Giacomo,19,0,35,16
1746549929913,ECON 120A,A01,887603,Dai; Yinlin,36,0,70,34
1746549930939,ECON 120C,A01,887608,Sun; Yixiao,0,1,35,35
1746549930939,ECON 120C,B01,887614,Sun; Yixiao,0,0,35,35
1746549931967,ECON 138,A00,887621,Bharadwaj; Prashant,0,20,20,20
1746549932995,ECON 144,A00,958007,Squires; Dale E,13,0,35,22
1746549934024,ECON 171,A01,907666,Staff,18,0,35,17
1746549935052,ECON 175,A00,887626,Wu; Pak Yeung,23,0,35,12
1746549936077,ECON 190,A00,887640,Vespa; Emanuel Ignacio,23,0,35,12
1746549937110,EDS 25,A01,888197,Staff,0,0,0,0
1746549937110,EDS 25,A02,888209,Staff,0,0,0,0
1746549937110,EDS 25,A03,888210,Staff,0,0,0,0
1746549937110,EDS 25,A04,888212,Staff,0,0,0,0
1746549937110,EDS 25,A05,888213,Staff,0,0,0,0
1746549937110,EDS 25,A06,888214,Staff,0,0,0,0
1746549937110,EDS 25,A07,888235,Staff,0,2,0,0
1746549937110,EDS 25,A08,888236,Staff,0,0,0,0
1746549937110,EDS 25,A09,888240,Staff,0,0,0,0
1746549937110,EDS 25,A10,888244,Staff,0,0,0,0
1746549937110,EDS 25,B01,888273,Staff,0,0,0,0
1746549937110,EDS 25,B02,888285,Staff,0,0,0,0
1746549937110,EDS 25,B03,888423,Staff,0,0,0,1
1746549937110,EDS 25,B04,888432,Staff,0,0,0,0
1746549937110,EDS 25,B05,888433,Staff,0,0,0,0
1746549937110,EDS 25,B06,888467,Staff,0,0,0,0
1746549937110,EDS 25,B07,888468,Staff,0,0,0,0
1746549937110,EDS 25,B08,888479,Staff,0,0,0,0
1746549937110,EDS 25,B09,888484,Staff,0,0,0,0
1746549937110,EDS 25,B10,888487,Staff,0,0,0,0
1746549938137,EDS 38,A01,907700,Choi; Bailey Miyeon,30,0,30,0
1746549939161,EDS 112,A01,888601,Chapman; Thandeka K,14,0,40,26
1746549940186,EDS 115,A00,888697,Mendez; Kathrina Mendoza,10,0,30,20
1746549941217,EDS 116,A01,888893,Staff,35,0,40,5
1746549943277,EDS 124AR,A00,889133,Staff,29,0,50,21
1746549943277,EDS 124AR,B00,907471,Simon; Elizabeth A,37,0,50,13
1746549944304,EDS 124BR,A00,889134,Simon; Elizabeth A,45,0,100,55
1746549945329,EDS 125,A00,889135,Staff,25,0,30,5
1746549946393,EDS 126,A01,889138,Staff,36,0,40,4
1746549947417,EDS 164R,A01,889142,Wishard Guerra; Alison G.,33,0,50,17
1746549948444,ENG 30,A01,886396,Staff,0,0,0,0
1746549948444,ENG 30,B01,886398,Staff,0,0,0,0
1746549949467,ENVR 102,A00,906150,Montejo; Carolina,23,0,25,2
1746549950495,ETHN 103A,A00,887236,Man; Simeon S,0,3,0,0
1746549951522,ETHN 113,A00,887239,Staff,16,0,30,14
1746549952552,ETHN 116,A00,887240,Staff,16,0,25,9
1746549953576,ETHN 117,A00,887241,Choi; Esther Min,28,0,30,2
1746549954602,ETHN 118,A00,887243,Staff,24,0,30,6
1746549955628,ETHN 127,A00,887248,Cuong; Marisol,11,0,15,4
1746549956654,ETHN 139,A00,887250,Staff,7,0,10,3
1746549957682,ETHN 142,A00,887252,Staff,10,0,30,20
1746549958710,ETHN 161,A00,887253,Browne; Errol Tsekani,24,0,30,6
1746549959735,ETHN 163FR,A00,887255,Burelle; Julie Sara Veronique,0,0,5,5
1746549960760,GLBH 20,A00,889149,Elwardani; Nile Regina,8,0,42,34
1746549962809,GLBH 111,A01,889152,Burgos; Jose L.,17,0,17,0
1746549963836,GLBH 150,A00,889181,Sloane; Julia Kathryn,0,5,15,15
1746549965889,HDS 60,A01,886406,Warstadt; Melissa Fawn,73,0,80,7
1746549966918,HIAF 111,A00,889324,Gyamfi; Bright,25,0,32,7
1746549967943,HIEA 131,A00,889328,Staff,16,0,32,16
1746549968969,HIEA 144,A00,889333,Henry; Todd A.,26,0,32,6
1746549969999,HIEA 154,A00,889336,Henry; Todd A.,24,0,32,8
1746549971028,HIEU 106,A00,889339,Staff,22,0,32,10
1746549973082,HIEU 114,A00,889340,Staff,3,0,32,29
1746549974109,HIEU 135GS,A00,889342,Patterson; Patrick H.,0,0,1,24
1746549975134,HIEU 137,A00,889343,Edington; Claire Ellen,9,0,25,16
1746549976162,HIEU 148,A00,889345,Staff,14,0,32,18
1746549977190,HIEU 154,A00,889346,Biess; Frank Peter,21,0,32,11
1746549978219,HILA 102,A00,889351,Staff,12,0,32,20
1746549979244,HILD 2A,A01,889221,Lewandoski; Julia Mavis,1,10,32,31
1746549980269,HILD 7B,A01,889225,Man; Simeon S,0,13,32,32
1746549981301,HILD 7C,A01,889288,Alvarez; Luis A,0,14,32,32
1746549982326,HILD 30,A01,889323,Staff,0,5,32,32
1746549984376,HISC 119,A00,889383,Golan; Tal,20,0,32,12
1746549985401,HIUS 103,A00,889384,Man; Simeon S,0,0,32,32
1746549986425,HIUS 117,A00,919797,Kwak; Nancy,18,0,32,14
1746549987450,HIUS 142A,A00,919788,Staff,22,0,32,10
1746549989500,HIUS 149,A00,889386,Gyamfi; Bright,27,0,32,5
1746549990525,HIUS 155,A00,889387,Alvarez; Luis A,14,0,32,18
1746549991549,HUM 3,A01,886499,Caldwell; Michael Alan,19,0,50,31
1746549992573,HUM 3GS,A00,886500,Rodriguez; Bretton Sigfred,0,0,0,28
1746549993600,HUM 3R,A01,886502,Markman; Kristina,0,36,50,50
1746549994625,HUM 4,A01,886504,Crum; Matthew Stephen,24,0,50,26
1746549994625,HUM 4,B01,886506,West; Geoffrey Scott,17,0,50,33
1746549995652,HUM 4GS,A00,886507,Staff,0,0,0,19
1746549996679,HUM 5,A01,886509,Staff,32,0,50,18
1746549997704,HUM 5R,A01,886511,Zavodny; Tatiana Sophia,0,39,50,50
1746549998728,JAPN 180,A00,886407,Staff,18,0,40,22
1746549999756,LATI 50,A01,886409,Martin-Cabrera; Luis,4,0,22,18
1746549999756,LATI 50,A02,886410,Martin-Cabrera; Luis,19,0,22,3
1746549999756,LATI 50,A03,886411,Martin-Cabrera; Luis,21,0,22,1
1746549999756,LATI 50,A04,886412,Martin-Cabrera; Luis,9,0,22,13
1746550000781,LAWS 101,A00,907664,Staff,28,0,60,32
1746550001806,LIAB 1A,A00,889388,Saab; Dima,17,0,20,3
1746550002831,LIAB 1AX,A00,889389,El Cheddadi; Youniss,17,0,20,3
1746550003857,LIFR 1C,A00,889391,Van Moer; Vinciane G,8,0,20,12
1746550004881,LIFR 1CX,A00,889392,Van Moer; Vinciane G,7,0,20,13
1746550005910,LIFR 1D,A00,889393,Van Moer; Vinciane G,7,0,20,13
1746550006939,LIFR 1DX,A00,889394,Van Moer; Vinciane G,8,0,20,12
1746550007963,LIGN 7,A00,886923,Staff,24,0,50,26
1746550008991,LIGN 17,A00,886924,Kehler; Andrew Scott,125,0,150,25
1746550010017,LTAM 110,A00,889395,Staff,15,0,30,15
1746550011042,LTAM 110GS,A00,958010,Rodriguez; Bretton Sigfred,0,0,0,28
1746550012069,LTCH 101,A00,889397,Staff,23,0,25,2
1746550013096,LTCS 130,A00,889398,Staff,23,0,25,2
1746550014121,LTEA 138,A00,889399,Staff,24,0,40,16
1746550015146,LTEN 149,A00,889400,Wesling; Megan E.,0,3,25,25
1746550016172,LTEN 169,A00,889401,Staff,20,0,25,5
1746550017203,LTEN 180,A00,889402,Staff,10,0,15,5
1746550018228,LTEN 181,A00,889403,Staff,21,0,25,4
1746550019252,LTWL 100,A00,889404,Myerston Santana; Jacobo,3,0,25,22
1746550020278,LTWL 180GS,A00,889405,Staff,0,0,20,20
1746550021306,LTWL 181,A00,889406,Staff,17,0,25,8
1746550022333,LTWL 184,A00,889475,Mukherjee; Silpa,22,0,25,3
1746550023359,LTWR 102C,A00,889486,Staff,29,0,30,1
1746550024385,LTWR 115W,A00,889491,Staff,0,2,15,15
1746550025412,MAE 8,A01,886905,Staff,0,2,0,0
1746550026437,MAE 11,A00,886906,Bandaru; Prabhakar,0,7,50,50
1746550027462,MAE 20,A00,886907,Evdokimenko; Ekaterina,44,0,70,26
1746550028488,MAE 30B,A00,886909,Ghazinejad; Maziar,26,0,45,19
1746550029515,MAE 101B,A00,886910,Saintillan; David,29,0,45,16
1746550030548,MAE 105,A00,886911,Bandaru; Prabhakar,18,0,50,32
1746550031580,MAE 107,B00,958024,Staff,8,0,50,42
1746550032605,MAE 143B,A00,886913,Bewley; Thomas R,7,0,40,33
1746550033630,MAE 148,A01,886915,Silberman; Jack,0,3,14,14
1746550034654,MAE 160,A00,886916,Evdokimenko; Ekaterina,31,0,60,29
1746550035682,MATH 3C,A01,889681,Staff,0,3,30,30
1746550035682,MATH 3C,A02,960048,Staff,25,0,30,5
1746550036705,MATH 10A,A01,889760,Staff,26,0,30,4
1746550036705,MATH 10A,A02,889783,Staff,29,0,30,1
1746550037732,MATH 10B,A01,889785,Verstraete; Jacques Allan,2,0,35,33
1746550037732,MATH 10B,A02,889795,Verstraete; Jacques Allan,4,0,35,31
1746550037732,MATH 10B,B01,889797,Verstraete; Jacques Allan,3,0,35,32
1746550037732,MATH 10B,B02,889828,Verstraete; Jacques Allan,3,0,35,32
1746550038759,MATH 10C,A01,889849,Habib; Yousaf,9,0,30,21
1746550038759,MATH 10C,A02,889852,Habib; Yousaf,14,0,30,16
1746550038759,MATH 10C,A03,889853,Habib; Yousaf,22,0,30,8
1746550038759,MATH 10C,A04,889858,Habib; Yousaf,20,0,30,10
1746550038759,MATH 10C,B01,889861,Staff,1,0,30,29
1746550038759,MATH 10C,B02,889862,Staff,24,0,30,6
1746550038759,MATH 10C,B03,889863,Staff,27,0,30,3
1746550038759,MATH 10C,B04,889967,Staff,23,0,30,7
1746550039783,MATH 18,A01,889974,Staff,7,0,30,23
1746550039783,MATH 18,A02,889977,Staff,20,0,30,10
1746550039783,MATH 18,B01,889984,Hardiman; Liam,22,0,30,8
1746550039783,MATH 18,B02,889985,Hardiman; Liam,25,0,30,5
1746550040812,MATH 20A,A01,889990,Suk; Andrew Hoon,30,0,35,5
1746550041841,MATH 20B,A01,889993,Ohm; Ko Woon,22,0,30,8
1746550041841,MATH 20B,A02,889994,Ohm; Ko Woon,30,0,30,0
1746550041841,MATH 20B,B01,889996,Ohm; Ko Woon,21,0,30,9
1746550041841,MATH 20B,B02,889997,Ohm; Ko Woon,23,0,30,7
1746550042869,MATH 20C,A01,889999,Hammock; Frances H,17,0,30,13
1746550042869,MATH 20C,A02,890003,Hammock; Frances H,23,0,30,7
1746550042869,MATH 20C,B01,890006,Hammock; Frances H,3,0,30,27
1746550042869,MATH 20C,B02,890007,Hammock; Frances H,11,0,30,19
1746550043900,MATH 20D,A01,890011,Cheng; Hsiao-Bing,1,1,30,29
1746550043900,MATH 20D,A02,890012,Cheng; Hsiao-Bing,14,0,30,16
1746550043900,MATH 20D,B01,890016,Cheng; Hsiao-Bing,13,0,30,17
1746550043900,MATH 20D,B02,890017,Cheng; Hsiao-Bing,13,0,30,17
1746550044926,MATH 20E,A01,890026,Harel; Guershon,1,0,30,29
1746550044926,MATH 20E,A02,890029,Harel; Guershon,23,0,30,7
1746550044926,MATH 20E,B01,890033,Harel; Guershon,7,0,30,23
1746550044926,MATH 20E,B02,890101,Harel; Guershon,21,0,30,9
1746550045953,MATH 102,A01,890104,Staff,17,0,30,13
1746550045953,MATH 102,A02,890105,Staff,27,0,30,3
1746550046979,MATH 103B,A01,890116,Salehi Golsefidy; Alireza,3,0,30,27
1746550046979,MATH 103B,B01,890118,Staff,0,3,34,34
1746550048008,MATH 109,A01,890121,Aliabadi Sr.; Mohsen,1,0,30,29
1746550048008,MATH 109,B01,890124,Upadrashta; Pranav Kumar,18,0,30,12
1746550049033,MATH 120A,A01,890126,Eggers; John Dietrich,13,0,30,17
1746550050060,MATH 142B,A01,890128,Ioana; Adrian,19,0,30,11
1746550050060,MATH 142B,A02,890129,Ioana; Adrian,13,0,30,17
1746550051088,MATH 154,A01,890174,Staff,0,0,30,30
1746550051088,MATH 154,A02,890182,Staff,0,0,30,30
1746550052114,MATH 168A,A01,890197,Dumitriu; Ioana,21,0,35,14
1746550053140,MATH 170A,A01,890240,Nie; Jiawang,1,0,30,29
1746550053140,MATH 170A,A02,890241,Nie; Jiawang,11,0,30,19
1746550053140,MATH 170A,A03,890249,Nie; Jiawang,23,0,30,7
1746550054171,MATH 170B,A01,957891,Nag; Panchali,13,0,35,22
1746550056226,MATH 181A,A01,908025,Staff,0,4,35,35
1746550056226,MATH 181A,A02,960115,Staff,27,0,35,8
1746550057251,MATH 181B,A01,959874,Staff,26,0,30,4
1746550058278,MATH 193B,A01,890265,Staff,0,4,35,35
1746550059303,MGT 4,A01,890311,Anderson; John Charles,42,0,88,46
1746550060328,MGT 5,A00,907740,Staff,13,0,98,85
1746550061358,MGT 12,A00,890312,Lindenberger; Wade Douglas,67,0,98,31
1746550062384,MGT 16,A00,957883,Staff,78,0,98,20
1746550064439,MGT 45,A00,890314,Pecore; Joseph P.,47,0,98,51
1746550065467,MGT 71,A00,890315,Staff,0,11,98,98
1746550066490,MGT 100,A00,890316,Yavorsky; Daniel Ryan,44,0,98,54
1746550067516,MGT 103,A00,890317,Ehrich; Kristine R,73,0,98,25
1746550068541,MGT 105,A00,890356,Bates; Kenneth Walter,0,7,98,98
1746550069567,MGT 112,A00,890360,Ehrich; Kristine R,55,0,98,43
1746550070593,MGT 127R,A00,907732,Zhu; Kevin Xiaoguo,23,0,98,75
1746550071623,MGT 131B,A00,890361,Anderson; John Charles,61,0,98,37
1746550072650,MGT 137,A00,890362,Lindenberger; Wade Douglas,65,0,98,33
1746550073676,MGT 160,A00,890369,Johnson; Erik Barry,9,0,98,89
1746550075727,MGT 164,A00,890372,Zimmermann; Carsten,0,39,98,98
1746550076757,MGT 180,A00,890374,Bliss; Barbara Ann,12,0,98,86
1746550077788,MMW 15,A01,886414,Chang; Edmond Yi-Teh,0,12,28,28
1746550077788,MMW 15,A02,886415,Chang; Edmond Yi-Teh,0,8,28,28
1746550077788,MMW 15,A03,886416,Chang; Edmond Yi-Teh,0,8,28,28
1746550077788,MMW 15,A04,886417,Chang; Edmond Yi-Teh,0,8,28,28
1746550077788,MMW 15,B01,886419,Chang; Edmond Yi-Teh,0,7,28,28
1746550077788,MMW 15,B02,886420,Chang; Edmond Yi-Teh,0,8,28,28
1746550077788,MMW 15,B03,886421,Chang; Edmond Yi-Teh,0,7,28,28
1746550077788,MMW 15,B04,886422,Chang; Edmond Yi-Teh,0,8,28,28
1746550077788,MMW 15,C01,886424,Staff,0,9,28,28
1746550077788,MMW 15,C02,886425,Staff,0,8,28,28
1746550077788,MMW 15,C03,886426,Staff,0,8,28,28
1746550077788,MMW 15,C04,886427,Staff,0,7,28,28
1746550077788,MMW 15,C05,958038,Staff,0,7,28,28
1746550077788,MMW 15,C06,958039,Staff,0,8,28,28
1746550078813,MMW 15GS,A00,906910,Patterson; Patrick H.,4,0,28,24
1746550079847,MMW 122R,A01,886429,Rahimi; Babak,0,13,28,28
1746550079847,MMW 122R,A02,886430,Rahimi; Babak,0,12,28,28
1746550079847,MMW 122R,A03,958040,Rahimi; Babak,0,11,28,28
1746550080876,MUS 1A,A01,890937,Staff,3,0,25,22
1746550080876,MUS 1A,A02,891035,Staff,5,0,25,20
1746550080876,MUS 1A,C01,958912,Staff,24,0,25,1
1746550080876,MUS 1A,C02,958913,Staff,25,0,25,0
1746550082928,MUS 2AK,A00,957092,Ohnishi; Takae,15,0,15,0
1746550083952,MUS 4,A01,891044,Staff,2,0,25,23
1746550083952,MUS 4,A02,891045,Staff,23,0,25,2
1746550083952,MUS 4,B01,891048,Staff,17,0,25,8
1746550083952,MUS 4,B02,891050,Staff,25,0,25,0
1746550084979,MUS 5,A01,957506,Dubnov; Shlomo,0,0,25,25
1746550084979,MUS 5,A02,957622,Dubnov; Shlomo,14,0,25,11
1746550084979,MUS 5,A03,957623,Dubnov; Shlomo,20,0,25,5
1746550086007,MUS 6,A01,891053,Freitas Caetano; Marcelo,24,0,25,1
1746550086007,MUS 6,A02,891054,Freitas Caetano; Marcelo,23,0,25,2
1746550087033,MUS 7,A01,891081,Staff,0,0,25,25
1746550087033,MUS 7,A02,891082,Staff,4,0,25,21
1746550088060,MUS 8GS,A00,891118,Borgo; David Garcia,0,0,25,25
1746550089084,MUS 11,A01,891140,Staff,11,0,25,14
1746550089084,MUS 11,A02,891141,Staff,22,0,25,3
1746550090110,MUS 13,A01,891143,Staff,8,0,25,17
1746550090110,MUS 13,A02,891144,Staff,24,0,25,1
1746550091136,MUS 15,A01,891146,Staff,9,0,25,16
1746550091136,MUS 15,A02,891148,Staff,21,0,25,4
1746550091136,MUS 15,B01,891150,Staff,18,0,25,7
1746550091136,MUS 15,B02,891151,Staff,25,0,25,0
1746550092166,MUS 20,A01,891153,Staff,5,0,20,15
1746550092166,MUS 20,A02,891155,Staff,14,0,20,6
1746550093194,MUS 80,A00,891156,Staff,19,0,25,6
1746550093194,MUS 80,B00,891157,Staff,23,0,25,2
1746550094219,MUS 130,A00,891158,Ohnishi; Takae,35,0,35,0
1746550095254,MUS 150GS,A01,891160,Borgo; David Garcia,0,0,25,25
1746550096279,MUS 170,A01,891162,Freitas Caetano; Marcelo,20,0,25,5
1746550096279,MUS 170,A02,891164,Freitas Caetano; Marcelo,21,0,25,4
1746550097306,NANO 11,A00,886220,Vazquez Mena; Oscar,13,0,15,2
1746550098334,NANO 15,A01,886222,Drews; Aaron,4,0,7,3
1746550099363,NANO 104,A00,886224,Sirbuly; Donald,18,0,25,7
1746550100388,PH 40,A00,886528,Staff,23,0,40,17
1746550101413,PH 45,A01,886799,Staff,35,0,40,5
1746550102439,PH 110,A00,886802,Staff,0,7,40,40
1746550103466,PH 172,A00,906716,Staff,19,0,35,16
1746550104505,PH 191,A00,886803,Staff,6,0,40,34
1746550105533,PHIL 1,A00,889500,Staff,19,0,30,11
1746550106562,PHIL 10,A01,889549,Grush; Rick Scott,15,0,22,7
1746550106562,PHIL 10,A02,889551,Grush; Rick Scott,22,0,22,0
1746550107590,PHIL 28,A01,889559,Lamey; Andy M.,0,1,31,31
1746550107590,PHIL 28,A02,889561,Lamey; Andy M.,0,1,30,30
1746550107590,PHIL 28,A03,889572,Lamey; Andy M.,0,1,30,30
1746550108617,PHIL 35,A00,907839,Staff,13,0,15,2
1746550109645,PHIL 60,A00,889574,Staff,74,0,90,16
1746550110673,PHIL 101,A00,958004,Staff,13,0,15,2
1746550112728,PHIL 136,A00,889582,Fulkerson; Matthew Todd,26,0,45,19
1746550113754,PHIL 163,A01,889601,Staff,21,0,30,9
1746550113754,PHIL 163,B01,889606,Brandt; Reuven A,0,3,0,0
1746550114778,PHIL 164,A00,889610,Staff,16,0,30,14
1746550115807,PHIL 165,A00,889613,Staff,23,0,30,7
1746550116831,PHYS 1A,A00,886431,Staff,26,0,70,44
1746550117859,PHYS 1AL,001,886432,Tsai; Philbert S,0,2,30,30
1746550117859,PHYS 1AL,002,886436,Tsai; Philbert S,11,0,30,19
1746550118884,PHYS 1B,A00,886439,Staff,185,0,240,55
1746550119912,PHYS 1BL,001,886441,Tsai; Philbert S,0,4,30,30
1746550119912,PHYS 1BL,002,886444,Tsai; Philbert S,2,0,30,28
1746550120940,PHYS 1C,A00,896092,Arnold; Kam S,78,0,146,68
1746550121968,PHYS 1CL,001,886448,Tsai; Philbert S,0,0,30,30
1746550121968,PHYS 1CL,002,886449,Tsai; Philbert S,0,0,30,30
1746550121968,PHYS 1CL,003,886450,Tsai; Philbert S,16,0,30,14
1746550121968,PHYS 1CL,004,886451,Tsai; Philbert S,15,0,30,15
1746550122994,PHYS 2B,A01,886457,Staff,69,0,115,46
1746550124020,PHYS 2C,A01,886460,Shotwell; Brian,0,8,65,65
1746550125046,PHYS 2CL,A01,886467,Staff,0,4,28,28
1746550125046,PHYS 2CL,A02,886468,Staff,0,3,28,28
1746550126074,PHYS 2D,A01,886470,Staff,10,0,50,40
1746550127102,PHYS 4B,A01,886475,Grinstein; Benjamin,22,0,40,18
1746550128128,POLI 5,A00,891173,Desposato; Scott,7,0,25,18
1746550129155,POLI 5D,A01,891175,Staff,5,0,5,0
1746550129155,POLI 5D,B01,891178,Staff,5,0,5,0
1746550130181,POLI 11,A00,891179,Ferree; Karen E,2,0,35,33
1746550131209,POLI 12,A00,891180,Staff,16,0,30,14
1746550132237,POLI 27,A01,891182,Staff,12,0,75,63
1746550133265,POLI 30,A00,891183,Staff,8,0,50,42
1746550134293,POLI 100B,A00,891244,Staff,5,1,35,30
1746550135322,POLI 100I,A00,891247,Staff,7,0,30,23
1746550136351,POLI 104J,A00,891248,Nichter; Maysa,14,0,30,16
1746550137375,POLI 104U,A00,891250,Nichter; Maysa,2,0,30,28
1746550139425,POLI 110B,A00,891255,Wiens; David,20,0,25,5
1746550140451,POLI 112A,A00,891256,Wiens; David,6,0,25,19
1746550141479,POLI 114BR,A00,891261,Staff,19,0,30,11
1746550142508,POLI 117R,A00,891262,Forman; Fonna,0,6,50,50
1746550143533,POLI 118,A00,891264,Ingham; Sean,17,0,25,8
1746550144559,POLI 124A,A00,891265,Staff,18,0,20,2
1746550145588,POLI 125D,A00,891266,Nichter; Simeon C,2,0,25,23
1746550146613,POLI 126,A00,891268,Nichter; Simeon C,7,0,25,18
1746550147638,POLI 126AA,A00,891272,Staff,17,0,25,8
1746550148664,POLI 130AA,A00,891273,Staff,15,0,20,5
1746550149688,POLI 134AA,A00,891274,Staff,4,0,20,16
1746550151738,POLI 138,A00,891278,Staff,21,0,25,4
1746550152764,POLI 142K,A00,891280,Staff,11,0,25,14
1746550153830,POLI 142M,A00,891281,Gartzke; Erik,17,0,30,13
1746550154858,POLI 142P,A00,891284,Staff,20,0,30,10
1746550155883,POLI 143,A00,891285,Gartzke; Erik,12,0,30,18
1746550156908,POLI 153,A00,891286,Staff,19,0,20,1
1746550158960,POLI 175,A00,891290,Staff,15,0,20,5
1746550159993,PSYC 1,A00,890674,Steiner; Eric Tomas,0,11,45,45
1746550161018,PSYC 2,A00,890676,Albright; Thomas D,21,0,35,14
1746550162044,PSYC 3,A00,890679,Staff,17,0,20,3
1746550163068,PSYC 6,A00,959858,Staff,20,0,20,0
1746550164094,PSYC 60,A01,890684,Rickard; Timothy C.,0,5,45,45
1746550165120,PSYC 70,A01,890689,Geller; Emma Harlan,7,0,30,23
1746550166148,PSYC 71,A01,959860,Staff,21,0,25,4
1746550167174,PSYC 100,A00,890690,Lacefield; Katharine I,0,50,180,180
1746550168198,PSYC 102,A00,890695,Staff,18,0,40,22
1746550169223,PSYC 105,A00,890699,Geller; Emma Harlan,71,0,100,29
1746550170253,PSYC 106,A00,890701,Gorman; Michael R.,5,0,30,25
1746550171282,PSYC 108,A00,890704,Adrian; Julia Anna,0,28,50,50
1746550172308,PSYC 118,A01,890712,Staff,11,0,30,19
1746550173334,PSYC 124,A00,890716,Chapman; Eddie Nathaniel,25,0,60,35
1746550174361,PSYC 131,A00,890717,Anagnostaras; Stephan,0,7,80,80
1746550175386,PSYC 137,A00,890719,Winkielman; Piotr,0,11,30,30
1746550176414,PSYC 144,A00,890721,Adrian; Julia Anna,0,9,45,45
1746550177439,PSYC 162,A00,890805,Staff,2,0,75,73
1746550178464,PSYC 169,A00,890810,Staff,0,15,30,30
1746550179495,PSYC 172,A00,890814,Gorman; Michael R.,9,0,30,21
1746550180519,PSYC 181,A00,890818,Anagnostaras; Stephan,8,0,200,192
1746550181544,PSYC 184,A00,959861,Staff,170,0,175,5
1746550182570,PSYC 189,A00,890823,Staff,0,1,30,30
1746550183597,PSYC 191,A00,890884,Rickard; Timothy C.,0,11,35,35
1746550184622,PSYC 193,A00,890913,Staff,19,0,30,11
1746550184622,PSYC 193,B00,890914,Chapman; Eddie Nathaniel,24,0,30,6
1746550185655,PSYC 193L,A01,890918,Lowe; Angela Beth,20,0,30,10
1746550185655,PSYC 193L,B01,890921,Hurwitz; Ethan Scott,20,0,30,10
1746550185655,PSYC 193L,C01,890928,Staff,30,0,30,0
1746550186682,RELI 149,A00,886806,Rahimi; Babak,23,0,40,17
1746550187710,SE 9,A01,886814,Staff,7,0,20,13
1746550188739,SE 101B,A01,886816,Chadha; Mayank,4,0,35,31
1746550189765,SE 110B,A00,886818,Zhu; Qiang,4,0,75,71
1746550190793,SE 125,A01,886830,Staff,10,0,30,20
1746550191818,SE 130B,A01,886835,Staff,14,0,40,26
1746550192847,SE 131A,A01,886838,Krysl; Petr,34,0,55,21
1746550193872,SE 154,A00,886840,Staff,30,0,50,20
1746550194898,SE 164GS,A01,886849,Staff,6,0,20,14
1746550195922,SE 167GS,A01,886853,Staff,6,0,20,14
1746550196949,SIO 25,A01,890107,Staff,19,0,30,11
1746550197976,SIO 45,A00,890109,Cook; Geoffrey W,117,0,200,83
1746550199000,SIO 109R,A00,890110,Forman; Fonna,0,16,20,20
1746550200104,SIO 187,A01,890114,Kacev; David,15,0,40,25
1746550201130,SOCI 1,A01,890431,Thorpe; Charles Robert,15,0,30,15
1746550201130,SOCI 1,A02,890518,Thorpe; Charles Robert,30,0,30,0
1746550202157,SOCI 2,A01,957978,Staff,25,0,25,0
1746550202157,SOCI 2,A02,957979,Staff,23,0,25,2
1746550203187,SOCI 20,A01,890523,Calderon-Zaks; Michael Aar,23,0,30,7
1746550203187,SOCI 20,A02,890526,Calderon-Zaks; Michael Aar,29,0,30,1
1746550204212,SOCI 30,A01,890533,Pardo Guerra; Juan Pablo,37,0,40,3
1746550205237,SOCI 40,A01,890535,Staff,27,0,45,18
1746550206262,SOCI 104Q,A00,890559,Staff,18,0,30,12
1746550207288,SOCI 106,A00,890560,Arnal; Maud Marie Leonie,20,0,30,10
1746550208316,SOCI 110,A00,890567,Holkenbrink-Monk; Charlene,19,0,30,11
1746550209340,SOCI 112,A00,890568,Victoria Torres; Pablo,1,0,55,54
1746550210370,SOCI 115,A00,890597,Arnal; Maud Marie Leonie,28,0,45,17
1746550212431,SOCI 121,A00,890604,Pardo Guerra; Juan Pablo,38,0,45,7
1746550213458,SOCI 126,A01,890608,Staff,8,0,10,2
1746550214486,SOCI 127,A00,890609,Staff,18,0,30,12
1746550215515,SOCI 131,A00,890610,Thorpe; Charles Robert,37,0,45,8
1746550216541,SOCI 135,A00,890615,Payne; Christine Anna,14,0,45,31
1746550217566,SOCI 139,A00,890620,Staff,38,0,45,7
1746550218592,SOCI 148E,A00,890622,Calderon-Zaks; Michael Aar,36,0,45,9
1746550219618,SOCI 150,A00,890623,Kohler; Kristopher M.,31,0,45,14
1746550220642,SOCI 157,A00,890625,Jules-Rosette; Bennetta W.,18,0,20,2
1746550221666,SOCI 160,A00,890627,Payne; Christine Anna,21,0,45,24
1746550222693,SYN 1,A00,886855,Fish; Gwendolyn Anne,0,0,0,0
1746550222693,SYN 1,B00,906086,Fish; Gwendolyn Anne,0,1,0,2
1746550223718,SYN 2R,A00,886860,Staff,0,17,15,15
1746550223718,SYN 2R,B00,906106,Atkinson; Arthur Laird,0,16,15,15
1746550224753,SYN 100,A01,886866,Browne; Emily,0,28,20,20
1746550224753,SYN 100,B01,906128,Rock; Martin,0,5,20,20
1746550224753,SYN 100,C01,906140,Deavenport; James Cary,0,3,20,20
1746550224753,SYN 100,D01,907816,Deavenport; James Cary,0,5,20,20
1746550225783,TDAC 1,A00,890286,Walsh; Kim C.,9,0,20,11
1746550226810,TDAC 101,A00,890296,Basso; Beatrice,16,0,20,4
1746550227839,TDDE 131,A00,890297,Staff,47,0,50,3
1746550228865,TDDM 1,A00,890287,Weinberg; Sadie,25,0,30,5
1746550229890,TDGE 11,A00,890288,Fulton; Julia,137,0,200,63
1746550229890,TDGE 11,B00,890289,Castro; Robert Jess,184,0,200,16
1746550230913,TDGE 25,B00,957359,Walsh; Kim C.,3,0,20,17
1746550231937,TDGE 40,A01,890292,Power; Jade Yukana,27,0,30,3
1746550232966,TDGE 124,A00,890298,Havis; Allan,0,1,50,50
1746550233990,TDGE 131R,A00,890299,Burelle; Julie Sara Veronique,15,0,42,27
1746550235015,TDHT 101,A00,890300,Staff,10,0,20,10
1746550236045,TDHT 109,A01,890302,Anderson; Mysia Anyse,31,0,40,9
1746550237077,TDMV 1,A00,890293,Arcidiacono; Kristin,18,0,30,12
1746550238102,TDMV 2,A00,890294,Weinberg; Sadie,23,0,30,7
1746550239126,TDMV 3,A00,957878,Arcidiacono; Kristin,28,0,30,2
1746550241182,TDMV 138,A00,890304,Jun; Grace Shin Hae,25,0,40,15
1746550242208,TDMV 140,A00,890305,Corrales; Joseph Bernales,25,0,30,5
1746550243233,TDMV 142,A00,890307,Caligagan; Tony,32,0,40,8
1746550244258,TDMV 144,A00,890308,Camaya; Michelle Ann,25,0,30,5
1746550245284,TDPW 1,A00,890295,Stein; Deborah Isobel,3,0,20,17
1746550246311,USP 2,A01,890272,Lerner; Amy M,6,0,20,14
1746550247336,USP 3,A01,890274,Staff,12,0,30,18
1746550248361,USP 15,A01,890276,Sun; Feiyang,17,0,30,13
1746550249386,USP 25,A00,890277,Shenkman; Michael Thomas,19,0,25,6
1746550250415,USP 138,A00,890278,Staff,13,0,25,12
1746550251440,USP 143,A00,890279,Staff,21,0,70,49
1746550252467,USP 144,A00,890280,Chowdhury; Muhammed Zohir,16,0,30,14
1746550253493,USP 150,A00,890281,Boomhower; Matthew Charles,4,0,30,26
1746550254517,USP 151,A00,890282,Staff,16,0,20,4
1746550255545,USP 162,A00,890283,Andrews; Abigail Leslie,16,0,20,4
1746550256572,USP 168,A00,920477,Kwak; Nancy,1,0,5,4
1746550257601,USP 181,A00,890284,Staff,3,0,20,17
1746550258627,USP 191A,A00,890285,Staff,13,0,20,7
1746550259652,VIS 101,A00,886512,Staff,25,0,75,50
1746550260677,VIS 103,A00,886513,Cruz; Edwin Teddy,61,0,75,14
1746550261706,VIS 108,A00,886514,Staff,3,0,15,12
1746550262730,VIS 127P,A00,886515,Shen; Kuiyi,80,0,146,66
1746550263757,VIS 149,A00,886516,Yoldas; Pinar,0,0,15,15
1746550264782,VIS 164,A00,886526,Erdmann; Dean,19,0,22,3
1746550265808,VIS 194S,A00,886527,Staff,61,0,75,14
1746550266837,WCWP 10A,C00,886484,Martiniuk; Jill,12,0,15,3
1746550267865,WCWP 10B,A00,886490,Uriarte; Emma,0,0,15,15
1746550267865,WCWP 10B,B00,886491,Dhir; Simrita,10,0,15,5
1746550267865,WCWP 10B,C00,886492,Ornelas; Tricia,0,0,15,15
1746550268890,WCWP 100,A00,886494,Young; Mark T,0,6,15,15
1746550270977,AAS 10,A01,886199,Childs; Dennis R.,0,3,0,0
1746550272004,ANAR 104,A01,886940,Shtienberg; Gilad,27,0,30,3
1746550273030,ANAR 120,A00,886953,Staff,12,0,20,8
1746550274057,ANBI 148,A01,886955,Wilder; Linnea Lorene,30,0,40,10
1746550276109,ANSC 122,A00,886957,Staff,25,0,30,5
1746550277135,ANSC 150,A00,886958,Sloane; Julia Kathryn,3,0,15,12
1746550278159,ANSC 156,A00,886959,Jenkins; Janis A.,0,1,15,15
1746550279186,ANSC 180,A00,886960,Staff,11,0,17,6
1746550280214,ANSC 188,A00,886961,Jassal; Aftab,9,0,25,16
1746550281240,ANSC 190,A00,886962,Jassal; Aftab,14,0,25,11
1746550282269,ANSC 191,A00,886963,Staff,18,0,20,2
1746550283293,ANTH 3,A01,891689,Staff,17,0,20,3
1746550284317,ANTH 5,A00,886933,Semendeferi; Ekaterini,16,0,20,4
1746550285341,ANTH 10,A00,886934,Staff,0,12,30,30
1746550286366,ANTH 21,A01,886936,Staff,40,0,60,20
1746550287391,ANTH 23,A01,886938,Staff,92,0,100,8
1746550288416,ANTH 105,A00,886964,Stewart; Alexander B,84,0,100,16
1746550289440,ANTH 108,A00,886965,Pedersen; David,9,0,20,11
1746550290471,AWP 10,001,886147,Staff,0,0,0,0
1746550290471,AWP 10,002,886148,Staff,0,0,0,0
1746550290471,AWP 10,003,886149,Staff,0,0,0,0
1746550290471,AWP 10,004,886150,Staff,0,0,0,0
1746550290471,AWP 10,005,886151,Staff,0,0,0,0
1746550290471,AWP 10,006,886152,Staff,0,0,0,0
1746550290471,AWP 10,007,886153,Staff,0,0,0,0
1746550290471,AWP 10,008,886154,Staff,0,0,0,0
1746550290471,AWP 10,009,886155,Staff,0,0,0,0
1746550290471,AWP 10,010,886156,Staff,0,0,0,0
1746550290471,AWP 10,011,886158,Staff,0,0,0,0
1746550290471,AWP 10,012,886160,Staff,0,0,0,0
1746550290471,AWP 10,013,886161,Staff,0,0,0,0
1746550290471,AWP 10,014,886162,Staff,0,0,0,0
1746550290471,AWP 10,015,886163,Staff,0,0,0,0
1746550290471,AWP 10,016,886164,Staff,0,0,0,0
1746550290471,AWP 10,017,886165,Staff,0,0,0,0
1746550290471,AWP 10,018,886166,Staff,0,0,0,0
1746550290471,AWP 10,019,886168,Staff,0,0,0,0
1746550290471,AWP 10,020,886170,Staff,0,0,0,0
1746550290471,AWP 10,021,886172,Staff,0,0,0,0
1746550291501,AWP 10R,001,886173,Staff,0,1,0,0
1746550291501,AWP 10R,002,886174,Staff,0,1,0,0
1746550291501,AWP 10R,003,886175,Staff,0,0,0,0
1746550291501,AWP 10R,004,886176,Staff,0,0,0,0
1746550291501,AWP 10R,005,886177,Staff,0,0,0,0
1746550291501,AWP 10R,006,886178,Staff,0,0,0,0
1746550291501,AWP 10R,007,886179,Staff,0,0,0,0
1746550291501,AWP 10R,008,886181,Staff,0,0,0,0
1746550291501,AWP 10R,009,886182,Staff,0,0,0,0
1746550291501,AWP 10R,010,886183,Staff,0,0,0,0
1746550291501,AWP 10R,011,886184,Staff,0,0,0,0
1746550291501,AWP 10R,012,886185,Staff,0,0,0,0
1746550291501,AWP 10R,013,886186,Staff,0,0,0,0
1746550291501,AWP 10R,014,886187,Staff,0,0,0,0
1746550291501,AWP 10R,015,886188,Staff,0,0,0,0
1746550291501,AWP 10R,016,886189,Staff,0,0,0,0
1746550292525,AWP 102R,A00,886190,Staff,0,0,0,0
1746550292525,AWP 102R,B00,886191,Staff,0,0,0,0
1746550293548,BENG 100,A01,886193,Staff,17,0,30,13
1746550294574,BENG 122A,A01,886195,Hasty; Jeff M,13,0,30,17
1746550295598,BENG 166A,A00,886196,Sah; Robert Lie-Yuan,0,1,30,30
1746550296621,BENG 190,A00,958050,Khojah; Reem I,24,0,25,1
1746550297647,BIBC 102,A01,894320,Staff,0,0,46,46
1746550297647,BIBC 102,A02,894321,Staff,0,0,46,46
1746550297647,BIBC 102,A03,894344,Staff,7,0,46,39
1746550297647,BIBC 102,A04,894345,Staff,26,0,47,21
1746550298672,BICD 100R,A01,894365,Smith; Laurie,0,3,58,58
1746550298672,BICD 100R,A02,894366,Smith; Laurie,0,5,58,58
1746550298672,BICD 100R,A03,894367,Smith; Laurie,2,0,59,57
1746550298672,BICD 100R,A04,959869,Smith; Laurie,41,0,59,18
1746550299698,BICD 136,A01,894383,Gustafson-Brown; Cindy,14,0,50,36
1746550300724,BIEB 102,A01,894494,Butler; Shannon Rhey,51,0,130,79
1746550302780,BIEB 150,A01,894617,Wills; Christopher,3,0,20,17
1746550302780,BIEB 150,A02,894631,Wills; Christopher,3,0,20,17
1746550302780,BIEB 150,A03,894937,Wills; Christopher,3,0,20,17
1746550302780,BIEB 150,A04,894946,Wills; Christopher,5,0,20,15
1746550303807,BIEB 194,A00,906141,Kurle; Carolyn M.,6,0,20,14
1746550304831,BILD 1,A01,894154,Staff,2,0,19,17
1746550304831,BILD 1,A02,894155,Staff,14,0,19,5
1746550304831,BILD 1,A03,894160,Staff,13,0,19,6
1746550304831,BILD 1,A04,894161,Staff,15,0,18,3
1746550305859,BILD 2,A01,894168,Staff,0,0,50,50
1746550305859,BILD 2,A02,894169,Staff,0,0,50,50
1746550305859,BILD 2,A03,894179,Staff,4,0,50,46
1746550305859,BILD 2,A04,894203,Staff,27,0,50,23
1746550306885,BILD 3,A01,894213,Staff,22,0,31,9
1746550306885,BILD 3,A02,894214,Staff,26,0,31,5
1746550306885,BILD 3,A03,894235,Staff,28,0,31,3
1746550306885,BILD 3,A04,894236,Staff,28,0,32,4
1746550307913,BILD 4,A01,894253,Reuther; Keefe,5,0,24,19
1746550307913,BILD 4,A02,894258,Reuther; Keefe,16,0,24,8
1746550308959,BILD 5,A01,894276,Reuther; Keefe,35,0,50,15
1746550308959,BILD 5,A02,894277,Reuther; Keefe,45,0,50,5
1746550308959,BILD 5,A03,894290,Reuther; Keefe,44,0,50,6
1746550308959,BILD 5,A04,894291,Reuther; Keefe,48,0,50,2
1746550309984,BILD 24,A01,894297,Pirino; Giorgia,40,0,60,20
1746550311009,BIMM 100,B01,958915,Staff,72,0,100,28
1746550312035,BIMM 101,A01,895017,McDonnell; Lisa Marie,0,5,24,24
1746550312035,BIMM 101,A02,895018,McDonnell; Lisa Marie,0,5,24,24
1746550312035,BIMM 101,B01,895020,McDonnell; Lisa Marie,0,6,24,24
1746550312035,BIMM 101,B02,895021,McDonnell; Lisa Marie,0,4,24,24
1746550313062,BIMM 110,A01,895023,Staff,1,0,25,24
1746550313062,BIMM 110,A02,895024,Staff,9,0,25,16
1746550313062,BIMM 110,A03,895025,Staff,18,0,25,7
1746550313062,BIMM 110,A04,895031,Staff,20,0,25,5
1746550314089,BIMM 120,A01,895114,Gustafson-Brown; Cindy,13,0,28,15
1746550314089,BIMM 120,A02,895126,Gustafson-Brown; Cindy,21,0,27,6
1746550315114,BIPN 100,A01,895130,Yang; Mingyu,1,0,38,37
1746550315114,BIPN 100,A02,895131,Yang; Mingyu,32,0,38,6
1746550315114,BIPN 100,A03,895132,Yang; Mingyu,32,0,38,6
1746550315114,BIPN 100,A04,895133,Yang; Mingyu,27,0,36,9
1746550316138,BIPN 120,A01,895135,Cooke; James Edward,0,3,13,13
1746550316138,BIPN 120,A02,895136,Cooke; James Edward,0,1,13,13
1746550316138,BIPN 120,A03,895137,Cooke; James Edward,0,3,13,13
1746550316138,BIPN 120,A04,895156,Cooke; James Edward,0,2,11,11
1746550317166,BIPN 134,A01,895235,Cooke; James Edward,0,2,25,25
1746550317166,BIPN 134,A02,895237,Cooke; James Edward,0,0,25,25
1746550317166,BIPN 134,A03,895240,Cooke; James Edward,3,0,25,22
1746550317166,BIPN 134,A04,895270,Cooke; James Edward,20,0,25,5
1746550318190,BIPN 189,A00,892103,Staff,0,13,14,14
1746550320237,BISP 194,A00,958008,Staff,0,2,0,0
1746550321263,CAT 124,A01,922009,Staff,0,5,20,20
1746550322294,CAT 125R,A00,886390,Morales; Celeste Georgianna,0,2,20,20
1746550322294,CAT 125R,B00,886391,Irwin; Matthew Joseph,0,3,20,20
1746550322294,CAT 125R,C00,886392,Smith; Lauryn Alissa,0,2,20,20
1746550322294,CAT 125R,D00,886393,Vanderschuit; Maya Alysia,0,2,20,20
1746550322294,CAT 125R,E00,886394,Marchisotto; Jennifer Anne,0,4,20,20
1746550323321,CENG 15,A01,886218,Drews; Aaron,3,0,8,5
1746550324345,CENG 113,A00,886219,Opatkiewicz; Justin Paul,15,0,25,10
1746550325371,CGS 101,A00,887044,Staff,7,0,20,13
1746550326396,CGS 105,A01,887046,Staff,14,0,25,11
1746550327420,CGS 112,A00,887047,Cuong; Marisol,12,0,15,3
1746550328446,CGS 113,A00,887048,Staff,23,0,30,7
1746550329472,CGS 120,A00,887049,Staff,10,0,17,7
1746550330499,CHEM 6A,A01,886336,Lam; Tin Yiu,38,0,50,12
1746550330499,CHEM 6A,A02,886338,Lam; Tin Yiu,37,0,50,13
1746550331527,CHEM 6B,A01,886341,Hopkins; Patrycja Anna,16,0,50,34
1746550331527,CHEM 6B,A02,886343,Hopkins; Patrycja Anna,42,0,50,8
1746550332552,CHEM 6C,A01,886346,Albizati; Kim F.,0,2,50,50
1746550332552,CHEM 6C,A02,886348,Albizati; Kim F.,23,0,50,27
1746550333581,CHEM 40A,A01,886352,Klosterman; Jeremy K,65,0,100,35
1746550334606,CHEM 40B,A01,886356,Klosterman; Jeremy K,0,23,100,100
1746550335633,CHEM 41B,A01,886360,Theodorakis; Emmanuel,25,0,50,25
1746550335633,CHEM 41B,A02,886362,Theodorakis; Emmanuel,47,0,50,3
1746550336659,CHIN 165A,A00,886382,Xu; Li,18,0,20,2
1746550337688,CLAS 120,A00,886387,Myerston Santana; Jacobo,33,0,40,7
1746550338712,COGS 9,A01,886967,Shannon; Kyle Michael,42,0,60,18
1746550339740,COGS 11,A01,886969,Staff,11,0,30,19
1746550340768,COGS 14A,A01,886971,Staff,6,0,60,54
1746550341796,COGS 14B,A01,886973,Hoffman; Drew Ellen,4,0,60,56
1746550342823,COGS 18,A01,886975,Morgan; Eric,35,0,60,25
1746550343848,COGS 20,A01,886977,Staff,4,0,8,4
1746550343848,COGS 20,A02,886978,Staff,5,0,7,2
1746550344877,COGS 100,A01,907783,Staff,0,2,30,30
1746550345906,COGS 101B,A01,886980,Staff,0,3,48,48
1746550346934,COGS 101C,A01,886982,Delgado; Tania,0,5,44,44
1746550347963,COGS 102A,A01,886984,Johnson; Christine M.,4,0,30,26
1746550348987,COGS 118B,A01,886986,Staff,0,3,88,88
1746550350025,COGS 150,A01,886988,Bergen; Benjamin,23,0,50,27
1746550351054,COGS 153,A00,886989,Delgado; Tania,0,2,41,41
1746550352081,COGS 186,A01,886991,Staff,0,0,32,32
1746550353106,COGS 187A,A01,886993,Boyle; Mary E. T.,7,0,30,23
1746550354136,COGS 189,A00,886994,Staff,0,1,30,30
1746550355163,COMM 10,A01,886996,Staff,0,0,20,21
1746550355163,COMM 10,A02,886997,Staff,12,0,20,8
1746550355163,COMM 10,A03,959845,Staff,19,0,20,1
1746550356191,COMM 20,A01,886999,Leuning; Grant Maurstad,24,0,40,16
1746550358243,COMM 100A,A01,887002,Staff,0,0,20,25
1746550358243,COMM 100A,A02,887003,Staff,7,0,20,13
1746550359268,COMM 100B,A01,887005,Staff,0,8,20,24
1746550360293,COMM 106D,A00,887006,Staff,14,0,40,26
1746550361321,COMM 110G,A00,887007,Whitworth-Smith; Andrew C,12,0,40,28
1746550362349,COMM 111B,A00,887008,Staff,31,0,40,9
1746550363373,COMM 113T,A00,887009,Abuelhiga; Soraya Jill,28,0,40,12
1746550363373,COMM 113T,B00,906733,Staff,40,0,40,0
1746550364404,COMM 145,A00,887010,Staff,12,0,40,28
1746550365432,COMM 146,A00,887054,Staff,31,0,40,9
1746550366481,COMM 190,A00,887012,Staff,8,0,23,15
1746550367507,CSE 8A,A50,887015,Cao; Yingjun,57,0,85,28
1746550368535,CSE 11,A01,887017,Cao; Yingjun,12,0,70,58
1746550369560,CSE 20,A01,887019,Staff,30,0,50,20
1746550370589,CSE 21,A01,887021,Staff,78,0,100,22
1746550370589,CSE 21,B01,892583,Braun; Oliver,45,0,50,5
1746550371615,CSE 30,A01,887025,Eldon; John,143,0,200,57
1746550372644,CSE 100,A01,887027,Staff,26,0,50,24
1746550372644,CSE 100,A02,887028,Staff,40,0,50,10
1746550373672,CSE 101,A01,887030,Braun; Oliver,75,0,100,25
1746550373672,CSE 101,B01,887032,Jones; Miles E,0,3,50,50
1746550373672,CSE 101,B02,887033,Jones; Miles E,0,1,50,50
1746550374698,CSE 105,A01,908084,Jones; Miles E,32,0,50,18
1746550374698,CSE 105,A02,908087,Jones; Miles E,33,0,50,17
1746550375753,CSE 135,A01,887035,Powell; Thomas Allan,0,4,50,50
1746550376777,CSE 142,A01,887037,Staff,8,0,60,52
1746550377802,CSE 142L,A01,887039,Staff,34,0,60,26
1746550378828,CSE 151A,A01,887041,Solares; Edwin A,47,0,100,53
1746550379856,CSE 175,A01,887043,Kumar; Rakesh,30,0,30,0
1746550380883,CSS 1,A01,886389,Staff,0,1,40,40
1746550381909,DSC 30,A01,908097,Liao; Soohyun Nam,47,0,75,28
1746550382958,DSC 40A,A01,908099,Shannon; Kyle Michael,30,0,50,20
1746550383981,DSC 40B,A01,908112,Staff,16,0,50,34
1746550385009,DSC 80,A01,908116,Staff,19,0,60,41
1746550386036,DSC 197,001,956863,Eldridge; Justin Matthew,9999,0,9999,0
1746550387064,ECE 5,A01,886400,Morris; Karcher William,2,0,6,4
1746550387064,ECE 5,A02,886401,Morris; Karcher William,3,0,6,3
1746550388090,ECE 148,A01,886403,Silberman; Jack,0,14,14,14
1746550389114,ECON 1,A01,887265,Crane; Meredith Helen,12,0,70,58
1746550389114,ECON 1,B01,887268,Staff,43,0,50,7
1746550390138,ECON 2,A01,887273,Crane; Meredith Helen,56,0,70,14
1746550391163,ECON 3,A01,887279,Rondina; Giacomo,32,0,70,38
1746550392187,ECON 4,A01,887282,Anderson; John Charles,0,2,10,10
1746550393212,ECON 5,A01,887285,Staff,33,0,45,12
1746550393212,ECON 5,B01,887292,Staff,41,0,45,4
1746550394238,ECON 100A,A01,887337,Newhouse; Herbert S,54,0,70,16
1746550394238,ECON 100A,B01,887349,Staff,45,0,50,5
1746550395267,ECON 100B,A01,887361,Du; Songzi,29,0,70,41
1746550396290,ECON 100C,A01,887445,Newhouse; Herbert S,59,0,70,11
1746550397317,ECON 105,A00,887488,Vespa; Emanuel Ignacio,23,0,35,12
1746550398341,ECON 109,A01,887506,Shishkin; Denis,28,0,35,7
1746550399367,ECON 110A,A01,887568,Alon; Titan Michael,0,3,35,35
1746550399367,ECON 110A,B01,907601,Alon; Titan Michael,20,0,35,15
1746550400391,ECON 110B,A01,887598,Levkoff; Steven B.,0,23,70,70
1746550401422,ECON 112,A00,887599,Rondina; Giacomo,19,0,35,16
1746550402445,ECON 120A,A01,887603,Dai; Yinlin,36,0,70,34
1746550403474,ECON 120C,A01,887608,Sun; Yixiao,0,1,35,35
1746550403474,ECON 120C,B01,887614,Sun; Yixiao,0,0,35,35
1746550404502,ECON 138,A00,887621,Bharadwaj; Prashant,0,20,20,20
1746550405532,ECON 144,A00,958007,Squires; Dale E,13,0,35,22
1746550406558,ECON 171,A01,907666,Staff,18,0,35,17
1746550407584,ECON 175,A00,887626,Wu; Pak Yeung,23,0,35,12
1746550408610,ECON 190,A00,887640,Vespa; Emanuel Ignacio,23,0,35,12
1746550409635,EDS 25,A01,888197,Staff,0,0,0,0
1746550409635,EDS 25,A02,888209,Staff,0,0,0,0
1746550409635,EDS 25,A03,888210,Staff,0,0,0,0
1746550409635,EDS 25,A04,888212,Staff,0,0,0,0
1746550409635,EDS 25,A05,888213,Staff,0,0,0,0
1746550409635,EDS 25,A06,888214,Staff,0,0,0,0
1746550409635,EDS 25,A07,888235,Staff,0,2,0,0
1746550409635,EDS 25,A08,888236,Staff,0,0,0,0
1746550409635,EDS 25,A09,888240,Staff,0,0,0,0
1746550409635,EDS 25,A10,888244,Staff,0,0,0,0
1746550409635,EDS 25,B01,888273,Staff,0,0,0,0
1746550409635,EDS 25,B02,888285,Staff,0,0,0,0
1746550409635,EDS 25,B03,888423,Staff,0,0,0,1
1746550409635,EDS 25,B04,888432,Staff,0,0,0,0
1746550409635,EDS 25,B05,888433,Staff,0,0,0,0
1746550409635,EDS 25,B06,888467,Staff,0,0,0,0
1746550409635,EDS 25,B07,888468,Staff,0,0,0,0
1746550409635,EDS 25,B08,888479,Staff,0,0,0,0
1746550409635,EDS 25,B09,888484,Staff,0,0,0,0
1746550409635,EDS 25,B10,888487,Staff,0,0,0,0
1746550410660,EDS 38,A01,907700,Choi; Bailey Miyeon,30,0,30,0
1746550411684,EDS 112,A01,888601,Chapman; Thandeka K,14,0,40,26
1746550412708,EDS 115,A00,888697,Mendez; Kathrina Mendoza,10,0,30,20
1746550413754,EDS 116,A01,888893,Staff,35,0,40,5
1746550415802,EDS 124AR,A00,889133,Staff,29,0,50,21
1746550415802,EDS 124AR,B00,907471,Simon; Elizabeth A,37,0,50,13
1746550416830,EDS 124BR,A00,889134,Simon; Elizabeth A,45,0,100,55
1746550417856,EDS 125,A00,889135,Staff,25,0,30,5
1746550418879,EDS 126,A01,889138,Staff,36,0,40,4
1746550419905,EDS 164R,A01,889142,Wishard Guerra; Alison G.,33,0,50,17
1746550420929,ENG 30,A01,886396,Staff,0,0,0,0
1746550420929,ENG 30,B01,886398,Staff,0,0,0,0
1746550421953,ENVR 102,A00,906150,Montejo; Carolina,23,0,25,2
1746550422980,ETHN 103A,A00,887236,Man; Simeon S,0,3,0,0
1746550424003,ETHN 113,A00,887239,Staff,16,0,30,14
1746550425028,ETHN 116,A00,887240,Staff,16,0,25,9
1746550426052,ETHN 117,A00,887241,Choi; Esther Min,28,0,30,2
1746550427076,ETHN 118,A00,887243,Staff,24,0,30,6
1746550428105,ETHN 127,A00,887248,Cuong; Marisol,11,0,15,4
1746550429128,ETHN 139,A00,887250,Staff,7,0,10,3
1746550430154,ETHN 142,A00,887252,Staff,10,0,30,20
1746550431181,ETHN 161,A00,887253,Browne; Errol Tsekani,24,0,30,6
1746550432207,ETHN 163FR,A00,887255,Burelle; Julie Sara Veronique,0,0,5,5
1746550433235,GLBH 20,A00,889149,Elwardani; Nile Regina,8,0,42,34
1746550435286,GLBH 111,A01,889152,Burgos; Jose L.,17,0,17,0
1746550436314,GLBH 150,A00,889181,Sloane; Julia Kathryn,0,5,15,15
1746550438367,HDS 60,A01,886406,Warstadt; Melissa Fawn,73,0,80,7
1746550439394,HIAF 111,A00,889324,Gyamfi; Bright,25,0,32,7
1746550440421,HIEA 131,A00,889328,Staff,16,0,32,16
1746550441449,HIEA 144,A00,889333,Henry; Todd A.,26,0,32,6
1746550442475,HIEA 154,A00,889336,Henry; Todd A.,24,0,32,8
1746550443502,HIEU 106,A00,889339,Staff,22,0,32,10
1746550445599,HIEU 114,A00,889340,Staff,3,0,32,29
1746550446625,HIEU 135GS,A00,889342,Patterson; Patrick H.,0,0,1,24
1746550447650,HIEU 137,A00,889343,Edington; Claire Ellen,9,0,25,16
1746550448679,HIEU 148,A00,889345,Staff,14,0,32,18
1746550449704,HIEU 154,A00,889346,Biess; Frank Peter,21,0,32,11
1746550450733,HILA 102,A00,889351,Staff,12,0,32,20
1746550451758,HILD 2A,A01,889221,Lewandoski; Julia Mavis,1,10,32,31
1746550452783,HILD 7B,A01,889225,Man; Simeon S,0,13,32,32
1746550453807,HILD 7C,A01,889288,Alvarez; Luis A,0,14,32,32
1746550454833,HILD 30,A01,889323,Staff,0,5,32,32
1746550456890,HISC 119,A00,889383,Golan; Tal,20,0,32,12
1746550457920,HIUS 103,A00,889384,Man; Simeon S,0,0,32,32
1746550458949,HIUS 117,A00,919797,Kwak; Nancy,18,0,32,14
1746550459974,HIUS 142A,A00,919788,Staff,22,0,32,10
1746550462025,HIUS 149,A00,889386,Gyamfi; Bright,27,0,32,5
1746550463055,HIUS 155,A00,889387,Alvarez; Luis A,14,0,32,18
1746550464082,HUM 3,A01,886499,Caldwell; Michael Alan,19,0,50,31
1746550465109,HUM 3GS,A00,886500,Rodriguez; Bretton Sigfred,0,0,0,28
1746550466135,HUM 3R,A01,886502,Markman; Kristina,0,36,50,50
1746550467185,HUM 4,A01,886504,Crum; Matthew Stephen,24,0,50,26
1746550467185,HUM 4,B01,886506,West; Geoffrey Scott,17,0,50,33
1746550468208,HUM 4GS,A00,886507,Staff,0,0,0,19
1746550469233,HUM 5,A01,886509,Staff,32,0,50,18
1746550470256,HUM 5R,A01,886511,Zavodny; Tatiana Sophia,0,39,50,50
1746550471281,JAPN 180,A00,886407,Staff,18,0,40,22
1746550472310,LATI 50,A01,886409,Martin-Cabrera; Luis,4,0,22,18
1746550472310,LATI 50,A02,886410,Martin-Cabrera; Luis,19,0,22,3
1746550472310,LATI 50,A03,886411,Martin-Cabrera; Luis,21,0,22,1
1746550472310,LATI 50,A04,886412,Martin-Cabrera; Luis,9,0,22,13
1746550473337,LAWS 101,A00,907664,Staff,28,0,60,32
1746550474362,LIAB 1A,A00,889388,Saab; Dima,17,0,20,3
1746550475387,LIAB 1AX,A00,889389,El Cheddadi; Youniss,17,0,20,3
1746550476411,LIFR 1C,A00,889391,Van Moer; Vinciane G,8,0,20,12
1746550477434,LIFR 1CX,A00,889392,Van Moer; Vinciane G,7,0,20,13
1746550478463,LIFR 1D,A00,889393,Van Moer; Vinciane G,7,0,20,13
1746550479487,LIFR 1DX,A00,889394,Van Moer; Vinciane G,8,0,20,12
1746550480513,LIGN 7,A00,886923,Staff,24,0,50,26
1746550481542,LIGN 17,A00,886924,Kehler; Andrew Scott,125,0,150,25
1746550482569,LTAM 110,A00,889395,Staff,15,0,30,15
1746550483593,LTAM 110GS,A00,958010,Rodriguez; Bretton Sigfred,0,0,0,28
1746550484618,LTCH 101,A00,889397,Staff,23,0,25,2
1746550485644,LTCS 130,A00,889398,Staff,23,0,25,2
1746550486671,LTEA 138,A00,889399,Staff,24,0,40,16
1746550487695,LTEN 149,A00,889400,Wesling; Megan E.,0,3,25,25
1746550488718,LTEN 169,A00,889401,Staff,20,0,25,5
1746550489747,LTEN 180,A00,889402,Staff,10,0,15,5
1746550490776,LTEN 181,A00,889403,Staff,21,0,25,4
1746550491803,LTWL 100,A00,889404,Myerston Santana; Jacobo,3,0,25,22
1746550492830,LTWL 180GS,A00,889405,Staff,0,0,20,20
1746550493858,LTWL 181,A00,889406,Staff,17,0,25,8
1746550494890,LTWL 184,A00,889475,Mukherjee; Silpa,22,0,25,3
1746550495917,LTWR 102C,A00,889486,Staff,29,0,30,1
1746550496941,LTWR 115W,A00,889491,Staff,0,2,15,15
1746550497967,MAE 8,A01,886905,Staff,0,2,0,0
1746550498996,MAE 11,A00,886906,Bandaru; Prabhakar,0,7,50,50
1746550500026,MAE 20,A00,886907,Evdokimenko; Ekaterina,44,0,70,26
1746550501056,MAE 30B,A00,886909,Ghazinejad; Maziar,26,0,45,19
1746550502082,MAE 101B,A00,886910,Saintillan; David,29,0,45,16
1746550503107,MAE 105,A00,886911,Bandaru; Prabhakar,18,0,50,32
1746550504132,MAE 107,B00,958024,Staff,8,0,50,42
1746550505158,MAE 143B,A00,886913,Bewley; Thomas R,7,0,40,33
1746550506181,MAE 148,A01,886915,Silberman; Jack,0,3,14,14
1746550507209,MAE 160,A00,886916,Evdokimenko; Ekaterina,31,0,60,29
1746550508234,MATH 3C,A01,889681,Staff,0,3,30,30
1746550508234,MATH 3C,A02,960048,Staff,25,0,30,5
1746550509259,MATH 10A,A01,889760,Staff,26,0,30,4
1746550509259,MATH 10A,A02,889783,Staff,29,0,30,1
1746550510289,MATH 10B,A01,889785,Verstraete; Jacques Allan,2,0,35,33
1746550510289,MATH 10B,A02,889795,Verstraete; Jacques Allan,4,0,35,31
1746550510289,MATH 10B,B01,889797,Verstraete; Jacques Allan,3,0,35,32
1746550510289,MATH 10B,B02,889828,Verstraete; Jacques Allan,3,0,35,32
1746550511313,MATH 10C,A01,889849,Habib; Yousaf,9,0,30,21
1746550511313,MATH 10C,A02,889852,Habib; Yousaf,14,0,30,16
1746550511313,MATH 10C,A03,889853,Habib; Yousaf,22,0,30,8
1746550511313,MATH 10C,A04,889858,Habib; Yousaf,20,0,30,10
1746550511313,MATH 10C,B01,889861,Staff,1,0,30,29
1746550511313,MATH 10C,B02,889862,Staff,24,0,30,6
1746550511313,MATH 10C,B03,889863,Staff,27,0,30,3
1746550511313,MATH 10C,B04,889967,Staff,23,0,30,7
1746550512339,MATH 18,A01,889974,Staff,7,0,30,23
1746550512339,MATH 18,A02,889977,Staff,20,0,30,10
1746550512339,MATH 18,B01,889984,Hardiman; Liam,22,0,30,8
1746550512339,MATH 18,B02,889985,Hardiman; Liam,25,0,30,5
1746550513365,MATH 20A,A01,889990,Suk; Andrew Hoon,30,0,35,5
1746550514395,MATH 20B,A01,889993,Ohm; Ko Woon,22,0,30,8
1746550514395,MATH 20B,A02,889994,Ohm; Ko Woon,30,0,30,0
1746550514395,MATH 20B,B01,889996,Ohm; Ko Woon,21,0,30,9
1746550514395,MATH 20B,B02,889997,Ohm; Ko Woon,23,0,30,7
1746550515419,MATH 20C,A01,889999,Hammock; Frances H,17,0,30,13
1746550515419,MATH 20C,A02,890003,Hammock; Frances H,23,0,30,7
1746550515419,MATH 20C,B01,890006,Hammock; Frances H,3,0,30,27
1746550515419,MATH 20C,B02,890007,Hammock; Frances H,11,0,30,19
1746550516448,MATH 20D,A01,890011,Cheng; Hsiao-Bing,1,1,30,29
1746550516448,MATH 20D,A02,890012,Cheng; Hsiao-Bing,14,0,30,16
1746550516448,MATH 20D,B01,890016,Cheng; Hsiao-Bing,13,0,30,17
1746550516448,MATH 20D,B02,890017,Cheng; Hsiao-Bing,13,0,30,17
1746550517473,MATH 20E,A01,890026,Harel; Guershon,1,0,30,29
1746550517473,MATH 20E,A02,890029,Harel; Guershon,23,0,30,7
1746550517473,MATH 20E,B01,890033,Harel; Guershon,7,0,30,23
1746550517473,MATH 20E,B02,890101,Harel; Guershon,21,0,30,9
1746550518500,MATH 102,A01,890104,Staff,17,0,30,13
1746550518500,MATH 102,A02,890105,Staff,27,0,30,3
1746550519529,MATH 103B,A01,890116,Salehi Golsefidy; Alireza,3,0,30,27
1746550519529,MATH 103B,B01,890118,Staff,0,3,34,34
1746550520554,MATH 109,A01,890121,Aliabadi Sr.; Mohsen,1,0,30,29
1746550520554,MATH 109,B01,890124,Upadrashta; Pranav Kumar,18,0,30,12
1746550521585,MATH 120A,A01,890126,Eggers; John Dietrich,13,0,30,17
1746550522610,MATH 142B,A01,890128,Ioana; Adrian,19,0,30,11
1746550522610,MATH 142B,A02,890129,Ioana; Adrian,13,0,30,17
1746550523634,MATH 154,A01,890174,Staff,0,0,30,30
1746550523634,MATH 154,A02,890182,Staff,0,0,30,30
1746550524662,MATH 168A,A01,890197,Dumitriu; Ioana,21,0,35,14
1746550525690,MATH 170A,A01,890240,Nie; Jiawang,1,0,30,29
1746550525690,MATH 170A,A02,890241,Nie; Jiawang,11,0,30,19
1746550525690,MATH 170A,A03,890249,Nie; Jiawang,23,0,30,7
1746550526714,MATH 170B,A01,957891,Nag; Panchali,13,0,35,22
1746550528765,MATH 181A,A01,908025,Staff,0,4,35,35
1746550528765,MATH 181A,A02,960115,Staff,27,0,35,8
1746550529790,MATH 181B,A01,959874,Staff,26,0,30,4
1746550530816,MATH 193B,A01,890265,Staff,0,4,35,35
1746550531841,MGT 4,A01,890311,Anderson; John Charles,42,0,88,46
1746550532868,MGT 5,A00,907740,Staff,13,0,98,85
1746550533891,MGT 12,A00,890312,Lindenberger; Wade Douglas,67,0,98,31
1746550534916,MGT 16,A00,957883,Staff,78,0,98,20
1746550536966,MGT 45,A00,890314,Pecore; Joseph P.,47,0,98,51
1746550537992,MGT 71,A00,890315,Staff,0,11,98,98
1746550539016,MGT 100,A00,890316,Yavorsky; Daniel Ryan,44,0,98,54
1746550540040,MGT 103,A00,890317,Ehrich; Kristine R,73,0,98,25
1746550541066,MGT 105,A00,890356,Bates; Kenneth Walter,0,7,98,98
1746550542152,MGT 112,A00,890360,Ehrich; Kristine R,55,0,98,43
1746550543178,MGT 127R,A00,907732,Zhu; Kevin Xiaoguo,23,0,98,75
1746550544208,MGT 131B,A00,890361,Anderson; John Charles,61,0,98,37
1746550545235,MGT 137,A00,890362,Lindenberger; Wade Douglas,65,0,98,33
1746550546261,MGT 160,A00,890369,Johnson; Erik Barry,9,0,98,89
1746550548312,MGT 164,A00,890372,Zimmermann; Carsten,0,39,98,98
1746550549338,MGT 180,A00,890374,Bliss; Barbara Ann,12,0,98,86
1746550550365,MMW 15,A01,886414,Chang; Edmond Yi-Teh,0,12,28,28
1746550550365,MMW 15,A02,886415,Chang; Edmond Yi-Teh,0,8,28,28
1746550550365,MMW 15,A03,886416,Chang; Edmond Yi-Teh,0,8,28,28
1746550550365,MMW 15,A04,886417,Chang; Edmond Yi-Teh,0,8,28,28
1746550550365,MMW 15,B01,886419,Chang; Edmond Yi-Teh,0,7,28,28
1746550550365,MMW 15,B02,886420,Chang; Edmond Yi-Teh,0,8,28,28
1746550550365,MMW 15,B03,886421,Chang; Edmond Yi-Teh,0,7,28,28
1746550550365,MMW 15,B04,886422,Chang; Edmond Yi-Teh,0,8,28,28
1746550550365,MMW 15,C01,886424,Staff,0,9,28,28
1746550550365,MMW 15,C02,886425,Staff,0,8,28,28
1746550550365,MMW 15,C03,886426,Staff,0,8,28,28
1746550550365,MMW 15,C04,886427,Staff,0,7,28,28
1746550550365,MMW 15,C05,958038,Staff,0,7,28,28
1746550550365,MMW 15,C06,958039,Staff,0,8,28,28
1746550551390,MMW 15GS,A00,906910,Patterson; Patrick H.,4,0,28,24
1746550552423,MMW 122R,A01,886429,Rahimi; Babak,0,13,28,28
1746550552423,MMW 122R,A02,886430,Rahimi; Babak,0,12,28,28
1746550552423,MMW 122R,A03,958040,Rahimi; Babak,0,11,28,28
1746550553450,MUS 1A,A01,890937,Staff,3,0,25,22
1746550553450,MUS 1A,A02,891035,Staff,6,0,25,19
1746550553450,MUS 1A,C01,958912,Staff,24,0,25,1
1746550553450,MUS 1A,C02,958913,Staff,25,0,25,0
1746550555503,MUS 2AK,A00,957092,Ohnishi; Takae,15,0,15,0
1746550556527,MUS 4,A01,891044,Staff,2,0,25,23
1746550556527,MUS 4,A02,891045,Staff,23,0,25,2
1746550556527,MUS 4,B01,891048,Staff,17,0,25,8
1746550556527,MUS 4,B02,891050,Staff,25,0,25,0
1746550557558,MUS 5,A01,957506,Dubnov; Shlomo,0,0,25,25
1746550557558,MUS 5,A02,957622,Dubnov; Shlomo,14,0,25,11
1746550557558,MUS 5,A03,957623,Dubnov; Shlomo,20,0,25,5
1746550558581,MUS 6,A01,891053,Freitas Caetano; Marcelo,24,0,25,1
1746550558581,MUS 6,A02,891054,Freitas Caetano; Marcelo,23,0,25,2
1746550559608,MUS 7,A01,891081,Staff,0,0,25,25
1746550559608,MUS 7,A02,891082,Staff,4,0,25,21
1746550560633,MUS 8GS,A00,891118,Borgo; David Garcia,0,0,25,25
1746550561656,MUS 11,A01,891140,Staff,11,0,25,14
1746550561656,MUS 11,A02,891141,Staff,22,0,25,3
1746550562681,MUS 13,A01,891143,Staff,8,0,25,17
1746550562681,MUS 13,A02,891144,Staff,24,0,25,1
1746550563712,MUS 15,A01,891146,Staff,9,0,25,16
1746550563712,MUS 15,A02,891148,Staff,21,0,25,4
1746550563712,MUS 15,B01,891150,Staff,18,0,25,7
1746550563712,MUS 15,B02,891151,Staff,25,0,25,0
1746550564737,MUS 20,A01,891153,Staff,5,0,20,15
1746550564737,MUS 20,A02,891155,Staff,14,0,20,6
1746550565766,MUS 80,A00,891156,Staff,19,0,25,6
1746550565766,MUS 80,B00,891157,Staff,23,0,25,2
1746550566791,MUS 130,A00,891158,Ohnishi; Takae,35,0,35,0
1746550567817,MUS 150GS,A01,891160,Borgo; David Garcia,0,0,25,25
1746550568842,MUS 170,A01,891162,Freitas Caetano; Marcelo,20,0,25,5
1746550568842,MUS 170,A02,891164,Freitas Caetano; Marcelo,21,0,25,4
1746550569869,NANO 11,A00,886220,Vazquez Mena; Oscar,13,0,15,2
1746550570895,NANO 15,A01,886222,Drews; Aaron,4,0,7,3
1746550571923,NANO 104,A00,886224,Sirbuly; Donald,18,0,25,7
1746550572946,PH 40,A00,886528,Staff,23,0,40,17
1746550573976,PH 45,A01,886799,Staff,35,0,40,5
1746550575003,PH 110,A00,886802,Staff,0,7,40,40
1746550576030,PH 172,A00,906716,Staff,19,0,35,16
1746550577057,PH 191,A00,886803,Staff,6,0,40,34
1746550578083,PHIL 1,A00,889500,Staff,19,0,30,11
1746550579109,PHIL 10,A01,889549,Grush; Rick Scott,15,0,22,7
1746550579109,PHIL 10,A02,889551,Grush; Rick Scott,22,0,22,0
1746550580138,PHIL 28,A01,889559,Lamey; Andy M.,0,1,31,31
1746550580138,PHIL 28,A02,889561,Lamey; Andy M.,0,1,30,30
1746550580138,PHIL 28,A03,889572,Lamey; Andy M.,0,1,30,30
1746550581169,PHIL 35,A00,907839,Staff,13,0,15,2
1746550582200,PHIL 60,A00,889574,Staff,74,0,90,16
1746550583227,PHIL 101,A00,958004,Staff,13,0,15,2
1746550585279,PHIL 136,A00,889582,Fulkerson; Matthew Todd,26,0,45,19
1746550586309,PHIL 163,A01,889601,Staff,21,0,30,9
1746550586309,PHIL 163,B01,889606,Brandt; Reuven A,0,3,0,0
1746550587335,PHIL 164,A00,889610,Staff,16,0,30,14
1746550588361,PHIL 165,A00,889613,Staff,23,0,30,7
1746550589392,PHYS 1A,A00,886431,Staff,26,0,70,44
1746550590420,PHYS 1AL,001,886432,Tsai; Philbert S,0,2,30,30
1746550590420,PHYS 1AL,002,886436,Tsai; Philbert S,11,0,30,19
1746550591446,PHYS 1B,A00,886439,Staff,185,0,240,55
1746550592469,PHYS 1BL,001,886441,Tsai; Philbert S,0,4,30,30
1746550592469,PHYS 1BL,002,886444,Tsai; Philbert S,2,0,30,28
1746550593497,PHYS 1C,A00,896092,Arnold; Kam S,78,0,146,68
1746550594525,PHYS 1CL,001,886448,Tsai; Philbert S,0,0,30,30
1746550594525,PHYS 1CL,002,886449,Tsai; Philbert S,0,0,30,30
1746550594525,PHYS 1CL,003,886450,Tsai; Philbert S,16,0,30,14
1746550594525,PHYS 1CL,004,886451,Tsai; Philbert S,15,0,30,15
1746550595552,PHYS 2B,A01,886457,Staff,69,0,115,46
1746550596576,PHYS 2C,A01,886460,Shotwell; Brian,0,8,65,65
1746550597602,PHYS 2CL,A01,886467,Staff,0,4,28,28
1746550597602,PHYS 2CL,A02,886468,Staff,0,3,28,28
1746550598629,PHYS 2D,A01,886470,Staff,10,0,50,40
1746550599653,PHYS 4B,A01,886475,Grinstein; Benjamin,22,0,40,18
1746550600677,POLI 5,A00,891173,Desposato; Scott,7,0,25,18
1746550601702,POLI 5D,A01,891175,Staff,5,0,5,0
1746550601702,POLI 5D,B01,891178,Staff,5,0,5,0
1746550602731,POLI 11,A00,891179,Ferree; Karen E,2,0,35,33
1746550603758,POLI 12,A00,891180,Staff,16,0,30,14
1746550604787,POLI 27,A01,891182,Staff,12,0,75,63
1746550605814,POLI 30,A00,891183,Staff,8,0,50,42
1746550606838,POLI 100B,A00,891244,Staff,5,1,35,30
1746550607863,POLI 100I,A00,891247,Staff,7,0,30,23
1746550608892,POLI 104J,A00,891248,Nichter; Maysa,14,0,30,16
1746550609921,POLI 104U,A00,891250,Nichter; Maysa,2,0,30,28
1746550611975,POLI 110B,A00,891255,Wiens; David,20,0,25,5
1746550613000,POLI 112A,A00,891256,Wiens; David,6,0,25,19
1746550614027,POLI 114BR,A00,891261,Staff,19,0,30,11
1746550615052,POLI 117R,A00,891262,Forman; Fonna,0,6,50,50
1746550616078,POLI 118,A00,891264,Ingham; Sean,17,0,25,8
1746550617106,POLI 124A,A00,891265,Staff,18,0,20,2
1746550618133,POLI 125D,A00,891266,Nichter; Simeon C,2,0,25,23
1746550619162,POLI 126,A00,891268,Nichter; Simeon C,7,0,25,18
1746550620189,POLI 126AA,A00,891272,Staff,17,0,25,8
1746550621216,POLI 130AA,A00,891273,Staff,15,0,20,5
1746550622247,POLI 134AA,A00,891274,Staff,4,0,20,16
1746550624296,POLI 138,A00,891278,Staff,21,0,25,4
1746550625325,POLI 142K,A00,891280,Staff,11,0,25,14
1746550626354,POLI 142M,A00,891281,Gartzke; Erik,17,0,30,13
1746550627378,POLI 142P,A00,891284,Staff,20,0,30,10
1746550628404,POLI 143,A00,891285,Gartzke; Erik,12,0,30,18
1746550629430,POLI 153,A00,891286,Staff,19,0,20,1
1746550631483,POLI 175,A00,891290,Staff,15,0,20,5
1746550632509,PSYC 1,A00,890674,Steiner; Eric Tomas,0,11,45,45
1746550633539,PSYC 2,A00,890676,Albright; Thomas D,21,0,35,14
1746550634566,PSYC 3,A00,890679,Staff,17,0,20,3
1746550635593,PSYC 6,A00,959858,Staff,20,0,20,0
1746550636623,PSYC 60,A01,890684,Rickard; Timothy C.,0,5,45,45
1746550637650,PSYC 70,A01,890689,Geller; Emma Harlan,7,0,30,23
1746550638674,PSYC 71,A01,959860,Staff,21,0,25,4
1746550639697,PSYC 100,A00,890690,Lacefield; Katharine I,0,50,180,180
1746550640722,PSYC 102,A00,890695,Staff,18,0,40,22
1746550641746,PSYC 105,A00,890699,Geller; Emma Harlan,71,0,100,29
1746550642771,PSYC 106,A00,890701,Gorman; Michael R.,5,0,30,25
1746550643800,PSYC 108,A00,890704,Adrian; Julia Anna,0,28,50,50
1746550644828,PSYC 118,A01,890712,Staff,11,0,30,19
1746550645854,PSYC 124,A00,890716,Chapman; Eddie Nathaniel,25,0,60,35
1746550646882,PSYC 131,A00,890717,Anagnostaras; Stephan,0,7,80,80
1746550647909,PSYC 137,A00,890719,Winkielman; Piotr,0,11,30,30
1746550648935,PSYC 144,A00,890721,Adrian; Julia Anna,0,9,45,45
1746550649965,PSYC 162,A00,890805,Staff,2,0,75,73
1746550650992,PSYC 169,A00,890810,Staff,0,15,30,30
1746550652017,PSYC 172,A00,890814,Gorman; Michael R.,9,0,30,21
1746550653041,PSYC 181,A00,890818,Anagnostaras; Stephan,8,0,200,192
1746550654069,PSYC 184,A00,959861,Staff,170,0,175,5
1746550655093,PSYC 189,A00,890823,Staff,0,1,30,30
1746550656119,PSYC 191,A00,890884,Rickard; Timothy C.,0,11,35,35
1746550657143,PSYC 193,A00,890913,Staff,19,0,30,11
1746550657143,PSYC 193,B00,890914,Chapman; Eddie Nathaniel,24,0,30,6
1746550658170,PSYC 193L,A01,890918,Lowe; Angela Beth,20,0,30,10
1746550658170,PSYC 193L,B01,890921,Hurwitz; Ethan Scott,20,0,30,10
1746550658170,PSYC 193L,C01,890928,Staff,30,0,30,0
1746550659198,RELI 149,A00,886806,Rahimi; Babak,23,0,40,17
1746550660226,SE 9,A01,886814,Staff,7,0,20,13
1746550661255,SE 101B,A01,886816,Chadha; Mayank,4,0,35,31
1746550662281,SE 110B,A00,886818,Zhu; Qiang,4,0,75,71
1746550663307,SE 125,A01,886830,Staff,10,0,30,20
1746550664332,SE 130B,A01,886835,Staff,14,0,40,26
1746550665360,SE 131A,A01,886838,Krysl; Petr,34,0,55,21
1746550666387,SE 154,A00,886840,Staff,30,0,50,20
1746550667412,SE 164GS,A01,886849,Staff,6,0,20,14
1746550668437,SE 167GS,A01,886853,Staff,6,0,20,14
1746550669461,SIO 25,A01,890107,Staff,19,0,30,11
1746550670487,SIO 45,A00,890109,Cook; Geoffrey W,117,0,200,83
1746550671514,SIO 109R,A00,890110,Forman; Fonna,0,16,20,20
1746550672542,SIO 187,A01,890114,Kacev; David,15,0,40,25
1746550673570,SOCI 1,A01,890431,Thorpe; Charles Robert,15,0,30,15
1746550673570,SOCI 1,A02,890518,Thorpe; Charles Robert,30,0,30,0
1746550674601,SOCI 2,A01,957978,Staff,25,0,25,0
1746550674601,SOCI 2,A02,957979,Staff,23,0,25,2
1746550675626,SOCI 20,A01,890523,Calderon-Zaks; Michael Aar,23,0,30,7
1746550675626,SOCI 20,A02,890526,Calderon-Zaks; Michael Aar,29,0,30,1
1746550676654,SOCI 30,A01,890533,Pardo Guerra; Juan Pablo,37,0,40,3
1746550677684,SOCI 40,A01,890535,Staff,27,0,45,18
1746550678710,SOCI 104Q,A00,890559,Staff,18,0,30,12
1746550679739,SOCI 106,A00,890560,Arnal; Maud Marie Leonie,20,0,30,10
1746550680763,SOCI 110,A00,890567,Holkenbrink-Monk; Charlene,19,0,30,11
1746550681789,SOCI 112,A00,890568,Victoria Torres; Pablo,1,0,55,54
1746550682817,SOCI 115,A00,890597,Arnal; Maud Marie Leonie,28,0,45,17
1746550684871,SOCI 121,A00,890604,Pardo Guerra; Juan Pablo,38,0,45,7
1746550685896,SOCI 126,A01,890608,Staff,8,0,10,2
1746550686924,SOCI 127,A00,890609,Staff,18,0,30,12
1746550687947,SOCI 131,A00,890610,Thorpe; Charles Robert,37,0,45,8
1746550688977,SOCI 135,A00,890615,Payne; Christine Anna,14,0,45,31
1746550690002,SOCI 139,A00,890620,Staff,38,0,45,7
1746550691029,SOCI 148E,A00,890622,Calderon-Zaks; Michael Aar,36,0,45,9
1746550692056,SOCI 150,A00,890623,Kohler; Kristopher M.,31,0,45,14
1746550693084,SOCI 157,A00,890625,Jules-Rosette; Bennetta W.,18,0,20,2
1746550694110,SOCI 160,A00,890627,Payne; Christine Anna,21,0,45,24
1746550695138,SYN 1,A00,886855,Fish; Gwendolyn Anne,0,0,0,0
1746550695138,SYN 1,B00,906086,Fish; Gwendolyn Anne,0,1,0,2
1746550696162,SYN 2R,A00,886860,Staff,0,17,15,15
1746550696162,SYN 2R,B00,906106,Atkinson; Arthur Laird,0,16,15,15
1746550697188,SYN 100,A01,886866,Browne; Emily,0,28,20,20
1746550697188,SYN 100,B01,906128,Rock; Martin,0,5,20,20
1746550697188,SYN 100,C01,906140,Deavenport; James Cary,0,3,20,20
1746550697188,SYN 100,D01,907816,Deavenport; James Cary,0,5,20,20
1746550698218,TDAC 1,A00,890286,Walsh; Kim C.,9,0,20,11
1746550699243,TDAC 101,A00,890296,Basso; Beatrice,16,0,20,4
1746550700273,TDDE 131,A00,890297,Staff,47,0,50,3
1746550701304,TDDM 1,A00,890287,Weinberg; Sadie,25,0,30,5
1746550702330,TDGE 11,A00,890288,Fulton; Julia,137,0,200,63
1746550702330,TDGE 11,B00,890289,Castro; Robert Jess,184,0,200,16
1746550703359,TDGE 25,B00,957359,Walsh; Kim C.,3,0,20,17
1746550704384,TDGE 40,A01,890292,Power; Jade Yukana,27,0,30,3
1746550705410,TDGE 124,A00,890298,Havis; Allan,0,1,50,50
1746550706436,TDGE 131R,A00,890299,Burelle; Julie Sara Veronique,15,0,42,27
1746550707464,TDHT 101,A00,890300,Staff,10,0,20,10
1746550708492,TDHT 109,A01,890302,Anderson; Mysia Anyse,31,0,40,9
1746550709520,TDMV 1,A00,890293,Arcidiacono; Kristin,18,0,30,12
1746550710546,TDMV 2,A00,890294,Weinberg; Sadie,23,0,30,7
1746550711574,TDMV 3,A00,957878,Arcidiacono; Kristin,28,0,30,2
1746550713623,TDMV 138,A00,890304,Jun; Grace Shin Hae,25,0,40,15
1746550714651,TDMV 140,A00,890305,Corrales; Joseph Bernales,25,0,30,5
1746550715675,TDMV 142,A00,890307,Caligagan; Tony,32,0,40,8
1746550716702,TDMV 144,A00,890308,Camaya; Michelle Ann,25,0,30,5
1746550717726,TDPW 1,A00,890295,Stein; Deborah Isobel,3,0,20,17
1746550718754,USP 2,A01,890272,Lerner; Amy M,6,0,20,14
1746550719780,USP 3,A01,890274,Staff,12,0,30,18
1746550720804,USP 15,A01,890276,Sun; Feiyang,17,0,30,13
1746550721831,USP 25,A00,890277,Shenkman; Michael Thomas,19,0,25,6
1746550722856,USP 138,A00,890278,Staff,13,0,25,12
1746550723880,USP 143,A00,890279,Staff,21,0,70,49
1746550724908,USP 144,A00,890280,Chowdhury; Muhammed Zohir,16,0,30,14
1746550725933,USP 150,A00,890281,Boomhower; Matthew Charles,4,0,30,26
1746550726962,USP 151,A00,890282,Staff,16,0,20,4
1746550727988,USP 162,A00,890283,Andrews; Abigail Leslie,16,0,20,4
1746550729014,USP 168,A00,920477,Kwak; Nancy,1,0,5,4
1746550730042,USP 181,A00,890284,Staff,3,0,20,17
1746550731068,USP 191A,A00,890285,Staff,13,0,20,7
1746550732095,VIS 101,A00,886512,Staff,25,0,75,50
1746550733120,VIS 103,A00,886513,Cruz; Edwin Teddy,61,0,75,14
1746550734144,VIS 108,A00,886514,Staff,3,0,15,12
1746550735169,VIS 127P,A00,886515,Shen; Kuiyi,80,0,146,66
1746550736202,VIS 149,A00,886516,Yoldas; Pinar,0,0,15,15
1746550737228,VIS 164,A00,886526,Erdmann; Dean,19,0,22,3
1746550738257,VIS 194S,A00,886527,Staff,61,0,75,14
1746550739281,WCWP 10A,C00,886484,Martiniuk; Jill,12,0,15,3
1746550740309,WCWP 10B,A00,886490,Uriarte; Emma,0,0,15,15
1746550740309,WCWP 10B,B00,886491,Dhir; Simrita,10,0,15,5
1746550740309,WCWP 10B,C00,886492,Ornelas; Tricia,0,0,15,15
1746550741336,WCWP 100,A00,886494,Young; Mark T,0,6,15,15
1746550743450,AAS 10,A01,886199,Childs; Dennis R.,0,3,0,0
1746550744474,ANAR 104,A01,886940,Shtienberg; Gilad,27,0,30,3
1746550745498,ANAR 120,A00,886953,Staff,12,0,20,8
1746550746524,ANBI 148,A01,886955,Wilder; Linnea Lorene,30,0,40,10
1746550748571,ANSC 122,A00,886957,Staff,25,0,30,5
1746550749599,ANSC 150,A00,886958,Sloane; Julia Kathryn,3,0,15,12
1746550750626,ANSC 156,A00,886959,Jenkins; Janis A.,0,1,15,15
1746550751650,ANSC 180,A00,886960,Staff,11,0,17,6
1746550752674,ANSC 188,A00,886961,Jassal; Aftab,9,0,25,16
1746550753698,ANSC 190,A00,886962,Jassal; Aftab,14,0,25,11
1746550754735,ANSC 191,A00,886963,Staff,18,0,20,2
1746550755764,ANTH 3,A01,891689,Staff,17,0,20,3
1746550756791,ANTH 5,A00,886933,Semendeferi; Ekaterini,16,0,20,4
1746550757819,ANTH 10,A00,886934,Staff,0,12,30,30
1746550758842,ANTH 21,A01,886936,Staff,40,0,60,20
1746550759868,ANTH 23,A01,886938,Staff,92,0,100,8
1746550760895,ANTH 105,A00,886964,Stewart; Alexander B,84,0,100,16
1746550761919,ANTH 108,A00,886965,Pedersen; David,9,0,20,11
1746550762943,AWP 10,001,886147,Staff,0,0,0,0
1746550762943,AWP 10,002,886148,Staff,0,0,0,0
1746550762943,AWP 10,003,886149,Staff,0,0,0,0
1746550762943,AWP 10,004,886150,Staff,0,0,0,0
1746550762943,AWP 10,005,886151,Staff,0,0,0,0
1746550762943,AWP 10,006,886152,Staff,0,0,0,0
1746550762943,AWP 10,007,886153,Staff,0,0,0,0
1746550762943,AWP 10,008,886154,Staff,0,0,0,0
1746550762943,AWP 10,009,886155,Staff,0,0,0,0
1746550762943,AWP 10,010,886156,Staff,0,0,0,0
1746550762943,AWP 10,011,886158,Staff,0,0,0,0
1746550762943,AWP 10,012,886160,Staff,0,0,0,0
1746550762943,AWP 10,013,886161,Staff,0,0,0,0
1746550762943,AWP 10,014,886162,Staff,0,0,0,0
1746550762943,AWP 10,015,886163,Staff,0,0,0,0
1746550762943,AWP 10,016,886164,Staff,0,0,0,0
1746550762943,AWP 10,017,886165,Staff,0,0,0,0
1746550762943,AWP 10,018,886166,Staff,0,0,0,0
1746550762943,AWP 10,019,886168,Staff,0,0,0,0
1746550762943,AWP 10,020,886170,Staff,0,0,0,0
1746550762943,AWP 10,021,886172,Staff,0,0,0,0
1746550763971,AWP 10R,001,886173,Staff,0,1,0,0
1746550763971,AWP 10R,002,886174,Staff,0,1,0,0
1746550763971,AWP 10R,003,886175,Staff,0,0,0,0
1746550763971,AWP 10R,004,886176,Staff,0,0,0,0
1746550763971,AWP 10R,005,886177,Staff,0,0,0,0
1746550763971,AWP 10R,006,886178,Staff,0,0,0,0
1746550763971,AWP 10R,007,886179,Staff,0,0,0,0
1746550763971,AWP 10R,008,886181,Staff,0,0,0,0
1746550763971,AWP 10R,009,886182,Staff,0,0,0,0
1746550763971,AWP 10R,010,886183,Staff,0,0,0,0
1746550763971,AWP 10R,011,886184,Staff,0,0,0,0
1746550763971,AWP 10R,012,886185,Staff,0,0,0,0
1746550763971,AWP 10R,013,886186,Staff,0,0,0,0
1746550763971,AWP 10R,014,886187,Staff,0,0,0,0
1746550763971,AWP 10R,015,886188,Staff,0,0,0,0
1746550763971,AWP 10R,016,886189,Staff,0,0,0,0
1746550764998,AWP 102R,A00,886190,Staff,0,0,0,0
1746550764998,AWP 102R,B00,886191,Staff,0,0,0,0
1746550766026,BENG 100,A01,886193,Staff,17,0,30,13
1746550767054,BENG 122A,A01,886195,Hasty; Jeff M,13,0,30,17
1746550768081,BENG 166A,A00,886196,Sah; Robert Lie-Yuan,0,1,30,30
1746550769106,BENG 190,A00,958050,Khojah; Reem I,24,0,25,1
1746550770132,BIBC 102,A01,894320,Staff,0,0,46,46
1746550770132,BIBC 102,A02,894321,Staff,0,0,46,46
1746550770132,BIBC 102,A03,894344,Staff,7,0,46,39
1746550770132,BIBC 102,A04,894345,Staff,26,0,47,21
1746550771161,BICD 100R,A01,894365,Smith; Laurie,0,3,58,58
1746550771161,BICD 100R,A02,894366,Smith; Laurie,0,5,58,58
1746550771161,BICD 100R,A03,894367,Smith; Laurie,2,0,59,57
1746550771161,BICD 100R,A04,959869,Smith; Laurie,41,0,59,18
1746550772185,BICD 136,A01,894383,Gustafson-Brown; Cindy,14,0,50,36
1746550773210,BIEB 102,A01,894494,Butler; Shannon Rhey,51,0,130,79
1746550775260,BIEB 150,A01,894617,Wills; Christopher,3,0,20,17
1746550775260,BIEB 150,A02,894631,Wills; Christopher,3,0,20,17
1746550775260,BIEB 150,A03,894937,Wills; Christopher,3,0,20,17
1746550775260,BIEB 150,A04,894946,Wills; Christopher,5,0,20,15
1746550776285,BIEB 194,A00,906141,Kurle; Carolyn M.,6,0,20,14
1746550777314,BILD 1,A01,894154,Staff,2,0,19,17
1746550777314,BILD 1,A02,894155,Staff,14,0,19,5
1746550777314,BILD 1,A03,894160,Staff,13,0,19,6
1746550777314,BILD 1,A04,894161,Staff,15,0,18,3
1746550778340,BILD 2,A01,894168,Staff,0,0,50,50
1746550778340,BILD 2,A02,894169,Staff,0,0,50,50
1746550778340,BILD 2,A03,894179,Staff,4,0,50,46
1746550778340,BILD 2,A04,894203,Staff,27,0,50,23
1746550779365,BILD 3,A01,894213,Staff,22,0,31,9
1746550779365,BILD 3,A02,894214,Staff,26,0,31,5
1746550779365,BILD 3,A03,894235,Staff,28,0,31,3
1746550779365,BILD 3,A04,894236,Staff,28,0,32,4
1746550780389,BILD 4,A01,894253,Reuther; Keefe,5,0,24,19
1746550780389,BILD 4,A02,894258,Reuther; Keefe,16,0,24,8
1746550781416,BILD 5,A01,894276,Reuther; Keefe,35,0,50,15
1746550781416,BILD 5,A02,894277,Reuther; Keefe,45,0,50,5
1746550781416,BILD 5,A03,894290,Reuther; Keefe,44,0,50,6
1746550781416,BILD 5,A04,894291,Reuther; Keefe,48,0,50,2
1746550782441,BILD 24,A01,894297,Pirino; Giorgia,40,0,60,20
1746550783466,BIMM 100,B01,958915,Staff,72,0,100,28
1746550784496,BIMM 101,A01,895017,McDonnell; Lisa Marie,0,5,24,24
1746550784496,BIMM 101,A02,895018,McDonnell; Lisa Marie,0,5,24,24
1746550784496,BIMM 101,B01,895020,McDonnell; Lisa Marie,0,6,24,24
1746550784496,BIMM 101,B02,895021,McDonnell; Lisa Marie,0,4,24,24
1746550785521,BIMM 110,A01,895023,Staff,1,0,25,24
1746550785521,BIMM 110,A02,895024,Staff,9,0,25,16
1746550785521,BIMM 110,A03,895025,Staff,18,0,25,7
1746550785521,BIMM 110,A04,895031,Staff,20,0,25,5
1746550786551,BIMM 120,A01,895114,Gustafson-Brown; Cindy,14,0,28,14
1746550786551,BIMM 120,A02,895126,Gustafson-Brown; Cindy,21,0,27,6
1746550787575,BIPN 100,A01,895130,Yang; Mingyu,1,0,38,37
1746550787575,BIPN 100,A02,895131,Yang; Mingyu,32,0,38,6
1746550787575,BIPN 100,A03,895132,Yang; Mingyu,32,0,38,6
1746550787575,BIPN 100,A04,895133,Yang; Mingyu,27,0,36,9
1746550788601,BIPN 120,A01,895135,Cooke; James Edward,0,3,13,13
1746550788601,BIPN 120,A02,895136,Cooke; James Edward,0,1,13,13
1746550788601,BIPN 120,A03,895137,Cooke; James Edward,0,3,13,13
1746550788601,BIPN 120,A04,895156,Cooke; James Edward,0,2,11,11
1746550789625,BIPN 134,A01,895235,Cooke; James Edward,0,2,25,25
1746550789625,BIPN 134,A02,895237,Cooke; James Edward,0,0,25,25
1746550789625,BIPN 134,A03,895240,Cooke; James Edward,3,0,25,22
1746550789625,BIPN 134,A04,895270,Cooke; James Edward,20,0,25,5
1746550790651,BIPN 189,A00,892103,Staff,0,13,14,14
1746550792705,BISP 194,A00,958008,Staff,0,2,0,0
1746550793731,CAT 124,A01,922009,Staff,0,5,20,20
1746550794762,CAT 125R,A00,886390,Morales; Celeste Georgianna,0,2,20,20
1746550794762,CAT 125R,B00,886391,Irwin; Matthew Joseph,0,3,20,20
1746550794762,CAT 125R,C00,886392,Smith; Lauryn Alissa,0,2,20,20
1746550794762,CAT 125R,D00,886393,Vanderschuit; Maya Alysia,0,2,20,20
1746550794762,CAT 125R,E00,886394,Marchisotto; Jennifer Anne,0,4,20,20
1746550795787,CENG 15,A01,886218,Drews; Aaron,3,0,8,5
1746550796811,CENG 113,A00,886219,Opatkiewicz; Justin Paul,15,0,25,10
1746550797834,CGS 101,A00,887044,Staff,7,0,20,13
1746550798858,CGS 105,A01,887046,Staff,14,0,25,11
1746550799886,CGS 112,A00,887047,Cuong; Marisol,12,0,15,3
1746550800910,CGS 113,A00,887048,Staff,23,0,30,7
1746550801949,CGS 120,A00,887049,Staff,10,0,17,7
1746550802975,CHEM 6A,A01,886336,Lam; Tin Yiu,38,0,50,12
1746550802975,CHEM 6A,A02,886338,Lam; Tin Yiu,37,0,50,13
1746550804003,CHEM 6B,A01,886341,Hopkins; Patrycja Anna,16,0,50,34
1746550804003,CHEM 6B,A02,886343,Hopkins; Patrycja Anna,42,0,50,8
1746550805028,CHEM 6C,A01,886346,Albizati; Kim F.,0,2,50,50
1746550805028,CHEM 6C,A02,886348,Albizati; Kim F.,23,0,50,27
1746550806053,CHEM 40A,A01,886352,Klosterman; Jeremy K,65,0,100,35
1746550807077,CHEM 40B,A01,886356,Klosterman; Jeremy K,0,23,100,100
1746550808104,CHEM 41B,A01,886360,Theodorakis; Emmanuel,25,0,50,25
1746550808104,CHEM 41B,A02,886362,Theodorakis; Emmanuel,47,0,50,3
1746550809131,CHIN 165A,A00,886382,Xu; Li,18,0,20,2
1746550810156,CLAS 120,A00,886387,Myerston Santana; Jacobo,33,0,40,7
1746550811182,COGS 9,A01,886967,Shannon; Kyle Michael,42,0,60,18
1746550812206,COGS 11,A01,886969,Staff,11,0,30,19
1746550813234,COGS 14A,A01,886971,Staff,6,0,60,54
1746550814263,COGS 14B,A01,886973,Hoffman; Drew Ellen,4,0,60,56
1746550815290,COGS 18,A01,886975,Morgan; Eric,35,0,60,25
1746550816315,COGS 20,A01,886977,Staff,4,0,8,4
1746550816315,COGS 20,A02,886978,Staff,5,0,7,2
1746550817342,COGS 100,A01,907783,Staff,0,2,30,30
1746550818370,COGS 101B,A01,886980,Staff,0,3,48,48
1746550819393,COGS 101C,A01,886982,Delgado; Tania,0,5,44,44
1746550820420,COGS 102A,A01,886984,Johnson; Christine M.,4,0,30,26
1746550821447,COGS 118B,A01,886986,Staff,0,3,88,88
1746550822473,COGS 150,A01,886988,Bergen; Benjamin,23,0,50,27
1746550823501,COGS 153,A00,886989,Delgado; Tania,0,2,41,41
1746550824528,COGS 186,A01,886991,Staff,0,0,32,32
1746550825553,COGS 187A,A01,886993,Boyle; Mary E. T.,7,0,30,23
1746550826601,COGS 189,A00,886994,Staff,0,1,30,30
1746550827626,COMM 10,A01,886996,Staff,0,0,20,21
1746550827626,COMM 10,A02,886997,Staff,12,0,20,8
1746550827626,COMM 10,A03,959845,Staff,19,0,20,1
1746550828656,COMM 20,A01,886999,Leuning; Grant Maurstad,24,0,40,16
1746550830706,COMM 100A,A01,887002,Staff,0,0,20,25
1746550830706,COMM 100A,A02,887003,Staff,7,0,20,13
1746550831730,COMM 100B,A01,887005,Staff,0,8,20,24
1746550832758,COMM 106D,A00,887006,Staff,14,0,40,26
1746550833783,COMM 110G,A00,887007,Whitworth-Smith; Andrew C,12,0,40,28
1746550834810,COMM 111B,A00,887008,Staff,31,0,40,9
1746550835835,COMM 113T,A00,887009,Abuelhiga; Soraya Jill,28,0,40,12
1746550835835,COMM 113T,B00,906733,Staff,40,0,40,0
1746550836862,COMM 145,A00,887010,Staff,12,0,40,28
1746550837889,COMM 146,A00,887054,Staff,31,0,40,9
1746550838912,COMM 190,A00,887012,Staff,8,0,23,15
1746550839937,CSE 8A,A50,887015,Cao; Yingjun,57,0,85,28
1746550840962,CSE 11,A01,887017,Cao; Yingjun,12,0,70,58
1746550841989,CSE 20,A01,887019,Staff,30,0,50,20
1746550843015,CSE 21,A01,887021,Staff,78,0,100,22
1746550843015,CSE 21,B01,892583,Braun; Oliver,45,0,50,5
1746550844039,CSE 30,A01,887025,Eldon; John,143,0,200,57
1746550845063,CSE 100,A01,887027,Staff,26,0,50,24
1746550845063,CSE 100,A02,887028,Staff,40,0,50,10
1746550846090,CSE 101,A01,887030,Braun; Oliver,75,0,100,25
1746550846090,CSE 101,B01,887032,Jones; Miles E,0,3,50,50
1746550846090,CSE 101,B02,887033,Jones; Miles E,0,1,50,50
1746550847118,CSE 105,A01,908084,Jones; Miles E,32,0,50,18
1746550847118,CSE 105,A02,908087,Jones; Miles E,33,0,50,17
1746550848142,CSE 135,A01,887035,Powell; Thomas Allan,0,4,50,50
1746550849166,CSE 142,A01,887037,Staff,8,0,60,52
1746550850194,CSE 142L,A01,887039,Staff,34,0,60,26
1746550851221,CSE 151A,A01,887041,Solares; Edwin A,47,0,100,53
1746550852246,CSE 175,A01,887043,Kumar; Rakesh,30,0,30,0
1746550853271,CSS 1,A01,886389,Staff,0,1,40,40
1746550854297,DSC 30,A01,908097,Liao; Soohyun Nam,47,0,75,28
1746550855321,DSC 40A,A01,908099,Shannon; Kyle Michael,30,0,50,20
1746550856346,DSC 40B,A01,908112,Staff,16,0,50,34
1746550857374,DSC 80,A01,908116,Staff,19,0,60,41
1746550858399,DSC 197,001,956863,Eldridge; Justin Matthew,9999,0,9999,0
1746550859423,ECE 5,A01,886400,Morris; Karcher William,2,0,6,4
1746550859423,ECE 5,A02,886401,Morris; Karcher William,3,0,6,3
1746550860448,ECE 148,A01,886403,Silberman; Jack,0,14,14,14
1746550861472,ECON 1,A01,887265,Crane; Meredith Helen,12,0,70,58
1746550861472,ECON 1,B01,887268,Staff,43,0,50,7
1746550862496,ECON 2,A01,887273,Crane; Meredith Helen,56,0,70,14
1746550863557,ECON 3,A01,887279,Rondina; Giacomo,32,0,70,38
1746550864581,ECON 4,A01,887282,Anderson; John Charles,0,2,10,10
1746550865606,ECON 5,A01,887285,Staff,33,0,45,12
1746550865606,ECON 5,B01,887292,Staff,41,0,45,4
1746550866631,ECON 100A,A01,887337,Newhouse; Herbert S,54,0,70,16
1746550866631,ECON 100A,B01,887349,Staff,45,0,50,5
1746550867658,ECON 100B,A01,887361,Du; Songzi,29,0,70,41
1746550868684,ECON 100C,A01,887445,Newhouse; Herbert S,59,0,70,11
1746550869708,ECON 105,A00,887488,Vespa; Emanuel Ignacio,23,0,35,12
1746550870734,ECON 109,A01,887506,Shishkin; Denis,28,0,35,7
1746550871760,ECON 110A,A01,887568,Alon; Titan Michael,0,3,35,35
1746550871760,ECON 110A,B01,907601,Alon; Titan Michael,20,0,35,15
1746550872786,ECON 110B,A01,887598,Levkoff; Steven B.,0,23,70,70
1746550873809,ECON 112,A00,887599,Rondina; Giacomo,19,0,35,16
1746550874836,ECON 120A,A01,887603,Dai; Yinlin,36,0,70,34
1746550875859,ECON 120C,A01,887608,Sun; Yixiao,0,1,35,35
1746550875859,ECON 120C,B01,887614,Sun; Yixiao,0,0,35,35
1746550876883,ECON 138,A00,887621,Bharadwaj; Prashant,0,21,20,20
1746550877909,ECON 144,A00,958007,Squires; Dale E,13,0,35,22
1746550878936,ECON 171,A01,907666,Staff,18,0,35,17
1746550879964,ECON 175,A00,887626,Wu; Pak Yeung,23,0,35,12
1746550880989,ECON 190,A00,887640,Vespa; Emanuel Ignacio,23,0,35,12
1746550882017,EDS 25,A01,888197,Staff,0,0,0,0
1746550882017,EDS 25,A02,888209,Staff,0,0,0,0
1746550882017,EDS 25,A03,888210,Staff,0,0,0,0
1746550882017,EDS 25,A04,888212,Staff,0,0,0,0
1746550882017,EDS 25,A05,888213,Staff,0,0,0,0
1746550882017,EDS 25,A06,888214,Staff,0,0,0,0
1746550882017,EDS 25,A07,888235,Staff,0,2,0,0
1746550882017,EDS 25,A08,888236,Staff,0,0,0,0
1746550882017,EDS 25,A09,888240,Staff,0,0,0,0
1746550882017,EDS 25,A10,888244,Staff,0,0,0,0
1746550882017,EDS 25,B01,888273,Staff,0,0,0,0
1746550882017,EDS 25,B02,888285,Staff,0,0,0,0
1746550882017,EDS 25,B03,888423,Staff,0,0,0,1
1746550882017,EDS 25,B04,888432,Staff,0,0,0,0
1746550882017,EDS 25,B05,888433,Staff,0,0,0,0
1746550882017,EDS 25,B06,888467,Staff,0,0,0,0
1746550882017,EDS 25,B07,888468,Staff,0,0,0,0
1746550882017,EDS 25,B08,888479,Staff,0,0,0,0
1746550882017,EDS 25,B09,888484,Staff,0,0,0,0
1746550882017,EDS 25,B10,888487,Staff,0,0,0,0
1746550883041,EDS 38,A01,907700,Choi; Bailey Miyeon,30,0,30,0
1746550884066,EDS 112,A01,888601,Chapman; Thandeka K,14,0,40,26
1746550885097,EDS 115,A00,888697,Mendez; Kathrina Mendoza,10,0,30,20
1746550886122,EDS 116,A01,888893,Staff,35,0,40,5
1746550888175,EDS 124AR,A00,889133,Staff,29,0,50,21
1746550888175,EDS 124AR,B00,907471,Simon; Elizabeth A,37,0,50,13
1746550889199,EDS 124BR,A00,889134,Simon; Elizabeth A,45,0,100,55
1746550890228,EDS 125,A00,889135,Staff,25,0,30,5
1746550891252,EDS 126,A01,889138,Staff,36,0,40,4
1746550892276,EDS 164R,A01,889142,Wishard Guerra; Alison G.,33,0,50,17
1746550893301,ENG 30,A01,886396,Staff,0,0,0,0
1746550893301,ENG 30,B01,886398,Staff,0,0,0,0
1746550894326,ENVR 102,A00,906150,Montejo; Carolina,23,0,25,2
1746550895351,ETHN 103A,A00,887236,Man; Simeon S,0,3,0,0
1746550896380,ETHN 113,A00,887239,Staff,16,0,30,14
1746550897407,ETHN 116,A00,887240,Staff,16,0,25,9
1746550898434,ETHN 117,A00,887241,Choi; Esther Min,28,0,30,2
1746550899463,ETHN 118,A00,887243,Staff,24,0,30,6
1746550900494,ETHN 127,A00,887248,Cuong; Marisol,11,0,15,4
1746550901520,ETHN 139,A00,887250,Staff,7,0,10,3
1746550902545,ETHN 142,A00,887252,Staff,10,0,30,20
1746550903569,ETHN 161,A00,887253,Browne; Errol Tsekani,24,0,30,6
1746550904596,ETHN 163FR,A00,887255,Burelle; Julie Sara Veronique,0,0,5,5
1746550905623,GLBH 20,A00,889149,Elwardani; Nile Regina,8,0,42,34
1746550907674,GLBH 111,A01,889152,Burgos; Jose L.,17,0,17,0
1746550908702,GLBH 150,A00,889181,Sloane; Julia Kathryn,0,5,15,15
1746550910752,HDS 60,A01,886406,Warstadt; Melissa Fawn,73,0,80,7
1746550911779,HIAF 111,A00,889324,Gyamfi; Bright,25,0,32,7
1746550912805,HIEA 131,A00,889328,Staff,16,0,32,16
1746550913833,HIEA 144,A00,889333,Henry; Todd A.,26,0,32,6
1746550914857,HIEA 154,A00,889336,Henry; Todd A.,24,0,32,8
1746550915882,HIEU 106,A00,889339,Staff,22,0,32,10
1746550917935,HIEU 114,A00,889340,Staff,3,0,32,29
1746550918961,HIEU 135GS,A00,889342,Patterson; Patrick H.,0,0,1,24
1746550919988,HIEU 137,A00,889343,Edington; Claire Ellen,9,0,25,16
1746550921015,HIEU 148,A00,889345,Staff,14,0,32,18
1746550922041,HIEU 154,A00,889346,Biess; Frank Peter,21,0,32,11
1746550923068,HILA 102,A00,889351,Staff,12,0,32,20
1746550924101,HILD 2A,A01,889221,Lewandoski; Julia Mavis,1,10,32,31
1746550925127,HILD 7B,A01,889225,Man; Simeon S,0,13,32,32
1746550926151,HILD 7C,A01,889288,Alvarez; Luis A,0,14,32,32
1746550927176,HILD 30,A01,889323,Staff,0,5,32,32
1746550929248,HISC 119,A00,889383,Golan; Tal,20,0,32,12
1746550930274,HIUS 103,A00,889384,Man; Simeon S,0,0,32,32
1746550931300,HIUS 117,A00,919797,Kwak; Nancy,18,0,32,14
1746550932324,HIUS 142A,A00,919788,Staff,22,0,32,10
1746550934377,HIUS 149,A00,889386,Gyamfi; Bright,27,0,32,5
1746550935406,HIUS 155,A00,889387,Alvarez; Luis A,14,0,32,18
1746550936430,HUM 3,A01,886499,Caldwell; Michael Alan,19,0,50,31
1746550937455,HUM 3GS,A00,886500,Rodriguez; Bretton Sigfred,0,0,0,28
1746550938481,HUM 3R,A01,886502,Markman; Kristina,0,36,50,50
1746550939510,HUM 4,A01,886504,Crum; Matthew Stephen,24,0,50,26
1746550939510,HUM 4,B01,886506,West; Geoffrey Scott,17,0,50,33
1746550940533,HUM 4GS,A00,886507,Staff,0,0,0,19
1746550941556,HUM 5,A01,886509,Staff,32,0,50,18
1746550942588,HUM 5R,A01,886511,Zavodny; Tatiana Sophia,0,39,50,50
1746550943614,JAPN 180,A00,886407,Staff,18,0,40,22
1746550944642,LATI 50,A01,886409,Martin-Cabrera; Luis,4,0,22,18
1746550944642,LATI 50,A02,886410,Martin-Cabrera; Luis,19,0,22,3
1746550944642,LATI 50,A03,886411,Martin-Cabrera; Luis,21,0,22,1
1746550944642,LATI 50,A04,886412,Martin-Cabrera; Luis,9,0,22,13
1746550945669,LAWS 101,A00,907664,Staff,28,0,60,32
1746550946693,LIAB 1A,A00,889388,Saab; Dima,17,0,20,3
1746550947721,LIAB 1AX,A00,889389,El Cheddadi; Youniss,17,0,20,3
1746550948748,LIFR 1C,A00,889391,Van Moer; Vinciane G,8,0,20,12
1746550949774,LIFR 1CX,A00,889392,Van Moer; Vinciane G,7,0,20,13
1746550950798,LIFR 1D,A00,889393,Van Moer; Vinciane G,7,0,20,13
1746550951827,LIFR 1DX,A00,889394,Van Moer; Vinciane G,8,0,20,12
1746550952852,LIGN 7,A00,886923,Staff,24,0,50,26
1746550953879,LIGN 17,A00,886924,Kehler; Andrew Scott,125,0,150,25
1746550954903,LTAM 110,A00,889395,Staff,15,0,30,15
1746550955927,LTAM 110GS,A00,958010,Rodriguez; Bretton Sigfred,0,0,0,28
1746550956953,LTCH 101,A00,889397,Staff,23,0,25,2
1746550957980,LTCS 130,A00,889398,Staff,23,0,25,2
1746550959007,LTEA 138,A00,889399,Staff,24,0,40,16
1746550960033,LTEN 149,A00,889400,Wesling; Megan E.,0,3,25,25
1746550961059,LTEN 169,A00,889401,Staff,20,0,25,5
1746550962084,LTEN 180,A00,889402,Staff,10,0,15,5
1746550963109,LTEN 181,A00,889403,Staff,21,0,25,4
1746550964134,LTWL 100,A00,889404,Myerston Santana; Jacobo,3,0,25,22
1746550965165,LTWL 180GS,A00,889405,Staff,0,0,20,20
1746550966194,LTWL 181,A00,889406,Staff,17,0,25,8
1746550967223,LTWL 184,A00,889475,Mukherjee; Silpa,22,0,25,3
1746550968247,LTWR 102C,A00,889486,Staff,29,0,30,1
1746550969276,LTWR 115W,A00,889491,Staff,0,2,15,15
1746550970300,MAE 8,A01,886905,Staff,0,2,0,0
1746550971325,MAE 11,A00,886906,Bandaru; Prabhakar,0,7,50,50
1746550972354,MAE 20,A00,886907,Evdokimenko; Ekaterina,44,0,70,26
1746550973380,MAE 30B,A00,886909,Ghazinejad; Maziar,26,0,45,19
1746550974407,MAE 101B,A00,886910,Saintillan; David,29,0,45,16
1746550975433,MAE 105,A00,886911,Bandaru; Prabhakar,18,0,50,32
1746550976462,MAE 107,B00,958024,Staff,8,0,50,42
1746550977488,MAE 143B,A00,886913,Bewley; Thomas R,7,0,40,33
1746550978512,MAE 148,A01,886915,Silberman; Jack,0,3,14,14
1746550979538,MAE 160,A00,886916,Evdokimenko; Ekaterina,31,0,60,29
1746550980567,MATH 3C,A01,889681,Staff,0,3,30,30
1746550980567,MATH 3C,A02,960048,Staff,25,0,30,5
1746550981592,MATH 10A,A01,889760,Staff,26,0,30,4
1746550981592,MATH 10A,A02,889783,Staff,29,0,30,1
1746550982621,MATH 10B,A01,889785,Verstraete; Jacques Allan,2,0,35,33
1746550982621,MATH 10B,A02,889795,Verstraete; Jacques Allan,4,0,35,31
1746550982621,MATH 10B,B01,889797,Verstraete; Jacques Allan,3,0,35,32
1746550982621,MATH 10B,B02,889828,Verstraete; Jacques Allan,3,0,35,32
1746550983646,MATH 10C,A01,889849,Habib; Yousaf,9,0,30,21
1746550983646,MATH 10C,A02,889852,Habib; Yousaf,14,0,30,16
1746550983646,MATH 10C,A03,889853,Habib; Yousaf,22,0,30,8
1746550983646,MATH 10C,A04,889858,Habib; Yousaf,20,0,30,10
1746550983646,MATH 10C,B01,889861,Staff,1,0,30,29
1746550983646,MATH 10C,B02,889862,Staff,24,0,30,6
1746550983646,MATH 10C,B03,889863,Staff,27,0,30,3
1746550983646,MATH 10C,B04,889967,Staff,23,0,30,7
1746550984677,MATH 18,A01,889974,Staff,7,0,30,23
1746550984677,MATH 18,A02,889977,Staff,20,0,30,10
1746550984677,MATH 18,B01,889984,Hardiman; Liam,22,0,30,8
1746550984677,MATH 18,B02,889985,Hardiman; Liam,25,0,30,5
1746550985707,MATH 20A,A01,889990,Suk; Andrew Hoon,30,0,35,5
1746550986734,MATH 20B,A01,889993,Ohm; Ko Woon,22,0,30,8
1746550986734,MATH 20B,A02,889994,Ohm; Ko Woon,30,0,30,0
1746550986734,MATH 20B,B01,889996,Ohm; Ko Woon,21,0,30,9
1746550986734,MATH 20B,B02,889997,Ohm; Ko Woon,23,0,30,7
1746550987760,MATH 20C,A01,889999,Hammock; Frances H,17,0,30,13
1746550987760,MATH 20C,A02,890003,Hammock; Frances H,23,0,30,7
1746550987760,MATH 20C,B01,890006,Hammock; Frances H,3,0,30,27
1746550987760,MATH 20C,B02,890007,Hammock; Frances H,11,0,30,19
1746550988790,MATH 20D,A01,890011,Cheng; Hsiao-Bing,1,1,30,29
1746550988790,MATH 20D,A02,890012,Cheng; Hsiao-Bing,14,0,30,16
1746550988790,MATH 20D,B01,890016,Cheng; Hsiao-Bing,13,0,30,17
1746550988790,MATH 20D,B02,890017,Cheng; Hsiao-Bing,13,0,30,17
1746550989815,MATH 20E,A01,890026,Harel; Guershon,1,0,30,29
1746550989815,MATH 20E,A02,890029,Harel; Guershon,23,0,30,7
1746550989815,MATH 20E,B01,890033,Harel; Guershon,7,0,30,23
1746550989815,MATH 20E,B02,890101,Harel; Guershon,21,0,30,9
1746550990843,MATH 102,A01,890104,Staff,17,0,30,13
1746550990843,MATH 102,A02,890105,Staff,27,0,30,3
1746550991868,MATH 103B,A01,890116,Salehi Golsefidy; Alireza,3,0,30,27
1746550991868,MATH 103B,B01,890118,Staff,0,3,34,34
1746550992897,MATH 109,A01,890121,Aliabadi Sr.; Mohsen,1,0,30,29
1746550992897,MATH 109,B01,890124,Upadrashta; Pranav Kumar,18,0,30,12
1746550993921,MATH 120A,A01,890126,Eggers; John Dietrich,13,0,30,17
1746550994946,MATH 142B,A01,890128,Ioana; Adrian,19,0,30,11
1746550994946,MATH 142B,A02,890129,Ioana; Adrian,13,0,30,17
1746550995972,MATH 154,A01,890174,Staff,0,0,30,30
1746550995972,MATH 154,A02,890182,Staff,0,0,30,30
1746550996999,MATH 168A,A01,890197,Dumitriu; Ioana,21,0,35,14
1746550998030,MATH 170A,A01,890240,Nie; Jiawang,1,0,30,29
1746550998030,MATH 170A,A02,890241,Nie; Jiawang,11,0,30,19
1746550998030,MATH 170A,A03,890249,Nie; Jiawang,23,0,30,7
1746550999059,MATH 170B,A01,957891,Nag; Panchali,13,0,35,22
1746551001111,MATH 181A,A01,908025,Staff,0,4,35,35
1746551001111,MATH 181A,A02,960115,Staff,27,0,35,8
1746551002137,MATH 181B,A01,959874,Staff,26,0,30,4
1746551003161,MATH 193B,A01,890265,Staff,0,4,35,35
1746551004185,MGT 4,A01,890311,Anderson; John Charles,42,0,88,46
1746551005213,MGT 5,A00,907740,Staff,13,0,98,85
1746551006240,MGT 12,A00,890312,Lindenberger; Wade Douglas,67,0,98,31
1746551007268,MGT 16,A00,957883,Staff,78,0,98,20
1746551009324,MGT 45,A00,890314,Pecore; Joseph P.,47,0,98,51
1746551010351,MGT 71,A00,890315,Staff,0,11,98,98
1746551011378,MGT 100,A00,890316,Yavorsky; Daniel Ryan,44,0,98,54
1746551012407,MGT 103,A00,890317,Ehrich; Kristine R,73,0,98,25
1746551013433,MGT 105,A00,890356,Bates; Kenneth Walter,0,7,98,98
1746551014462,MGT 112,A00,890360,Ehrich; Kristine R,55,0,98,43
1746551015487,MGT 127R,A00,907732,Zhu; Kevin Xiaoguo,23,0,98,75
1746551016515,MGT 131B,A00,890361,Anderson; John Charles,61,0,98,37
1746551017541,MGT 137,A00,890362,Lindenberger; Wade Douglas,65,0,98,33
1746551018569,MGT 160,A00,890369,Johnson; Erik Barry,9,0,98,89
1746551020617,MGT 164,A00,890372,Zimmermann; Carsten,0,39,98,98
1746551021643,MGT 180,A00,890374,Bliss; Barbara Ann,12,0,98,86
1746551022673,MMW 15,A01,886414,Chang; Edmond Yi-Teh,0,12,28,28
1746551022673,MMW 15,A02,886415,Chang; Edmond Yi-Teh,0,8,28,28
1746551022673,MMW 15,A03,886416,Chang; Edmond Yi-Teh,0,8,28,28
1746551022673,MMW 15,A04,886417,Chang; Edmond Yi-Teh,0,8,28,28
1746551022673,MMW 15,B01,886419,Chang; Edmond Yi-Teh,0,7,28,28
1746551022673,MMW 15,B02,886420,Chang; Edmond Yi-Teh,0,8,28,28
1746551022673,MMW 15,B03,886421,Chang; Edmond Yi-Teh,0,7,28,28
1746551022673,MMW 15,B04,886422,Chang; Edmond Yi-Teh,0,8,28,28
1746551022673,MMW 15,C01,886424,Staff,0,9,28,28
1746551022673,MMW 15,C02,886425,Staff,0,8,28,28
1746551022673,MMW 15,C03,886426,Staff,0,8,28,28
1746551022673,MMW 15,C04,886427,Staff,0,7,28,28
1746551022673,MMW 15,C05,958038,Staff,0,7,28,28
1746551022673,MMW 15,C06,958039,Staff,0,8,28,28
1746551023699,MMW 15GS,A00,906910,Patterson; Patrick H.,4,0,28,24
1746551024725,MMW 122R,A01,886429,Rahimi; Babak,0,13,28,28
1746551024725,MMW 122R,A02,886430,Rahimi; Babak,0,12,28,28
1746551024725,MMW 122R,A03,958040,Rahimi; Babak,0,11,28,28
1746551025753,MUS 1A,A01,890937,Staff,3,0,25,22
1746551025753,MUS 1A,A02,891035,Staff,6,0,25,19
1746551025753,MUS 1A,C01,958912,Staff,24,0,25,1
1746551025753,MUS 1A,C02,958913,Staff,25,0,25,0
1746551027803,MUS 2AK,A00,957092,Ohnishi; Takae,15,0,15,0
1746551028828,MUS 4,A01,891044,Staff,1,0,25,24
1746551028828,MUS 4,A02,891045,Staff,23,0,25,2
1746551028828,MUS 4,B01,891048,Staff,17,0,25,8
1746551028828,MUS 4,B02,891050,Staff,25,0,25,0
1746551029859,MUS 5,A01,957506,Dubnov; Shlomo,0,0,25,25
1746551029859,MUS 5,A02,957622,Dubnov; Shlomo,14,0,25,11
1746551029859,MUS 5,A03,957623,Dubnov; Shlomo,20,0,25,5
1746551030884,MUS 6,A01,891053,Freitas Caetano; Marcelo,24,0,25,1
1746551030884,MUS 6,A02,891054,Freitas Caetano; Marcelo,23,0,25,2
1746551031911,MUS 7,A01,891081,Staff,0,0,25,25
1746551031911,MUS 7,A02,891082,Staff,4,0,25,21
1746551032938,MUS 8GS,A00,891118,Borgo; David Garcia,0,0,25,25
1746551033964,MUS 11,A01,891140,Staff,11,0,25,14
1746551033964,MUS 11,A02,891141,Staff,22,0,25,3
1746551034996,MUS 13,A01,891143,Staff,8,0,25,17
1746551034996,MUS 13,A02,891144,Staff,24,0,25,1
1746551036022,MUS 15,A01,891146,Staff,9,0,25,16
1746551036022,MUS 15,A02,891148,Staff,21,0,25,4
1746551036022,MUS 15,B01,891150,Staff,18,0,25,7
1746551036022,MUS 15,B02,891151,Staff,25,0,25,0
1746551037052,MUS 20,A01,891153,Staff,5,0,20,15
1746551037052,MUS 20,A02,891155,Staff,14,0,20,6
1746551038076,MUS 80,A00,891156,Staff,19,0,25,6
1746551038076,MUS 80,B00,891157,Staff,23,0,25,2
1746551039107,MUS 130,A00,891158,Ohnishi; Takae,35,0,35,0
1746551040131,MUS 150GS,A01,891160,Borgo; David Garcia,0,0,25,25
1746551041156,MUS 170,A01,891162,Freitas Caetano; Marcelo,20,0,25,5
1746551041156,MUS 170,A02,891164,Freitas Caetano; Marcelo,21,0,25,4
1746551042181,NANO 11,A00,886220,Vazquez Mena; Oscar,13,0,15,2
1746551043208,NANO 15,A01,886222,Drews; Aaron,4,0,7,3
1746551044236,NANO 104,A00,886224,Sirbuly; Donald,18,0,25,7
1746551045260,PH 40,A00,886528,Staff,23,0,40,17
1746551046288,PH 45,A01,886799,Staff,35,0,40,5
1746551047315,PH 110,A00,886802,Staff,0,7,40,40
1746551048340,PH 172,A00,906716,Staff,19,0,35,16
1746551049367,PH 191,A00,886803,Staff,6,0,40,34
1746551050390,PHIL 1,A00,889500,Staff,19,0,30,11
1746551051418,PHIL 10,A01,889549,Grush; Rick Scott,15,0,22,7
1746551051418,PHIL 10,A02,889551,Grush; Rick Scott,22,0,22,0
1746551052443,PHIL 28,A01,889559,Lamey; Andy M.,0,1,31,31
1746551052443,PHIL 28,A02,889561,Lamey; Andy M.,0,1,30,30
1746551052443,PHIL 28,A03,889572,Lamey; Andy M.,0,1,30,30
1746551053469,PHIL 35,A00,907839,Staff,13,0,15,2
1746551054497,PHIL 60,A00,889574,Staff,74,0,90,16
1746551055523,PHIL 101,A00,958004,Staff,13,0,15,2
1746551057573,PHIL 136,A00,889582,Fulkerson; Matthew Todd,26,0,45,19
1746551058600,PHIL 163,A01,889601,Staff,21,0,30,9
1746551058600,PHIL 163,B01,889606,Brandt; Reuven A,0,3,0,0
1746551059627,PHIL 164,A00,889610,Staff,16,0,30,14
1746551060655,PHIL 165,A00,889613,Staff,23,0,30,7
1746551061680,PHYS 1A,A00,886431,Staff,26,0,70,44
1746551062704,PHYS 1AL,001,886432,Tsai; Philbert S,0,2,30,30
1746551062704,PHYS 1AL,002,886436,Tsai; Philbert S,11,0,30,19
1746551063730,PHYS 1B,A00,886439,Staff,185,0,240,55
1746551064755,PHYS 1BL,001,886441,Tsai; Philbert S,0,4,30,30
1746551064755,PHYS 1BL,002,886444,Tsai; Philbert S,2,0,30,28
1746551065844,PHYS 1C,A00,896092,Arnold; Kam S,78,0,146,68
1746551066872,PHYS 1CL,001,886448,Tsai; Philbert S,0,0,30,30
1746551066872,PHYS 1CL,002,886449,Tsai; Philbert S,0,0,30,30
1746551066872,PHYS 1CL,003,886450,Tsai; Philbert S,16,0,30,14
1746551066872,PHYS 1CL,004,886451,Tsai; Philbert S,15,0,30,15
1746551067899,PHYS 2B,A01,886457,Staff,69,0,115,46
1746551068927,PHYS 2C,A01,886460,Shotwell; Brian,0,8,65,65
1746551069954,PHYS 2CL,A01,886467,Staff,0,4,28,28
1746551069954,PHYS 2CL,A02,886468,Staff,0,3,28,28
1746551070980,PHYS 2D,A01,886470,Staff,10,0,50,40
1746551072009,PHYS 4B,A01,886475,Grinstein; Benjamin,22,0,40,18
1746551073033,POLI 5,A00,891173,Desposato; Scott,7,0,25,18
1746551074058,POLI 5D,A01,891175,Staff,5,0,5,0
1746551074058,POLI 5D,B01,891178,Staff,5,0,5,0
1746551075083,POLI 11,A00,891179,Ferree; Karen E,2,0,35,33
1746551076115,POLI 12,A00,891180,Staff,16,0,30,14
1746551077143,POLI 27,A01,891182,Staff,12,0,75,63
1746551078167,POLI 30,A00,891183,Staff,8,0,50,42
1746551079195,POLI 100B,A00,891244,Staff,5,1,35,30
1746551080222,POLI 100I,A00,891247,Staff,7,0,30,23
1746551081252,POLI 104J,A00,891248,Nichter; Maysa,14,0,30,16
1746551082279,POLI 104U,A00,891250,Nichter; Maysa,2,0,30,28
1746551084330,POLI 110B,A00,891255,Wiens; David,20,0,25,5
1746551085357,POLI 112A,A00,891256,Wiens; David,6,0,25,19
1746551086382,POLI 114BR,A00,891261,Staff,19,0,30,11
1746551087408,POLI 117R,A00,891262,Forman; Fonna,0,6,50,50
1746551088432,POLI 118,A00,891264,Ingham; Sean,17,0,25,8
1746551089460,POLI 124A,A00,891265,Staff,18,0,20,2
1746551090485,POLI 125D,A00,891266,Nichter; Simeon C,2,0,25,23
1746551091509,POLI 126,A00,891268,Nichter; Simeon C,7,0,25,18
1746551092534,POLI 126AA,A00,891272,Staff,17,0,25,8
1746551093562,POLI 130AA,A00,891273,Staff,15,0,20,5
1746551094589,POLI 134AA,A00,891274,Staff,4,0,20,16
1746551096640,POLI 138,A00,891278,Staff,21,0,25,4
1746551097664,POLI 142K,A00,891280,Staff,11,0,25,14
1746551098688,POLI 142M,A00,891281,Gartzke; Erik,17,0,30,13
1746551099713,POLI 142P,A00,891284,Staff,20,0,30,10
1746551100739,POLI 143,A00,891285,Gartzke; Erik,12,0,30,18
1746551101767,POLI 153,A00,891286,Staff,19,0,20,1
1746551103822,POLI 175,A00,891290,Staff,15,0,20,5
1746551104848,PSYC 1,A00,890674,Steiner; Eric Tomas,0,11,45,45
1746551105873,PSYC 2,A00,890676,Albright; Thomas D,21,0,35,14
1746551106901,PSYC 3,A00,890679,Staff,17,0,20,3
1746551107929,PSYC 6,A00,959858,Staff,20,0,20,0
1746551108959,PSYC 60,A01,890684,Rickard; Timothy C.,0,5,45,45
1746551109990,PSYC 70,A01,890689,Geller; Emma Harlan,7,0,30,23
1746551111013,PSYC 71,A01,959860,Staff,21,0,25,4
1746551112040,PSYC 100,A00,890690,Lacefield; Katharine I,0,50,180,180
1746551113068,PSYC 102,A00,890695,Staff,18,0,40,22
1746551114098,PSYC 105,A00,890699,Geller; Emma Harlan,71,0,100,29
1746551115126,PSYC 106,A00,890701,Gorman; Michael R.,5,0,30,25
1746551116152,PSYC 108,A00,890704,Adrian; Julia Anna,0,28,50,50
1746551117177,PSYC 118,A01,890712,Staff,11,0,30,19
1746551118202,PSYC 124,A00,890716,Chapman; Eddie Nathaniel,25,0,60,35
1746551119228,PSYC 131,A00,890717,Anagnostaras; Stephan,0,7,80,80
1746551120254,PSYC 137,A00,890719,Winkielman; Piotr,0,11,30,30
1746551121282,PSYC 144,A00,890721,Adrian; Julia Anna,0,9,45,45
1746551122309,PSYC 162,A00,890805,Staff,2,0,75,73
1746551123335,PSYC 169,A00,890810,Staff,0,15,30,30
1746551124360,PSYC 172,A00,890814,Gorman; Michael R.,9,0,30,21
1746551126400,PSYC 181,A00,890818,Anagnostaras; Stephan,8,0,200,192
1746551127428,PSYC 184,A00,959861,Staff,170,0,175,5
1746551128455,PSYC 189,A00,890823,Staff,0,1,30,30
1746551129480,PSYC 191,A00,890884,Rickard; Timothy C.,0,11,35,35
1746551130530,PSYC 193,A00,890913,Staff,19,0,30,11
1746551130530,PSYC 193,B00,890914,Chapman; Eddie Nathaniel,24,0,30,6
1746551131557,PSYC 193L,A01,890918,Lowe; Angela Beth,20,0,30,10
1746551131557,PSYC 193L,B01,890921,Hurwitz; Ethan Scott,20,0,30,10
1746551131557,PSYC 193L,C01,890928,Staff,30,0,30,0
1746551132586,RELI 149,A00,886806,Rahimi; Babak,23,0,40,17
1746551133611,SE 9,A01,886814,Staff,7,0,20,13
1746551134640,SE 101B,A01,886816,Chadha; Mayank,4,0,35,31
1746551135669,SE 110B,A00,886818,Zhu; Qiang,4,0,75,71
1746551136693,SE 125,A01,886830,Staff,10,0,30,20
1746551137717,SE 130B,A01,886835,Staff,14,0,40,26
1746551138747,SE 131A,A01,886838,Krysl; Petr,34,0,55,21
1746551139771,SE 154,A00,886840,Staff,30,0,50,20
1746551140795,SE 164GS,A01,886849,Staff,6,0,20,14
1746551141819,SE 167GS,A01,886853,Staff,6,0,20,14
1746551142846,SIO 25,A01,890107,Staff,19,0,30,11
1746551143870,SIO 45,A00,890109,Cook; Geoffrey W,117,0,200,83
1746551144896,SIO 109R,A00,890110,Forman; Fonna,0,16,20,20
1746551145923,SIO 187,A01,890114,Kacev; David,15,0,40,25
1746551146950,SOCI 1,A01,890431,Thorpe; Charles Robert,15,0,30,15
1746551146950,SOCI 1,A02,890518,Thorpe; Charles Robert,30,0,30,0
1746551147975,SOCI 2,A01,957978,Staff,25,0,25,0
1746551147975,SOCI 2,A02,957979,Staff,23,0,25,2
1746551149005,SOCI 20,A01,890523,Calderon-Zaks; Michael Aar,23,0,30,7
1746551149005,SOCI 20,A02,890526,Calderon-Zaks; Michael Aar,29,0,30,1
1746551150031,SOCI 30,A01,890533,Pardo Guerra; Juan Pablo,37,0,40,3
1746551151056,SOCI 40,A01,890535,Staff,27,0,45,18
1746551152084,SOCI 104Q,A00,890559,Staff,18,0,30,12
1746551153111,SOCI 106,A00,890560,Arnal; Maud Marie Leonie,20,0,30,10
1746551154138,SOCI 110,A00,890567,Holkenbrink-Monk; Charlene,19,0,30,11
1746551155168,SOCI 112,A00,890568,Victoria Torres; Pablo,1,0,55,54
1746551156195,SOCI 115,A00,890597,Arnal; Maud Marie Leonie,28,0,45,17
1746551158246,SOCI 121,A00,890604,Pardo Guerra; Juan Pablo,38,0,45,7
1746551159276,SOCI 126,A01,890608,Staff,8,0,10,2
1746551160300,SOCI 127,A00,890609,Staff,18,0,30,12
1746551161325,SOCI 131,A00,890610,Thorpe; Charles Robert,37,0,45,8
1746551162349,SOCI 135,A00,890615,Payne; Christine Anna,14,0,45,31
1746551163375,SOCI 139,A00,890620,Staff,38,0,45,7
1746551164398,SOCI 148E,A00,890622,Calderon-Zaks; Michael Aar,36,0,45,9
1746551165424,SOCI 150,A00,890623,Kohler; Kristopher M.,31,0,45,14
1746551166450,SOCI 157,A00,890625,Jules-Rosette; Bennetta W.,18,0,20,2
1746551167474,SOCI 160,A00,890627,Payne; Christine Anna,21,0,45,24
1746551168501,SYN 1,A00,886855,Fish; Gwendolyn Anne,0,0,0,0
1746551168501,SYN 1,B00,906086,Fish; Gwendolyn Anne,0,1,0,2
1746551169529,SYN 2R,A00,886860,Staff,0,17,15,15
1746551169529,SYN 2R,B00,906106,Atkinson; Arthur Laird,0,16,15,15
1746551170556,SYN 100,A01,886866,Browne; Emily,0,28,20,20
1746551170556,SYN 100,B01,906128,Rock; Martin,0,5,20,20
1746551170556,SYN 100,C01,906140,Deavenport; James Cary,0,3,20,20
1746551170556,SYN 100,D01,907816,Deavenport; James Cary,0,5,20,20
1746551171581,TDAC 1,A00,890286,Walsh; Kim C.,9,0,20,11
1746551172604,TDAC 101,A00,890296,Basso; Beatrice,16,0,20,4
1746551173631,TDDE 131,A00,890297,Staff,47,0,50,3
1746551174658,TDDM 1,A00,890287,Weinberg; Sadie,25,0,30,5
1746551175685,TDGE 11,A00,890288,Fulton; Julia,137,0,200,63
1746551175685,TDGE 11,B00,890289,Castro; Robert Jess,184,0,200,16
1746551176714,TDGE 25,B00,957359,Walsh; Kim C.,3,0,20,17
1746551177739,TDGE 40,A01,890292,Power; Jade Yukana,27,0,30,3
1746551178762,TDGE 124,A00,890298,Havis; Allan,0,1,50,50
1746551179788,TDGE 131R,A00,890299,Burelle; Julie Sara Veronique,15,0,42,27
1746551180815,TDHT 101,A00,890300,Staff,10,0,20,10
1746551181838,TDHT 109,A01,890302,Anderson; Mysia Anyse,31,0,40,9
1746551182862,TDMV 1,A00,890293,Arcidiacono; Kristin,18,0,30,12
1746551183888,TDMV 2,A00,890294,Weinberg; Sadie,23,0,30,7
1746551184916,TDMV 3,A00,957878,Arcidiacono; Kristin,28,0,30,2
1746551186967,TDMV 138,A00,890304,Jun; Grace Shin Hae,25,0,40,15
1746551187995,TDMV 140,A00,890305,Corrales; Joseph Bernales,25,0,30,5
1746551189019,TDMV 142,A00,890307,Caligagan; Tony,32,0,40,8
1746551190043,TDMV 144,A00,890308,Camaya; Michelle Ann,25,0,30,5
1746551191067,TDPW 1,A00,890295,Stein; Deborah Isobel,3,0,20,17
1746551192092,USP 2,A01,890272,Lerner; Amy M,6,0,20,14
1746551193117,USP 3,A01,890274,Staff,12,0,30,18
1746551194142,USP 15,A01,890276,Sun; Feiyang,17,0,30,13
1746551195168,USP 25,A00,890277,Shenkman; Michael Thomas,19,0,25,6
1746551196193,USP 138,A00,890278,Staff,13,0,25,12
1746551197217,USP 143,A00,890279,Staff,21,0,70,49
1746551198242,USP 144,A00,890280,Chowdhury; Muhammed Zohir,16,0,30,14
1746551199267,USP 150,A00,890281,Boomhower; Matthew Charles,4,0,30,26
1746551200294,USP 151,A00,890282,Staff,16,0,20,4
1746551201322,USP 162,A00,890283,Andrews; Abigail Leslie,16,0,20,4
1746551202349,USP 168,A00,920477,Kwak; Nancy,1,0,5,4
1746551203374,USP 181,A00,890284,Staff,3,0,20,17
1746551204404,USP 191A,A00,890285,Staff,13,0,20,7
1746551205431,VIS 101,A00,886512,Staff,25,0,75,50
1746551206454,VIS 103,A00,886513,Cruz; Edwin Teddy,61,0,75,14
1746551207482,VIS 108,A00,886514,Staff,3,0,15,12
1746551208511,VIS 127P,A00,886515,Shen; Kuiyi,80,0,146,66
1746551209539,VIS 149,A00,886516,Yoldas; Pinar,0,0,15,15
1746551210564,VIS 164,A00,886526,Erdmann; Dean,19,0,22,3
1746551211591,VIS 194S,A00,886527,Staff,61,0,75,14
1746551212617,WCWP 10A,C00,886484,Martiniuk; Jill,12,0,15,3
1746551213642,WCWP 10B,A00,886490,Uriarte; Emma,0,0,15,15
1746551213642,WCWP 10B,B00,886491,Dhir; Simrita,10,0,15,5
1746551213642,WCWP 10B,C00,886492,Ornelas; Tricia,0,0,15,15
1746551214667,WCWP 100,A00,886494,Young; Mark T,0,6,15,15
1746551216742,AAS 10,A01,886199,Childs; Dennis R.,0,3,0,0
1746551217767,ANAR 104,A01,886940,Shtienberg; Gilad,27,0,30,3
1746551218793,ANAR 120,A00,886953,Staff,12,0,20,8
1746551219818,ANBI 148,A01,886955,Wilder; Linnea Lorene,30,0,40,10
1746551221871,ANSC 122,A00,886957,Staff,25,0,30,5
1746551222896,ANSC 150,A00,886958,Sloane; Julia Kathryn,3,0,15,12
1746551223921,ANSC 156,A00,886959,Jenkins; Janis A.,0,1,15,15
1746551224949,ANSC 180,A00,886960,Staff,11,0,17,6
1746551225977,ANSC 188,A00,886961,Jassal; Aftab,9,0,25,16
1746551227002,ANSC 190,A00,886962,Jassal; Aftab,14,0,25,11
1746551228027,ANSC 191,A00,886963,Staff,18,0,20,2
1746551229053,ANTH 3,A01,891689,Staff,17,0,20,3
1746551230079,ANTH 5,A00,886933,Semendeferi; Ekaterini,16,0,20,4
1746551231107,ANTH 10,A00,886934,Staff,0,12,30,30
1746551232133,ANTH 21,A01,886936,Staff,40,0,60,20
1746551233158,ANTH 23,A01,886938,Staff,92,0,100,8
1746551234185,ANTH 105,A00,886964,Stewart; Alexander B,84,0,100,16
1746551235214,ANTH 108,A00,886965,Pedersen; David,9,0,20,11
1746551236243,AWP 10,001,886147,Staff,0,0,0,0
1746551236243,AWP 10,002,886148,Staff,0,0,0,0
1746551236243,AWP 10,003,886149,Staff,0,0,0,0
1746551236243,AWP 10,004,886150,Staff,0,0,0,0
1746551236243,AWP 10,005,886151,Staff,0,0,0,0
1746551236243,AWP 10,006,886152,Staff,0,0,0,0
1746551236243,AWP 10,007,886153,Staff,0,0,0,0
1746551236243,AWP 10,008,886154,Staff,0,0,0,0
1746551236243,AWP 10,009,886155,Staff,0,0,0,0
1746551236243,AWP 10,010,886156,Staff,0,0,0,0
1746551236243,AWP 10,011,886158,Staff,0,0,0,0
1746551236243,AWP 10,012,886160,Staff,0,0,0,0
1746551236243,AWP 10,013,886161,Staff,0,0,0,0
1746551236243,AWP 10,014,886162,Staff,0,0,0,0
1746551236243,AWP 10,015,886163,Staff,0,0,0,0
1746551236243,AWP 10,016,886164,Staff,0,0,0,0
1746551236243,AWP 10,017,886165,Staff,0,0,0,0
1746551236243,AWP 10,018,886166,Staff,0,0,0,0
1746551236243,AWP 10,019,886168,Staff,0,0,0,0
1746551236243,AWP 10,020,886170,Staff,0,0,0,0
1746551236243,AWP 10,021,886172,Staff,0,0,0,0
1746551237270,AWP 10R,001,886173,Staff,0,1,0,0
1746551237270,AWP 10R,002,886174,Staff,0,1,0,0
1746551237270,AWP 10R,003,886175,Staff,0,0,0,0
1746551237270,AWP 10R,004,886176,Staff,0,0,0,0
1746551237270,AWP 10R,005,886177,Staff,0,0,0,0
1746551237270,AWP 10R,006,886178,Staff,0,0,0,0
1746551237270,AWP 10R,007,886179,Staff,0,0,0,0
1746551237270,AWP 10R,008,886181,Staff,0,0,0,0
1746551237270,AWP 10R,009,886182,Staff,0,0,0,0
1746551237270,AWP 10R,010,886183,Staff,0,0,0,0
1746551237270,AWP 10R,011,886184,Staff,0,0,0,0
1746551237270,AWP 10R,012,886185,Staff,0,0,0,0
1746551237270,AWP 10R,013,886186,Staff,0,0,0,0
1746551237270,AWP 10R,014,886187,Staff,0,0,0,0
1746551237270,AWP 10R,015,886188,Staff,0,0,0,0
1746551237270,AWP 10R,016,886189,Staff,0,0,0,0
1746551238299,AWP 102R,A00,886190,Staff,0,0,0,0
1746551238299,AWP 102R,B00,886191,Staff,0,0,0,0
1746551239323,BENG 100,A01,886193,Staff,17,0,30,13
1746551240386,BENG 122A,A01,886195,Hasty; Jeff M,13,0,30,17
1746551241413,BENG 166A,A00,886196,Sah; Robert Lie-Yuan,0,1,30,30
1746551242438,BENG 190,A00,958050,Khojah; Reem I,24,0,25,1
1746551243468,BIBC 102,A01,894320,Staff,0,0,46,46
1746551243468,BIBC 102,A02,894321,Staff,0,0,46,46
1746551243468,BIBC 102,A03,894344,Staff,7,0,46,39
1746551243468,BIBC 102,A04,894345,Staff,26,0,47,21
1746551244494,BICD 100R,A01,894365,Smith; Laurie,0,3,58,58
1746551244494,BICD 100R,A02,894366,Smith; Laurie,0,5,58,58
1746551244494,BICD 100R,A03,894367,Smith; Laurie,2,0,59,57
1746551244494,BICD 100R,A04,959869,Smith; Laurie,41,0,59,18
1746551245519,BICD 136,A01,894383,Gustafson-Brown; Cindy,14,0,50,36
1746551246544,BIEB 102,A01,894494,Butler; Shannon Rhey,51,0,130,79
1746551248596,BIEB 150,A01,894617,Wills; Christopher,3,0,20,17
1746551248596,BIEB 150,A02,894631,Wills; Christopher,3,0,20,17
1746551248596,BIEB 150,A03,894937,Wills; Christopher,3,0,20,17
1746551248596,BIEB 150,A04,894946,Wills; Christopher,5,0,20,15
1746551249621,BIEB 194,A00,906141,Kurle; Carolyn M.,6,0,20,14
1746551250646,BILD 1,A01,894154,Staff,2,0,19,17
1746551250646,BILD 1,A02,894155,Staff,14,0,19,5
1746551250646,BILD 1,A03,894160,Staff,13,0,19,6
1746551250646,BILD 1,A04,894161,Staff,15,0,18,3
1746551251675,BILD 2,A01,894168,Staff,0,0,50,50
1746551251675,BILD 2,A02,894169,Staff,0,0,50,50
1746551251675,BILD 2,A03,894179,Staff,4,0,50,46
1746551251675,BILD 2,A04,894203,Staff,27,0,50,23
1746551252700,BILD 3,A01,894213,Staff,22,0,31,9
1746551252700,BILD 3,A02,894214,Staff,26,0,31,5
1746551252700,BILD 3,A03,894235,Staff,28,0,31,3
1746551252700,BILD 3,A04,894236,Staff,28,0,32,4
1746551253728,BILD 4,A01,894253,Reuther; Keefe,5,0,24,19
1746551253728,BILD 4,A02,894258,Reuther; Keefe,16,0,24,8
1746551254755,BILD 5,A01,894276,Reuther; Keefe,35,0,50,15
1746551254755,BILD 5,A02,894277,Reuther; Keefe,45,0,50,5
1746551254755,BILD 5,A03,894290,Reuther; Keefe,44,0,50,6
1746551254755,BILD 5,A04,894291,Reuther; Keefe,48,0,50,2
1746551255783,BILD 24,A01,894297,Pirino; Giorgia,40,0,60,20
1746551256813,BIMM 100,B01,958915,Staff,72,0,100,28
1746551257841,BIMM 101,A01,895017,McDonnell; Lisa Marie,0,5,24,24
1746551257841,BIMM 101,A02,895018,McDonnell; Lisa Marie,0,5,24,24
1746551257841,BIMM 101,B01,895020,McDonnell; Lisa Marie,0,6,24,24
1746551257841,BIMM 101,B02,895021,McDonnell; Lisa Marie,0,4,24,24
1746551258869,BIMM 110,A01,895023,Staff,1,0,25,24
1746551258869,BIMM 110,A02,895024,Staff,9,0,25,16
1746551258869,BIMM 110,A03,895025,Staff,18,0,25,7
1746551258869,BIMM 110,A04,895031,Staff,20,0,25,5
1746551259894,BIMM 120,A01,895114,Gustafson-Brown; Cindy,14,0,28,14
1746551259894,BIMM 120,A02,895126,Gustafson-Brown; Cindy,21,0,27,6
1746551260919,BIPN 100,A01,895130,Yang; Mingyu,1,0,38,37
1746551260919,BIPN 100,A02,895131,Yang; Mingyu,32,0,38,6
1746551260919,BIPN 100,A03,895132,Yang; Mingyu,32,0,38,6
1746551260919,BIPN 100,A04,895133,Yang; Mingyu,27,0,36,9
1746551261946,BIPN 120,A01,895135,Cooke; James Edward,0,3,13,13
1746551261946,BIPN 120,A02,895136,Cooke; James Edward,0,1,13,13
1746551261946,BIPN 120,A03,895137,Cooke; James Edward,0,3,13,13
1746551261946,BIPN 120,A04,895156,Cooke; James Edward,0,2,11,11
1746551262972,BIPN 134,A01,895235,Cooke; James Edward,0,2,25,25
1746551262972,BIPN 134,A02,895237,Cooke; James Edward,0,0,25,25
1746551262972,BIPN 134,A03,895240,Cooke; James Edward,3,0,25,22
1746551262972,BIPN 134,A04,895270,Cooke; James Edward,20,0,25,5
1746551263997,BIPN 189,A00,892103,Staff,0,13,14,14
1746551266046,BISP 194,A00,958008,Staff,0,2,0,0
1746551267072,CAT 124,A01,922009,Staff,0,5,20,20
1746551268105,CAT 125R,A00,886390,Morales; Celeste Georgianna,0,2,20,20
1746551268105,CAT 125R,B00,886391,Irwin; Matthew Joseph,0,3,20,20
1746551268105,CAT 125R,C00,886392,Smith; Lauryn Alissa,0,2,20,20
1746551268105,CAT 125R,D00,886393,Vanderschuit; Maya Alysia,0,2,20,20
1746551268105,CAT 125R,E00,886394,Marchisotto; Jennifer Anne,0,4,20,20
1746551269129,CENG 15,A01,886218,Drews; Aaron,3,0,8,5
1746551270155,CENG 113,A00,886219,Opatkiewicz; Justin Paul,15,0,25,10
1746551271179,CGS 101,A00,887044,Staff,7,0,20,13
1746551272204,CGS 105,A01,887046,Staff,14,0,25,11
1746551273231,CGS 112,A00,887047,Cuong; Marisol,12,0,15,3
1746551274255,CGS 113,A00,887048,Staff,23,0,30,7
1746551275279,CGS 120,A00,887049,Staff,10,0,17,7
1746551276309,CHEM 6A,A01,886336,Lam; Tin Yiu,38,0,50,12
1746551276309,CHEM 6A,A02,886338,Lam; Tin Yiu,37,0,50,13
1746551277334,CHEM 6B,A01,886341,Hopkins; Patrycja Anna,16,0,50,34
1746551277334,CHEM 6B,A02,886343,Hopkins; Patrycja Anna,42,0,50,8
1746551278373,CHEM 6C,A01,886346,Albizati; Kim F.,0,2,50,50
1746551278373,CHEM 6C,A02,886348,Albizati; Kim F.,23,0,50,27
1746551279401,CHEM 40A,A01,886352,Klosterman; Jeremy K,65,0,100,35
1746551280430,CHEM 40B,A01,886356,Klosterman; Jeremy K,0,23,100,100
1746551281455,CHEM 41B,A01,886360,Theodorakis; Emmanuel,25,0,50,25
1746551281455,CHEM 41B,A02,886362,Theodorakis; Emmanuel,47,0,50,3
1746551282480,CHIN 165A,A00,886382,Xu; Li,18,0,20,2
1746551283509,CLAS 120,A00,886387,Myerston Santana; Jacobo,33,0,40,7
1746551284538,COGS 9,A01,886967,Shannon; Kyle Michael,42,0,60,18
1746551285563,COGS 11,A01,886969,Staff,11,0,30,19
1746551286591,COGS 14A,A01,886971,Staff,6,0,60,54
1746551287615,COGS 14B,A01,886973,Hoffman; Drew Ellen,4,0,60,56
1746551288643,COGS 18,A01,886975,Morgan; Eric,35,0,60,25
1746551289670,COGS 20,A01,886977,Staff,4,0,8,4
1746551289670,COGS 20,A02,886978,Staff,5,0,7,2
1746551290714,COGS 100,A01,907783,Staff,0,2,30,30
1746551291738,COGS 101B,A01,886980,Staff,0,3,48,48
1746551292767,COGS 101C,A01,886982,Delgado; Tania,0,5,44,44
1746551293792,COGS 102A,A01,886984,Johnson; Christine M.,4,0,30,26
1746551294819,COGS 118B,A01,886986,Staff,0,3,88,88
1746551295847,COGS 150,A01,886988,Bergen; Benjamin,23,0,50,27
1746551296874,COGS 153,A00,886989,Delgado; Tania,0,2,41,41
1746551297900,COGS 186,A01,886991,Staff,0,0,32,32
1746551298928,COGS 187A,A01,886993,Boyle; Mary E. T.,7,0,30,23
1746551299954,COGS 189,A00,886994,Staff,0,1,30,30
1746551300981,COMM 10,A01,886996,Staff,0,0,20,21
1746551300981,COMM 10,A02,886997,Staff,12,0,20,8
1746551300981,COMM 10,A03,959845,Staff,19,0,20,1
1746551302011,COMM 20,A01,886999,Leuning; Grant Maurstad,24,0,40,16
1746551304059,COMM 100A,A01,887002,Staff,0,0,20,25
1746551304059,COMM 100A,A02,887003,Staff,7,0,20,13
1746551305082,COMM 100B,A01,887005,Staff,0,8,20,24
1746551306109,COMM 106D,A00,887006,Staff,14,0,40,26
1746551307137,COMM 110G,A00,887007,Whitworth-Smith; Andrew C,12,0,40,28
1746551308164,COMM 111B,A00,887008,Staff,31,0,40,9
1746551309192,COMM 113T,A00,887009,Abuelhiga; Soraya Jill,28,0,40,12
1746551309192,COMM 113T,B00,906733,Staff,40,0,40,0
1746551310217,COMM 145,A00,887010,Staff,12,0,40,28
1746551311242,COMM 146,A00,887054,Staff,31,0,40,9
1746551312267,COMM 190,A00,887012,Staff,8,0,23,15
1746551313293,CSE 8A,A50,887015,Cao; Yingjun,57,0,85,28
1746551314317,CSE 11,A01,887017,Cao; Yingjun,12,0,70,58
1746551315347,CSE 20,A01,887019,Staff,30,0,50,20
1746551316375,CSE 21,A01,887021,Staff,78,0,100,22
1746551316375,CSE 21,B01,892583,Braun; Oliver,45,0,50,5
1746551317405,CSE 30,A01,887025,Eldon; John,143,0,200,57
1746551318432,CSE 100,A01,887027,Staff,26,0,50,24
1746551318432,CSE 100,A02,887028,Staff,40,0,50,10
1746551319457,CSE 101,A01,887030,Braun; Oliver,75,0,100,25
1746551319457,CSE 101,B01,887032,Jones; Miles E,0,3,50,50
1746551319457,CSE 101,B02,887033,Jones; Miles E,0,1,50,50
1746551320486,CSE 105,A01,908084,Jones; Miles E,32,0,50,18
1746551320486,CSE 105,A02,908087,Jones; Miles E,33,0,50,17
1746551321512,CSE 135,A01,887035,Powell; Thomas Allan,0,4,50,50
1746551322539,CSE 142,A01,887037,Staff,8,0,60,52
1746551323567,CSE 142L,A01,887039,Staff,34,0,60,26
1746551324596,CSE 151A,A01,887041,Solares; Edwin A,47,0,100,53
1746551325621,CSE 175,A01,887043,Kumar; Rakesh,30,0,30,0
1746551326645,CSS 1,A01,886389,Staff,0,1,40,40
1746551327674,DSC 30,A01,908097,Liao; Soohyun Nam,47,0,75,28
1746551328700,DSC 40A,A01,908099,Shannon; Kyle Michael,30,0,50,20
1746551329723,DSC 40B,A01,908112,Staff,16,0,50,34
1746551330753,DSC 80,A01,908116,Staff,19,0,60,41
1746551331779,DSC 197,001,956863,Eldridge; Justin Matthew,9999,0,9999,0
1746551332805,ECE 5,A01,886400,Morris; Karcher William,2,0,6,4
1746551332805,ECE 5,A02,886401,Morris; Karcher William,3,0,6,3
1746551333832,ECE 148,A01,886403,Silberman; Jack,0,14,14,14
1746551334859,ECON 1,A01,887265,Crane; Meredith Helen,12,0,70,58
1746551334859,ECON 1,B01,887268,Staff,43,0,50,7
1746551335886,ECON 2,A01,887273,Crane; Meredith Helen,56,0,70,14
1746551336911,ECON 3,A01,887279,Rondina; Giacomo,32,0,70,38
1746551337938,ECON 4,A01,887282,Anderson; John Charles,0,2,10,10
1746551338965,ECON 5,A01,887285,Staff,33,0,45,12
1746551338965,ECON 5,B01,887292,Staff,41,0,45,4
1746551339995,ECON 100A,A01,887337,Newhouse; Herbert S,54,0,70,16
1746551339995,ECON 100A,B01,887349,Staff,45,0,50,5
1746551341020,ECON 100B,A01,887361,Du; Songzi,29,0,70,41
1746551342049,ECON 100C,A01,887445,Newhouse; Herbert S,59,0,70,11
1746551343074,ECON 105,A00,887488,Vespa; Emanuel Ignacio,23,0,35,12
1746551344145,ECON 109,A01,887506,Shishkin; Denis,28,0,35,7
1746551345174,ECON 110A,A01,887568,Alon; Titan Michael,0,3,35,35
1746551345174,ECON 110A,B01,907601,Alon; Titan Michael,20,0,35,15
1746551346201,ECON 110B,A01,887598,Levkoff; Steven B.,0,23,70,70
1746551347226,ECON 112,A00,887599,Rondina; Giacomo,19,0,35,16
1746551348253,ECON 120A,A01,887603,Dai; Yinlin,36,0,70,34
1746551349278,ECON 120C,A01,887608,Sun; Yixiao,0,1,35,35
1746551349278,ECON 120C,B01,887614,Sun; Yixiao,0,0,35,35
1746551350304,ECON 138,A00,887621,Bharadwaj; Prashant,0,21,20,20
1746551351333,ECON 144,A00,958007,Squires; Dale E,13,0,35,22
1746551352359,ECON 171,A01,907666,Staff,18,0,35,17
1746551353383,ECON 175,A00,887626,Wu; Pak Yeung,23,0,35,12
1746551354411,ECON 190,A00,887640,Vespa; Emanuel Ignacio,23,0,35,12
1746551355445,EDS 25,A01,888197,Staff,0,0,0,0
1746551355445,EDS 25,A02,888209,Staff,0,0,0,0
1746551355445,EDS 25,A03,888210,Staff,0,0,0,0
1746551355445,EDS 25,A04,888212,Staff,0,0,0,0
1746551355445,EDS 25,A05,888213,Staff,0,0,0,0
1746551355445,EDS 25,A06,888214,Staff,0,0,0,0
1746551355445,EDS 25,A07,888235,Staff,0,2,0,0
1746551355445,EDS 25,A08,888236,Staff,0,0,0,0
1746551355445,EDS 25,A09,888240,Staff,0,0,0,0
1746551355445,EDS 25,A10,888244,Staff,0,0,0,0
1746551355445,EDS 25,B01,888273,Staff,0,0,0,0
1746551355445,EDS 25,B02,888285,Staff,0,0,0,0
1746551355445,EDS 25,B03,888423,Staff,0,0,0,1
1746551355445,EDS 25,B04,888432,Staff,0,0,0,0
1746551355445,EDS 25,B05,888433,Staff,0,0,0,0
1746551355445,EDS 25,B06,888467,Staff,0,0,0,0
1746551355445,EDS 25,B07,888468,Staff,0,0,0,0
1746551355445,EDS 25,B08,888479,Staff,0,0,0,0
1746551355445,EDS 25,B09,888484,Staff,0,0,0,0
1746551355445,EDS 25,B10,888487,Staff,0,0,0,0
1746551356473,EDS 38,A01,907700,Choi; Bailey Miyeon,30,0,30,0
1746551357499,EDS 112,A01,888601,Chapman; Thandeka K,14,0,40,26
1746551358524,EDS 115,A00,888697,Mendez; Kathrina Mendoza,10,0,30,20
1746551359549,EDS 116,A01,888893,Staff,35,0,40,5
1746551361599,EDS 124AR,A00,889133,Staff,29,0,50,21
1746551361599,EDS 124AR,B00,907471,Simon; Elizabeth A,37,0,50,13
1746551362626,EDS 124BR,A00,889134,Simon; Elizabeth A,45,0,100,55
1746551363652,EDS 125,A00,889135,Staff,25,0,30,5
1746551364678,EDS 126,A01,889138,Staff,36,0,40,4
1746551365704,EDS 164R,A01,889142,Wishard Guerra; Alison G.,33,0,50,17
1746551366733,ENG 30,A01,886396,Staff,0,0,0,0
1746551366733,ENG 30,B01,886398,Staff,0,0,0,0
1746551367760,ENVR 102,A00,906150,Montejo; Carolina,23,0,25,2
1746551368785,ETHN 103A,A00,887236,Man; Simeon S,0,3,0,0
1746551369813,ETHN 113,A00,887239,Staff,16,0,30,14
1746551370836,ETHN 116,A00,887240,Staff,16,0,25,9
1746551371864,ETHN 117,A00,887241,Choi; Esther Min,28,0,30,2
1746551372891,ETHN 118,A00,887243,Staff,24,0,30,6
1746551373916,ETHN 127,A00,887248,Cuong; Marisol,11,0,15,4
1746551374941,ETHN 139,A00,887250,Staff,7,0,10,3
1746551375965,ETHN 142,A00,887252,Staff,10,0,30,20
1746551376993,ETHN 161,A00,887253,Browne; Errol Tsekani,24,0,30,6
1746551378021,ETHN 163FR,A00,887255,Burelle; Julie Sara Veronique,0,0,5,5
1746551379050,GLBH 20,A00,889149,Elwardani; Nile Regina,8,0,42,34
1746551381102,GLBH 111,A01,889152,Burgos; Jose L.,17,0,17,0
1746551382126,GLBH 150,A00,889181,Sloane; Julia Kathryn,0,5,15,15
1746551384179,HDS 60,A01,886406,Warstadt; Melissa Fawn,73,0,80,7
1746551385205,HIAF 111,A00,889324,Gyamfi; Bright,25,0,32,7
1746551386231,HIEA 131,A00,889328,Staff,16,0,32,16
1746551387255,HIEA 144,A00,889333,Henry; Todd A.,26,0,32,6
1746551388282,HIEA 154,A00,889336,Henry; Todd A.,24,0,32,8
1746551389306,HIEU 106,A00,889339,Staff,22,0,32,10
1746551391357,HIEU 114,A00,889340,Staff,3,0,32,29
1746551392383,HIEU 135GS,A00,889342,Patterson; Patrick H.,0,0,1,24
1746551393407,HIEU 137,A00,889343,Edington; Claire Ellen,9,0,25,16
1746551394436,HIEU 148,A00,889345,Staff,14,0,32,18
1746551395462,HIEU 154,A00,889346,Biess; Frank Peter,21,0,32,11
1746551396486,HILA 102,A00,889351,Staff,12,0,32,20
1746551397510,HILD 2A,A01,889221,Lewandoski; Julia Mavis,1,10,32,31
1746551398533,HILD 7B,A01,889225,Man; Simeon S,0,13,32,32
1746551399560,HILD 7C,A01,889288,Alvarez; Luis A,0,14,32,32
1746551400604,HILD 30,A01,889323,Staff,0,5,32,32
1746551402655,HISC 119,A00,889383,Golan; Tal,20,0,32,12
1746551403683,HIUS 103,A00,889384,Man; Simeon S,0,0,32,32
1746551404708,HIUS 117,A00,919797,Kwak; Nancy,18,0,32,14
1746551405732,HIUS 142A,A00,919788,Staff,22,0,32,10
1746551407785,HIUS 149,A00,889386,Gyamfi; Bright,27,0,32,5
1746551408811,HIUS 155,A00,889387,Alvarez; Luis A,14,0,32,18
1746551409837,HUM 3,A01,886499,Caldwell; Michael Alan,19,0,50,31
1746551410862,HUM 3GS,A00,886500,Rodriguez; Bretton Sigfred,0,0,0,28
1746551411887,HUM 3R,A01,886502,Markman; Kristina,0,36,50,50
1746551412911,HUM 4,A01,886504,Crum; Matthew Stephen,24,0,50,26
1746551412911,HUM 4,B01,886506,West; Geoffrey Scott,17,0,50,33
1746551413939,HUM 4GS,A00,886507,Staff,0,0,0,19
1746551414964,HUM 5,A01,886509,Staff,32,0,50,18
1746551415989,HUM 5R,A01,886511,Zavodny; Tatiana Sophia,0,39,50,50
1746551417014,JAPN 180,A00,886407,Staff,18,0,40,22
1746551418043,LATI 50,A01,886409,Martin-Cabrera; Luis,4,0,22,18
1746551418043,LATI 50,A02,886410,Martin-Cabrera; Luis,19,0,22,3
1746551418043,LATI 50,A03,886411,Martin-Cabrera; Luis,21,0,22,1
1746551418043,LATI 50,A04,886412,Martin-Cabrera; Luis,9,0,22,13
1746551419073,LAWS 101,A00,907664,Staff,28,0,60,32
1746551420097,LIAB 1A,A00,889388,Saab; Dima,17,0,20,3
1746551421125,LIAB 1AX,A00,889389,El Cheddadi; Youniss,17,0,20,3
1746551422149,LIFR 1C,A00,889391,Van Moer; Vinciane G,8,0,20,12
1746551423178,LIFR 1CX,A00,889392,Van Moer; Vinciane G,7,0,20,13
1746551424202,LIFR 1D,A00,889393,Van Moer; Vinciane G,7,0,20,13
1746551425227,LIFR 1DX,A00,889394,Van Moer; Vinciane G,8,0,20,12
1746551426253,LIGN 7,A00,886923,Staff,24,0,50,26
1746551427278,LIGN 17,A00,886924,Kehler; Andrew Scott,125,0,150,25
1746551428303,LTAM 110,A00,889395,Staff,15,0,30,15
1746551429331,LTAM 110GS,A00,958010,Rodriguez; Bretton Sigfred,0,0,0,28
1746551430355,LTCH 101,A00,889397,Staff,23,0,25,2
1746551431382,LTCS 130,A00,889398,Staff,23,0,25,2
1746551432417,LTEA 138,A00,889399,Staff,24,0,40,16
1746551433443,LTEN 149,A00,889400,Wesling; Megan E.,0,3,25,25
1746551434470,LTEN 169,A00,889401,Staff,20,0,25,5
1746551435498,LTEN 180,A00,889402,Staff,10,0,15,5
1746551436524,LTEN 181,A00,889403,Staff,21,0,25,4
1746551437549,LTWL 100,A00,889404,Myerston Santana; Jacobo,3,0,25,22
1746551438572,LTWL 180GS,A00,889405,Staff,0,0,20,20
1746551439598,LTWL 181,A00,889406,Staff,17,0,25,8
1746551440623,LTWL 184,A00,889475,Mukherjee; Silpa,22,0,25,3
1746551441652,LTWR 102C,A00,889486,Staff,29,0,30,1
1746551442679,LTWR 115W,A00,889491,Staff,0,2,15,15
1746551443708,MAE 8,A01,886905,Staff,0,2,0,0
1746551444735,MAE 11,A00,886906,Bandaru; Prabhakar,0,7,50,50
1746551445766,MAE 20,A00,886907,Evdokimenko; Ekaterina,43,0,70,27
1746551446793,MAE 30B,A00,886909,Ghazinejad; Maziar,26,0,45,19
1746551447872,MAE 101B,A00,886910,Saintillan; David,29,0,45,16
1746551448899,MAE 105,A00,886911,Bandaru; Prabhakar,18,0,50,32
1746551449923,MAE 107,B00,958024,Staff,8,0,50,42
1746551450949,MAE 143B,A00,886913,Bewley; Thomas R,7,0,40,33
1746551451979,MAE 148,A01,886915,Silberman; Jack,0,3,14,14
1746551453006,MAE 160,A00,886916,Evdokimenko; Ekaterina,31,0,60,29
1746551454034,MATH 3C,A01,889681,Staff,0,3,30,30
1746551454034,MATH 3C,A02,960048,Staff,25,0,30,5
1746551455060,MATH 10A,A01,889760,Staff,26,0,30,4
1746551455060,MATH 10A,A02,889783,Staff,29,0,30,1
1746551456085,MATH 10B,A01,889785,Verstraete; Jacques Allan,2,0,35,33
1746551456085,MATH 10B,A02,889795,Verstraete; Jacques Allan,4,0,35,31
1746551456085,MATH 10B,B01,889797,Verstraete; Jacques Allan,3,0,35,32
1746551456085,MATH 10B,B02,889828,Verstraete; Jacques Allan,3,0,35,32
1746551457115,MATH 10C,A01,889849,Habib; Yousaf,9,0,30,21
1746551457115,MATH 10C,A02,889852,Habib; Yousaf,14,0,30,16
1746551457115,MATH 10C,A03,889853,Habib; Yousaf,22,0,30,8
1746551457115,MATH 10C,A04,889858,Habib; Yousaf,20,0,30,10
1746551457115,MATH 10C,B01,889861,Staff,1,0,30,29
1746551457115,MATH 10C,B02,889862,Staff,24,0,30,6
1746551457115,MATH 10C,B03,889863,Staff,27,0,30,3
1746551457115,MATH 10C,B04,889967,Staff,23,0,30,7
1746551458142,MATH 18,A01,889974,Staff,7,0,30,23
1746551458142,MATH 18,A02,889977,Staff,20,0,30,10
1746551458142,MATH 18,B01,889984,Hardiman; Liam,22,0,30,8
1746551458142,MATH 18,B02,889985,Hardiman; Liam,25,0,30,5
1746551459168,MATH 20A,A01,889990,Suk; Andrew Hoon,30,0,35,5
1746551460194,MATH 20B,A01,889993,Ohm; Ko Woon,22,0,30,8
1746551460194,MATH 20B,A02,889994,Ohm; Ko Woon,30,0,30,0
1746551460194,MATH 20B,B01,889996,Ohm; Ko Woon,21,0,30,9
1746551460194,MATH 20B,B02,889997,Ohm; Ko Woon,23,0,30,7
1746551461225,MATH 20C,A01,889999,Hammock; Frances H,17,0,30,13
1746551461225,MATH 20C,A02,890003,Hammock; Frances H,23,0,30,7
1746551461225,MATH 20C,B01,890006,Hammock; Frances H,3,0,30,27
1746551461225,MATH 20C,B02,890007,Hammock; Frances H,11,0,30,19
1746551462256,MATH 20D,A01,890011,Cheng; Hsiao-Bing,1,1,30,29
1746551462256,MATH 20D,A02,890012,Cheng; Hsiao-Bing,14,0,30,16
1746551462256,MATH 20D,B01,890016,Cheng; Hsiao-Bing,13,0,30,17
1746551462256,MATH 20D,B02,890017,Cheng; Hsiao-Bing,13,0,30,17
1746551463281,MATH 20E,A01,890026,Harel; Guershon,1,0,30,29
1746551463281,MATH 20E,A02,890029,Harel; Guershon,23,0,30,7
1746551463281,MATH 20E,B01,890033,Harel; Guershon,7,0,30,23
1746551463281,MATH 20E,B02,890101,Harel; Guershon,21,0,30,9
1746551464308,MATH 102,A01,890104,Staff,17,0,30,13
1746551464308,MATH 102,A02,890105,Staff,27,0,30,3
1746551465333,MATH 103B,A01,890116,Salehi Golsefidy; Alireza,3,0,30,27
1746551465333,MATH 103B,B01,890118,Staff,0,3,34,34
1746551466359,MATH 109,A01,890121,Aliabadi Sr.; Mohsen,1,0,30,29
1746551466359,MATH 109,B01,890124,Upadrashta; Pranav Kumar,18,0,30,12
1746551467384,MATH 120A,A01,890126,Eggers; John Dietrich,13,0,30,17
1746551468410,MATH 142B,A01,890128,Ioana; Adrian,19,0,30,11
1746551468410,MATH 142B,A02,890129,Ioana; Adrian,13,0,30,17
1746551469435,MATH 154,A01,890174,Staff,0,0,30,30
1746551469435,MATH 154,A02,890182,Staff,0,0,30,30
1746551470465,MATH 168A,A01,890197,Dumitriu; Ioana,21,0,35,14
1746551471494,MATH 170A,A01,890240,Nie; Jiawang,1,0,30,29
1746551471494,MATH 170A,A02,890241,Nie; Jiawang,11,0,30,19
1746551471494,MATH 170A,A03,890249,Nie; Jiawang,23,0,30,7
1746551472521,MATH 170B,A01,957891,Nag; Panchali,13,0,35,22
1746551474570,MATH 181A,A01,908025,Staff,0,4,35,35
1746551474570,MATH 181A,A02,960115,Staff,27,0,35,8
1746551475599,MATH 181B,A01,959874,Staff,25,0,30,5
1746551476628,MATH 193B,A01,890265,Staff,0,4,35,35
1746551477657,MGT 4,A01,890311,Anderson; John Charles,42,0,88,46
1746551478682,MGT 5,A00,907740,Staff,13,0,98,85
1746551479710,MGT 12,A00,890312,Lindenberger; Wade Douglas,67,0,98,31
1746551480736,MGT 16,A00,957883,Staff,78,0,98,20
1746551482789,MGT 45,A00,890314,Pecore; Joseph P.,47,0,98,51
1746551483816,MGT 71,A00,890315,Staff,0,11,98,98
1746551484841,MGT 100,A00,890316,Yavorsky; Daniel Ryan,44,0,98,54
1746551485869,MGT 103,A00,890317,Ehrich; Kristine R,73,0,98,25
1746551486896,MGT 105,A00,890356,Bates; Kenneth Walter,0,7,98,98
1746551487924,MGT 112,A00,890360,Ehrich; Kristine R,55,0,98,43
1746551488951,MGT 127R,A00,907732,Zhu; Kevin Xiaoguo,24,0,98,74
1746551489975,MGT 131B,A00,890361,Anderson; John Charles,61,0,98,37
1746551491085,MGT 137,A00,890362,Lindenberger; Wade Douglas,65,0,98,33
1746551492114,MGT 160,A00,890369,Johnson; Erik Barry,9,0,98,89
1746551494165,MGT 164,A00,890372,Zimmermann; Carsten,0,39,98,98
1746551495193,MGT 180,A00,890374,Bliss; Barbara Ann,12,0,98,86
1746551496218,MMW 15,A01,886414,Chang; Edmond Yi-Teh,0,12,28,28
1746551496218,MMW 15,A02,886415,Chang; Edmond Yi-Teh,0,8,28,28
1746551496218,MMW 15,A03,886416,Chang; Edmond Yi-Teh,0,8,28,28
1746551496218,MMW 15,A04,886417,Chang; Edmond Yi-Teh,0,8,28,28
1746551496218,MMW 15,B01,886419,Chang; Edmond Yi-Teh,0,7,28,28
1746551496218,MMW 15,B02,886420,Chang; Edmond Yi-Teh,0,8,28,28
1746551496218,MMW 15,B03,886421,Chang; Edmond Yi-Teh,0,7,28,28
1746551496218,MMW 15,B04,886422,Chang; Edmond Yi-Teh,0,8,28,28
1746551496218,MMW 15,C01,886424,Staff,0,9,28,28
1746551496218,MMW 15,C02,886425,Staff,0,8,28,28
1746551496218,MMW 15,C03,886426,Staff,0,8,28,28
1746551496218,MMW 15,C04,886427,Staff,0,7,28,28
1746551496218,MMW 15,C05,958038,Staff,0,7,28,28
1746551496218,MMW 15,C06,958039,Staff,0,8,28,28
1746551497244,MMW 15GS,A00,906910,Patterson; Patrick H.,4,0,28,24
1746551498269,MMW 122R,A01,886429,Rahimi; Babak,0,13,28,28
1746551498269,MMW 122R,A02,886430,Rahimi; Babak,0,12,28,28
1746551498269,MMW 122R,A03,958040,Rahimi; Babak,0,11,28,28
1746551499297,MUS 1A,A01,890937,Staff,3,0,25,22
1746551499297,MUS 1A,A02,891035,Staff,6,0,25,19
1746551499297,MUS 1A,C01,958912,Staff,24,0,25,1
1746551499297,MUS 1A,C02,958913,Staff,25,0,25,0
1746551501351,MUS 2AK,A00,957092,Ohnishi; Takae,15,0,15,0
1746551502380,MUS 4,A01,891044,Staff,1,0,25,24
1746551502380,MUS 4,A02,891045,Staff,23,0,25,2
1746551502380,MUS 4,B01,891048,Staff,17,0,25,8
1746551502380,MUS 4,B02,891050,Staff,25,0,25,0
1746551503410,MUS 5,A01,957506,Dubnov; Shlomo,0,0,25,25
1746551503410,MUS 5,A02,957622,Dubnov; Shlomo,14,0,25,11
1746551503410,MUS 5,A03,957623,Dubnov; Shlomo,20,0,25,5
1746551504439,MUS 6,A01,891053,Freitas Caetano; Marcelo,24,0,25,1
1746551504439,MUS 6,A02,891054,Freitas Caetano; Marcelo,23,0,25,2
1746551505467,MUS 7,A01,891081,Staff,0,0,25,25
1746551505467,MUS 7,A02,891082,Staff,4,0,25,21
1746551506493,MUS 8GS,A00,891118,Borgo; David Garcia,0,0,25,25
1746551507519,MUS 11,A01,891140,Staff,11,0,25,14
1746551507519,MUS 11,A02,891141,Staff,22,0,25,3
1746551508545,MUS 13,A01,891143,Staff,8,0,25,17
1746551508545,MUS 13,A02,891144,Staff,24,0,25,1
1746551509571,MUS 15,A01,891146,Staff,9,0,25,16
1746551509571,MUS 15,A02,891148,Staff,21,0,25,4
1746551509571,MUS 15,B01,891150,Staff,18,0,25,7
1746551509571,MUS 15,B02,891151,Staff,25,0,25,0
1746551510595,MUS 20,A01,891153,Staff,5,0,20,15
1746551510595,MUS 20,A02,891155,Staff,14,0,20,6
1746551511622,MUS 80,A00,891156,Staff,19,0,25,6
1746551511622,MUS 80,B00,891157,Staff,23,0,25,2
1746551512650,MUS 130,A00,891158,Ohnishi; Takae,35,0,35,0
1746551513676,MUS 150GS,A01,891160,Borgo; David Garcia,0,0,25,25
1746551514700,MUS 170,A01,891162,Freitas Caetano; Marcelo,20,0,25,5
1746551514700,MUS 170,A02,891164,Freitas Caetano; Marcelo,21,0,25,4
1746551515725,NANO 11,A00,886220,Vazquez Mena; Oscar,13,0,15,2
1746551516751,NANO 15,A01,886222,Drews; Aaron,4,0,7,3
1746551517776,NANO 104,A00,886224,Sirbuly; Donald,18,0,25,7
1746551518801,PH 40,A00,886528,Staff,23,0,40,17
1746551519827,PH 45,A01,886799,Staff,35,0,40,5
1746551520852,PH 110,A00,886802,Staff,0,7,40,40
1746551521876,PH 172,A00,906716,Staff,19,0,35,16
1746551522900,PH 191,A00,886803,Staff,6,0,40,34
1746551523925,PHIL 1,A00,889500,Staff,19,0,30,11
1746551524954,PHIL 10,A01,889549,Grush; Rick Scott,15,0,22,7
1746551524954,PHIL 10,A02,889551,Grush; Rick Scott,22,0,22,0
1746551525979,PHIL 28,A01,889559,Lamey; Andy M.,0,1,31,31
1746551525979,PHIL 28,A02,889561,Lamey; Andy M.,0,1,30,30
1746551525979,PHIL 28,A03,889572,Lamey; Andy M.,0,1,30,30
1746551527007,PHIL 35,A00,907839,Staff,13,0,15,2
1746551528033,PHIL 60,A00,889574,Staff,74,0,90,16
1746551529061,PHIL 101,A00,958004,Staff,13,0,15,2
1746551531113,PHIL 136,A00,889582,Fulkerson; Matthew Todd,26,0,45,19
1746551532139,PHIL 163,A01,889601,Staff,21,0,30,9
1746551532139,PHIL 163,B01,889606,Brandt; Reuven A,0,3,0,0
1746551533163,PHIL 164,A00,889610,Staff,16,0,30,14
1746551534190,PHIL 165,A00,889613,Staff,23,0,30,7
1746551535216,PHYS 1A,A00,886431,Staff,26,0,70,44
1746551536243,PHYS 1AL,001,886432,Tsai; Philbert S,0,2,30,30
1746551536243,PHYS 1AL,002,886436,Tsai; Philbert S,11,0,30,19
1746551537268,PHYS 1B,A00,886439,Staff,185,0,240,55
1746551538294,PHYS 1BL,001,886441,Tsai; Philbert S,0,4,30,30
1746551538294,PHYS 1BL,002,886444,Tsai; Philbert S,2,0,30,28
1746551539323,PHYS 1C,A00,896092,Arnold; Kam S,78,0,146,68
1746551540349,PHYS 1CL,001,886448,Tsai; Philbert S,0,0,30,30
1746551540349,PHYS 1CL,002,886449,Tsai; Philbert S,0,0,30,30
1746551540349,PHYS 1CL,003,886450,Tsai; Philbert S,16,0,30,14
1746551540349,PHYS 1CL,004,886451,Tsai; Philbert S,15,0,30,15
1746551541378,PHYS 2B,A01,886457,Staff,69,0,115,46
1746551542418,PHYS 2C,A01,886460,Shotwell; Brian,0,8,65,65
1746551543443,PHYS 2CL,A01,886467,Staff,0,4,28,28
1746551543443,PHYS 2CL,A02,886468,Staff,0,3,28,28
1746551544471,PHYS 2D,A01,886470,Staff,10,0,50,40
1746551545498,PHYS 4B,A01,886475,Grinstein; Benjamin,22,0,40,18
1746551546525,POLI 5,A00,891173,Desposato; Scott,7,0,25,18
1746551547553,POLI 5D,A01,891175,Staff,5,0,5,0
1746551547553,POLI 5D,B01,891178,Staff,5,0,5,0
1746551548577,POLI 11,A00,891179,Ferree; Karen E,2,0,35,33
1746551549601,POLI 12,A00,891180,Staff,16,0,30,14
1746551550631,POLI 27,A01,891182,Staff,12,0,75,63
1746551551697,POLI 30,A00,891183,Staff,8,0,50,42
1746551552724,POLI 100B,A00,891244,Staff,5,1,35,30
1746551553749,POLI 100I,A00,891247,Staff,7,0,30,23
1746551554775,POLI 104J,A00,891248,Nichter; Maysa,14,0,30,16
1746551555798,POLI 104U,A00,891250,Nichter; Maysa,2,0,30,28
1746551557851,POLI 110B,A00,891255,Wiens; David,20,0,25,5
1746551558876,POLI 112A,A00,891256,Wiens; David,6,0,25,19
1746551559904,POLI 114BR,A00,891261,Staff,19,0,30,11
1746551560929,POLI 117R,A00,891262,Forman; Fonna,0,6,50,50
1746551561956,POLI 118,A00,891264,Ingham; Sean,17,0,25,8
1746551562983,POLI 124A,A00,891265,Staff,18,0,20,2
1746551564009,POLI 125D,A00,891266,Nichter; Simeon C,2,0,25,23
1746551565033,POLI 126,A00,891268,Nichter; Simeon C,7,0,25,18
1746551566059,POLI 126AA,A00,891272,Staff,17,0,25,8
1746551567086,POLI 130AA,A00,891273,Staff,15,0,20,5
1746551568114,POLI 134AA,A00,891274,Staff,4,0,20,16
1746551570169,POLI 138,A00,891278,Staff,21,0,25,4
1746551571196,POLI 142K,A00,891280,Staff,11,0,25,14
1746551572225,POLI 142M,A00,891281,Gartzke; Erik,17,0,30,13
1746551573250,POLI 142P,A00,891284,Staff,20,0,30,10
1746551574275,POLI 143,A00,891285,Gartzke; Erik,12,0,30,18
1746551575303,POLI 153,A00,891286,Staff,19,0,20,1
1746551577354,POLI 175,A00,891290,Staff,15,0,20,5
1746551578379,PSYC 1,A00,890674,Steiner; Eric Tomas,0,11,45,45
1746551579406,PSYC 2,A00,890676,Albright; Thomas D,21,0,35,14
1746551580432,PSYC 3,A00,890679,Staff,17,0,20,3
1746551581461,PSYC 6,A00,959858,Staff,20,0,20,0
1746551582506,PSYC 60,A01,890684,Rickard; Timothy C.,0,5,45,45
1746551583530,PSYC 70,A01,890689,Geller; Emma Harlan,7,0,30,23
1746551584556,PSYC 71,A01,959860,Staff,21,0,25,4
1746551585581,PSYC 100,A00,890690,Lacefield; Katharine I,0,50,180,180
1746551586607,PSYC 102,A00,890695,Staff,18,0,40,22
1746551587635,PSYC 105,A00,890699,Geller; Emma Harlan,71,0,100,29
1746551588660,PSYC 106,A00,890701,Gorman; Michael R.,5,0,30,25
1746551589686,PSYC 108,A00,890704,Adrian; Julia Anna,0,28,50,50
1746551590713,PSYC 118,A01,890712,Staff,11,0,30,19
1746551591737,PSYC 124,A00,890716,Chapman; Eddie Nathaniel,25,0,60,35
1746551592763,PSYC 131,A00,890717,Anagnostaras; Stephan,0,7,80,80
1746551593789,PSYC 137,A00,890719,Winkielman; Piotr,0,11,30,30
1746551594816,PSYC 144,A00,890721,Adrian; Julia Anna,0,9,45,45
1746551595841,PSYC 162,A00,890805,Staff,2,0,75,73
1746551596867,PSYC 169,A00,890810,Staff,0,15,30,30
1746551597892,PSYC 172,A00,890814,Gorman; Michael R.,9,0,30,21
1746551598917,PSYC 181,A00,890818,Anagnostaras; Stephan,8,0,200,192
1746551599943,PSYC 184,A00,959861,Staff,170,0,175,5
1746551600970,PSYC 189,A00,890823,Staff,0,1,30,30
1746551601998,PSYC 191,A00,890884,Rickard; Timothy C.,0,11,35,35
1746551603023,PSYC 193,A00,890913,Staff,19,0,30,11
1746551603023,PSYC 193,B00,890914,Chapman; Eddie Nathaniel,24,0,30,6
1746551604053,PSYC 193L,A01,890918,Lowe; Angela Beth,20,0,30,10
1746551604053,PSYC 193L,B01,890921,Hurwitz; Ethan Scott,20,0,30,10
1746551604053,PSYC 193L,C01,890928,Staff,30,0,30,0
1746551605082,RELI 149,A00,886806,Rahimi; Babak,23,0,40,17
1746551606107,SE 9,A01,886814,Staff,7,0,20,13
1746551607132,SE 101B,A01,886816,Chadha; Mayank,4,0,35,31
1746551608159,SE 110B,A00,886818,Zhu; Qiang,4,0,75,71
1746551609187,SE 125,A01,886830,Staff,10,0,30,20
1746551610214,SE 130B,A01,886835,Staff,14,0,40,26
1746551611246,SE 131A,A01,886838,Krysl; Petr,34,0,55,21
1746551612270,SE 154,A00,886840,Staff,30,0,50,20
1746551613296,SE 164GS,A01,886849,Staff,6,0,20,14
1746551614321,SE 167GS,A01,886853,Staff,6,0,20,14
1746551615351,SIO 25,A01,890107,Staff,19,0,30,11
1746551616378,SIO 45,A00,890109,Cook; Geoffrey W,117,0,200,83
1746551617434,SIO 109R,A00,890110,Forman; Fonna,0,16,20,20
1746551618460,SIO 187,A01,890114,Kacev; David,15,0,40,25
1746551619489,SOCI 1,A01,890431,Thorpe; Charles Robert,15,0,30,15
1746551619489,SOCI 1,A02,890518,Thorpe; Charles Robert,30,0,30,0
1746551620515,SOCI 2,A01,957978,Staff,25,0,25,0
1746551620515,SOCI 2,A02,957979,Staff,23,0,25,2
1746551621540,SOCI 20,A01,890523,Calderon-Zaks; Michael Aar,23,0,30,7
1746551621540,SOCI 20,A02,890526,Calderon-Zaks; Michael Aar,29,0,30,1
1746551622567,SOCI 30,A01,890533,Pardo Guerra; Juan Pablo,37,0,40,3
1746551623592,SOCI 40,A01,890535,Staff,27,0,45,18
1746551624620,SOCI 104Q,A00,890559,Staff,18,0,30,12
1746551625648,SOCI 106,A00,890560,Arnal; Maud Marie Leonie,20,0,30,10
1746551626679,SOCI 110,A00,890567,Holkenbrink-Monk; Charlene,19,0,30,11
1746551627706,SOCI 112,A00,890568,Victoria Torres; Pablo,1,0,55,54
1746551628732,SOCI 115,A00,890597,Arnal; Maud Marie Leonie,28,0,45,17
1746551630783,SOCI 121,A00,890604,Pardo Guerra; Juan Pablo,38,0,45,7
1746551631808,SOCI 126,A01,890608,Staff,8,0,10,2
1746551632835,SOCI 127,A00,890609,Staff,18,0,30,12
1746551633861,SOCI 131,A00,890610,Thorpe; Charles Robert,37,0,45,8
1746551634889,SOCI 135,A00,890615,Payne; Christine Anna,14,0,45,31
1746551635915,SOCI 139,A00,890620,Staff,38,0,45,7
1746551636940,SOCI 148E,A00,890622,Calderon-Zaks; Michael Aar,36,0,45,9
1746551637966,SOCI 150,A00,890623,Kohler; Kristopher M.,31,0,45,14
1746551638994,SOCI 157,A00,890625,Jules-Rosette; Bennetta W.,18,0,20,2
1746551640019,SOCI 160,A00,890627,Payne; Christine Anna,21,0,45,24
1746551641045,SYN 1,A00,886855,Fish; Gwendolyn Anne,0,0,0,0
1746551641045,SYN 1,B00,906086,Fish; Gwendolyn Anne,0,1,0,2
1746551642069,SYN 2R,A00,886860,Staff,0,17,15,15
1746551642069,SYN 2R,B00,906106,Atkinson; Arthur Laird,0,16,15,15
1746551643104,SYN 100,A01,886866,Browne; Emily,0,28,20,20
1746551643104,SYN 100,B01,906128,Rock; Martin,0,5,20,20
1746551643104,SYN 100,C01,906140,Deavenport; James Cary,0,3,20,20
1746551643104,SYN 100,D01,907816,Deavenport; James Cary,0,5,20,20
1746551644129,TDAC 1,A00,890286,Walsh; Kim C.,9,0,20,11
1746551645154,TDAC 101,A00,890296,Basso; Beatrice,16,0,20,4
1746551646179,TDDE 131,A00,890297,Staff,47,0,50,3
1746551647208,TDDM 1,A00,890287,Weinberg; Sadie,25,0,30,5
1746551648237,TDGE 11,A00,890288,Fulton; Julia,137,0,200,63
1746551648237,TDGE 11,B00,890289,Castro; Robert Jess,184,0,200,16
1746551649262,TDGE 25,B00,957359,Walsh; Kim C.,3,0,20,17
1746551650288,TDGE 40,A01,890292,Power; Jade Yukana,27,0,30,3
1746551651317,TDGE 124,A00,890298,Havis; Allan,0,1,50,50
1746551652345,TDGE 131R,A00,890299,Burelle; Julie Sara Veronique,15,0,42,27
1746551653372,TDHT 101,A00,890300,Staff,10,0,20,10
1746551654398,TDHT 109,A01,890302,Anderson; Mysia Anyse,31,0,40,9
1746551655485,TDMV 1,A00,890293,Arcidiacono; Kristin,18,0,30,12
1746551656509,TDMV 2,A00,890294,Weinberg; Sadie,23,0,30,7
1746551657534,TDMV 3,A00,957878,Arcidiacono; Kristin,28,0,30,2
1746551659587,TDMV 138,A00,890304,Jun; Grace Shin Hae,25,0,40,15
1746551660616,TDMV 140,A00,890305,Corrales; Joseph Bernales,25,0,30,5
1746551661644,TDMV 142,A00,890307,Caligagan; Tony,32,0,40,8
1746551662669,TDMV 144,A00,890308,Camaya; Michelle Ann,25,0,30,5
1746551663694,TDPW 1,A00,890295,Stein; Deborah Isobel,3,0,20,17
1746551664721,USP 2,A01,890272,Lerner; Amy M,6,0,20,14
1746551665748,USP 3,A01,890274,Staff,12,0,30,18
1746551666775,USP 15,A01,890276,Sun; Feiyang,17,0,30,13
1746551667804,USP 25,A00,890277,Shenkman; Michael Thomas,19,0,25,6
1746551668828,USP 138,A00,890278,Staff,13,0,25,12
1746551669855,USP 143,A00,890279,Staff,21,0,70,49
1746551670882,USP 144,A00,890280,Chowdhury; Muhammed Zohir,16,0,30,14
1746551671906,USP 150,A00,890281,Boomhower; Matthew Charles,4,0,30,26
1746551672932,USP 151,A00,890282,Staff,16,0,20,4
1746551673958,USP 162,A00,890283,Andrews; Abigail Leslie,16,0,20,4
1746551674988,USP 168,A00,920477,Kwak; Nancy,1,0,5,4
1746551676016,USP 181,A00,890284,Staff,3,0,20,17
1746551677044,USP 191A,A00,890285,Staff,13,0,20,7
1746551678071,VIS 101,A00,886512,Staff,25,0,75,50
1746551679098,VIS 103,A00,886513,Cruz; Edwin Teddy,61,0,75,14
1746551680333,VIS 108,A00,886514,Staff,3,0,15,12
1746551681360,VIS 127P,A00,886515,Shen; Kuiyi,80,0,146,66
1746551682387,VIS 149,A00,886516,Yoldas; Pinar,0,0,15,15
1746551683413,VIS 164,A00,886526,Erdmann; Dean,19,0,22,3
1746551684439,VIS 194S,A00,886527,Staff,61,0,75,14
1746551685463,WCWP 10A,C00,886484,Martiniuk; Jill,12,0,15,3
1746551686488,WCWP 10B,A00,886490,Uriarte; Emma,0,0,15,15
1746551686488,WCWP 10B,B00,886491,Dhir; Simrita,10,0,15,5
1746551686488,WCWP 10B,C00,886492,Ornelas; Tricia,0,0,15,15
1746551687517,WCWP 100,A00,886494,Young; Mark T,0,6,15,15
1746551689605,AAS 10,A01,886199,Childs; Dennis R.,0,3,0,0
1746551690632,ANAR 104,A01,886940,Shtienberg; Gilad,27,0,30,3
1746551691660,ANAR 120,A00,886953,Staff,12,0,20,8
1746551692689,ANBI 148,A01,886955,Wilder; Linnea Lorene,30,0,40,10
1746551694738,ANSC 122,A00,886957,Staff,25,0,30,5
1746551695765,ANSC 150,A00,886958,Sloane; Julia Kathryn,2,0,15,13
1746551696791,ANSC 156,A00,886959,Jenkins; Janis A.,0,1,15,15
1746551697816,ANSC 180,A00,886960,Staff,11,0,17,6
1746551698842,ANSC 188,A00,886961,Jassal; Aftab,9,0,25,16
1746551699865,ANSC 190,A00,886962,Jassal; Aftab,14,0,25,11
1746551700890,ANSC 191,A00,886963,Staff,18,0,20,2
1746551701918,ANTH 3,A01,891689,Staff,17,0,20,3
1746551702950,ANTH 5,A00,886933,Semendeferi; Ekaterini,16,0,20,4
1746551703974,ANTH 10,A00,886934,Staff,0,12,30,30
1746551705003,ANTH 21,A01,886936,Staff,40,0,60,20
1746551706026,ANTH 23,A01,886938,Staff,92,0,100,8
1746551707055,ANTH 105,A00,886964,Stewart; Alexander B,84,0,100,16
1746551708083,ANTH 108,A00,886965,Pedersen; David,9,0,20,11
1746551709110,AWP 10,001,886147,Staff,0,0,0,0
1746551709110,AWP 10,002,886148,Staff,0,0,0,0
1746551709110,AWP 10,003,886149,Staff,0,0,0,0
1746551709110,AWP 10,004,886150,Staff,0,0,0,0
1746551709110,AWP 10,005,886151,Staff,0,0,0,0
1746551709110,AWP 10,006,886152,Staff,0,0,0,0
1746551709110,AWP 10,007,886153,Staff,0,0,0,0
1746551709110,AWP 10,008,886154,Staff,0,0,0,0
1746551709110,AWP 10,009,886155,Staff,0,0,0,0
1746551709110,AWP 10,010,886156,Staff,0,0,0,0
1746551709110,AWP 10,011,886158,Staff,0,0,0,0
1746551709110,AWP 10,012,886160,Staff,0,0,0,0
1746551709110,AWP 10,013,886161,Staff,0,0,0,0
1746551709110,AWP 10,014,886162,Staff,0,0,0,0
1746551709110,AWP 10,015,886163,Staff,0,0,0,0
1746551709110,AWP 10,016,886164,Staff,0,0,0,0
1746551709110,AWP 10,017,886165,Staff,0,0,0,0
1746551709110,AWP 10,018,886166,Staff,0,0,0,0
1746551709110,AWP 10,019,886168,Staff,0,0,0,0
1746551709110,AWP 10,020,886170,Staff,0,0,0,0
1746551709110,AWP 10,021,886172,Staff,0,0,0,0
1746551710135,AWP 10R,001,886173,Staff,0,1,0,0
1746551710135,AWP 10R,002,886174,Staff,0,1,0,0
1746551710135,AWP 10R,003,886175,Staff,0,0,0,0
1746551710135,AWP 10R,004,886176,Staff,0,0,0,0
1746551710135,AWP 10R,005,886177,Staff,0,0,0,0
1746551710135,AWP 10R,006,886178,Staff,0,0,0,0
1746551710135,AWP 10R,007,886179,Staff,0,0,0,0
1746551710135,AWP 10R,008,886181,Staff,0,0,0,0
1746551710135,AWP 10R,009,886182,Staff,0,0,0,0
1746551710135,AWP 10R,010,886183,Staff,0,0,0,0
1746551710135,AWP 10R,011,886184,Staff,0,0,0,0
1746551710135,AWP 10R,012,886185,Staff,0,0,0,0
1746551710135,AWP 10R,013,886186,Staff,0,0,0,0
1746551710135,AWP 10R,014,886187,Staff,0,0,0,0
1746551710135,AWP 10R,015,886188,Staff,0,0,0,0
1746551710135,AWP 10R,016,886189,Staff,0,0,0,0
1746551711162,AWP 102R,A00,886190,Staff,0,0,0,0
1746551711162,AWP 102R,B00,886191,Staff,0,0,0,0
1746551712189,BENG 100,A01,886193,Staff,17,0,30,13
1746551713215,BENG 122A,A01,886195,Hasty; Jeff M,13,0,30,17
1746551714243,BENG 166A,A00,886196,Sah; Robert Lie-Yuan,0,1,30,30
1746551715268,BENG 190,A00,958050,Khojah; Reem I,24,0,25,1
1746551716293,BIBC 102,A01,894320,Staff,0,0,46,46
1746551716293,BIBC 102,A02,894321,Staff,0,0,46,46
1746551716293,BIBC 102,A03,894344,Staff,7,0,46,39
1746551716293,BIBC 102,A04,894345,Staff,26,0,47,21
1746551717320,BICD 100R,A01,894365,Smith; Laurie,0,3,58,58
1746551717320,BICD 100R,A02,894366,Smith; Laurie,0,5,58,58
1746551717320,BICD 100R,A03,894367,Smith; Laurie,2,0,59,57
1746551717320,BICD 100R,A04,959869,Smith; Laurie,41,0,59,18
1746551718350,BICD 136,A01,894383,Gustafson-Brown; Cindy,14,0,50,36
1746551719375,BIEB 102,A01,894494,Butler; Shannon Rhey,51,0,130,79
1746551721429,BIEB 150,A01,894617,Wills; Christopher,3,0,20,17
1746551721429,BIEB 150,A02,894631,Wills; Christopher,3,0,20,17
1746551721429,BIEB 150,A03,894937,Wills; Christopher,3,0,20,17
1746551721429,BIEB 150,A04,894946,Wills; Christopher,5,0,20,15
1746551722453,BIEB 194,A00,906141,Kurle; Carolyn M.,6,0,20,14
1746551723483,BILD 1,A01,894154,Staff,2,0,19,17
1746551723483,BILD 1,A02,894155,Staff,14,0,19,5
1746551723483,BILD 1,A03,894160,Staff,13,0,19,6
1746551723483,BILD 1,A04,894161,Staff,15,0,18,3
1746551724507,BILD 2,A01,894168,Staff,0,0,50,50
1746551724507,BILD 2,A02,894169,Staff,0,0,50,50
1746551724507,BILD 2,A03,894179,Staff,4,0,50,46
1746551724507,BILD 2,A04,894203,Staff,27,0,50,23
1746551725535,BILD 3,A01,894213,Staff,22,0,31,9
1746551725535,BILD 3,A02,894214,Staff,26,0,31,5
1746551725535,BILD 3,A03,894235,Staff,28,0,31,3
1746551725535,BILD 3,A04,894236,Staff,28,0,32,4
1746551726561,BILD 4,A01,894253,Reuther; Keefe,5,0,24,19
1746551726561,BILD 4,A02,894258,Reuther; Keefe,16,0,24,8
1746551727586,BILD 5,A01,894276,Reuther; Keefe,35,0,50,15
1746551727586,BILD 5,A02,894277,Reuther; Keefe,45,0,50,5
1746551727586,BILD 5,A03,894290,Reuther; Keefe,44,0,50,6
1746551727586,BILD 5,A04,894291,Reuther; Keefe,48,0,50,2
1746551728614,BILD 24,A01,894297,Pirino; Giorgia,40,0,60,20
1746551729643,BIMM 100,B01,958915,Staff,72,0,100,28
1746551730673,BIMM 101,A01,895017,McDonnell; Lisa Marie,0,5,24,24
1746551730673,BIMM 101,A02,895018,McDonnell; Lisa Marie,0,5,24,24
1746551730673,BIMM 101,B01,895020,McDonnell; Lisa Marie,0,6,24,24
1746551730673,BIMM 101,B02,895021,McDonnell; Lisa Marie,0,4,24,24
1746551731697,BIMM 110,A01,895023,Staff,1,0,25,24
1746551731697,BIMM 110,A02,895024,Staff,9,0,25,16
1746551731697,BIMM 110,A03,895025,Staff,18,0,25,7
1746551731697,BIMM 110,A04,895031,Staff,20,0,25,5
1746551732725,BIMM 120,A01,895114,Gustafson-Brown; Cindy,14,0,28,14
1746551732725,BIMM 120,A02,895126,Gustafson-Brown; Cindy,21,0,27,6
1746551733750,BIPN 100,A01,895130,Yang; Mingyu,1,0,38,37
1746551733750,BIPN 100,A02,895131,Yang; Mingyu,32,0,38,6
1746551733750,BIPN 100,A03,895132,Yang; Mingyu,32,0,38,6
1746551733750,BIPN 100,A04,895133,Yang; Mingyu,27,0,36,9
1746551734777,BIPN 120,A01,895135,Cooke; James Edward,0,3,13,13
1746551734777,BIPN 120,A02,895136,Cooke; James Edward,0,1,13,13
1746551734777,BIPN 120,A03,895137,Cooke; James Edward,0,3,13,13
1746551734777,BIPN 120,A04,895156,Cooke; James Edward,0,2,11,11
1746551735802,BIPN 134,A01,895235,Cooke; James Edward,0,2,25,25
1746551735802,BIPN 134,A02,895237,Cooke; James Edward,0,0,25,25
1746551735802,BIPN 134,A03,895240,Cooke; James Edward,3,0,25,22
1746551735802,BIPN 134,A04,895270,Cooke; James Edward,20,0,25,5
1746551736829,BIPN 189,A00,892103,Staff,0,13,14,14
1746551738935,BISP 194,A00,958008,Staff,0,2,0,0
1746551739960,CAT 124,A01,922009,Staff,0,5,20,20
1746551740987,CAT 125R,A00,886390,Morales; Celeste Georgianna,0,2,20,20
1746551740987,CAT 125R,B00,886391,Irwin; Matthew Joseph,0,3,20,20
1746551740987,CAT 125R,C00,886392,Smith; Lauryn Alissa,0,2,20,20
1746551740987,CAT 125R,D00,886393,Vanderschuit; Maya Alysia,0,2,20,20
1746551740987,CAT 125R,E00,886394,Marchisotto; Jennifer Anne,0,4,20,20
1746551742016,CENG 15,A01,886218,Drews; Aaron,3,0,8,5
1746551743041,CENG 113,A00,886219,Opatkiewicz; Justin Paul,15,0,25,10
1746551744065,CGS 101,A00,887044,Staff,7,0,20,13
1746551745089,CGS 105,A01,887046,Staff,14,0,25,11
1746551746114,CGS 112,A00,887047,Cuong; Marisol,12,0,15,3
1746551747139,CGS 113,A00,887048,Staff,23,0,30,7
1746551748166,CGS 120,A00,887049,Staff,10,0,17,7
1746551749191,CHEM 6A,A01,886336,Lam; Tin Yiu,38,0,50,12
1746551749191,CHEM 6A,A02,886338,Lam; Tin Yiu,37,0,50,13
1746551750216,CHEM 6B,A01,886341,Hopkins; Patrycja Anna,16,0,50,34
1746551750216,CHEM 6B,A02,886343,Hopkins; Patrycja Anna,42,0,50,8
1746551751245,CHEM 6C,A01,886346,Albizati; Kim F.,0,2,50,50
1746551751245,CHEM 6C,A02,886348,Albizati; Kim F.,23,0,50,27
1746551752270,CHEM 40A,A01,886352,Klosterman; Jeremy K,65,0,100,35
1746551753296,CHEM 40B,A01,886356,Klosterman; Jeremy K,0,23,100,100
1746551754323,CHEM 41B,A01,886360,Theodorakis; Emmanuel,25,0,50,25
1746551754323,CHEM 41B,A02,886362,Theodorakis; Emmanuel,47,0,50,3
1746551755350,CHIN 165A,A00,886382,Xu; Li,18,0,20,2
1746551756377,CLAS 120,A00,886387,Myerston Santana; Jacobo,33,0,40,7
1746551757402,COGS 9,A01,886967,Shannon; Kyle Michael,42,0,60,18
1746551758426,COGS 11,A01,886969,Staff,11,0,30,19
1746551759450,COGS 14A,A01,886971,Staff,6,0,60,54
1746551760482,COGS 14B,A01,886973,Hoffman; Drew Ellen,4,0,60,56
1746551761506,COGS 18,A01,886975,Morgan; Eric,35,0,60,25
1746551762539,COGS 20,A01,886977,Staff,4,0,8,4
1746551762539,COGS 20,A02,886978,Staff,5,0,7,2
1746551763566,COGS 100,A01,907783,Staff,0,2,30,30
1746551764590,COGS 101B,A01,886980,Staff,0,3,48,48
1746551765616,COGS 101C,A01,886982,Delgado; Tania,0,5,44,44
1746551766643,COGS 102A,A01,886984,Johnson; Christine M.,4,0,30,26
1746551767667,COGS 118B,A01,886986,Staff,0,3,88,88
1746551768691,COGS 150,A01,886988,Bergen; Benjamin,23,0,50,27
1746551769717,COGS 153,A00,886989,Delgado; Tania,0,2,41,41
1746551770744,COGS 186,A01,886991,Staff,0,0,32,32
1746551771769,COGS 187A,A01,886993,Boyle; Mary E. T.,7,0,30,23
1746551772796,COGS 189,A00,886994,Staff,0,1,30,30
1746551773822,COMM 10,A01,886996,Staff,0,0,20,21
1746551773822,COMM 10,A02,886997,Staff,12,0,20,8
1746551773822,COMM 10,A03,959845,Staff,19,0,20,1
1746551774847,COMM 20,A01,886999,Leuning; Grant Maurstad,24,0,40,16
1746551776899,COMM 100A,A01,887002,Staff,0,0,20,25
1746551776899,COMM 100A,A02,887003,Staff,7,0,20,13
1746551777926,COMM 100B,A01,887005,Staff,0,8,20,24
1746551778952,COMM 106D,A00,887006,Staff,14,0,40,26
1746551779979,COMM 110G,A00,887007,Whitworth-Smith; Andrew C,12,0,40,28
1746551781008,COMM 111B,A00,887008,Staff,31,0,40,9
1746551782035,COMM 113T,A00,887009,Abuelhiga; Soraya Jill,28,0,40,12
1746551782035,COMM 113T,B00,906733,Staff,40,0,40,0
1746551783061,COMM 145,A00,887010,Staff,12,0,40,28
1746551784087,COMM 146,A00,887054,Staff,31,0,40,9
1746551785114,COMM 190,A00,887012,Staff,8,0,23,15
1746551786138,CSE 8A,A50,887015,Cao; Yingjun,57,0,85,28
1746551787166,CSE 11,A01,887017,Cao; Yingjun,12,0,70,58
1746551788191,CSE 20,A01,887019,Staff,30,0,50,20
1746551789219,CSE 21,A01,887021,Staff,78,0,100,22
1746551789219,CSE 21,B01,892583,Braun; Oliver,45,0,50,5
1746551790247,CSE 30,A01,887025,Eldon; John,143,0,200,57
1746551791272,CSE 100,A01,887027,Staff,26,0,50,24
1746551791272,CSE 100,A02,887028,Staff,40,0,50,10
1746551792300,CSE 101,A01,887030,Braun; Oliver,75,0,100,25
1746551792300,CSE 101,B01,887032,Jones; Miles E,0,3,50,50
1746551792300,CSE 101,B02,887033,Jones; Miles E,0,1,50,50
1746551793327,CSE 105,A01,908084,Jones; Miles E,32,0,50,18
1746551793327,CSE 105,A02,908087,Jones; Miles E,33,0,50,17
1746551794355,CSE 135,A01,887035,Powell; Thomas Allan,0,4,50,50
1746551795380,CSE 142,A01,887037,Staff,8,0,60,52
1746551796407,CSE 142L,A01,887039,Staff,34,0,60,26
1746551797436,CSE 151A,A01,887041,Solares; Edwin A,47,0,100,53
1746551798460,CSE 175,A01,887043,Kumar; Rakesh,30,0,30,0
1746551799488,CSS 1,A01,886389,Staff,0,1,40,40
1746551800512,DSC 30,A01,908097,Liao; Soohyun Nam,47,0,75,28
1746551801538,DSC 40A,A01,908099,Shannon; Kyle Michael,30,0,50,20
1746551802562,DSC 40B,A01,908112,Staff,16,0,50,34
1746551803591,DSC 80,A01,908116,Staff,19,0,60,41
1746551804616,DSC 197,001,956863,Eldridge; Justin Matthew,9999,0,9999,0
1746551805645,ECE 5,A01,886400,Morris; Karcher William,2,0,6,4
1746551805645,ECE 5,A02,886401,Morris; Karcher William,3,0,6,3
1746551806671,ECE 148,A01,886403,Silberman; Jack,0,14,14,14
1746551807698,ECON 1,A01,887265,Crane; Meredith Helen,12,0,70,58
1746551807698,ECON 1,B01,887268,Staff,43,0,50,7
1746551808726,ECON 2,A01,887273,Crane; Meredith Helen,56,0,70,14
1746551809752,ECON 3,A01,887279,Rondina; Giacomo,32,0,70,38
1746551810778,ECON 4,A01,887282,Anderson; John Charles,0,2,10,10
1746551811803,ECON 5,A01,887285,Staff,33,0,45,12
1746551811803,ECON 5,B01,887292,Staff,41,0,45,4
1746551812829,ECON 100A,A01,887337,Newhouse; Herbert S,54,0,70,16
1746551812829,ECON 100A,B01,887349,Staff,45,0,50,5
1746551813857,ECON 100B,A01,887361,Du; Songzi,29,0,70,41
1746551814885,ECON 100C,A01,887445,Newhouse; Herbert S,59,0,70,11
1746551815910,ECON 105,A00,887488,Vespa; Emanuel Ignacio,23,0,35,12
1746551816937,ECON 109,A01,887506,Shishkin; Denis,28,0,35,7
1746551817963,ECON 110A,A01,887568,Alon; Titan Michael,0,3,35,35
1746551817963,ECON 110A,B01,907601,Alon; Titan Michael,20,0,35,15
1746551818987,ECON 110B,A01,887598,Levkoff; Steven B.,0,23,70,70
1746551820013,ECON 112,A00,887599,Rondina; Giacomo,19,0,35,16
1746551821040,ECON 120A,A01,887603,Dai; Yinlin,36,0,70,34
1746551822065,ECON 120C,A01,887608,Sun; Yixiao,0,1,35,35
1746551822065,ECON 120C,B01,887614,Sun; Yixiao,0,0,35,35
1746551823092,ECON 138,A00,887621,Bharadwaj; Prashant,0,21,20,20
1746551824119,ECON 144,A00,958007,Squires; Dale E,13,0,35,22
1746551825144,ECON 171,A01,907666,Staff,18,0,35,17
1746551826169,ECON 175,A00,887626,Wu; Pak Yeung,23,0,35,12
1746551827195,ECON 190,A00,887640,Vespa; Emanuel Ignacio,23,0,35,12
1746551828228,EDS 25,A01,888197,Staff,0,0,0,0
1746551828228,EDS 25,A02,888209,Staff,0,0,0,0
1746551828228,EDS 25,A03,888210,Staff,0,0,0,0
1746551828228,EDS 25,A04,888212,Staff,0,0,0,0
1746551828228,EDS 25,A05,888213,Staff,0,0,0,0
1746551828228,EDS 25,A06,888214,Staff,0,0,0,0
1746551828228,EDS 25,A07,888235,Staff,0,2,0,0
1746551828228,EDS 25,A08,888236,Staff,0,0,0,0
1746551828228,EDS 25,A09,888240,Staff,0,0,0,0
1746551828228,EDS 25,A10,888244,Staff,0,0,0,0
1746551828228,EDS 25,B01,888273,Staff,0,0,0,0
1746551828228,EDS 25,B02,888285,Staff,0,0,0,0
1746551828228,EDS 25,B03,888423,Staff,0,0,0,1
1746551828228,EDS 25,B04,888432,Staff,0,0,0,0
1746551828228,EDS 25,B05,888433,Staff,0,0,0,0
1746551828228,EDS 25,B06,888467,Staff,0,0,0,0
1746551828228,EDS 25,B07,888468,Staff,0,0,0,0
1746551828228,EDS 25,B08,888479,Staff,0,0,0,0
1746551828228,EDS 25,B09,888484,Staff,0,0,0,0
1746551828228,EDS 25,B10,888487,Staff,0,0,0,0
1746551829254,EDS 38,A01,907700,Choi; Bailey Miyeon,30,0,30,0
1746551830278,EDS 112,A01,888601,Chapman; Thandeka K,14,0,40,26
1746551831303,EDS 115,A00,888697,Mendez; Kathrina Mendoza,10,0,30,20
1746551832331,EDS 116,A01,888893,Staff,35,0,40,5
1746551834383,EDS 124AR,A00,889133,Staff,29,0,50,21
1746551834383,EDS 124AR,B00,907471,Simon; Elizabeth A,37,0,50,13
1746551835411,EDS 124BR,A00,889134,Simon; Elizabeth A,45,0,100,55
1746551836436,EDS 125,A00,889135,Staff,25,0,30,5
1746551837466,EDS 126,A01,889138,Staff,36,0,40,4
1746551838528,EDS 164R,A01,889142,Wishard Guerra; Alison G.,33,0,50,17
1746551839557,ENG 30,A01,886396,Staff,0,0,0,0
1746551839557,ENG 30,B01,886398,Staff,0,0,0,0
1746551840582,ENVR 102,A00,906150,Montejo; Carolina,23,0,25,2
1746551841611,ETHN 103A,A00,887236,Man; Simeon S,0,3,0,0
1746551842637,ETHN 113,A00,887239,Staff,16,0,30,14
1746551843660,ETHN 116,A00,887240,Staff,16,0,25,9
1746551844685,ETHN 117,A00,887241,Choi; Esther Min,28,0,30,2
1746551845712,ETHN 118,A00,887243,Staff,24,0,30,6
1746551846740,ETHN 127,A00,887248,Cuong; Marisol,11,0,15,4
1746551847768,ETHN 139,A00,887250,Staff,7,0,10,3
1746551848792,ETHN 142,A00,887252,Staff,10,0,30,20
1746551849819,ETHN 161,A00,887253,Browne; Errol Tsekani,24,0,30,6
1746551850845,ETHN 163FR,A00,887255,Burelle; Julie Sara Veronique,0,0,5,5
1746551851873,GLBH 20,A00,889149,Elwardani; Nile Regina,8,0,42,34
1746551853925,GLBH 111,A01,889152,Burgos; Jose L.,17,0,17,0
1746551854950,GLBH 150,A00,889181,Sloane; Julia Kathryn,0,5,15,15
1746551857003,HDS 60,A01,886406,Warstadt; Melissa Fawn,73,0,80,7
1746551858030,HIAF 111,A00,889324,Gyamfi; Bright,25,0,32,7
1746551859056,HIEA 131,A00,889328,Staff,16,0,32,16
1746551860081,HIEA 144,A00,889333,Henry; Todd A.,26,0,32,6
1746551861106,HIEA 154,A00,889336,Henry; Todd A.,24,0,32,8
1746551862133,HIEU 106,A00,889339,Staff,22,0,32,10
1746551864185,HIEU 114,A00,889340,Staff,3,0,32,29
1746551865210,HIEU 135GS,A00,889342,Patterson; Patrick H.,0,0,1,24
1746551866235,HIEU 137,A00,889343,Edington; Claire Ellen,9,0,25,16
1746551867261,HIEU 148,A00,889345,Staff,14,0,32,18
1746551868289,HIEU 154,A00,889346,Biess; Frank Peter,21,0,32,11
1746551869314,HILA 102,A00,889351,Staff,12,0,32,20
1746551870343,HILD 2A,A01,889221,Lewandoski; Julia Mavis,1,10,32,31
1746551871370,HILD 7B,A01,889225,Man; Simeon S,0,13,32,32
1746551872398,HILD 7C,A01,889288,Alvarez; Luis A,0,14,32,32
1746551873425,HILD 30,A01,889323,Staff,0,5,32,32
1746551875476,HISC 119,A00,889383,Golan; Tal,20,0,32,12
1746551876560,HIUS 103,A00,889384,Man; Simeon S,0,0,32,32
1746551877584,HIUS 117,A00,919797,Kwak; Nancy,18,0,32,14
1746551878609,HIUS 142A,A00,919788,Staff,22,0,32,10
1746551880658,HIUS 149,A00,889386,Gyamfi; Bright,27,0,32,5
1746551881684,HIUS 155,A00,889387,Alvarez; Luis A,14,0,32,18
1746551882709,HUM 3,A01,886499,Caldwell; Michael Alan,19,0,50,31
1746551883733,HUM 3GS,A00,886500,Rodriguez; Bretton Sigfred,0,0,0,28
1746551884761,HUM 3R,A01,886502,Markman; Kristina,0,36,50,50
1746551885785,HUM 4,A01,886504,Crum; Matthew Stephen,24,0,50,26
1746551885785,HUM 4,B01,886506,West; Geoffrey Scott,17,0,50,33
1746551886811,HUM 4GS,A00,886507,Staff,0,0,0,19
1746551887837,HUM 5,A01,886509,Staff,32,0,50,18
1746551888862,HUM 5R,A01,886511,Zavodny; Tatiana Sophia,0,39,50,50
1746551889888,JAPN 180,A00,886407,Staff,17,0,40,23
1746551890916,LATI 50,A01,886409,Martin-Cabrera; Luis,4,0,22,18
1746551890916,LATI 50,A02,886410,Martin-Cabrera; Luis,19,0,22,3
1746551890916,LATI 50,A03,886411,Martin-Cabrera; Luis,21,0,22,1
1746551890916,LATI 50,A04,886412,Martin-Cabrera; Luis,9,0,22,13
1746551891941,LAWS 101,A00,907664,Staff,28,0,60,32
1746551892969,LIAB 1A,A00,889388,Saab; Dima,17,0,20,3
1746551893998,LIAB 1AX,A00,889389,El Cheddadi; Youniss,17,0,20,3
1746551895030,LIFR 1C,A00,889391,Van Moer; Vinciane G,8,0,20,12
1746551896056,LIFR 1CX,A00,889392,Van Moer; Vinciane G,7,0,20,13
1746551897081,LIFR 1D,A00,889393,Van Moer; Vinciane G,7,0,20,13
1746551898108,LIFR 1DX,A00,889394,Van Moer; Vinciane G,8,0,20,12
1746551899133,LIGN 7,A00,886923,Staff,24,0,50,26
1746551900162,LIGN 17,A00,886924,Kehler; Andrew Scott,125,0,150,25
1746551901188,LTAM 110,A00,889395,Staff,15,0,30,15
1746551902212,LTAM 110GS,A00,958010,Rodriguez; Bretton Sigfred,0,0,0,28
1746551903239,LTCH 101,A00,889397,Staff,23,0,25,2
1746551904267,LTCS 130,A00,889398,Staff,23,0,25,2
1746551905294,LTEA 138,A00,889399,Staff,24,0,40,16
1746551906319,LTEN 149,A00,889400,Wesling; Megan E.,0,3,25,25
1746551907344,LTEN 169,A00,889401,Staff,20,0,25,5
1746551908370,LTEN 180,A00,889402,Staff,10,0,15,5
1746551909396,LTEN 181,A00,889403,Staff,21,0,25,4
1746551910425,LTWL 100,A00,889404,Myerston Santana; Jacobo,3,0,25,22
1746551911451,LTWL 180GS,A00,889405,Staff,0,0,20,20
1746551912480,LTWL 181,A00,889406,Staff,17,0,25,8
1746551913503,LTWL 184,A00,889475,Mukherjee; Silpa,22,0,25,3
1746551914530,LTWR 102C,A00,889486,Staff,29,0,30,1
1746551915556,LTWR 115W,A00,889491,Staff,0,2,15,15
1746551916581,MAE 8,A01,886905,Staff,0,2,0,0
1746551917607,MAE 11,A00,886906,Bandaru; Prabhakar,0,7,50,50
1746551918632,MAE 20,A00,886907,Evdokimenko; Ekaterina,43,0,70,27
1746551919656,MAE 30B,A00,886909,Ghazinejad; Maziar,26,0,45,19
1746551920683,MAE 101B,A00,886910,Saintillan; David,29,0,45,16
1746551921709,MAE 105,A00,886911,Bandaru; Prabhakar,18,0,50,32
1746551922744,MAE 107,B00,958024,Staff,8,0,50,42
1746551923769,MAE 143B,A00,886913,Bewley; Thomas R,7,0,40,33
1746551924797,MAE 148,A01,886915,Silberman; Jack,0,3,14,14
1746551925825,MAE 160,A00,886916,Evdokimenko; Ekaterina,31,0,60,29
1746551926853,MATH 3C,A01,889681,Staff,0,3,30,30
1746551926853,MATH 3C,A02,960048,Staff,25,0,30,5
1746551927879,MATH 10A,A01,889760,Staff,26,0,30,4
1746551927879,MATH 10A,A02,889783,Staff,29,0,30,1
1746551928909,MATH 10B,A01,889785,Verstraete; Jacques Allan,2,0,35,33
1746551928909,MATH 10B,A02,889795,Verstraete; Jacques Allan,4,0,35,31
1746551928909,MATH 10B,B01,889797,Verstraete; Jacques Allan,3,0,35,32
1746551928909,MATH 10B,B02,889828,Verstraete; Jacques Allan,3,0,35,32
1746551929935,MATH 10C,A01,889849,Habib; Yousaf,9,0,30,21
1746551929935,MATH 10C,A02,889852,Habib; Yousaf,14,0,30,16
1746551929935,MATH 10C,A03,889853,Habib; Yousaf,22,0,30,8
1746551929935,MATH 10C,A04,889858,Habib; Yousaf,20,0,30,10
1746551929935,MATH 10C,B01,889861,Staff,1,0,30,29
1746551929935,MATH 10C,B02,889862,Staff,24,0,30,6
1746551929935,MATH 10C,B03,889863,Staff,27,0,30,3
1746551929935,MATH 10C,B04,889967,Staff,23,0,30,7
1746551930965,MATH 18,A01,889974,Staff,6,0,30,24
1746551930965,MATH 18,A02,889977,Staff,20,0,30,10
1746551930965,MATH 18,B01,889984,Hardiman; Liam,22,0,30,8
1746551930965,MATH 18,B02,889985,Hardiman; Liam,25,0,30,5
1746551931994,MATH 20A,A01,889990,Suk; Andrew Hoon,30,0,35,5
1746551933024,MATH 20B,A01,889993,Ohm; Ko Woon,22,0,30,8
1746551933024,MATH 20B,A02,889994,Ohm; Ko Woon,30,0,30,0
1746551933024,MATH 20B,B01,889996,Ohm; Ko Woon,21,0,30,9
1746551933024,MATH 20B,B02,889997,Ohm; Ko Woon,23,0,30,7
1746551934050,MATH 20C,A01,889999,Hammock; Frances H,17,0,30,13
1746551934050,MATH 20C,A02,890003,Hammock; Frances H,23,0,30,7
1746551934050,MATH 20C,B01,890006,Hammock; Frances H,3,0,30,27
1746551934050,MATH 20C,B02,890007,Hammock; Frances H,11,0,30,19
1746551935075,MATH 20D,A01,890011,Cheng; Hsiao-Bing,1,1,30,29
1746551935075,MATH 20D,A02,890012,Cheng; Hsiao-Bing,14,0,30,16
1746551935075,MATH 20D,B01,890016,Cheng; Hsiao-Bing,13,0,30,17
1746551935075,MATH 20D,B02,890017,Cheng; Hsiao-Bing,13,0,30,17
1746551936102,MATH 20E,A01,890026,Harel; Guershon,1,0,30,29
1746551936102,MATH 20E,A02,890029,Harel; Guershon,23,0,30,7
1746551936102,MATH 20E,B01,890033,Harel; Guershon,7,0,30,23
1746551936102,MATH 20E,B02,890101,Harel; Guershon,21,0,30,9
1746551937129,MATH 102,A01,890104,Staff,17,0,30,13
1746551937129,MATH 102,A02,890105,Staff,27,0,30,3
1746551938155,MATH 103B,A01,890116,Salehi Golsefidy; Alireza,3,0,30,27
1746551938155,MATH 103B,B01,890118,Staff,0,3,34,34
1746551939186,MATH 109,A01,890121,Aliabadi Sr.; Mohsen,1,0,30,29
1746551939186,MATH 109,B01,890124,Upadrashta; Pranav Kumar,18,0,30,12
1746551940212,MATH 120A,A01,890126,Eggers; John Dietrich,13,0,30,17
1746551941237,MATH 142B,A01,890128,Ioana; Adrian,19,0,30,11
1746551941237,MATH 142B,A02,890129,Ioana; Adrian,13,0,30,17
1746551942263,MATH 154,A01,890174,Staff,0,0,30,30
1746551942263,MATH 154,A02,890182,Staff,0,0,30,30
1746551943291,MATH 168A,A01,890197,Dumitriu; Ioana,21,0,35,14
1746551944316,MATH 170A,A01,890240,Nie; Jiawang,1,0,30,29
1746551944316,MATH 170A,A02,890241,Nie; Jiawang,11,0,30,19
1746551944316,MATH 170A,A03,890249,Nie; Jiawang,23,0,30,7
1746551945342,MATH 170B,A01,957891,Nag; Panchali,13,0,35,22
1746551947397,MATH 181A,A01,908025,Staff,0,4,35,35
1746551947397,MATH 181A,A02,960115,Staff,27,0,35,8
1746551948423,MATH 181B,A01,959874,Staff,25,0,30,5
1746551949451,MATH 193B,A01,890265,Staff,0,4,35,35
1746551950480,MGT 4,A01,890311,Anderson; John Charles,42,0,88,46
1746551951509,MGT 5,A00,907740,Staff,13,0,98,85
1746551952533,MGT 12,A00,890312,Lindenberger; Wade Douglas,67,0,98,31
1746551953561,MGT 16,A00,957883,Staff,78,0,98,20
1746551955613,MGT 45,A00,890314,Pecore; Joseph P.,47,0,98,51
1746551956639,MGT 71,A00,890315,Staff,0,11,98,98
1746551957666,MGT 100,A00,890316,Yavorsky; Daniel Ryan,44,0,98,54
1746551958692,MGT 103,A00,890317,Ehrich; Kristine R,73,0,98,25
1746551959718,MGT 105,A00,890356,Bates; Kenneth Walter,0,7,98,98
1746551960745,MGT 112,A00,890360,Ehrich; Kristine R,55,0,98,43
1746551961773,MGT 127R,A00,907732,Zhu; Kevin Xiaoguo,24,0,98,74
1746551962797,MGT 131B,A00,890361,Anderson; John Charles,61,0,98,37
1746551963825,MGT 137,A00,890362,Lindenberger; Wade Douglas,65,0,98,33
1746551964853,MGT 160,A00,890369,Johnson; Erik Barry,9,0,98,89
1746551966905,MGT 164,A00,890372,Zimmermann; Carsten,0,39,98,98
1746551967932,MGT 180,A00,890374,Bliss; Barbara Ann,12,0,98,86
1746551968963,MMW 15,A01,886414,Chang; Edmond Yi-Teh,0,12,28,28
1746551968963,MMW 15,A02,886415,Chang; Edmond Yi-Teh,0,8,28,28
1746551968963,MMW 15,A03,886416,Chang; Edmond Yi-Teh,0,8,28,28
1746551968963,MMW 15,A04,886417,Chang; Edmond Yi-Teh,0,8,28,28
1746551968963,MMW 15,B01,886419,Chang; Edmond Yi-Teh,0,7,28,28
1746551968963,MMW 15,B02,886420,Chang; Edmond Yi-Teh,0,8,28,28
1746551968963,MMW 15,B03,886421,Chang; Edmond Yi-Teh,0,7,28,28
1746551968963,MMW 15,B04,886422,Chang; Edmond Yi-Teh,0,8,28,28
1746551968963,MMW 15,C01,886424,Staff,0,9,28,28
1746551968963,MMW 15,C02,886425,Staff,0,8,28,28
1746551968963,MMW 15,C03,886426,Staff,0,8,28,28
1746551968963,MMW 15,C04,886427,Staff,0,7,28,28
1746551968963,MMW 15,C05,958038,Staff,0,7,28,28
1746551968963,MMW 15,C06,958039,Staff,0,8,28,28
1746551969990,MMW 15GS,A00,906910,Patterson; Patrick H.,4,0,28,24
1746551971019,MMW 122R,A01,886429,Rahimi; Babak,0,13,28,28
1746551971019,MMW 122R,A02,886430,Rahimi; Babak,0,12,28,28
1746551971019,MMW 122R,A03,958040,Rahimi; Babak,0,11,28,28
1746551972045,MUS 1A,A01,890937,Staff,2,0,25,23
1746551972045,MUS 1A,A02,891035,Staff,6,0,25,19
1746551972045,MUS 1A,C01,958912,Staff,24,0,25,1
1746551972045,MUS 1A,C02,958913,Staff,25,0,25,0
1746551974099,MUS 2AK,A00,957092,Ohnishi; Takae,15,0,15,0
1746551975125,MUS 4,A01,891044,Staff,1,0,25,24
1746551975125,MUS 4,A02,891045,Staff,23,0,25,2
1746551975125,MUS 4,B01,891048,Staff,17,0,25,8
1746551975125,MUS 4,B02,891050,Staff,25,0,25,0
1746551976151,MUS 5,A01,957506,Dubnov; Shlomo,0,0,25,25
1746551976151,MUS 5,A02,957622,Dubnov; Shlomo,13,0,25,12
1746551976151,MUS 5,A03,957623,Dubnov; Shlomo,20,0,25,5
1746551977178,MUS 6,A01,891053,Freitas Caetano; Marcelo,24,0,25,1
1746551977178,MUS 6,A02,891054,Freitas Caetano; Marcelo,23,0,25,2
1746551978203,MUS 7,A01,891081,Staff,0,0,25,25
1746551978203,MUS 7,A02,891082,Staff,4,0,25,21
1746551979228,MUS 8GS,A00,891118,Borgo; David Garcia,0,0,25,25
1746551980291,MUS 11,A01,891140,Staff,11,0,25,14
1746551980291,MUS 11,A02,891141,Staff,22,0,25,3
1746551981318,MUS 13,A01,891143,Staff,8,0,25,17
1746551981318,MUS 13,A02,891144,Staff,24,0,25,1
1746551982346,MUS 15,A01,891146,Staff,9,0,25,16
1746551982346,MUS 15,A02,891148,Staff,21,0,25,4
1746551982346,MUS 15,B01,891150,Staff,18,0,25,7
1746551982346,MUS 15,B02,891151,Staff,25,0,25,0
1746551983374,MUS 20,A01,891153,Staff,5,0,20,15
1746551983374,MUS 20,A02,891155,Staff,14,0,20,6
1746551984402,MUS 80,A00,891156,Staff,19,0,25,6
1746551984402,MUS 80,B00,891157,Staff,23,0,25,2
1746551985428,MUS 130,A00,891158,Ohnishi; Takae,35,0,35,0
1746551986455,MUS 150GS,A01,891160,Borgo; David Garcia,0,0,25,25
1746551987479,MUS 170,A01,891162,Freitas Caetano; Marcelo,20,0,25,5
1746551987479,MUS 170,A02,891164,Freitas Caetano; Marcelo,21,0,25,4
1746551988504,NANO 11,A00,886220,Vazquez Mena; Oscar,13,0,15,2
1746551989534,NANO 15,A01,886222,Drews; Aaron,4,0,7,3
1746551990560,NANO 104,A00,886224,Sirbuly; Donald,18,0,25,7
1746551991588,PH 40,A00,886528,Staff,23,0,40,17
1746551992617,PH 45,A01,886799,Staff,35,0,40,5
1746551993643,PH 110,A00,886802,Staff,0,7,40,40
1746551994668,PH 172,A00,906716,Staff,19,0,35,16
1746551995697,PH 191,A00,886803,Staff,6,0,40,34
1746551996726,PHIL 1,A00,889500,Staff,19,0,30,11
1746551997754,PHIL 10,A01,889549,Grush; Rick Scott,15,0,22,7
1746551997754,PHIL 10,A02,889551,Grush; Rick Scott,22,0,22,0
1746551998779,PHIL 28,A01,889559,Lamey; Andy M.,0,1,31,31
1746551998779,PHIL 28,A02,889561,Lamey; Andy M.,0,1,30,30
1746551998779,PHIL 28,A03,889572,Lamey; Andy M.,0,1,30,30
1746551999803,PHIL 35,A00,907839,Staff,13,0,15,2
1746552000827,PHIL 60,A00,889574,Staff,74,0,90,16
1746552001852,PHIL 101,A00,958004,Staff,13,0,15,2
1746552003902,PHIL 136,A00,889582,Fulkerson; Matthew Todd,26,0,45,19
1746552004927,PHIL 163,A01,889601,Staff,21,0,30,9
1746552004927,PHIL 163,B01,889606,Brandt; Reuven A,0,3,0,0
1746552005952,PHIL 164,A00,889610,Staff,16,0,30,14
1746552006980,PHIL 165,A00,889613,Staff,23,0,30,7
1746552008005,PHYS 1A,A00,886431,Staff,26,0,70,44
1746552009032,PHYS 1AL,001,886432,Tsai; Philbert S,0,2,30,30
1746552009032,PHYS 1AL,002,886436,Tsai; Philbert S,11,0,30,19
1746552010060,PHYS 1B,A00,886439,Staff,185,0,240,55
1746552011088,PHYS 1BL,001,886441,Tsai; Philbert S,0,4,30,30
1746552011088,PHYS 1BL,002,886444,Tsai; Philbert S,2,0,30,28
1746552012117,PHYS 1C,A00,896092,Arnold; Kam S,78,0,146,68
1746552013146,PHYS 1CL,001,886448,Tsai; Philbert S,0,0,30,30
1746552013146,PHYS 1CL,002,886449,Tsai; Philbert S,0,0,30,30
1746552013146,PHYS 1CL,003,886450,Tsai; Philbert S,16,0,30,14
1746552013146,PHYS 1CL,004,886451,Tsai; Philbert S,15,0,30,15
1746552014172,PHYS 2B,A01,886457,Staff,69,0,115,46
1746552015200,PHYS 2C,A01,886460,Shotwell; Brian,0,8,65,65
1746552016225,PHYS 2CL,A01,886467,Staff,0,4,28,28
1746552016225,PHYS 2CL,A02,886468,Staff,0,3,28,28
1746552017255,PHYS 2D,A01,886470,Staff,10,0,50,40
1746552018280,PHYS 4B,A01,886475,Grinstein; Benjamin,22,0,40,18
1746552019306,POLI 5,A00,891173,Desposato; Scott,7,0,25,18
1746552020335,POLI 5D,A01,891175,Staff,5,0,5,0
1746552020335,POLI 5D,B01,891178,Staff,5,0,5,0
1746552021368,POLI 11,A00,891179,Ferree; Karen E,2,0,35,33
1746552022394,POLI 12,A00,891180,Staff,16,0,30,14
1746552023427,POLI 27,A01,891182,Staff,12,0,75,63
1746552024452,POLI 30,A00,891183,Staff,8,0,50,42
1746552025482,POLI 100B,A00,891244,Staff,5,1,35,30
1746552026509,POLI 100I,A00,891247,Staff,7,0,30,23
1746552027537,POLI 104J,A00,891248,Nichter; Maysa,14,0,30,16
1746552028564,POLI 104U,A00,891250,Nichter; Maysa,2,0,30,28
1746552030613,POLI 110B,A00,891255,Wiens; David,20,0,25,5
1746552031637,POLI 112A,A00,891256,Wiens; David,6,0,25,19
1746552032663,POLI 114BR,A00,891261,Staff,19,0,30,11
1746552033691,POLI 117R,A00,891262,Forman; Fonna,0,6,50,50
1746552034720,POLI 118,A00,891264,Ingham; Sean,17,0,25,8
1746552035746,POLI 124A,A00,891265,Staff,18,0,20,2
1746552036771,POLI 125D,A00,891266,Nichter; Simeon C,2,0,25,23
1746552037798,POLI 126,A00,891268,Nichter; Simeon C,7,0,25,18
1746552038825,POLI 126AA,A00,891272,Staff,17,0,25,8
1746552039850,POLI 130AA,A00,891273,Staff,15,0,20,5
1746552040879,POLI 134AA,A00,891274,Staff,4,0,20,16
1746552042932,POLI 138,A00,891278,Staff,21,0,25,4
1746552043957,POLI 142K,A00,891280,Staff,11,0,25,14
1746552044987,POLI 142M,A00,891281,Gartzke; Erik,17,0,30,13
1746552046014,POLI 142P,A00,891284,Staff,20,0,30,10
1746552047041,POLI 143,A00,891285,Gartzke; Erik,12,0,30,18
1746552048068,POLI 153,A00,891286,Staff,19,0,20,1
1746552050124,POLI 175,A00,891290,Staff,15,0,20,5
1746552051150,PSYC 1,A00,890674,Steiner; Eric Tomas,0,11,45,45
1746552052177,PSYC 2,A00,890676,Albright; Thomas D,21,0,35,14
1746552053202,PSYC 3,A00,890679,Staff,17,0,20,3
1746552054230,PSYC 6,A00,959858,Staff,20,0,20,0
1746552055258,PSYC 60,A01,890684,Rickard; Timothy C.,0,5,45,45
1746552056285,PSYC 70,A01,890689,Geller; Emma Harlan,7,0,30,23
1746552057312,PSYC 71,A01,959860,Staff,21,0,25,4
1746552058337,PSYC 100,A00,890690,Lacefield; Katharine I,0,50,180,180
1746552059362,PSYC 102,A00,890695,Staff,18,0,40,22
1746552060387,PSYC 105,A00,890699,Geller; Emma Harlan,71,0,100,29
1746552061412,PSYC 106,A00,890701,Gorman; Michael R.,5,0,30,25
1746552062438,PSYC 108,A00,890704,Adrian; Julia Anna,0,28,50,50
1746552063461,PSYC 118,A01,890712,Staff,11,0,30,19
1746552064485,PSYC 124,A00,890716,Chapman; Eddie Nathaniel,25,0,60,35
1746552065511,PSYC 131,A00,890717,Anagnostaras; Stephan,0,7,80,80
1746552066536,PSYC 137,A00,890719,Winkielman; Piotr,0,11,30,30
1746552067563,PSYC 144,A00,890721,Adrian; Julia Anna,0,9,45,45
1746552068589,PSYC 162,A00,890805,Staff,2,0,75,73
1746552069616,PSYC 169,A00,890810,Staff,0,15,30,30
1746552070642,PSYC 172,A00,890814,Gorman; Michael R.,9,0,30,21
1746552071666,PSYC 181,A00,890818,Anagnostaras; Stephan,8,0,200,192
1746552072693,PSYC 184,A00,959861,Staff,170,0,175,5
1746552073717,PSYC 189,A00,890823,Staff,0,1,30,30
1746552074744,PSYC 191,A00,890884,Rickard; Timothy C.,0,11,35,35
1746552075771,PSYC 193,A00,890913,Staff,19,0,30,11
1746552075771,PSYC 193,B00,890914,Chapman; Eddie Nathaniel,24,0,30,6
1746552076796,PSYC 193L,A01,890918,Lowe; Angela Beth,20,0,30,10
1746552076796,PSYC 193L,B01,890921,Hurwitz; Ethan Scott,20,0,30,10
1746552076796,PSYC 193L,C01,890928,Staff,30,0,30,0
1746552077825,RELI 149,A00,886806,Rahimi; Babak,23,0,40,17
1746552078853,SE 9,A01,886814,Staff,7,0,20,13
1746552079877,SE 101B,A01,886816,Chadha; Mayank,4,0,35,31
1746552080900,SE 110B,A00,886818,Zhu; Qiang,4,0,75,71
1746552081925,SE 125,A01,886830,Staff,10,0,30,20
1746552082953,SE 130B,A01,886835,Staff,14,0,40,26
1746552084020,SE 131A,A01,886838,Krysl; Petr,34,0,55,21
1746552085046,SE 154,A00,886840,Staff,30,0,50,20
1746552086071,SE 164GS,A01,886849,Staff,6,0,20,14
1746552087096,SE 167GS,A01,886853,Staff,6,0,20,14
1746552088122,SIO 25,A01,890107,Staff,19,0,30,11
1746552089147,SIO 45,A00,890109,Cook; Geoffrey W,117,0,200,83
1746552090173,SIO 109R,A00,890110,Forman; Fonna,0,16,20,20
1746552091202,SIO 187,A01,890114,Kacev; David,15,0,40,25
1746552092231,SOCI 1,A01,890431,Thorpe; Charles Robert,15,0,30,15
1746552092231,SOCI 1,A02,890518,Thorpe; Charles Robert,30,0,30,0
1746552093261,SOCI 2,A01,957978,Staff,25,0,25,0
1746552093261,SOCI 2,A02,957979,Staff,23,0,25,2
1746552094286,SOCI 20,A01,890523,Calderon-Zaks; Michael Aar,23,0,30,7
1746552094286,SOCI 20,A02,890526,Calderon-Zaks; Michael Aar,29,0,30,1
1746552095313,SOCI 30,A01,890533,Pardo Guerra; Juan Pablo,37,0,40,3
1746552096340,SOCI 40,A01,890535,Staff,27,0,45,18
1746552097364,SOCI 104Q,A00,890559,Staff,18,0,30,12
1746552098389,SOCI 106,A00,890560,Arnal; Maud Marie Leonie,20,0,30,10
1746552099417,SOCI 110,A00,890567,Holkenbrink-Monk; Charlene,19,0,30,11
1746552100441,SOCI 112,A00,890568,Victoria Torres; Pablo,1,0,55,54
1746552101466,SOCI 115,A00,890597,Arnal; Maud Marie Leonie,28,0,45,17
1746552103516,SOCI 121,A00,890604,Pardo Guerra; Juan Pablo,38,0,45,7
1746552104540,SOCI 126,A01,890608,Staff,8,0,10,2
1746552105565,SOCI 127,A00,890609,Staff,18,0,30,12
1746552106593,SOCI 131,A00,890610,Thorpe; Charles Robert,37,0,45,8
1746552107618,SOCI 135,A00,890615,Payne; Christine Anna,14,0,45,31
1746552108645,SOCI 139,A00,890620,Staff,38,0,45,7
1746552109670,SOCI 148E,A00,890622,Calderon-Zaks; Michael Aar,36,0,45,9
1746552110698,SOCI 150,A00,890623,Kohler; Kristopher M.,31,0,45,14
1746552111725,SOCI 157,A00,890625,Jules-Rosette; Bennetta W.,18,0,20,2
1746552112752,SOCI 160,A00,890627,Payne; Christine Anna,21,0,45,24
1746552113776,SYN 1,A00,886855,Fish; Gwendolyn Anne,0,0,0,0
1746552113776,SYN 1,B00,906086,Fish; Gwendolyn Anne,0,1,0,2
1746552114805,SYN 2R,A00,886860,Staff,0,17,15,15
1746552114805,SYN 2R,B00,906106,Atkinson; Arthur Laird,0,16,15,15
1746552115836,SYN 100,A01,886866,Browne; Emily,0,28,20,20
1746552115836,SYN 100,B01,906128,Rock; Martin,0,5,20,20
1746552115836,SYN 100,C01,906140,Deavenport; James Cary,0,3,20,20
1746552115836,SYN 100,D01,907816,Deavenport; James Cary,0,5,20,20
1746552116862,TDAC 1,A00,890286,Walsh; Kim C.,9,0,20,11
1746552117890,TDAC 101,A00,890296,Basso; Beatrice,16,0,20,4
1746552118916,TDDE 131,A00,890297,Staff,47,0,50,3
1746552119942,TDDM 1,A00,890287,Weinberg; Sadie,25,0,30,5
1746552120984,TDGE 11,A00,890288,Fulton; Julia,137,0,200,63
1746552120984,TDGE 11,B00,890289,Castro; Robert Jess,184,0,200,16
1746552122008,TDGE 25,B00,957359,Walsh; Kim C.,3,0,20,17
1746552123033,TDGE 40,A01,890292,Power; Jade Yukana,27,0,30,3
1746552124058,TDGE 124,A00,890298,Havis; Allan,0,1,50,50
1746552125085,TDGE 131R,A00,890299,Burelle; Julie Sara Veronique,15,0,42,27
1746552126109,TDHT 101,A00,890300,Staff,10,0,20,10
1746552127134,TDHT 109,A01,890302,Anderson; Mysia Anyse,31,0,40,9
1746552128165,TDMV 1,A00,890293,Arcidiacono; Kristin,18,0,30,12
1746552129191,TDMV 2,A00,890294,Weinberg; Sadie,23,0,30,7
1746552130219,TDMV 3,A00,957878,Arcidiacono; Kristin,28,0,30,2
1746552132270,TDMV 138,A00,890304,Jun; Grace Shin Hae,25,0,40,15
1746552133293,TDMV 140,A00,890305,Corrales; Joseph Bernales,25,0,30,5
1746552134321,TDMV 142,A00,890307,Caligagan; Tony,32,0,40,8
1746552135346,TDMV 144,A00,890308,Camaya; Michelle Ann,25,0,30,5
1746552136371,TDPW 1,A00,890295,Stein; Deborah Isobel,3,0,20,17
1746552137399,USP 2,A01,890272,Lerner; Amy M,6,0,20,14
1746552138425,USP 3,A01,890274,Staff,12,0,30,18
1746552139451,USP 15,A01,890276,Sun; Feiyang,17,0,30,13
1746552140485,USP 25,A00,890277,Shenkman; Michael Thomas,19,0,25,6
1746552141514,USP 138,A00,890278,Staff,13,0,25,12
1746552142543,USP 143,A00,890279,Staff,21,0,70,49
1746552143573,USP 144,A00,890280,Chowdhury; Muhammed Zohir,16,0,30,14
1746552144597,USP 150,A00,890281,Boomhower; Matthew Charles,4,0,30,26
1746552145625,USP 151,A00,890282,Staff,16,0,20,4
1746552146657,USP 162,A00,890283,Andrews; Abigail Leslie,16,0,20,4
1746552147682,USP 168,A00,920477,Kwak; Nancy,1,0,5,4
1746552148709,USP 181,A00,890284,Staff,3,0,20,17
1746552149734,USP 191A,A00,890285,Staff,13,0,20,7
1746552150759,VIS 101,A00,886512,Staff,25,0,75,50
1746552151787,VIS 103,A00,886513,Cruz; Edwin Teddy,61,0,75,14
1746552152812,VIS 108,A00,886514,Staff,3,0,15,12
1746552153837,VIS 127P,A00,886515,Shen; Kuiyi,80,0,146,66
1746552154863,VIS 149,A00,886516,Yoldas; Pinar,0,0,15,15
1746552155887,VIS 164,A00,886526,Erdmann; Dean,19,0,22,3
1746552156912,VIS 194S,A00,886527,Staff,61,0,75,14
1746552157941,WCWP 10A,C00,886484,Martiniuk; Jill,12,0,15,3
1746552158965,WCWP 10B,A00,886490,Uriarte; Emma,0,0,15,15
1746552158965,WCWP 10B,B00,886491,Dhir; Simrita,10,0,15,5
1746552158965,WCWP 10B,C00,886492,Ornelas; Tricia,0,0,15,15
1746552159992,WCWP 100,A00,886494,Young; Mark T,0,6,15,15
1746552162077,AAS 10,A01,886199,Childs; Dennis R.,0,3,0,0
1746552163102,ANAR 104,A01,886940,Shtienberg; Gilad,27,0,30,3
1746552164126,ANAR 120,A00,886953,Staff,12,0,20,8
1746552165155,ANBI 148,A01,886955,Wilder; Linnea Lorene,30,0,40,10
1746552167203,ANSC 122,A00,886957,Staff,25,0,30,5
1746552168230,ANSC 150,A00,886958,Sloane; Julia Kathryn,2,0,15,13
1746552169256,ANSC 156,A00,886959,Jenkins; Janis A.,0,1,15,15
1746552170284,ANSC 180,A00,886960,Staff,11,0,17,6
1746552171312,ANSC 188,A00,886961,Jassal; Aftab,9,0,25,16
1746552172337,ANSC 190,A00,886962,Jassal; Aftab,14,0,25,11
1746552173363,ANSC 191,A00,886963,Staff,18,0,20,2
1746552174387,ANTH 3,A01,891689,Staff,17,0,20,3
1746552175415,ANTH 5,A00,886933,Semendeferi; Ekaterini,16,0,20,4
1746552176440,ANTH 10,A00,886934,Staff,0,12,30,30
1746552177466,ANTH 21,A01,886936,Staff,40,0,60,20
1746552178492,ANTH 23,A01,886938,Staff,92,0,100,8
1746552179517,ANTH 105,A00,886964,Stewart; Alexander B,84,0,100,16
1746552180541,ANTH 108,A00,886965,Pedersen; David,9,0,20,11
1746552181568,AWP 10,001,886147,Staff,0,0,0,0
1746552181568,AWP 10,002,886148,Staff,0,0,0,0
1746552181568,AWP 10,003,886149,Staff,0,0,0,0
1746552181568,AWP 10,004,886150,Staff,0,0,0,0
1746552181568,AWP 10,005,886151,Staff,0,0,0,0
1746552181568,AWP 10,006,886152,Staff,0,0,0,0
1746552181568,AWP 10,007,886153,Staff,0,0,0,0
1746552181568,AWP 10,008,886154,Staff,0,0,0,0
1746552181568,AWP 10,009,886155,Staff,0,0,0,0
1746552181568,AWP 10,010,886156,Staff,0,0,0,0
1746552181568,AWP 10,011,886158,Staff,0,0,0,0
1746552181568,AWP 10,012,886160,Staff,0,0,0,0
1746552181568,AWP 10,013,886161,Staff,0,0,0,0
1746552181568,AWP 10,014,886162,Staff,0,0,0,0
1746552181568,AWP 10,015,886163,Staff,0,0,0,0
1746552181568,AWP 10,016,886164,Staff,0,0,0,0
1746552181568,AWP 10,017,886165,Staff,0,0,0,0
1746552181568,AWP 10,018,886166,Staff,0,0,0,0
1746552181568,AWP 10,019,886168,Staff,0,0,0,0
1746552181568,AWP 10,020,886170,Staff,0,0,0,0
1746552181568,AWP 10,021,886172,Staff,0,0,0,0
1746552182598,AWP 10R,001,886173,Staff,0,1,0,0
1746552182598,AWP 10R,002,886174,Staff,0,1,0,0
1746552182598,AWP 10R,003,886175,Staff,0,0,0,0
1746552182598,AWP 10R,004,886176,Staff,0,0,0,0
1746552182598,AWP 10R,005,886177,Staff,0,0,0,0
1746552182598,AWP 10R,006,886178,Staff,0,0,0,0
1746552182598,AWP 10R,007,886179,Staff,0,0,0,0
1746552182598,AWP 10R,008,886181,Staff,0,0,0,0
1746552182598,AWP 10R,009,886182,Staff,0,0,0,0
1746552182598,AWP 10R,010,886183,Staff,0,0,0,0
1746552182598,AWP 10R,011,886184,Staff,0,0,0,0
1746552182598,AWP 10R,012,886185,Staff,0,0,0,0
1746552182598,AWP 10R,013,886186,Staff,0,0,0,0
1746552182598,AWP 10R,014,886187,Staff,0,0,0,0
1746552182598,AWP 10R,015,886188,Staff,0,0,0,0
1746552182598,AWP 10R,016,886189,Staff,0,0,0,0
1746552183623,AWP 102R,A00,886190,Staff,0,0,0,0
1746552183623,AWP 102R,B00,886191,Staff,0,0,0,0
1746552184652,BENG 100,A01,886193,Staff,17,0,30,13
1746552185677,BENG 122A,A01,886195,Hasty; Jeff M,13,0,30,17
1746552186702,BENG 166A,A00,886196,Sah; Robert Lie-Yuan,0,2,30,30
1746552187769,BENG 190,A00,958050,Khojah; Reem I,24,0,25,1
1746552188794,BIBC 102,A01,894320,Staff,0,0,46,46
1746552188794,BIBC 102,A02,894321,Staff,0,0,46,46
1746552188794,BIBC 102,A03,894344,Staff,7,0,46,39
1746552188794,BIBC 102,A04,894345,Staff,26,0,47,21
1746552189819,BICD 100R,A01,894365,Smith; Laurie,0,3,58,58
1746552189819,BICD 100R,A02,894366,Smith; Laurie,0,5,58,58
1746552189819,BICD 100R,A03,894367,Smith; Laurie,2,0,59,57
1746552189819,BICD 100R,A04,959869,Smith; Laurie,41,0,59,18
1746552190845,BICD 136,A01,894383,Gustafson-Brown; Cindy,14,0,50,36
1746552191873,BIEB 102,A01,894494,Butler; Shannon Rhey,51,0,130,79
1746552193928,BIEB 150,A01,894617,Wills; Christopher,3,0,20,17
1746552193928,BIEB 150,A02,894631,Wills; Christopher,3,0,20,17
1746552193928,BIEB 150,A03,894937,Wills; Christopher,3,0,20,17
1746552193928,BIEB 150,A04,894946,Wills; Christopher,5,0,20,15
1746552194956,BIEB 194,A00,906141,Kurle; Carolyn M.,6,0,20,14
1746552195982,BILD 1,A01,894154,Staff,2,0,19,17
1746552195982,BILD 1,A02,894155,Staff,14,0,19,5
1746552195982,BILD 1,A03,894160,Staff,13,0,19,6
1746552195982,BILD 1,A04,894161,Staff,15,0,18,3
1746552197018,BILD 2,A01,894168,Staff,0,0,50,50
1746552197018,BILD 2,A02,894169,Staff,0,0,50,50
1746552197018,BILD 2,A03,894179,Staff,4,0,50,46
1746552197018,BILD 2,A04,894203,Staff,27,0,50,23
1746552198045,BILD 3,A01,894213,Staff,22,0,31,9
1746552198045,BILD 3,A02,894214,Staff,26,0,31,5
1746552198045,BILD 3,A03,894235,Staff,28,0,31,3
1746552198045,BILD 3,A04,894236,Staff,28,0,32,4
1746552199072,BILD 4,A01,894253,Reuther; Keefe,5,0,24,19
1746552199072,BILD 4,A02,894258,Reuther; Keefe,16,0,24,8
1746552200103,BILD 5,A01,894276,Reuther; Keefe,35,0,50,15
1746552200103,BILD 5,A02,894277,Reuther; Keefe,45,0,50,5
1746552200103,BILD 5,A03,894290,Reuther; Keefe,44,0,50,6
1746552200103,BILD 5,A04,894291,Reuther; Keefe,48,0,50,2
1746552201128,BILD 24,A01,894297,Pirino; Giorgia,40,0,60,20
1746552202156,BIMM 100,B01,958915,Staff,72,0,100,28
1746552203182,BIMM 101,A01,895017,McDonnell; Lisa Marie,0,5,24,24
1746552203182,BIMM 101,A02,895018,McDonnell; Lisa Marie,0,5,24,24
1746552203182,BIMM 101,B01,895020,McDonnell; Lisa Marie,0,6,24,24
1746552203182,BIMM 101,B02,895021,McDonnell; Lisa Marie,0,4,24,24
1746552204207,BIMM 110,A01,895023,Staff,1,0,25,24
1746552204207,BIMM 110,A02,895024,Staff,9,0,25,16
1746552204207,BIMM 110,A03,895025,Staff,18,0,25,7
1746552204207,BIMM 110,A04,895031,Staff,20,0,25,5
1746552205237,BIMM 120,A01,895114,Gustafson-Brown; Cindy,14,0,28,14
1746552205237,BIMM 120,A02,895126,Gustafson-Brown; Cindy,21,0,27,6
1746552206264,BIPN 100,A01,895130,Yang; Mingyu,1,0,38,37
1746552206264,BIPN 100,A02,895131,Yang; Mingyu,32,0,38,6
1746552206264,BIPN 100,A03,895132,Yang; Mingyu,32,0,38,6
1746552206264,BIPN 100,A04,895133,Yang; Mingyu,27,0,36,9
1746552207289,BIPN 120,A01,895135,Cooke; James Edward,0,3,13,13
1746552207289,BIPN 120,A02,895136,Cooke; James Edward,0,1,13,13
1746552207289,BIPN 120,A03,895137,Cooke; James Edward,0,3,13,13
1746552207289,BIPN 120,A04,895156,Cooke; James Edward,0,2,11,11
1746552208314,BIPN 134,A01,895235,Cooke; James Edward,0,2,25,25
1746552208314,BIPN 134,A02,895237,Cooke; James Edward,0,0,25,25
1746552208314,BIPN 134,A03,895240,Cooke; James Edward,3,0,25,22
1746552208314,BIPN 134,A04,895270,Cooke; James Edward,20,0,25,5
1746552209340,BIPN 189,A00,892103,Staff,0,13,14,14
1746552211390,BISP 194,A00,958008,Staff,0,2,0,0
1746552212418,CAT 124,A01,922009,Staff,0,5,20,20
1746552213449,CAT 125R,A00,886390,Morales; Celeste Georgianna,0,2,20,20
1746552213449,CAT 125R,B00,886391,Irwin; Matthew Joseph,0,3,20,20
1746552213449,CAT 125R,C00,886392,Smith; Lauryn Alissa,0,2,20,20
1746552213449,CAT 125R,D00,886393,Vanderschuit; Maya Alysia,0,2,20,20
1746552213449,CAT 125R,E00,886394,Marchisotto; Jennifer Anne,0,4,20,20
1746552214473,CENG 15,A01,886218,Drews; Aaron,3,0,8,5
1746552215498,CENG 113,A00,886219,Opatkiewicz; Justin Paul,15,0,25,10
1746552216526,CGS 101,A00,887044,Staff,7,0,20,13
1746552217551,CGS 105,A01,887046,Staff,14,0,25,11
1746552218576,CGS 112,A00,887047,Cuong; Marisol,12,0,15,3
1746552219603,CGS 113,A00,887048,Staff,23,0,30,7
1746552220629,CGS 120,A00,887049,Staff,10,0,17,7
1746552221657,CHEM 6A,A01,886336,Lam; Tin Yiu,38,0,50,12
1746552221657,CHEM 6A,A02,886338,Lam; Tin Yiu,37,0,50,13
1746552222682,CHEM 6B,A01,886341,Hopkins; Patrycja Anna,16,0,50,34
1746552222682,CHEM 6B,A02,886343,Hopkins; Patrycja Anna,42,0,50,8
1746552223708,CHEM 6C,A01,886346,Albizati; Kim F.,0,2,50,50
1746552223708,CHEM 6C,A02,886348,Albizati; Kim F.,23,0,50,27
1746552224735,CHEM 40A,A01,886352,Klosterman; Jeremy K,65,0,100,35
1746552225785,CHEM 40B,A01,886356,Klosterman; Jeremy K,0,23,100,100
1746552226839,CHEM 41B,A01,886360,Theodorakis; Emmanuel,25,0,50,25
1746552226839,CHEM 41B,A02,886362,Theodorakis; Emmanuel,47,0,50,3
1746552227864,CHIN 165A,A00,886382,Xu; Li,18,0,20,2
1746552228890,CLAS 120,A00,886387,Myerston Santana; Jacobo,33,0,40,7
1746552229925,COGS 9,A01,886967,Shannon; Kyle Michael,42,0,60,18
1746552230952,COGS 11,A01,886969,Staff,11,0,30,19
1746552231981,COGS 14A,A01,886971,Staff,6,0,60,54
1746552233008,COGS 14B,A01,886973,Hoffman; Drew Ellen,4,0,60,56
1746552234034,COGS 18,A01,886975,Morgan; Eric,35,0,60,25
1746552235063,COGS 20,A01,886977,Staff,4,0,8,4
1746552235063,COGS 20,A02,886978,Staff,5,0,7,2
1746552236089,COGS 100,A01,907783,Staff,0,2,30,30
1746552237114,COGS 101B,A01,886980,Staff,0,3,48,48
1746552238139,COGS 101C,A01,886982,Delgado; Tania,0,5,44,44
1746552239162,COGS 102A,A01,886984,Johnson; Christine M.,4,0,30,26
1746552240188,COGS 118B,A01,886986,Staff,0,3,88,88
1746552241213,COGS 150,A01,886988,Bergen; Benjamin,23,0,50,27
1746552242237,COGS 153,A00,886989,Delgado; Tania,0,2,41,41
1746552243262,COGS 186,A01,886991,Staff,0,0,32,32
1746552244287,COGS 187A,A01,886993,Boyle; Mary E. T.,7,0,30,23
1746552245314,COGS 189,A00,886994,Staff,0,1,30,30
1746552246342,COMM 10,A01,886996,Staff,0,0,20,21
1746552246342,COMM 10,A02,886997,Staff,12,0,20,8
1746552246342,COMM 10,A03,959845,Staff,19,0,20,1
1746552247371,COMM 20,A01,886999,Leuning; Grant Maurstad,24,0,40,16
1746552249423,COMM 100A,A01,887002,Staff,0,0,20,25
1746552249423,COMM 100A,A02,887003,Staff,7,0,20,13
1746552250447,COMM 100B,A01,887005,Staff,0,8,20,24
1746552251474,COMM 106D,A00,887006,Staff,14,0,40,26
1746552252499,COMM 110G,A00,887007,Whitworth-Smith; Andrew C,12,0,40,28
1746552253525,COMM 111B,A00,887008,Staff,31,0,40,9
1746552254554,COMM 113T,A00,887009,Abuelhiga; Soraya Jill,28,0,40,12
1746552254554,COMM 113T,B00,906733,Staff,40,0,40,0
1746552255582,COMM 145,A00,887010,Staff,12,0,40,28
1746552256609,COMM 146,A00,887054,Staff,31,0,40,9
1746552257633,COMM 190,A00,887012,Staff,8,0,23,15
1746552258660,CSE 8A,A50,887015,Cao; Yingjun,57,0,85,28
1746552259685,CSE 11,A01,887017,Cao; Yingjun,12,0,70,58
1746552260712,CSE 20,A01,887019,Staff,30,0,50,20
1746552261740,CSE 21,A01,887021,Staff,78,0,100,22
1746552261740,CSE 21,B01,892583,Braun; Oliver,45,0,50,5
1746552262765,CSE 30,A01,887025,Eldon; John,143,0,200,57
1746552263792,CSE 100,A01,887027,Staff,26,0,50,24
1746552263792,CSE 100,A02,887028,Staff,40,0,50,10
1746552264822,CSE 101,A01,887030,Braun; Oliver,75,0,100,25
1746552264822,CSE 101,B01,887032,Jones; Miles E,0,3,50,50
1746552264822,CSE 101,B02,887033,Jones; Miles E,0,1,50,50
1746552265849,CSE 105,A01,908084,Jones; Miles E,32,0,50,18
1746552265849,CSE 105,A02,908087,Jones; Miles E,32,0,50,18
1746552266877,CSE 135,A01,887035,Powell; Thomas Allan,0,4,50,50
1746552267902,CSE 142,A01,887037,Staff,8,0,60,52
1746552268929,CSE 142L,A01,887039,Staff,34,0,60,26
1746552269959,CSE 151A,A01,887041,Solares; Edwin A,47,0,100,53
1746552270986,CSE 175,A01,887043,Kumar; Rakesh,30,0,30,0
1746552272016,CSS 1,A01,886389,Staff,0,1,40,40
1746552273045,DSC 30,A01,908097,Liao; Soohyun Nam,47,0,75,28
1746552274070,DSC 40A,A01,908099,Shannon; Kyle Michael,30,0,50,20
1746552275094,DSC 40B,A01,908112,Staff,16,0,50,34
1746552276124,DSC 80,A01,908116,Staff,19,0,60,41
1746552277149,DSC 197,001,956863,Eldridge; Justin Matthew,9999,0,9999,0
1746552278173,ECE 5,A01,886400,Morris; Karcher William,2,0,6,4
1746552278173,ECE 5,A02,886401,Morris; Karcher William,3,0,6,3
1746552279199,ECE 148,A01,886403,Silberman; Jack,0,14,14,14
1746552280226,ECON 1,A01,887265,Crane; Meredith Helen,12,0,70,58
1746552280226,ECON 1,B01,887268,Staff,43,0,50,7
1746552281252,ECON 2,A01,887273,Crane; Meredith Helen,56,0,70,14
1746552282280,ECON 3,A01,887279,Rondina; Giacomo,32,0,70,38
1746552283306,ECON 4,A01,887282,Anderson; John Charles,0,2,10,10
1746552284330,ECON 5,A01,887285,Staff,33,0,45,12
1746552284330,ECON 5,B01,887292,Staff,41,0,45,4
1746552285361,ECON 100A,A01,887337,Newhouse; Herbert S,54,0,70,16
1746552285361,ECON 100A,B01,887349,Staff,45,0,50,5
1746552286386,ECON 100B,A01,887361,Du; Songzi,29,0,70,41
1746552287411,ECON 100C,A01,887445,Newhouse; Herbert S,59,0,70,11
1746552288438,ECON 105,A00,887488,Vespa; Emanuel Ignacio,23,0,35,12
1746552289462,ECON 109,A01,887506,Shishkin; Denis,28,0,35,7
1746552290512,ECON 110A,A01,887568,Alon; Titan Michael,0,3,35,35
1746552290512,ECON 110A,B01,907601,Alon; Titan Michael,20,0,35,15
1746552291541,ECON 110B,A01,887598,Levkoff; Steven B.,0,23,70,70
1746552292567,ECON 112,A00,887599,Rondina; Giacomo,19,0,35,16
1746552293591,ECON 120A,A01,887603,Dai; Yinlin,36,0,70,34
1746552294617,ECON 120C,A01,887608,Sun; Yixiao,0,1,35,35
1746552294617,ECON 120C,B01,887614,Sun; Yixiao,0,0,35,35
1746552295641,ECON 138,A00,887621,Bharadwaj; Prashant,0,21,20,20
1746552296668,ECON 144,A00,958007,Squires; Dale E,13,0,35,22
1746552297698,ECON 171,A01,907666,Staff,18,0,35,17
1746552298723,ECON 175,A00,887626,Wu; Pak Yeung,23,0,35,12
1746552299746,ECON 190,A00,887640,Vespa; Emanuel Ignacio,23,0,35,12
1746552300782,EDS 25,A01,888197,Staff,0,0,0,0
1746552300782,EDS 25,A02,888209,Staff,0,0,0,0
1746552300782,EDS 25,A03,888210,Staff,0,0,0,0
1746552300782,EDS 25,A04,888212,Staff,0,0,0,0
1746552300782,EDS 25,A05,888213,Staff,0,0,0,0
1746552300782,EDS 25,A06,888214,Staff,0,0,0,0
1746552300782,EDS 25,A07,888235,Staff,0,2,0,0
1746552300782,EDS 25,A08,888236,Staff,0,0,0,0
1746552300782,EDS 25,A09,888240,Staff,0,0,0,0
1746552300782,EDS 25,A10,888244,Staff,0,0,0,0
1746552300782,EDS 25,B01,888273,Staff,0,0,0,0
1746552300782,EDS 25,B02,888285,Staff,0,0,0,0
1746552300782,EDS 25,B03,888423,Staff,0,0,0,1
1746552300782,EDS 25,B04,888432,Staff,0,0,0,0
1746552300782,EDS 25,B05,888433,Staff,0,0,0,0
1746552300782,EDS 25,B06,888467,Staff,0,0,0,0
1746552300782,EDS 25,B07,888468,Staff,0,0,0,0
1746552300782,EDS 25,B08,888479,Staff,0,0,0,0
1746552300782,EDS 25,B09,888484,Staff,0,0,0,0
1746552300782,EDS 25,B10,888487,Staff,0,0,0,0
1746552301806,EDS 38,A01,907700,Choi; Bailey Miyeon,30,0,30,0
1746552302835,EDS 112,A01,888601,Chapman; Thandeka K,14,0,40,26
1746552303864,EDS 115,A00,888697,Mendez; Kathrina Mendoza,10,0,30,20
1746552304892,EDS 116,A01,888893,Staff,35,0,40,5
1746552306943,EDS 124AR,A00,889133,Staff,29,0,50,21
1746552306943,EDS 124AR,B00,907471,Simon; Elizabeth A,37,0,50,13
1746552307969,EDS 124BR,A00,889134,Simon; Elizabeth A,45,0,100,55
1746552308995,EDS 125,A00,889135,Staff,25,0,30,5
1746552310022,EDS 126,A01,889138,Staff,36,0,40,4
1746552311051,EDS 164R,A01,889142,Wishard Guerra; Alison G.,33,0,50,17
1746552312076,ENG 30,A01,886396,Staff,0,0,0,0
1746552312076,ENG 30,B01,886398,Staff,0,0,0,0
1746552313103,ENVR 102,A00,906150,Montejo; Carolina,23,0,25,2
1746552314128,ETHN 103A,A00,887236,Man; Simeon S,0,3,0,0
1746552315157,ETHN 113,A00,887239,Staff,16,0,30,14
1746552316186,ETHN 116,A00,887240,Staff,16,0,25,9
1746552317214,ETHN 117,A00,887241,Choi; Esther Min,28,0,30,2
1746552318241,ETHN 118,A00,887243,Staff,24,0,30,6
1746552319267,ETHN 127,A00,887248,Cuong; Marisol,11,0,15,4
1746552320295,ETHN 139,A00,887250,Staff,7,0,10,3
1746552321321,ETHN 142,A00,887252,Staff,10,0,30,20
1746552322346,ETHN 161,A00,887253,Browne; Errol Tsekani,24,0,30,6
1746552323374,ETHN 163FR,A00,887255,Burelle; Julie Sara Veronique,0,0,5,5
1746552324402,GLBH 20,A00,889149,Elwardani; Nile Regina,8,0,42,34
1746552326451,GLBH 111,A01,889152,Burgos; Jose L.,17,0,17,0
1746552327478,GLBH 150,A00,889181,Sloane; Julia Kathryn,0,5,15,15
1746552329529,HDS 60,A01,886406,Warstadt; Melissa Fawn,73,0,80,7
1746552330554,HIAF 111,A00,889324,Gyamfi; Bright,25,0,32,7
1746552331580,HIEA 131,A00,889328,Staff,16,0,32,16
1746552332604,HIEA 144,A00,889333,Henry; Todd A.,26,0,32,6
1746552333631,HIEA 154,A00,889336,Henry; Todd A.,24,0,32,8
1746552334655,HIEU 106,A00,889339,Staff,22,0,32,10
1746552336708,HIEU 114,A00,889340,Staff,3,0,32,29
1746552337735,HIEU 135GS,A00,889342,Patterson; Patrick H.,0,0,1,24
1746552338760,HIEU 137,A00,889343,Edington; Claire Ellen,9,0,25,16
1746552339785,HIEU 148,A00,889345,Staff,14,0,32,18
1746552340812,HIEU 154,A00,889346,Biess; Frank Peter,21,0,32,11
1746552341840,HILA 102,A00,889351,Staff,12,0,32,20
1746552342865,HILD 2A,A01,889221,Lewandoski; Julia Mavis,1,10,32,31
1746552343890,HILD 7B,A01,889225,Man; Simeon S,0,13,32,32
1746552344914,HILD 7C,A01,889288,Alvarez; Luis A,0,14,32,32
1746552345940,HILD 30,A01,889323,Staff,0,5,32,32
1746552347992,HISC 119,A00,889383,Golan; Tal,20,0,32,12
1746552349019,HIUS 103,A00,889384,Man; Simeon S,0,0,32,32
1746552350047,HIUS 117,A00,919797,Kwak; Nancy,18,0,32,14
1746552351075,HIUS 142A,A00,919788,Staff,22,0,32,10
1746552353126,HIUS 149,A00,889386,Gyamfi; Bright,27,0,32,5
1746552354154,HIUS 155,A00,889387,Alvarez; Luis A,14,0,32,18
1746552355184,HUM 3,A01,886499,Caldwell; Michael Alan,19,0,50,31
1746552356208,HUM 3GS,A00,886500,Rodriguez; Bretton Sigfred,0,0,0,28
1746552357233,HUM 3R,A01,886502,Markman; Kristina,0,36,50,50
1746552358259,HUM 4,A01,886504,Crum; Matthew Stephen,24,0,50,26
1746552358259,HUM 4,B01,886506,West; Geoffrey Scott,17,0,50,33
1746552359284,HUM 4GS,A00,886507,Staff,0,0,0,19
1746552360309,HUM 5,A01,886509,Staff,32,0,50,18
1746552361336,HUM 5R,A01,886511,Zavodny; Tatiana Sophia,0,39,50,50
1746552362361,JAPN 180,A00,886407,Staff,17,0,40,23
1746552363389,LATI 50,A01,886409,Martin-Cabrera; Luis,4,0,22,18
1746552363389,LATI 50,A02,886410,Martin-Cabrera; Luis,19,0,22,3
1746552363389,LATI 50,A03,886411,Martin-Cabrera; Luis,21,0,22,1
1746552363389,LATI 50,A04,886412,Martin-Cabrera; Luis,9,0,22,13
1746552364414,LAWS 101,A00,907664,Staff,28,0,60,32
1746552365442,LIAB 1A,A00,889388,Saab; Dima,17,0,20,3
1746552366472,LIAB 1AX,A00,889389,El Cheddadi; Youniss,17,0,20,3
1746552367500,LIFR 1C,A00,889391,Van Moer; Vinciane G,8,0,20,12
1746552368526,LIFR 1CX,A00,889392,Van Moer; Vinciane G,7,0,20,13
1746552369553,LIFR 1D,A00,889393,Van Moer; Vinciane G,7,0,20,13
1746552370578,LIFR 1DX,A00,889394,Van Moer; Vinciane G,8,0,20,12
1746552371605,LIGN 7,A00,886923,Staff,24,0,50,26
1746552372629,LIGN 17,A00,886924,Kehler; Andrew Scott,125,0,150,25
1746552373657,LTAM 110,A00,889395,Staff,15,0,30,15
1746552374683,LTAM 110GS,A00,958010,Rodriguez; Bretton Sigfred,0,0,0,28
1746552375708,LTCH 101,A00,889397,Staff,23,0,25,2
1746552376737,LTCS 130,A00,889398,Staff,23,0,25,2
1746552377765,LTEA 138,A00,889399,Staff,24,0,40,16
1746552378807,LTEN 149,A00,889400,Wesling; Megan E.,0,3,25,25
1746552379835,LTEN 169,A00,889401,Staff,20,0,25,5
1746552380860,LTEN 180,A00,889402,Staff,10,0,15,5
1746552381887,LTEN 181,A00,889403,Staff,21,0,25,4
1746552382913,LTWL 100,A00,889404,Myerston Santana; Jacobo,3,0,25,22
1746552383940,LTWL 180GS,A00,889405,Staff,0,0,20,20
1746552384968,LTWL 181,A00,889406,Staff,17,0,25,8
1746552385995,LTWL 184,A00,889475,Mukherjee; Silpa,22,0,25,3
1746552387023,LTWR 102C,A00,889486,Staff,29,0,30,1
1746552388047,LTWR 115W,A00,889491,Staff,0,2,15,15
1746552389079,MAE 8,A01,886905,Staff,0,2,0,0
1746552390112,MAE 11,A00,886906,Bandaru; Prabhakar,0,7,50,50
1746552391138,MAE 20,A00,886907,Evdokimenko; Ekaterina,43,0,70,27
1746552392166,MAE 30B,A00,886909,Ghazinejad; Maziar,26,0,45,19
1746552393193,MAE 101B,A00,886910,Saintillan; David,29,0,45,16
1746552394217,MAE 105,A00,886911,Bandaru; Prabhakar,18,0,50,32
1746552395245,MAE 107,B00,958024,Staff,8,0,50,42
1746552396270,MAE 143B,A00,886913,Bewley; Thomas R,7,0,40,33
1746552397297,MAE 148,A01,886915,Silberman; Jack,0,3,14,14
1746552398322,MAE 160,A00,886916,Evdokimenko; Ekaterina,31,0,60,29
1746552399350,MATH 3C,A01,889681,Staff,0,3,30,30
1746552399350,MATH 3C,A02,960048,Staff,25,0,30,5
1746552400381,MATH 10A,A01,889760,Staff,26,0,30,4
1746552400381,MATH 10A,A02,889783,Staff,29,0,30,1
1746552401411,MATH 10B,A01,889785,Verstraete; Jacques Allan,2,0,35,33
1746552401411,MATH 10B,A02,889795,Verstraete; Jacques Allan,4,0,35,31
1746552401411,MATH 10B,B01,889797,Verstraete; Jacques Allan,3,0,35,32
1746552401411,MATH 10B,B02,889828,Verstraete; Jacques Allan,3,0,35,32
1746552402437,MATH 10C,A01,889849,Habib; Yousaf,9,0,30,21
1746552402437,MATH 10C,A02,889852,Habib; Yousaf,14,0,30,16
1746552402437,MATH 10C,A03,889853,Habib; Yousaf,22,0,30,8
1746552402437,MATH 10C,A04,889858,Habib; Yousaf,20,0,30,10
1746552402437,MATH 10C,B01,889861,Staff,1,0,30,29
1746552402437,MATH 10C,B02,889862,Staff,24,0,30,6
1746552402437,MATH 10C,B03,889863,Staff,27,0,30,3
1746552402437,MATH 10C,B04,889967,Staff,23,0,30,7
1746552403464,MATH 18,A01,889974,Staff,6,0,30,24
1746552403464,MATH 18,A02,889977,Staff,20,0,30,10
1746552403464,MATH 18,B01,889984,Hardiman; Liam,22,0,30,8
1746552403464,MATH 18,B02,889985,Hardiman; Liam,25,0,30,5
1746552404490,MATH 20A,A01,889990,Suk; Andrew Hoon,30,0,35,5
1746552405515,MATH 20B,A01,889993,Ohm; Ko Woon,22,0,30,8
1746552405515,MATH 20B,A02,889994,Ohm; Ko Woon,30,0,30,0
1746552405515,MATH 20B,B01,889996,Ohm; Ko Woon,21,0,30,9
1746552405515,MATH 20B,B02,889997,Ohm; Ko Woon,23,0,30,7
1746552406545,MATH 20C,A01,889999,Hammock; Frances H,17,0,30,13
1746552406545,MATH 20C,A02,890003,Hammock; Frances H,23,0,30,7
1746552406545,MATH 20C,B01,890006,Hammock; Frances H,3,0,30,27
1746552406545,MATH 20C,B02,890007,Hammock; Frances H,11,0,30,19
1746552407569,MATH 20D,A01,890011,Cheng; Hsiao-Bing,1,1,30,29
1746552407569,MATH 20D,A02,890012,Cheng; Hsiao-Bing,14,0,30,16
1746552407569,MATH 20D,B01,890016,Cheng; Hsiao-Bing,13,0,30,17
1746552407569,MATH 20D,B02,890017,Cheng; Hsiao-Bing,13,0,30,17
1746552408596,MATH 20E,A01,890026,Harel; Guershon,1,0,30,29
1746552408596,MATH 20E,A02,890029,Harel; Guershon,23,0,30,7
1746552408596,MATH 20E,B01,890033,Harel; Guershon,7,0,30,23
1746552408596,MATH 20E,B02,890101,Harel; Guershon,21,0,30,9
1746552409623,MATH 102,A01,890104,Staff,17,0,30,13
1746552409623,MATH 102,A02,890105,Staff,27,0,30,3
1746552410649,MATH 103B,A01,890116,Salehi Golsefidy; Alireza,3,0,30,27
1746552410649,MATH 103B,B01,890118,Staff,0,3,34,34
1746552411675,MATH 109,A01,890121,Aliabadi Sr.; Mohsen,1,0,30,29
1746552411675,MATH 109,B01,890124,Upadrashta; Pranav Kumar,18,0,30,12
1746552412704,MATH 120A,A01,890126,Eggers; John Dietrich,13,0,30,17
1746552413729,MATH 142B,A01,890128,Ioana; Adrian,19,0,30,11
1746552413729,MATH 142B,A02,890129,Ioana; Adrian,13,0,30,17
1746552414755,MATH 154,A01,890174,Staff,0,0,30,30
1746552414755,MATH 154,A02,890182,Staff,0,0,30,30
1746552415781,MATH 168A,A01,890197,Dumitriu; Ioana,21,0,35,14
1746552428720,MATH 170A,A01,890240,Nie; Jiawang,1,0,30,29
1746552428720,MATH 170A,A02,890241,Nie; Jiawang,11,0,30,19
1746552428720,MATH 170A,A03,890249,Nie; Jiawang,23,0,30,7
1746552429750,MATH 170B,A01,957891,Nag; Panchali,13,0,35,22
1746552431801,MATH 181A,A01,908025,Staff,0,4,35,35
1746552431801,MATH 181A,A02,960115,Staff,27,0,35,8
1746552432824,MATH 181B,A01,959874,Staff,25,0,30,5
1746552433852,MATH 193B,A01,890265,Staff,0,4,35,35
1746552434876,MGT 4,A01,890311,Anderson; John Charles,42,0,88,46
1746552435901,MGT 5,A00,907740,Staff,13,0,98,85
1746552436925,MGT 12,A00,890312,Lindenberger; Wade Douglas,67,0,98,31
1746552437951,MGT 16,A00,957883,Staff,78,0,98,20
1746552440013,MGT 45,A00,890314,Pecore; Joseph P.,47,0,98,51
1746552441036,MGT 71,A00,890315,Staff,0,11,98,98
1746552442111,MGT 100,A00,890316,Yavorsky; Daniel Ryan,44,0,98,54
1746552443137,MGT 103,A00,890317,Ehrich; Kristine R,73,0,98,25
1746552444162,MGT 105,A00,890356,Bates; Kenneth Walter,0,7,98,98
1746552445190,MGT 112,A00,890360,Ehrich; Kristine R,55,0,98,43
1746552446218,MGT 127R,A00,907732,Zhu; Kevin Xiaoguo,24,0,98,74
1746552447240,MGT 131B,A00,890361,Anderson; John Charles,61,0,98,37
1746552448263,MGT 137,A00,890362,Lindenberger; Wade Douglas,65,0,98,33
1746552449291,MGT 160,A00,890369,Johnson; Erik Barry,9,0,98,89
1746552451339,MGT 164,A00,890372,Zimmermann; Carsten,0,39,98,98
1746552452366,MGT 180,A00,890374,Bliss; Barbara Ann,12,0,98,86
1746552453394,MMW 15,A01,886414,Chang; Edmond Yi-Teh,0,12,28,28
1746552453394,MMW 15,A02,886415,Chang; Edmond Yi-Teh,0,8,28,28
1746552453394,MMW 15,A03,886416,Chang; Edmond Yi-Teh,0,8,28,28
1746552453394,MMW 15,A04,886417,Chang; Edmond Yi-Teh,0,8,28,28
1746552453394,MMW 15,B01,886419,Chang; Edmond Yi-Teh,0,7,28,28
1746552453394,MMW 15,B02,886420,Chang; Edmond Yi-Teh,0,8,28,28
1746552453394,MMW 15,B03,886421,Chang; Edmond Yi-Teh,0,7,28,28
1746552453394,MMW 15,B04,886422,Chang; Edmond Yi-Teh,0,8,28,28
1746552453394,MMW 15,C01,886424,Staff,0,9,28,28
1746552453394,MMW 15,C02,886425,Staff,0,8,28,28
1746552453394,MMW 15,C03,886426,Staff,0,8,28,28
1746552453394,MMW 15,C04,886427,Staff,0,7,28,28
1746552453394,MMW 15,C05,958038,Staff,0,7,28,28
1746552453394,MMW 15,C06,958039,Staff,0,8,28,28
1746552454422,MMW 15GS,A00,906910,Patterson; Patrick H.,4,0,28,24
1746552455455,MMW 122R,A01,886429,Rahimi; Babak,0,13,28,28
1746552455455,MMW 122R,A02,886430,Rahimi; Babak,0,12,28,28
1746552455455,MMW 122R,A03,958040,Rahimi; Babak,0,11,28,28
1746552456482,MUS 1A,A01,890937,Staff,2,0,25,23
1746552456482,MUS 1A,A02,891035,Staff,6,0,25,19
1746552456482,MUS 1A,C01,958912,Staff,24,0,25,1
1746552456482,MUS 1A,C02,958913,Staff,25,0,25,0
1746552458530,MUS 2AK,A00,957092,Ohnishi; Takae,15,0,15,0
1746552459556,MUS 4,A01,891044,Staff,2,0,25,23
1746552459556,MUS 4,A02,891045,Staff,23,0,25,2
1746552459556,MUS 4,B01,891048,Staff,17,0,25,8
1746552459556,MUS 4,B02,891050,Staff,25,0,25,0
1746552460582,MUS 5,A01,957506,Dubnov; Shlomo,0,0,25,25
1746552460582,MUS 5,A02,957622,Dubnov; Shlomo,13,0,25,12
1746552460582,MUS 5,A03,957623,Dubnov; Shlomo,20,0,25,5
1746552461608,MUS 6,A01,891053,Freitas Caetano; Marcelo,24,0,25,1
1746552461608,MUS 6,A02,891054,Freitas Caetano; Marcelo,23,0,25,2
1746552462634,MUS 7,A01,891081,Staff,0,0,25,25
1746552462634,MUS 7,A02,891082,Staff,3,0,25,22
1746552463662,MUS 8GS,A00,891118,Borgo; David Garcia,0,0,25,25
1746552464685,MUS 11,A01,891140,Staff,11,0,25,14
1746552464685,MUS 11,A02,891141,Staff,22,0,25,3
1746552465711,MUS 13,A01,891143,Staff,8,0,25,17
1746552465711,MUS 13,A02,891144,Staff,24,0,25,1
1746552466740,MUS 15,A01,891146,Staff,9,0,25,16
1746552466740,MUS 15,A02,891148,Staff,21,0,25,4
1746552466740,MUS 15,B01,891150,Staff,18,0,25,7
1746552466740,MUS 15,B02,891151,Staff,25,0,25,0
1746552467764,MUS 20,A01,891153,Staff,5,0,20,15
1746552467764,MUS 20,A02,891155,Staff,14,0,20,6
1746552468789,MUS 80,A00,891156,Staff,19,0,25,6
1746552468789,MUS 80,B00,891157,Staff,23,0,25,2
1746552469819,MUS 130,A00,891158,Ohnishi; Takae,35,0,35,0
1746552470843,MUS 150GS,A01,891160,Borgo; David Garcia,0,0,25,25
1746552471868,MUS 170,A01,891162,Freitas Caetano; Marcelo,20,0,25,5
1746552471868,MUS 170,A02,891164,Freitas Caetano; Marcelo,21,0,25,4
1746552472898,NANO 11,A00,886220,Vazquez Mena; Oscar,13,0,15,2
1746552473924,NANO 15,A01,886222,Drews; Aaron,4,0,7,3
1746552474952,NANO 104,A00,886224,Sirbuly; Donald,18,0,25,7
1746552475981,PH 40,A00,886528,Staff,23,0,40,17
1746552477008,PH 45,A01,886799,Staff,35,0,40,5
1746552478032,PH 110,A00,886802,Staff,0,7,40,40
1746552479057,PH 172,A00,906716,Staff,19,0,35,16
1746552480086,PH 191,A00,886803,Staff,6,0,40,34
1746552481111,PHIL 1,A00,889500,Staff,19,0,30,11
1746552482140,PHIL 10,A01,889549,Grush; Rick Scott,15,0,22,7
1746552482140,PHIL 10,A02,889551,Grush; Rick Scott,22,0,22,0
1746552483164,PHIL 28,A01,889559,Lamey; Andy M.,0,1,31,31
1746552483164,PHIL 28,A02,889561,Lamey; Andy M.,0,1,30,30
1746552483164,PHIL 28,A03,889572,Lamey; Andy M.,0,1,30,30
1746552484192,PHIL 35,A00,907839,Staff,13,0,15,2
1746552485218,PHIL 60,A00,889574,Staff,74,0,90,16
1746552486242,PHIL 101,A00,958004,Staff,13,0,15,2
1746552488292,PHIL 136,A00,889582,Fulkerson; Matthew Todd,26,0,45,19
1746552489319,PHIL 163,A01,889601,Staff,21,0,30,9
1746552489319,PHIL 163,B01,889606,Brandt; Reuven A,0,3,0,0
1746552490344,PHIL 164,A00,889610,Staff,16,0,30,14
1746552491373,PHIL 165,A00,889613,Staff,23,0,30,7
1746552492407,PHYS 1A,A00,886431,Staff,26,0,70,44
1746552493434,PHYS 1AL,001,886432,Tsai; Philbert S,0,2,30,30
1746552493434,PHYS 1AL,002,886436,Tsai; Philbert S,11,0,30,19
1746552494461,PHYS 1B,A00,886439,Staff,185,0,240,55
1746552495489,PHYS 1BL,001,886441,Tsai; Philbert S,0,4,30,30
1746552495489,PHYS 1BL,002,886444,Tsai; Philbert S,2,0,30,28
1746552496515,PHYS 1C,A00,896092,Arnold; Kam S,78,0,146,68
1746552497543,PHYS 1CL,001,886448,Tsai; Philbert S,0,0,30,30
1746552497543,PHYS 1CL,002,886449,Tsai; Philbert S,0,0,30,30
1746552497543,PHYS 1CL,003,886450,Tsai; Philbert S,16,0,30,14
1746552497543,PHYS 1CL,004,886451,Tsai; Philbert S,15,0,30,15
1746552498568,PHYS 2B,A01,886457,Staff,69,0,115,46
1746552499593,PHYS 2C,A01,886460,Shotwell; Brian,0,8,65,65
1746552500620,PHYS 2CL,A01,886467,Staff,0,4,28,28
1746552500620,PHYS 2CL,A02,886468,Staff,0,3,28,28
1746552501645,PHYS 2D,A01,886470,Staff,10,0,50,40
1746552502669,PHYS 4B,A01,886475,Grinstein; Benjamin,22,0,40,18
1746552503697,POLI 5,A00,891173,Desposato; Scott,7,0,25,18
1746552504722,POLI 5D,A01,891175,Staff,5,0,5,0
1746552504722,POLI 5D,B01,891178,Staff,5,0,5,0
1746552505749,POLI 11,A00,891179,Ferree; Karen E,2,0,35,33
1746552506773,POLI 12,A00,891180,Staff,16,0,30,14
1746552507797,POLI 27,A01,891182,Staff,12,0,75,63
1746552508825,POLI 30,A00,891183,Staff,8,0,50,42
1746552509853,POLI 100B,A00,891244,Staff,5,1,35,30
1746552510879,POLI 100I,A00,891247,Staff,7,0,30,23
1746552511906,POLI 104J,A00,891248,Nichter; Maysa,14,0,30,16
1746552512930,POLI 104U,A00,891250,Nichter; Maysa,2,0,30,28
1746552514979,POLI 110B,A00,891255,Wiens; David,20,0,25,5
1746552516004,POLI 112A,A00,891256,Wiens; David,6,0,25,19
1746552517031,POLI 114BR,A00,891261,Staff,19,0,30,11
1746552518057,POLI 117R,A00,891262,Forman; Fonna,0,6,50,50
1746552519085,POLI 118,A00,891264,Ingham; Sean,17,0,25,8
1746552520111,POLI 124A,A00,891265,Staff,18,0,20,2
1746552521137,POLI 125D,A00,891266,Nichter; Simeon C,2,0,25,23
1746552522162,POLI 126,A00,891268,Nichter; Simeon C,7,0,25,18
1746552523188,POLI 126AA,A00,891272,Staff,17,0,25,8
1746552524213,POLI 130AA,A00,891273,Staff,15,0,20,5
1746552525237,POLI 134AA,A00,891274,Staff,4,0,20,16
1746552527291,POLI 138,A00,891278,Staff,21,0,25,4
1746552528317,POLI 142K,A00,891280,Staff,11,0,25,14
1746552529345,POLI 142M,A00,891281,Gartzke; Erik,17,0,30,13
1746552530371,POLI 142P,A00,891284,Staff,20,0,30,10
1746552531399,POLI 143,A00,891285,Gartzke; Erik,12,0,30,18
1746552532427,POLI 153,A00,891286,Staff,19,0,20,1
1746552534480,POLI 175,A00,891290,Staff,15,0,20,5
1746552535509,PSYC 1,A00,890674,Steiner; Eric Tomas,0,11,45,45
1746552536534,PSYC 2,A00,890676,Albright; Thomas D,21,0,35,14
1746552537560,PSYC 3,A00,890679,Staff,17,0,20,3
1746552538584,PSYC 6,A00,959858,Staff,20,0,20,0
1746552539609,PSYC 60,A01,890684,Rickard; Timothy C.,0,5,45,45
1746552540635,PSYC 70,A01,890689,Geller; Emma Harlan,7,0,30,23
1746552541659,PSYC 71,A01,959860,Staff,21,0,25,4
1746552542688,PSYC 100,A00,890690,Lacefield; Katharine I,0,50,180,180
1746552543714,PSYC 102,A00,890695,Staff,18,0,40,22
1746552544745,PSYC 105,A00,890699,Geller; Emma Harlan,71,0,100,29
1746552545774,PSYC 106,A00,890701,Gorman; Michael R.,5,0,30,25
1746552546802,PSYC 108,A00,890704,Adrian; Julia Anna,0,28,50,50
1746552547828,PSYC 118,A01,890712,Staff,11,0,30,19
1746552548858,PSYC 124,A00,890716,Chapman; Eddie Nathaniel,25,0,60,35
1746552549889,PSYC 131,A00,890717,Anagnostaras; Stephan,0,7,80,80
1746552550914,PSYC 137,A00,890719,Winkielman; Piotr,0,11,30,30
1746552551941,PSYC 144,A00,890721,Adrian; Julia Anna,0,9,45,45
1746552552969,PSYC 162,A00,890805,Staff,2,0,75,73
1746552553993,PSYC 169,A00,890810,Staff,0,15,30,30
1746552555021,PSYC 172,A00,890814,Gorman; Michael R.,9,0,30,21
1746552556046,PSYC 181,A00,890818,Anagnostaras; Stephan,8,0,200,192
1746552557070,PSYC 184,A00,959861,Staff,170,0,175,5
1746552558096,PSYC 189,A00,890823,Staff,0,1,30,30
1746552559122,PSYC 191,A00,890884,Rickard; Timothy C.,0,11,35,35
1746552560148,PSYC 193,A00,890913,Staff,19,0,30,11
1746552560148,PSYC 193,B00,890914,Chapman; Eddie Nathaniel,24,0,30,6
1746552561175,PSYC 193L,A01,890918,Lowe; Angela Beth,20,0,30,10
1746552561175,PSYC 193L,B01,890921,Hurwitz; Ethan Scott,20,0,30,10
1746552561175,PSYC 193L,C01,890928,Staff,30,0,30,0
1746552562206,RELI 149,A00,886806,Rahimi; Babak,23,0,40,17
1746552563234,SE 9,A01,886814,Staff,7,0,20,13
1746552564261,SE 101B,A01,886816,Chadha; Mayank,4,0,35,31
1746552565288,SE 110B,A00,886818,Zhu; Qiang,4,0,75,71
1746552566315,SE 125,A01,886830,Staff,10,0,30,20
1746552567342,SE 130B,A01,886835,Staff,14,0,40,26
1746552568366,SE 131A,A01,886838,Krysl; Petr,34,0,55,21
1746552569392,SE 154,A00,886840,Staff,30,0,50,20
1746552570418,SE 164GS,A01,886849,Staff,6,0,20,14
1746552571445,SE 167GS,A01,886853,Staff,6,0,20,14
1746552572469,SIO 25,A01,890107,Staff,19,0,30,11
1746552573494,SIO 45,A00,890109,Cook; Geoffrey W,117,0,200,83
1746552574518,SIO 109R,A00,890110,Forman; Fonna,0,16,20,20
1746552575544,SIO 187,A01,890114,Kacev; David,15,0,40,25
1746552576570,SOCI 1,A01,890431,Thorpe; Charles Robert,15,0,30,15
1746552576570,SOCI 1,A02,890518,Thorpe; Charles Robert,30,0,30,0
1746552577593,SOCI 2,A01,957978,Staff,25,0,25,0
1746552577593,SOCI 2,A02,957979,Staff,23,0,25,2
1746552578620,SOCI 20,A01,890523,Calderon-Zaks; Michael Aar,23,0,30,7
1746552578620,SOCI 20,A02,890526,Calderon-Zaks; Michael Aar,29,0,30,1
1746552579645,SOCI 30,A01,890533,Pardo Guerra; Juan Pablo,37,0,40,3
1746552580670,SOCI 40,A01,890535,Staff,27,0,45,18
1746552581694,SOCI 104Q,A00,890559,Staff,18,0,30,12
1746552582719,SOCI 106,A00,890560,Arnal; Maud Marie Leonie,20,0,30,10
1746552583747,SOCI 110,A00,890567,Holkenbrink-Monk; Charlene,19,0,30,11
1746552584772,SOCI 112,A00,890568,Victoria Torres; Pablo,1,0,55,54
1746552585801,SOCI 115,A00,890597,Arnal; Maud Marie Leonie,28,0,45,17
1746552587854,SOCI 121,A00,890604,Pardo Guerra; Juan Pablo,38,0,45,7
1746552588880,SOCI 126,A01,890608,Staff,8,0,10,2
1746552589907,SOCI 127,A00,890609,Staff,18,0,30,12
1746552590936,SOCI 131,A00,890610,Thorpe; Charles Robert,37,0,45,8
1746552591961,SOCI 135,A00,890615,Payne; Christine Anna,14,0,45,31
1746552592987,SOCI 139,A00,890620,Staff,38,0,45,7
1746552594013,SOCI 148E,A00,890622,Calderon-Zaks; Michael Aar,36,0,45,9
1746552595041,SOCI 150,A00,890623,Kohler; Kristopher M.,31,0,45,14
1746552596067,SOCI 157,A00,890625,Jules-Rosette; Bennetta W.,18,0,20,2
1746552597098,SOCI 160,A00,890627,Payne; Christine Anna,21,0,45,24
1746552598125,SYN 1,A00,886855,Fish; Gwendolyn Anne,0,0,0,0
1746552598125,SYN 1,B00,906086,Fish; Gwendolyn Anne,0,1,0,2
1746552599149,SYN 2R,A00,886860,Staff,0,17,15,15
1746552599149,SYN 2R,B00,906106,Atkinson; Arthur Laird,0,16,15,15
1746552600182,SYN 100,A01,886866,Browne; Emily,0,28,20,20
1746552600182,SYN 100,B01,906128,Rock; Martin,0,5,20,20
1746552600182,SYN 100,C01,906140,Deavenport; James Cary,0,3,20,20
1746552600182,SYN 100,D01,907816,Deavenport; James Cary,0,5,20,20
1746552601207,TDAC 1,A00,890286,Walsh; Kim C.,9,0,20,11
1746552602236,TDAC 101,A00,890296,Basso; Beatrice,16,0,20,4
1746552603265,TDDE 131,A00,890297,Staff,47,0,50,3
1746552604290,TDDM 1,A00,890287,Weinberg; Sadie,25,0,30,5
1746552605316,TDGE 11,A00,890288,Fulton; Julia,137,0,200,63
1746552605316,TDGE 11,B00,890289,Castro; Robert Jess,184,0,200,16
1746552606341,TDGE 25,B00,957359,Walsh; Kim C.,3,0,20,17
1746552607365,TDGE 40,A01,890292,Power; Jade Yukana,27,0,30,3
1746552608393,TDGE 124,A00,890298,Havis; Allan,0,1,50,50
1746552609418,TDGE 131R,A00,890299,Burelle; Julie Sara Veronique,15,0,42,27
1746552610443,TDHT 101,A00,890300,Staff,10,0,20,10
1746552611469,TDHT 109,A01,890302,Anderson; Mysia Anyse,31,0,40,9
1746552612500,TDMV 1,A00,890293,Arcidiacono; Kristin,18,0,30,12
1746552613527,TDMV 2,A00,890294,Weinberg; Sadie,23,0,30,7
1746552614552,TDMV 3,A00,957878,Arcidiacono; Kristin,28,0,30,2
1746552616607,TDMV 138,A00,890304,Jun; Grace Shin Hae,25,0,40,15
1746552617632,TDMV 140,A00,890305,Corrales; Joseph Bernales,25,0,30,5
1746552618657,TDMV 142,A00,890307,Caligagan; Tony,32,0,40,8
1746552619685,TDMV 144,A00,890308,Camaya; Michelle Ann,25,0,30,5
1746552620711,TDPW 1,A00,890295,Stein; Deborah Isobel,3,0,20,17
1746552621739,USP 2,A01,890272,Lerner; Amy M,6,0,20,14
1746552622766,USP 3,A01,890274,Staff,12,0,30,18
1746552623793,USP 15,A01,890276,Sun; Feiyang,17,0,30,13
1746552624818,USP 25,A00,890277,Shenkman; Michael Thomas,19,0,25,6
1746552625870,USP 138,A00,890278,Staff,13,0,25,12
1746552626895,USP 143,A00,890279,Staff,21,0,70,49
1746552627920,USP 144,A00,890280,Chowdhury; Muhammed Zohir,16,0,30,14
1746552628945,USP 150,A00,890281,Boomhower; Matthew Charles,4,0,30,26
1746552629974,USP 151,A00,890282,Staff,16,0,20,4
1746552631002,USP 162,A00,890283,Andrews; Abigail Leslie,16,0,20,4
1746552632029,USP 168,A00,920477,Kwak; Nancy,1,0,5,4
1746552633056,USP 181,A00,890284,Staff,3,0,20,17
1746552634080,USP 191A,A00,890285,Staff,13,0,20,7
1746552635106,VIS 101,A00,886512,Staff,25,0,75,50
1746552636133,VIS 103,A00,886513,Cruz; Edwin Teddy,61,0,75,14
1746552637163,VIS 108,A00,886514,Staff,3,0,15,12
1746552638190,VIS 127P,A00,886515,Shen; Kuiyi,80,0,146,66
1746552639219,VIS 149,A00,886516,Yoldas; Pinar,0,0,15,15
1746552640245,VIS 164,A00,886526,Erdmann; Dean,19,0,22,3
1746552641272,VIS 194S,A00,886527,Staff,61,0,75,14
1746552642300,WCWP 10A,C00,886484,Martiniuk; Jill,12,0,15,3
1746552643324,WCWP 10B,A00,886490,Uriarte; Emma,0,0,15,15
1746552643324,WCWP 10B,B00,886491,Dhir; Simrita,10,0,15,5
1746552643324,WCWP 10B,C00,886492,Ornelas; Tricia,0,0,15,15
1746552644351,WCWP 100,A00,886494,Young; Mark T,0,6,15,15
1746552646452,AAS 10,A01,886199,Childs; Dennis R.,0,3,0,0
1746552647478,ANAR 104,A01,886940,Shtienberg; Gilad,27,0,30,3
1746552648504,ANAR 120,A00,886953,Staff,12,0,20,8
1746552649531,ANBI 148,A01,886955,Wilder; Linnea Lorene,30,0,40,10
1746552651580,ANSC 122,A00,886957,Staff,25,0,30,5
1746552652605,ANSC 150,A00,886958,Sloane; Julia Kathryn,2,0,15,13
1746552653634,ANSC 156,A00,886959,Jenkins; Janis A.,0,1,15,15
1746552654660,ANSC 180,A00,886960,Staff,11,0,17,6
1746552655685,ANSC 188,A00,886961,Jassal; Aftab,9,0,25,16
1746552656708,ANSC 190,A00,886962,Jassal; Aftab,14,0,25,11
1746552657736,ANSC 191,A00,886963,Staff,18,0,20,2
1746552658762,ANTH 3,A01,891689,Staff,17,0,20,3
1746552659789,ANTH 5,A00,886933,Semendeferi; Ekaterini,16,0,20,4
1746552660813,ANTH 10,A00,886934,Staff,0,12,30,30
1746552661838,ANTH 21,A01,886936,Staff,40,0,60,20
1746552662868,ANTH 23,A01,886938,Staff,92,0,100,8
1746552663894,ANTH 105,A00,886964,Stewart; Alexander B,84,0,100,16
1746552664920,ANTH 108,A00,886965,Pedersen; David,9,0,20,11
1746552665947,AWP 10,001,886147,Staff,0,0,0,0
1746552665947,AWP 10,002,886148,Staff,0,0,0,0
1746552665947,AWP 10,003,886149,Staff,0,0,0,0
1746552665947,AWP 10,004,886150,Staff,0,0,0,0
1746552665947,AWP 10,005,886151,Staff,0,0,0,0
1746552665947,AWP 10,006,886152,Staff,0,0,0,0
1746552665947,AWP 10,007,886153,Staff,0,0,0,0
1746552665947,AWP 10,008,886154,Staff,0,0,0,0
1746552665947,AWP 10,009,886155,Staff,0,0,0,0
1746552665947,AWP 10,010,886156,Staff,0,0,0,0
1746552665947,AWP 10,011,886158,Staff,0,0,0,0
1746552665947,AWP 10,012,886160,Staff,0,0,0,0
1746552665947,AWP 10,013,886161,Staff,0,0,0,0
1746552665947,AWP 10,014,886162,Staff,0,0,0,0
1746552665947,AWP 10,015,886163,Staff,0,0,0,0
1746552665947,AWP 10,016,886164,Staff,0,0,0,0
1746552665947,AWP 10,017,886165,Staff,0,0,0,0
1746552665947,AWP 10,018,886166,Staff,0,0,0,0
1746552665947,AWP 10,019,886168,Staff,0,0,0,0
1746552665947,AWP 10,020,886170,Staff,0,0,0,0
1746552665947,AWP 10,021,886172,Staff,0,0,0,0
1746552666981,AWP 10R,001,886173,Staff,0,1,0,0
1746552666981,AWP 10R,002,886174,Staff,0,1,0,0
1746552666981,AWP 10R,003,886175,Staff,0,0,0,0
1746552666981,AWP 10R,004,886176,Staff,0,0,0,0
1746552666981,AWP 10R,005,886177,Staff,0,0,0,0
1746552666981,AWP 10R,006,886178,Staff,0,0,0,0
1746552666981,AWP 10R,007,886179,Staff,0,0,0,0
1746552666981,AWP 10R,008,886181,Staff,0,0,0,0
1746552666981,AWP 10R,009,886182,Staff,0,0,0,0
1746552666981,AWP 10R,010,886183,Staff,0,0,0,0
1746552666981,AWP 10R,011,886184,Staff,0,0,0,0
1746552666981,AWP 10R,012,886185,Staff,0,0,0,0
1746552666981,AWP 10R,013,886186,Staff,0,0,0,0
1746552666981,AWP 10R,014,886187,Staff,0,0,0,0
1746552666981,AWP 10R,015,886188,Staff,0,0,0,0
1746552666981,AWP 10R,016,886189,Staff,0,0,0,0
1746552666981,AWP 10R,017,960532,Staff,0,0,0,0
1746552666981,AWP 10R,018,960533,Staff,0,0,0,0
1746552666981,AWP 10R,019,960534,Staff,0,0,0,0
1746552666981,AWP 10R,020,960538,Staff,0,0,0,0
1746552666981,AWP 10R,021,960540,Staff,0,0,0,0
1746552666981,AWP 10R,022,960541,Staff,0,0,0,0
1746552666981,AWP 10R,023,960542,Staff,0,0,0,0
1746552666981,AWP 10R,024,960544,Staff,0,0,0,0
1746552668008,AWP 102R,A00,886190,Staff,0,0,0,0
1746552668008,AWP 102R,B00,886191,Staff,0,0,0,0
1746552669032,BENG 100,A01,886193,Staff,17,0,30,13
1746552670061,BENG 122A,A01,886195,Hasty; Jeff M,13,0,30,17
1746552671084,BENG 166A,A00,886196,Sah; Robert Lie-Yuan,0,2,30,30
1746552672111,BENG 190,A00,958050,Khojah; Reem I,24,0,25,1
1746552673138,BIBC 102,A01,894320,Staff,0,0,46,46
1746552673138,BIBC 102,A02,894321,Staff,0,0,46,46
1746552673138,BIBC 102,A03,894344,Staff,7,0,46,39
1746552673138,BIBC 102,A04,894345,Staff,26,0,47,21
1746552674163,BICD 100R,A01,894365,Smith; Laurie,0,3,58,58
1746552674163,BICD 100R,A02,894366,Smith; Laurie,0,5,58,58
1746552674163,BICD 100R,A03,894367,Smith; Laurie,2,0,59,57
1746552674163,BICD 100R,A04,959869,Smith; Laurie,41,0,59,18
1746552675192,BICD 136,A01,894383,Gustafson-Brown; Cindy,14,0,50,36
1746552676221,BIEB 102,A01,894494,Butler; Shannon Rhey,51,0,130,79
1746552678271,BIEB 150,A01,894617,Wills; Christopher,3,0,20,17
1746552678271,BIEB 150,A02,894631,Wills; Christopher,3,0,20,17
1746552678271,BIEB 150,A03,894937,Wills; Christopher,3,0,20,17
1746552678271,BIEB 150,A04,894946,Wills; Christopher,5,0,20,15
1746552679296,BIEB 194,A00,906141,Kurle; Carolyn M.,6,0,20,14
1746552680320,BILD 1,A01,894154,Staff,2,0,19,17
1746552680320,BILD 1,A02,894155,Staff,14,0,19,5
1746552680320,BILD 1,A03,894160,Staff,13,0,19,6
1746552680320,BILD 1,A04,894161,Staff,15,0,18,3
1746552681346,BILD 2,A01,894168,Staff,0,0,50,50
1746552681346,BILD 2,A02,894169,Staff,0,0,50,50
1746552681346,BILD 2,A03,894179,Staff,4,0,50,46
1746552681346,BILD 2,A04,894203,Staff,27,0,50,23
1746552682370,BILD 3,A01,894213,Staff,22,0,31,9
1746552682370,BILD 3,A02,894214,Staff,26,0,31,5
1746552682370,BILD 3,A03,894235,Staff,28,0,31,3
1746552682370,BILD 3,A04,894236,Staff,28,0,32,4
1746552683394,BILD 4,A01,894253,Reuther; Keefe,5,0,24,19
1746552683394,BILD 4,A02,894258,Reuther; Keefe,16,0,24,8
1746552684418,BILD 5,A01,894276,Reuther; Keefe,35,0,50,15
1746552684418,BILD 5,A02,894277,Reuther; Keefe,45,0,50,5
1746552684418,BILD 5,A03,894290,Reuther; Keefe,44,0,50,6
1746552684418,BILD 5,A04,894291,Reuther; Keefe,48,0,50,2
1746552685443,BILD 24,A01,894297,Pirino; Giorgia,40,0,60,20
1746552686470,BIMM 100,B01,958915,Staff,72,0,100,28
1746552687498,BIMM 101,A01,895017,McDonnell; Lisa Marie,0,5,24,24
1746552687498,BIMM 101,A02,895018,McDonnell; Lisa Marie,0,5,24,24
1746552687498,BIMM 101,B01,895020,McDonnell; Lisa Marie,0,6,24,24
1746552687498,BIMM 101,B02,895021,McDonnell; Lisa Marie,0,4,24,24
1746552688524,BIMM 110,A01,895023,Staff,1,0,25,24
1746552688524,BIMM 110,A02,895024,Staff,9,0,25,16
1746552688524,BIMM 110,A03,895025,Staff,18,0,25,7
1746552688524,BIMM 110,A04,895031,Staff,20,0,25,5
1746552689554,BIMM 120,A01,895114,Gustafson-Brown; Cindy,14,0,28,14
1746552689554,BIMM 120,A02,895126,Gustafson-Brown; Cindy,21,0,27,6
1746552690580,BIPN 100,A01,895130,Yang; Mingyu,1,0,38,37
1746552690580,BIPN 100,A02,895131,Yang; Mingyu,32,0,38,6
1746552690580,BIPN 100,A03,895132,Yang; Mingyu,32,0,38,6
1746552690580,BIPN 100,A04,895133,Yang; Mingyu,27,0,36,9
1746552691608,BIPN 120,A01,895135,Cooke; James Edward,0,3,13,13
1746552691608,BIPN 120,A02,895136,Cooke; James Edward,0,1,13,13
1746552691608,BIPN 120,A03,895137,Cooke; James Edward,0,3,13,13
1746552691608,BIPN 120,A04,895156,Cooke; James Edward,0,2,11,11
1746552692637,BIPN 134,A01,895235,Cooke; James Edward,0,2,25,25
1746552692637,BIPN 134,A02,895237,Cooke; James Edward,0,0,25,25
1746552692637,BIPN 134,A03,895240,Cooke; James Edward,3,0,25,22
1746552692637,BIPN 134,A04,895270,Cooke; James Edward,20,0,25,5
1746552693661,BIPN 189,A00,892103,Staff,0,13,14,14
1746552695713,BISP 194,A00,958008,Staff,0,2,0,0
1746552696741,CAT 124,A01,922009,Staff,0,5,20,20
1746552697772,CAT 125R,A00,886390,Morales; Celeste Georgianna,0,2,20,20
1746552697772,CAT 125R,B00,886391,Irwin; Matthew Joseph,0,3,20,20
1746552697772,CAT 125R,C00,886392,Smith; Lauryn Alissa,0,2,20,20
1746552697772,CAT 125R,D00,886393,Vanderschuit; Maya Alysia,0,2,20,20
1746552697772,CAT 125R,E00,886394,Marchisotto; Jennifer Anne,0,4,20,20
1746552698801,CENG 15,A01,886218,Drews; Aaron,3,0,8,5
1746552699828,CENG 113,A00,886219,Opatkiewicz; Justin Paul,15,0,25,10
1746552700853,CGS 101,A00,887044,Staff,7,0,20,13
1746552701879,CGS 105,A01,887046,Staff,14,0,25,11
1746552702905,CGS 112,A00,887047,Cuong; Marisol,12,0,15,3
1746552703930,CGS 113,A00,887048,Staff,23,0,30,7
1746552704954,CGS 120,A00,887049,Staff,10,0,17,7
1746552705982,CHEM 6A,A01,886336,Lam; Tin Yiu,38,0,50,12
1746552705982,CHEM 6A,A02,886338,Lam; Tin Yiu,37,0,50,13
1746552707011,CHEM 6B,A01,886341,Hopkins; Patrycja Anna,16,0,50,34
1746552707011,CHEM 6B,A02,886343,Hopkins; Patrycja Anna,42,0,50,8
1746552708037,CHEM 6C,A01,886346,Albizati; Kim F.,0,2,50,50
1746552708037,CHEM 6C,A02,886348,Albizati; Kim F.,23,0,50,27
1746552709064,CHEM 40A,A01,886352,Klosterman; Jeremy K,65,0,100,35
1746552710094,CHEM 40B,A01,886356,Klosterman; Jeremy K,0,23,100,100
1746552711121,CHEM 41B,A01,886360,Theodorakis; Emmanuel,25,0,50,25
1746552711121,CHEM 41B,A02,886362,Theodorakis; Emmanuel,47,0,50,3
1746552712150,CHIN 165A,A00,886382,Xu; Li,18,0,20,2
1746552713176,CLAS 120,A00,886387,Myerston Santana; Jacobo,33,0,40,7
1746552714205,COGS 9,A01,886967,Shannon; Kyle Michael,42,0,60,18
1746552715231,COGS 11,A01,886969,Staff,11,0,30,19
1746552716258,COGS 14A,A01,886971,Staff,6,0,60,54
1746552717286,COGS 14B,A01,886973,Hoffman; Drew Ellen,4,0,60,56
1746552718311,COGS 18,A01,886975,Morgan; Eric,35,0,60,25
1746552719337,COGS 20,A01,886977,Staff,4,0,8,4
1746552719337,COGS 20,A02,886978,Staff,5,0,7,2
1746552720362,COGS 100,A01,907783,Staff,0,2,30,30
1746552721387,COGS 101B,A01,886980,Staff,0,3,48,48
1746552722428,COGS 101C,A01,886982,Delgado; Tania,0,5,44,44
1746552723456,COGS 102A,A01,886984,Johnson; Christine M.,4,0,30,26
1746552724479,COGS 118B,A01,886986,Staff,0,3,88,88
1746552725515,COGS 150,A01,886988,Bergen; Benjamin,23,0,50,27
1746552726544,COGS 153,A00,886989,Delgado; Tania,0,2,41,41
1746552727571,COGS 186,A01,886991,Staff,0,0,32,32
1746552728598,COGS 187A,A01,886993,Boyle; Mary E. T.,7,0,30,23
1746552729626,COGS 189,A00,886994,Staff,0,1,30,30
1746552730650,COMM 10,A01,886996,Staff,0,0,20,21
1746552730650,COMM 10,A02,886997,Staff,12,0,20,8
1746552730650,COMM 10,A03,959845,Staff,19,0,20,1
1746552731678,COMM 20,A01,886999,Leuning; Grant Maurstad,24,0,40,16
1746552733731,COMM 100A,A01,887002,Staff,0,0,20,25
1746552733731,COMM 100A,A02,887003,Staff,7,0,20,13
1746552734757,COMM 100B,A01,887005,Staff,0,8,20,24
1746552735781,COMM 106D,A00,887006,Staff,14,0,40,26
1746552736809,COMM 110G,A00,887007,Whitworth-Smith; Andrew C,12,0,40,28
1746552737836,COMM 111B,A00,887008,Staff,31,0,40,9
1746552738861,COMM 113T,A00,887009,Abuelhiga; Soraya Jill,28,0,40,12
1746552738861,COMM 113T,B00,906733,Staff,40,0,40,0
1746552739885,COMM 145,A00,887010,Staff,12,0,40,28
1746552740913,COMM 146,A00,887054,Staff,31,0,40,9
1746552741936,COMM 190,A00,887012,Staff,8,0,23,15
1746552742961,CSE 8A,A50,887015,Cao; Yingjun,57,0,85,28
1746552743987,CSE 11,A01,887017,Cao; Yingjun,12,0,70,58
1746552745013,CSE 20,A01,887019,Staff,30,0,50,20
1746552746038,CSE 21,A01,887021,Staff,78,0,100,22
1746552746038,CSE 21,B01,892583,Braun; Oliver,45,0,50,5
1746552747063,CSE 30,A01,887025,Eldon; John,143,0,200,57
1746552748088,CSE 100,A01,887027,Staff,25,0,50,25
1746552748088,CSE 100,A02,887028,Staff,41,0,50,9
1746552749112,CSE 101,A01,887030,Braun; Oliver,75,0,100,25
1746552749112,CSE 101,B01,887032,Jones; Miles E,0,3,50,50
1746552749112,CSE 101,B02,887033,Jones; Miles E,0,1,50,50
1746552750136,CSE 105,A01,908084,Jones; Miles E,32,0,50,18
1746552750136,CSE 105,A02,908087,Jones; Miles E,32,0,50,18
1746552751163,CSE 135,A01,887035,Powell; Thomas Allan,0,4,50,50
1746552752188,CSE 142,A01,887037,Staff,8,0,60,52
1746552753217,CSE 142L,A01,887039,Staff,34,0,60,26
1746552754246,CSE 151A,A01,887041,Solares; Edwin A,47,0,100,53
1746552755271,CSE 175,A01,887043,Kumar; Rakesh,30,0,30,0
1746552756295,CSS 1,A01,886389,Staff,0,1,40,40
1746552757320,DSC 30,A01,908097,Liao; Soohyun Nam,47,0,75,28
1746552758347,DSC 40A,A01,908099,Shannon; Kyle Michael,30,0,50,20
1746552759373,DSC 40B,A01,908112,Staff,16,0,50,34
1746552760400,DSC 80,A01,908116,Staff,19,0,60,41
1746552761424,DSC 197,001,956863,Eldridge; Justin Matthew,9999,0,9999,0
1746552762454,ECE 5,A01,886400,Morris; Karcher William,2,0,6,4
1746552762454,ECE 5,A02,886401,Morris; Karcher William,3,0,6,3
1746552763481,ECE 148,A01,886403,Silberman; Jack,0,14,14,14
1746552764511,ECON 1,A01,887265,Crane; Meredith Helen,12,0,70,58
1746552764511,ECON 1,B01,887268,Staff,43,0,50,7
1746552765536,ECON 2,A01,887273,Crane; Meredith Helen,56,0,70,14
1746552766567,ECON 3,A01,887279,Rondina; Giacomo,32,0,70,38
1746552767592,ECON 4,A01,887282,Anderson; John Charles,0,2,10,10
1746552768617,ECON 5,A01,887285,Staff,33,0,45,12
1746552768617,ECON 5,B01,887292,Staff,41,0,45,4
1746552769642,ECON 100A,A01,887337,Newhouse; Herbert S,54,0,70,16
1746552769642,ECON 100A,B01,887349,Staff,45,0,50,5
1746552770665,ECON 100B,A01,887361,Du; Songzi,29,0,70,41
1746552771692,ECON 100C,A01,887445,Newhouse; Herbert S,59,0,70,11
1746552772718,ECON 105,A00,887488,Vespa; Emanuel Ignacio,23,0,35,12
1746552773743,ECON 109,A01,887506,Shishkin; Denis,28,0,35,7
1746552774767,ECON 110A,A01,887568,Alon; Titan Michael,0,3,35,35
1746552774767,ECON 110A,B01,907601,Alon; Titan Michael,20,0,35,15
1746552775795,ECON 110B,A01,887598,Levkoff; Steven B.,0,23,70,70
1746552776820,ECON 112,A00,887599,Rondina; Giacomo,19,0,35,16
1746552777846,ECON 120A,A01,887603,Dai; Yinlin,36,0,70,34
1746552778878,ECON 120C,A01,887608,Sun; Yixiao,0,1,35,35
1746552778878,ECON 120C,B01,887614,Sun; Yixiao,0,0,35,35
1746552779905,ECON 138,A00,887621,Bharadwaj; Prashant,0,21,20,20
1746552780934,ECON 144,A00,958007,Squires; Dale E,13,0,35,22
1746552781959,ECON 171,A01,907666,Staff,18,0,35,17
1746552782988,ECON 175,A00,887626,Wu; Pak Yeung,23,0,35,12
1746552784013,ECON 190,A00,887640,Vespa; Emanuel Ignacio,23,0,35,12
1746552785038,EDS 25,A01,888197,Staff,0,0,0,0
1746552785038,EDS 25,A02,888209,Staff,0,0,0,0
1746552785038,EDS 25,A03,888210,Staff,0,0,0,0
1746552785038,EDS 25,A04,888212,Staff,0,0,0,0
1746552785038,EDS 25,A05,888213,Staff,0,0,0,0
1746552785038,EDS 25,A06,888214,Staff,0,0,0,0
1746552785038,EDS 25,A07,888235,Staff,0,2,0,0
1746552785038,EDS 25,A08,888236,Staff,0,0,0,0
1746552785038,EDS 25,A09,888240,Staff,0,0,0,0
1746552785038,EDS 25,A10,888244,Staff,0,0,0,0
1746552785038,EDS 25,B01,888273,Staff,0,0,0,0
1746552785038,EDS 25,B02,888285,Staff,0,0,0,0
1746552785038,EDS 25,B03,888423,Staff,0,0,0,1
1746552785038,EDS 25,B04,888432,Staff,0,0,0,0
1746552785038,EDS 25,B05,888433,Staff,0,0,0,0
1746552785038,EDS 25,B06,888467,Staff,0,0,0,0
1746552785038,EDS 25,B07,888468,Staff,0,0,0,0
1746552785038,EDS 25,B08,888479,Staff,0,0,0,0
1746552785038,EDS 25,B09,888484,Staff,0,0,0,0
1746552785038,EDS 25,B10,888487,Staff,0,0,0,0
1746552786064,EDS 38,A01,907700,Choi; Bailey Miyeon,30,0,30,0
1746552787089,EDS 112,A01,888601,Chapman; Thandeka K,14,0,40,26
1746552788116,EDS 115,A00,888697,Mendez; Kathrina Mendoza,10,0,30,20
1746552789143,EDS 116,A01,888893,Staff,35,0,40,5
1746552791195,EDS 124AR,A00,889133,Staff,29,0,50,21
1746552791195,EDS 124AR,B00,907471,Simon; Elizabeth A,37,0,50,13
1746552792222,EDS 124BR,A00,889134,Simon; Elizabeth A,45,0,100,55
1746552793250,EDS 125,A00,889135,Staff,25,0,30,5
1746552794276,EDS 126,A01,889138,Staff,36,0,40,4
1746552795304,EDS 164R,A01,889142,Wishard Guerra; Alison G.,33,0,50,17
1746552796330,ENG 30,A01,886396,Staff,0,0,0,0
1746552796330,ENG 30,B01,886398,Staff,0,0,0,0
1746552797354,ENVR 102,A00,906150,Montejo; Carolina,23,0,25,2
1746552798381,ETHN 103A,A00,887236,Man; Simeon S,0,3,0,0
1746552799405,ETHN 113,A00,887239,Staff,16,0,30,14
1746552800433,ETHN 116,A00,887240,Staff,16,0,25,9
1746552801461,ETHN 117,A00,887241,Choi; Esther Min,28,0,30,2
1746552802486,ETHN 118,A00,887243,Staff,24,0,30,6
1746552803513,ETHN 127,A00,887248,Cuong; Marisol,11,0,15,4
1746552804539,ETHN 139,A00,887250,Staff,7,0,10,3
1746552805566,ETHN 142,A00,887252,Staff,10,0,30,20
1746552806593,ETHN 161,A00,887253,Browne; Errol Tsekani,24,0,30,6
1746552807621,ETHN 163FR,A00,887255,Burelle; Julie Sara Veronique,0,0,5,5
1746552808651,GLBH 20,A00,889149,Elwardani; Nile Regina,8,0,42,34
1746552810703,GLBH 111,A01,889152,Burgos; Jose L.,17,0,17,0
1746552811733,GLBH 150,A00,889181,Sloane; Julia Kathryn,0,5,15,15
1746552813779,HDS 60,A01,886406,Warstadt; Melissa Fawn,73,0,80,7
1746552814804,HIAF 111,A00,889324,Gyamfi; Bright,25,0,32,7
1746552815828,HIEA 131,A00,889328,Staff,16,0,32,16
1746552816853,HIEA 144,A00,889333,Henry; Todd A.,26,0,32,6
1746552817881,HIEA 154,A00,889336,Henry; Todd A.,24,0,32,8
1746552818904,HIEU 106,A00,889339,Staff,22,0,32,10
1746552820958,HIEU 114,A00,889340,Staff,3,0,32,29
1746552821988,HIEU 135GS,A00,889342,Patterson; Patrick H.,0,0,1,24
1746552823015,HIEU 137,A00,889343,Edington; Claire Ellen,9,0,25,16
1746552824042,HIEU 148,A00,889345,Staff,14,0,32,18
1746552825069,HIEU 154,A00,889346,Biess; Frank Peter,21,0,32,11
1746552826097,HILA 102,A00,889351,Staff,12,0,32,20
1746552827123,HILD 2A,A01,889221,Lewandoski; Julia Mavis,1,10,32,31
1746552828149,HILD 7B,A01,889225,Man; Simeon S,0,13,32,32
1746552829178,HILD 7C,A01,889288,Alvarez; Luis A,0,14,32,32
1746552830205,HILD 30,A01,889323,Staff,0,5,32,32
1746552832255,HISC 119,A00,889383,Golan; Tal,20,0,32,12
1746552833284,HIUS 103,A00,889384,Man; Simeon S,0,0,32,32
1746552834312,HIUS 117,A00,919797,Kwak; Nancy,18,0,32,14
1746552835337,HIUS 142A,A00,919788,Staff,22,0,32,10
1746552837391,HIUS 149,A00,889386,Gyamfi; Bright,27,0,32,5
1746552838418,HIUS 155,A00,889387,Alvarez; Luis A,14,0,32,18
1746552839442,HUM 3,A01,886499,Caldwell; Michael Alan,19,0,50,31
1746552840471,HUM 3GS,A00,886500,Rodriguez; Bretton Sigfred,0,0,0,28
1746552841495,HUM 3R,A01,886502,Markman; Kristina,0,36,50,50
1746552842526,HUM 4,A01,886504,Crum; Matthew Stephen,24,0,50,26
1746552842526,HUM 4,B01,886506,West; Geoffrey Scott,17,0,50,33
1746552843552,HUM 4GS,A00,886507,Staff,0,0,0,19
1746552844580,HUM 5,A01,886509,Staff,32,0,50,18
1746552845605,HUM 5R,A01,886511,Zavodny; Tatiana Sophia,0,39,50,50
1746552846633,JAPN 180,A00,886407,Staff,17,0,40,23
1746552847660,LATI 50,A01,886409,Martin-Cabrera; Luis,4,0,22,18
1746552847660,LATI 50,A02,886410,Martin-Cabrera; Luis,19,0,22,3
1746552847660,LATI 50,A03,886411,Martin-Cabrera; Luis,21,0,22,1
1746552847660,LATI 50,A04,886412,Martin-Cabrera; Luis,9,0,22,13
1746552848687,LAWS 101,A00,907664,Staff,28,0,60,32
1746552849714,LIAB 1A,A00,889388,Saab; Dima,17,0,20,3
1746552850743,LIAB 1AX,A00,889389,El Cheddadi; Youniss,17,0,20,3
1746552851770,LIFR 1C,A00,889391,Van Moer; Vinciane G,8,0,20,12
1746552852794,LIFR 1CX,A00,889392,Van Moer; Vinciane G,7,0,20,13
1746552853819,LIFR 1D,A00,889393,Van Moer; Vinciane G,7,0,20,13
1746552854846,LIFR 1DX,A00,889394,Van Moer; Vinciane G,8,0,20,12
1746552855870,LIGN 7,A00,886923,Staff,24,0,50,26
1746552856896,LIGN 17,A00,886924,Kehler; Andrew Scott,125,0,150,25
1746552857923,LTAM 110,A00,889395,Staff,15,0,30,15
1746552858950,LTAM 110GS,A00,958010,Rodriguez; Bretton Sigfred,0,0,0,28
1746552859981,LTCH 101,A00,889397,Staff,23,0,25,2
1746552861007,LTCS 130,A00,889398,Staff,23,0,25,2
1746552862031,LTEA 138,A00,889399,Staff,24,0,40,16
1746552863060,LTEN 149,A00,889400,Wesling; Megan E.,0,3,25,25
1746552864085,LTEN 169,A00,889401,Staff,20,0,25,5
1746552865114,LTEN 180,A00,889402,Staff,10,0,15,5
1746552866137,LTEN 181,A00,889403,Staff,21,0,25,4
1746552867164,LTWL 100,A00,889404,Myerston Santana; Jacobo,3,0,25,22
1746552868192,LTWL 180GS,A00,889405,Staff,0,0,20,20
1746552869219,LTWL 181,A00,889406,Staff,17,0,25,8
1746552870246,LTWL 184,A00,889475,Mukherjee; Silpa,22,0,25,3
1746552871272,LTWR 102C,A00,889486,Staff,29,0,30,1
1746552872297,LTWR 115W,A00,889491,Staff,0,2,15,15
1746552873325,MAE 8,A01,886905,Staff,0,2,0,0
1746552874355,MAE 11,A00,886906,Bandaru; Prabhakar,0,7,50,50
1746552875385,MAE 20,A00,886907,Evdokimenko; Ekaterina,43,0,70,27
1746552876410,MAE 30B,A00,886909,Ghazinejad; Maziar,26,0,45,19
1746552877435,MAE 101B,A00,886910,Saintillan; David,29,0,45,16
1746552878462,MAE 105,A00,886911,Bandaru; Prabhakar,18,0,50,32
1746552879488,MAE 107,B00,958024,Staff,8,0,50,42
1746552880521,MAE 143B,A00,886913,Bewley; Thomas R,7,0,40,33
1746552881546,MAE 148,A01,886915,Silberman; Jack,0,3,14,14
1746552882573,MAE 160,A00,886916,Evdokimenko; Ekaterina,31,0,60,29
1746552883624,MATH 3C,A01,889681,Staff,0,3,30,30
1746552883624,MATH 3C,A02,960048,Staff,25,0,30,5
1746552884648,MATH 10A,A01,889760,Staff,26,0,30,4
1746552884648,MATH 10A,A02,889783,Staff,29,0,30,1
1746552885677,MATH 10B,A01,889785,Verstraete; Jacques Allan,2,0,35,33
1746552885677,MATH 10B,A02,889795,Verstraete; Jacques Allan,4,0,35,31
1746552885677,MATH 10B,B01,889797,Verstraete; Jacques Allan,3,0,35,32
1746552885677,MATH 10B,B02,889828,Verstraete; Jacques Allan,3,0,35,32
1746552886708,MATH 10C,A01,889849,Habib; Yousaf,9,0,30,21
1746552886708,MATH 10C,A02,889852,Habib; Yousaf,14,0,30,16
1746552886708,MATH 10C,A03,889853,Habib; Yousaf,22,0,30,8
1746552886708,MATH 10C,A04,889858,Habib; Yousaf,20,0,30,10
1746552886708,MATH 10C,B01,889861,Staff,1,0,30,29
1746552886708,MATH 10C,B02,889862,Staff,24,0,30,6
1746552886708,MATH 10C,B03,889863,Staff,27,0,30,3
1746552886708,MATH 10C,B04,889967,Staff,23,0,30,7
1746552887732,MATH 18,A01,889974,Staff,7,0,30,23
1746552887732,MATH 18,A02,889977,Staff,20,0,30,10
1746552887732,MATH 18,B01,889984,Hardiman; Liam,22,0,30,8
1746552887732,MATH 18,B02,889985,Hardiman; Liam,25,0,30,5
1746552888757,MATH 20A,A01,889990,Suk; Andrew Hoon,30,0,35,5
1746552889787,MATH 20B,A01,889993,Ohm; Ko Woon,22,0,30,8
1746552889787,MATH 20B,A02,889994,Ohm; Ko Woon,30,0,30,0
1746552889787,MATH 20B,B01,889996,Ohm; Ko Woon,21,0,30,9
1746552889787,MATH 20B,B02,889997,Ohm; Ko Woon,23,0,30,7
1746552890813,MATH 20C,A01,889999,Hammock; Frances H,17,0,30,13
1746552890813,MATH 20C,A02,890003,Hammock; Frances H,23,0,30,7
1746552890813,MATH 20C,B01,890006,Hammock; Frances H,3,0,30,27
1746552890813,MATH 20C,B02,890007,Hammock; Frances H,11,0,30,19
1746552891839,MATH 20D,A01,890011,Cheng; Hsiao-Bing,1,1,30,29
1746552891839,MATH 20D,A02,890012,Cheng; Hsiao-Bing,14,0,30,16
1746552891839,MATH 20D,B01,890016,Cheng; Hsiao-Bing,13,0,30,17
1746552891839,MATH 20D,B02,890017,Cheng; Hsiao-Bing,13,0,30,17
1746552892864,MATH 20E,A01,890026,Harel; Guershon,1,0,30,29
1746552892864,MATH 20E,A02,890029,Harel; Guershon,23,0,30,7
1746552892864,MATH 20E,B01,890033,Harel; Guershon,7,0,30,23
1746552892864,MATH 20E,B02,890101,Harel; Guershon,21,0,30,9
1746552893890,MATH 102,A01,890104,Staff,17,0,30,13
1746552893890,MATH 102,A02,890105,Staff,27,0,30,3
1746552894921,MATH 103B,A01,890116,Salehi Golsefidy; Alireza,3,0,30,27
1746552894921,MATH 103B,B01,890118,Staff,0,3,34,34
1746552895948,MATH 109,A01,890121,Aliabadi Sr.; Mohsen,1,0,30,29
1746552895948,MATH 109,B01,890124,Upadrashta; Pranav Kumar,18,0,30,12
1746552896973,MATH 120A,A01,890126,Eggers; John Dietrich,13,0,30,17
1746552897998,MATH 142B,A01,890128,Ioana; Adrian,19,0,30,11
1746552897998,MATH 142B,A02,890129,Ioana; Adrian,13,0,30,17
1746552899023,MATH 154,A01,890174,Staff,0,0,30,30
1746552899023,MATH 154,A02,890182,Staff,0,0,30,30
1746552900047,MATH 168A,A01,890197,Dumitriu; Ioana,21,0,35,14
1746552901081,MATH 170A,A01,890240,Nie; Jiawang,1,0,30,29
1746552901081,MATH 170A,A02,890241,Nie; Jiawang,11,0,30,19
1746552901081,MATH 170A,A03,890249,Nie; Jiawang,23,0,30,7
1746552902108,MATH 170B,A01,957891,Nag; Panchali,13,0,35,22
1746552904159,MATH 181A,A01,908025,Staff,0,4,35,35
1746552904159,MATH 181A,A02,960115,Staff,27,0,35,8
1746552905184,MATH 181B,A01,959874,Staff,25,0,30,5
1746552906210,MATH 193B,A01,890265,Staff,0,4,35,35
1746552907236,MGT 4,A01,890311,Anderson; John Charles,42,0,88,46
1746552908261,MGT 5,A00,907740,Staff,13,0,98,85
1746552909285,MGT 12,A00,890312,Lindenberger; Wade Douglas,67,0,98,31
1746552910313,MGT 16,A00,957883,Staff,78,0,98,20
1746552912363,MGT 45,A00,890314,Pecore; Joseph P.,47,0,98,51
1746552913386,MGT 71,A00,890315,Staff,0,11,98,98
1746552914414,MGT 100,A00,890316,Yavorsky; Daniel Ryan,44,0,98,54
1746552915438,MGT 103,A00,890317,Ehrich; Kristine R,73,0,98,25
1746552916462,MGT 105,A00,890356,Bates; Kenneth Walter,0,7,98,98
1746552917489,MGT 112,A00,890360,Ehrich; Kristine R,55,0,98,43
1746552918515,MGT 127R,A00,907732,Zhu; Kevin Xiaoguo,24,0,98,74
1746552919538,MGT 131B,A00,890361,Anderson; John Charles,61,0,98,37
1746552920565,MGT 137,A00,890362,Lindenberger; Wade Douglas,65,0,98,33
1746552921588,MGT 160,A00,890369,Johnson; Erik Barry,9,0,98,89
1746552923641,MGT 164,A00,890372,Zimmermann; Carsten,0,39,98,98
1746552924665,MGT 180,A00,890374,Bliss; Barbara Ann,12,0,98,86
1746552925691,MMW 15,A01,886414,Chang; Edmond Yi-Teh,0,12,28,28
1746552925691,MMW 15,A02,886415,Chang; Edmond Yi-Teh,0,8,28,28
1746552925691,MMW 15,A03,886416,Chang; Edmond Yi-Teh,0,8,28,28
1746552925691,MMW 15,A04,886417,Chang; Edmond Yi-Teh,0,8,28,28
1746552925691,MMW 15,B01,886419,Chang; Edmond Yi-Teh,0,7,28,28
1746552925691,MMW 15,B02,886420,Chang; Edmond Yi-Teh,0,8,28,28
1746552925691,MMW 15,B03,886421,Chang; Edmond Yi-Teh,0,7,28,28
1746552925691,MMW 15,B04,886422,Chang; Edmond Yi-Teh,0,8,28,28
1746552925691,MMW 15,C01,886424,Staff,0,9,28,28
1746552925691,MMW 15,C02,886425,Staff,0,8,28,28
1746552925691,MMW 15,C03,886426,Staff,0,8,28,28
1746552925691,MMW 15,C04,886427,Staff,0,7,28,28
1746552925691,MMW 15,C05,958038,Staff,0,7,28,28
1746552925691,MMW 15,C06,958039,Staff,0,8,28,28
1746552926720,MMW 15GS,A00,906910,Patterson; Patrick H.,4,0,28,24
1746552927747,MMW 122R,A01,886429,Rahimi; Babak,0,13,28,28
1746552927747,MMW 122R,A02,886430,Rahimi; Babak,0,12,28,28
1746552927747,MMW 122R,A03,958040,Rahimi; Babak,0,11,28,28
1746552928771,MUS 1A,A01,890937,Staff,2,0,25,23
1746552928771,MUS 1A,A02,891035,Staff,6,0,25,19
1746552928771,MUS 1A,C01,958912,Staff,24,0,25,1
1746552928771,MUS 1A,C02,958913,Staff,25,0,25,0
1746552930821,MUS 2AK,A00,957092,Ohnishi; Takae,15,0,15,0
1746552931846,MUS 4,A01,891044,Staff,2,0,25,23
1746552931846,MUS 4,A02,891045,Staff,23,0,25,2
1746552931846,MUS 4,B01,891048,Staff,17,0,25,8
1746552931846,MUS 4,B02,891050,Staff,25,0,25,0
1746552932872,MUS 5,A01,957506,Dubnov; Shlomo,0,0,25,25
1746552932872,MUS 5,A02,957622,Dubnov; Shlomo,13,0,25,12
1746552932872,MUS 5,A03,957623,Dubnov; Shlomo,20,0,25,5
1746552933898,MUS 6,A01,891053,Freitas Caetano; Marcelo,24,0,25,1
1746552933898,MUS 6,A02,891054,Freitas Caetano; Marcelo,23,0,25,2
1746552934930,MUS 7,A01,891081,Staff,0,0,25,25
1746552934930,MUS 7,A02,891082,Staff,4,0,25,21
1746552935954,MUS 8GS,A00,891118,Borgo; David Garcia,0,0,25,25
1746552936980,MUS 11,A01,891140,Staff,11,0,25,14
1746552936980,MUS 11,A02,891141,Staff,22,0,25,3
1746552938009,MUS 13,A01,891143,Staff,8,0,25,17
1746552938009,MUS 13,A02,891144,Staff,24,0,25,1
1746552939037,MUS 15,A01,891146,Staff,9,0,25,16
1746552939037,MUS 15,A02,891148,Staff,21,0,25,4
1746552939037,MUS 15,B01,891150,Staff,18,0,25,7
1746552939037,MUS 15,B02,891151,Staff,25,0,25,0
1746552940065,MUS 20,A01,891153,Staff,5,0,20,15
1746552940065,MUS 20,A02,891155,Staff,14,0,20,6
1746552941089,MUS 80,A00,891156,Staff,19,0,25,6
1746552941089,MUS 80,B00,891157,Staff,23,0,25,2
1746552942115,MUS 130,A00,891158,Ohnishi; Takae,35,0,35,0
1746552943139,MUS 150GS,A01,891160,Borgo; David Garcia,0,0,25,25
1746552944165,MUS 170,A01,891162,Freitas Caetano; Marcelo,20,0,25,5
1746552944165,MUS 170,A02,891164,Freitas Caetano; Marcelo,21,0,25,4
1746552945192,NANO 11,A00,886220,Vazquez Mena; Oscar,13,0,15,2
1746552946218,NANO 15,A01,886222,Drews; Aaron,4,0,7,3
1746552947245,NANO 104,A00,886224,Sirbuly; Donald,18,0,25,7
1746552948273,PH 40,A00,886528,Staff,23,0,40,17
1746552949300,PH 45,A01,886799,Staff,35,0,40,5
1746552950329,PH 110,A00,886802,Staff,0,7,40,40
1746552951357,PH 172,A00,906716,Staff,19,0,35,16
1746552952386,PH 191,A00,886803,Staff,6,0,40,34
1746552953413,PHIL 1,A00,889500,Staff,19,0,30,11
1746552954437,PHIL 10,A01,889549,Grush; Rick Scott,15,0,22,7
1746552954437,PHIL 10,A02,889551,Grush; Rick Scott,22,0,22,0
1746552955466,PHIL 28,A01,889559,Lamey; Andy M.,0,1,31,31
1746552955466,PHIL 28,A02,889561,Lamey; Andy M.,0,1,30,30
1746552955466,PHIL 28,A03,889572,Lamey; Andy M.,0,1,30,30
1746552956491,PHIL 35,A00,907839,Staff,13,0,15,2
1746552957515,PHIL 60,A00,889574,Staff,74,0,90,16
1746552958539,PHIL 101,A00,958004,Staff,13,0,15,2
1746552960590,PHIL 136,A00,889582,Fulkerson; Matthew Todd,26,0,45,19
1746552961617,PHIL 163,A01,889601,Staff,21,0,30,9
1746552961617,PHIL 163,B01,889606,Brandt; Reuven A,0,3,0,0
1746552962644,PHIL 164,A00,889610,Staff,16,0,30,14
1746552963671,PHIL 165,A00,889613,Staff,23,0,30,7
1746552964701,PHYS 1A,A00,886431,Staff,26,0,70,44
1746552965730,PHYS 1AL,001,886432,Tsai; Philbert S,0,2,30,30
1746552965730,PHYS 1AL,002,886436,Tsai; Philbert S,11,0,30,19
1746552966759,PHYS 1B,A00,886439,Staff,185,0,240,55
1746552967784,PHYS 1BL,001,886441,Tsai; Philbert S,0,4,30,30
1746552967784,PHYS 1BL,002,886444,Tsai; Philbert S,2,0,30,28
1746552968812,PHYS 1C,A00,896092,Arnold; Kam S,78,0,146,68
1746552969841,PHYS 1CL,001,886448,Tsai; Philbert S,0,0,30,30
1746552969841,PHYS 1CL,002,886449,Tsai; Philbert S,0,0,30,30
1746552969841,PHYS 1CL,003,886450,Tsai; Philbert S,16,0,30,14
1746552969841,PHYS 1CL,004,886451,Tsai; Philbert S,15,0,30,15
1746552970867,PHYS 2B,A01,886457,Staff,69,0,115,46
1746552971895,PHYS 2C,A01,886460,Shotwell; Brian,0,8,65,65
1746552972923,PHYS 2CL,A01,886467,Staff,0,4,28,28
1746552972923,PHYS 2CL,A02,886468,Staff,0,3,28,28
1746552973949,PHYS 2D,A01,886470,Staff,10,0,50,40
1746552974980,PHYS 4B,A01,886475,Grinstein; Benjamin,22,0,40,18
1746552976004,POLI 5,A00,891173,Desposato; Scott,7,0,25,18
1746552977030,POLI 5D,A01,891175,Staff,5,0,5,0
1746552977030,POLI 5D,B01,891178,Staff,5,0,5,0
1746552978055,POLI 11,A00,891179,Ferree; Karen E,2,0,35,33
1746552979086,POLI 12,A00,891180,Staff,16,0,30,14
1746552980112,POLI 27,A01,891182,Staff,12,0,75,63
1746552981137,POLI 30,A00,891183,Staff,8,0,50,42
1746552982162,POLI 100B,A00,891244,Staff,5,1,35,30
1746552983187,POLI 100I,A00,891247,Staff,7,0,30,23
1746552984214,POLI 104J,A00,891248,Nichter; Maysa,14,0,30,16
1746552985242,POLI 104U,A00,891250,Nichter; Maysa,2,0,30,28
1746552987292,POLI 110B,A00,891255,Wiens; David,20,0,25,5
1746552988318,POLI 112A,A00,891256,Wiens; David,6,0,25,19
1746552989345,POLI 114BR,A00,891261,Staff,19,0,30,11
1746552990373,POLI 117R,A00,891262,Forman; Fonna,0,6,50,50
1746552991396,POLI 118,A00,891264,Ingham; Sean,17,0,25,8
1746552992420,POLI 124A,A00,891265,Staff,18,0,20,2
1746552993446,POLI 125D,A00,891266,Nichter; Simeon C,2,0,25,23
1746552994472,POLI 126,A00,891268,Nichter; Simeon C,7,0,25,18
1746552995498,POLI 126AA,A00,891272,Staff,17,0,25,8
1746552996527,POLI 130AA,A00,891273,Staff,15,0,20,5
1746552997554,POLI 134AA,A00,891274,Staff,4,0,20,16
1746552999608,POLI 138,A00,891278,Staff,21,0,25,4
1746553000637,POLI 142K,A00,891280,Staff,11,0,25,14
1746553001665,POLI 142M,A00,891281,Gartzke; Erik,17,0,30,13
1746553002691,POLI 142P,A00,891284,Staff,20,0,30,10
1746553003719,POLI 143,A00,891285,Gartzke; Erik,12,0,30,18
1746553004767,POLI 153,A00,891286,Staff,19,0,20,1
1746553006817,POLI 175,A00,891290,Staff,15,0,20,5
1746553007844,PSYC 1,A00,890674,Steiner; Eric Tomas,0,11,45,45
1746553008868,PSYC 2,A00,890676,Albright; Thomas D,21,0,35,14
1746553009892,PSYC 3,A00,890679,Staff,17,0,20,3
1746553010917,PSYC 6,A00,959858,Staff,20,0,20,0
1746553011941,PSYC 60,A01,890684,Rickard; Timothy C.,0,5,45,45
1746553012968,PSYC 70,A01,890689,Geller; Emma Harlan,7,0,30,23
1746553013994,PSYC 71,A01,959860,Staff,21,0,25,4
1746553015020,PSYC 100,A00,890690,Lacefield; Katharine I,0,50,180,180
1746553016048,PSYC 102,A00,890695,Staff,18,0,40,22
1746553017073,PSYC 105,A00,890699,Geller; Emma Harlan,71,0,100,29
1746553018102,PSYC 106,A00,890701,Gorman; Michael R.,5,0,30,25
1746553019131,PSYC 108,A00,890704,Adrian; Julia Anna,0,28,50,50
1746553020160,PSYC 118,A01,890712,Staff,11,0,30,19
1746553021190,PSYC 124,A00,890716,Chapman; Eddie Nathaniel,25,0,60,35
1746553022213,PSYC 131,A00,890717,Anagnostaras; Stephan,0,7,80,80
1746553023239,PSYC 137,A00,890719,Winkielman; Piotr,0,11,30,30
1746553024265,PSYC 144,A00,890721,Adrian; Julia Anna,0,9,45,45
1746553025290,PSYC 162,A00,890805,Staff,2,0,75,73
1746553026317,PSYC 169,A00,890810,Staff,0,14,30,30
1746553027340,PSYC 172,A00,890814,Gorman; Michael R.,9,0,30,21
1746553028364,PSYC 181,A00,890818,Anagnostaras; Stephan,8,0,200,192
1746553029394,PSYC 184,A00,959861,Staff,170,0,175,5
1746553030419,PSYC 189,A00,890823,Staff,0,1,30,30
1746553031445,PSYC 191,A00,890884,Rickard; Timothy C.,0,11,35,35
1746553032475,PSYC 193,A00,890913,Staff,19,0,30,11
1746553032475,PSYC 193,B00,890914,Chapman; Eddie Nathaniel,24,0,30,6
1746553033504,PSYC 193L,A01,890918,Lowe; Angela Beth,20,0,30,10
1746553033504,PSYC 193L,B01,890921,Hurwitz; Ethan Scott,20,0,30,10
1746553033504,PSYC 193L,C01,890928,Staff,30,0,30,0
1746553034534,RELI 149,A00,886806,Rahimi; Babak,23,0,40,17
1746553035559,SE 9,A01,886814,Staff,7,0,20,13
1746553036584,SE 101B,A01,886816,Chadha; Mayank,4,0,35,31
1746553037609,SE 110B,A00,886818,Zhu; Qiang,4,0,75,71
1746553038635,SE 125,A01,886830,Staff,10,0,30,20
1746553039663,SE 130B,A01,886835,Staff,14,0,40,26
1746553040688,SE 131A,A01,886838,Krysl; Petr,34,0,55,21
1746553041715,SE 154,A00,886840,Staff,30,0,50,20
1746553042744,SE 164GS,A01,886849,Staff,6,0,20,14
1746553043770,SE 167GS,A01,886853,Staff,6,0,20,14
1746553044798,SIO 25,A01,890107,Staff,19,0,30,11
1746553045823,SIO 45,A00,890109,Cook; Geoffrey W,117,0,200,83
1746553046850,SIO 109R,A00,890110,Forman; Fonna,0,16,20,20
1746553047876,SIO 187,A01,890114,Kacev; David,15,0,40,25
1746553048901,SOCI 1,A01,890431,Thorpe; Charles Robert,15,0,30,15
1746553048901,SOCI 1,A02,890518,Thorpe; Charles Robert,30,0,30,0
1746553049927,SOCI 2,A01,957978,Staff,25,0,25,0
1746553049927,SOCI 2,A02,957979,Staff,23,0,25,2
1746553050952,SOCI 20,A01,890523,Calderon-Zaks; Michael Aar,23,0,30,7
1746553050952,SOCI 20,A02,890526,Calderon-Zaks; Michael Aar,29,0,30,1
1746553051977,SOCI 30,A01,890533,Pardo Guerra; Juan Pablo,37,0,40,3
1746553053006,SOCI 40,A01,890535,Staff,27,0,45,18
1746553054032,SOCI 104Q,A00,890559,Staff,18,0,30,12
1746553055057,SOCI 106,A00,890560,Arnal; Maud Marie Leonie,20,0,30,10
1746553056081,SOCI 110,A00,890567,Holkenbrink-Monk; Charlene,19,0,30,11
1746553057109,SOCI 112,A00,890568,Victoria Torres; Pablo,2,0,55,53
1746553058136,SOCI 115,A00,890597,Arnal; Maud Marie Leonie,28,0,45,17
1746553060190,SOCI 121,A00,890604,Pardo Guerra; Juan Pablo,38,0,45,7
1746553061216,SOCI 126,A01,890608,Staff,8,0,10,2
1746553062241,SOCI 127,A00,890609,Staff,18,0,30,12
1746553063265,SOCI 131,A00,890610,Thorpe; Charles Robert,37,0,45,8
1746553064291,SOCI 135,A00,890615,Payne; Christine Anna,14,0,45,31
1746553065317,SOCI 139,A00,890620,Staff,38,0,45,7
1746553066340,SOCI 148E,A00,890622,Calderon-Zaks; Michael Aar,36,0,45,9
1746553067366,SOCI 150,A00,890623,Kohler; Kristopher M.,31,0,45,14
1746553068393,SOCI 157,A00,890625,Jules-Rosette; Bennetta W.,18,0,20,2
1746553069420,SOCI 160,A00,890627,Payne; Christine Anna,21,0,45,24
1746553070445,SYN 1,A00,886855,Fish; Gwendolyn Anne,0,0,0,0
1746553070445,SYN 1,B00,906086,Fish; Gwendolyn Anne,0,1,0,2
1746553071474,SYN 2R,A00,886860,Staff,0,17,15,15
1746553071474,SYN 2R,B00,906106,Atkinson; Arthur Laird,0,16,15,15
1746553072506,SYN 100,A01,886866,Browne; Emily,0,28,20,20
1746553072506,SYN 100,B01,906128,Rock; Martin,0,5,20,20
1746553072506,SYN 100,C01,906140,Deavenport; James Cary,0,3,20,20
1746553072506,SYN 100,D01,907816,Deavenport; James Cary,0,5,20,20
1746553073533,TDAC 1,A00,890286,Walsh; Kim C.,9,0,20,11
1746553074559,TDAC 101,A00,890296,Basso; Beatrice,16,0,20,4
1746553075585,TDDE 131,A00,890297,Staff,47,0,50,3
1746553076612,TDDM 1,A00,890287,Weinberg; Sadie,25,0,30,5
1746553077638,TDGE 11,A00,890288,Fulton; Julia,137,0,200,63
1746553077638,TDGE 11,B00,890289,Castro; Robert Jess,184,0,200,16
1746553078663,TDGE 25,B00,957359,Walsh; Kim C.,3,0,20,17
1746553079688,TDGE 40,A01,890292,Power; Jade Yukana,27,0,30,3
1746553080714,TDGE 124,A00,890298,Havis; Allan,0,1,50,50
1746553081738,TDGE 131R,A00,890299,Burelle; Julie Sara Veronique,15,0,42,27
1746553082765,TDHT 101,A00,890300,Staff,10,0,20,10
1746553083807,TDHT 109,A01,890302,Anderson; Mysia Anyse,31,0,40,9
1746553084835,TDMV 1,A00,890293,Arcidiacono; Kristin,18,0,30,12
1746553085862,TDMV 2,A00,890294,Weinberg; Sadie,23,0,30,7
1746553086887,TDMV 3,A00,957878,Arcidiacono; Kristin,28,0,30,2
1746553088938,TDMV 138,A00,890304,Jun; Grace Shin Hae,25,0,40,15
1746553089970,TDMV 140,A00,890305,Corrales; Joseph Bernales,25,0,30,5
1746553090997,TDMV 142,A00,890307,Caligagan; Tony,32,0,40,8
1746553092024,TDMV 144,A00,890308,Camaya; Michelle Ann,25,0,30,5
1746553093051,TDPW 1,A00,890295,Stein; Deborah Isobel,3,0,20,17
1746553094076,USP 2,A01,890272,Lerner; Amy M,6,0,20,14
1746553095106,USP 3,A01,890274,Staff,12,0,30,18
1746553096135,USP 15,A01,890276,Sun; Feiyang,17,0,30,13
1746553097161,USP 25,A00,890277,Shenkman; Michael Thomas,19,0,25,6
1746553098189,USP 138,A00,890278,Staff,13,0,25,12
1746553099214,USP 143,A00,890279,Staff,21,0,70,49
1746553100242,USP 144,A00,890280,Chowdhury; Muhammed Zohir,16,0,30,14
1746553101271,USP 150,A00,890281,Boomhower; Matthew Charles,4,0,30,26
1746553102295,USP 151,A00,890282,Staff,16,0,20,4
1746553103324,USP 162,A00,890283,Andrews; Abigail Leslie,16,0,20,4
1746553104348,USP 168,A00,920477,Kwak; Nancy,1,0,5,4
1746553105373,USP 181,A00,890284,Staff,3,0,20,17
1746553106400,USP 191A,A00,890285,Staff,13,0,20,7
1746553107425,VIS 101,A00,886512,Staff,25,0,75,50
1746553108451,VIS 103,A00,886513,Cruz; Edwin Teddy,61,0,75,14
1746553109476,VIS 108,A00,886514,Staff,3,0,15,12
1746553110502,VIS 127P,A00,886515,Shen; Kuiyi,80,0,146,66
1746553111531,VIS 149,A00,886516,Yoldas; Pinar,0,0,15,15
1746553112556,VIS 164,A00,886526,Erdmann; Dean,19,0,22,3
1746553113584,VIS 194S,A00,886527,Staff,61,0,75,14
1746553114608,WCWP 10A,C00,886484,Martiniuk; Jill,12,0,15,3
1746553115638,WCWP 10B,A00,886490,Uriarte; Emma,0,0,15,15
1746553115638,WCWP 10B,B00,886491,Dhir; Simrita,10,0,15,5
1746553115638,WCWP 10B,C00,886492,Ornelas; Tricia,0,0,15,15
1746553116667,WCWP 100,A00,886494,Young; Mark T,0,6,15,15
1746553118743,AAS 10,A01,886199,Childs; Dennis R.,0,3,0,0
1746553119768,ANAR 104,A01,886940,Shtienberg; Gilad,27,0,30,3
1746553120794,ANAR 120,A00,886953,Staff,12,0,20,8
1746553121820,ANBI 148,A01,886955,Wilder; Linnea Lorene,30,0,40,10
1746553123866,ANSC 122,A00,886957,Staff,25,0,30,5
1746553124892,ANSC 150,A00,886958,Sloane; Julia Kathryn,2,0,15,13
1746553125916,ANSC 156,A00,886959,Jenkins; Janis A.,0,1,15,15
1746553126940,ANSC 180,A00,886960,Staff,11,0,17,6
1746553127966,ANSC 188,A00,886961,Jassal; Aftab,9,0,25,16
1746553128991,ANSC 190,A00,886962,Jassal; Aftab,14,0,25,11
1746553130017,ANSC 191,A00,886963,Staff,18,0,20,2
1746553131043,ANTH 3,A01,891689,Staff,17,0,20,3
1746553132071,ANTH 5,A00,886933,Semendeferi; Ekaterini,16,0,20,4
1746553133097,ANTH 10,A00,886934,Staff,0,12,30,30
1746553134153,ANTH 21,A01,886936,Staff,40,0,60,20
1746553135180,ANTH 23,A01,886938,Staff,92,0,100,8
1746553136206,ANTH 105,A00,886964,Stewart; Alexander B,84,0,100,16
1746553137232,ANTH 108,A00,886965,Pedersen; David,9,0,20,11
1746553138262,AWP 10,001,886147,Staff,0,0,0,0
1746553138262,AWP 10,002,886148,Staff,0,0,0,0
1746553138262,AWP 10,003,886149,Staff,0,0,0,0
1746553138262,AWP 10,004,886150,Staff,0,0,0,0
1746553138262,AWP 10,005,886151,Staff,0,0,0,0
1746553138262,AWP 10,006,886152,Staff,0,0,0,0
1746553138262,AWP 10,007,886153,Staff,0,0,0,0
1746553138262,AWP 10,008,886154,Staff,0,0,0,0
1746553138262,AWP 10,009,886155,Staff,0,0,0,0
1746553138262,AWP 10,010,886156,Staff,0,0,0,0
1746553138262,AWP 10,011,886158,Staff,0,0,0,0
1746553138262,AWP 10,012,886160,Staff,0,0,0,0
1746553138262,AWP 10,013,886161,Staff,0,0,0,0
1746553138262,AWP 10,014,886162,Staff,0,0,0,0
1746553138262,AWP 10,015,886163,Staff,0,0,0,0
1746553138262,AWP 10,016,886164,Staff,0,0,0,0
1746553138262,AWP 10,017,886165,Staff,0,0,0,0
1746553138262,AWP 10,018,886166,Staff,0,0,0,0
1746553138262,AWP 10,019,886168,Staff,0,0,0,0
1746553138262,AWP 10,020,886170,Staff,0,0,0,0
1746553138262,AWP 10,021,886172,Staff,0,0,0,0
1746553139289,AWP 10R,001,886173,Staff,0,1,0,0
1746553139289,AWP 10R,002,886174,Staff,0,1,0,0
1746553139289,AWP 10R,003,886175,Staff,0,0,0,0
1746553139289,AWP 10R,004,886176,Staff,0,0,0,0
1746553139289,AWP 10R,005,886177,Staff,0,0,0,0
1746553139289,AWP 10R,006,886178,Staff,0,0,0,0
1746553139289,AWP 10R,007,886179,Staff,0,0,0,0
1746553139289,AWP 10R,008,886181,Staff,0,0,0,0
1746553139289,AWP 10R,009,886182,Staff,0,0,0,0
1746553139289,AWP 10R,010,886183,Staff,0,0,0,0
1746553139289,AWP 10R,011,886184,Staff,0,0,0,0
1746553139289,AWP 10R,012,886185,Staff,0,0,0,0
1746553139289,AWP 10R,013,886186,Staff,0,0,0,0
1746553139289,AWP 10R,014,886187,Staff,0,0,0,0
1746553139289,AWP 10R,015,886188,Staff,0,0,0,0
1746553139289,AWP 10R,016,886189,Staff,0,0,0,0
1746553139289,AWP 10R,017,960532,Staff,0,0,0,0
1746553139289,AWP 10R,018,960533,Staff,0,0,0,0
1746553139289,AWP 10R,019,960534,Staff,0,0,0,0
1746553139289,AWP 10R,020,960538,Staff,0,0,0,0
1746553139289,AWP 10R,021,960540,Staff,0,0,0,0
1746553139289,AWP 10R,022,960541,Staff,0,0,0,0
1746553139289,AWP 10R,023,960542,Staff,0,0,0,0
1746553139289,AWP 10R,024,960544,Staff,0,0,0,0
1746553139289,AWP 10R,025,960545,Staff,0,0,0,0
1746553139289,AWP 10R,026,960548,Staff,0,0,0,0
1746553140317,AWP 102R,A00,886190,Staff,0,0,0,0
1746553140317,AWP 102R,B00,886191,Staff,0,0,0,0
1746553141342,BENG 100,A01,886193,Staff,17,0,30,13
1746553142372,BENG 122A,A01,886195,Hasty; Jeff M,13,0,30,17
1746553143397,BENG 166A,A00,886196,Sah; Robert Lie-Yuan,0,2,30,30
1746553144425,BENG 190,A00,958050,Khojah; Reem I,24,0,25,1
1746553145453,BIBC 102,A01,894320,Staff,0,0,46,46
1746553145453,BIBC 102,A02,894321,Staff,0,0,46,46
1746553145453,BIBC 102,A03,894344,Staff,7,0,46,39
1746553145453,BIBC 102,A04,894345,Staff,26,0,47,21
1746553146481,BICD 100R,A01,894365,Smith; Laurie,0,3,58,58
1746553146481,BICD 100R,A02,894366,Smith; Laurie,0,5,58,58
1746553146481,BICD 100R,A03,894367,Smith; Laurie,2,0,59,57
1746553146481,BICD 100R,A04,959869,Smith; Laurie,41,0,59,18
1746553147510,BICD 136,A01,894383,Gustafson-Brown; Cindy,14,0,50,36
1746553148535,BIEB 102,A01,894494,Butler; Shannon Rhey,51,0,130,79
1746553150591,BIEB 150,A01,894617,Wills; Christopher,3,0,20,17
1746553150591,BIEB 150,A02,894631,Wills; Christopher,3,0,20,17
1746553150591,BIEB 150,A03,894937,Wills; Christopher,3,0,20,17
1746553150591,BIEB 150,A04,894946,Wills; Christopher,5,0,20,15
1746553151615,BIEB 194,A00,906141,Kurle; Carolyn M.,6,0,20,14
1746553152641,BILD 1,A01,894154,Staff,2,0,19,17
1746553152641,BILD 1,A02,894155,Staff,14,0,19,5
1746553152641,BILD 1,A03,894160,Staff,13,0,19,6
1746553152641,BILD 1,A04,894161,Staff,15,0,18,3
1746553153667,BILD 2,A01,894168,Staff,0,0,50,50
1746553153667,BILD 2,A02,894169,Staff,0,0,50,50
1746553153667,BILD 2,A03,894179,Staff,4,0,50,46
1746553153667,BILD 2,A04,894203,Staff,27,0,50,23
1746553154695,BILD 3,A01,894213,Staff,22,0,31,9
1746553154695,BILD 3,A02,894214,Staff,26,0,31,5
1746553154695,BILD 3,A03,894235,Staff,28,0,31,3
1746553154695,BILD 3,A04,894236,Staff,28,0,32,4
1746553155722,BILD 4,A01,894253,Reuther; Keefe,5,0,24,19
1746553155722,BILD 4,A02,894258,Reuther; Keefe,16,0,24,8
1746553156752,BILD 5,A01,894276,Reuther; Keefe,35,0,50,15
1746553156752,BILD 5,A02,894277,Reuther; Keefe,45,0,50,5
1746553156752,BILD 5,A03,894290,Reuther; Keefe,44,0,50,6
1746553156752,BILD 5,A04,894291,Reuther; Keefe,48,0,50,2
1746553157780,BILD 24,A01,894297,Pirino; Giorgia,40,0,60,20
1746553158816,BIMM 100,B01,958915,Staff,72,0,100,28
1746553159840,BIMM 101,A01,895017,McDonnell; Lisa Marie,0,5,24,24
1746553159840,BIMM 101,A02,895018,McDonnell; Lisa Marie,0,5,24,24
1746553159840,BIMM 101,B01,895020,McDonnell; Lisa Marie,0,6,24,24
1746553159840,BIMM 101,B02,895021,McDonnell; Lisa Marie,0,4,24,24
1746553160864,BIMM 110,A01,895023,Staff,1,0,25,24
1746553160864,BIMM 110,A02,895024,Staff,9,0,25,16
1746553160864,BIMM 110,A03,895025,Staff,18,0,25,7
1746553160864,BIMM 110,A04,895031,Staff,20,0,25,5
1746553161894,BIMM 120,A01,895114,Gustafson-Brown; Cindy,14,0,28,14
1746553161894,BIMM 120,A02,895126,Gustafson-Brown; Cindy,21,0,27,6
1746553162921,BIPN 100,A01,895130,Yang; Mingyu,1,0,38,37
1746553162921,BIPN 100,A02,895131,Yang; Mingyu,32,0,38,6
1746553162921,BIPN 100,A03,895132,Yang; Mingyu,32,0,38,6
1746553162921,BIPN 100,A04,895133,Yang; Mingyu,27,0,36,9
1746553163945,BIPN 120,A01,895135,Cooke; James Edward,0,3,13,13
1746553163945,BIPN 120,A02,895136,Cooke; James Edward,0,1,13,13
1746553163945,BIPN 120,A03,895137,Cooke; James Edward,0,3,13,13
1746553163945,BIPN 120,A04,895156,Cooke; James Edward,0,2,11,11
1746553164974,BIPN 134,A01,895235,Cooke; James Edward,0,2,25,25
1746553164974,BIPN 134,A02,895237,Cooke; James Edward,0,0,25,25
1746553164974,BIPN 134,A03,895240,Cooke; James Edward,3,0,25,22
1746553164974,BIPN 134,A04,895270,Cooke; James Edward,20,0,25,5
1746553166002,BIPN 189,A00,892103,Staff,0,13,14,14
1746553168051,BISP 194,A00,958008,Staff,0,2,0,0
1746553169074,CAT 124,A01,922009,Staff,0,5,20,20
1746553170105,CAT 125R,A00,886390,Morales; Celeste Georgianna,0,2,20,20
1746553170105,CAT 125R,B00,886391,Irwin; Matthew Joseph,0,3,20,20
1746553170105,CAT 125R,C00,886392,Smith; Lauryn Alissa,0,2,20,20
1746553170105,CAT 125R,D00,886393,Vanderschuit; Maya Alysia,0,2,20,20
1746553170105,CAT 125R,E00,886394,Marchisotto; Jennifer Anne,0,4,20,20
1746553171134,CENG 15,A01,886218,Drews; Aaron,3,0,8,5
1746553172168,CENG 113,A00,886219,Opatkiewicz; Justin Paul,15,0,25,10
1746553173194,CGS 101,A00,887044,Staff,7,0,20,13
1746553174221,CGS 105,A01,887046,Staff,14,0,25,11
1746553175246,CGS 112,A00,887047,Cuong; Marisol,12,0,15,3
1746553176272,CGS 113,A00,887048,Staff,23,0,30,7
1746553177296,CGS 120,A00,887049,Staff,10,0,17,7
1746553178324,CHEM 6A,A01,886336,Lam; Tin Yiu,38,0,50,12
1746553178324,CHEM 6A,A02,886338,Lam; Tin Yiu,37,0,50,13
1746553179352,CHEM 6B,A01,886341,Hopkins; Patrycja Anna,16,0,50,34
1746553179352,CHEM 6B,A02,886343,Hopkins; Patrycja Anna,42,0,50,8
1746553180385,CHEM 6C,A01,886346,Albizati; Kim F.,0,2,50,50
1746553180385,CHEM 6C,A02,886348,Albizati; Kim F.,23,0,50,27
1746553181409,CHEM 40A,A01,886352,Klosterman; Jeremy K,65,0,100,35
1746553182435,CHEM 40B,A01,886356,Klosterman; Jeremy K,0,23,100,100
1746553183459,CHEM 41B,A01,886360,Theodorakis; Emmanuel,25,0,50,25
1746553183459,CHEM 41B,A02,886362,Theodorakis; Emmanuel,47,0,50,3
1746553184489,CHIN 165A,A00,886382,Xu; Li,18,0,20,2
1746553185513,CLAS 120,A00,886387,Myerston Santana; Jacobo,33,0,40,7
1746553186540,COGS 9,A01,886967,Shannon; Kyle Michael,42,0,60,18
1746553187567,COGS 11,A01,886969,Staff,11,0,30,19
1746553188595,COGS 14A,A01,886971,Staff,6,0,60,54
1746553189624,COGS 14B,A01,886973,Hoffman; Drew Ellen,4,0,60,56
1746553190649,COGS 18,A01,886975,Morgan; Eric,35,0,60,25
1746553191674,COGS 20,A01,886977,Staff,4,0,8,4
1746553191674,COGS 20,A02,886978,Staff,5,0,7,2
1746553192702,COGS 100,A01,907783,Staff,0,2,30,30
1746553193725,COGS 101B,A01,886980,Staff,0,3,48,48
1746553194757,COGS 101C,A01,886982,Delgado; Tania,0,5,44,44
1746553195787,COGS 102A,A01,886984,Johnson; Christine M.,4,0,30,26
1746553196814,COGS 118B,A01,886986,Staff,0,3,88,88
1746553197842,COGS 150,A01,886988,Bergen; Benjamin,23,0,50,27
1746553198866,COGS 153,A00,886989,Delgado; Tania,0,2,41,41
1746553199892,COGS 186,A01,886991,Staff,0,0,32,32
1746553200916,COGS 187A,A01,886993,Boyle; Mary E. T.,7,0,30,23
1746553201948,COGS 189,A00,886994,Staff,0,1,30,30
1746553202976,COMM 10,A01,886996,Staff,0,0,20,21
1746553202976,COMM 10,A02,886997,Staff,12,0,20,8
1746553202976,COMM 10,A03,959845,Staff,19,0,20,1
1746553204004,COMM 20,A01,886999,Leuning; Grant Maurstad,24,0,40,16
1746553206053,COMM 100A,A01,887002,Staff,0,0,20,25
1746553206053,COMM 100A,A02,887003,Staff,7,0,20,13
1746553207079,COMM 100B,A01,887005,Staff,0,8,20,24
1746553208103,COMM 106D,A00,887006,Staff,14,0,40,26
1746553209129,COMM 110G,A00,887007,Whitworth-Smith; Andrew C,12,0,40,28
1746553210158,COMM 111B,A00,887008,Staff,31,0,40,9
1746553211186,COMM 113T,A00,887009,Abuelhiga; Soraya Jill,28,0,40,12
1746553211186,COMM 113T,B00,906733,Staff,40,0,40,0
1746553212212,COMM 145,A00,887010,Staff,12,0,40,28
1746553213236,COMM 146,A00,887054,Staff,31,0,40,9
1746553214260,COMM 190,A00,887012,Staff,8,0,23,15
1746553215285,CSE 8A,A50,887015,Cao; Yingjun,57,0,85,28
1746553216309,CSE 11,A01,887017,Cao; Yingjun,12,0,70,58
1746553217339,CSE 20,A01,887019,Staff,30,0,50,20
1746553218370,CSE 21,A01,887021,Staff,78,0,100,22
1746553218370,CSE 21,B01,892583,Braun; Oliver,45,0,50,5
1746553219393,CSE 30,A01,887025,Eldon; John,143,0,200,57
1746553220420,CSE 100,A01,887027,Staff,25,0,50,25
1746553220420,CSE 100,A02,887028,Staff,41,0,50,9
1746553221446,CSE 101,A01,887030,Braun; Oliver,75,0,100,25
1746553221446,CSE 101,B01,887032,Jones; Miles E,0,3,50,50
1746553221446,CSE 101,B02,887033,Jones; Miles E,0,1,50,50
1746553222475,CSE 105,A01,908084,Jones; Miles E,32,0,50,18
1746553222475,CSE 105,A02,908087,Jones; Miles E,32,0,50,18
1746553223501,CSE 135,A01,887035,Powell; Thomas Allan,0,4,50,50
1746553224526,CSE 142,A01,887037,Staff,8,0,60,52
1746553225553,CSE 142L,A01,887039,Staff,34,0,60,26
1746553226579,CSE 151A,A01,887041,Solares; Edwin A,47,0,100,53
1746553227605,CSE 175,A01,887043,Kumar; Rakesh,30,0,30,0
1746553228633,CSS 1,A01,886389,Staff,0,1,40,40
1746553229662,DSC 30,A01,908097,Liao; Soohyun Nam,47,0,75,28
1746553230687,DSC 40A,A01,908099,Shannon; Kyle Michael,30,0,50,20
1746553231715,DSC 40B,A01,908112,Staff,16,0,50,34
1746553232739,DSC 80,A01,908116,Staff,19,0,60,41
1746553233767,DSC 197,001,956863,Eldridge; Justin Matthew,9999,0,9999,0
1746553234792,ECE 5,A01,886400,Morris; Karcher William,2,0,6,4
1746553234792,ECE 5,A02,886401,Morris; Karcher William,3,0,6,3
1746553235821,ECE 148,A01,886403,Silberman; Jack,0,14,14,14
1746553236848,ECON 1,A01,887265,Crane; Meredith Helen,12,0,70,58
1746553236848,ECON 1,B01,887268,Staff,43,0,50,7
1746553237874,ECON 2,A01,887273,Crane; Meredith Helen,56,0,70,14
1746553238901,ECON 3,A01,887279,Rondina; Giacomo,32,0,70,38
1746553239926,ECON 4,A01,887282,Anderson; John Charles,0,2,10,10
1746553240955,ECON 5,A01,887285,Staff,33,0,45,12
1746553240955,ECON 5,B01,887292,Staff,41,0,45,4
1746553241983,ECON 100A,A01,887337,Newhouse; Herbert S,54,0,70,16
1746553241983,ECON 100A,B01,887349,Staff,45,0,50,5
1746553243010,ECON 100B,A01,887361,Du; Songzi,29,0,70,41
1746553244035,ECON 100C,A01,887445,Newhouse; Herbert S,59,0,70,11
1746553245063,ECON 105,A00,887488,Vespa; Emanuel Ignacio,23,0,35,12
1746553246088,ECON 109,A01,887506,Shishkin; Denis,28,0,35,7
1746553247118,ECON 110A,A01,887568,Alon; Titan Michael,0,3,35,35
1746553247118,ECON 110A,B01,907601,Alon; Titan Michael,20,0,35,15
1746553248148,ECON 110B,A01,887598,Levkoff; Steven B.,0,23,70,70
1746553249173,ECON 112,A00,887599,Rondina; Giacomo,19,0,35,16
1746553250202,ECON 120A,A01,887603,Dai; Yinlin,36,0,70,34
1746553251229,ECON 120C,A01,887608,Sun; Yixiao,0,1,35,35
1746553251229,ECON 120C,B01,887614,Sun; Yixiao,0,0,35,35
1746553252254,ECON 138,A00,887621,Bharadwaj; Prashant,0,21,20,20
1746553253282,ECON 144,A00,958007,Squires; Dale E,13,0,35,22
1746553254308,ECON 171,A01,907666,Staff,18,0,35,17
1746553255338,ECON 175,A00,887626,Wu; Pak Yeung,23,0,35,12
1746553256365,ECON 190,A00,887640,Vespa; Emanuel Ignacio,23,0,35,12
1746553257393,EDS 25,A01,888197,Staff,0,0,0,0
1746553257393,EDS 25,A02,888209,Staff,0,0,0,0
1746553257393,EDS 25,A03,888210,Staff,0,0,0,0
1746553257393,EDS 25,A04,888212,Staff,0,0,0,0
1746553257393,EDS 25,A05,888213,Staff,0,0,0,0
1746553257393,EDS 25,A06,888214,Staff,0,0,0,0
1746553257393,EDS 25,A07,888235,Staff,0,2,0,0
1746553257393,EDS 25,A08,888236,Staff,0,0,0,0
1746553257393,EDS 25,A09,888240,Staff,0,0,0,0
1746553257393,EDS 25,A10,888244,Staff,0,0,0,0
1746553257393,EDS 25,B01,888273,Staff,0,0,0,0
1746553257393,EDS 25,B02,888285,Staff,0,0,0,0
1746553257393,EDS 25,B03,888423,Staff,0,0,0,1
1746553257393,EDS 25,B04,888432,Staff,0,0,0,0
1746553257393,EDS 25,B05,888433,Staff,0,0,0,0
1746553257393,EDS 25,B06,888467,Staff,0,0,0,0
1746553257393,EDS 25,B07,888468,Staff,0,0,0,0
1746553257393,EDS 25,B08,888479,Staff,0,0,0,0
1746553257393,EDS 25,B09,888484,Staff,0,0,0,0
1746553257393,EDS 25,B10,888487,Staff,0,0,0,0
1746553258415,EDS 38,A01,907700,Choi; Bailey Miyeon,30,0,30,0
1746553259444,EDS 112,A01,888601,Chapman; Thandeka K,14,0,40,26
1746553260470,EDS 115,A00,888697,Mendez; Kathrina Mendoza,10,0,30,20
1746553261495,EDS 116,A01,888893,Staff,35,0,40,5
1746553263551,EDS 124AR,A00,889133,Staff,29,0,50,21
1746553263551,EDS 124AR,B00,907471,Simon; Elizabeth A,37,0,50,13
1746553264580,EDS 124BR,A00,889134,Simon; Elizabeth A,45,0,100,55
1746553265608,EDS 125,A00,889135,Staff,25,0,30,5
1746553266635,EDS 126,A01,889138,Staff,36,0,40,4
1746553267662,EDS 164R,A01,889142,Wishard Guerra; Alison G.,33,0,50,17
1746553268690,ENG 30,A01,886396,Staff,0,0,0,0
1746553268690,ENG 30,B01,886398,Staff,0,0,0,0
1746553269715,ENVR 102,A00,906150,Montejo; Carolina,23,0,25,2
1746553270745,ETHN 103A,A00,887236,Man; Simeon S,0,3,0,0
1746553271774,ETHN 113,A00,887239,Staff,16,0,30,14
1746553272802,ETHN 116,A00,887240,Staff,16,0,25,9
1746553273831,ETHN 117,A00,887241,Choi; Esther Min,28,0,30,2
1746553274858,ETHN 118,A00,887243,Staff,24,0,30,6
1746553275883,ETHN 127,A00,887248,Cuong; Marisol,11,0,15,4
1746553276910,ETHN 139,A00,887250,Staff,7,0,10,3
1746553277935,ETHN 142,A00,887252,Staff,10,0,30,20
1746553278962,ETHN 161,A00,887253,Browne; Errol Tsekani,24,0,30,6
1746553279988,ETHN 163FR,A00,887255,Burelle; Julie Sara Veronique,0,0,5,5
1746553281015,GLBH 20,A00,889149,Elwardani; Nile Regina,8,0,42,34
1746553283071,GLBH 111,A01,889152,Burgos; Jose L.,17,0,17,0
1746553284099,GLBH 150,A00,889181,Sloane; Julia Kathryn,0,5,15,15
1746553286149,HDS 60,A01,886406,Warstadt; Melissa Fawn,73,0,80,7
1746553287175,HIAF 111,A00,889324,Gyamfi; Bright,25,0,32,7
1746553288199,HIEA 131,A00,889328,Staff,16,0,32,16
1746553289225,HIEA 144,A00,889333,Henry; Todd A.,26,0,32,6
1746553290255,HIEA 154,A00,889336,Henry; Todd A.,24,0,32,8
1746553291282,HIEU 106,A00,889339,Staff,22,0,32,10
1746553293333,HIEU 114,A00,889340,Staff,3,0,32,29
1746553294359,HIEU 135GS,A00,889342,Patterson; Patrick H.,0,0,1,24
1746553295383,HIEU 137,A00,889343,Edington; Claire Ellen,9,0,25,16
1746553296407,HIEU 148,A00,889345,Staff,14,0,32,18
1746553297433,HIEU 154,A00,889346,Biess; Frank Peter,21,0,32,11
1746553298467,HILA 102,A00,889351,Staff,12,0,32,20
1746553299491,HILD 2A,A01,889221,Lewandoski; Julia Mavis,1,10,32,31
1746553300515,HILD 7B,A01,889225,Man; Simeon S,0,13,32,32
1746553301542,HILD 7C,A01,889288,Alvarez; Luis A,0,14,32,32
1746553302568,HILD 30,A01,889323,Staff,0,5,32,32
1746553304618,HISC 119,A00,889383,Golan; Tal,20,0,32,12
1746553305643,HIUS 103,A00,889384,Man; Simeon S,0,0,32,32
1746553306670,HIUS 117,A00,919797,Kwak; Nancy,18,0,32,14
1746553307757,HIUS 142A,A00,919788,Staff,22,0,32,10
1746553309808,HIUS 149,A00,889386,Gyamfi; Bright,27,0,32,5
1746553310835,HIUS 155,A00,889387,Alvarez; Luis A,14,0,32,18
1746553311859,HUM 3,A01,886499,Caldwell; Michael Alan,19,0,50,31
1746553312886,HUM 3GS,A00,886500,Rodriguez; Bretton Sigfred,0,0,0,28
1746553313914,HUM 3R,A01,886502,Markman; Kristina,0,36,50,50
1746553314943,HUM 4,A01,886504,Crum; Matthew Stephen,24,0,50,26
1746553314943,HUM 4,B01,886506,West; Geoffrey Scott,17,0,50,33
1746553315967,HUM 4GS,A00,886507,Staff,0,0,0,19
1746553316997,HUM 5,A01,886509,Staff,32,0,50,18
1746553318024,HUM 5R,A01,886511,Zavodny; Tatiana Sophia,0,39,50,50
1746553319050,JAPN 180,A00,886407,Staff,17,0,40,23
1746553320074,LATI 50,A01,886409,Martin-Cabrera; Luis,4,0,22,18
1746553320074,LATI 50,A02,886410,Martin-Cabrera; Luis,19,0,22,3
1746553320074,LATI 50,A03,886411,Martin-Cabrera; Luis,21,0,22,1
1746553320074,LATI 50,A04,886412,Martin-Cabrera; Luis,9,0,22,13
1746553321104,LAWS 101,A00,907664,Staff,28,0,60,32
1746553322132,LIAB 1A,A00,889388,Saab; Dima,17,0,20,3
1746553323163,LIAB 1AX,A00,889389,El Cheddadi; Youniss,17,0,20,3
1746553324187,LIFR 1C,A00,889391,Van Moer; Vinciane G,8,0,20,12
1746553325214,LIFR 1CX,A00,889392,Van Moer; Vinciane G,7,0,20,13
1746553326239,LIFR 1D,A00,889393,Van Moer; Vinciane G,7,0,20,13
1746553327264,LIFR 1DX,A00,889394,Van Moer; Vinciane G,8,0,20,12
1746553328291,LIGN 7,A00,886923,Staff,24,0,50,26
1746553329315,LIGN 17,A00,886924,Kehler; Andrew Scott,125,0,150,25
1746553330341,LTAM 110,A00,889395,Staff,15,0,30,15
1746553331366,LTAM 110GS,A00,958010,Rodriguez; Bretton Sigfred,0,0,0,28
1746553332392,LTCH 101,A00,889397,Staff,23,0,25,2
1746553333417,LTCS 130,A00,889398,Staff,23,0,25,2
1746553334444,LTEA 138,A00,889399,Staff,24,0,40,16
1746553335468,LTEN 149,A00,889400,Wesling; Megan E.,0,3,25,25
1746553336495,LTEN 169,A00,889401,Staff,20,0,25,5
1746553337523,LTEN 180,A00,889402,Staff,10,0,15,5
1746553338551,LTEN 181,A00,889403,Staff,21,0,25,4
1746553339577,LTWL 100,A00,889404,Myerston Santana; Jacobo,3,0,25,22
1746553340605,LTWL 180GS,A00,889405,Staff,0,0,20,20
1746553341633,LTWL 181,A00,889406,Staff,17,0,25,8
1746553342658,LTWL 184,A00,889475,Mukherjee; Silpa,22,0,25,3
1746553343683,LTWR 102C,A00,889486,Staff,29,0,30,1
1746553344709,LTWR 115W,A00,889491,Staff,0,2,15,15
1746553345733,MAE 8,A01,886905,Staff,0,2,0,0
1746553346758,MAE 11,A00,886906,Bandaru; Prabhakar,0,7,50,50
1746553347785,MAE 20,A00,886907,Evdokimenko; Ekaterina,43,0,70,27
1746553348811,MAE 30B,A00,886909,Ghazinejad; Maziar,26,0,45,19
1746553349842,MAE 101B,A00,886910,Saintillan; David,29,0,45,16
1746553350867,MAE 105,A00,886911,Bandaru; Prabhakar,18,0,50,32
1746553351895,MAE 107,B00,958024,Staff,8,0,50,42
1746553352920,MAE 143B,A00,886913,Bewley; Thomas R,7,0,40,33
1746553353946,MAE 148,A01,886915,Silberman; Jack,0,3,14,14
1746553354973,MAE 160,A00,886916,Evdokimenko; Ekaterina,31,0,60,29
1746553356001,MATH 3C,A01,889681,Staff,0,3,30,30
1746553356001,MATH 3C,A02,960048,Staff,25,0,30,5
1746553357029,MATH 10A,A01,889760,Staff,26,0,30,4
1746553357029,MATH 10A,A02,889783,Staff,29,0,30,1
1746553358059,MATH 10B,A01,889785,Verstraete; Jacques Allan,2,0,35,33
1746553358059,MATH 10B,A02,889795,Verstraete; Jacques Allan,4,0,35,31
1746553358059,MATH 10B,B01,889797,Verstraete; Jacques Allan,3,0,35,32
1746553358059,MATH 10B,B02,889828,Verstraete; Jacques Allan,3,0,35,32
1746553359093,MATH 10C,A01,889849,Habib; Yousaf,8,0,30,22
1746553359093,MATH 10C,A02,889852,Habib; Yousaf,14,0,30,16
1746553359093,MATH 10C,A03,889853,Habib; Yousaf,22,0,30,8
1746553359093,MATH 10C,A04,889858,Habib; Yousaf,20,0,30,10
1746553359093,MATH 10C,B01,889861,Staff,1,0,30,29
1746553359093,MATH 10C,B02,889862,Staff,24,0,30,6
1746553359093,MATH 10C,B03,889863,Staff,27,0,30,3
1746553359093,MATH 10C,B04,889967,Staff,23,0,30,7
1746553360126,MATH 18,A01,889974,Staff,7,0,30,23
1746553360126,MATH 18,A02,889977,Staff,20,0,30,10
1746553360126,MATH 18,B01,889984,Hardiman; Liam,22,0,30,8
1746553360126,MATH 18,B02,889985,Hardiman; Liam,25,0,30,5
1746553361151,MATH 20A,A01,889990,Suk; Andrew Hoon,30,0,35,5
1746553362179,MATH 20B,A01,889993,Ohm; Ko Woon,22,0,30,8
1746553362179,MATH 20B,A02,889994,Ohm; Ko Woon,30,0,30,0
1746553362179,MATH 20B,B01,889996,Ohm; Ko Woon,21,0,30,9
1746553362179,MATH 20B,B02,889997,Ohm; Ko Woon,23,0,30,7
1746553363208,MATH 20C,A01,889999,Hammock; Frances H,17,0,30,13
1746553363208,MATH 20C,A02,890003,Hammock; Frances H,23,0,30,7
1746553363208,MATH 20C,B01,890006,Hammock; Frances H,3,0,30,27
1746553363208,MATH 20C,B02,890007,Hammock; Frances H,11,0,30,19
1746553364237,MATH 20D,A01,890011,Cheng; Hsiao-Bing,1,1,30,29
1746553364237,MATH 20D,A02,890012,Cheng; Hsiao-Bing,14,0,30,16
1746553364237,MATH 20D,B01,890016,Cheng; Hsiao-Bing,13,0,30,17
1746553364237,MATH 20D,B02,890017,Cheng; Hsiao-Bing,13,0,30,17
1746553365262,MATH 20E,A01,890026,Harel; Guershon,1,0,30,29
1746553365262,MATH 20E,A02,890029,Harel; Guershon,23,0,30,7
1746553365262,MATH 20E,B01,890033,Harel; Guershon,7,0,30,23
1746553365262,MATH 20E,B02,890101,Harel; Guershon,21,0,30,9
1746553366287,MATH 102,A01,890104,Staff,17,0,30,13
1746553366287,MATH 102,A02,890105,Staff,27,0,30,3
1746553367691,MATH 103B,A01,890116,Salehi Golsefidy; Alireza,3,0,30,27
1746553367691,MATH 103B,B01,890118,Staff,0,3,34,34
1746553368721,MATH 109,A01,890121,Aliabadi Sr.; Mohsen,1,0,30,29
1746553368721,MATH 109,B01,890124,Upadrashta; Pranav Kumar,18,0,30,12
1746553369746,MATH 120A,A01,890126,Eggers; John Dietrich,13,0,30,17
1746553370774,MATH 142B,A01,890128,Ioana; Adrian,19,0,30,11
1746553370774,MATH 142B,A02,890129,Ioana; Adrian,13,0,30,17
1746553371800,MATH 154,A01,890174,Staff,0,0,30,30
1746553371800,MATH 154,A02,890182,Staff,0,0,30,30
1746553372830,MATH 168A,A01,890197,Dumitriu; Ioana,21,0,35,14
1746553373859,MATH 170A,A01,890240,Nie; Jiawang,1,0,30,29
1746553373859,MATH 170A,A02,890241,Nie; Jiawang,11,0,30,19
1746553373859,MATH 170A,A03,890249,Nie; Jiawang,23,0,30,7
1746553374885,MATH 170B,A01,957891,Nag; Panchali,13,0,35,22
1746553376937,MATH 181A,A01,908025,Staff,0,4,35,35
1746553376937,MATH 181A,A02,960115,Staff,27,0,35,8
1746553377967,MATH 181B,A01,959874,Staff,25,0,30,5
1746553378992,MATH 193B,A01,890265,Staff,0,4,35,35
1746553380026,MGT 4,A01,890311,Anderson; John Charles,42,0,88,46
1746553381053,MGT 5,A00,907740,Staff,13,0,98,85
1746553382079,MGT 12,A00,890312,Lindenberger; Wade Douglas,67,0,98,31
1746553383106,MGT 16,A00,957883,Staff,78,0,98,20
1746553385158,MGT 45,A00,890314,Pecore; Joseph P.,47,0,98,51
1746553386187,MGT 71,A00,890315,Staff,0,11,98,98
1746553387212,MGT 100,A00,890316,Yavorsky; Daniel Ryan,44,0,98,54
1746553388239,MGT 103,A00,890317,Ehrich; Kristine R,73,0,98,25
1746553389265,MGT 105,A00,890356,Bates; Kenneth Walter,0,7,98,98
1746553390295,MGT 112,A00,890360,Ehrich; Kristine R,55,0,98,43
1746553391320,MGT 127R,A00,907732,Zhu; Kevin Xiaoguo,24,0,98,74
1746553392348,MGT 131B,A00,890361,Anderson; John Charles,61,0,98,37
1746553393375,MGT 137,A00,890362,Lindenberger; Wade Douglas,65,0,98,33
1746553394404,MGT 160,A00,890369,Johnson; Erik Barry,9,0,98,89
1746553396457,MGT 164,A00,890372,Zimmermann; Carsten,0,39,98,98
1746553397480,MGT 180,A00,890374,Bliss; Barbara Ann,12,0,98,86
1746553398512,MMW 15,A01,886414,Chang; Edmond Yi-Teh,0,12,28,28
1746553398512,MMW 15,A02,886415,Chang; Edmond Yi-Teh,0,8,28,28
1746553398512,MMW 15,A03,886416,Chang; Edmond Yi-Teh,0,8,28,28
1746553398512,MMW 15,A04,886417,Chang; Edmond Yi-Teh,0,8,28,28
1746553398512,MMW 15,B01,886419,Chang; Edmond Yi-Teh,0,7,28,28
1746553398512,MMW 15,B02,886420,Chang; Edmond Yi-Teh,0,8,28,28
1746553398512,MMW 15,B03,886421,Chang; Edmond Yi-Teh,0,7,28,28
1746553398512,MMW 15,B04,886422,Chang; Edmond Yi-Teh,0,8,28,28
1746553398512,MMW 15,C01,886424,Staff,0,9,28,28
1746553398512,MMW 15,C02,886425,Staff,0,8,28,28
1746553398512,MMW 15,C03,886426,Staff,0,8,28,28
1746553398512,MMW 15,C04,886427,Staff,0,8,28,28
1746553398512,MMW 15,C05,958038,Staff,0,7,28,28
1746553398512,MMW 15,C06,958039,Staff,0,8,28,28
1746553399537,MMW 15GS,A00,906910,Patterson; Patrick H.,4,0,28,24
1746553400570,MMW 122R,A01,886429,Rahimi; Babak,0,13,28,28
1746553400570,MMW 122R,A02,886430,Rahimi; Babak,0,12,28,28
1746553400570,MMW 122R,A03,958040,Rahimi; Babak,0,11,28,28
1746553401601,MUS 1A,A01,890937,Staff,2,0,25,23
1746553401601,MUS 1A,A02,891035,Staff,6,0,25,19
1746553401601,MUS 1A,C01,958912,Staff,24,0,25,1
1746553401601,MUS 1A,C02,958913,Staff,25,0,25,0
1746553403654,MUS 2AK,A00,957092,Ohnishi; Takae,15,0,15,0
1746553404677,MUS 4,A01,891044,Staff,2,0,25,23
1746553404677,MUS 4,A02,891045,Staff,23,0,25,2
1746553404677,MUS 4,B01,891048,Staff,17,0,25,8
1746553404677,MUS 4,B02,891050,Staff,25,0,25,0
1746553405707,MUS 5,A01,957506,Dubnov; Shlomo,0,0,25,25
1746553405707,MUS 5,A02,957622,Dubnov; Shlomo,13,0,25,12
1746553405707,MUS 5,A03,957623,Dubnov; Shlomo,20,0,25,5
1746553406734,MUS 6,A01,891053,Freitas Caetano; Marcelo,24,0,25,1
1746553406734,MUS 6,A02,891054,Freitas Caetano; Marcelo,23,0,25,2
1746553407762,MUS 7,A01,891081,Staff,0,0,25,25
1746553407762,MUS 7,A02,891082,Staff,4,0,25,21
1746553408789,MUS 8GS,A00,891118,Borgo; David Garcia,0,0,25,25
1746553409816,MUS 11,A01,891140,Staff,11,0,25,14
1746553409816,MUS 11,A02,891141,Staff,22,0,25,3
1746553410841,MUS 13,A01,891143,Staff,8,0,25,17
1746553410841,MUS 13,A02,891144,Staff,24,0,25,1
1746553411868,MUS 15,A01,891146,Staff,9,0,25,16
1746553411868,MUS 15,A02,891148,Staff,21,0,25,4
1746553411868,MUS 15,B01,891150,Staff,18,0,25,7
1746553411868,MUS 15,B02,891151,Staff,25,0,25,0
1746553412892,MUS 20,A01,891153,Staff,5,0,20,15
1746553412892,MUS 20,A02,891155,Staff,14,0,20,6
1746553413921,MUS 80,A00,891156,Staff,19,0,25,6
1746553413921,MUS 80,B00,891157,Staff,23,0,25,2
1746553414945,MUS 130,A00,891158,Ohnishi; Takae,35,0,35,0
1746553415971,MUS 150GS,A01,891160,Borgo; David Garcia,0,0,25,25
1746553416994,MUS 170,A01,891162,Freitas Caetano; Marcelo,20,0,25,5
1746553416994,MUS 170,A02,891164,Freitas Caetano; Marcelo,21,0,25,4
1746553418024,NANO 11,A00,886220,Vazquez Mena; Oscar,13,0,15,2
1746553419055,NANO 15,A01,886222,Drews; Aaron,4,0,7,3
1746553420081,NANO 104,A00,886224,Sirbuly; Donald,18,0,25,7
1746553421106,PH 40,A00,886528,Staff,23,0,40,17
1746553422135,PH 45,A01,886799,Staff,35,0,40,5
1746553423161,PH 110,A00,886802,Staff,0,7,40,40
1746553424187,PH 172,A00,906716,Staff,19,0,35,16
1746553425213,PH 191,A00,886803,Staff,6,0,40,34
1746553426237,PHIL 1,A00,889500,Staff,19,0,30,11
1746553427264,PHIL 10,A01,889549,Grush; Rick Scott,15,0,22,7
1746553427264,PHIL 10,A02,889551,Grush; Rick Scott,22,0,22,0
1746553428294,PHIL 28,A01,889559,Lamey; Andy M.,0,1,31,31
1746553428294,PHIL 28,A02,889561,Lamey; Andy M.,0,1,30,30
1746553428294,PHIL 28,A03,889572,Lamey; Andy M.,0,1,30,30
1746553429343,PHIL 35,A00,907839,Staff,13,0,15,2
1746553430369,PHIL 60,A00,889574,Staff,74,0,90,16
1746553431395,PHIL 101,A00,958004,Staff,13,0,15,2
1746553433443,PHIL 136,A00,889582,Fulkerson; Matthew Todd,26,0,45,19
1746553434471,PHIL 163,A01,889601,Staff,21,0,30,9
1746553434471,PHIL 163,B01,889606,Brandt; Reuven A,0,3,0,0
1746553435495,PHIL 164,A00,889610,Staff,16,0,30,14
1746553436518,PHIL 165,A00,889613,Staff,23,0,30,7
1746553437544,PHYS 1A,A00,886431,Staff,26,0,70,44
1746553438566,PHYS 1AL,001,886432,Tsai; Philbert S,0,2,30,30
1746553438566,PHYS 1AL,002,886436,Tsai; Philbert S,11,0,30,19
1746553439593,PHYS 1B,A00,886439,Staff,185,0,240,55
1746553440617,PHYS 1BL,001,886441,Tsai; Philbert S,0,4,30,30
1746553440617,PHYS 1BL,002,886444,Tsai; Philbert S,2,0,30,28
1746553441650,PHYS 1C,A00,896092,Arnold; Kam S,78,0,146,68
1746553442677,PHYS 1CL,001,886448,Tsai; Philbert S,0,0,30,30
1746553442677,PHYS 1CL,002,886449,Tsai; Philbert S,0,0,30,30
1746553442677,PHYS 1CL,003,886450,Tsai; Philbert S,16,0,30,14
1746553442677,PHYS 1CL,004,886451,Tsai; Philbert S,15,0,30,15
1746553443703,PHYS 2B,A01,886457,Staff,69,0,115,46
1746553444729,PHYS 2C,A01,886460,Shotwell; Brian,0,8,65,65
1746553445761,PHYS 2CL,A01,886467,Staff,0,4,28,28
1746553445761,PHYS 2CL,A02,886468,Staff,0,3,28,28
1746553446794,PHYS 2D,A01,886470,Staff,10,0,50,40
1746553447818,PHYS 4B,A01,886475,Grinstein; Benjamin,22,0,40,18
1746553448842,POLI 5,A00,891173,Desposato; Scott,7,0,25,18
1746553449867,POLI 5D,A01,891175,Staff,5,0,5,0
1746553449867,POLI 5D,B01,891178,Staff,5,0,5,0
1746553450893,POLI 11,A00,891179,Ferree; Karen E,2,0,35,33
1746553451920,POLI 12,A00,891180,Staff,16,0,30,14
1746553452951,POLI 27,A01,891182,Staff,12,0,75,63
1746553453978,POLI 30,A00,891183,Staff,8,0,50,42
1746553455006,POLI 100B,A00,891244,Staff,5,1,35,30
1746553456031,POLI 100I,A00,891247,Staff,7,0,30,23
1746553457057,POLI 104J,A00,891248,Nichter; Maysa,14,0,30,16
1746553458083,POLI 104U,A00,891250,Nichter; Maysa,2,0,30,28
1746553460141,POLI 110B,A00,891255,Wiens; David,20,0,25,5
1746553461168,POLI 112A,A00,891256,Wiens; David,6,0,25,19
1746553462194,POLI 114BR,A00,891261,Staff,19,0,30,11
1746553463222,POLI 117R,A00,891262,Forman; Fonna,0,6,50,50
1746553464246,POLI 118,A00,891264,Ingham; Sean,17,0,25,8
1746553465273,POLI 124A,A00,891265,Staff,18,0,20,2
1746553466297,POLI 125D,A00,891266,Nichter; Simeon C,2,0,25,23
1746553467325,POLI 126,A00,891268,Nichter; Simeon C,7,0,25,18
1746553468377,POLI 126AA,A00,891272,Staff,17,0,25,8
1746553469401,POLI 130AA,A00,891273,Staff,15,0,20,5
1746553470427,POLI 134AA,A00,891274,Staff,4,0,20,16
1746553472475,POLI 138,A00,891278,Staff,21,0,25,4
1746553473498,POLI 142K,A00,891280,Staff,11,0,25,14
1746553474525,POLI 142M,A00,891281,Gartzke; Erik,17,0,30,13
1746553475550,POLI 142P,A00,891284,Staff,20,0,30,10
1746553476575,POLI 143,A00,891285,Gartzke; Erik,12,0,30,18
1746553477600,POLI 153,A00,891286,Staff,19,0,20,1
1746553479653,POLI 175,A00,891290,Staff,15,0,20,5
1746553480680,PSYC 1,A00,890674,Steiner; Eric Tomas,0,11,45,45
1746553481705,PSYC 2,A00,890676,Albright; Thomas D,21,0,35,14
1746553482732,PSYC 3,A00,890679,Staff,17,0,20,3
1746553483755,PSYC 6,A00,959858,Staff,20,0,20,0
1746553484783,PSYC 60,A01,890684,Rickard; Timothy C.,0,5,45,45
1746553485813,PSYC 70,A01,890689,Geller; Emma Harlan,7,0,30,23
1746553486839,PSYC 71,A01,959860,Staff,21,0,25,4
1746553487863,PSYC 100,A00,890690,Lacefield; Katharine I,0,50,180,180
1746553488888,PSYC 102,A00,890695,Staff,18,0,40,22
1746553489914,PSYC 105,A00,890699,Geller; Emma Harlan,71,0,100,29
1746553490938,PSYC 106,A00,890701,Gorman; Michael R.,5,0,30,25
1746553491962,PSYC 108,A00,890704,Adrian; Julia Anna,0,28,50,50
1746553492988,PSYC 118,A01,890712,Staff,11,0,30,19
1746553494015,PSYC 124,A00,890716,Chapman; Eddie Nathaniel,25,0,60,35
1746553495045,PSYC 131,A00,890717,Anagnostaras; Stephan,0,7,80,80
1746553496070,PSYC 137,A00,890719,Winkielman; Piotr,0,11,30,30
1746553497099,PSYC 144,A00,890721,Adrian; Julia Anna,0,9,45,45
1746553498125,PSYC 162,A00,890805,Staff,2,0,75,73
1746553499149,PSYC 169,A00,890810,Staff,0,14,30,30
1746553500176,PSYC 172,A00,890814,Gorman; Michael R.,9,0,30,21
1746553501201,PSYC 181,A00,890818,Anagnostaras; Stephan,8,0,200,192
1746553502227,PSYC 184,A00,959861,Staff,170,0,175,5
1746553503254,PSYC 189,A00,890823,Staff,0,1,30,30
1746553504283,PSYC 191,A00,890884,Rickard; Timothy C.,0,11,35,35
1746553505308,PSYC 193,A00,890913,Staff,19,0,30,11
1746553505308,PSYC 193,B00,890914,Chapman; Eddie Nathaniel,24,0,30,6
1746553506333,PSYC 193L,A01,890918,Lowe; Angela Beth,20,0,30,10
1746553506333,PSYC 193L,B01,890921,Hurwitz; Ethan Scott,20,0,30,10
1746553506333,PSYC 193L,C01,890928,Staff,30,0,30,0
1746553507359,RELI 149,A00,886806,Rahimi; Babak,23,0,40,17
1746553508384,SE 9,A01,886814,Staff,7,0,20,13
1746553509413,SE 101B,A01,886816,Chadha; Mayank,4,0,35,31
1746553510439,SE 110B,A00,886818,Zhu; Qiang,4,0,75,71
1746553511469,SE 125,A01,886830,Staff,10,0,30,20
1746553512493,SE 130B,A01,886835,Staff,14,0,40,26
1746553513523,SE 131A,A01,886838,Krysl; Petr,34,0,55,21
1746553514548,SE 154,A00,886840,Staff,30,0,50,20
1746553515576,SE 164GS,A01,886849,Staff,6,0,20,14
1746553516601,SE 167GS,A01,886853,Staff,6,0,20,14
1746553517626,SIO 25,A01,890107,Staff,19,0,30,11
1746553518656,SIO 45,A00,890109,Cook; Geoffrey W,117,0,200,83
1746553519682,SIO 109R,A00,890110,Forman; Fonna,0,16,20,20
1746553520707,SIO 187,A01,890114,Kacev; David,15,0,40,25
1746553521735,SOCI 1,A01,890431,Thorpe; Charles Robert,15,0,30,15
1746553521735,SOCI 1,A02,890518,Thorpe; Charles Robert,30,0,30,0
1746553522759,SOCI 2,A01,957978,Staff,25,0,25,0
1746553522759,SOCI 2,A02,957979,Staff,23,0,25,2
1746553523786,SOCI 20,A01,890523,Calderon-Zaks; Michael Aar,23,0,30,7
1746553523786,SOCI 20,A02,890526,Calderon-Zaks; Michael Aar,29,0,30,1
1746553524810,SOCI 30,A01,890533,Pardo Guerra; Juan Pablo,37,0,40,3
1746553525834,SOCI 40,A01,890535,Staff,27,0,45,18
1746553526860,SOCI 104Q,A00,890559,Staff,18,0,30,12
1746553527886,SOCI 106,A00,890560,Arnal; Maud Marie Leonie,20,0,30,10
1746553528914,SOCI 110,A00,890567,Holkenbrink-Monk; Charlene,19,0,30,11
1746553529939,SOCI 112,A00,890568,Victoria Torres; Pablo,2,0,55,53
1746553530965,SOCI 115,A00,890597,Arnal; Maud Marie Leonie,28,0,45,17
1746553533019,SOCI 121,A00,890604,Pardo Guerra; Juan Pablo,38,0,45,7
1746553534045,SOCI 126,A01,890608,Staff,8,0,10,2
1746553535069,SOCI 127,A00,890609,Staff,18,0,30,12
1746553536097,SOCI 131,A00,890610,Thorpe; Charles Robert,37,0,45,8
1746553537122,SOCI 135,A00,890615,Payne; Christine Anna,14,0,45,31
1746553538146,SOCI 139,A00,890620,Staff,38,0,45,7
1746553539174,SOCI 148E,A00,890622,Calderon-Zaks; Michael Aar,36,0,45,9
1746553540198,SOCI 150,A00,890623,Kohler; Kristopher M.,31,0,45,14
1746553541226,SOCI 157,A00,890625,Jules-Rosette; Bennetta W.,18,0,20,2
1746553542251,SOCI 160,A00,890627,Payne; Christine Anna,21,0,45,24
1746553543279,SYN 1,A00,886855,Fish; Gwendolyn Anne,0,0,0,0
1746553543279,SYN 1,B00,906086,Fish; Gwendolyn Anne,0,1,0,2
1746553544303,SYN 2R,A00,886860,Staff,0,17,15,15
1746553544303,SYN 2R,B00,906106,Atkinson; Arthur Laird,0,16,15,15
1746553545335,SYN 100,A01,886866,Browne; Emily,0,28,20,20
1746553545335,SYN 100,B01,906128,Rock; Martin,0,5,20,20
1746553545335,SYN 100,C01,906140,Deavenport; James Cary,0,3,20,20
1746553545335,SYN 100,D01,907816,Deavenport; James Cary,0,5,20,20
1746553546364,TDAC 1,A00,890286,Walsh; Kim C.,9,0,20,11
1746553547391,TDAC 101,A00,890296,Basso; Beatrice,16,0,20,4
1746553548420,TDDE 131,A00,890297,Staff,47,0,50,3
1746553549445,TDDM 1,A00,890287,Weinberg; Sadie,25,0,30,5
1746553550469,TDGE 11,A00,890288,Fulton; Julia,137,0,200,63
1746553550469,TDGE 11,B00,890289,Castro; Robert Jess,184,0,200,16
1746553551498,TDGE 25,B00,957359,Walsh; Kim C.,3,0,20,17
1746553552524,TDGE 40,A01,890292,Power; Jade Yukana,27,0,30,3
1746553553551,TDGE 124,A00,890298,Havis; Allan,0,1,50,50
1746553554579,TDGE 131R,A00,890299,Burelle; Julie Sara Veronique,15,0,42,27
1746553555608,TDHT 101,A00,890300,Staff,10,0,20,10
1746553556636,TDHT 109,A01,890302,Anderson; Mysia Anyse,31,0,40,9
1746553557662,TDMV 1,A00,890293,Arcidiacono; Kristin,18,0,30,12
1746553558686,TDMV 2,A00,890294,Weinberg; Sadie,23,0,30,7
1746553559715,TDMV 3,A00,957878,Arcidiacono; Kristin,28,0,30,2
1746553561766,TDMV 138,A00,890304,Jun; Grace Shin Hae,25,0,40,15
1746553562795,TDMV 140,A00,890305,Corrales; Joseph Bernales,25,0,30,5
1746553563820,TDMV 142,A00,890307,Caligagan; Tony,32,0,40,8
1746553564844,TDMV 144,A00,890308,Camaya; Michelle Ann,25,0,30,5
1746553565872,TDPW 1,A00,890295,Stein; Deborah Isobel,3,0,20,17
1746553566898,USP 2,A01,890272,Lerner; Amy M,6,0,20,14
1746553567927,USP 3,A01,890274,Staff,12,0,30,18
1746553568956,USP 15,A01,890276,Sun; Feiyang,17,0,30,13
1746553569984,USP 25,A00,890277,Shenkman; Michael Thomas,19,0,25,6
1746553571007,USP 138,A00,890278,Staff,13,0,25,12
1746553572034,USP 143,A00,890279,Staff,21,0,70,49
1746553573063,USP 144,A00,890280,Chowdhury; Muhammed Zohir,16,0,30,14
1746553574091,USP 150,A00,890281,Boomhower; Matthew Charles,4,0,30,26
1746553575119,USP 151,A00,890282,Staff,16,0,20,4
1746553576149,USP 162,A00,890283,Andrews; Abigail Leslie,16,0,20,4
1746553577174,USP 168,A00,920477,Kwak; Nancy,1,0,5,4
1746553578213,USP 181,A00,890284,Staff,3,0,20,17
1746553579236,USP 191A,A00,890285,Staff,13,0,20,7
1746553580264,VIS 101,A00,886512,Staff,25,0,75,50
1746553581311,VIS 103,A00,886513,Cruz; Edwin Teddy,61,0,75,14
1746553582337,VIS 108,A00,886514,Staff,3,0,15,12
1746553583364,VIS 127P,A00,886515,Shen; Kuiyi,80,0,146,66
1746553584393,VIS 149,A00,886516,Yoldas; Pinar,0,0,15,15
1746553585420,VIS 164,A00,886526,Erdmann; Dean,19,0,22,3
1746553586444,VIS 194S,A00,886527,Staff,61,0,75,14
1746553587470,WCWP 10A,C00,886484,Martiniuk; Jill,12,0,15,3
1746553588499,WCWP 10B,A00,886490,Uriarte; Emma,0,0,15,15
1746553588499,WCWP 10B,B00,886491,Dhir; Simrita,10,0,15,5
1746553588499,WCWP 10B,C00,886492,Ornelas; Tricia,0,0,15,15
1746553589527,WCWP 100,A00,886494,Young; Mark T,0,6,15,15
1746553591634,AAS 10,A01,886199,Childs; Dennis R.,0,3,0,0
1746553592660,ANAR 104,A01,886940,Shtienberg; Gilad,27,0,30,3
1746553593687,ANAR 120,A00,886953,Staff,12,0,20,8
1746553594713,ANBI 148,A01,886955,Wilder; Linnea Lorene,30,0,40,10
1746553596760,ANSC 122,A00,886957,Staff,25,0,30,5
1746553597789,ANSC 150,A00,886958,Sloane; Julia Kathryn,2,0,15,13
1746553598812,ANSC 156,A00,886959,Jenkins; Janis A.,0,1,15,15
1746553599841,ANSC 180,A00,886960,Staff,11,0,17,6
1746553600869,ANSC 188,A00,886961,Jassal; Aftab,9,0,25,16
1746553601895,ANSC 190,A00,886962,Jassal; Aftab,14,0,25,11
1746553602923,ANSC 191,A00,886963,Staff,18,0,20,2
1746553603949,ANTH 3,A01,891689,Staff,17,0,20,3
1746553604977,ANTH 5,A00,886933,Semendeferi; Ekaterini,16,0,20,4
1746553606005,ANTH 10,A00,886934,Staff,0,12,30,30
1746553607033,ANTH 21,A01,886936,Staff,40,0,60,20
1746553608059,ANTH 23,A01,886938,Staff,92,0,100,8
1746553609087,ANTH 105,A00,886964,Stewart; Alexander B,84,0,100,16
1746553610110,ANTH 108,A00,886965,Pedersen; David,9,0,20,11
1746553611144,AWP 10,001,886147,Staff,0,0,0,0
1746553611144,AWP 10,002,886148,Staff,0,0,0,0
1746553611144,AWP 10,003,886149,Staff,0,0,0,0
1746553611144,AWP 10,004,886150,Staff,0,0,0,0
1746553611144,AWP 10,005,886151,Staff,0,0,0,0
1746553611144,AWP 10,006,886152,Staff,0,0,0,0
1746553611144,AWP 10,007,886153,Staff,0,0,0,0
1746553611144,AWP 10,008,886154,Staff,0,0,0,0
1746553611144,AWP 10,009,886155,Staff,0,0,0,0
1746553611144,AWP 10,010,886156,Staff,0,0,0,0
1746553611144,AWP 10,011,886158,Staff,0,0,0,0
1746553611144,AWP 10,012,886160,Staff,0,0,0,0
1746553611144,AWP 10,013,886161,Staff,0,0,0,0
1746553611144,AWP 10,014,886162,Staff,0,0,0,0
1746553611144,AWP 10,015,886163,Staff,0,0,0,0
1746553611144,AWP 10,016,886164,Staff,0,0,0,0
1746553611144,AWP 10,017,886165,Staff,0,0,0,0
1746553611144,AWP 10,018,886166,Staff,0,0,0,0
1746553611144,AWP 10,019,886168,Staff,0,0,0,0
1746553611144,AWP 10,020,886170,Staff,0,0,0,0
1746553611144,AWP 10,021,886172,Staff,0,0,0,0
1746553612176,AWP 10R,001,886173,Staff,0,1,0,0
1746553612176,AWP 10R,002,886174,Staff,0,1,0,0
1746553612176,AWP 10R,003,886175,Staff,0,0,0,0
1746553612176,AWP 10R,004,886176,Staff,0,0,0,0
1746553612176,AWP 10R,005,886177,Staff,0,0,0,0
1746553612176,AWP 10R,006,886178,Staff,0,0,0,0
1746553612176,AWP 10R,007,886179,Staff,0,0,0,0
1746553612176,AWP 10R,008,886181,Staff,0,0,0,0
1746553612176,AWP 10R,009,886182,Staff,0,0,0,0
1746553612176,AWP 10R,010,886183,Staff,0,0,0,0
1746553612176,AWP 10R,011,886184,Staff,0,0,0,0
1746553612176,AWP 10R,012,886185,Staff,0,0,0,0
1746553612176,AWP 10R,013,886186,Staff,0,0,0,0
1746553612176,AWP 10R,014,886187,Staff,0,0,0,0
1746553612176,AWP 10R,015,886188,Staff,0,0,0,0
1746553612176,AWP 10R,016,886189,Staff,0,0,0,0
1746553612176,AWP 10R,017,960532,Staff,0,0,0,0
1746553612176,AWP 10R,018,960533,Staff,0,0,0,0
1746553612176,AWP 10R,019,960534,Staff,0,0,0,0
1746553612176,AWP 10R,020,960538,Staff,0,0,0,0
1746553612176,AWP 10R,021,960540,Staff,0,0,0,0
1746553612176,AWP 10R,022,960541,Staff,0,0,0,0
1746553612176,AWP 10R,023,960542,Staff,0,0,0,0
1746553612176,AWP 10R,024,960544,Staff,0,0,0,0
1746553612176,AWP 10R,025,960545,Staff,0,0,0,0
1746553612176,AWP 10R,026,960548,Staff,0,0,0,0
1746553613203,AWP 102R,A00,886190,Staff,0,0,0,0
1746553613203,AWP 102R,B00,886191,Staff,0,0,0,0
1746553614230,BENG 100,A01,886193,Staff,17,0,30,13
1746553615257,BENG 122A,A01,886195,Hasty; Jeff M,13,0,30,17
1746553616320,BENG 166A,A00,886196,Sah; Robert Lie-Yuan,0,2,30,30
1746553617347,BENG 190,A00,958050,Khojah; Reem I,24,0,25,1
1746553618375,BIBC 102,A01,894320,Staff,0,0,46,46
1746553618375,BIBC 102,A02,894321,Staff,0,0,46,46
1746553618375,BIBC 102,A03,894344,Staff,7,0,46,39
1746553618375,BIBC 102,A04,894345,Staff,26,0,47,21
1746553619404,BICD 100R,A01,894365,Smith; Laurie,0,3,58,58
1746553619404,BICD 100R,A02,894366,Smith; Laurie,0,5,58,58
1746553619404,BICD 100R,A03,894367,Smith; Laurie,2,0,59,57
1746553619404,BICD 100R,A04,959869,Smith; Laurie,41,0,59,18
1746553620432,BICD 136,A01,894383,Gustafson-Brown; Cindy,14,0,50,36
1746553621457,BIEB 102,A01,894494,Butler; Shannon Rhey,51,0,130,79
1746553623510,BIEB 150,A01,894617,Wills; Christopher,3,0,20,17
1746553623510,BIEB 150,A02,894631,Wills; Christopher,3,0,20,17
1746553623510,BIEB 150,A03,894937,Wills; Christopher,3,0,20,17
1746553623510,BIEB 150,A04,894946,Wills; Christopher,5,0,20,15
1746553624534,BIEB 194,A00,906141,Kurle; Carolyn M.,6,0,20,14
1746553625559,BILD 1,A01,894154,Staff,2,0,19,17
1746553625559,BILD 1,A02,894155,Staff,14,0,19,5
1746553625559,BILD 1,A03,894160,Staff,13,0,19,6
1746553625559,BILD 1,A04,894161,Staff,15,0,18,3
1746553626584,BILD 2,A01,894168,Staff,0,0,50,50
1746553626584,BILD 2,A02,894169,Staff,0,0,50,50
1746553626584,BILD 2,A03,894179,Staff,3,0,50,47
1746553626584,BILD 2,A04,894203,Staff,27,0,50,23
1746553627611,BILD 3,A01,894213,Staff,22,0,31,9
1746553627611,BILD 3,A02,894214,Staff,26,0,31,5
1746553627611,BILD 3,A03,894235,Staff,28,0,31,3
1746553627611,BILD 3,A04,894236,Staff,28,0,32,4
1746553628637,BILD 4,A01,894253,Reuther; Keefe,5,0,24,19
1746553628637,BILD 4,A02,894258,Reuther; Keefe,16,0,24,8
1746553629662,BILD 5,A01,894276,Reuther; Keefe,35,0,50,15
1746553629662,BILD 5,A02,894277,Reuther; Keefe,45,0,50,5
1746553629662,BILD 5,A03,894290,Reuther; Keefe,44,0,50,6
1746553629662,BILD 5,A04,894291,Reuther; Keefe,48,0,50,2
1746553630691,BILD 24,A01,894297,Pirino; Giorgia,40,0,60,20
1746553631716,BIMM 100,B01,958915,Staff,72,0,100,28
1746553632745,BIMM 101,A01,895017,McDonnell; Lisa Marie,0,5,24,24
1746553632745,BIMM 101,A02,895018,McDonnell; Lisa Marie,0,5,24,24
1746553632745,BIMM 101,B01,895020,McDonnell; Lisa Marie,0,6,24,24
1746553632745,BIMM 101,B02,895021,McDonnell; Lisa Marie,0,4,24,24
1746553633770,BIMM 110,A01,895023,Staff,1,0,25,24
1746553633770,BIMM 110,A02,895024,Staff,9,0,25,16
1746553633770,BIMM 110,A03,895025,Staff,18,0,25,7
1746553633770,BIMM 110,A04,895031,Staff,20,0,25,5
1746553634795,BIMM 120,A01,895114,Gustafson-Brown; Cindy,14,0,28,14
1746553634795,BIMM 120,A02,895126,Gustafson-Brown; Cindy,21,0,27,6
1746553635823,BIPN 100,A01,895130,Yang; Mingyu,1,0,38,37
1746553635823,BIPN 100,A02,895131,Yang; Mingyu,32,0,38,6
1746553635823,BIPN 100,A03,895132,Yang; Mingyu,32,0,38,6
1746553635823,BIPN 100,A04,895133,Yang; Mingyu,27,0,36,9
1746553636848,BIPN 120,A01,895135,Cooke; James Edward,0,3,13,13
1746553636848,BIPN 120,A02,895136,Cooke; James Edward,0,1,13,13
1746553636848,BIPN 120,A03,895137,Cooke; James Edward,0,3,13,13
1746553636848,BIPN 120,A04,895156,Cooke; James Edward,0,2,11,11
1746553637873,BIPN 134,A01,895235,Cooke; James Edward,0,2,25,25
1746553637873,BIPN 134,A02,895237,Cooke; James Edward,0,0,25,25
1746553637873,BIPN 134,A03,895240,Cooke; James Edward,3,0,25,22
1746553637873,BIPN 134,A04,895270,Cooke; James Edward,20,0,25,5
1746553638896,BIPN 189,A00,892103,Staff,0,13,14,14
1746553640950,BISP 194,A00,958008,Staff,0,2,0,0
1746553641974,CAT 124,A01,922009,Staff,0,5,20,20
1746553643004,CAT 125R,A00,886390,Morales; Celeste Georgianna,0,2,20,20
1746553643004,CAT 125R,B00,886391,Irwin; Matthew Joseph,0,3,20,20
1746553643004,CAT 125R,C00,886392,Smith; Lauryn Alissa,0,2,20,20
1746553643004,CAT 125R,D00,886393,Vanderschuit; Maya Alysia,0,2,20,20
1746553643004,CAT 125R,E00,886394,Marchisotto; Jennifer Anne,0,4,20,20
1746553644029,CENG 15,A01,886218,Drews; Aaron,3,0,8,5
1746553645056,CENG 113,A00,886219,Opatkiewicz; Justin Paul,15,0,25,10
1746553646082,CGS 101,A00,887044,Staff,7,0,20,13
1746553647105,CGS 105,A01,887046,Staff,14,0,25,11
1746553648134,CGS 112,A00,887047,Cuong; Marisol,12,0,15,3
1746553649159,CGS 113,A00,887048,Staff,23,0,30,7
1746553650186,CGS 120,A00,887049,Staff,10,0,17,7
1746553651213,CHEM 6A,A01,886336,Lam; Tin Yiu,38,0,50,12
1746553651213,CHEM 6A,A02,886338,Lam; Tin Yiu,37,0,50,13
1746553652237,CHEM 6B,A01,886341,Hopkins; Patrycja Anna,16,0,50,34
1746553652237,CHEM 6B,A02,886343,Hopkins; Patrycja Anna,42,0,50,8
1746553653266,CHEM 6C,A01,886346,Albizati; Kim F.,0,2,50,50
1746553653266,CHEM 6C,A02,886348,Albizati; Kim F.,23,0,50,27
1746553654290,CHEM 40A,A01,886352,Klosterman; Jeremy K,65,0,100,35
1746553655315,CHEM 40B,A01,886356,Klosterman; Jeremy K,0,23,100,100
1746553656342,CHEM 41B,A01,886360,Theodorakis; Emmanuel,25,0,50,25
1746553656342,CHEM 41B,A02,886362,Theodorakis; Emmanuel,47,0,50,3
1746553657369,CHIN 165A,A00,886382,Xu; Li,18,0,20,2
1746553658395,CLAS 120,A00,886387,Myerston Santana; Jacobo,33,0,40,7
1746553659498,COGS 9,A01,886967,Shannon; Kyle Michael,42,0,60,18
1746553660526,COGS 11,A01,886969,Staff,11,0,30,19
1746553661556,COGS 14A,A01,886971,Staff,6,0,60,54
1746553662582,COGS 14B,A01,886973,Hoffman; Drew Ellen,4,0,60,56
1746553663606,COGS 18,A01,886975,Morgan; Eric,35,0,60,25
1746553664632,COGS 20,A01,886977,Staff,4,0,8,4
1746553664632,COGS 20,A02,886978,Staff,5,0,7,2
1746553665657,COGS 100,A01,907783,Staff,0,2,30,30
1746553666681,COGS 101B,A01,886980,Staff,0,3,48,48
1746553667709,COGS 101C,A01,886982,Delgado; Tania,0,5,44,44
1746553668736,COGS 102A,A01,886984,Johnson; Christine M.,4,0,30,26
1746553669763,COGS 118B,A01,886986,Staff,0,3,88,88
1746553670791,COGS 150,A01,886988,Bergen; Benjamin,23,0,50,27
1746553671816,COGS 153,A00,886989,Delgado; Tania,0,2,41,41
1746553672841,COGS 186,A01,886991,Staff,0,0,32,32
1746553673867,COGS 187A,A01,886993,Boyle; Mary E. T.,7,0,30,23
1746553674893,COGS 189,A00,886994,Staff,0,1,30,30
1746553675918,COMM 10,A01,886996,Staff,0,0,20,21
1746553675918,COMM 10,A02,886997,Staff,12,0,20,8
1746553675918,COMM 10,A03,959845,Staff,19,0,20,1
1746553676942,COMM 20,A01,886999,Leuning; Grant Maurstad,24,0,40,16
1746553678996,COMM 100A,A01,887002,Staff,0,0,20,25
1746553678996,COMM 100A,A02,887003,Staff,7,0,20,13
1746553680021,COMM 100B,A01,887005,Staff,0,8,20,24
1746553681045,COMM 106D,A00,887006,Staff,14,0,40,26
1746553682070,COMM 110G,A00,887007,Whitworth-Smith; Andrew C,12,0,40,28
1746553683096,COMM 111B,A00,887008,Staff,31,0,40,9
1746553684121,COMM 113T,A00,887009,Abuelhiga; Soraya Jill,28,0,40,12
1746553684121,COMM 113T,B00,906733,Staff,40,0,40,0
1746553685145,COMM 145,A00,887010,Staff,12,0,40,28
1746553686170,COMM 146,A00,887054,Staff,31,0,40,9
1746553687204,COMM 190,A00,887012,Staff,8,0,23,15
1746553688231,CSE 8A,A50,887015,Cao; Yingjun,57,0,85,28
1746553689257,CSE 11,A01,887017,Cao; Yingjun,12,0,70,58
1746553690281,CSE 20,A01,887019,Staff,30,0,50,20
1746553691307,CSE 21,A01,887021,Staff,78,0,100,22
1746553691307,CSE 21,B01,892583,Braun; Oliver,45,0,50,5
1746553692334,CSE 30,A01,887025,Eldon; John,143,0,200,57
1746553693360,CSE 100,A01,887027,Staff,25,0,50,25
1746553693360,CSE 100,A02,887028,Staff,41,0,50,9
1746553694386,CSE 101,A01,887030,Braun; Oliver,75,0,100,25
1746553694386,CSE 101,B01,887032,Jones; Miles E,0,3,50,50
1746553694386,CSE 101,B02,887033,Jones; Miles E,0,1,50,50
1746553695415,CSE 105,A01,908084,Jones; Miles E,32,0,50,18
1746553695415,CSE 105,A02,908087,Jones; Miles E,32,0,50,18
1746553696442,CSE 135,A01,887035,Powell; Thomas Allan,0,4,50,50
1746553697468,CSE 142,A01,887037,Staff,8,0,60,52
1746553698496,CSE 142L,A01,887039,Staff,34,0,60,26
1746553699524,CSE 151A,A01,887041,Solares; Edwin A,47,0,100,53
1746553700547,CSE 175,A01,887043,Kumar; Rakesh,30,0,30,0
1746553701576,CSS 1,A01,886389,Staff,0,1,40,40
1746553702606,DSC 30,A01,908097,Liao; Soohyun Nam,47,0,75,28
1746553703634,DSC 40A,A01,908099,Shannon; Kyle Michael,30,0,50,20
1746553704659,DSC 40B,A01,908112,Staff,16,0,50,34
1746553705688,DSC 80,A01,908116,Staff,19,0,60,41
1746553706715,DSC 197,001,956863,Eldridge; Justin Matthew,9999,0,9999,0
1746553707810,ECE 5,A01,886400,Morris; Karcher William,2,0,6,4
1746553707810,ECE 5,A02,886401,Morris; Karcher William,3,0,6,3
1746553708837,ECE 148,A01,886403,Silberman; Jack,0,14,14,14
1746553709862,ECON 1,A01,887265,Crane; Meredith Helen,12,0,70,58
1746553709862,ECON 1,B01,887268,Staff,43,0,50,7
1746553710886,ECON 2,A01,887273,Crane; Meredith Helen,56,0,70,14
1746553711915,ECON 3,A01,887279,Rondina; Giacomo,32,0,70,38
1746553712943,ECON 4,A01,887282,Anderson; John Charles,0,2,10,10
1746553713969,ECON 5,A01,887285,Staff,33,0,45,12
1746553713969,ECON 5,B01,887292,Staff,41,0,45,4
1746553714997,ECON 100A,A01,887337,Newhouse; Herbert S,54,0,70,16
1746553714997,ECON 100A,B01,887349,Staff,45,0,50,5
1746553716023,ECON 100B,A01,887361,Du; Songzi,29,0,70,41
1746553717051,ECON 100C,A01,887445,Newhouse; Herbert S,59,0,70,11
1746553718077,ECON 105,A00,887488,Vespa; Emanuel Ignacio,23,0,35,12
1746553719107,ECON 109,A01,887506,Shishkin; Denis,28,0,35,7
1746553720137,ECON 110A,A01,887568,Alon; Titan Michael,0,3,35,35
1746553720137,ECON 110A,B01,907601,Alon; Titan Michael,20,0,35,15
1746553721161,ECON 110B,A01,887598,Levkoff; Steven B.,0,23,70,70
1746553722187,ECON 112,A00,887599,Rondina; Giacomo,19,0,35,16
1746553723211,ECON 120A,A01,887603,Dai; Yinlin,36,0,70,34
1746553724242,ECON 120C,A01,887608,Sun; Yixiao,0,1,35,35
1746553724242,ECON 120C,B01,887614,Sun; Yixiao,0,0,35,35
1746553725271,ECON 138,A00,887621,Bharadwaj; Prashant,0,21,20,20
1746553726297,ECON 144,A00,958007,Squires; Dale E,13,0,35,22
1746553727328,ECON 171,A01,907666,Staff,18,0,35,17
1746553728358,ECON 175,A00,887626,Wu; Pak Yeung,23,0,35,12
1746553729384,ECON 190,A00,887640,Vespa; Emanuel Ignacio,23,0,35,12
1746553730412,EDS 25,A01,888197,Staff,0,0,0,0
1746553730412,EDS 25,A02,888209,Staff,0,0,0,0
1746553730412,EDS 25,A03,888210,Staff,0,0,0,0
1746553730412,EDS 25,A04,888212,Staff,0,0,0,0
1746553730412,EDS 25,A05,888213,Staff,0,0,0,0
1746553730412,EDS 25,A06,888214,Staff,0,0,0,0
1746553730412,EDS 25,A07,888235,Staff,0,2,0,0
1746553730412,EDS 25,A08,888236,Staff,0,0,0,0
1746553730412,EDS 25,A09,888240,Staff,0,0,0,0
1746553730412,EDS 25,A10,888244,Staff,0,0,0,0
1746553730412,EDS 25,B01,888273,Staff,0,0,0,0
1746553730412,EDS 25,B02,888285,Staff,0,0,0,0
1746553730412,EDS 25,B03,888423,Staff,0,0,0,1
1746553730412,EDS 25,B04,888432,Staff,0,0,0,0
1746553730412,EDS 25,B05,888433,Staff,0,0,0,0
1746553730412,EDS 25,B06,888467,Staff,0,0,0,0
1746553730412,EDS 25,B07,888468,Staff,0,0,0,0
1746553730412,EDS 25,B08,888479,Staff,0,0,0,0
1746553730412,EDS 25,B09,888484,Staff,0,0,0,0
1746553730412,EDS 25,B10,888487,Staff,0,0,0,0
1746553731440,EDS 38,A01,907700,Choi; Bailey Miyeon,30,0,30,0
1746553732465,EDS 112,A01,888601,Chapman; Thandeka K,14,0,40,26
1746553733493,EDS 115,A00,888697,Mendez; Kathrina Mendoza,10,0,30,20
1746553734519,EDS 116,A01,888893,Staff,35,0,40,5
1746553736575,EDS 124AR,A00,889133,Staff,29,0,50,21
1746553736575,EDS 124AR,B00,907471,Simon; Elizabeth A,37,0,50,13
1746553737604,EDS 124BR,A00,889134,Simon; Elizabeth A,45,0,100,55
1746553738630,EDS 125,A00,889135,Staff,25,0,30,5
1746553739656,EDS 126,A01,889138,Staff,36,0,40,4
1746553740682,EDS 164R,A01,889142,Wishard Guerra; Alison G.,33,0,50,17
1746553741709,ENG 30,A01,886396,Staff,0,0,0,0
1746553741709,ENG 30,B01,886398,Staff,0,0,0,0
1746553742733,ENVR 102,A00,906150,Montejo; Carolina,23,0,25,2
1746553743759,ETHN 103A,A00,887236,Man; Simeon S,0,3,0,0
1746553744785,ETHN 113,A00,887239,Staff,16,0,30,14
1746553745810,ETHN 116,A00,887240,Staff,16,0,25,9
1746553746835,ETHN 117,A00,887241,Choi; Esther Min,28,0,30,2
1746553747864,ETHN 118,A00,887243,Staff,24,0,30,6
1746553748891,ETHN 127,A00,887248,Cuong; Marisol,11,0,15,4
1746553749915,ETHN 139,A00,887250,Staff,7,0,10,3
1746553750945,ETHN 142,A00,887252,Staff,10,0,30,20
1746553751970,ETHN 161,A00,887253,Browne; Errol Tsekani,24,0,30,6
1746553752998,ETHN 163FR,A00,887255,Burelle; Julie Sara Veronique,0,0,5,5
1746553754026,GLBH 20,A00,889149,Elwardani; Nile Regina,8,0,42,34
1746553756078,GLBH 111,A01,889152,Burgos; Jose L.,17,0,17,0
1746553757104,GLBH 150,A00,889181,Sloane; Julia Kathryn,0,5,15,15
1746553759154,HDS 60,A01,886406,Warstadt; Melissa Fawn,73,0,80,7
1746553760180,HIAF 111,A00,889324,Gyamfi; Bright,25,0,32,7
1746553761204,HIEA 131,A00,889328,Staff,16,0,32,16
1746553762228,HIEA 144,A00,889333,Henry; Todd A.,26,0,32,6
1746553763253,HIEA 154,A00,889336,Henry; Todd A.,24,0,32,8
1746553764280,HIEU 106,A00,889339,Staff,22,0,32,10
1746553766328,HIEU 114,A00,889340,Staff,3,0,32,29
1746553767352,HIEU 135GS,A00,889342,Patterson; Patrick H.,0,0,1,24
1746553768377,HIEU 137,A00,889343,Edington; Claire Ellen,9,0,25,16
1746553769401,HIEU 148,A00,889345,Staff,14,0,32,18
1746553770425,HIEU 154,A00,889346,Biess; Frank Peter,21,0,32,11
1746553771449,HILA 102,A00,889351,Staff,12,0,32,20
1746553772475,HILD 2A,A01,889221,Lewandoski; Julia Mavis,1,10,32,31
1746553773503,HILD 7B,A01,889225,Man; Simeon S,0,13,32,32
1746553774530,HILD 7C,A01,889288,Alvarez; Luis A,0,14,32,32
1746553775553,HILD 30,A01,889323,Staff,0,5,32,32
1746553777606,HISC 119,A00,889383,Golan; Tal,20,0,32,12
1746553778631,HIUS 103,A00,889384,Man; Simeon S,0,0,32,32
1746553779658,HIUS 117,A00,919797,Kwak; Nancy,18,0,32,14
1746553780685,HIUS 142A,A00,919788,Staff,22,0,32,10
1746553782733,HIUS 149,A00,889386,Gyamfi; Bright,27,0,32,5
1746553783761,HIUS 155,A00,889387,Alvarez; Luis A,14,0,32,18
1746553784786,HUM 3,A01,886499,Caldwell; Michael Alan,19,0,50,31
1746553785812,HUM 3GS,A00,886500,Rodriguez; Bretton Sigfred,0,0,0,28
1746553786838,HUM 3R,A01,886502,Markman; Kristina,0,36,50,50
1746553787867,HUM 4,A01,886504,Crum; Matthew Stephen,24,0,50,26
1746553787867,HUM 4,B01,886506,West; Geoffrey Scott,17,0,50,33
1746553788892,HUM 4GS,A00,886507,Staff,0,0,0,19
1746553789920,HUM 5,A01,886509,Staff,32,0,50,18
1746553790947,HUM 5R,A01,886511,Zavodny; Tatiana Sophia,0,39,50,50
1746553791974,JAPN 180,A00,886407,Staff,17,0,40,23
1746553793001,LATI 50,A01,886409,Martin-Cabrera; Luis,4,0,22,18
1746553793001,LATI 50,A02,886410,Martin-Cabrera; Luis,19,0,22,3
1746553793001,LATI 50,A03,886411,Martin-Cabrera; Luis,21,0,22,1
1746553793001,LATI 50,A04,886412,Martin-Cabrera; Luis,9,0,22,13
1746553794030,LAWS 101,A00,907664,Staff,28,0,60,32
1746553795054,LIAB 1A,A00,889388,Saab; Dima,17,0,20,3
1746553796081,LIAB 1AX,A00,889389,El Cheddadi; Youniss,17,0,20,3
1746553797107,LIFR 1C,A00,889391,Van Moer; Vinciane G,8,0,20,12
1746553798135,LIFR 1CX,A00,889392,Van Moer; Vinciane G,7,0,20,13
1746553799160,LIFR 1D,A00,889393,Van Moer; Vinciane G,7,0,20,13
1746553800189,LIFR 1DX,A00,889394,Van Moer; Vinciane G,8,0,20,12
1746553801214,LIGN 7,A00,886923,Staff,24,0,50,26
1746553802240,LIGN 17,A00,886924,Kehler; Andrew Scott,125,0,150,25
1746553803265,LTAM 110,A00,889395,Staff,15,0,30,15
1746553804289,LTAM 110GS,A00,958010,Rodriguez; Bretton Sigfred,0,0,0,28
1746553805317,LTCH 101,A00,889397,Staff,23,0,25,2
1746553806344,LTCS 130,A00,889398,Staff,23,0,25,2
1746553807368,LTEA 138,A00,889399,Staff,24,0,40,16
1746553808392,LTEN 149,A00,889400,Wesling; Megan E.,0,3,25,25
1746553809418,LTEN 169,A00,889401,Staff,20,0,25,5
1746553810444,LTEN 180,A00,889402,Staff,10,0,15,5
1746553811469,LTEN 181,A00,889403,Staff,21,0,25,4
1746553812495,LTWL 100,A00,889404,Myerston Santana; Jacobo,3,0,25,22
1746553813521,LTWL 180GS,A00,889405,Staff,0,0,20,20
1746553814550,LTWL 181,A00,889406,Staff,17,0,25,8
1746553815576,LTWL 184,A00,889475,Mukherjee; Silpa,22,0,25,3
1746553816599,LTWR 102C,A00,889486,Staff,29,0,30,1
1746553817627,LTWR 115W,A00,889491,Staff,0,2,15,15
1746553818651,MAE 8,A01,886905,Staff,0,2,0,0
1746553819677,MAE 11,A00,886906,Bandaru; Prabhakar,0,7,50,50
1746553820705,MAE 20,A00,886907,Evdokimenko; Ekaterina,43,0,70,27
1746553821732,MAE 30B,A00,886909,Ghazinejad; Maziar,26,0,45,19
1746553822762,MAE 101B,A00,886910,Saintillan; David,29,0,45,16
1746553823786,MAE 105,A00,886911,Bandaru; Prabhakar,18,0,50,32
1746553824811,MAE 107,B00,958024,Staff,8,0,50,42
1746553825838,MAE 143B,A00,886913,Bewley; Thomas R,7,0,40,33
1746553826869,MAE 148,A01,886915,Silberman; Jack,0,3,14,14
1746553827893,MAE 160,A00,886916,Evdokimenko; Ekaterina,31,0,60,29
1746553828922,MATH 3C,A01,889681,Staff,0,3,30,30
1746553828922,MATH 3C,A02,960048,Staff,25,0,30,5
1746553829946,MATH 10A,A01,889760,Staff,26,0,30,4
1746553829946,MATH 10A,A02,889783,Staff,29,0,30,1
1746553830974,MATH 10B,A01,889785,Verstraete; Jacques Allan,2,0,35,33
1746553830974,MATH 10B,A02,889795,Verstraete; Jacques Allan,4,0,35,31
1746553830974,MATH 10B,B01,889797,Verstraete; Jacques Allan,3,0,35,32
1746553830974,MATH 10B,B02,889828,Verstraete; Jacques Allan,3,0,35,32
1746553832006,MATH 10C,A01,889849,Habib; Yousaf,8,0,30,22
1746553832006,MATH 10C,A02,889852,Habib; Yousaf,14,0,30,16
1746553832006,MATH 10C,A03,889853,Habib; Yousaf,22,0,30,8
1746553832006,MATH 10C,A04,889858,Habib; Yousaf,20,0,30,10
1746553832006,MATH 10C,B01,889861,Staff,1,0,30,29
1746553832006,MATH 10C,B02,889862,Staff,24,0,30,6
1746553832006,MATH 10C,B03,889863,Staff,27,0,30,3
1746553832006,MATH 10C,B04,889967,Staff,23,0,30,7
1746553833034,MATH 18,A01,889974,Staff,7,0,30,23
1746553833034,MATH 18,A02,889977,Staff,20,0,30,10
1746553833034,MATH 18,B01,889984,Hardiman; Liam,22,0,30,8
1746553833034,MATH 18,B02,889985,Hardiman; Liam,25,0,30,5
1746553834059,MATH 20A,A01,889990,Suk; Andrew Hoon,30,0,35,5
1746553835085,MATH 20B,A01,889993,Ohm; Ko Woon,22,0,30,8
1746553835085,MATH 20B,A02,889994,Ohm; Ko Woon,30,0,30,0
1746553835085,MATH 20B,B01,889996,Ohm; Ko Woon,21,0,30,9
1746553835085,MATH 20B,B02,889997,Ohm; Ko Woon,23,0,30,7
1746553836113,MATH 20C,A01,889999,Hammock; Frances H,17,0,30,13
1746553836113,MATH 20C,A02,890003,Hammock; Frances H,23,0,30,7
1746553836113,MATH 20C,B01,890006,Hammock; Frances H,3,0,30,27
1746553836113,MATH 20C,B02,890007,Hammock; Frances H,11,0,30,19
1746553837143,MATH 20D,A01,890011,Cheng; Hsiao-Bing,1,1,30,29
1746553837143,MATH 20D,A02,890012,Cheng; Hsiao-Bing,14,0,30,16
1746553837143,MATH 20D,B01,890016,Cheng; Hsiao-Bing,13,0,30,17
1746553837143,MATH 20D,B02,890017,Cheng; Hsiao-Bing,13,0,30,17
1746553838168,MATH 20E,A01,890026,Harel; Guershon,1,0,30,29
1746553838168,MATH 20E,A02,890029,Harel; Guershon,23,0,30,7
1746553838168,MATH 20E,B01,890033,Harel; Guershon,7,0,30,23
1746553838168,MATH 20E,B02,890101,Harel; Guershon,21,0,30,9
1746553839194,MATH 102,A01,890104,Staff,17,0,30,13
1746553839194,MATH 102,A02,890105,Staff,27,0,30,3
1746553840218,MATH 103B,A01,890116,Salehi Golsefidy; Alireza,3,0,30,27
1746553840218,MATH 103B,B01,890118,Staff,0,3,34,34
1746553841247,MATH 109,A01,890121,Aliabadi Sr.; Mohsen,1,0,30,29
1746553841247,MATH 109,B01,890124,Upadrashta; Pranav Kumar,18,0,30,12
1746553842271,MATH 120A,A01,890126,Eggers; John Dietrich,13,0,30,17
1746553843303,MATH 142B,A01,890128,Ioana; Adrian,19,0,30,11
1746553843303,MATH 142B,A02,890129,Ioana; Adrian,13,0,30,17
1746553844335,MATH 154,A01,890174,Staff,0,0,30,30
1746553844335,MATH 154,A02,890182,Staff,0,0,30,30
1746553845364,MATH 168A,A01,890197,Dumitriu; Ioana,21,0,35,14
1746553846390,MATH 170A,A01,890240,Nie; Jiawang,1,0,30,29
1746553846390,MATH 170A,A02,890241,Nie; Jiawang,11,0,30,19
1746553846390,MATH 170A,A03,890249,Nie; Jiawang,23,0,30,7
1746553847415,MATH 170B,A01,957891,Nag; Panchali,13,0,35,22
1746553849469,MATH 181A,A01,908025,Staff,0,4,35,35
1746553849469,MATH 181A,A02,960115,Staff,27,0,35,8
1746553850494,MATH 181B,A01,959874,Staff,25,0,30,5
1746553851520,MATH 193B,A01,890265,Staff,0,4,35,35
1746553852545,MGT 4,A01,890311,Anderson; John Charles,42,0,88,46
1746553853575,MGT 5,A00,907740,Staff,13,0,98,85
1746553854601,MGT 12,A00,890312,Lindenberger; Wade Douglas,67,0,98,31
1746553855628,MGT 16,A00,957883,Staff,78,0,98,20
1746553857681,MGT 45,A00,890314,Pecore; Joseph P.,47,0,98,51
1746553858705,MGT 71,A00,890315,Staff,0,11,98,98
1746553859734,MGT 100,A00,890316,Yavorsky; Daniel Ryan,44,0,98,54
1746553860760,MGT 103,A00,890317,Ehrich; Kristine R,73,0,98,25
1746553861784,MGT 105,A00,890356,Bates; Kenneth Walter,0,7,98,98
1746553862812,MGT 112,A00,890360,Ehrich; Kristine R,55,0,98,43
1746553863837,MGT 127R,A00,907732,Zhu; Kevin Xiaoguo,24,0,98,74
1746553864863,MGT 131B,A00,890361,Anderson; John Charles,61,0,98,37
1746553865888,MGT 137,A00,890362,Lindenberger; Wade Douglas,65,0,98,33
1746553866914,MGT 160,A00,890369,Johnson; Erik Barry,9,0,98,89
1746553868964,MGT 164,A00,890372,Zimmermann; Carsten,0,39,98,98
1746553869989,MGT 180,A00,890374,Bliss; Barbara Ann,12,0,98,86
1746553871017,MMW 15,A01,886414,Chang; Edmond Yi-Teh,0,12,28,28
1746553871017,MMW 15,A02,886415,Chang; Edmond Yi-Teh,0,8,28,28
1746553871017,MMW 15,A03,886416,Chang; Edmond Yi-Teh,0,8,28,28
1746553871017,MMW 15,A04,886417,Chang; Edmond Yi-Teh,0,8,28,28
1746553871017,MMW 15,B01,886419,Chang; Edmond Yi-Teh,0,7,28,28
1746553871017,MMW 15,B02,886420,Chang; Edmond Yi-Teh,0,8,28,28
1746553871017,MMW 15,B03,886421,Chang; Edmond Yi-Teh,0,7,28,28
1746553871017,MMW 15,B04,886422,Chang; Edmond Yi-Teh,0,8,28,28
1746553871017,MMW 15,C01,886424,Staff,0,9,28,28
1746553871017,MMW 15,C02,886425,Staff,0,8,28,28
1746553871017,MMW 15,C03,886426,Staff,0,8,28,28
1746553871017,MMW 15,C04,886427,Staff,0,8,28,28
1746553871017,MMW 15,C05,958038,Staff,0,7,28,28
1746553871017,MMW 15,C06,958039,Staff,0,8,28,28
1746553872044,MMW 15GS,A00,906910,Patterson; Patrick H.,4,0,28,24
1746553873072,MMW 122R,A01,886429,Rahimi; Babak,0,13,28,28
1746553873072,MMW 122R,A02,886430,Rahimi; Babak,0,12,28,28
1746553873072,MMW 122R,A03,958040,Rahimi; Babak,0,11,28,28
1746553874102,MUS 1A,A01,890937,Staff,2,0,25,23
1746553874102,MUS 1A,A02,891035,Staff,6,0,25,19
1746553874102,MUS 1A,C01,958912,Staff,24,0,25,1
1746553874102,MUS 1A,C02,958913,Staff,25,0,25,0
1746553876153,MUS 2AK,A00,957092,Ohnishi; Takae,15,0,15,0
1746553877181,MUS 4,A01,891044,Staff,2,0,25,23
1746553877181,MUS 4,A02,891045,Staff,23,0,25,2
1746553877181,MUS 4,B01,891048,Staff,17,0,25,8
1746553877181,MUS 4,B02,891050,Staff,25,0,25,0
1746553878209,MUS 5,A01,957506,Dubnov; Shlomo,0,0,25,25
1746553878209,MUS 5,A02,957622,Dubnov; Shlomo,13,0,25,12
1746553878209,MUS 5,A03,957623,Dubnov; Shlomo,20,0,25,5
1746553879232,MUS 6,A01,891053,Freitas Caetano; Marcelo,24,0,25,1
1746553879232,MUS 6,A02,891054,Freitas Caetano; Marcelo,23,0,25,2
1746553880259,MUS 7,A01,891081,Staff,0,0,25,25
1746553880259,MUS 7,A02,891082,Staff,4,0,25,21
1746553881283,MUS 8GS,A00,891118,Borgo; David Garcia,0,0,25,25
1746553882347,MUS 11,A01,891140,Staff,11,0,25,14
1746553882347,MUS 11,A02,891141,Staff,22,0,25,3
1746553883373,MUS 13,A01,891143,Staff,8,0,25,17
1746553883373,MUS 13,A02,891144,Staff,24,0,25,1
1746553884398,MUS 15,A01,891146,Staff,9,0,25,16
1746553884398,MUS 15,A02,891148,Staff,21,0,25,4
1746553884398,MUS 15,B01,891150,Staff,18,0,25,7
1746553884398,MUS 15,B02,891151,Staff,25,0,25,0
1746553885422,MUS 20,A01,891153,Staff,5,0,20,15
1746553885422,MUS 20,A02,891155,Staff,14,0,20,6
1746553886450,MUS 80,A00,891156,Staff,19,0,25,6
1746553886450,MUS 80,B00,891157,Staff,23,0,25,2
1746553887475,MUS 130,A00,891158,Ohnishi; Takae,35,0,35,0
1746553888499,MUS 150GS,A01,891160,Borgo; David Garcia,0,0,25,25
1746553889524,MUS 170,A01,891162,Freitas Caetano; Marcelo,20,0,25,5
1746553889524,MUS 170,A02,891164,Freitas Caetano; Marcelo,21,0,25,4
1746553890552,NANO 11,A00,886220,Vazquez Mena; Oscar,13,0,15,2
1746553891581,NANO 15,A01,886222,Drews; Aaron,4,0,7,3
1746553892607,NANO 104,A00,886224,Sirbuly; Donald,18,0,25,7
1746553893631,PH 40,A00,886528,Staff,23,0,40,17
1746553894659,PH 45,A01,886799,Staff,35,0,40,5
1746553895683,PH 110,A00,886802,Staff,0,7,40,40
1746553896708,PH 172,A00,906716,Staff,19,0,35,16
1746553897737,PH 191,A00,886803,Staff,6,0,40,34
1746553898761,PHIL 1,A00,889500,Staff,19,0,30,11
1746553899788,PHIL 10,A01,889549,Grush; Rick Scott,15,0,22,7
1746553899788,PHIL 10,A02,889551,Grush; Rick Scott,22,0,22,0
1746553900815,PHIL 28,A01,889559,Lamey; Andy M.,0,1,31,31
1746553900815,PHIL 28,A02,889561,Lamey; Andy M.,0,1,30,30
1746553900815,PHIL 28,A03,889572,Lamey; Andy M.,0,1,30,30
1746553901840,PHIL 35,A00,907839,Staff,13,0,15,2
1746553902864,PHIL 60,A00,889574,Staff,74,0,90,16
1746553903891,PHIL 101,A00,958004,Staff,13,0,15,2
1746553905943,PHIL 136,A00,889582,Fulkerson; Matthew Todd,26,0,45,19
1746553906973,PHIL 163,A01,889601,Staff,21,0,30,9
1746553906973,PHIL 163,B01,889606,Brandt; Reuven A,0,3,0,0
1746553907998,PHIL 164,A00,889610,Staff,16,0,30,14
1746553909025,PHIL 165,A00,889613,Staff,23,0,30,7
1746553910048,PHYS 1A,A00,886431,Staff,26,0,70,44
1746553911075,PHYS 1AL,001,886432,Tsai; Philbert S,0,2,30,30
1746553911075,PHYS 1AL,002,886436,Tsai; Philbert S,11,0,30,19
1746553912102,PHYS 1B,A00,886439,Staff,185,0,240,55
1746553913126,PHYS 1BL,001,886441,Tsai; Philbert S,0,4,30,30
1746553913126,PHYS 1BL,002,886444,Tsai; Philbert S,2,0,30,28
1746553914151,PHYS 1C,A00,896092,Arnold; Kam S,78,0,146,68
1746553915176,PHYS 1CL,001,886448,Tsai; Philbert S,0,0,30,30
1746553915176,PHYS 1CL,002,886449,Tsai; Philbert S,0,0,30,30
1746553915176,PHYS 1CL,003,886450,Tsai; Philbert S,16,0,30,14
1746553915176,PHYS 1CL,004,886451,Tsai; Philbert S,15,0,30,15
1746553916205,PHYS 2B,A01,886457,Staff,69,0,115,46
1746553917234,PHYS 2C,A01,886460,Shotwell; Brian,0,8,65,65
1746553918258,PHYS 2CL,A01,886467,Staff,0,4,28,28
1746553918258,PHYS 2CL,A02,886468,Staff,0,3,28,28
1746553919288,PHYS 2D,A01,886470,Staff,10,0,50,40
1746553920313,PHYS 4B,A01,886475,Grinstein; Benjamin,22,0,40,18
1746553921341,POLI 5,A00,891173,Desposato; Scott,7,0,25,18
1746553922368,POLI 5D,A01,891175,Staff,5,0,5,0
1746553922368,POLI 5D,B01,891178,Staff,5,0,5,0
1746553923393,POLI 11,A00,891179,Ferree; Karen E,2,0,35,33
1746553924418,POLI 12,A00,891180,Staff,16,0,30,14
1746553925441,POLI 27,A01,891182,Staff,12,0,75,63
1746553926467,POLI 30,A00,891183,Staff,8,0,50,42
1746553927493,POLI 100B,A00,891244,Staff,5,1,35,30
1746553928521,POLI 100I,A00,891247,Staff,7,0,30,23
1746553929549,POLI 104J,A00,891248,Nichter; Maysa,14,0,30,16
1746553930578,POLI 104U,A00,891250,Nichter; Maysa,2,0,30,28
1746553932632,POLI 110B,A00,891255,Wiens; David,20,0,25,5
1746553933659,POLI 112A,A00,891256,Wiens; David,6,0,25,19
1746553934685,POLI 114BR,A00,891261,Staff,19,0,30,11
1746553935711,POLI 117R,A00,891262,Forman; Fonna,0,6,50,50
1746553936736,POLI 118,A00,891264,Ingham; Sean,17,0,25,8
1746553937762,POLI 124A,A00,891265,Staff,18,0,20,2
1746553938791,POLI 125D,A00,891266,Nichter; Simeon C,2,0,25,23
1746553939815,POLI 126,A00,891268,Nichter; Simeon C,7,0,25,18
1746553940840,POLI 126AA,A00,891272,Staff,17,0,25,8
1746553941867,POLI 130AA,A00,891273,Staff,15,0,20,5
1746553942896,POLI 134AA,A00,891274,Staff,4,0,20,16
1746553944949,POLI 138,A00,891278,Staff,21,0,25,4
1746553945977,POLI 142K,A00,891280,Staff,11,0,25,14
1746553947003,POLI 142M,A00,891281,Gartzke; Erik,17,0,30,13
1746553948027,POLI 142P,A00,891284,Staff,20,0,30,10
1746553949051,POLI 143,A00,891285,Gartzke; Erik,12,0,30,18
1746553950075,POLI 153,A00,891286,Staff,19,0,20,1
1746553952126,POLI 175,A00,891290,Staff,15,0,20,5
1746553953151,PSYC 1,A00,890674,Steiner; Eric Tomas,0,11,45,45
1746553954176,PSYC 2,A00,890676,Albright; Thomas D,21,0,35,14
1746553955202,PSYC 3,A00,890679,Staff,17,0,20,3
1746553956230,PSYC 6,A00,959858,Staff,20,0,20,0
1746553957257,PSYC 60,A01,890684,Rickard; Timothy C.,0,5,45,45
1746553958281,PSYC 70,A01,890689,Geller; Emma Harlan,7,0,30,23
1746553959308,PSYC 71,A01,959860,Staff,21,0,25,4
1746553960335,PSYC 100,A00,890690,Lacefield; Katharine I,0,50,180,180
1746553961360,PSYC 102,A00,890695,Staff,18,0,40,22
1746553962389,PSYC 105,A00,890699,Geller; Emma Harlan,71,0,100,29
1746553963415,PSYC 106,A00,890701,Gorman; Michael R.,5,0,30,25
1746553964446,PSYC 108,A00,890704,Adrian; Julia Anna,0,28,50,50
1746553965474,PSYC 118,A01,890712,Staff,11,0,30,19
1746553966502,PSYC 124,A00,890716,Chapman; Eddie Nathaniel,25,0,60,35
1746553967528,PSYC 131,A00,890717,Anagnostaras; Stephan,0,7,80,80
1746553968561,PSYC 137,A00,890719,Winkielman; Piotr,0,11,30,30
1746553969589,PSYC 144,A00,890721,Adrian; Julia Anna,0,9,45,45
1746553970614,PSYC 162,A00,890805,Staff,2,0,75,73
1746553971639,PSYC 169,A00,890810,Staff,0,14,30,30
1746553972666,PSYC 172,A00,890814,Gorman; Michael R.,9,0,30,21
1746553973694,PSYC 181,A00,890818,Anagnostaras; Stephan,8,0,200,192
1746553974720,PSYC 184,A00,959861,Staff,170,0,175,5
1746553975745,PSYC 189,A00,890823,Staff,0,1,30,30
1746553976769,PSYC 191,A00,890884,Rickard; Timothy C.,0,11,35,35
1746553977799,PSYC 193,A00,890913,Staff,19,0,30,11
1746553977799,PSYC 193,B00,890914,Chapman; Eddie Nathaniel,24,0,30,6
1746553978827,PSYC 193L,A01,890918,Lowe; Angela Beth,20,0,30,10
1746553978827,PSYC 193L,B01,890921,Hurwitz; Ethan Scott,20,0,30,10
1746553978827,PSYC 193L,C01,890928,Staff,30,0,30,0
1746553979852,RELI 149,A00,886806,Rahimi; Babak,23,0,40,17
1746553980877,SE 9,A01,886814,Staff,7,0,20,13
1746553981903,SE 101B,A01,886816,Chadha; Mayank,4,0,35,31
1746553982930,SE 110B,A00,886818,Zhu; Qiang,4,0,75,71
1746553983957,SE 125,A01,886830,Staff,10,0,30,20
1746553984983,SE 130B,A01,886835,Staff,14,0,40,26
1746553986009,SE 131A,A01,886838,Krysl; Petr,34,0,55,21
1746553987033,SE 154,A00,886840,Staff,30,0,50,20
1746553988058,SE 164GS,A01,886849,Staff,6,0,20,14
1746553989081,SE 167GS,A01,886853,Staff,6,0,20,14
1746553990105,SIO 25,A01,890107,Staff,19,0,30,11
1746553991132,SIO 45,A00,890109,Cook; Geoffrey W,117,0,200,83
1746553992160,SIO 109R,A00,890110,Forman; Fonna,0,16,20,20
1746553993187,SIO 187,A01,890114,Kacev; David,15,0,40,25
1746553994214,SOCI 1,A01,890431,Thorpe; Charles Robert,15,0,30,15
1746553994214,SOCI 1,A02,890518,Thorpe; Charles Robert,30,0,30,0
1746553995242,SOCI 2,A01,957978,Staff,25,0,25,0
1746553995242,SOCI 2,A02,957979,Staff,23,0,25,2
1746553996267,SOCI 20,A01,890523,Calderon-Zaks; Michael Aar,23,0,30,7
1746553996267,SOCI 20,A02,890526,Calderon-Zaks; Michael Aar,29,0,30,1
1746553997290,SOCI 30,A01,890533,Pardo Guerra; Juan Pablo,37,0,40,3
1746553998315,SOCI 40,A01,890535,Staff,27,0,45,18
1746553999341,SOCI 104Q,A00,890559,Staff,18,0,30,12
1746554000369,SOCI 106,A00,890560,Arnal; Maud Marie Leonie,20,0,30,10
1746554001392,SOCI 110,A00,890567,Holkenbrink-Monk; Charlene,19,0,30,11
1746554002426,SOCI 112,A00,890568,Victoria Torres; Pablo,2,0,55,53
1746554003452,SOCI 115,A00,890597,Arnal; Maud Marie Leonie,28,0,45,17
1746554005501,SOCI 121,A00,890604,Pardo Guerra; Juan Pablo,38,0,45,7
1746554006525,SOCI 126,A01,890608,Staff,8,0,10,2
1746554007550,SOCI 127,A00,890609,Staff,18,0,30,12
1746554008577,SOCI 131,A00,890610,Thorpe; Charles Robert,37,0,45,8
1746554009601,SOCI 135,A00,890615,Payne; Christine Anna,14,0,45,31
1746554010626,SOCI 139,A00,890620,Staff,38,0,45,7
1746554011652,SOCI 148E,A00,890622,Calderon-Zaks; Michael Aar,36,0,45,9
1746554012679,SOCI 150,A00,890623,Kohler; Kristopher M.,31,0,45,14
1746554013712,SOCI 157,A00,890625,Jules-Rosette; Bennetta W.,18,0,20,2
1746554014737,SOCI 160,A00,890627,Payne; Christine Anna,21,0,45,24
1746554015762,SYN 1,A00,886855,Fish; Gwendolyn Anne,0,0,0,0
1746554015762,SYN 1,B00,906086,Fish; Gwendolyn Anne,0,1,0,2
1746554016792,SYN 2R,A00,886860,Staff,0,17,15,15
1746554016792,SYN 2R,B00,906106,Atkinson; Arthur Laird,0,16,15,15
1746554017827,SYN 100,A01,886866,Browne; Emily,0,28,20,20
1746554017827,SYN 100,B01,906128,Rock; Martin,0,5,20,20
1746554017827,SYN 100,C01,906140,Deavenport; James Cary,0,3,20,20
1746554017827,SYN 100,D01,907816,Deavenport; James Cary,0,5,20,20
1746554018857,TDAC 1,A00,890286,Walsh; Kim C.,9,0,20,11
1746554019886,TDAC 101,A00,890296,Basso; Beatrice,16,0,20,4
1746554020911,TDDE 131,A00,890297,Staff,47,0,50,3
1746554021935,TDDM 1,A00,890287,Weinberg; Sadie,25,0,30,5
1746554022964,TDGE 11,A00,890288,Fulton; Julia,137,0,200,63
1746554022964,TDGE 11,B00,890289,Castro; Robert Jess,184,0,200,16
1746554023988,TDGE 25,B00,957359,Walsh; Kim C.,3,0,20,17
1746554025013,TDGE 40,A01,890292,Power; Jade Yukana,27,0,30,3
1746554026040,TDGE 124,A00,890298,Havis; Allan,0,1,50,50
1746554027065,TDGE 131R,A00,890299,Burelle; Julie Sara Veronique,15,0,42,27
1746554028090,TDHT 101,A00,890300,Staff,10,0,20,10
1746554029119,TDHT 109,A01,890302,Anderson; Mysia Anyse,31,0,40,9
1746554030146,TDMV 1,A00,890293,Arcidiacono; Kristin,18,0,30,12
1746554031174,TDMV 2,A00,890294,Weinberg; Sadie,23,0,30,7
1746554032202,TDMV 3,A00,957878,Arcidiacono; Kristin,28,0,30,2
1746554034255,TDMV 138,A00,890304,Jun; Grace Shin Hae,25,0,40,15
1746554035280,TDMV 140,A00,890305,Corrales; Joseph Bernales,25,0,30,5
1746554036304,TDMV 142,A00,890307,Caligagan; Tony,32,0,40,8
1746554037333,TDMV 144,A00,890308,Camaya; Michelle Ann,25,0,30,5
1746554038358,TDPW 1,A00,890295,Stein; Deborah Isobel,3,0,20,17
1746554039388,USP 2,A01,890272,Lerner; Amy M,6,0,20,14
1746554040417,USP 3,A01,890274,Staff,12,0,30,18
1746554041445,USP 15,A01,890276,Sun; Feiyang,17,0,30,13
1746554042473,USP 25,A00,890277,Shenkman; Michael Thomas,19,0,25,6
1746554043499,USP 138,A00,890278,Staff,13,0,25,12
1746554044523,USP 143,A00,890279,Staff,21,0,70,49
1746554045558,USP 144,A00,890280,Chowdhury; Muhammed Zohir,16,0,30,14
1746554046583,USP 150,A00,890281,Boomhower; Matthew Charles,4,0,30,26
1746554047610,USP 151,A00,890282,Staff,16,0,20,4
1746554048639,USP 162,A00,890283,Andrews; Abigail Leslie,16,0,20,4
1746554049666,USP 168,A00,920477,Kwak; Nancy,1,0,5,4
1746554050695,USP 181,A00,890284,Staff,3,0,20,17
1746554051722,USP 191A,A00,890285,Staff,13,0,20,7
1746554052748,VIS 101,A00,886512,Staff,25,0,75,50
1746554053775,VIS 103,A00,886513,Cruz; Edwin Teddy,61,0,75,14
1746554054802,VIS 108,A00,886514,Staff,3,0,15,12
1746554055827,VIS 127P,A00,886515,Shen; Kuiyi,80,0,146,66
1746554056851,VIS 149,A00,886516,Yoldas; Pinar,0,0,15,15
1746554057876,VIS 164,A00,886526,Erdmann; Dean,19,0,22,3
1746554058904,VIS 194S,A00,886527,Staff,61,0,75,14
1746554059935,WCWP 10A,C00,886484,Martiniuk; Jill,12,0,15,3
1746554060966,WCWP 10B,A00,886490,Uriarte; Emma,0,0,15,15
1746554060966,WCWP 10B,B00,886491,Dhir; Simrita,10,0,15,5
1746554060966,WCWP 10B,C00,886492,Ornelas; Tricia,0,0,15,15
1746554061995,WCWP 100,A00,886494,Young; Mark T,0,6,15,15
1746554064075,AAS 10,A01,886199,Childs; Dennis R.,0,3,0,0
1746554065102,ANAR 104,A01,886940,Shtienberg; Gilad,27,0,30,3
1746554066133,ANAR 120,A00,886953,Staff,12,0,20,8
1746554067161,ANBI 148,A01,886955,Wilder; Linnea Lorene,30,0,40,10
1746554069209,ANSC 122,A00,886957,Staff,25,0,30,5
1746554070234,ANSC 150,A00,886958,Sloane; Julia Kathryn,2,0,15,13
1746554071260,ANSC 156,A00,886959,Jenkins; Janis A.,0,1,15,15
1746554072286,ANSC 180,A00,886960,Staff,11,0,17,6
1746554073314,ANSC 188,A00,886961,Jassal; Aftab,9,0,25,16
1746554074337,ANSC 190,A00,886962,Jassal; Aftab,14,0,25,11
1746554075361,ANSC 191,A00,886963,Staff,18,0,20,2
1746554076386,ANTH 3,A01,891689,Staff,17,0,20,3
1746554077413,ANTH 5,A00,886933,Semendeferi; Ekaterini,16,0,20,4
1746554078439,ANTH 10,A00,886934,Staff,0,12,30,30
1746554079465,ANTH 21,A01,886936,Staff,40,0,60,20
1746554080491,ANTH 23,A01,886938,Staff,92,0,100,8
1746554081519,ANTH 105,A00,886964,Stewart; Alexander B,84,0,100,16
1746554082553,ANTH 108,A00,886965,Pedersen; David,9,0,20,11
1746554083584,AWP 10,001,886147,Staff,0,0,0,0
1746554083584,AWP 10,002,886148,Staff,0,0,0,0
1746554083584,AWP 10,003,886149,Staff,0,0,0,0
1746554083584,AWP 10,004,886150,Staff,0,0,0,0
1746554083584,AWP 10,005,886151,Staff,0,0,0,0
1746554083584,AWP 10,006,886152,Staff,0,0,0,0
1746554083584,AWP 10,007,886153,Staff,0,0,0,0
1746554083584,AWP 10,008,886154,Staff,0,0,0,0
1746554083584,AWP 10,009,886155,Staff,0,0,0,0
1746554083584,AWP 10,010,886156,Staff,0,0,0,0
1746554083584,AWP 10,011,886158,Staff,0,0,0,0
1746554083584,AWP 10,012,886160,Staff,0,0,0,0
1746554083584,AWP 10,013,886161,Staff,0,0,0,0
1746554083584,AWP 10,014,886162,Staff,0,0,0,0
1746554083584,AWP 10,015,886163,Staff,0,0,0,0
1746554083584,AWP 10,016,886164,Staff,0,0,0,0
1746554083584,AWP 10,017,886165,Staff,0,0,0,0
1746554083584,AWP 10,018,886166,Staff,0,0,0,0
1746554083584,AWP 10,019,886168,Staff,0,0,0,0
1746554083584,AWP 10,020,886170,Staff,0,0,0,0
1746554083584,AWP 10,021,886172,Staff,0,0,0,0
1746554084613,AWP 10R,001,886173,Staff,0,1,0,0
1746554084613,AWP 10R,002,886174,Staff,0,1,0,0
1746554084613,AWP 10R,003,886175,Staff,0,0,0,0
1746554084613,AWP 10R,004,886176,Staff,0,0,0,0
1746554084613,AWP 10R,005,886177,Staff,0,0,0,0
1746554084613,AWP 10R,006,886178,Staff,0,0,0,0
1746554084613,AWP 10R,007,886179,Staff,0,0,0,0
1746554084613,AWP 10R,008,886181,Staff,0,0,0,0
1746554084613,AWP 10R,009,886182,Staff,0,0,0,0
1746554084613,AWP 10R,010,886183,Staff,0,0,0,0
1746554084613,AWP 10R,011,886184,Staff,0,0,0,0
1746554084613,AWP 10R,012,886185,Staff,0,0,0,0
1746554084613,AWP 10R,013,886186,Staff,0,0,0,0
1746554084613,AWP 10R,014,886187,Staff,0,0,0,0
1746554084613,AWP 10R,015,886188,Staff,0,0,0,0
1746554084613,AWP 10R,016,886189,Staff,0,0,0,0
1746554084613,AWP 10R,017,960532,Staff,0,0,0,0
1746554084613,AWP 10R,018,960533,Staff,0,0,0,0
1746554084613,AWP 10R,019,960534,Staff,0,0,0,0
1746554084613,AWP 10R,020,960538,Staff,0,0,0,0
1746554084613,AWP 10R,021,960540,Staff,0,0,0,0
1746554084613,AWP 10R,022,960541,Staff,0,0,0,0
1746554084613,AWP 10R,023,960542,Staff,0,0,0,0
1746554084613,AWP 10R,024,960544,Staff,0,0,0,0
1746554084613,AWP 10R,025,960545,Staff,0,0,0,0
1746554084613,AWP 10R,026,960548,Staff,0,0,0,0
1746554085638,AWP 102R,A00,886190,Staff,0,0,0,0
1746554085638,AWP 102R,B00,886191,Staff,0,0,0,0
1746554086662,BENG 100,A01,886193,Staff,17,0,30,13
1746554087688,BENG 122A,A01,886195,Hasty; Jeff M,13,0,30,17
1746554088716,BENG 166A,A00,886196,Sah; Robert Lie-Yuan,0,2,30,30
1746554089744,BENG 190,A00,958050,Khojah; Reem I,24,0,25,1
1746554090769,BIBC 102,A01,894320,Staff,0,0,46,46
1746554090769,BIBC 102,A02,894321,Staff,0,0,46,46
1746554090769,BIBC 102,A03,894344,Staff,7,0,46,39
1746554090769,BIBC 102,A04,894345,Staff,26,0,47,21
1746554091800,BICD 100R,A01,894365,Smith; Laurie,0,3,58,58
1746554091800,BICD 100R,A02,894366,Smith; Laurie,0,5,58,58
1746554091800,BICD 100R,A03,894367,Smith; Laurie,2,0,59,57
1746554091800,BICD 100R,A04,959869,Smith; Laurie,41,0,59,18
1746554092828,BICD 136,A01,894383,Gustafson-Brown; Cindy,14,0,50,36
1746554093856,BIEB 102,A01,894494,Butler; Shannon Rhey,51,0,130,79
1746554095912,BIEB 150,A01,894617,Wills; Christopher,3,0,20,17
1746554095912,BIEB 150,A02,894631,Wills; Christopher,3,0,20,17
1746554095912,BIEB 150,A03,894937,Wills; Christopher,3,0,20,17
1746554095912,BIEB 150,A04,894946,Wills; Christopher,5,0,20,15
1746554096940,BIEB 194,A00,906141,Kurle; Carolyn M.,6,0,20,14
1746554097965,BILD 1,A01,894154,Staff,3,0,19,16
1746554097965,BILD 1,A02,894155,Staff,14,0,19,5
1746554097965,BILD 1,A03,894160,Staff,13,0,19,6
1746554097965,BILD 1,A04,894161,Staff,15,0,18,3
1746554098990,BILD 2,A01,894168,Staff,0,0,50,50
1746554098990,BILD 2,A02,894169,Staff,0,0,50,50
1746554098990,BILD 2,A03,894179,Staff,2,0,50,48
1746554098990,BILD 2,A04,894203,Staff,27,0,50,23
1746554100037,BILD 3,A01,894213,Staff,22,0,31,9
1746554100037,BILD 3,A02,894214,Staff,26,0,31,5
1746554100037,BILD 3,A03,894235,Staff,28,0,31,3
1746554100037,BILD 3,A04,894236,Staff,28,0,32,4
1746554101070,BILD 4,A01,894253,Reuther; Keefe,5,0,24,19
1746554101070,BILD 4,A02,894258,Reuther; Keefe,16,0,24,8
1746554102097,BILD 5,A01,894276,Reuther; Keefe,35,0,50,15
1746554102097,BILD 5,A02,894277,Reuther; Keefe,45,0,50,5
1746554102097,BILD 5,A03,894290,Reuther; Keefe,44,0,50,6
1746554102097,BILD 5,A04,894291,Reuther; Keefe,48,0,50,2
1746554103125,BILD 24,A01,894297,Pirino; Giorgia,40,0,60,20
1746554104154,BIMM 100,B01,958915,Staff,72,0,100,28
1746554105181,BIMM 101,A01,895017,McDonnell; Lisa Marie,0,5,24,24
1746554105181,BIMM 101,A02,895018,McDonnell; Lisa Marie,0,5,24,24
1746554105181,BIMM 101,B01,895020,McDonnell; Lisa Marie,0,6,24,24
1746554105181,BIMM 101,B02,895021,McDonnell; Lisa Marie,0,4,24,24
1746554106206,BIMM 110,A01,895023,Staff,1,0,25,24
1746554106206,BIMM 110,A02,895024,Staff,9,0,25,16
1746554106206,BIMM 110,A03,895025,Staff,18,0,25,7
1746554106206,BIMM 110,A04,895031,Staff,20,0,25,5
1746554107232,BIMM 120,A01,895114,Gustafson-Brown; Cindy,14,0,28,14
1746554107232,BIMM 120,A02,895126,Gustafson-Brown; Cindy,21,0,27,6
1746554108261,BIPN 100,A01,895130,Yang; Mingyu,1,0,38,37
1746554108261,BIPN 100,A02,895131,Yang; Mingyu,32,0,38,6
1746554108261,BIPN 100,A03,895132,Yang; Mingyu,32,0,38,6
1746554108261,BIPN 100,A04,895133,Yang; Mingyu,27,0,36,9
1746554109288,BIPN 120,A01,895135,Cooke; James Edward,0,3,13,13
1746554109288,BIPN 120,A02,895136,Cooke; James Edward,0,1,13,13
1746554109288,BIPN 120,A03,895137,Cooke; James Edward,0,3,13,13
1746554109288,BIPN 120,A04,895156,Cooke; James Edward,0,2,11,11
1746554110313,BIPN 134,A01,895235,Cooke; James Edward,0,2,25,25
1746554110313,BIPN 134,A02,895237,Cooke; James Edward,0,0,25,25
1746554110313,BIPN 134,A03,895240,Cooke; James Edward,3,0,25,22
1746554110313,BIPN 134,A04,895270,Cooke; James Edward,20,0,25,5
1746554111340,BIPN 189,A00,892103,Staff,0,13,14,14
1746554113389,BISP 194,A00,958008,Staff,0,2,0,0
1746554114413,CAT 124,A01,922009,Staff,0,5,20,20
1746554115439,CAT 125R,A00,886390,Morales; Celeste Georgianna,0,2,20,20
1746554115439,CAT 125R,B00,886391,Irwin; Matthew Joseph,0,3,20,20
1746554115439,CAT 125R,C00,886392,Smith; Lauryn Alissa,0,2,20,20
1746554115439,CAT 125R,D00,886393,Vanderschuit; Maya Alysia,0,2,20,20
1746554115439,CAT 125R,E00,886394,Marchisotto; Jennifer Anne,0,4,20,20
1746554116468,CENG 15,A01,886218,Drews; Aaron,3,0,8,5
1746554117494,CENG 113,A00,886219,Opatkiewicz; Justin Paul,15,0,25,10
1746554118520,CGS 101,A00,887044,Staff,7,0,20,13
1746554119545,CGS 105,A01,887046,Staff,14,0,25,11
1746554120575,CGS 112,A00,887047,Cuong; Marisol,12,0,15,3
1746554121602,CGS 113,A00,887048,Staff,23,0,30,7
1746554122628,CGS 120,A00,887049,Staff,10,0,17,7
1746554123657,CHEM 6A,A01,886336,Lam; Tin Yiu,38,0,50,12
1746554123657,CHEM 6A,A02,886338,Lam; Tin Yiu,37,0,50,13
1746554124684,CHEM 6B,A01,886341,Hopkins; Patrycja Anna,16,0,50,34
1746554124684,CHEM 6B,A02,886343,Hopkins; Patrycja Anna,42,0,50,8
1746554125707,CHEM 6C,A01,886346,Albizati; Kim F.,0,2,50,50
1746554125707,CHEM 6C,A02,886348,Albizati; Kim F.,23,0,50,27
1746554126733,CHEM 40A,A01,886352,Klosterman; Jeremy K,65,0,100,35
1746554127761,CHEM 40B,A01,886356,Klosterman; Jeremy K,0,23,100,100
1746554128791,CHEM 41B,A01,886360,Theodorakis; Emmanuel,25,0,50,25
1746554128791,CHEM 41B,A02,886362,Theodorakis; Emmanuel,47,0,50,3
1746554129815,CHIN 165A,A00,886382,Xu; Li,18,0,20,2
1746554130840,CLAS 120,A00,886387,Myerston Santana; Jacobo,33,0,40,7
1746554131864,COGS 9,A01,886967,Shannon; Kyle Michael,42,0,60,18
1746554132889,COGS 11,A01,886969,Staff,11,0,30,19
1746554133916,COGS 14A,A01,886971,Staff,6,0,60,54
1746554134940,COGS 14B,A01,886973,Hoffman; Drew Ellen,4,0,60,56
1746554135965,COGS 18,A01,886975,Morgan; Eric,35,0,60,25
1746554136991,COGS 20,A01,886977,Staff,4,0,8,4
1746554136991,COGS 20,A02,886978,Staff,5,0,7,2
1746554138017,COGS 100,A01,907783,Staff,0,2,30,30
1746554139048,COGS 101B,A01,886980,Staff,0,3,48,48
1746554140076,COGS 101C,A01,886982,Delgado; Tania,0,5,44,44
1746554141103,COGS 102A,A01,886984,Johnson; Christine M.,4,0,30,26
1746554142130,COGS 118B,A01,886986,Staff,0,3,88,88
1746554143154,COGS 150,A01,886988,Bergen; Benjamin,23,0,50,27
1746554144182,COGS 153,A00,886989,Delgado; Tania,0,2,41,41
1746554145209,COGS 186,A01,886991,Staff,0,0,32,32
1746554146237,COGS 187A,A01,886993,Boyle; Mary E. T.,7,0,30,23
1746554147263,COGS 189,A00,886994,Staff,0,1,30,30
1746554148290,COMM 10,A01,886996,Staff,0,0,20,21
1746554148290,COMM 10,A02,886997,Staff,12,0,20,8
1746554148290,COMM 10,A03,959845,Staff,19,0,20,1
1746554149315,COMM 20,A01,886999,Leuning; Grant Maurstad,24,0,40,16
1746554151407,COMM 100A,A01,887002,Staff,0,0,20,25
1746554151407,COMM 100A,A02,887003,Staff,7,0,20,13
1746554152431,COMM 100B,A01,887005,Staff,0,8,20,24
1746554153456,COMM 106D,A00,887006,Staff,14,0,40,26
1746554154481,COMM 110G,A00,887007,Whitworth-Smith; Andrew C,12,0,40,28
1746554155506,COMM 111B,A00,887008,Staff,31,0,40,9
1746554156531,COMM 113T,A00,887009,Abuelhiga; Soraya Jill,28,0,40,12
1746554156531,COMM 113T,B00,906733,Staff,40,0,40,0
1746554157559,COMM 145,A00,887010,Staff,12,0,40,28
1746554158584,COMM 146,A00,887054,Staff,31,0,40,9
1746554159610,COMM 190,A00,887012,Staff,8,0,23,15
1746554160637,CSE 8A,A50,887015,Cao; Yingjun,57,0,85,28
1746554161666,CSE 11,A01,887017,Cao; Yingjun,12,0,70,58
1746554162693,CSE 20,A01,887019,Staff,30,0,50,20
1746554163718,CSE 21,A01,887021,Staff,78,0,100,22
1746554163718,CSE 21,B01,892583,Braun; Oliver,45,0,50,5
1746554164748,CSE 30,A01,887025,Eldon; John,143,0,200,57
1746554165776,CSE 100,A01,887027,Staff,25,0,50,25
1746554165776,CSE 100,A02,887028,Staff,42,0,50,8
1746554166805,CSE 101,A01,887030,Braun; Oliver,74,0,100,26
1746554166805,CSE 101,B01,887032,Jones; Miles E,0,3,50,50
1746554166805,CSE 101,B02,887033,Jones; Miles E,0,1,50,50
1746554167830,CSE 105,A01,908084,Jones; Miles E,32,0,50,18
1746554167830,CSE 105,A02,908087,Jones; Miles E,32,0,50,18
1746554168855,CSE 135,A01,887035,Powell; Thomas Allan,0,4,50,50
1746554169880,CSE 142,A01,887037,Staff,8,0,60,52
1746554170903,CSE 142L,A01,887039,Staff,34,0,60,26
1746554171930,CSE 151A,A01,887041,Solares; Edwin A,47,0,100,53
1746554172955,CSE 175,A01,887043,Kumar; Rakesh,30,0,30,0
1746554173980,CSS 1,A01,886389,Staff,0,1,40,40
1746554175006,DSC 30,A01,908097,Liao; Soohyun Nam,47,0,75,28
1746554176035,DSC 40A,A01,908099,Shannon; Kyle Michael,30,0,50,20
1746554177063,DSC 40B,A01,908112,Staff,16,0,50,34
1746554178087,DSC 80,A01,908116,Staff,19,0,60,41
1746554179113,DSC 197,001,956863,Eldridge; Justin Matthew,9999,0,9999,0
1746554180142,ECE 5,A01,886400,Morris; Karcher William,2,0,6,4
1746554180142,ECE 5,A02,886401,Morris; Karcher William,3,0,6,3
1746554181168,ECE 148,A01,886403,Silberman; Jack,0,14,14,14
1746554182196,ECON 1,A01,887265,Crane; Meredith Helen,12,0,70,58
1746554182196,ECON 1,B01,887268,Staff,43,0,50,7
1746554183226,ECON 2,A01,887273,Crane; Meredith Helen,56,0,70,14
1746554184253,ECON 3,A01,887279,Rondina; Giacomo,32,0,70,38
1746554185277,ECON 4,A01,887282,Anderson; John Charles,0,2,10,10
1746554186305,ECON 5,A01,887285,Staff,33,0,45,12
1746554186305,ECON 5,B01,887292,Staff,41,0,45,4
1746554187332,ECON 100A,A01,887337,Newhouse; Herbert S,54,0,70,16
1746554187332,ECON 100A,B01,887349,Staff,45,0,50,5
1746554188356,ECON 100B,A01,887361,Du; Songzi,29,0,70,41
1746554189384,ECON 100C,A01,887445,Newhouse; Herbert S,59,0,70,11
1746554190411,ECON 105,A00,887488,Vespa; Emanuel Ignacio,23,0,35,12
1746554191436,ECON 109,A01,887506,Shishkin; Denis,28,0,35,7
1746554192466,ECON 110A,A01,887568,Alon; Titan Michael,0,3,35,35
1746554192466,ECON 110A,B01,907601,Alon; Titan Michael,20,0,35,15
1746554193492,ECON 110B,A01,887598,Levkoff; Steven B.,0,23,70,70
1746554194516,ECON 112,A00,887599,Rondina; Giacomo,19,0,35,16
1746554195544,ECON 120A,A01,887603,Dai; Yinlin,36,0,70,34
1746554196569,ECON 120C,A01,887608,Sun; Yixiao,0,1,35,35
1746554196569,ECON 120C,B01,887614,Sun; Yixiao,0,0,35,35
1746554197593,ECON 138,A00,887621,Bharadwaj; Prashant,0,21,20,20
1746554198618,ECON 144,A00,958007,Squires; Dale E,13,0,35,22
1746554199644,ECON 171,A01,907666,Staff,18,0,35,17
1746554200668,ECON 175,A00,887626,Wu; Pak Yeung,23,0,35,12
1746554201692,ECON 190,A00,887640,Vespa; Emanuel Ignacio,23,0,35,12
1746554202724,EDS 25,A01,888197,Staff,0,0,0,0
1746554202724,EDS 25,A02,888209,Staff,0,0,0,0
1746554202724,EDS 25,A03,888210,Staff,0,0,0,0
1746554202724,EDS 25,A04,888212,Staff,0,0,0,0
1746554202724,EDS 25,A05,888213,Staff,0,0,0,0
1746554202724,EDS 25,A06,888214,Staff,0,0,0,0
1746554202724,EDS 25,A07,888235,Staff,0,2,0,0
1746554202724,EDS 25,A08,888236,Staff,0,0,0,0
1746554202724,EDS 25,A09,888240,Staff,0,0,0,0
1746554202724,EDS 25,A10,888244,Staff,0,0,0,0
1746554202724,EDS 25,B01,888273,Staff,0,0,0,0
1746554202724,EDS 25,B02,888285,Staff,0,0,0,0
1746554202724,EDS 25,B03,888423,Staff,0,0,0,1
1746554202724,EDS 25,B04,888432,Staff,0,0,0,0
1746554202724,EDS 25,B05,888433,Staff,0,0,0,0
1746554202724,EDS 25,B06,888467,Staff,0,0,0,0
1746554202724,EDS 25,B07,888468,Staff,0,0,0,0
1746554202724,EDS 25,B08,888479,Staff,0,0,0,0
1746554202724,EDS 25,B09,888484,Staff,0,0,0,0
1746554202724,EDS 25,B10,888487,Staff,0,0,0,0
1746554203750,EDS 38,A01,907700,Choi; Bailey Miyeon,30,0,30,0
1746554204776,EDS 112,A01,888601,Chapman; Thandeka K,14,0,40,26
1746554205805,EDS 115,A00,888697,Mendez; Kathrina Mendoza,10,0,30,20
1746554206833,EDS 116,A01,888893,Staff,35,0,40,5
1746554208890,EDS 124AR,A00,889133,Staff,29,0,50,21
1746554208890,EDS 124AR,B00,907471,Simon; Elizabeth A,37,0,50,13
1746554209919,EDS 124BR,A00,889134,Simon; Elizabeth A,45,0,100,55
1746554210946,EDS 125,A00,889135,Staff,25,0,30,5
1746554211974,EDS 126,A01,889138,Staff,36,0,40,4
1746554213006,EDS 164R,A01,889142,Wishard Guerra; Alison G.,33,0,50,17
1746554214030,ENG 30,A01,886396,Staff,0,0,0,0
1746554214030,ENG 30,B01,886398,Staff,0,0,0,0
1746554215058,ENVR 102,A00,906150,Montejo; Carolina,23,0,25,2
1746554216085,ETHN 103A,A00,887236,Man; Simeon S,0,3,0,0
1746554217111,ETHN 113,A00,887239,Staff,16,0,30,14
1746554218135,ETHN 116,A00,887240,Staff,16,0,25,9
1746554219160,ETHN 117,A00,887241,Choi; Esther Min,28,0,30,2
1746554220185,ETHN 118,A00,887243,Staff,24,0,30,6
1746554221209,ETHN 127,A00,887248,Cuong; Marisol,11,0,15,4
1746554222237,ETHN 139,A00,887250,Staff,7,0,10,3
1746554223262,ETHN 142,A00,887252,Staff,10,0,30,20
1746554224289,ETHN 161,A00,887253,Browne; Errol Tsekani,24,0,30,6
1746554225316,ETHN 163FR,A00,887255,Burelle; Julie Sara Veronique,0,0,5,5
1746554226341,GLBH 20,A00,889149,Elwardani; Nile Regina,8,0,42,34
1746554228393,GLBH 111,A01,889152,Burgos; Jose L.,17,0,17,0
1746554229418,GLBH 150,A00,889181,Sloane; Julia Kathryn,0,5,15,15
1746554231470,HDS 60,A01,886406,Warstadt; Melissa Fawn,73,0,80,7
1746554232498,HIAF 111,A00,889324,Gyamfi; Bright,25,0,32,7
1746554233525,HIEA 131,A00,889328,Staff,16,0,32,16
1746554234548,HIEA 144,A00,889333,Henry; Todd A.,26,0,32,6
1746554235572,HIEA 154,A00,889336,Henry; Todd A.,24,0,32,8
1746554236598,HIEU 106,A00,889339,Staff,22,0,32,10
1746554238646,HIEU 114,A00,889340,Staff,3,0,32,29
1746554239670,HIEU 135GS,A00,889342,Patterson; Patrick H.,0,0,1,24
1746554240695,HIEU 137,A00,889343,Edington; Claire Ellen,9,0,25,16
1746554241723,HIEU 148,A00,889345,Staff,14,0,32,18
1746554242747,HIEU 154,A00,889346,Biess; Frank Peter,21,0,32,11
1746554243772,HILA 102,A00,889351,Staff,12,0,32,20
1746554244796,HILD 2A,A01,889221,Lewandoski; Julia Mavis,1,10,32,31
1746554245820,HILD 7B,A01,889225,Man; Simeon S,0,13,32,32
1746554246845,HILD 7C,A01,889288,Alvarez; Luis A,0,14,32,32
1746554247871,HILD 30,A01,889323,Staff,0,5,32,32
1746554249921,HISC 119,A00,889383,Golan; Tal,20,0,32,12
1746554250947,HIUS 103,A00,889384,Man; Simeon S,0,0,32,32
1746554251970,HIUS 117,A00,919797,Kwak; Nancy,18,0,32,14
1746554252997,HIUS 142A,A00,919788,Staff,22,0,32,10
1746554255101,HIUS 149,A00,889386,Gyamfi; Bright,27,0,32,5
1746554256125,HIUS 155,A00,889387,Alvarez; Luis A,14,0,32,18
1746554257151,HUM 3,A01,886499,Caldwell; Michael Alan,19,0,50,31
1746554258174,HUM 3GS,A00,886500,Rodriguez; Bretton Sigfred,0,0,0,28
1746554259202,HUM 3R,A01,886502,Markman; Kristina,0,36,50,50
1746554260230,HUM 4,A01,886504,Crum; Matthew Stephen,24,0,50,26
1746554260230,HUM 4,B01,886506,West; Geoffrey Scott,17,0,50,33
1746554261255,HUM 4GS,A00,886507,Staff,0,0,0,19
1746554262279,HUM 5,A01,886509,Staff,32,0,50,18
1746554263304,HUM 5R,A01,886511,Zavodny; Tatiana Sophia,0,39,50,50
1746554264328,JAPN 180,A00,886407,Staff,17,0,40,23
1746554265357,LATI 50,A01,886409,Martin-Cabrera; Luis,4,0,22,18
1746554265357,LATI 50,A02,886410,Martin-Cabrera; Luis,19,0,22,3
1746554265357,LATI 50,A03,886411,Martin-Cabrera; Luis,21,0,22,1
1746554265357,LATI 50,A04,886412,Martin-Cabrera; Luis,9,0,22,13
1746554266385,LAWS 101,A00,907664,Staff,28,0,60,32
1746554267409,LIAB 1A,A00,889388,Saab; Dima,17,0,20,3
1746554268437,LIAB 1AX,A00,889389,El Cheddadi; Youniss,17,0,20,3
1746554269465,LIFR 1C,A00,889391,Van Moer; Vinciane G,8,0,20,12
1746554270491,LIFR 1CX,A00,889392,Van Moer; Vinciane G,7,0,20,13
1746554271515,LIFR 1D,A00,889393,Van Moer; Vinciane G,7,0,20,13
1746554272540,LIFR 1DX,A00,889394,Van Moer; Vinciane G,8,0,20,12
1746554273565,LIGN 7,A00,886923,Staff,24,0,50,26
1746554274591,LIGN 17,A00,886924,Kehler; Andrew Scott,125,0,150,25
1746554275617,LTAM 110,A00,889395,Staff,15,0,30,15
1746554276645,LTAM 110GS,A00,958010,Rodriguez; Bretton Sigfred,0,0,0,28
1746554277669,LTCH 101,A00,889397,Staff,23,0,25,2
1746554278694,LTCS 130,A00,889398,Staff,23,0,25,2
1746554279722,LTEA 138,A00,889399,Staff,24,0,40,16
1746554280750,LTEN 149,A00,889400,Wesling; Megan E.,0,3,25,25
1746554281777,LTEN 169,A00,889401,Staff,20,0,25,5
1746554282802,LTEN 180,A00,889402,Staff,10,0,15,5
1746554283827,LTEN 181,A00,889403,Staff,21,0,25,4
1746554284853,LTWL 100,A00,889404,Myerston Santana; Jacobo,3,0,25,22
1746554285877,LTWL 180GS,A00,889405,Staff,0,0,20,20
1746554286903,LTWL 181,A00,889406,Staff,17,0,25,8
1746554287931,LTWL 184,A00,889475,Mukherjee; Silpa,22,0,25,3
1746554288957,LTWR 102C,A00,889486,Staff,29,0,30,1
1746554289987,LTWR 115W,A00,889491,Staff,0,2,15,15
1746554291017,MAE 8,A01,886905,Staff,0,2,0,0
1746554292041,MAE 11,A00,886906,Bandaru; Prabhakar,0,7,50,50
1746554293070,MAE 20,A00,886907,Evdokimenko; Ekaterina,43,0,70,27
1746554294094,MAE 30B,A00,886909,Ghazinejad; Maziar,26,0,45,19
1746554295120,MAE 101B,A00,886910,Saintillan; David,29,0,45,16
1746554296145,MAE 105,A00,886911,Bandaru; Prabhakar,18,0,50,32
1746554297173,MAE 107,B00,958024,Staff,8,0,50,42
1746554298198,MAE 143B,A00,886913,Bewley; Thomas R,7,0,40,33
1746554299222,MAE 148,A01,886915,Silberman; Jack,0,3,14,14
1746554300247,MAE 160,A00,886916,Evdokimenko; Ekaterina,31,0,60,29
1746554301272,MATH 3C,A01,889681,Staff,0,3,30,30
1746554301272,MATH 3C,A02,960048,Staff,25,0,30,5
1746554302296,MATH 10A,A01,889760,Staff,26,0,30,4
1746554302296,MATH 10A,A02,889783,Staff,29,0,30,1
1746554303328,MATH 10B,A01,889785,Verstraete; Jacques Allan,2,0,35,33
1746554303328,MATH 10B,A02,889795,Verstraete; Jacques Allan,4,0,35,31
1746554303328,MATH 10B,B01,889797,Verstraete; Jacques Allan,3,0,35,32
1746554303328,MATH 10B,B02,889828,Verstraete; Jacques Allan,3,0,35,32
1746554304355,MATH 10C,A01,889849,Habib; Yousaf,8,0,30,22
1746554304355,MATH 10C,A02,889852,Habib; Yousaf,14,0,30,16
1746554304355,MATH 10C,A03,889853,Habib; Yousaf,22,0,30,8
1746554304355,MATH 10C,A04,889858,Habib; Yousaf,20,0,30,10
1746554304355,MATH 10C,B01,889861,Staff,1,0,30,29
1746554304355,MATH 10C,B02,889862,Staff,24,0,30,6
1746554304355,MATH 10C,B03,889863,Staff,27,0,30,3
1746554304355,MATH 10C,B04,889967,Staff,23,0,30,7
1746554305382,MATH 18,A01,889974,Staff,7,0,30,23
1746554305382,MATH 18,A02,889977,Staff,20,0,30,10
1746554305382,MATH 18,B01,889984,Hardiman; Liam,22,0,30,8
1746554305382,MATH 18,B02,889985,Hardiman; Liam,25,0,30,5
1746554306408,MATH 20A,A01,889990,Suk; Andrew Hoon,30,0,35,5
1746554307439,MATH 20B,A01,889993,Ohm; Ko Woon,22,0,30,8
1746554307439,MATH 20B,A02,889994,Ohm; Ko Woon,30,0,30,0
1746554307439,MATH 20B,B01,889996,Ohm; Ko Woon,21,0,30,9
1746554307439,MATH 20B,B02,889997,Ohm; Ko Woon,23,0,30,7
1746554308465,MATH 20C,A01,889999,Hammock; Frances H,17,0,30,13
1746554308465,MATH 20C,A02,890003,Hammock; Frances H,23,0,30,7
1746554308465,MATH 20C,B01,890006,Hammock; Frances H,3,0,30,27
1746554308465,MATH 20C,B02,890007,Hammock; Frances H,11,0,30,19
1746554309494,MATH 20D,A01,890011,Cheng; Hsiao-Bing,1,1,30,29
1746554309494,MATH 20D,A02,890012,Cheng; Hsiao-Bing,14,0,30,16
1746554309494,MATH 20D,B01,890016,Cheng; Hsiao-Bing,13,0,30,17
1746554309494,MATH 20D,B02,890017,Cheng; Hsiao-Bing,13,0,30,17
1746554310524,MATH 20E,A01,890026,Harel; Guershon,1,0,30,29
1746554310524,MATH 20E,A02,890029,Harel; Guershon,23,0,30,7
1746554310524,MATH 20E,B01,890033,Harel; Guershon,7,0,30,23
1746554310524,MATH 20E,B02,890101,Harel; Guershon,21,0,30,9
1746554311557,MATH 102,A01,890104,Staff,17,0,30,13
1746554311557,MATH 102,A02,890105,Staff,27,0,30,3
1746554312584,MATH 103B,A01,890116,Salehi Golsefidy; Alireza,3,0,30,27
1746554312584,MATH 103B,B01,890118,Staff,0,3,34,34
1746554313614,MATH 109,A01,890121,Aliabadi Sr.; Mohsen,1,0,30,29
1746554313614,MATH 109,B01,890124,Upadrashta; Pranav Kumar,18,0,30,12
1746554314639,MATH 120A,A01,890126,Eggers; John Dietrich,13,0,30,17
1746554315667,MATH 142B,A01,890128,Ioana; Adrian,19,0,30,11
1746554315667,MATH 142B,A02,890129,Ioana; Adrian,13,0,30,17
1746554316690,MATH 154,A01,890174,Staff,0,0,30,30
1746554316690,MATH 154,A02,890182,Staff,0,0,30,30
1746554317719,MATH 168A,A01,890197,Dumitriu; Ioana,21,0,35,14
1746554318743,MATH 170A,A01,890240,Nie; Jiawang,1,0,30,29
1746554318743,MATH 170A,A02,890241,Nie; Jiawang,11,0,30,19
1746554318743,MATH 170A,A03,890249,Nie; Jiawang,23,0,30,7
1746554319781,MATH 170B,A01,957891,Nag; Panchali,13,0,35,22
1746554321833,MATH 181A,A01,908025,Staff,0,4,35,35
1746554321833,MATH 181A,A02,960115,Staff,27,0,35,8
1746554322863,MATH 181B,A01,959874,Staff,25,0,30,5
1746554323892,MATH 193B,A01,890265,Staff,0,4,35,35
1746554324918,MGT 4,A01,890311,Anderson; John Charles,42,0,88,46
1746554325943,MGT 5,A00,907740,Staff,13,0,98,85
1746554326969,MGT 12,A00,890312,Lindenberger; Wade Douglas,67,0,98,31
1746554327995,MGT 16,A00,957883,Staff,78,0,98,20
1746554330046,MGT 45,A00,890314,Pecore; Joseph P.,47,0,98,51
1746554331071,MGT 71,A00,890315,Staff,0,11,98,98
1746554332099,MGT 100,A00,890316,Yavorsky; Daniel Ryan,44,0,98,54
1746554333125,MGT 103,A00,890317,Ehrich; Kristine R,73,0,98,25
1746554334150,MGT 105,A00,890356,Bates; Kenneth Walter,0,7,98,98
1746554335174,MGT 112,A00,890360,Ehrich; Kristine R,55,0,98,43
1746554336201,MGT 127R,A00,907732,Zhu; Kevin Xiaoguo,24,0,98,74
1746554337229,MGT 131B,A00,890361,Anderson; John Charles,60,0,98,38
1746554338256,MGT 137,A00,890362,Lindenberger; Wade Douglas,65,0,98,33
1746554339281,MGT 160,A00,890369,Johnson; Erik Barry,9,0,98,89
1746554341336,MGT 164,A00,890372,Zimmermann; Carsten,0,39,98,98
1746554342359,MGT 180,A00,890374,Bliss; Barbara Ann,12,0,98,86
1746554343389,MMW 15,A01,886414,Chang; Edmond Yi-Teh,0,12,28,28
1746554343389,MMW 15,A02,886415,Chang; Edmond Yi-Teh,0,8,28,28
1746554343389,MMW 15,A03,886416,Chang; Edmond Yi-Teh,0,8,28,28
1746554343389,MMW 15,A04,886417,Chang; Edmond Yi-Teh,0,8,28,28
1746554343389,MMW 15,B01,886419,Chang; Edmond Yi-Teh,0,7,28,28
1746554343389,MMW 15,B02,886420,Chang; Edmond Yi-Teh,0,8,28,28
1746554343389,MMW 15,B03,886421,Chang; Edmond Yi-Teh,0,7,28,28
1746554343389,MMW 15,B04,886422,Chang; Edmond Yi-Teh,0,8,28,28
1746554343389,MMW 15,C01,886424,Staff,0,9,28,28
1746554343389,MMW 15,C02,886425,Staff,0,8,28,28
1746554343389,MMW 15,C03,886426,Staff,0,8,28,28
1746554343389,MMW 15,C04,886427,Staff,0,8,28,28
1746554343389,MMW 15,C05,958038,Staff,0,7,28,28
1746554343389,MMW 15,C06,958039,Staff,0,8,28,28
1746554344416,MMW 15GS,A00,906910,Patterson; Patrick H.,4,0,28,24
1746554345441,MMW 122R,A01,886429,Rahimi; Babak,0,13,28,28
1746554345441,MMW 122R,A02,886430,Rahimi; Babak,0,12,28,28
1746554345441,MMW 122R,A03,958040,Rahimi; Babak,0,11,28,28
1746554346471,MUS 1A,A01,890937,Staff,2,0,25,23
1746554346471,MUS 1A,A02,891035,Staff,6,0,25,19
1746554346471,MUS 1A,C01,958912,Staff,24,0,25,1
1746554346471,MUS 1A,C02,958913,Staff,25,0,25,0
1746554348519,MUS 2AK,A00,957092,Ohnishi; Takae,15,0,15,0
1746554349544,MUS 4,A01,891044,Staff,2,0,25,23
1746554349544,MUS 4,A02,891045,Staff,23,0,25,2
1746554349544,MUS 4,B01,891048,Staff,17,0,25,8
1746554349544,MUS 4,B02,891050,Staff,25,0,25,0
1746554350573,MUS 5,A01,957506,Dubnov; Shlomo,0,0,25,25
1746554350573,MUS 5,A02,957622,Dubnov; Shlomo,13,0,25,12
1746554350573,MUS 5,A03,957623,Dubnov; Shlomo,20,0,25,5
1746554351598,MUS 6,A01,891053,Freitas Caetano; Marcelo,24,0,25,1
1746554351598,MUS 6,A02,891054,Freitas Caetano; Marcelo,23,0,25,2
1746554352623,MUS 7,A01,891081,Staff,0,0,25,25
1746554352623,MUS 7,A02,891082,Staff,4,0,25,21
1746554353647,MUS 8GS,A00,891118,Borgo; David Garcia,0,0,25,25
1746554354675,MUS 11,A01,891140,Staff,11,0,25,14
1746554354675,MUS 11,A02,891141,Staff,22,0,25,3
1746554355703,MUS 13,A01,891143,Staff,8,0,25,17
1746554355703,MUS 13,A02,891144,Staff,24,0,25,1
1746554356732,MUS 15,A01,891146,Staff,9,0,25,16
1746554356732,MUS 15,A02,891148,Staff,21,0,25,4
1746554356732,MUS 15,B01,891150,Staff,18,0,25,7
1746554356732,MUS 15,B02,891151,Staff,25,0,25,0
1746554357759,MUS 20,A01,891153,Staff,5,0,20,15
1746554357759,MUS 20,A02,891155,Staff,14,0,20,6
1746554358838,MUS 80,A00,891156,Staff,19,0,25,6
1746554358838,MUS 80,B00,891157,Staff,23,0,25,2
1746554359864,MUS 130,A00,891158,Ohnishi; Takae,35,0,35,0
1746554360887,MUS 150GS,A01,891160,Borgo; David Garcia,0,0,25,25
1746554361917,MUS 170,A01,891162,Freitas Caetano; Marcelo,20,0,25,5
1746554361917,MUS 170,A02,891164,Freitas Caetano; Marcelo,21,0,25,4
1746554362944,NANO 11,A00,886220,Vazquez Mena; Oscar,13,0,15,2
1746554363968,NANO 15,A01,886222,Drews; Aaron,4,0,7,3
1746554364998,NANO 104,A00,886224,Sirbuly; Donald,18,0,25,7
1746554366023,PH 40,A00,886528,Staff,23,0,40,17
1746554367051,PH 45,A01,886799,Staff,35,0,40,5
1746554368076,PH 110,A00,886802,Staff,0,7,40,40
1746554369101,PH 172,A00,906716,Staff,19,0,35,16
1746554370126,PH 191,A00,886803,Staff,6,0,40,34
1746554371152,PHIL 1,A00,889500,Staff,20,0,30,10
1746554372179,PHIL 10,A01,889549,Grush; Rick Scott,15,0,22,7
1746554372179,PHIL 10,A02,889551,Grush; Rick Scott,22,0,22,0
1746554373204,PHIL 28,A01,889559,Lamey; Andy M.,0,1,31,31
1746554373204,PHIL 28,A02,889561,Lamey; Andy M.,0,1,30,30
1746554373204,PHIL 28,A03,889572,Lamey; Andy M.,0,1,30,30
1746554374231,PHIL 35,A00,907839,Staff,13,0,15,2
1746554375258,PHIL 60,A00,889574,Staff,74,0,90,16
1746554376284,PHIL 101,A00,958004,Staff,12,0,15,3
1746554378336,PHIL 136,A00,889582,Fulkerson; Matthew Todd,26,0,45,19
1746554379361,PHIL 163,A01,889601,Staff,21,0,30,9
1746554379361,PHIL 163,B01,889606,Brandt; Reuven A,0,3,0,0
1746554380384,PHIL 164,A00,889610,Staff,16,0,30,14
1746554381410,PHIL 165,A00,889613,Staff,23,0,30,7
1746554382436,PHYS 1A,A00,886431,Staff,26,0,70,44
1746554383461,PHYS 1AL,001,886432,Tsai; Philbert S,0,2,30,30
1746554383461,PHYS 1AL,002,886436,Tsai; Philbert S,11,0,30,19
1746554384488,PHYS 1B,A00,886439,Staff,185,0,240,55
1746554385514,PHYS 1BL,001,886441,Tsai; Philbert S,0,4,30,30
1746554385514,PHYS 1BL,002,886444,Tsai; Philbert S,2,0,30,28
1746554386538,PHYS 1C,A00,896092,Arnold; Kam S,78,0,146,68
1746554387564,PHYS 1CL,001,886448,Tsai; Philbert S,0,0,30,30
1746554387564,PHYS 1CL,002,886449,Tsai; Philbert S,0,0,30,30
1746554387564,PHYS 1CL,003,886450,Tsai; Philbert S,16,0,30,14
1746554387564,PHYS 1CL,004,886451,Tsai; Philbert S,15,0,30,15
1746554388588,PHYS 2B,A01,886457,Staff,69,0,115,46
1746554389612,PHYS 2C,A01,886460,Shotwell; Brian,0,8,65,65
1746554390637,PHYS 2CL,A01,886467,Staff,0,4,28,28
1746554390637,PHYS 2CL,A02,886468,Staff,0,3,28,28
1746554391663,PHYS 2D,A01,886470,Staff,10,0,50,40
1746554392692,PHYS 4B,A01,886475,Grinstein; Benjamin,22,0,40,18
1746554393718,POLI 5,A00,891173,Desposato; Scott,7,0,25,18
1746554394745,POLI 5D,A01,891175,Staff,5,0,5,0
1746554394745,POLI 5D,B01,891178,Staff,5,0,5,0
1746554395773,POLI 11,A00,891179,Ferree; Karen E,2,0,35,33
1746554396799,POLI 12,A00,891180,Staff,16,0,30,14
1746554397822,POLI 27,A01,891182,Staff,12,0,75,63
1746554398863,POLI 30,A00,891183,Staff,8,0,50,42
1746554399886,POLI 100B,A00,891244,Staff,5,1,35,30
1746554400912,POLI 100I,A00,891247,Staff,7,0,30,23
1746554401941,POLI 104J,A00,891248,Nichter; Maysa,14,0,30,16
1746554402966,POLI 104U,A00,891250,Nichter; Maysa,2,0,30,28
1746554405016,POLI 110B,A00,891255,Wiens; David,20,0,25,5
1746554406042,POLI 112A,A00,891256,Wiens; David,6,0,25,19
1746554407068,POLI 114BR,A00,891261,Staff,19,0,30,11
1746554408093,POLI 117R,A00,891262,Forman; Fonna,0,6,50,50
1746554409119,POLI 118,A00,891264,Ingham; Sean,17,0,25,8
1746554410149,POLI 124A,A00,891265,Staff,18,0,20,2
1746554411172,POLI 125D,A00,891266,Nichter; Simeon C,2,0,25,23
1746554412197,POLI 126,A00,891268,Nichter; Simeon C,7,0,25,18
1746554413237,POLI 126AA,A00,891272,Staff,17,0,25,8
1746554414262,POLI 130AA,A00,891273,Staff,15,0,20,5
1746554415287,POLI 134AA,A00,891274,Staff,4,0,20,16
1746554417337,POLI 138,A00,891278,Staff,21,0,25,4
1746554418365,POLI 142K,A00,891280,Staff,11,0,25,14
1746554419390,POLI 142M,A00,891281,Gartzke; Erik,17,0,30,13
1746554420418,POLI 142P,A00,891284,Staff,20,0,30,10
1746554421445,POLI 143,A00,891285,Gartzke; Erik,12,0,30,18
1746554422469,POLI 153,A00,891286,Staff,19,0,20,1
1746554424520,POLI 175,A00,891290,Staff,15,0,20,5
1746554425544,PSYC 1,A00,890674,Steiner; Eric Tomas,0,11,45,45
1746554426572,PSYC 2,A00,890676,Albright; Thomas D,21,0,35,14
1746554427599,PSYC 3,A00,890679,Staff,17,0,20,3
1746554428627,PSYC 6,A00,959858,Staff,20,0,20,0
1746554429653,PSYC 60,A01,890684,Rickard; Timothy C.,0,5,45,45
1746554430678,PSYC 70,A01,890689,Geller; Emma Harlan,7,0,30,23
1746554431703,PSYC 71,A01,959860,Staff,21,0,25,4
1746554432727,PSYC 100,A00,890690,Lacefield; Katharine I,0,50,180,180
1746554433751,PSYC 102,A00,890695,Staff,18,0,40,22
1746554434777,PSYC 105,A00,890699,Geller; Emma Harlan,71,0,100,29
1746554435801,PSYC 106,A00,890701,Gorman; Michael R.,5,0,30,25
1746554436829,PSYC 108,A00,890704,Adrian; Julia Anna,0,28,50,50
1746554437854,PSYC 118,A01,890712,Staff,11,0,30,19
1746554438883,PSYC 124,A00,890716,Chapman; Eddie Nathaniel,25,0,60,35
1746554439907,PSYC 131,A00,890717,Anagnostaras; Stephan,0,7,80,80
1746554440933,PSYC 137,A00,890719,Winkielman; Piotr,0,11,30,30
1746554441956,PSYC 144,A00,890721,Adrian; Julia Anna,0,9,45,45
1746554442983,PSYC 162,A00,890805,Staff,2,0,75,73
1746554444007,PSYC 169,A00,890810,Staff,0,14,30,30
1746554445033,PSYC 172,A00,890814,Gorman; Michael R.,9,0,30,21
1746554446058,PSYC 181,A00,890818,Anagnostaras; Stephan,8,0,200,192
1746554447082,PSYC 184,A00,959861,Staff,170,0,175,5
1746554448112,PSYC 189,A00,890823,Staff,0,1,30,30
1746554449137,PSYC 191,A00,890884,Rickard; Timothy C.,0,11,35,35
1746554450165,PSYC 193,A00,890913,Staff,19,0,30,11
1746554450165,PSYC 193,B00,890914,Chapman; Eddie Nathaniel,24,0,30,6
1746554451197,PSYC 193L,A01,890918,Lowe; Angela Beth,20,0,30,10
1746554451197,PSYC 193L,B01,890921,Hurwitz; Ethan Scott,20,0,30,10
1746554451197,PSYC 193L,C01,890928,Staff,30,0,30,0
1746554452220,RELI 149,A00,886806,Rahimi; Babak,23,0,40,17
1746554453245,SE 9,A01,886814,Staff,7,0,20,13
1746554454270,SE 101B,A01,886816,Chadha; Mayank,4,0,35,31
1746554455295,SE 110B,A00,886818,Zhu; Qiang,4,0,75,71
1746554456321,SE 125,A01,886830,Staff,10,0,30,20
1746554457351,SE 130B,A01,886835,Staff,14,0,40,26
1746554458374,SE 131A,A01,886838,Krysl; Petr,34,0,55,21
1746554459401,SE 154,A00,886840,Staff,29,0,50,21
1746554460426,SE 164GS,A01,886849,Staff,6,0,20,14
1746554461451,SE 167GS,A01,886853,Staff,6,0,20,14
1746554462515,SIO 25,A01,890107,Staff,19,0,30,11
1746554463542,SIO 45,A00,890109,Cook; Geoffrey W,117,0,200,83
1746554464572,SIO 109R,A00,890110,Forman; Fonna,0,16,20,20
1746554465600,SIO 187,A01,890114,Kacev; David,15,0,40,25
1746554466626,SOCI 1,A01,890431,Thorpe; Charles Robert,15,0,30,15
1746554466626,SOCI 1,A02,890518,Thorpe; Charles Robert,30,0,30,0
1746554467650,SOCI 2,A01,957978,Staff,25,0,25,0
1746554467650,SOCI 2,A02,957979,Staff,23,0,25,2
1746554468679,SOCI 20,A01,890523,Calderon-Zaks; Michael Aar,23,0,30,7
1746554468679,SOCI 20,A02,890526,Calderon-Zaks; Michael Aar,29,0,30,1
1746554469703,SOCI 30,A01,890533,Pardo Guerra; Juan Pablo,37,0,40,3
1746554470729,SOCI 40,A01,890535,Staff,27,0,45,18
1746554471755,SOCI 104Q,A00,890559,Staff,18,0,30,12
1746554472779,SOCI 106,A00,890560,Arnal; Maud Marie Leonie,20,0,30,10
1746554473808,SOCI 110,A00,890567,Holkenbrink-Monk; Charlene,19,0,30,11
1746554474837,SOCI 112,A00,890568,Victoria Torres; Pablo,2,0,55,53
1746554475863,SOCI 115,A00,890597,Arnal; Maud Marie Leonie,28,0,45,17
1746554477917,SOCI 121,A00,890604,Pardo Guerra; Juan Pablo,38,0,45,7
1746554478948,SOCI 126,A01,890608,Staff,8,0,10,2
1746554479976,SOCI 127,A00,890609,Staff,18,0,30,12
1746554481004,SOCI 131,A00,890610,Thorpe; Charles Robert,37,0,45,8
1746554482035,SOCI 135,A00,890615,Payne; Christine Anna,14,0,45,31
1746554483059,SOCI 139,A00,890620,Staff,38,0,45,7
1746554484084,SOCI 148E,A00,890622,Calderon-Zaks; Michael Aar,36,0,45,9
1746554485112,SOCI 150,A00,890623,Kohler; Kristopher M.,31,0,45,14
1746554486140,SOCI 157,A00,890625,Jules-Rosette; Bennetta W.,18,0,20,2
1746554487167,SOCI 160,A00,890627,Payne; Christine Anna,21,0,45,24
1746554488191,SYN 1,A00,886855,Fish; Gwendolyn Anne,0,0,0,0
1746554488191,SYN 1,B00,906086,Fish; Gwendolyn Anne,0,1,0,2
1746554489216,SYN 2R,A00,886860,Staff,0,17,15,15
1746554489216,SYN 2R,B00,906106,Atkinson; Arthur Laird,0,16,15,15
1746554490251,SYN 100,A01,886866,Browne; Emily,0,28,20,20
1746554490251,SYN 100,B01,906128,Rock; Martin,0,5,20,20
1746554490251,SYN 100,C01,906140,Deavenport; James Cary,0,3,20,20
1746554490251,SYN 100,D01,907816,Deavenport; James Cary,0,5,20,20
1746554491279,TDAC 1,A00,890286,Walsh; Kim C.,9,0,20,11
1746554492304,TDAC 101,A00,890296,Basso; Beatrice,16,0,20,4
1746554493331,TDDE 131,A00,890297,Staff,47,0,50,3
1746554494358,TDDM 1,A00,890287,Weinberg; Sadie,25,0,30,5
1746554495383,TDGE 11,A00,890288,Fulton; Julia,137,0,200,63
1746554495383,TDGE 11,B00,890289,Castro; Robert Jess,184,0,200,16
1746554496408,TDGE 25,B00,957359,Walsh; Kim C.,3,0,20,17
1746554497434,TDGE 40,A01,890292,Power; Jade Yukana,27,0,30,3
1746554498460,TDGE 124,A00,890298,Havis; Allan,0,1,50,50
1746554499487,TDGE 131R,A00,890299,Burelle; Julie Sara Veronique,15,0,42,27
1746554500513,TDHT 101,A00,890300,Staff,10,0,20,10
1746554501537,TDHT 109,A01,890302,Anderson; Mysia Anyse,31,0,40,9
1746554502564,TDMV 1,A00,890293,Arcidiacono; Kristin,18,0,30,12
1746554503591,TDMV 2,A00,890294,Weinberg; Sadie,23,0,30,7
1746554504618,TDMV 3,A00,957878,Arcidiacono; Kristin,28,0,30,2
1746554506670,TDMV 138,A00,890304,Jun; Grace Shin Hae,25,0,40,15
1746554507696,TDMV 140,A00,890305,Corrales; Joseph Bernales,25,0,30,5
1746554508722,TDMV 142,A00,890307,Caligagan; Tony,32,0,40,8
1746554509750,TDMV 144,A00,890308,Camaya; Michelle Ann,25,0,30,5
1746554510777,TDPW 1,A00,890295,Stein; Deborah Isobel,3,0,20,17
1746554511801,USP 2,A01,890272,Lerner; Amy M,6,0,20,14
1746554512829,USP 3,A01,890274,Staff,12,0,30,18
1746554513853,USP 15,A01,890276,Sun; Feiyang,17,0,30,13
1746554514879,USP 25,A00,890277,Shenkman; Michael Thomas,19,0,25,6
1746554515904,USP 138,A00,890278,Staff,13,0,25,12
1746554516929,USP 143,A00,890279,Staff,21,0,70,49
1746554517954,USP 144,A00,890280,Chowdhury; Muhammed Zohir,16,0,30,14
1746554518991,USP 150,A00,890281,Boomhower; Matthew Charles,4,0,30,26
1746554520017,USP 151,A00,890282,Staff,16,0,20,4
1746554521044,USP 162,A00,890283,Andrews; Abigail Leslie,16,0,20,4
1746554522072,USP 168,A00,920477,Kwak; Nancy,1,0,5,4
1746554523098,USP 181,A00,890284,Staff,3,0,20,17
1746554524127,USP 191A,A00,890285,Staff,12,0,20,8
1746554525152,VIS 101,A00,886512,Staff,25,0,75,50
1746554526180,VIS 103,A00,886513,Cruz; Edwin Teddy,61,0,75,14
1746554527204,VIS 108,A00,886514,Staff,3,0,15,12
1746554528231,VIS 127P,A00,886515,Shen; Kuiyi,80,0,146,66
1746554529259,VIS 149,A00,886516,Yoldas; Pinar,0,0,15,15
1746554530286,VIS 164,A00,886526,Erdmann; Dean,19,0,22,3
1746554531313,VIS 194S,A00,886527,Staff,61,0,75,14
1746554532336,WCWP 10A,C00,886484,Martiniuk; Jill,12,0,15,3
1746554533366,WCWP 10B,A00,886490,Uriarte; Emma,0,0,15,15
1746554533366,WCWP 10B,B00,886491,Dhir; Simrita,10,0,15,5
1746554533366,WCWP 10B,C00,886492,Ornelas; Tricia,0,0,15,15
1746554534390,WCWP 100,A00,886494,Young; Mark T,0,6,15,15
1746554536463,AAS 10,A01,886199,Childs; Dennis R.,0,3,0,0
1746554537493,ANAR 104,A01,886940,Shtienberg; Gilad,27,0,30,3
1746554538517,ANAR 120,A00,886953,Staff,12,0,20,8
1746554539546,ANBI 148,A01,886955,Wilder; Linnea Lorene,30,0,40,10
1746554541603,ANSC 122,A00,886957,Staff,25,0,30,5
1746554542630,ANSC 150,A00,886958,Sloane; Julia Kathryn,2,0,15,13
1746554543656,ANSC 156,A00,886959,Jenkins; Janis A.,0,1,15,15
1746554544691,ANSC 180,A00,886960,Staff,11,0,17,6
1746554545716,ANSC 188,A00,886961,Jassal; Aftab,9,0,25,16
1746554546739,ANSC 190,A00,886962,Jassal; Aftab,14,0,25,11
1746554547766,ANSC 191,A00,886963,Staff,18,0,20,2
1746554548793,ANTH 3,A01,891689,Staff,17,0,20,3
1746554549819,ANTH 5,A00,886933,Semendeferi; Ekaterini,16,0,20,4
1746554550846,ANTH 10,A00,886934,Staff,0,12,30,30
1746554551872,ANTH 21,A01,886936,Staff,40,0,60,20
1746554552898,ANTH 23,A01,886938,Staff,92,0,100,8
1746554553924,ANTH 105,A00,886964,Stewart; Alexander B,84,0,100,16
1746554554949,ANTH 108,A00,886965,Pedersen; David,9,0,20,11
1746554555981,AWP 10,001,886147,Staff,0,0,0,0
1746554555981,AWP 10,002,886148,Staff,0,0,0,0
1746554555981,AWP 10,003,886149,Staff,0,0,0,0
1746554555981,AWP 10,004,886150,Staff,0,0,0,0
1746554555981,AWP 10,005,886151,Staff,0,0,0,0
1746554555981,AWP 10,006,886152,Staff,0,0,0,0
1746554555981,AWP 10,007,886153,Staff,0,0,0,0
1746554555981,AWP 10,008,886154,Staff,0,0,0,0
1746554555981,AWP 10,009,886155,Staff,0,0,0,0
1746554555981,AWP 10,010,886156,Staff,0,0,0,0
1746554555981,AWP 10,011,886158,Staff,0,0,0,0
1746554555981,AWP 10,012,886160,Staff,0,0,0,0
1746554555981,AWP 10,013,886161,Staff,0,0,0,0
1746554555981,AWP 10,014,886162,Staff,0,0,0,0
1746554555981,AWP 10,015,886163,Staff,0,0,0,0
1746554555981,AWP 10,016,886164,Staff,0,0,0,0
1746554555981,AWP 10,017,886165,Staff,0,0,0,0
1746554555981,AWP 10,018,886166,Staff,0,0,0,0
1746554555981,AWP 10,019,886168,Staff,0,0,0,0
1746554555981,AWP 10,020,886170,Staff,0,0,0,0
1746554555981,AWP 10,021,886172,Staff,0,0,0,0
1746554557008,AWP 10R,001,886173,Staff,0,1,0,0
1746554557008,AWP 10R,002,886174,Staff,0,1,0,0
1746554557008,AWP 10R,003,886175,Staff,0,0,0,0
1746554557008,AWP 10R,004,886176,Staff,0,0,0,0
1746554557008,AWP 10R,005,886177,Staff,0,0,0,0
1746554557008,AWP 10R,006,886178,Staff,0,0,0,0
1746554557008,AWP 10R,007,886179,Staff,0,0,0,0
1746554557008,AWP 10R,008,886181,Staff,0,0,0,0
1746554557008,AWP 10R,009,886182,Staff,0,0,0,0
1746554557008,AWP 10R,010,886183,Staff,0,0,0,0
1746554557008,AWP 10R,011,886184,Staff,0,0,0,0
1746554557008,AWP 10R,012,886185,Staff,0,0,0,0
1746554557008,AWP 10R,013,886186,Staff,0,0,0,0
1746554557008,AWP 10R,014,886187,Staff,0,0,0,0
1746554557008,AWP 10R,015,886188,Staff,0,0,0,0
1746554557008,AWP 10R,016,886189,Staff,0,0,0,0
1746554557008,AWP 10R,017,960532,Staff,0,0,0,0
1746554557008,AWP 10R,018,960533,Staff,0,0,0,0
1746554557008,AWP 10R,019,960534,Staff,0,0,0,0
1746554557008,AWP 10R,020,960538,Staff,0,0,0,0
1746554557008,AWP 10R,021,960540,Staff,0,0,0,0
1746554557008,AWP 10R,022,960541,Staff,0,0,0,0
1746554557008,AWP 10R,023,960542,Staff,0,0,0,0
1746554557008,AWP 10R,024,960544,Staff,0,0,0,0
1746554557008,AWP 10R,025,960545,Staff,0,0,0,0
1746554557008,AWP 10R,026,960548,Staff,0,0,0,0
1746554558034,AWP 102R,A00,886190,Staff,0,0,0,0
1746554558034,AWP 102R,B00,886191,Staff,0,0,0,0
1746554559059,BENG 100,A01,886193,Staff,17,0,30,13
1746554560084,BENG 122A,A01,886195,Hasty; Jeff M,13,0,30,17
1746554561113,BENG 166A,A00,886196,Sah; Robert Lie-Yuan,0,2,30,30
1746554562140,BENG 190,A00,958050,Khojah; Reem I,24,0,25,1
1746554563167,BIBC 102,A01,894320,Staff,0,0,46,46
1746554563167,BIBC 102,A02,894321,Staff,0,0,46,46
1746554563167,BIBC 102,A03,894344,Staff,7,0,46,39
1746554563167,BIBC 102,A04,894345,Staff,26,0,47,21
1746554564193,BICD 100R,A01,894365,Smith; Laurie,0,4,58,58
1746554564193,BICD 100R,A02,894366,Smith; Laurie,0,5,58,58
1746554564193,BICD 100R,A03,894367,Smith; Laurie,2,0,59,57
1746554564193,BICD 100R,A04,959869,Smith; Laurie,41,0,59,18
1746554565222,BICD 136,A01,894383,Gustafson-Brown; Cindy,14,0,50,36
1746554566301,BIEB 102,A01,894494,Butler; Shannon Rhey,51,0,130,79
1746554568356,BIEB 150,A01,894617,Wills; Christopher,3,0,20,17
1746554568356,BIEB 150,A02,894631,Wills; Christopher,3,0,20,17
1746554568356,BIEB 150,A03,894937,Wills; Christopher,3,0,20,17
1746554568356,BIEB 150,A04,894946,Wills; Christopher,5,0,20,15
1746554569384,BIEB 194,A00,906141,Kurle; Carolyn M.,6,0,20,14
1746554570408,BILD 1,A01,894154,Staff,3,0,19,16
1746554570408,BILD 1,A02,894155,Staff,14,0,19,5
1746554570408,BILD 1,A03,894160,Staff,13,0,19,6
1746554570408,BILD 1,A04,894161,Staff,15,0,18,3
1746554571437,BILD 2,A01,894168,Staff,0,0,50,50
1746554571437,BILD 2,A02,894169,Staff,0,0,50,50
1746554571437,BILD 2,A03,894179,Staff,2,0,50,48
1746554571437,BILD 2,A04,894203,Staff,27,0,50,23
1746554572461,BILD 3,A01,894213,Staff,22,0,31,9
1746554572461,BILD 3,A02,894214,Staff,26,0,31,5
1746554572461,BILD 3,A03,894235,Staff,28,0,31,3
1746554572461,BILD 3,A04,894236,Staff,28,0,32,4
1746554573487,BILD 4,A01,894253,Reuther; Keefe,5,0,24,19
1746554573487,BILD 4,A02,894258,Reuther; Keefe,16,0,24,8
1746554574512,BILD 5,A01,894276,Reuther; Keefe,35,0,50,15
1746554574512,BILD 5,A02,894277,Reuther; Keefe,45,0,50,5
1746554574512,BILD 5,A03,894290,Reuther; Keefe,44,0,50,6
1746554574512,BILD 5,A04,894291,Reuther; Keefe,48,0,50,2
1746554575539,BILD 24,A01,894297,Pirino; Giorgia,40,0,60,20
1746554576563,BIMM 100,B01,958915,Staff,72,0,100,28
1746554577592,BIMM 101,A01,895017,McDonnell; Lisa Marie,0,5,24,24
1746554577592,BIMM 101,A02,895018,McDonnell; Lisa Marie,0,5,24,24
1746554577592,BIMM 101,B01,895020,McDonnell; Lisa Marie,0,6,24,24
1746554577592,BIMM 101,B02,895021,McDonnell; Lisa Marie,0,4,24,24
1746554578617,BIMM 110,A01,895023,Staff,1,0,25,24
1746554578617,BIMM 110,A02,895024,Staff,9,0,25,16
1746554578617,BIMM 110,A03,895025,Staff,18,0,25,7
1746554578617,BIMM 110,A04,895031,Staff,20,0,25,5
1746554579642,BIMM 120,A01,895114,Gustafson-Brown; Cindy,14,0,28,14
1746554579642,BIMM 120,A02,895126,Gustafson-Brown; Cindy,21,0,27,6
1746554580672,BIPN 100,A01,895130,Yang; Mingyu,1,0,38,37
1746554580672,BIPN 100,A02,895131,Yang; Mingyu,32,0,38,6
1746554580672,BIPN 100,A03,895132,Yang; Mingyu,32,0,38,6
1746554580672,BIPN 100,A04,895133,Yang; Mingyu,27,0,36,9
1746554581698,BIPN 120,A01,895135,Cooke; James Edward,0,3,13,13
1746554581698,BIPN 120,A02,895136,Cooke; James Edward,0,1,13,13
1746554581698,BIPN 120,A03,895137,Cooke; James Edward,0,3,13,13
1746554581698,BIPN 120,A04,895156,Cooke; James Edward,0,2,11,11
1746554582728,BIPN 134,A01,895235,Cooke; James Edward,0,2,25,25
1746554582728,BIPN 134,A02,895237,Cooke; James Edward,0,0,25,25
1746554582728,BIPN 134,A03,895240,Cooke; James Edward,3,0,25,22
1746554582728,BIPN 134,A04,895270,Cooke; James Edward,20,0,25,5
1746554583756,BIPN 189,A00,892103,Staff,0,13,14,14
1746554585804,BISP 194,A00,958008,Staff,0,2,0,0
1746554586831,CAT 124,A01,922009,Staff,0,5,20,20
1746554587862,CAT 125R,A00,886390,Morales; Celeste Georgianna,0,2,20,20
1746554587862,CAT 125R,B00,886391,Irwin; Matthew Joseph,0,3,20,20
1746554587862,CAT 125R,C00,886392,Smith; Lauryn Alissa,0,2,20,20
1746554587862,CAT 125R,D00,886393,Vanderschuit; Maya Alysia,0,2,20,20
1746554587862,CAT 125R,E00,886394,Marchisotto; Jennifer Anne,0,4,20,20
1746554588888,CENG 15,A01,886218,Drews; Aaron,3,0,8,5
1746554589917,CENG 113,A00,886219,Opatkiewicz; Justin Paul,15,0,25,10
1746554590945,CGS 101,A00,887044,Staff,7,0,20,13
1746554591969,CGS 105,A01,887046,Staff,14,0,25,11
1746554592995,CGS 112,A00,887047,Cuong; Marisol,12,0,15,3
1746554594022,CGS 113,A00,887048,Staff,23,0,30,7
1746554595047,CGS 120,A00,887049,Staff,10,0,17,7
1746554596075,CHEM 6A,A01,886336,Lam; Tin Yiu,38,0,50,12
1746554596075,CHEM 6A,A02,886338,Lam; Tin Yiu,37,0,50,13
1746554597101,CHEM 6B,A01,886341,Hopkins; Patrycja Anna,16,0,50,34
1746554597101,CHEM 6B,A02,886343,Hopkins; Patrycja Anna,42,0,50,8
1746554598128,CHEM 6C,A01,886346,Albizati; Kim F.,0,2,50,50
1746554598128,CHEM 6C,A02,886348,Albizati; Kim F.,23,0,50,27
1746554599155,CHEM 40A,A01,886352,Klosterman; Jeremy K,65,0,100,35
1746554600180,CHEM 40B,A01,886356,Klosterman; Jeremy K,0,23,100,100
1746554601207,CHEM 41B,A01,886360,Theodorakis; Emmanuel,25,0,50,25
1746554601207,CHEM 41B,A02,886362,Theodorakis; Emmanuel,47,0,50,3
1746554602235,CHIN 165A,A00,886382,Xu; Li,18,0,20,2
1746554603262,CLAS 120,A00,886387,Myerston Santana; Jacobo,33,0,40,7
1746554604289,COGS 9,A01,886967,Shannon; Kyle Michael,42,0,60,18
1746554605313,COGS 11,A01,886969,Staff,11,0,30,19
1746554606341,COGS 14A,A01,886971,Staff,6,0,60,54
1746554607366,COGS 14B,A01,886973,Hoffman; Drew Ellen,4,0,60,56
1746554608390,COGS 18,A01,886975,Morgan; Eric,35,0,60,25
1746554609416,COGS 20,A01,886977,Staff,4,0,8,4
1746554609416,COGS 20,A02,886978,Staff,5,0,7,2
1746554610441,COGS 100,A01,907783,Staff,0,2,30,30
1746554611466,COGS 101B,A01,886980,Staff,0,3,48,48
1746554612490,COGS 101C,A01,886982,Delgado; Tania,0,5,44,44
1746554613518,COGS 102A,A01,886984,Johnson; Christine M.,4,0,30,26
1746554614542,COGS 118B,A01,886986,Staff,0,3,88,88
1746554615567,COGS 150,A01,886988,Bergen; Benjamin,23,0,50,27
1746554616591,COGS 153,A00,886989,Delgado; Tania,0,2,41,41
1746554617615,COGS 186,A01,886991,Staff,0,0,32,32
1746554618644,COGS 187A,A01,886993,Boyle; Mary E. T.,7,0,30,23
1746554619671,COGS 189,A00,886994,Staff,0,1,30,30
1746554620695,COMM 10,A01,886996,Staff,0,0,20,21
1746554620695,COMM 10,A02,886997,Staff,12,0,20,8
1746554620695,COMM 10,A03,959845,Staff,19,0,20,1
1746554621724,COMM 20,A01,886999,Leuning; Grant Maurstad,24,0,40,16
1746554623774,COMM 100A,A01,887002,Staff,0,0,20,25
1746554623774,COMM 100A,A02,887003,Staff,7,0,20,13
1746554624798,COMM 100B,A01,887005,Staff,0,8,20,24
1746554625822,COMM 106D,A00,887006,Staff,14,0,40,26
1746554626846,COMM 110G,A00,887007,Whitworth-Smith; Andrew C,12,0,40,28
1746554627874,COMM 111B,A00,887008,Staff,31,0,40,9
1746554628903,COMM 113T,A00,887009,Abuelhiga; Soraya Jill,28,0,40,12
1746554628903,COMM 113T,B00,906733,Staff,40,0,40,0
1746554629930,COMM 145,A00,887010,Staff,12,0,40,28
1746554630955,COMM 146,A00,887054,Staff,31,0,40,9
1746554631982,COMM 190,A00,887012,Staff,8,0,23,15
1746554633008,CSE 8A,A50,887015,Cao; Yingjun,57,0,85,28
1746554634036,CSE 11,A01,887017,Cao; Yingjun,12,0,70,58
1746554635060,CSE 20,A01,887019,Staff,30,0,50,20
1746554636089,CSE 21,A01,887021,Staff,78,0,100,22
1746554636089,CSE 21,B01,892583,Braun; Oliver,45,0,50,5
1746554637114,CSE 30,A01,887025,Eldon; John,143,0,200,57
1746554638139,CSE 100,A01,887027,Staff,25,0,50,25
1746554638139,CSE 100,A02,887028,Staff,42,0,50,8
1746554639165,CSE 101,A01,887030,Braun; Oliver,74,0,100,26
1746554639165,CSE 101,B01,887032,Jones; Miles E,0,3,50,50
1746554639165,CSE 101,B02,887033,Jones; Miles E,0,1,50,50
1746554640189,CSE 105,A01,908084,Jones; Miles E,32,0,50,18
1746554640189,CSE 105,A02,908087,Jones; Miles E,32,0,50,18
1746554641218,CSE 135,A01,887035,Powell; Thomas Allan,0,4,50,50
1746554642245,CSE 142,A01,887037,Staff,8,0,60,52
1746554643271,CSE 142L,A01,887039,Staff,34,0,60,26
1746554644298,CSE 151A,A01,887041,Solares; Edwin A,47,0,100,53
1746554645323,CSE 175,A01,887043,Kumar; Rakesh,30,0,30,0
1746554646353,CSS 1,A01,886389,Staff,0,1,40,40
1746554647383,DSC 30,A01,908097,Liao; Soohyun Nam,47,0,75,28
1746554648410,DSC 40A,A01,908099,Shannon; Kyle Michael,30,0,50,20
1746554649436,DSC 40B,A01,908112,Staff,16,0,50,34
1746554650462,DSC 80,A01,908116,Staff,19,0,60,41
1746554651486,DSC 197,001,956863,Eldridge; Justin Matthew,9999,0,9999,0
1746554652516,ECE 5,A01,886400,Morris; Karcher William,2,0,6,4
1746554652516,ECE 5,A02,886401,Morris; Karcher William,3,0,6,3
1746554653542,ECE 148,A01,886403,Silberman; Jack,0,14,14,14
1746554654571,ECON 1,A01,887265,Crane; Meredith Helen,12,0,70,58
1746554654571,ECON 1,B01,887268,Staff,43,0,50,7
1746554655600,ECON 2,A01,887273,Crane; Meredith Helen,56,0,70,14
1746554656627,ECON 3,A01,887279,Rondina; Giacomo,32,0,70,38
1746554657653,ECON 4,A01,887282,Anderson; John Charles,0,2,10,10
1746554658677,ECON 5,A01,887285,Staff,33,0,45,12
1746554658677,ECON 5,B01,887292,Staff,41,0,45,4
1746554659705,ECON 100A,A01,887337,Newhouse; Herbert S,54,0,70,16
1746554659705,ECON 100A,B01,887349,Staff,45,0,50,5
1746554660730,ECON 100B,A01,887361,Du; Songzi,29,0,70,41
1746554661758,ECON 100C,A01,887445,Newhouse; Herbert S,59,0,70,11
1746554662783,ECON 105,A00,887488,Vespa; Emanuel Ignacio,23,0,35,12
1746554663812,ECON 109,A01,887506,Shishkin; Denis,28,0,35,7
1746554664841,ECON 110A,A01,887568,Alon; Titan Michael,0,3,35,35
1746554664841,ECON 110A,B01,907601,Alon; Titan Michael,20,0,35,15
1746554665867,ECON 110B,A01,887598,Levkoff; Steven B.,0,23,70,70
1746554666892,ECON 112,A00,887599,Rondina; Giacomo,19,0,35,16
1746554667917,ECON 120A,A01,887603,Dai; Yinlin,36,0,70,34
1746554668942,ECON 120C,A01,887608,Sun; Yixiao,0,1,35,35
1746554668942,ECON 120C,B01,887614,Sun; Yixiao,0,0,35,35
1746554670009,ECON 138,A00,887621,Bharadwaj; Prashant,0,21,20,20
1746554671037,ECON 144,A00,958007,Squires; Dale E,13,0,35,22
1746554672062,ECON 171,A01,907666,Staff,18,0,35,17
1746554673086,ECON 175,A00,887626,Wu; Pak Yeung,23,0,35,12
1746554674114,ECON 190,A00,887640,Vespa; Emanuel Ignacio,23,0,35,12
1746554675145,EDS 25,A01,888197,Staff,0,0,0,0
1746554675145,EDS 25,A02,888209,Staff,0,0,0,0
1746554675145,EDS 25,A03,888210,Staff,0,0,0,0
1746554675145,EDS 25,A04,888212,Staff,0,0,0,0
1746554675145,EDS 25,A05,888213,Staff,0,0,0,0
1746554675145,EDS 25,A06,888214,Staff,0,0,0,0
1746554675145,EDS 25,A07,888235,Staff,0,2,0,0
1746554675145,EDS 25,A08,888236,Staff,0,0,0,0
1746554675145,EDS 25,A09,888240,Staff,0,0,0,0
1746554675145,EDS 25,A10,888244,Staff,0,0,0,0
1746554675145,EDS 25,B01,888273,Staff,0,0,0,0
1746554675145,EDS 25,B02,888285,Staff,0,0,0,0
1746554675145,EDS 25,B03,888423,Staff,0,0,0,1
1746554675145,EDS 25,B04,888432,Staff,0,0,0,0
1746554675145,EDS 25,B05,888433,Staff,0,0,0,0
1746554675145,EDS 25,B06,888467,Staff,0,0,0,0
1746554675145,EDS 25,B07,888468,Staff,0,0,0,0
1746554675145,EDS 25,B08,888479,Staff,0,0,0,0
1746554675145,EDS 25,B09,888484,Staff,0,0,0,0
1746554675145,EDS 25,B10,888487,Staff,0,0,0,0
1746554676170,EDS 38,A01,907700,Choi; Bailey Miyeon,30,0,30,0
1746554677195,EDS 112,A01,888601,Chapman; Thandeka K,14,0,40,26
1746554678221,EDS 115,A00,888697,Mendez; Kathrina Mendoza,10,0,30,20
1746554679248,EDS 116,A01,888893,Staff,35,0,40,5
1746554681297,EDS 124AR,A00,889133,Staff,29,0,50,21
1746554681297,EDS 124AR,B00,907471,Simon; Elizabeth A,37,0,50,13
1746554682321,EDS 124BR,A00,889134,Simon; Elizabeth A,45,0,100,55
1746554683406,EDS 125,A00,889135,Staff,25,0,30,5
1746554684431,EDS 126,A01,889138,Staff,36,0,40,4
1746554685455,EDS 164R,A01,889142,Wishard Guerra; Alison G.,33,0,50,17
1746554686481,ENG 30,A01,886396,Staff,0,0,0,0
1746554686481,ENG 30,B01,886398,Staff,0,0,0,0
1746554687509,ENVR 102,A00,906150,Montejo; Carolina,23,0,25,2
1746554688534,ETHN 103A,A00,887236,Man; Simeon S,0,3,0,0
1746554689559,ETHN 113,A00,887239,Staff,16,0,30,14
1746554690586,ETHN 116,A00,887240,Staff,16,0,25,9
1746554691614,ETHN 117,A00,887241,Choi; Esther Min,28,0,30,2
1746554692639,ETHN 118,A00,887243,Staff,24,0,30,6
1746554693666,ETHN 127,A00,887248,Cuong; Marisol,11,0,15,4
1746554694692,ETHN 139,A00,887250,Staff,7,0,10,3
1746554695716,ETHN 142,A00,887252,Staff,10,0,30,20
1746554696744,ETHN 161,A00,887253,Browne; Errol Tsekani,24,0,30,6
1746554697769,ETHN 163FR,A00,887255,Burelle; Julie Sara Veronique,0,0,5,5
1746554698794,GLBH 20,A00,889149,Elwardani; Nile Regina,8,0,42,34
1746554700842,GLBH 111,A01,889152,Burgos; Jose L.,17,0,17,0
1746554701870,GLBH 150,A00,889181,Sloane; Julia Kathryn,0,5,15,15
1746554703929,HDS 60,A01,886406,Warstadt; Melissa Fawn,73,0,80,7
1746554704953,HIAF 111,A00,889324,Gyamfi; Bright,25,0,32,7
1746554705976,HIEA 131,A00,889328,Staff,16,0,32,16
1746554707006,HIEA 144,A00,889333,Henry; Todd A.,26,0,32,6
1746554708030,HIEA 154,A00,889336,Henry; Todd A.,24,0,32,8
1746554709056,HIEU 106,A00,889339,Staff,22,0,32,10
1746554711106,HIEU 114,A00,889340,Staff,3,0,32,29
1746554712133,HIEU 135GS,A00,889342,Patterson; Patrick H.,0,0,1,24
1746554713157,HIEU 137,A00,889343,Edington; Claire Ellen,9,0,25,16
1746554714183,HIEU 148,A00,889345,Staff,14,0,32,18
1746554715208,HIEU 154,A00,889346,Biess; Frank Peter,21,0,32,11
1746554716233,HILA 102,A00,889351,Staff,12,0,32,20
1746554717257,HILD 2A,A01,889221,Lewandoski; Julia Mavis,1,10,32,31
1746554718283,HILD 7B,A01,889225,Man; Simeon S,0,13,32,32
1746554719308,HILD 7C,A01,889288,Alvarez; Luis A,0,14,32,32
1746554720334,HILD 30,A01,889323,Staff,0,5,32,32
1746554722382,HISC 119,A00,889383,Golan; Tal,20,0,32,12
1746554723410,HIUS 103,A00,889384,Man; Simeon S,0,0,32,32
1746554724436,HIUS 117,A00,919797,Kwak; Nancy,18,0,32,14
1746554725462,HIUS 142A,A00,919788,Staff,22,0,32,10
1746554727514,HIUS 149,A00,889386,Gyamfi; Bright,27,0,32,5
1746554728539,HIUS 155,A00,889387,Alvarez; Luis A,14,0,32,18
1746554729564,HUM 3,A01,886499,Caldwell; Michael Alan,19,0,50,31
1746554730589,HUM 3GS,A00,886500,Rodriguez; Bretton Sigfred,0,0,0,28
1746554731614,HUM 3R,A01,886502,Markman; Kristina,0,36,50,50
1746554732642,HUM 4,A01,886504,Crum; Matthew Stephen,24,0,50,26
1746554732642,HUM 4,B01,886506,West; Geoffrey Scott,17,0,50,33
1746554733667,HUM 4GS,A00,886507,Staff,0,0,0,19
1746554734690,HUM 5,A01,886509,Staff,32,0,50,18
1746554735716,HUM 5R,A01,886511,Zavodny; Tatiana Sophia,0,39,50,50
1746554736741,JAPN 180,A00,886407,Staff,17,0,40,23
1746554737770,LATI 50,A01,886409,Martin-Cabrera; Luis,4,0,22,18
1746554737770,LATI 50,A02,886410,Martin-Cabrera; Luis,19,0,22,3
1746554737770,LATI 50,A03,886411,Martin-Cabrera; Luis,21,0,22,1
1746554737770,LATI 50,A04,886412,Martin-Cabrera; Luis,9,0,22,13
1746554738796,LAWS 101,A00,907664,Staff,28,0,60,32
1746554739823,LIAB 1A,A00,889388,Saab; Dima,17,0,20,3
1746554740849,LIAB 1AX,A00,889389,El Cheddadi; Youniss,17,0,20,3
1746554741873,LIFR 1C,A00,889391,Van Moer; Vinciane G,8,0,20,12
1746554742900,LIFR 1CX,A00,889392,Van Moer; Vinciane G,7,0,20,13
1746554743925,LIFR 1D,A00,889393,Van Moer; Vinciane G,7,0,20,13
1746554744950,LIFR 1DX,A00,889394,Van Moer; Vinciane G,8,0,20,12
1746554745978,LIGN 7,A00,886923,Staff,24,0,50,26
1746554747008,LIGN 17,A00,886924,Kehler; Andrew Scott,125,0,150,25
1746554748033,LTAM 110,A00,889395,Staff,15,0,30,15
1746554749059,LTAM 110GS,A00,958010,Rodriguez; Bretton Sigfred,0,0,0,28
1746554750085,LTCH 101,A00,889397,Staff,23,0,25,2
1746554751111,LTCS 130,A00,889398,Staff,23,0,25,2
1746554752139,LTEA 138,A00,889399,Staff,24,0,40,16
1746554753166,LTEN 149,A00,889400,Wesling; Megan E.,0,3,25,25
1746554754192,LTEN 169,A00,889401,Staff,20,0,25,5
1746554755218,LTEN 180,A00,889402,Staff,10,0,15,5
1746554756246,LTEN 181,A00,889403,Staff,21,0,25,4
1746554757273,LTWL 100,A00,889404,Myerston Santana; Jacobo,3,0,25,22
1746554758299,LTWL 180GS,A00,889405,Staff,0,0,20,20
1746554759325,LTWL 181,A00,889406,Staff,17,0,25,8
1746554760355,LTWL 184,A00,889475,Mukherjee; Silpa,22,0,25,3
1746554761379,LTWR 102C,A00,889486,Staff,29,0,30,1
1746554762406,LTWR 115W,A00,889491,Staff,0,2,15,15
1746554763430,MAE 8,A01,886905,Staff,0,2,0,0
1746554764454,MAE 11,A00,886906,Bandaru; Prabhakar,0,7,50,50
1746554765479,MAE 20,A00,886907,Evdokimenko; Ekaterina,43,0,70,27
1746554766504,MAE 30B,A00,886909,Ghazinejad; Maziar,26,0,45,19
1746554767532,MAE 101B,A00,886910,Saintillan; David,29,0,45,16
1746554768556,MAE 105,A00,886911,Bandaru; Prabhakar,18,0,50,32
1746554769581,MAE 107,B00,958024,Staff,8,0,50,42
1746554770607,MAE 143B,A00,886913,Bewley; Thomas R,7,0,40,33
1746554771633,MAE 148,A01,886915,Silberman; Jack,0,3,14,14
1746554772660,MAE 160,A00,886916,Evdokimenko; Ekaterina,31,0,60,29
1746554773684,MATH 3C,A01,889681,Staff,0,3,30,30
1746554773684,MATH 3C,A02,960048,Staff,25,0,30,5
1746554774713,MATH 10A,A01,889760,Staff,26,0,30,4
1746554774713,MATH 10A,A02,889783,Staff,29,0,30,1
1746554775740,MATH 10B,A01,889785,Verstraete; Jacques Allan,2,0,35,33
1746554775740,MATH 10B,A02,889795,Verstraete; Jacques Allan,4,0,35,31
1746554775740,MATH 10B,B01,889797,Verstraete; Jacques Allan,3,0,35,32
1746554775740,MATH 10B,B02,889828,Verstraete; Jacques Allan,3,0,35,32
1746554776766,MATH 10C,A01,889849,Habib; Yousaf,8,0,30,22
1746554776766,MATH 10C,A02,889852,Habib; Yousaf,14,0,30,16
1746554776766,MATH 10C,A03,889853,Habib; Yousaf,22,0,30,8
1746554776766,MATH 10C,A04,889858,Habib; Yousaf,20,0,30,10
1746554776766,MATH 10C,B01,889861,Staff,1,0,30,29
1746554776766,MATH 10C,B02,889862,Staff,24,0,30,6
1746554776766,MATH 10C,B03,889863,Staff,27,0,30,3
1746554776766,MATH 10C,B04,889967,Staff,23,0,30,7
1746554777795,MATH 18,A01,889974,Staff,7,0,30,23
1746554777795,MATH 18,A02,889977,Staff,20,0,30,10
1746554777795,MATH 18,B01,889984,Hardiman; Liam,22,0,30,8
1746554777795,MATH 18,B02,889985,Hardiman; Liam,25,0,30,5
1746554778822,MATH 20A,A01,889990,Suk; Andrew Hoon,30,0,35,5
1746554779849,MATH 20B,A01,889993,Ohm; Ko Woon,22,0,30,8
1746554779849,MATH 20B,A02,889994,Ohm; Ko Woon,30,0,30,0
1746554779849,MATH 20B,B01,889996,Ohm; Ko Woon,21,0,30,9
1746554779849,MATH 20B,B02,889997,Ohm; Ko Woon,23,0,30,7
1746554780874,MATH 20C,A01,889999,Hammock; Frances H,17,0,30,13
1746554780874,MATH 20C,A02,890003,Hammock; Frances H,23,0,30,7
1746554780874,MATH 20C,B01,890006,Hammock; Frances H,3,0,30,27
1746554780874,MATH 20C,B02,890007,Hammock; Frances H,11,0,30,19
1746554781903,MATH 20D,A01,890011,Cheng; Hsiao-Bing,1,1,30,29
1746554781903,MATH 20D,A02,890012,Cheng; Hsiao-Bing,14,0,30,16
1746554781903,MATH 20D,B01,890016,Cheng; Hsiao-Bing,13,0,30,17
1746554781903,MATH 20D,B02,890017,Cheng; Hsiao-Bing,13,0,30,17
1746554782934,MATH 20E,A01,890026,Harel; Guershon,1,0,30,29
1746554782934,MATH 20E,A02,890029,Harel; Guershon,23,0,30,7
1746554782934,MATH 20E,B01,890033,Harel; Guershon,7,0,30,23
1746554782934,MATH 20E,B02,890101,Harel; Guershon,21,0,30,9
1746554783964,MATH 102,A01,890104,Staff,17,0,30,13
1746554783964,MATH 102,A02,890105,Staff,27,0,30,3
1746554784996,MATH 103B,A01,890116,Salehi Golsefidy; Alireza,3,0,30,27
1746554784996,MATH 103B,B01,890118,Staff,0,3,34,34
1746554786020,MATH 109,A01,890121,Aliabadi Sr.; Mohsen,1,0,30,29
1746554786020,MATH 109,B01,890124,Upadrashta; Pranav Kumar,18,0,30,12
1746554787047,MATH 120A,A01,890126,Eggers; John Dietrich,13,0,30,17
1746554788075,MATH 142B,A01,890128,Ioana; Adrian,19,0,30,11
1746554788075,MATH 142B,A02,890129,Ioana; Adrian,13,0,30,17
1746554789101,MATH 154,A01,890174,Staff,0,0,30,30
1746554789101,MATH 154,A02,890182,Staff,0,0,30,30
1746554790126,MATH 168A,A01,890197,Dumitriu; Ioana,21,0,35,14
1746554791153,MATH 170A,A01,890240,Nie; Jiawang,1,0,30,29
1746554791153,MATH 170A,A02,890241,Nie; Jiawang,11,0,30,19
1746554791153,MATH 170A,A03,890249,Nie; Jiawang,23,0,30,7
1746554792178,MATH 170B,A01,957891,Nag; Panchali,13,0,35,22
1746554794230,MATH 181A,A01,908025,Staff,0,4,35,35
1746554794230,MATH 181A,A02,960115,Staff,27,0,35,8
1746554795255,MATH 181B,A01,959874,Staff,25,0,30,5
1746554796283,MATH 193B,A01,890265,Staff,0,4,35,35
1746554797308,MGT 4,A01,890311,Anderson; John Charles,42,0,88,46
1746554798336,MGT 5,A00,907740,Staff,13,0,98,85
1746554799363,MGT 12,A00,890312,Lindenberger; Wade Douglas,67,0,98,31
1746554800390,MGT 16,A00,957883,Staff,78,0,98,20
1746554802446,MGT 45,A00,890314,Pecore; Joseph P.,47,0,98,51
1746554803475,MGT 71,A00,890315,Staff,0,11,98,98
1746554804499,MGT 100,A00,890316,Yavorsky; Daniel Ryan,44,0,98,54
1746554805528,MGT 103,A00,890317,Ehrich; Kristine R,73,0,98,25
1746554806554,MGT 105,A00,890356,Bates; Kenneth Walter,0,7,98,98
1746554807579,MGT 112,A00,890360,Ehrich; Kristine R,55,0,98,43
1746554808607,MGT 127R,A00,907732,Zhu; Kevin Xiaoguo,24,0,98,74
1746554809632,MGT 131B,A00,890361,Anderson; John Charles,60,0,98,38
1746554810661,MGT 137,A00,890362,Lindenberger; Wade Douglas,65,0,98,33
1746554811685,MGT 160,A00,890369,Johnson; Erik Barry,9,0,98,89
1746554813735,MGT 164,A00,890372,Zimmermann; Carsten,0,39,98,98
1746554814759,MGT 180,A00,890374,Bliss; Barbara Ann,12,0,98,86
1746554815784,MMW 15,A01,886414,Chang; Edmond Yi-Teh,0,12,28,28
1746554815784,MMW 15,A02,886415,Chang; Edmond Yi-Teh,0,8,28,28
1746554815784,MMW 15,A03,886416,Chang; Edmond Yi-Teh,0,8,28,28
1746554815784,MMW 15,A04,886417,Chang; Edmond Yi-Teh,0,8,28,28
1746554815784,MMW 15,B01,886419,Chang; Edmond Yi-Teh,0,7,28,28
1746554815784,MMW 15,B02,886420,Chang; Edmond Yi-Teh,0,8,28,28
1746554815784,MMW 15,B03,886421,Chang; Edmond Yi-Teh,0,7,28,28
1746554815784,MMW 15,B04,886422,Chang; Edmond Yi-Teh,0,8,28,28
1746554815784,MMW 15,C01,886424,Staff,0,9,28,28
1746554815784,MMW 15,C02,886425,Staff,0,8,28,28
1746554815784,MMW 15,C03,886426,Staff,0,8,28,28
1746554815784,MMW 15,C04,886427,Staff,0,8,28,28
1746554815784,MMW 15,C05,958038,Staff,0,7,28,28
1746554815784,MMW 15,C06,958039,Staff,0,8,28,28
1746554816810,MMW 15GS,A00,906910,Patterson; Patrick H.,4,0,28,24
1746554817834,MMW 122R,A01,886429,Rahimi; Babak,0,13,28,28
1746554817834,MMW 122R,A02,886430,Rahimi; Babak,0,12,28,28
1746554817834,MMW 122R,A03,958040,Rahimi; Babak,0,11,28,28
1746554818888,MUS 1A,A01,890937,Staff,2,0,25,23
1746554818888,MUS 1A,A02,891035,Staff,6,0,25,19
1746554818888,MUS 1A,C01,958912,Staff,24,0,25,1
1746554818888,MUS 1A,C02,958913,Staff,25,0,25,0
1746554820937,MUS 2AK,A00,957092,Ohnishi; Takae,15,0,15,0
1746554821963,MUS 4,A01,891044,Staff,2,0,25,23
1746554821963,MUS 4,A02,891045,Staff,23,0,25,2
1746554821963,MUS 4,B01,891048,Staff,17,0,25,8
1746554821963,MUS 4,B02,891050,Staff,25,0,25,0
1746554822987,MUS 5,A01,957506,Dubnov; Shlomo,0,0,25,25
1746554822987,MUS 5,A02,957622,Dubnov; Shlomo,13,0,25,12
1746554822987,MUS 5,A03,957623,Dubnov; Shlomo,20,0,25,5
1746554824013,MUS 6,A01,891053,Freitas Caetano; Marcelo,24,0,25,1
1746554824013,MUS 6,A02,891054,Freitas Caetano; Marcelo,23,0,25,2
1746554825041,MUS 7,A01,891081,Staff,0,0,25,25
1746554825041,MUS 7,A02,891082,Staff,4,0,25,21
1746554826068,MUS 8GS,A00,891118,Borgo; David Garcia,0,0,25,25
1746554827096,MUS 11,A01,891140,Staff,11,0,25,14
1746554827096,MUS 11,A02,891141,Staff,22,0,25,3
1746554828121,MUS 13,A01,891143,Staff,8,0,25,17
1746554828121,MUS 13,A02,891144,Staff,24,0,25,1
1746554829146,MUS 15,A01,891146,Staff,9,0,25,16
1746554829146,MUS 15,A02,891148,Staff,21,0,25,4
1746554829146,MUS 15,B01,891150,Staff,18,0,25,7
1746554829146,MUS 15,B02,891151,Staff,25,0,25,0
1746554830174,MUS 20,A01,891153,Staff,5,0,20,15
1746554830174,MUS 20,A02,891155,Staff,14,0,20,6
1746554831204,MUS 80,A00,891156,Staff,19,0,25,6
1746554831204,MUS 80,B00,891157,Staff,23,0,25,2
1746554832230,MUS 130,A00,891158,Ohnishi; Takae,35,0,35,0
1746554833255,MUS 150GS,A01,891160,Borgo; David Garcia,0,0,25,25
1746554834284,MUS 170,A01,891162,Freitas Caetano; Marcelo,20,0,25,5
1746554834284,MUS 170,A02,891164,Freitas Caetano; Marcelo,21,0,25,4
1746554835311,NANO 11,A00,886220,Vazquez Mena; Oscar,13,0,15,2
1746554836337,NANO 15,A01,886222,Drews; Aaron,4,0,7,3
1746554837362,NANO 104,A00,886224,Sirbuly; Donald,18,0,25,7
1746554838391,PH 40,A00,886528,Staff,23,0,40,17
1746554839416,PH 45,A01,886799,Staff,35,0,40,5
1746554840442,PH 110,A00,886802,Staff,0,7,40,40
1746554841469,PH 172,A00,906716,Staff,19,0,35,16
1746554842494,PH 191,A00,886803,Staff,6,0,40,34
1746554843519,PHIL 1,A00,889500,Staff,20,0,30,10
1746554844547,PHIL 10,A01,889549,Grush; Rick Scott,15,0,22,7
1746554844547,PHIL 10,A02,889551,Grush; Rick Scott,22,0,22,0
1746554845579,PHIL 28,A01,889559,Lamey; Andy M.,0,1,31,31
1746554845579,PHIL 28,A02,889561,Lamey; Andy M.,0,1,30,30
1746554845579,PHIL 28,A03,889572,Lamey; Andy M.,0,1,30,30
1746554846603,PHIL 35,A00,907839,Staff,13,0,15,2
1746554847631,PHIL 60,A00,889574,Staff,74,0,90,16
1746554848657,PHIL 101,A00,958004,Staff,12,0,15,3
1746554850706,PHIL 136,A00,889582,Fulkerson; Matthew Todd,26,0,45,19
1746554851735,PHIL 163,A01,889601,Staff,21,0,30,9
1746554851735,PHIL 163,B01,889606,Brandt; Reuven A,0,3,0,0
1746554852760,PHIL 164,A00,889610,Staff,16,0,30,14
1746554853785,PHIL 165,A00,889613,Staff,23,0,30,7
1746554854809,PHYS 1A,A00,886431,Staff,26,0,70,44
1746554855834,PHYS 1AL,001,886432,Tsai; Philbert S,0,2,30,30
1746554855834,PHYS 1AL,002,886436,Tsai; Philbert S,11,0,30,19
1746554856862,PHYS 1B,A00,886439,Staff,185,0,240,55
1746554857886,PHYS 1BL,001,886441,Tsai; Philbert S,0,4,30,30
1746554857886,PHYS 1BL,002,886444,Tsai; Philbert S,2,0,30,28
1746554858911,PHYS 1C,A00,896092,Arnold; Kam S,78,0,146,68
1746554859936,PHYS 1CL,001,886448,Tsai; Philbert S,0,0,30,30
1746554859936,PHYS 1CL,002,886449,Tsai; Philbert S,0,0,30,30
1746554859936,PHYS 1CL,003,886450,Tsai; Philbert S,16,0,30,14
1746554859936,PHYS 1CL,004,886451,Tsai; Philbert S,15,0,30,15
1746554860964,PHYS 2B,A01,886457,Staff,69,0,115,46
1746554861989,PHYS 2C,A01,886460,Shotwell; Brian,0,8,65,65
1746554863015,PHYS 2CL,A01,886467,Staff,0,4,28,28
1746554863015,PHYS 2CL,A02,886468,Staff,0,3,28,28
1746554864040,PHYS 2D,A01,886470,Staff,10,0,50,40
1746554865066,PHYS 4B,A01,886475,Grinstein; Benjamin,22,0,40,18
1746554866090,POLI 5,A00,891173,Desposato; Scott,7,0,25,18
1746554867115,POLI 5D,A01,891175,Staff,5,0,5,0
1746554867115,POLI 5D,B01,891178,Staff,5,0,5,0
1746554868141,POLI 11,A00,891179,Ferree; Karen E,2,0,35,33
1746554869168,POLI 12,A00,891180,Staff,16,0,30,14
1746554870193,POLI 27,A01,891182,Staff,12,0,75,63
1746554871221,POLI 30,A00,891183,Staff,8,0,50,42
1746554872246,POLI 100B,A00,891244,Staff,5,1,35,30
1746554873271,POLI 100I,A00,891247,Staff,7,0,30,23
1746554874297,POLI 104J,A00,891248,Nichter; Maysa,14,0,30,16
1746554875320,POLI 104U,A00,891250,Nichter; Maysa,2,0,30,28
1746554877372,POLI 110B,A00,891255,Wiens; David,20,0,25,5
1746554878398,POLI 112A,A00,891256,Wiens; David,6,0,25,19
1746554879423,POLI 114BR,A00,891261,Staff,19,0,30,11
1746554880450,POLI 117R,A00,891262,Forman; Fonna,0,6,50,50
1746554881476,POLI 118,A00,891264,Ingham; Sean,17,0,25,8
1746554882500,POLI 124A,A00,891265,Staff,18,0,20,2
1746554883526,POLI 125D,A00,891266,Nichter; Simeon C,2,0,25,23
1746554884554,POLI 126,A00,891268,Nichter; Simeon C,7,0,25,18
1746554885579,POLI 126AA,A00,891272,Staff,17,0,25,8
1746554886605,POLI 130AA,A00,891273,Staff,15,0,20,5
1746554887632,POLI 134AA,A00,891274,Staff,4,0,20,16
1746554889684,POLI 138,A00,891278,Staff,21,0,25,4
1746554890709,POLI 142K,A00,891280,Staff,11,0,25,14
1746554891734,POLI 142M,A00,891281,Gartzke; Erik,17,0,30,13
1746554892762,POLI 142P,A00,891284,Staff,20,0,30,10
1746554893787,POLI 143,A00,891285,Gartzke; Erik,12,0,30,18
1746554894811,POLI 153,A00,891286,Staff,19,0,20,1
1746554896863,POLI 175,A00,891290,Staff,15,0,20,5
1746554897888,PSYC 1,A00,890674,Steiner; Eric Tomas,0,11,45,45
1746554898912,PSYC 2,A00,890676,Albright; Thomas D,21,0,35,14
1746554899939,PSYC 3,A00,890679,Staff,17,0,20,3
1746554900969,PSYC 6,A00,959858,Staff,20,0,20,0
1746554901997,PSYC 60,A01,890684,Rickard; Timothy C.,0,5,45,45
1746554903023,PSYC 70,A01,890689,Geller; Emma Harlan,7,0,30,23
1746554904048,PSYC 71,A01,959860,Staff,21,0,25,4
1746554905075,PSYC 100,A00,890690,Lacefield; Katharine I,0,50,180,180
1746554906104,PSYC 102,A00,890695,Staff,18,0,40,22
1746554907130,PSYC 105,A00,890699,Geller; Emma Harlan,71,0,100,29
1746554908155,PSYC 106,A00,890701,Gorman; Michael R.,5,0,30,25
1746554909181,PSYC 108,A00,890704,Adrian; Julia Anna,0,28,50,50
1746554910209,PSYC 118,A01,890712,Staff,11,0,30,19
1746554911236,PSYC 124,A00,890716,Chapman; Eddie Nathaniel,25,0,60,35
1746554912263,PSYC 131,A00,890717,Anagnostaras; Stephan,0,7,80,80
1746554913289,PSYC 137,A00,890719,Winkielman; Piotr,0,11,30,30
1746554914313,PSYC 144,A00,890721,Adrian; Julia Anna,0,9,45,45
1746554915337,PSYC 162,A00,890805,Staff,2,0,75,73
1746554916364,PSYC 169,A00,890810,Staff,0,14,30,30
1746554917387,PSYC 172,A00,890814,Gorman; Michael R.,9,0,30,21
1746554918414,PSYC 181,A00,890818,Anagnostaras; Stephan,8,0,200,192
1746554919442,PSYC 184,A00,959861,Staff,170,0,175,5
1746554920467,PSYC 189,A00,890823,Staff,0,1,30,30
1746554921492,PSYC 191,A00,890884,Rickard; Timothy C.,0,11,35,35
1746554922518,PSYC 193,A00,890913,Staff,19,0,30,11
1746554922518,PSYC 193,B00,890914,Chapman; Eddie Nathaniel,24,0,30,6
1746554923548,PSYC 193L,A01,890918,Lowe; Angela Beth,20,0,30,10
1746554923548,PSYC 193L,B01,890921,Hurwitz; Ethan Scott,20,0,30,10
1746554923548,PSYC 193L,C01,890928,Staff,30,0,30,0
1746554924573,RELI 149,A00,886806,Rahimi; Babak,23,0,40,17
1746554925600,SE 9,A01,886814,Staff,7,0,20,13
1746554926629,SE 101B,A01,886816,Chadha; Mayank,4,0,35,31
1746554927659,SE 110B,A00,886818,Zhu; Qiang,4,0,75,71
1746554928683,SE 125,A01,886830,Staff,10,0,30,20
1746554929708,SE 130B,A01,886835,Staff,14,0,40,26
1746554930736,SE 131A,A01,886838,Krysl; Petr,34,0,55,21
1746554931762,SE 154,A00,886840,Staff,29,0,50,21
1746554932786,SE 164GS,A01,886849,Staff,6,0,20,14
1746554933811,SE 167GS,A01,886853,Staff,6,0,20,14
1746554934836,SIO 25,A01,890107,Staff,19,0,30,11
1746554935861,SIO 45,A00,890109,Cook; Geoffrey W,117,0,200,83
1746554936886,SIO 109R,A00,890110,Forman; Fonna,0,16,20,20
1746554937913,SIO 187,A01,890114,Kacev; David,15,0,40,25
1746554938938,SOCI 1,A01,890431,Thorpe; Charles Robert,15,0,30,15
1746554938938,SOCI 1,A02,890518,Thorpe; Charles Robert,30,0,30,0
1746554939963,SOCI 2,A01,957978,Staff,25,0,25,0
1746554939963,SOCI 2,A02,957979,Staff,23,0,25,2
1746554940991,SOCI 20,A01,890523,Calderon-Zaks; Michael Aar,23,0,30,7
1746554940991,SOCI 20,A02,890526,Calderon-Zaks; Michael Aar,29,0,30,1
1746554942015,SOCI 30,A01,890533,Pardo Guerra; Juan Pablo,37,0,40,3
1746554943040,SOCI 40,A01,890535,Staff,27,0,45,18
1746554944065,SOCI 104Q,A00,890559,Staff,18,0,30,12
1746554945091,SOCI 106,A00,890560,Arnal; Maud Marie Leonie,20,0,30,10
1746554946117,SOCI 110,A00,890567,Holkenbrink-Monk; Charlene,19,0,30,11
1746554947141,SOCI 112,A00,890568,Victoria Torres; Pablo,2,0,55,53
1746554948167,SOCI 115,A00,890597,Arnal; Maud Marie Leonie,28,0,45,17
1746554950223,SOCI 121,A00,890604,Pardo Guerra; Juan Pablo,38,0,45,7
1746554951246,SOCI 126,A01,890608,Staff,8,0,10,2
1746554952273,SOCI 127,A00,890609,Staff,18,0,30,12
1746554953301,SOCI 131,A00,890610,Thorpe; Charles Robert,37,0,45,8
1746554954326,SOCI 135,A00,890615,Payne; Christine Anna,14,0,45,31
1746554955351,SOCI 139,A00,890620,Staff,38,0,45,7
1746554956375,SOCI 148E,A00,890622,Calderon-Zaks; Michael Aar,36,0,45,9
1746554957401,SOCI 150,A00,890623,Kohler; Kristopher M.,31,0,45,14
1746554958427,SOCI 157,A00,890625,Jules-Rosette; Bennetta W.,18,0,20,2
1746554959453,SOCI 160,A00,890627,Payne; Christine Anna,21,0,45,24
1746554960478,SYN 1,A00,886855,Fish; Gwendolyn Anne,0,0,0,0
1746554960478,SYN 1,B00,906086,Fish; Gwendolyn Anne,0,1,0,2
1746554961503,SYN 2R,A00,886860,Staff,0,17,15,15
1746554961503,SYN 2R,B00,906106,Atkinson; Arthur Laird,0,16,15,15
1746554962534,SYN 100,A01,886866,Browne; Emily,0,28,20,20
1746554962534,SYN 100,B01,906128,Rock; Martin,0,5,20,20
1746554962534,SYN 100,C01,906140,Deavenport; James Cary,0,3,20,20
1746554962534,SYN 100,D01,907816,Deavenport; James Cary,0,5,20,20
1746554963558,TDAC 1,A00,890286,Walsh; Kim C.,9,0,20,11
1746554964586,TDAC 101,A00,890296,Basso; Beatrice,16,0,20,4
1746554965612,TDDE 131,A00,890297,Staff,47,0,50,3
1746554966640,TDDM 1,A00,890287,Weinberg; Sadie,25,0,30,5
1746554967668,TDGE 11,A00,890288,Fulton; Julia,137,0,200,63
1746554967668,TDGE 11,B00,890289,Castro; Robert Jess,184,0,200,16
1746554968695,TDGE 25,B00,957359,Walsh; Kim C.,3,0,20,17
1746554969721,TDGE 40,A01,890292,Power; Jade Yukana,27,0,30,3
1746554970750,TDGE 124,A00,890298,Havis; Allan,0,1,50,50
1746554971775,TDGE 131R,A00,890299,Burelle; Julie Sara Veronique,15,0,42,27
1746554972800,TDHT 101,A00,890300,Staff,10,0,20,10
1746554973824,TDHT 109,A01,890302,Anderson; Mysia Anyse,31,0,40,9
1746554974851,TDMV 1,A00,890293,Arcidiacono; Kristin,18,0,30,12
1746554975879,TDMV 2,A00,890294,Weinberg; Sadie,23,0,30,7
1746554976931,TDMV 3,A00,957878,Arcidiacono; Kristin,28,0,30,2
1746554978983,TDMV 138,A00,890304,Jun; Grace Shin Hae,25,0,40,15
1746554980013,TDMV 140,A00,890305,Corrales; Joseph Bernales,25,0,30,5
1746554981043,TDMV 142,A00,890307,Caligagan; Tony,32,0,40,8
1746554982069,TDMV 144,A00,890308,Camaya; Michelle Ann,25,0,30,5
1746554983098,TDPW 1,A00,890295,Stein; Deborah Isobel,3,0,20,17
1746554984126,USP 2,A01,890272,Lerner; Amy M,6,0,20,14
1746554985151,USP 3,A01,890274,Staff,12,0,30,18
1746554986179,USP 15,A01,890276,Sun; Feiyang,17,0,30,13
1746554987207,USP 25,A00,890277,Shenkman; Michael Thomas,19,0,25,6
1746554988230,USP 138,A00,890278,Staff,13,0,25,12
1746554989257,USP 143,A00,890279,Staff,21,0,70,49
1746554990281,USP 144,A00,890280,Chowdhury; Muhammed Zohir,16,0,30,14
1746554991311,USP 150,A00,890281,Boomhower; Matthew Charles,4,0,30,26
1746554992335,USP 151,A00,890282,Staff,16,0,20,4
1746554993361,USP 162,A00,890283,Andrews; Abigail Leslie,16,0,20,4
1746554994388,USP 168,A00,920477,Kwak; Nancy,1,0,5,4
1746554995617,USP 181,A00,890284,Staff,3,0,20,17
1746554996644,USP 191A,A00,890285,Staff,12,0,20,8
1746554997669,VIS 101,A00,886512,Staff,25,0,75,50
1746554998696,VIS 103,A00,886513,Cruz; Edwin Teddy,61,0,75,14
1746554999723,VIS 108,A00,886514,Staff,3,0,15,12
1746555000750,VIS 127P,A00,886515,Shen; Kuiyi,80,0,146,66
1746555001781,VIS 149,A00,886516,Yoldas; Pinar,0,0,15,15
1746555002810,VIS 164,A00,886526,Erdmann; Dean,19,0,22,3
1746555003839,VIS 194S,A00,886527,Staff,61,0,75,14
1746555004869,WCWP 10A,C00,886484,Martiniuk; Jill,12,0,15,3
1746555005898,WCWP 10B,A00,886490,Uriarte; Emma,0,0,15,15
1746555005898,WCWP 10B,B00,886491,Dhir; Simrita,10,0,15,5
1746555005898,WCWP 10B,C00,886492,Ornelas; Tricia,0,0,15,15
1746555006923,WCWP 100,A00,886494,Young; Mark T,0,6,15,15
1746555009085,AAS 10,A01,886199,Childs; Dennis R.,0,3,0,0
1746555010110,ANAR 104,A01,886940,Shtienberg; Gilad,27,0,30,3
1746555011134,ANAR 120,A00,886953,Staff,12,0,20,8
1746555012160,ANBI 148,A01,886955,Wilder; Linnea Lorene,30,0,40,10
1746555014209,ANSC 122,A00,886957,Staff,25,0,30,5
1746555015234,ANSC 150,A00,886958,Sloane; Julia Kathryn,2,0,15,13
1746555016259,ANSC 156,A00,886959,Jenkins; Janis A.,0,1,15,15
1746555017288,ANSC 180,A00,886960,Staff,11,0,17,6
1746555018317,ANSC 188,A00,886961,Jassal; Aftab,9,0,25,16
1746555019356,ANSC 190,A00,886962,Jassal; Aftab,14,0,25,11
1746555020382,ANSC 191,A00,886963,Staff,18,0,20,2
1746555021408,ANTH 3,A01,891689,Staff,17,0,20,3
1746555022435,ANTH 5,A00,886933,Semendeferi; Ekaterini,16,0,20,4
1746555023462,ANTH 10,A00,886934,Staff,0,12,30,30
1746555024490,ANTH 21,A01,886936,Staff,40,0,60,20
1746555025515,ANTH 23,A01,886938,Staff,92,0,100,8
1746555026540,ANTH 105,A00,886964,Stewart; Alexander B,84,0,100,16
1746555027569,ANTH 108,A00,886965,Pedersen; David,9,0,20,11
1746555028596,AWP 10,001,886147,Staff,0,0,0,0
1746555028596,AWP 10,002,886148,Staff,0,0,0,0
1746555028596,AWP 10,003,886149,Staff,0,0,0,0
1746555028596,AWP 10,004,886150,Staff,0,0,0,0
1746555028596,AWP 10,005,886151,Staff,0,0,0,0
1746555028596,AWP 10,006,886152,Staff,0,0,0,0
1746555028596,AWP 10,007,886153,Staff,0,0,0,0
1746555028596,AWP 10,008,886154,Staff,0,0,0,0
1746555028596,AWP 10,009,886155,Staff,0,0,0,0
1746555028596,AWP 10,010,886156,Staff,0,0,0,0
1746555028596,AWP 10,011,886158,Staff,0,0,0,0
1746555028596,AWP 10,012,886160,Staff,0,0,0,0
1746555028596,AWP 10,013,886161,Staff,0,0,0,0
1746555028596,AWP 10,014,886162,Staff,0,0,0,0
1746555028596,AWP 10,015,886163,Staff,0,0,0,0
1746555028596,AWP 10,016,886164,Staff,0,0,0,0
1746555028596,AWP 10,017,886165,Staff,0,0,0,0
1746555028596,AWP 10,018,886166,Staff,0,0,0,0
1746555028596,AWP 10,019,886168,Staff,0,0,0,0
1746555028596,AWP 10,020,886170,Staff,0,0,0,0
1746555028596,AWP 10,021,886172,Staff,0,0,0,0
1746555029623,AWP 10R,001,886173,Staff,0,1,0,0
1746555029623,AWP 10R,002,886174,Staff,0,1,0,0
1746555029623,AWP 10R,003,886175,Staff,0,0,0,0
1746555029623,AWP 10R,004,886176,Staff,0,0,0,0
1746555029623,AWP 10R,005,886177,Staff,0,0,0,0
1746555029623,AWP 10R,006,886178,Staff,0,0,0,0
1746555029623,AWP 10R,007,886179,Staff,0,0,0,0
1746555029623,AWP 10R,008,886181,Staff,0,0,0,0
1746555029623,AWP 10R,009,886182,Staff,0,0,0,0
1746555029623,AWP 10R,010,886183,Staff,0,0,0,0
1746555029623,AWP 10R,011,886184,Staff,0,0,0,0
1746555029623,AWP 10R,012,886185,Staff,0,0,0,0
1746555029623,AWP 10R,013,886186,Staff,0,0,0,0
1746555029623,AWP 10R,014,886187,Staff,0,0,0,0
1746555029623,AWP 10R,015,886188,Staff,0,0,0,0
1746555029623,AWP 10R,016,886189,Staff,0,0,0,0
1746555029623,AWP 10R,017,960532,Staff,0,0,0,0
1746555029623,AWP 10R,018,960533,Staff,0,0,0,0
1746555029623,AWP 10R,019,960534,Staff,0,0,0,0
1746555029623,AWP 10R,020,960538,Staff,0,0,0,0
1746555029623,AWP 10R,021,960540,Staff,0,0,0,0
1746555029623,AWP 10R,022,960541,Staff,0,0,0,0
1746555029623,AWP 10R,023,960542,Staff,0,0,0,0
1746555029623,AWP 10R,024,960544,Staff,0,0,0,0
1746555029623,AWP 10R,025,960545,Staff,0,0,0,0
1746555029623,AWP 10R,026,960548,Staff,0,0,0,0
1746555030650,AWP 102R,A00,886190,Staff,0,0,0,0
1746555030650,AWP 102R,B00,886191,Staff,0,0,0,0
1746555031674,BENG 100,A01,886193,Staff,17,0,30,13
1746555032700,BENG 122A,A01,886195,Hasty; Jeff M,13,0,30,17
1746555033725,BENG 166A,A00,886196,Sah; Robert Lie-Yuan,0,2,30,30
1746555034754,BENG 190,A00,958050,Khojah; Reem I,23,0,25,2
1746555035781,BIBC 102,A01,894320,Staff,0,0,46,46
1746555035781,BIBC 102,A02,894321,Staff,0,0,46,46
1746555035781,BIBC 102,A03,894344,Staff,7,0,46,39
1746555035781,BIBC 102,A04,894345,Staff,26,0,47,21
1746555036807,BICD 100R,A01,894365,Smith; Laurie,0,4,58,58
1746555036807,BICD 100R,A02,894366,Smith; Laurie,0,5,58,58
1746555036807,BICD 100R,A03,894367,Smith; Laurie,2,0,59,57
1746555036807,BICD 100R,A04,959869,Smith; Laurie,41,0,59,18
1746555037834,BICD 136,A01,894383,Gustafson-Brown; Cindy,14,0,50,36
1746555038865,BIEB 102,A01,894494,Butler; Shannon Rhey,51,0,130,79
1746555040917,BIEB 150,A01,894617,Wills; Christopher,3,0,20,17
1746555040917,BIEB 150,A02,894631,Wills; Christopher,3,0,20,17
1746555040917,BIEB 150,A03,894937,Wills; Christopher,3,0,20,17
1746555040917,BIEB 150,A04,894946,Wills; Christopher,5,0,20,15
1746555041942,BIEB 194,A00,906141,Kurle; Carolyn M.,6,0,20,14
1746555042965,BILD 1,A01,894154,Staff,3,0,19,16
1746555042965,BILD 1,A02,894155,Staff,14,0,19,5
1746555042965,BILD 1,A03,894160,Staff,13,0,19,6
1746555042965,BILD 1,A04,894161,Staff,15,0,18,3
1746555043992,BILD 2,A01,894168,Staff,0,0,50,50
1746555043992,BILD 2,A02,894169,Staff,0,0,50,50
1746555043992,BILD 2,A03,894179,Staff,2,0,50,48
1746555043992,BILD 2,A04,894203,Staff,27,0,50,23
1746555045021,BILD 3,A01,894213,Staff,22,0,31,9
1746555045021,BILD 3,A02,894214,Staff,26,0,31,5
1746555045021,BILD 3,A03,894235,Staff,28,0,31,3
1746555045021,BILD 3,A04,894236,Staff,28,0,32,4
1746555046047,BILD 4,A01,894253,Reuther; Keefe,5,0,24,19
1746555046047,BILD 4,A02,894258,Reuther; Keefe,16,0,24,8
1746555047072,BILD 5,A01,894276,Reuther; Keefe,35,0,50,15
1746555047072,BILD 5,A02,894277,Reuther; Keefe,45,0,50,5
1746555047072,BILD 5,A03,894290,Reuther; Keefe,44,0,50,6
1746555047072,BILD 5,A04,894291,Reuther; Keefe,48,0,50,2
1746555048099,BILD 24,A01,894297,Pirino; Giorgia,40,0,60,20
1746555049130,BIMM 100,B01,958915,Staff,72,0,100,28
1746555050157,BIMM 101,A01,895017,McDonnell; Lisa Marie,0,5,24,24
1746555050157,BIMM 101,A02,895018,McDonnell; Lisa Marie,0,5,24,24
1746555050157,BIMM 101,B01,895020,McDonnell; Lisa Marie,0,6,24,24
1746555050157,BIMM 101,B02,895021,McDonnell; Lisa Marie,0,4,24,24
1746555051183,BIMM 110,A01,895023,Staff,1,0,25,24
1746555051183,BIMM 110,A02,895024,Staff,9,0,25,16
1746555051183,BIMM 110,A03,895025,Staff,18,0,25,7
1746555051183,BIMM 110,A04,895031,Staff,20,0,25,5
1746555052210,BIMM 120,A01,895114,Gustafson-Brown; Cindy,14,0,28,14
1746555052210,BIMM 120,A02,895126,Gustafson-Brown; Cindy,21,0,27,6
1746555053238,BIPN 100,A01,895130,Yang; Mingyu,1,0,38,37
1746555053238,BIPN 100,A02,895131,Yang; Mingyu,32,0,38,6
1746555053238,BIPN 100,A03,895132,Yang; Mingyu,32,0,38,6
1746555053238,BIPN 100,A04,895133,Yang; Mingyu,27,0,36,9
1746555054264,BIPN 120,A01,895135,Cooke; James Edward,0,3,13,13
1746555054264,BIPN 120,A02,895136,Cooke; James Edward,0,1,13,13
1746555054264,BIPN 120,A03,895137,Cooke; James Edward,0,3,13,13
1746555054264,BIPN 120,A04,895156,Cooke; James Edward,0,2,11,11
1746555055288,BIPN 134,A01,895235,Cooke; James Edward,0,2,25,25
1746555055288,BIPN 134,A02,895237,Cooke; James Edward,0,0,25,25
1746555055288,BIPN 134,A03,895240,Cooke; James Edward,3,0,25,22
1746555055288,BIPN 134,A04,895270,Cooke; James Edward,20,0,25,5
1746555056318,BIPN 189,A00,892103,Staff,0,13,14,14
1746555058369,BISP 194,A00,958008,Staff,0,2,0,0
1746555059404,CAT 124,A01,922009,Staff,0,5,20,20
1746555060434,CAT 125R,A00,886390,Morales; Celeste Georgianna,0,2,20,20
1746555060434,CAT 125R,B00,886391,Irwin; Matthew Joseph,0,3,20,20
1746555060434,CAT 125R,C00,886392,Smith; Lauryn Alissa,0,2,20,20
1746555060434,CAT 125R,D00,886393,Vanderschuit; Maya Alysia,0,2,20,20
1746555060434,CAT 125R,E00,886394,Marchisotto; Jennifer Anne,0,4,20,20
1746555061464,CENG 15,A01,886218,Drews; Aaron,3,0,8,5
1746555062490,CENG 113,A00,886219,Opatkiewicz; Justin Paul,15,0,25,10
1746555063516,CGS 101,A00,887044,Staff,7,0,20,13
1746555064543,CGS 105,A01,887046,Staff,14,0,25,11
1746555065572,CGS 112,A00,887047,Cuong; Marisol,12,0,15,3
1746555066597,CGS 113,A00,887048,Staff,23,0,30,7
1746555067625,CGS 120,A00,887049,Staff,10,0,17,7
1746555068652,CHEM 6A,A01,886336,Lam; Tin Yiu,38,0,50,12
1746555068652,CHEM 6A,A02,886338,Lam; Tin Yiu,37,0,50,13
1746555069678,CHEM 6B,A01,886341,Hopkins; Patrycja Anna,16,0,50,34
1746555069678,CHEM 6B,A02,886343,Hopkins; Patrycja Anna,42,0,50,8
1746555070707,CHEM 6C,A01,886346,Albizati; Kim F.,0,2,50,50
1746555070707,CHEM 6C,A02,886348,Albizati; Kim F.,23,0,50,27
1746555071733,CHEM 40A,A01,886352,Klosterman; Jeremy K,65,0,100,35
1746555072763,CHEM 40B,A01,886356,Klosterman; Jeremy K,0,23,100,100
1746555073789,CHEM 41B,A01,886360,Theodorakis; Emmanuel,25,0,50,25
1746555073789,CHEM 41B,A02,886362,Theodorakis; Emmanuel,47,0,50,3
1746555074815,CHIN 165A,A00,886382,Xu; Li,18,0,20,2
1746555075842,CLAS 120,A00,886387,Myerston Santana; Jacobo,33,0,40,7
1746555076870,COGS 9,A01,886967,Shannon; Kyle Michael,42,0,60,18
1746555077895,COGS 11,A01,886969,Staff,11,0,30,19
1746555078921,COGS 14A,A01,886971,Staff,6,0,60,54
1746555079946,COGS 14B,A01,886973,Hoffman; Drew Ellen,4,0,60,56
1746555080970,COGS 18,A01,886975,Morgan; Eric,35,0,60,25
1746555081995,COGS 20,A01,886977,Staff,4,0,8,4
1746555081995,COGS 20,A02,886978,Staff,5,0,7,2
1746555083024,COGS 100,A01,907783,Staff,0,2,30,30
1746555084051,COGS 101B,A01,886980,Staff,0,3,48,48
1746555085076,COGS 101C,A01,886982,Delgado; Tania,0,5,44,44
1746555086105,COGS 102A,A01,886984,Johnson; Christine M.,4,0,30,26
1746555087130,COGS 118B,A01,886986,Staff,0,3,88,88
1746555088156,COGS 150,A01,886988,Bergen; Benjamin,23,0,50,27
1746555089182,COGS 153,A00,886989,Delgado; Tania,0,2,41,41
1746555090210,COGS 186,A01,886991,Staff,0,0,32,32
1746555091234,COGS 187A,A01,886993,Boyle; Mary E. T.,7,0,30,23
1746555092261,COGS 189,A00,886994,Staff,0,1,30,30
1746555093290,COMM 10,A01,886996,Staff,0,0,20,21
1746555093290,COMM 10,A02,886997,Staff,12,0,20,8
1746555093290,COMM 10,A03,959845,Staff,19,0,20,1
1746555094314,COMM 20,A01,886999,Leuning; Grant Maurstad,24,0,40,16
1746555096365,COMM 100A,A01,887002,Staff,0,0,20,25
1746555096365,COMM 100A,A02,887003,Staff,7,0,20,13
1746555097390,COMM 100B,A01,887005,Staff,0,8,20,24
1746555098414,COMM 106D,A00,887006,Staff,14,0,40,26
1746555099438,COMM 110G,A00,887007,Whitworth-Smith; Andrew C,12,0,40,28
1746555100463,COMM 111B,A00,887008,Staff,31,0,40,9
1746555101490,COMM 113T,A00,887009,Abuelhiga; Soraya Jill,28,0,40,12
1746555101490,COMM 113T,B00,906733,Staff,40,0,40,0
1746555102517,COMM 145,A00,887010,Staff,12,0,40,28
1746555103546,COMM 146,A00,887054,Staff,31,0,40,9
1746555104573,COMM 190,A00,887012,Staff,8,0,23,15
1746555105599,CSE 8A,A50,887015,Cao; Yingjun,57,0,85,28
1746555106834,CSE 11,A01,887017,Cao; Yingjun,12,0,70,58
1746555107858,CSE 20,A01,887019,Staff,30,0,50,20
1746555108887,CSE 21,A01,887021,Staff,78,0,100,22
1746555108887,CSE 21,B01,892583,Braun; Oliver,45,0,50,5
1746555109913,CSE 30,A01,887025,Eldon; John,143,0,200,57
1746555110940,CSE 100,A01,887027,Staff,25,0,50,25
1746555110940,CSE 100,A02,887028,Staff,42,0,50,8
1746555111965,CSE 101,A01,887030,Braun; Oliver,74,0,100,26
1746555111965,CSE 101,B01,887032,Jones; Miles E,0,3,50,50
1746555111965,CSE 101,B02,887033,Jones; Miles E,0,1,50,50
1746555112990,CSE 105,A01,908084,Jones; Miles E,32,0,50,18
1746555112990,CSE 105,A02,908087,Jones; Miles E,32,0,50,18
1746555114014,CSE 135,A01,887035,Powell; Thomas Allan,0,4,50,50
1746555115040,CSE 142,A01,887037,Staff,8,0,60,52
1746555116065,CSE 142L,A01,887039,Staff,34,0,60,26
1746555117091,CSE 151A,A01,887041,Solares; Edwin A,47,0,100,53
1746555118122,CSE 175,A01,887043,Kumar; Rakesh,30,0,30,0
1746555119146,CSS 1,A01,886389,Staff,0,1,40,40
1746555120170,DSC 30,A01,908097,Liao; Soohyun Nam,47,0,75,28
1746555121195,DSC 40A,A01,908099,Shannon; Kyle Michael,30,0,50,20
1746555122224,DSC 40B,A01,908112,Staff,16,0,50,34
1746555123249,DSC 80,A01,908116,Staff,19,0,60,41
1746555124274,DSC 197,001,956863,Eldridge; Justin Matthew,9999,0,9999,0
1746555125299,ECE 5,A01,886400,Morris; Karcher William,2,0,6,4
1746555125299,ECE 5,A02,886401,Morris; Karcher William,3,0,6,3
1746555126323,ECE 148,A01,886403,Silberman; Jack,0,14,14,14
1746555127352,ECON 1,A01,887265,Crane; Meredith Helen,12,0,70,58
1746555127352,ECON 1,B01,887268,Staff,43,0,50,7
1746555128381,ECON 2,A01,887273,Crane; Meredith Helen,56,0,70,14
1746555129407,ECON 3,A01,887279,Rondina; Giacomo,32,0,70,38
1746555130434,ECON 4,A01,887282,Anderson; John Charles,0,2,10,10
1746555131462,ECON 5,A01,887285,Staff,33,0,45,12
1746555131462,ECON 5,B01,887292,Staff,41,0,45,4
1746555132491,ECON 100A,A01,887337,Newhouse; Herbert S,54,0,70,16
1746555132491,ECON 100A,B01,887349,Staff,45,0,50,5
1746555133516,ECON 100B,A01,887361,Du; Songzi,29,0,70,41
1746555134540,ECON 100C,A01,887445,Newhouse; Herbert S,59,0,70,11
1746555135568,ECON 105,A00,887488,Vespa; Emanuel Ignacio,23,0,35,12
1746555136594,ECON 109,A01,887506,Shishkin; Denis,28,0,35,7
1746555137621,ECON 110A,A01,887568,Alon; Titan Michael,0,3,35,35
1746555137621,ECON 110A,B01,907601,Alon; Titan Michael,20,0,35,15
1746555138650,ECON 110B,A01,887598,Levkoff; Steven B.,0,24,70,70
1746555139680,ECON 112,A00,887599,Rondina; Giacomo,19,0,35,16
1746555140707,ECON 120A,A01,887603,Dai; Yinlin,36,0,70,34
1746555141739,ECON 120C,A01,887608,Sun; Yixiao,0,1,35,35
1746555141739,ECON 120C,B01,887614,Sun; Yixiao,0,0,35,35
1746555142767,ECON 138,A00,887621,Bharadwaj; Prashant,0,21,20,20
1746555143797,ECON 144,A00,958007,Squires; Dale E,13,0,35,22
1746555144822,ECON 171,A01,907666,Staff,18,0,35,17
1746555145849,ECON 175,A00,887626,Wu; Pak Yeung,23,0,35,12
1746555146875,ECON 190,A00,887640,Vespa; Emanuel Ignacio,23,0,35,12
1746555147908,EDS 25,A01,888197,Staff,0,0,0,0
1746555147908,EDS 25,A02,888209,Staff,0,0,0,0
1746555147908,EDS 25,A03,888210,Staff,0,0,0,0
1746555147908,EDS 25,A04,888212,Staff,0,0,0,0
1746555147908,EDS 25,A05,888213,Staff,0,0,0,0
1746555147908,EDS 25,A06,888214,Staff,0,0,0,0
1746555147908,EDS 25,A07,888235,Staff,0,2,0,0
1746555147908,EDS 25,A08,888236,Staff,0,0,0,0
1746555147908,EDS 25,A09,888240,Staff,0,0,0,0
1746555147908,EDS 25,A10,888244,Staff,0,0,0,0
1746555147908,EDS 25,B01,888273,Staff,0,0,0,0
1746555147908,EDS 25,B02,888285,Staff,0,0,0,0
1746555147908,EDS 25,B03,888423,Staff,0,0,0,1
1746555147908,EDS 25,B04,888432,Staff,0,0,0,0
1746555147908,EDS 25,B05,888433,Staff,0,0,0,0
1746555147908,EDS 25,B06,888467,Staff,0,0,0,0
1746555147908,EDS 25,B07,888468,Staff,0,0,0,0
1746555147908,EDS 25,B08,888479,Staff,0,0,0,0
1746555147908,EDS 25,B09,888484,Staff,0,0,0,0
1746555147908,EDS 25,B10,888487,Staff,0,0,0,0
1746555148933,EDS 38,A01,907700,Choi; Bailey Miyeon,30,0,30,0
1746555149959,EDS 112,A01,888601,Chapman; Thandeka K,14,0,40,26
1746555150987,EDS 115,A00,888697,Mendez; Kathrina Mendoza,10,0,30,20
1746555152012,EDS 116,A01,888893,Staff,35,0,40,5
1746555154065,EDS 124AR,A00,889133,Staff,29,0,50,21
1746555154065,EDS 124AR,B00,907471,Simon; Elizabeth A,37,0,50,13
1746555155089,EDS 124BR,A00,889134,Simon; Elizabeth A,45,0,100,55
1746555156114,EDS 125,A00,889135,Staff,25,0,30,5
1746555157142,EDS 126,A01,889138,Staff,36,0,40,4
1746555158168,EDS 164R,A01,889142,Wishard Guerra; Alison G.,33,0,50,17
1746555159193,ENG 30,A01,886396,Staff,0,0,0,0
1746555159193,ENG 30,B01,886398,Staff,0,0,0,0
1746555160220,ENVR 102,A00,906150,Montejo; Carolina,23,0,25,2
1746555161244,ETHN 103A,A00,887236,Man; Simeon S,0,3,0,0
1746555162272,ETHN 113,A00,887239,Staff,16,0,30,14
1746555163296,ETHN 116,A00,887240,Staff,16,0,25,9
1746555164321,ETHN 117,A00,887241,Choi; Esther Min,28,0,30,2
1746555165345,ETHN 118,A00,887243,Staff,24,0,30,6
1746555166370,ETHN 127,A00,887248,Cuong; Marisol,11,0,15,4
1746555167398,ETHN 139,A00,887250,Staff,7,0,10,3
1746555168432,ETHN 142,A00,887252,Staff,10,0,30,20
1746555169456,ETHN 161,A00,887253,Browne; Errol Tsekani,24,0,30,6
1746555170482,ETHN 163FR,A00,887255,Burelle; Julie Sara Veronique,0,0,5,5
1746555171510,GLBH 20,A00,889149,Elwardani; Nile Regina,8,0,42,34
1746555173560,GLBH 111,A01,889152,Burgos; Jose L.,17,0,17,0
1746555174589,GLBH 150,A00,889181,Sloane; Julia Kathryn,0,5,15,15
1746555176640,HDS 60,A01,886406,Warstadt; Melissa Fawn,73,0,80,7
1746555177668,HIAF 111,A00,889324,Gyamfi; Bright,25,0,32,7
1746555178694,HIEA 131,A00,889328,Staff,16,0,32,16
1746555179721,HIEA 144,A00,889333,Henry; Todd A.,26,0,32,6
1746555180745,HIEA 154,A00,889336,Henry; Todd A.,24,0,32,8
1746555181769,HIEU 106,A00,889339,Staff,22,0,32,10
1746555183820,HIEU 114,A00,889340,Staff,3,0,32,29
1746555184846,HIEU 135GS,A00,889342,Patterson; Patrick H.,0,0,1,24
1746555185875,HIEU 137,A00,889343,Edington; Claire Ellen,9,0,25,16
1746555186900,HIEU 148,A00,889345,Staff,14,0,32,18
1746555187926,HIEU 154,A00,889346,Biess; Frank Peter,21,0,32,11
1746555188951,HILA 102,A00,889351,Staff,12,0,32,20
1746555189978,HILD 2A,A01,889221,Lewandoski; Julia Mavis,1,10,32,31
1746555191006,HILD 7B,A01,889225,Man; Simeon S,0,13,32,32
1746555192033,HILD 7C,A01,889288,Alvarez; Luis A,0,14,32,32
1746555193060,HILD 30,A01,889323,Staff,0,5,32,32
1746555195113,HISC 119,A00,889383,Golan; Tal,20,0,32,12
1746555196313,HIUS 103,A00,889384,Man; Simeon S,0,0,32,32
1746555197338,HIUS 117,A00,919797,Kwak; Nancy,18,0,32,14
1746555198363,HIUS 142A,A00,919788,Staff,22,0,32,10
1746555200411,HIUS 149,A00,889386,Gyamfi; Bright,27,0,32,5
1746555201437,HIUS 155,A00,889387,Alvarez; Luis A,14,0,32,18
1746555202465,HUM 3,A01,886499,Caldwell; Michael Alan,19,0,50,31
1746555203511,HUM 3GS,A00,886500,Rodriguez; Bretton Sigfred,0,0,0,28
1746555204538,HUM 3R,A01,886502,Markman; Kristina,0,36,50,50
1746555205565,HUM 4,A01,886504,Crum; Matthew Stephen,24,0,50,26
1746555205565,HUM 4,B01,886506,West; Geoffrey Scott,17,0,50,33
1746555206590,HUM 4GS,A00,886507,Staff,0,0,0,19
1746555207617,HUM 5,A01,886509,Staff,32,0,50,18
1746555208642,HUM 5R,A01,886511,Zavodny; Tatiana Sophia,0,39,50,50
1746555209665,JAPN 180,A00,886407,Staff,17,0,40,23
1746555210694,LATI 50,A01,886409,Martin-Cabrera; Luis,4,0,22,18
1746555210694,LATI 50,A02,886410,Martin-Cabrera; Luis,19,0,22,3
1746555210694,LATI 50,A03,886411,Martin-Cabrera; Luis,21,0,22,1
1746555210694,LATI 50,A04,886412,Martin-Cabrera; Luis,9,0,22,13
1746555211719,LAWS 101,A00,907664,Staff,28,0,60,32
1746555212742,LIAB 1A,A00,889388,Saab; Dima,17,0,20,3
1746555213770,LIAB 1AX,A00,889389,El Cheddadi; Youniss,17,0,20,3
1746555214795,LIFR 1C,A00,889391,Van Moer; Vinciane G,8,0,20,12
1746555215822,LIFR 1CX,A00,889392,Van Moer; Vinciane G,7,0,20,13
1746555216846,LIFR 1D,A00,889393,Van Moer; Vinciane G,7,0,20,13
1746555217873,LIFR 1DX,A00,889394,Van Moer; Vinciane G,8,0,20,12
1746555218902,LIGN 7,A00,886923,Staff,24,0,50,26
1746555219927,LIGN 17,A00,886924,Kehler; Andrew Scott,125,0,150,25
1746555220954,LTAM 110,A00,889395,Staff,15,0,30,15
1746555221982,LTAM 110GS,A00,958010,Rodriguez; Bretton Sigfred,0,0,0,28
1746555223005,LTCH 101,A00,889397,Staff,23,0,25,2
1746555224029,LTCS 130,A00,889398,Staff,23,0,25,2
1746555225054,LTEA 138,A00,889399,Staff,24,0,40,16
1746555226079,LTEN 149,A00,889400,Wesling; Megan E.,0,3,25,25
1746555227105,LTEN 169,A00,889401,Staff,20,0,25,5
1746555228131,LTEN 180,A00,889402,Staff,10,0,15,5
1746555229156,LTEN 181,A00,889403,Staff,21,0,25,4
1746555230185,LTWL 100,A00,889404,Myerston Santana; Jacobo,3,0,25,22
1746555231209,LTWL 180GS,A00,889405,Staff,0,0,20,20
1746555232233,LTWL 181,A00,889406,Staff,17,0,25,8
1746555233258,LTWL 184,A00,889475,Mukherjee; Silpa,22,0,25,3
1746555234293,LTWR 102C,A00,889486,Staff,29,0,30,1
1746555235318,LTWR 115W,A00,889491,Staff,0,2,15,15
1746555236345,MAE 8,A01,886905,Staff,0,2,0,0
1746555237370,MAE 11,A00,886906,Bandaru; Prabhakar,0,7,50,50
1746555238398,MAE 20,A00,886907,Evdokimenko; Ekaterina,43,0,70,27
1746555239425,MAE 30B,A00,886909,Ghazinejad; Maziar,26,0,45,19
1746555240449,MAE 101B,A00,886910,Saintillan; David,29,0,45,16
1746555241475,MAE 105,A00,886911,Bandaru; Prabhakar,18,0,50,32
1746555242503,MAE 107,B00,958024,Staff,8,0,50,42
1746555243527,MAE 143B,A00,886913,Bewley; Thomas R,7,0,40,33
1746555244552,MAE 148,A01,886915,Silberman; Jack,0,3,14,14
1746555245582,MAE 160,A00,886916,Evdokimenko; Ekaterina,31,0,60,29
1746555246609,MATH 3C,A01,889681,Staff,0,3,30,30
1746555246609,MATH 3C,A02,960048,Staff,25,0,30,5
1746555247638,MATH 10A,A01,889760,Staff,26,0,30,4
1746555247638,MATH 10A,A02,889783,Staff,29,0,30,1
1746555248666,MATH 10B,A01,889785,Verstraete; Jacques Allan,2,0,35,33
1746555248666,MATH 10B,A02,889795,Verstraete; Jacques Allan,4,0,35,31
1746555248666,MATH 10B,B01,889797,Verstraete; Jacques Allan,3,0,35,32
1746555248666,MATH 10B,B02,889828,Verstraete; Jacques Allan,3,0,35,32
1746555249693,MATH 10C,A01,889849,Habib; Yousaf,8,0,30,22
1746555249693,MATH 10C,A02,889852,Habib; Yousaf,14,0,30,16
1746555249693,MATH 10C,A03,889853,Habib; Yousaf,22,0,30,8
1746555249693,MATH 10C,A04,889858,Habib; Yousaf,20,0,30,10
1746555249693,MATH 10C,B01,889861,Staff,1,0,30,29
1746555249693,MATH 10C,B02,889862,Staff,24,0,30,6
1746555249693,MATH 10C,B03,889863,Staff,27,0,30,3
1746555249693,MATH 10C,B04,889967,Staff,23,0,30,7
1746555250718,MATH 18,A01,889974,Staff,6,0,30,24
1746555250718,MATH 18,A02,889977,Staff,20,0,30,10
1746555250718,MATH 18,B01,889984,Hardiman; Liam,22,0,30,8
1746555250718,MATH 18,B02,889985,Hardiman; Liam,25,0,30,5
1746555251743,MATH 20A,A01,889990,Suk; Andrew Hoon,30,0,35,5
1746555252774,MATH 20B,A01,889993,Ohm; Ko Woon,22,0,30,8
1746555252774,MATH 20B,A02,889994,Ohm; Ko Woon,30,0,30,0
1746555252774,MATH 20B,B01,889996,Ohm; Ko Woon,21,0,30,9
1746555252774,MATH 20B,B02,889997,Ohm; Ko Woon,23,0,30,7
1746555253801,MATH 20C,A01,889999,Hammock; Frances H,17,0,30,13
1746555253801,MATH 20C,A02,890003,Hammock; Frances H,23,0,30,7
1746555253801,MATH 20C,B01,890006,Hammock; Frances H,3,0,30,27
1746555253801,MATH 20C,B02,890007,Hammock; Frances H,11,0,30,19
1746555254827,MATH 20D,A01,890011,Cheng; Hsiao-Bing,1,1,30,29
1746555254827,MATH 20D,A02,890012,Cheng; Hsiao-Bing,14,0,30,16
1746555254827,MATH 20D,B01,890016,Cheng; Hsiao-Bing,13,0,30,17
1746555254827,MATH 20D,B02,890017,Cheng; Hsiao-Bing,13,0,30,17
1746555255853,MATH 20E,A01,890026,Harel; Guershon,1,0,30,29
1746555255853,MATH 20E,A02,890029,Harel; Guershon,23,0,30,7
1746555255853,MATH 20E,B01,890033,Harel; Guershon,7,0,30,23
1746555255853,MATH 20E,B02,890101,Harel; Guershon,21,0,30,9
1746555256877,MATH 102,A01,890104,Staff,17,0,30,13
1746555256877,MATH 102,A02,890105,Staff,27,0,30,3
1746555257903,MATH 103B,A01,890116,Salehi Golsefidy; Alireza,3,0,30,27
1746555257903,MATH 103B,B01,890118,Staff,0,3,34,34
1746555258934,MATH 109,A01,890121,Aliabadi Sr.; Mohsen,1,0,30,29
1746555258934,MATH 109,B01,890124,Upadrashta; Pranav Kumar,18,0,30,12
1746555259962,MATH 120A,A01,890126,Eggers; John Dietrich,13,0,30,17
1746555260987,MATH 142B,A01,890128,Ioana; Adrian,19,0,30,11
1746555260987,MATH 142B,A02,890129,Ioana; Adrian,13,0,30,17
1746555262012,MATH 154,A01,890174,Staff,0,0,30,30
1746555262012,MATH 154,A02,890182,Staff,0,0,30,30
1746555263037,MATH 168A,A01,890197,Dumitriu; Ioana,21,0,35,14
1746555264063,MATH 170A,A01,890240,Nie; Jiawang,1,0,30,29
1746555264063,MATH 170A,A02,890241,Nie; Jiawang,11,0,30,19
1746555264063,MATH 170A,A03,890249,Nie; Jiawang,23,0,30,7
1746555265087,MATH 170B,A01,957891,Nag; Panchali,13,0,35,22
1746555267142,MATH 181A,A01,908025,Staff,0,4,35,35
1746555267142,MATH 181A,A02,960115,Staff,27,0,35,8
1746555268167,MATH 181B,A01,959874,Staff,25,0,30,5
1746555269192,MATH 193B,A01,890265,Staff,0,4,35,35
1746555270216,MGT 4,A01,890311,Anderson; John Charles,42,0,88,46
1746555271240,MGT 5,A00,907740,Staff,13,0,98,85
1746555272267,MGT 12,A00,890312,Lindenberger; Wade Douglas,67,0,98,31
1746555273295,MGT 16,A00,957883,Staff,78,0,98,20
1746555275345,MGT 45,A00,890314,Pecore; Joseph P.,47,0,98,51
1746555276369,MGT 71,A00,890315,Staff,0,11,98,98
1746555277394,MGT 100,A00,890316,Yavorsky; Daniel Ryan,44,0,98,54
1746555278419,MGT 103,A00,890317,Ehrich; Kristine R,73,0,98,25
1746555279446,MGT 105,A00,890356,Bates; Kenneth Walter,0,7,98,98
1746555280473,MGT 112,A00,890360,Ehrich; Kristine R,55,0,98,43
1746555281499,MGT 127R,A00,907732,Zhu; Kevin Xiaoguo,24,0,98,74
1746555282525,MGT 131B,A00,890361,Anderson; John Charles,60,0,98,38
1746555283550,MGT 137,A00,890362,Lindenberger; Wade Douglas,65,0,98,33
1746555284575,MGT 160,A00,890369,Johnson; Erik Barry,9,0,98,89
1746555286625,MGT 164,A00,890372,Zimmermann; Carsten,0,39,98,98
1746555287653,MGT 180,A00,890374,Bliss; Barbara Ann,12,0,98,86
1746555288677,MMW 15,A01,886414,Chang; Edmond Yi-Teh,0,12,28,28
1746555288677,MMW 15,A02,886415,Chang; Edmond Yi-Teh,0,8,28,28
1746555288677,MMW 15,A03,886416,Chang; Edmond Yi-Teh,0,8,28,28
1746555288677,MMW 15,A04,886417,Chang; Edmond Yi-Teh,0,8,28,28
1746555288677,MMW 15,B01,886419,Chang; Edmond Yi-Teh,0,7,28,28
1746555288677,MMW 15,B02,886420,Chang; Edmond Yi-Teh,0,8,28,28
1746555288677,MMW 15,B03,886421,Chang; Edmond Yi-Teh,0,7,28,28
1746555288677,MMW 15,B04,886422,Chang; Edmond Yi-Teh,0,8,28,28
1746555288677,MMW 15,C01,886424,Staff,0,9,28,28
1746555288677,MMW 15,C02,886425,Staff,0,8,28,28
1746555288677,MMW 15,C03,886426,Staff,0,8,28,28
1746555288677,MMW 15,C04,886427,Staff,0,8,28,28
1746555288677,MMW 15,C05,958038,Staff,0,7,28,28
1746555288677,MMW 15,C06,958039,Staff,0,8,28,28
1746555289705,MMW 15GS,A00,906910,Patterson; Patrick H.,4,0,28,24
1746555290730,MMW 122R,A01,886429,Rahimi; Babak,0,13,28,28
1746555290730,MMW 122R,A02,886430,Rahimi; Babak,0,12,28,28
1746555290730,MMW 122R,A03,958040,Rahimi; Babak,0,11,28,28
1746555291754,MUS 1A,A01,890937,Staff,2,0,25,23
1746555291754,MUS 1A,A02,891035,Staff,6,0,25,19
1746555291754,MUS 1A,C01,958912,Staff,24,0,25,1
1746555291754,MUS 1A,C02,958913,Staff,25,0,25,0
1746555293803,MUS 2AK,A00,957092,Ohnishi; Takae,15,0,15,0
1746555294830,MUS 4,A01,891044,Staff,2,0,25,23
1746555294830,MUS 4,A02,891045,Staff,23,0,25,2
1746555294830,MUS 4,B01,891048,Staff,17,0,25,8
1746555294830,MUS 4,B02,891050,Staff,25,0,25,0
1746555295859,MUS 5,A01,957506,Dubnov; Shlomo,0,0,25,25
1746555295859,MUS 5,A02,957622,Dubnov; Shlomo,13,0,25,12
1746555295859,MUS 5,A03,957623,Dubnov; Shlomo,20,0,25,5
1746555296884,MUS 6,A01,891053,Freitas Caetano; Marcelo,24,0,25,1
1746555296884,MUS 6,A02,891054,Freitas Caetano; Marcelo,23,0,25,2
1746555297925,MUS 7,A01,891081,Staff,0,0,25,25
1746555297925,MUS 7,A02,891082,Staff,4,0,25,21
1746555298949,MUS 8GS,A00,891118,Borgo; David Garcia,0,0,25,25
1746555299974,MUS 11,A01,891140,Staff,11,0,25,14
1746555299974,MUS 11,A02,891141,Staff,22,0,25,3
1746555300998,MUS 13,A01,891143,Staff,8,0,25,17
1746555300998,MUS 13,A02,891144,Staff,24,0,25,1
1746555302028,MUS 15,A01,891146,Staff,9,0,25,16
1746555302028,MUS 15,A02,891148,Staff,21,0,25,4
1746555302028,MUS 15,B01,891150,Staff,18,0,25,7
1746555302028,MUS 15,B02,891151,Staff,25,0,25,0
1746555303055,MUS 20,A01,891153,Staff,5,0,20,15
1746555303055,MUS 20,A02,891155,Staff,14,0,20,6
1746555304080,MUS 80,A00,891156,Staff,19,0,25,6
1746555304080,MUS 80,B00,891157,Staff,23,0,25,2
1746555305106,MUS 130,A00,891158,Ohnishi; Takae,35,0,35,0
1746555306133,MUS 150GS,A01,891160,Borgo; David Garcia,0,0,25,25
1746555307159,MUS 170,A01,891162,Freitas Caetano; Marcelo,20,0,25,5
1746555307159,MUS 170,A02,891164,Freitas Caetano; Marcelo,21,0,25,4
1746555308182,NANO 11,A00,886220,Vazquez Mena; Oscar,13,0,15,2
1746555309209,NANO 15,A01,886222,Drews; Aaron,4,0,7,3
1746555310237,NANO 104,A00,886224,Sirbuly; Donald,18,0,25,7
1746555311260,PH 40,A00,886528,Staff,23,0,40,17
1746555312288,PH 45,A01,886799,Staff,35,0,40,5
1746555313312,PH 110,A00,886802,Staff,0,7,40,40
1746555314336,PH 172,A00,906716,Staff,19,0,35,16
1746555315361,PH 191,A00,886803,Staff,6,0,40,34
1746555316385,PHIL 1,A00,889500,Staff,20,0,30,10
1746555317412,PHIL 10,A01,889549,Grush; Rick Scott,15,0,22,7
1746555317412,PHIL 10,A02,889551,Grush; Rick Scott,22,0,22,0
1746555318439,PHIL 28,A01,889559,Lamey; Andy M.,0,1,31,31
1746555318439,PHIL 28,A02,889561,Lamey; Andy M.,0,1,30,30
1746555318439,PHIL 28,A03,889572,Lamey; Andy M.,0,1,30,30
1746555319462,PHIL 35,A00,907839,Staff,13,0,15,2
1746555320485,PHIL 60,A00,889574,Staff,74,0,90,16
1746555321509,PHIL 101,A00,958004,Staff,12,0,15,3
1746555323571,PHIL 136,A00,889582,Fulkerson; Matthew Todd,26,0,45,19
1746555324599,PHIL 163,A01,889601,Staff,21,0,30,9
1746555324599,PHIL 163,B01,889606,Brandt; Reuven A,0,3,0,0
1746555325622,PHIL 164,A00,889610,Staff,16,0,30,14
1746555326647,PHIL 165,A00,889613,Staff,23,0,30,7
1746555327673,PHYS 1A,A00,886431,Staff,26,0,70,44
1746555328698,PHYS 1AL,001,886432,Tsai; Philbert S,0,2,30,30
1746555328698,PHYS 1AL,002,886436,Tsai; Philbert S,11,0,30,19
1746555329721,PHYS 1B,A00,886439,Staff,185,0,240,55
1746555330748,PHYS 1BL,001,886441,Tsai; Philbert S,0,4,30,30
1746555330748,PHYS 1BL,002,886444,Tsai; Philbert S,2,0,30,28
1746555331774,PHYS 1C,A00,896092,Arnold; Kam S,78,0,146,68
1746555332799,PHYS 1CL,001,886448,Tsai; Philbert S,0,0,30,30
1746555332799,PHYS 1CL,002,886449,Tsai; Philbert S,0,0,30,30
1746555332799,PHYS 1CL,003,886450,Tsai; Philbert S,16,0,30,14
1746555332799,PHYS 1CL,004,886451,Tsai; Philbert S,15,0,30,15
1746555333824,PHYS 2B,A01,886457,Staff,69,0,115,46
1746555334853,PHYS 2C,A01,886460,Shotwell; Brian,0,9,65,65
1746555335877,PHYS 2CL,A01,886467,Staff,0,4,28,28
1746555335877,PHYS 2CL,A02,886468,Staff,0,3,28,28
1746555336903,PHYS 2D,A01,886470,Staff,10,0,50,40
1746555337927,PHYS 4B,A01,886475,Grinstein; Benjamin,22,0,40,18
1746555338952,POLI 5,A00,891173,Desposato; Scott,7,0,25,18
1746555339976,POLI 5D,A01,891175,Staff,5,0,5,0
1746555339976,POLI 5D,B01,891178,Staff,5,0,5,0
1746555341001,POLI 11,A00,891179,Ferree; Karen E,2,0,35,33
1746555342026,POLI 12,A00,891180,Staff,16,0,30,14
1746555343056,POLI 27,A01,891182,Staff,12,0,75,63
1746555344083,POLI 30,A00,891183,Staff,8,0,50,42
1746555345111,POLI 100B,A00,891244,Staff,5,1,35,30
1746555346138,POLI 100I,A00,891247,Staff,7,0,30,23
1746555347164,POLI 104J,A00,891248,Nichter; Maysa,14,0,30,16
1746555348189,POLI 104U,A00,891250,Nichter; Maysa,2,0,30,28
1746555350240,POLI 110B,A00,891255,Wiens; David,20,0,25,5
1746555351268,POLI 112A,A00,891256,Wiens; David,6,0,25,19
1746555352296,POLI 114BR,A00,891261,Staff,19,0,30,11
1746555353322,POLI 117R,A00,891262,Forman; Fonna,0,6,50,50
1746555354349,POLI 118,A00,891264,Ingham; Sean,17,0,25,8
1746555355377,POLI 124A,A00,891265,Staff,18,0,20,2
1746555356402,POLI 125D,A00,891266,Nichter; Simeon C,2,0,25,23
1746555357430,POLI 126,A00,891268,Nichter; Simeon C,7,0,25,18
1746555358452,POLI 126AA,A00,891272,Staff,17,0,25,8
1746555359477,POLI 130AA,A00,891273,Staff,15,0,20,5
1746555360503,POLI 134AA,A00,891274,Staff,4,0,20,16
1746555362553,POLI 138,A00,891278,Staff,21,0,25,4
1746555363578,POLI 142K,A00,891280,Staff,11,0,25,14
1746555364604,POLI 142M,A00,891281,Gartzke; Erik,17,0,30,13
1746555365632,POLI 142P,A00,891284,Staff,20,0,30,10
1746555366658,POLI 143,A00,891285,Gartzke; Erik,12,0,30,18
1746555367683,POLI 153,A00,891286,Staff,19,0,20,1
1746555369737,POLI 175,A00,891290,Staff,15,0,20,5
1746555370764,PSYC 1,A00,890674,Steiner; Eric Tomas,0,11,45,45
1746555371805,PSYC 2,A00,890676,Albright; Thomas D,21,0,35,14
1746555372831,PSYC 3,A00,890679,Staff,17,0,20,3
1746555373856,PSYC 6,A00,959858,Staff,20,0,20,0
1746555374881,PSYC 60,A01,890684,Rickard; Timothy C.,0,5,45,45
1746555375908,PSYC 70,A01,890689,Geller; Emma Harlan,7,0,30,23
1746555376933,PSYC 71,A01,959860,Staff,21,0,25,4
1746555377963,PSYC 100,A00,890690,Lacefield; Katharine I,0,50,180,180
1746555379011,PSYC 102,A00,890695,Staff,18,0,40,22
1746555380036,PSYC 105,A00,890699,Geller; Emma Harlan,70,0,100,30
1746555381060,PSYC 106,A00,890701,Gorman; Michael R.,6,0,30,24
1746555382085,PSYC 108,A00,890704,Adrian; Julia Anna,0,28,50,50
1746555383108,PSYC 118,A01,890712,Staff,11,0,30,19
1746555384132,PSYC 124,A00,890716,Chapman; Eddie Nathaniel,25,0,60,35
1746555385160,PSYC 131,A00,890717,Anagnostaras; Stephan,0,7,80,80
1746555386183,PSYC 137,A00,890719,Winkielman; Piotr,0,11,30,30
1746555387207,PSYC 144,A00,890721,Adrian; Julia Anna,0,9,45,45
1746555388232,PSYC 162,A00,890805,Staff,2,0,75,73
1746555389259,PSYC 169,A00,890810,Staff,0,14,30,30
1746555390287,PSYC 172,A00,890814,Gorman; Michael R.,9,0,30,21
1746555391313,PSYC 181,A00,890818,Anagnostaras; Stephan,8,0,200,192
1746555392341,PSYC 184,A00,959861,Staff,170,0,175,5
1746555393369,PSYC 189,A00,890823,Staff,0,1,30,30
1746555394397,PSYC 191,A00,890884,Rickard; Timothy C.,0,11,35,35
1746555395422,PSYC 193,A00,890913,Staff,19,0,30,11
1746555395422,PSYC 193,B00,890914,Chapman; Eddie Nathaniel,24,0,30,6
1746555396448,PSYC 193L,A01,890918,Lowe; Angela Beth,20,0,30,10
1746555396448,PSYC 193L,B01,890921,Hurwitz; Ethan Scott,20,0,30,10
1746555396448,PSYC 193L,C01,890928,Staff,30,0,30,0
1746555397477,RELI 149,A00,886806,Rahimi; Babak,23,0,40,17
1746555398505,SE 9,A01,886814,Staff,7,0,20,13
1746555399530,SE 101B,A01,886816,Chadha; Mayank,4,0,35,31
1746555400555,SE 110B,A00,886818,Zhu; Qiang,4,0,75,71
1746555401584,SE 125,A01,886830,Staff,10,0,30,20
1746555402613,SE 130B,A01,886835,Staff,14,0,40,26
1746555403637,SE 131A,A01,886838,Krysl; Petr,34,0,55,21
1746555404662,SE 154,A00,886840,Staff,29,0,50,21
1746555405687,SE 164GS,A01,886849,Staff,6,0,20,14
1746555406714,SE 167GS,A01,886853,Staff,6,0,20,14
1746555407739,SIO 25,A01,890107,Staff,19,0,30,11
1746555408766,SIO 45,A00,890109,Cook; Geoffrey W,117,0,200,83
1746555409792,SIO 109R,A00,890110,Forman; Fonna,0,16,20,20
1746555410820,SIO 187,A01,890114,Kacev; David,15,0,40,25
1746555411846,SOCI 1,A01,890431,Thorpe; Charles Robert,15,0,30,15
1746555411846,SOCI 1,A02,890518,Thorpe; Charles Robert,30,0,30,0
1746555412871,SOCI 2,A01,957978,Staff,25,0,25,0
1746555412871,SOCI 2,A02,957979,Staff,23,0,25,2
1746555413898,SOCI 20,A01,890523,Calderon-Zaks; Michael Aar,23,0,30,7
1746555413898,SOCI 20,A02,890526,Calderon-Zaks; Michael Aar,29,0,30,1
1746555414927,SOCI 30,A01,890533,Pardo Guerra; Juan Pablo,37,0,40,3
1746555415954,SOCI 40,A01,890535,Staff,27,0,45,18
1746555416980,SOCI 104Q,A00,890559,Staff,18,0,30,12
1746555418004,SOCI 106,A00,890560,Arnal; Maud Marie Leonie,20,0,30,10
1746555419033,SOCI 110,A00,890567,Holkenbrink-Monk; Charlene,19,0,30,11
1746555420058,SOCI 112,A00,890568,Victoria Torres; Pablo,2,0,55,53
1746555421084,SOCI 115,A00,890597,Arnal; Maud Marie Leonie,28,0,45,17
1746555423141,SOCI 121,A00,890604,Pardo Guerra; Juan Pablo,38,0,45,7
1746555424165,SOCI 126,A01,890608,Staff,8,0,10,2
1746555425192,SOCI 127,A00,890609,Staff,18,0,30,12
1746555426216,SOCI 131,A00,890610,Thorpe; Charles Robert,37,0,45,8
1746555427241,SOCI 135,A00,890615,Payne; Christine Anna,14,0,45,31
1746555428268,SOCI 139,A00,890620,Staff,38,0,45,7
1746555429295,SOCI 148E,A00,890622,Calderon-Zaks; Michael Aar,36,0,45,9
1746555430322,SOCI 150,A00,890623,Kohler; Kristopher M.,31,0,45,14
1746555431354,SOCI 157,A00,890625,Jules-Rosette; Bennetta W.,18,0,20,2
1746555432380,SOCI 160,A00,890627,Payne; Christine Anna,21,0,45,24
1746555433404,SYN 1,A00,886855,Fish; Gwendolyn Anne,0,0,0,0
1746555433404,SYN 1,B00,906086,Fish; Gwendolyn Anne,0,1,0,2
1746555434433,SYN 2R,A00,886860,Staff,0,17,15,15
1746555434433,SYN 2R,B00,906106,Atkinson; Arthur Laird,0,16,15,15
1746555435461,SYN 100,A01,886866,Browne; Emily,0,28,20,20
1746555435461,SYN 100,B01,906128,Rock; Martin,0,5,20,20
1746555435461,SYN 100,C01,906140,Deavenport; James Cary,0,3,20,20
1746555435461,SYN 100,D01,907816,Deavenport; James Cary,0,5,20,20
1746555436489,TDAC 1,A00,890286,Walsh; Kim C.,9,0,20,11
1746555437514,TDAC 101,A00,890296,Basso; Beatrice,16,0,20,4
1746555438540,TDDE 131,A00,890297,Staff,47,0,50,3
1746555439567,TDDM 1,A00,890287,Weinberg; Sadie,25,0,30,5
1746555440593,TDGE 11,A00,890288,Fulton; Julia,137,0,200,63
1746555440593,TDGE 11,B00,890289,Castro; Robert Jess,184,0,200,16
1746555441620,TDGE 25,B00,957359,Walsh; Kim C.,3,0,20,17
1746555442646,TDGE 40,A01,890292,Power; Jade Yukana,27,0,30,3
1746555443676,TDGE 124,A00,890298,Havis; Allan,0,1,50,50
1746555444703,TDGE 131R,A00,890299,Burelle; Julie Sara Veronique,15,0,42,27
1746555445728,TDHT 101,A00,890300,Staff,10,0,20,10
1746555446755,TDHT 109,A01,890302,Anderson; Mysia Anyse,31,0,40,9
1746555447779,TDMV 1,A00,890293,Arcidiacono; Kristin,18,0,30,12
1746555448805,TDMV 2,A00,890294,Weinberg; Sadie,23,0,30,7
1746555449829,TDMV 3,A00,957878,Arcidiacono; Kristin,28,0,30,2
1746555451884,TDMV 138,A00,890304,Jun; Grace Shin Hae,25,0,40,15
1746555452909,TDMV 140,A00,890305,Corrales; Joseph Bernales,25,0,30,5
1746555453937,TDMV 142,A00,890307,Caligagan; Tony,32,0,40,8
1746555454968,TDMV 144,A00,890308,Camaya; Michelle Ann,25,0,30,5
1746555455992,TDPW 1,A00,890295,Stein; Deborah Isobel,3,0,20,17
1746555457021,USP 2,A01,890272,Lerner; Amy M,6,0,20,14
1746555458049,USP 3,A01,890274,Staff,12,0,30,18
1746555459072,USP 15,A01,890276,Sun; Feiyang,17,0,30,13
1746555460101,USP 25,A00,890277,Shenkman; Michael Thomas,19,0,25,6
1746555461131,USP 138,A00,890278,Staff,13,0,25,12
1746555462157,USP 143,A00,890279,Staff,21,0,70,49
1746555463188,USP 144,A00,890280,Chowdhury; Muhammed Zohir,16,0,30,14
1746555464217,USP 150,A00,890281,Boomhower; Matthew Charles,4,0,30,26
1746555465241,USP 151,A00,890282,Staff,16,0,20,4
1746555466266,USP 162,A00,890283,Andrews; Abigail Leslie,16,0,20,4
1746555467290,USP 168,A00,920477,Kwak; Nancy,1,0,5,4
1746555468314,USP 181,A00,890284,Staff,3,0,20,17
1746555469338,USP 191A,A00,890285,Staff,12,0,20,8
1746555470362,VIS 101,A00,886512,Staff,25,0,75,50
1746555471386,VIS 103,A00,886513,Cruz; Edwin Teddy,61,0,75,14
1746555472415,VIS 108,A00,886514,Staff,3,0,15,12
1746555473438,VIS 127P,A00,886515,Shen; Kuiyi,80,0,146,66
1746555474465,VIS 149,A00,886516,Yoldas; Pinar,0,0,15,15
1746555475489,VIS 164,A00,886526,Erdmann; Dean,19,0,22,3
1746555476514,VIS 194S,A00,886527,Staff,61,0,75,14
1746555477537,WCWP 10A,C00,886484,Martiniuk; Jill,12,0,15,3
1746555478566,WCWP 10B,A00,886490,Uriarte; Emma,0,0,15,15
1746555478566,WCWP 10B,B00,886491,Dhir; Simrita,10,0,15,5
1746555478566,WCWP 10B,C00,886492,Ornelas; Tricia,0,0,15,15
1746555479593,WCWP 100,A00,886494,Young; Mark T,0,6,15,15
1746555481659,AAS 10,A01,886199,Childs; Dennis R.,0,3,0,0
1746555482685,ANAR 104,A01,886940,Shtienberg; Gilad,27,0,30,3
1746555483713,ANAR 120,A00,886953,Staff,12,0,20,8
1746555484741,ANBI 148,A01,886955,Wilder; Linnea Lorene,30,0,40,10
1746555486797,ANSC 122,A00,886957,Staff,25,0,30,5
1746555487823,ANSC 150,A00,886958,Sloane; Julia Kathryn,2,0,15,13
1746555488850,ANSC 156,A00,886959,Jenkins; Janis A.,0,1,15,15
1746555489877,ANSC 180,A00,886960,Staff,11,0,17,6
1746555490902,ANSC 188,A00,886961,Jassal; Aftab,9,0,25,16
1746555491927,ANSC 190,A00,886962,Jassal; Aftab,14,0,25,11
1746555492952,ANSC 191,A00,886963,Staff,18,0,20,2
1746555493979,ANTH 3,A01,891689,Staff,17,0,20,3
1746555495008,ANTH 5,A00,886933,Semendeferi; Ekaterini,16,0,20,4
1746555496034,ANTH 10,A00,886934,Staff,0,12,30,30
1746555497057,ANTH 21,A01,886936,Staff,40,0,60,20
1746555498082,ANTH 23,A01,886938,Staff,92,0,100,8
1746555499106,ANTH 105,A00,886964,Stewart; Alexander B,84,0,100,16
1746555500132,ANTH 108,A00,886965,Pedersen; David,9,0,20,11
1746555501163,AWP 10,001,886147,Staff,0,0,0,0
1746555501163,AWP 10,002,886148,Staff,0,0,0,0
1746555501163,AWP 10,003,886149,Staff,0,0,0,0
1746555501163,AWP 10,004,886150,Staff,0,0,0,0
1746555501163,AWP 10,005,886151,Staff,0,0,0,0
1746555501163,AWP 10,006,886152,Staff,0,0,0,0
1746555501163,AWP 10,007,886153,Staff,0,0,0,0
1746555501163,AWP 10,008,886154,Staff,0,0,0,0
1746555501163,AWP 10,009,886155,Staff,0,0,0,0
1746555501163,AWP 10,010,886156,Staff,0,0,0,0
1746555501163,AWP 10,011,886158,Staff,0,0,0,0
1746555501163,AWP 10,012,886160,Staff,0,0,0,0
1746555501163,AWP 10,013,886161,Staff,0,0,0,0
1746555501163,AWP 10,014,886162,Staff,0,0,0,0
1746555501163,AWP 10,015,886163,Staff,0,0,0,0
1746555501163,AWP 10,016,886164,Staff,0,0,0,0
1746555501163,AWP 10,017,886165,Staff,0,0,0,0
1746555501163,AWP 10,018,886166,Staff,0,0,0,0
1746555501163,AWP 10,019,886168,Staff,0,0,0,0
1746555501163,AWP 10,020,886170,Staff,0,0,0,0
1746555501163,AWP 10,021,886172,Staff,0,0,0,0
1746555502212,AWP 10R,001,886173,Staff,0,1,0,0
1746555502212,AWP 10R,002,886174,Staff,0,1,0,0
1746555502212,AWP 10R,003,886175,Staff,0,0,0,0
1746555502212,AWP 10R,004,886176,Staff,0,0,0,0
1746555502212,AWP 10R,005,886177,Staff,0,0,0,0
1746555502212,AWP 10R,006,886178,Staff,0,0,0,0
1746555502212,AWP 10R,007,886179,Staff,0,0,0,0
1746555502212,AWP 10R,008,886181,Staff,0,0,0,0
1746555502212,AWP 10R,009,886182,Staff,0,0,0,0
1746555502212,AWP 10R,010,886183,Staff,0,0,0,0
1746555502212,AWP 10R,011,886184,Staff,0,0,0,0
1746555502212,AWP 10R,012,886185,Staff,0,0,0,0
1746555502212,AWP 10R,013,886186,Staff,0,0,0,0
1746555502212,AWP 10R,014,886187,Staff,0,0,0,0
1746555502212,AWP 10R,015,886188,Staff,0,0,0,0
1746555502212,AWP 10R,016,886189,Staff,0,0,0,0
1746555502212,AWP 10R,017,960532,Staff,0,0,0,0
1746555502212,AWP 10R,018,960533,Staff,0,0,0,0
1746555502212,AWP 10R,019,960534,Staff,0,0,0,0
1746555502212,AWP 10R,020,960538,Staff,0,0,0,0
1746555502212,AWP 10R,021,960540,Staff,0,0,0,0
1746555502212,AWP 10R,022,960541,Staff,0,0,0,0
1746555502212,AWP 10R,023,960542,Staff,0,0,0,0
1746555502212,AWP 10R,024,960544,Staff,0,0,0,0
1746555502212,AWP 10R,025,960545,Staff,0,0,0,0
1746555502212,AWP 10R,026,960548,Staff,0,0,0,0
1746555503237,AWP 102R,A00,886190,Staff,0,0,0,0
1746555503237,AWP 102R,B00,886191,Staff,0,0,0,0
1746555504262,BENG 100,A01,886193,Staff,17,0,30,13
1746555505288,BENG 122A,A01,886195,Hasty; Jeff M,13,0,30,17
1746555506316,BENG 166A,A00,886196,Sah; Robert Lie-Yuan,0,2,30,30
1746555507342,BENG 190,A00,958050,Khojah; Reem I,23,0,25,2
1746555508368,BIBC 102,A01,894320,Staff,0,0,46,46
1746555508368,BIBC 102,A02,894321,Staff,0,0,46,46
1746555508368,BIBC 102,A03,894344,Staff,7,0,46,39
1746555508368,BIBC 102,A04,894345,Staff,26,0,47,21
1746555509397,BICD 100R,A01,894365,Smith; Laurie,0,4,58,58
1746555509397,BICD 100R,A02,894366,Smith; Laurie,0,5,58,58
1746555509397,BICD 100R,A03,894367,Smith; Laurie,2,0,59,57
1746555509397,BICD 100R,A04,959869,Smith; Laurie,41,0,59,18
1746555510426,BICD 136,A01,894383,Gustafson-Brown; Cindy,14,0,50,36
1746555511452,BIEB 102,A01,894494,Butler; Shannon Rhey,51,0,130,79
1746555513503,BIEB 150,A01,894617,Wills; Christopher,3,0,20,17
1746555513503,BIEB 150,A02,894631,Wills; Christopher,3,0,20,17
1746555513503,BIEB 150,A03,894937,Wills; Christopher,3,0,20,17
1746555513503,BIEB 150,A04,894946,Wills; Christopher,5,0,20,15
1746555514527,BIEB 194,A00,906141,Kurle; Carolyn M.,6,0,20,14
1746555515554,BILD 1,A01,894154,Staff,3,0,19,16
1746555515554,BILD 1,A02,894155,Staff,14,0,19,5
1746555515554,BILD 1,A03,894160,Staff,13,0,19,6
1746555515554,BILD 1,A04,894161,Staff,15,0,18,3
1746555516586,BILD 2,A01,894168,Staff,0,0,50,50
1746555516586,BILD 2,A02,894169,Staff,0,0,50,50
1746555516586,BILD 2,A03,894179,Staff,1,0,50,49
1746555516586,BILD 2,A04,894203,Staff,27,0,50,23
1746555517613,BILD 3,A01,894213,Staff,22,0,31,9
1746555517613,BILD 3,A02,894214,Staff,26,0,31,5
1746555517613,BILD 3,A03,894235,Staff,28,0,31,3
1746555517613,BILD 3,A04,894236,Staff,28,0,32,4
1746555518649,BILD 4,A01,894253,Reuther; Keefe,5,0,24,19
1746555518649,BILD 4,A02,894258,Reuther; Keefe,16,0,24,8
1746555519676,BILD 5,A01,894276,Reuther; Keefe,35,0,50,15
1746555519676,BILD 5,A02,894277,Reuther; Keefe,45,0,50,5
1746555519676,BILD 5,A03,894290,Reuther; Keefe,44,0,50,6
1746555519676,BILD 5,A04,894291,Reuther; Keefe,48,0,50,2
1746555520703,BILD 24,A01,894297,Pirino; Giorgia,40,0,60,20
1746555521728,BIMM 100,B01,958915,Staff,71,0,100,29
1746555522758,BIMM 101,A01,895017,McDonnell; Lisa Marie,0,5,24,24
1746555522758,BIMM 101,A02,895018,McDonnell; Lisa Marie,0,5,24,24
1746555522758,BIMM 101,B01,895020,McDonnell; Lisa Marie,0,6,24,24
1746555522758,BIMM 101,B02,895021,McDonnell; Lisa Marie,0,4,24,24
1746555523782,BIMM 110,A01,895023,Staff,1,0,25,24
1746555523782,BIMM 110,A02,895024,Staff,9,0,25,16
1746555523782,BIMM 110,A03,895025,Staff,18,0,25,7
1746555523782,BIMM 110,A04,895031,Staff,20,0,25,5
1746555524805,BIMM 120,A01,895114,Gustafson-Brown; Cindy,14,0,28,14
1746555524805,BIMM 120,A02,895126,Gustafson-Brown; Cindy,21,0,27,6
1746555525833,BIPN 100,A01,895130,Yang; Mingyu,1,0,38,37
1746555525833,BIPN 100,A02,895131,Yang; Mingyu,32,0,38,6
1746555525833,BIPN 100,A03,895132,Yang; Mingyu,32,0,38,6
1746555525833,BIPN 100,A04,895133,Yang; Mingyu,27,0,36,9
1746555526860,BIPN 120,A01,895135,Cooke; James Edward,0,3,13,13
1746555526860,BIPN 120,A02,895136,Cooke; James Edward,0,1,13,13
1746555526860,BIPN 120,A03,895137,Cooke; James Edward,0,3,13,13
1746555526860,BIPN 120,A04,895156,Cooke; James Edward,0,2,11,11
1746555527891,BIPN 134,A01,895235,Cooke; James Edward,0,2,25,25
1746555527891,BIPN 134,A02,895237,Cooke; James Edward,0,0,25,25
1746555527891,BIPN 134,A03,895240,Cooke; James Edward,3,0,25,22
1746555527891,BIPN 134,A04,895270,Cooke; James Edward,20,0,25,5
1746555528921,BIPN 189,A00,892103,Staff,0,13,14,14
1746555530971,BISP 194,A00,958008,Staff,0,2,0,0
1746555531995,CAT 124,A01,922009,Staff,0,5,20,20
1746555533022,CAT 125R,A00,886390,Morales; Celeste Georgianna,0,2,20,20
1746555533022,CAT 125R,B00,886391,Irwin; Matthew Joseph,0,3,20,20
1746555533022,CAT 125R,C00,886392,Smith; Lauryn Alissa,0,2,20,20
1746555533022,CAT 125R,D00,886393,Vanderschuit; Maya Alysia,0,2,20,20
1746555533022,CAT 125R,E00,886394,Marchisotto; Jennifer Anne,0,4,20,20
1746555534046,CENG 15,A01,886218,Drews; Aaron,3,0,8,5
1746555535075,CENG 113,A00,886219,Opatkiewicz; Justin Paul,15,0,25,10
1746555536099,CGS 101,A00,887044,Staff,7,0,20,13
1746555537123,CGS 105,A01,887046,Staff,14,0,25,11
1746555538148,CGS 112,A00,887047,Cuong; Marisol,12,0,15,3
1746555539172,CGS 113,A00,887048,Staff,23,0,30,7
1746555540198,CGS 120,A00,887049,Staff,10,0,17,7
1746555541224,CHEM 6A,A01,886336,Lam; Tin Yiu,38,0,50,12
1746555541224,CHEM 6A,A02,886338,Lam; Tin Yiu,37,0,50,13
1746555542253,CHEM 6B,A01,886341,Hopkins; Patrycja Anna,16,0,50,34
1746555542253,CHEM 6B,A02,886343,Hopkins; Patrycja Anna,42,0,50,8
1746555543278,CHEM 6C,A01,886346,Albizati; Kim F.,0,2,50,50
1746555543278,CHEM 6C,A02,886348,Albizati; Kim F.,23,0,50,27
1746555544302,CHEM 40A,A01,886352,Klosterman; Jeremy K,65,0,100,35
1746555545326,CHEM 40B,A01,886356,Klosterman; Jeremy K,0,23,100,100
1746555546354,CHEM 41B,A01,886360,Theodorakis; Emmanuel,25,0,50,25
1746555546354,CHEM 41B,A02,886362,Theodorakis; Emmanuel,47,0,50,3
1746555547379,CHIN 165A,A00,886382,Xu; Li,18,0,20,2
1746555548403,CLAS 120,A00,886387,Myerston Santana; Jacobo,33,0,40,7
1746555549430,COGS 9,A01,886967,Shannon; Kyle Michael,42,0,60,18
1746555550455,COGS 11,A01,886969,Staff,11,0,30,19
1746555551484,COGS 14A,A01,886971,Staff,6,0,60,54
1746555552509,COGS 14B,A01,886973,Hoffman; Drew Ellen,4,0,60,56
1746555553538,COGS 18,A01,886975,Morgan; Eric,35,0,60,25
1746555554564,COGS 20,A01,886977,Staff,4,0,8,4
1746555554564,COGS 20,A02,886978,Staff,5,0,7,2
1746555555588,COGS 100,A01,907783,Staff,0,2,30,30
1746555556615,COGS 101B,A01,886980,Staff,0,3,48,48
1746555557640,COGS 101C,A01,886982,Delgado; Tania,0,5,44,44
1746555558665,COGS 102A,A01,886984,Johnson; Christine M.,4,0,30,26
1746555559692,COGS 118B,A01,886986,Staff,0,3,88,88
1746555560717,COGS 150,A01,886988,Bergen; Benjamin,23,0,50,27
1746555561743,COGS 153,A00,886989,Delgado; Tania,0,2,41,41
1746555562770,COGS 186,A01,886991,Staff,0,0,32,32
1746555563796,COGS 187A,A01,886993,Boyle; Mary E. T.,7,0,30,23
1746555564821,COGS 189,A00,886994,Staff,0,1,30,30
1746555565847,COMM 10,A01,886996,Staff,0,0,20,21
1746555565847,COMM 10,A02,886997,Staff,12,0,20,8
1746555565847,COMM 10,A03,959845,Staff,19,0,20,1
1746555566872,COMM 20,A01,886999,Leuning; Grant Maurstad,24,0,40,16
1746555568923,COMM 100A,A01,887002,Staff,0,0,20,25
1746555568923,COMM 100A,A02,887003,Staff,7,0,20,13
1746555569949,COMM 100B,A01,887005,Staff,0,8,20,24
1746555570974,COMM 106D,A00,887006,Staff,14,0,40,26
1746555571998,COMM 110G,A00,887007,Whitworth-Smith; Andrew C,12,0,40,28
1746555573023,COMM 111B,A00,887008,Staff,31,0,40,9
1746555574050,COMM 113T,A00,887009,Abuelhiga; Soraya Jill,28,0,40,12
1746555574050,COMM 113T,B00,906733,Staff,40,0,40,0
1746555575077,COMM 145,A00,887010,Staff,12,0,40,28
1746555576106,COMM 146,A00,887054,Staff,31,0,40,9
1746555577130,COMM 190,A00,887012,Staff,8,0,23,15
1746555578159,CSE 8A,A50,887015,Cao; Yingjun,57,0,85,28
1746555579184,CSE 11,A01,887017,Cao; Yingjun,12,0,70,58
1746555580212,CSE 20,A01,887019,Staff,30,0,50,20
1746555581240,CSE 21,A01,887021,Staff,78,0,100,22
1746555581240,CSE 21,B01,892583,Braun; Oliver,45,0,50,5
1746555582271,CSE 30,A01,887025,Eldon; John,143,0,200,57
1746555583300,CSE 100,A01,887027,Staff,26,0,50,24
1746555583300,CSE 100,A02,887028,Staff,42,0,50,8
1746555584326,CSE 101,A01,887030,Braun; Oliver,74,0,100,26
1746555584326,CSE 101,B01,887032,Jones; Miles E,0,3,50,50
1746555584326,CSE 101,B02,887033,Jones; Miles E,0,1,50,50
1746555585350,CSE 105,A01,908084,Jones; Miles E,32,0,50,18
1746555585350,CSE 105,A02,908087,Jones; Miles E,32,0,50,18
1746555586376,CSE 135,A01,887035,Powell; Thomas Allan,0,4,50,50
1746555587402,CSE 142,A01,887037,Staff,8,0,60,52
1746555588426,CSE 142L,A01,887039,Staff,34,0,60,26
1746555589454,CSE 151A,A01,887041,Solares; Edwin A,47,0,100,53
1746555590481,CSE 175,A01,887043,Kumar; Rakesh,30,0,30,0
1746555591509,CSS 1,A01,886389,Staff,0,1,40,40
1746555592537,DSC 30,A01,908097,Liao; Soohyun Nam,47,0,75,28
1746555593567,DSC 40A,A01,908099,Shannon; Kyle Michael,30,0,50,20
1746555594597,DSC 40B,A01,908112,Staff,16,0,50,34
1746555595621,DSC 80,A01,908116,Staff,19,0,60,41
1746555596648,DSC 197,001,956863,Eldridge; Justin Matthew,9999,0,9999,0
1746555597678,ECE 5,A01,886400,Morris; Karcher William,2,0,6,4
1746555597678,ECE 5,A02,886401,Morris; Karcher William,3,0,6,3
1746555598707,ECE 148,A01,886403,Silberman; Jack,0,14,14,14
1746555599738,ECON 1,A01,887265,Crane; Meredith Helen,12,0,70,58
1746555599738,ECON 1,B01,887268,Staff,43,0,50,7
1746555600764,ECON 2,A01,887273,Crane; Meredith Helen,56,0,70,14
1746555601794,ECON 3,A01,887279,Rondina; Giacomo,32,0,70,38
1746555602824,ECON 4,A01,887282,Anderson; John Charles,0,2,10,10
1746555603852,ECON 5,A01,887285,Staff,33,0,45,12
1746555603852,ECON 5,B01,887292,Staff,41,0,45,4
1746555604881,ECON 100A,A01,887337,Newhouse; Herbert S,54,0,70,16
1746555604881,ECON 100A,B01,887349,Staff,45,0,50,5
1746555605908,ECON 100B,A01,887361,Du; Songzi,29,0,70,41
1746555606935,ECON 100C,A01,887445,Newhouse; Herbert S,59,0,70,11
1746555607962,ECON 105,A00,887488,Vespa; Emanuel Ignacio,23,0,35,12
1746555608986,ECON 109,A01,887506,Shishkin; Denis,28,0,35,7
1746555610012,ECON 110A,A01,887568,Alon; Titan Michael,0,3,35,35
1746555610012,ECON 110A,B01,907601,Alon; Titan Michael,20,0,35,15
1746555611038,ECON 110B,A01,887598,Levkoff; Steven B.,0,24,70,70
1746555612065,ECON 112,A00,887599,Rondina; Giacomo,19,0,35,16
1746555613106,ECON 120A,A01,887603,Dai; Yinlin,35,0,70,35
1746555614132,ECON 120C,A01,887608,Sun; Yixiao,0,1,35,35
1746555614132,ECON 120C,B01,887614,Sun; Yixiao,0,0,35,35
1746555615158,ECON 138,A00,887621,Bharadwaj; Prashant,0,21,20,20
1746555616184,ECON 144,A00,958007,Squires; Dale E,13,0,35,22
1746555617212,ECON 171,A01,907666,Staff,18,0,35,17
1746555618241,ECON 175,A00,887626,Wu; Pak Yeung,23,0,35,12
1746555619265,ECON 190,A00,887640,Vespa; Emanuel Ignacio,23,0,35,12
1746555620294,EDS 25,A01,888197,Staff,0,0,0,0
1746555620294,EDS 25,A02,888209,Staff,0,0,0,0
1746555620294,EDS 25,A03,888210,Staff,0,0,0,0
1746555620294,EDS 25,A04,888212,Staff,0,0,0,0
1746555620294,EDS 25,A05,888213,Staff,0,0,0,0
1746555620294,EDS 25,A06,888214,Staff,0,0,0,0
1746555620294,EDS 25,A07,888235,Staff,0,2,0,0
1746555620294,EDS 25,A08,888236,Staff,0,0,0,0
1746555620294,EDS 25,A09,888240,Staff,0,0,0,0
1746555620294,EDS 25,A10,888244,Staff,0,0,0,0
1746555620294,EDS 25,B01,888273,Staff,0,0,0,0
1746555620294,EDS 25,B02,888285,Staff,0,0,0,0
1746555620294,EDS 25,B03,888423,Staff,0,0,0,1
1746555620294,EDS 25,B04,888432,Staff,0,0,0,0
1746555620294,EDS 25,B05,888433,Staff,0,0,0,0
1746555620294,EDS 25,B06,888467,Staff,0,0,0,0
1746555620294,EDS 25,B07,888468,Staff,0,0,0,0
1746555620294,EDS 25,B08,888479,Staff,0,0,0,0
1746555620294,EDS 25,B09,888484,Staff,0,0,0,0
1746555620294,EDS 25,B10,888487,Staff,0,0,0,0
1746555621321,EDS 38,A01,907700,Choi; Bailey Miyeon,30,0,30,0
1746555622347,EDS 112,A01,888601,Chapman; Thandeka K,14,0,40,26
1746555623372,EDS 115,A00,888697,Mendez; Kathrina Mendoza,10,0,30,20
1746555624399,EDS 116,A01,888893,Staff,35,0,40,5
1746555626473,EDS 124AR,A00,889133,Staff,29,0,50,21
1746555626473,EDS 124AR,B00,907471,Simon; Elizabeth A,37,0,50,13
1746555627499,EDS 124BR,A00,889134,Simon; Elizabeth A,45,0,100,55
1746555628522,EDS 125,A00,889135,Staff,25,0,30,5
1746555629550,EDS 126,A01,889138,Staff,36,0,40,4
1746555630574,EDS 164R,A01,889142,Wishard Guerra; Alison G.,33,0,50,17
1746555631601,ENG 30,A01,886396,Staff,0,0,0,0
1746555631601,ENG 30,B01,886398,Staff,0,0,0,0
1746555632629,ENVR 102,A00,906150,Montejo; Carolina,23,0,25,2
1746555633653,ETHN 103A,A00,887236,Man; Simeon S,0,3,0,0
1746555634677,ETHN 113,A00,887239,Staff,16,0,30,14
1746555635701,ETHN 116,A00,887240,Staff,16,0,25,9
1746555636729,ETHN 117,A00,887241,Choi; Esther Min,28,0,30,2
1746555637753,ETHN 118,A00,887243,Staff,24,0,30,6
1746555638779,ETHN 127,A00,887248,Cuong; Marisol,11,0,15,4
1746555639804,ETHN 139,A00,887250,Staff,7,0,10,3
1746555640832,ETHN 142,A00,887252,Staff,10,0,30,20
1746555641867,ETHN 161,A00,887253,Browne; Errol Tsekani,24,0,30,6
1746555642892,ETHN 163FR,A00,887255,Burelle; Julie Sara Veronique,0,0,5,5
1746555643920,GLBH 20,A00,889149,Elwardani; Nile Regina,8,0,42,34
1746555645973,GLBH 111,A01,889152,Burgos; Jose L.,17,0,17,0
1746555646998,GLBH 150,A00,889181,Sloane; Julia Kathryn,0,5,15,15
1746555649048,HDS 60,A01,886406,Warstadt; Melissa Fawn,73,0,80,7
1746555650075,HIAF 111,A00,889324,Gyamfi; Bright,25,0,32,7
1746555651100,HIEA 131,A00,889328,Staff,16,0,32,16
1746555652126,HIEA 144,A00,889333,Henry; Todd A.,26,0,32,6
1746555653149,HIEA 154,A00,889336,Henry; Todd A.,24,0,32,8
1746555654174,HIEU 106,A00,889339,Staff,22,0,32,10
1746555656233,HIEU 114,A00,889340,Staff,3,0,32,29
1746555657260,HIEU 135GS,A00,889342,Patterson; Patrick H.,0,0,1,24
1746555658285,HIEU 137,A00,889343,Edington; Claire Ellen,9,0,25,16
1746555659312,HIEU 148,A00,889345,Staff,14,0,32,18
1746555660336,HIEU 154,A00,889346,Biess; Frank Peter,21,0,32,11
1746555661360,HILA 102,A00,889351,Staff,12,0,32,20
1746555662385,HILD 2A,A01,889221,Lewandoski; Julia Mavis,1,10,32,31
1746555663411,HILD 7B,A01,889225,Man; Simeon S,0,13,32,32
1746555664437,HILD 7C,A01,889288,Alvarez; Luis A,0,14,32,32
1746555665465,HILD 30,A01,889323,Staff,0,5,32,32
1746555667517,HISC 119,A00,889383,Golan; Tal,20,0,32,12
1746555668545,HIUS 103,A00,889384,Man; Simeon S,0,0,32,32
1746555669570,HIUS 117,A00,919797,Kwak; Nancy,18,0,32,14
1746555670597,HIUS 142A,A00,919788,Staff,22,0,32,10
1746555672651,HIUS 149,A00,889386,Gyamfi; Bright,27,0,32,5
1746555673677,HIUS 155,A00,889387,Alvarez; Luis A,14,0,32,18
1746555674707,HUM 3,A01,886499,Caldwell; Michael Alan,19,0,50,31
1746555675732,HUM 3GS,A00,886500,Rodriguez; Bretton Sigfred,0,0,0,28
1746555676759,HUM 3R,A01,886502,Markman; Kristina,0,36,50,50
1746555677785,HUM 4,A01,886504,Crum; Matthew Stephen,24,0,50,26
1746555677785,HUM 4,B01,886506,West; Geoffrey Scott,17,0,50,33
1746555678811,HUM 4GS,A00,886507,Staff,0,0,0,19
1746555679841,HUM 5,A01,886509,Staff,32,0,50,18
1746555680865,HUM 5R,A01,886511,Zavodny; Tatiana Sophia,0,39,50,50
1746555681893,JAPN 180,A00,886407,Staff,17,0,40,23
1746555682925,LATI 50,A01,886409,Martin-Cabrera; Luis,4,0,22,18
1746555682925,LATI 50,A02,886410,Martin-Cabrera; Luis,19,0,22,3
1746555682925,LATI 50,A03,886411,Martin-Cabrera; Luis,21,0,22,1
1746555682925,LATI 50,A04,886412,Martin-Cabrera; Luis,9,0,22,13
1746555683951,LAWS 101,A00,907664,Staff,28,0,60,32
1746555684978,LIAB 1A,A00,889388,Saab; Dima,17,0,20,3
1746555686004,LIAB 1AX,A00,889389,El Cheddadi; Youniss,17,0,20,3
1746555687030,LIFR 1C,A00,889391,Van Moer; Vinciane G,8,0,20,12
1746555688055,LIFR 1CX,A00,889392,Van Moer; Vinciane G,7,0,20,13
1746555689081,LIFR 1D,A00,889393,Van Moer; Vinciane G,7,0,20,13
1746555690108,LIFR 1DX,A00,889394,Van Moer; Vinciane G,8,0,20,12
1746555691134,LIGN 7,A00,886923,Staff,24,0,50,26
1746555692158,LIGN 17,A00,886924,Kehler; Andrew Scott,125,0,150,25
1746555693186,LTAM 110,A00,889395,Staff,15,0,30,15
1746555694210,LTAM 110GS,A00,958010,Rodriguez; Bretton Sigfred,0,0,0,28
1746555695236,LTCH 101,A00,889397,Staff,23,0,25,2
1746555696263,LTCS 130,A00,889398,Staff,23,0,25,2
1746555697288,LTEA 138,A00,889399,Staff,24,0,40,16
1746555698313,LTEN 149,A00,889400,Wesling; Megan E.,0,3,25,25
1746555699338,LTEN 169,A00,889401,Staff,20,0,25,5
1746555700361,LTEN 180,A00,889402,Staff,10,0,15,5
1746555701386,LTEN 181,A00,889403,Staff,21,0,25,4
1746555702425,LTWL 100,A00,889404,Myerston Santana; Jacobo,3,0,25,22
1746555703449,LTWL 180GS,A00,889405,Staff,0,0,20,20
1746555704476,LTWL 181,A00,889406,Staff,17,0,25,8
1746555705501,LTWL 184,A00,889475,Mukherjee; Silpa,22,0,25,3
1746555706524,LTWR 102C,A00,889486,Staff,29,0,30,1
1746555707548,LTWR 115W,A00,889491,Staff,0,2,15,15
1746555708574,MAE 8,A01,886905,Staff,0,2,0,0
1746555709599,MAE 11,A00,886906,Bandaru; Prabhakar,0,7,50,50
1746555710623,MAE 20,A00,886907,Evdokimenko; Ekaterina,43,0,70,27
1746555711650,MAE 30B,A00,886909,Ghazinejad; Maziar,26,0,45,19
1746555712677,MAE 101B,A00,886910,Saintillan; David,29,0,45,16
1746555713705,MAE 105,A00,886911,Bandaru; Prabhakar,18,0,50,32
1746555714730,MAE 107,B00,958024,Staff,8,0,50,42
1746555715756,MAE 143B,A00,886913,Bewley; Thomas R,7,0,40,33
1746555716781,MAE 148,A01,886915,Silberman; Jack,0,3,14,14
1746555717810,MAE 160,A00,886916,Evdokimenko; Ekaterina,31,0,60,29
1746555718837,MATH 3C,A01,889681,Staff,0,3,30,30
1746555718837,MATH 3C,A02,960048,Staff,25,0,30,5
1746555719863,MATH 10A,A01,889760,Staff,26,0,30,4
1746555719863,MATH 10A,A02,889783,Staff,29,0,30,1
1746555720889,MATH 10B,A01,889785,Verstraete; Jacques Allan,2,0,35,33
1746555720889,MATH 10B,A02,889795,Verstraete; Jacques Allan,4,0,35,31
1746555720889,MATH 10B,B01,889797,Verstraete; Jacques Allan,3,0,35,32
1746555720889,MATH 10B,B02,889828,Verstraete; Jacques Allan,3,0,35,32
1746555721922,MATH 10C,A01,889849,Habib; Yousaf,8,0,30,22
1746555721922,MATH 10C,A02,889852,Habib; Yousaf,14,0,30,16
1746555721922,MATH 10C,A03,889853,Habib; Yousaf,22,0,30,8
1746555721922,MATH 10C,A04,889858,Habib; Yousaf,20,0,30,10
1746555721922,MATH 10C,B01,889861,Staff,1,0,30,29
1746555721922,MATH 10C,B02,889862,Staff,24,0,30,6
1746555721922,MATH 10C,B03,889863,Staff,27,0,30,3
1746555721922,MATH 10C,B04,889967,Staff,23,0,30,7
1746555722951,MATH 18,A01,889974,Staff,7,0,30,23
1746555722951,MATH 18,A02,889977,Staff,20,0,30,10
1746555722951,MATH 18,B01,889984,Hardiman; Liam,21,0,30,9
1746555722951,MATH 18,B02,889985,Hardiman; Liam,25,0,30,5
1746555723975,MATH 20A,A01,889990,Suk; Andrew Hoon,30,0,35,5
1746555725002,MATH 20B,A01,889993,Ohm; Ko Woon,22,0,30,8
1746555725002,MATH 20B,A02,889994,Ohm; Ko Woon,30,0,30,0
1746555725002,MATH 20B,B01,889996,Ohm; Ko Woon,21,0,30,9
1746555725002,MATH 20B,B02,889997,Ohm; Ko Woon,23,0,30,7
1746555726032,MATH 20C,A01,889999,Hammock; Frances H,17,0,30,13
1746555726032,MATH 20C,A02,890003,Hammock; Frances H,23,0,30,7
1746555726032,MATH 20C,B01,890006,Hammock; Frances H,3,0,30,27
1746555726032,MATH 20C,B02,890007,Hammock; Frances H,11,0,30,19
1746555727058,MATH 20D,A01,890011,Cheng; Hsiao-Bing,1,1,30,29
1746555727058,MATH 20D,A02,890012,Cheng; Hsiao-Bing,14,0,30,16
1746555727058,MATH 20D,B01,890016,Cheng; Hsiao-Bing,13,0,30,17
1746555727058,MATH 20D,B02,890017,Cheng; Hsiao-Bing,13,0,30,17
1746555728083,MATH 20E,A01,890026,Harel; Guershon,1,0,30,29
1746555728083,MATH 20E,A02,890029,Harel; Guershon,23,0,30,7
1746555728083,MATH 20E,B01,890033,Harel; Guershon,7,0,30,23
1746555728083,MATH 20E,B02,890101,Harel; Guershon,21,0,30,9
1746555729109,MATH 102,A01,890104,Staff,17,0,30,13
1746555729109,MATH 102,A02,890105,Staff,27,0,30,3
1746555730136,MATH 103B,A01,890116,Salehi Golsefidy; Alireza,3,0,30,27
1746555730136,MATH 103B,B01,890118,Staff,0,3,34,34
1746555731163,MATH 109,A01,890121,Aliabadi Sr.; Mohsen,1,0,30,29
1746555731163,MATH 109,B01,890124,Upadrashta; Pranav Kumar,18,0,30,12
1746555732189,MATH 120A,A01,890126,Eggers; John Dietrich,13,0,30,17
1746555733215,MATH 142B,A01,890128,Ioana; Adrian,19,0,30,11
1746555733215,MATH 142B,A02,890129,Ioana; Adrian,13,0,30,17
1746555734244,MATH 154,A01,890174,Staff,0,0,30,30
1746555734244,MATH 154,A02,890182,Staff,0,0,30,30
1746555735288,MATH 168A,A01,890197,Dumitriu; Ioana,21,0,35,14
1746555736317,MATH 170A,A01,890240,Nie; Jiawang,1,0,30,29
1746555736317,MATH 170A,A02,890241,Nie; Jiawang,11,0,30,19
1746555736317,MATH 170A,A03,890249,Nie; Jiawang,23,0,30,7
1746555737341,MATH 170B,A01,957891,Nag; Panchali,13,0,35,22
1746555739397,MATH 181A,A01,908025,Staff,0,4,35,35
1746555739397,MATH 181A,A02,960115,Staff,27,0,35,8
1746555740426,MATH 181B,A01,959874,Staff,25,0,30,5
1746555741451,MATH 193B,A01,890265,Staff,0,4,35,35
1746555742475,MGT 4,A01,890311,Anderson; John Charles,42,0,88,46
1746555743499,MGT 5,A00,907740,Staff,13,0,98,85
1746555744525,MGT 12,A00,890312,Lindenberger; Wade Douglas,67,0,98,31
1746555745549,MGT 16,A00,957883,Staff,78,0,98,20
1746555747601,MGT 45,A00,890314,Pecore; Joseph P.,47,0,98,51
1746555748626,MGT 71,A00,890315,Staff,0,11,98,98
1746555749654,MGT 100,A00,890316,Yavorsky; Daniel Ryan,44,0,98,54
1746555750681,MGT 103,A00,890317,Ehrich; Kristine R,73,0,98,25
1746555751707,MGT 105,A00,890356,Bates; Kenneth Walter,0,7,98,98
1746555752733,MGT 112,A00,890360,Ehrich; Kristine R,55,0,98,43
1746555753757,MGT 127R,A00,907732,Zhu; Kevin Xiaoguo,24,0,98,74
1746555754781,MGT 131B,A00,890361,Anderson; John Charles,60,0,98,38
1746555755808,MGT 137,A00,890362,Lindenberger; Wade Douglas,65,0,98,33
1746555756835,MGT 160,A00,890369,Johnson; Erik Barry,9,0,98,89
1746555758889,MGT 164,A00,890372,Zimmermann; Carsten,0,39,98,98
1746555759917,MGT 180,A00,890374,Bliss; Barbara Ann,12,0,98,86
1746555760946,MMW 15,A01,886414,Chang; Edmond Yi-Teh,0,12,28,28
1746555760946,MMW 15,A02,886415,Chang; Edmond Yi-Teh,0,8,28,28
1746555760946,MMW 15,A03,886416,Chang; Edmond Yi-Teh,0,8,28,28
1746555760946,MMW 15,A04,886417,Chang; Edmond Yi-Teh,0,8,28,28
1746555760946,MMW 15,B01,886419,Chang; Edmond Yi-Teh,0,7,28,28
1746555760946,MMW 15,B02,886420,Chang; Edmond Yi-Teh,0,8,28,28
1746555760946,MMW 15,B03,886421,Chang; Edmond Yi-Teh,0,7,28,28
1746555760946,MMW 15,B04,886422,Chang; Edmond Yi-Teh,0,8,28,28
1746555760946,MMW 15,C01,886424,Staff,0,9,28,28
1746555760946,MMW 15,C02,886425,Staff,0,8,28,28
1746555760946,MMW 15,C03,886426,Staff,0,8,28,28
1746555760946,MMW 15,C04,886427,Staff,0,8,28,28
1746555760946,MMW 15,C05,958038,Staff,0,7,28,28
1746555760946,MMW 15,C06,958039,Staff,0,8,28,28
1746555761974,MMW 15GS,A00,906910,Patterson; Patrick H.,4,0,28,24
1746555762997,MMW 122R,A01,886429,Rahimi; Babak,0,13,28,28
1746555762997,MMW 122R,A02,886430,Rahimi; Babak,0,12,28,28
1746555762997,MMW 122R,A03,958040,Rahimi; Babak,0,11,28,28
1746555764026,MUS 1A,A01,890937,Staff,2,0,25,23
1746555764026,MUS 1A,A02,891035,Staff,6,0,25,19
1746555764026,MUS 1A,C01,958912,Staff,24,0,25,1
1746555764026,MUS 1A,C02,958913,Staff,25,0,25,0
1746555766079,MUS 2AK,A00,957092,Ohnishi; Takae,15,0,15,0
1746555767104,MUS 4,A01,891044,Staff,2,0,25,23
1746555767104,MUS 4,A02,891045,Staff,23,0,25,2
1746555767104,MUS 4,B01,891048,Staff,17,0,25,8
1746555767104,MUS 4,B02,891050,Staff,25,0,25,0
1746555768133,MUS 5,A01,957506,Dubnov; Shlomo,0,0,25,25
1746555768133,MUS 5,A02,957622,Dubnov; Shlomo,13,0,25,12
1746555768133,MUS 5,A03,957623,Dubnov; Shlomo,20,0,25,5
1746555769158,MUS 6,A01,891053,Freitas Caetano; Marcelo,24,0,25,1
1746555769158,MUS 6,A02,891054,Freitas Caetano; Marcelo,23,0,25,2
1746555770186,MUS 7,A01,891081,Staff,0,0,25,25
1746555770186,MUS 7,A02,891082,Staff,4,0,25,21
1746555771214,MUS 8GS,A00,891118,Borgo; David Garcia,0,0,25,25
1746555772239,MUS 11,A01,891140,Staff,11,0,25,14
1746555772239,MUS 11,A02,891141,Staff,22,0,25,3
1746555773264,MUS 13,A01,891143,Staff,8,0,25,17
1746555773264,MUS 13,A02,891144,Staff,24,0,25,1
1746555774289,MUS 15,A01,891146,Staff,9,0,25,16
1746555774289,MUS 15,A02,891148,Staff,21,0,25,4
1746555774289,MUS 15,B01,891150,Staff,18,0,25,7
1746555774289,MUS 15,B02,891151,Staff,25,0,25,0
1746555775317,MUS 20,A01,891153,Staff,5,0,20,15
1746555775317,MUS 20,A02,891155,Staff,14,0,20,6
1746555776345,MUS 80,A00,891156,Staff,19,0,25,6
1746555776345,MUS 80,B00,891157,Staff,23,0,25,2
1746555777373,MUS 130,A00,891158,Ohnishi; Takae,35,0,35,0
1746555778398,MUS 150GS,A01,891160,Borgo; David Garcia,0,0,25,25
1746555779426,MUS 170,A01,891162,Freitas Caetano; Marcelo,20,0,25,5
1746555779426,MUS 170,A02,891164,Freitas Caetano; Marcelo,21,0,25,4
1746555780454,NANO 11,A00,886220,Vazquez Mena; Oscar,13,0,15,2
1746555781482,NANO 15,A01,886222,Drews; Aaron,4,0,7,3
1746555782507,NANO 104,A00,886224,Sirbuly; Donald,18,0,25,7
1746555783536,PH 40,A00,886528,Staff,23,0,40,17
1746555784562,PH 45,A01,886799,Staff,35,0,40,5
1746555785591,PH 110,A00,886802,Staff,0,7,40,40
1746555786618,PH 172,A00,906716,Staff,19,0,35,16
1746555787642,PH 191,A00,886803,Staff,6,0,40,34
1746555788666,PHIL 1,A00,889500,Staff,20,0,30,10
1746555789692,PHIL 10,A01,889549,Grush; Rick Scott,15,0,22,7
1746555789692,PHIL 10,A02,889551,Grush; Rick Scott,22,0,22,0
1746555790724,PHIL 28,A01,889559,Lamey; Andy M.,0,1,31,31
1746555790724,PHIL 28,A02,889561,Lamey; Andy M.,0,1,30,30
1746555790724,PHIL 28,A03,889572,Lamey; Andy M.,0,1,30,30
1746555791747,PHIL 35,A00,907839,Staff,13,0,15,2
1746555792772,PHIL 60,A00,889574,Staff,74,0,90,16
1746555793800,PHIL 101,A00,958004,Staff,12,0,15,3
1746555795858,PHIL 136,A00,889582,Fulkerson; Matthew Todd,26,0,45,19
1746555796883,PHIL 163,A01,889601,Staff,21,0,30,9
1746555796883,PHIL 163,B01,889606,Brandt; Reuven A,0,3,0,0
1746555797907,PHIL 164,A00,889610,Staff,16,0,30,14
1746555798934,PHIL 165,A00,889613,Staff,23,0,30,7
1746555799969,PHYS 1A,A00,886431,Staff,26,0,70,44
1746555800996,PHYS 1AL,001,886432,Tsai; Philbert S,0,2,30,30
1746555800996,PHYS 1AL,002,886436,Tsai; Philbert S,11,0,30,19
1746555802022,PHYS 1B,A00,886439,Staff,185,0,240,55
1746555803046,PHYS 1BL,001,886441,Tsai; Philbert S,0,4,30,30
1746555803046,PHYS 1BL,002,886444,Tsai; Philbert S,2,0,30,28
1746555804071,PHYS 1C,A00,896092,Arnold; Kam S,78,0,146,68
1746555805098,PHYS 1CL,001,886448,Tsai; Philbert S,0,0,30,30
1746555805098,PHYS 1CL,002,886449,Tsai; Philbert S,0,0,30,30
1746555805098,PHYS 1CL,003,886450,Tsai; Philbert S,16,0,30,14
1746555805098,PHYS 1CL,004,886451,Tsai; Philbert S,15,0,30,15
1746555806124,PHYS 2B,A01,886457,Staff,68,0,115,47
1746555807148,PHYS 2C,A01,886460,Shotwell; Brian,0,9,65,65
1746555808176,PHYS 2CL,A01,886467,Staff,0,4,28,28
1746555808176,PHYS 2CL,A02,886468,Staff,0,3,28,28
1746555809199,PHYS 2D,A01,886470,Staff,10,0,50,40
1746555810224,PHYS 4B,A01,886475,Grinstein; Benjamin,22,0,40,18
1746555811248,POLI 5,A00,891173,Desposato; Scott,7,0,25,18
1746555812274,POLI 5D,A01,891175,Staff,5,0,5,0
1746555812274,POLI 5D,B01,891178,Staff,5,0,5,0
1746555813298,POLI 11,A00,891179,Ferree; Karen E,2,0,35,33
1746555814323,POLI 12,A00,891180,Staff,16,0,30,14
1746555815346,POLI 27,A01,891182,Staff,12,0,75,63
1746555816373,POLI 30,A00,891183,Staff,8,0,50,42
1746555817397,POLI 100B,A00,891244,Staff,5,1,35,30
1746555818422,POLI 100I,A00,891247,Staff,7,0,30,23
1746555819447,POLI 104J,A00,891248,Nichter; Maysa,14,0,30,16
1746555820471,POLI 104U,A00,891250,Nichter; Maysa,2,0,30,28
1746555822521,POLI 110B,A00,891255,Wiens; David,20,0,25,5
1746555823597,POLI 112A,A00,891256,Wiens; David,6,0,25,19
1746555824620,POLI 114BR,A00,891261,Staff,19,0,30,11
1746555825649,POLI 117R,A00,891262,Forman; Fonna,0,6,50,50
1746555826675,POLI 118,A00,891264,Ingham; Sean,17,0,25,8
1746555827703,POLI 124A,A00,891265,Staff,18,0,20,2
1746555828732,POLI 125D,A00,891266,Nichter; Simeon C,2,0,25,23
1746555829760,POLI 126,A00,891268,Nichter; Simeon C,7,0,25,18
1746555830787,POLI 126AA,A00,891272,Staff,17,0,25,8
1746555831810,POLI 130AA,A00,891273,Staff,15,0,20,5
1746555832835,POLI 134AA,A00,891274,Staff,4,0,20,16
1746555834913,POLI 138,A00,891278,Staff,21,0,25,4
1746555835946,POLI 142K,A00,891280,Staff,11,0,25,14
1746555836971,POLI 142M,A00,891281,Gartzke; Erik,17,0,30,13
1746555837994,POLI 142P,A00,891284,Staff,20,0,30,10
1746555839022,POLI 143,A00,891285,Gartzke; Erik,12,0,30,18
1746555840052,POLI 153,A00,891286,Staff,19,0,20,1
1746555842107,POLI 175,A00,891290,Staff,15,0,20,5
1746555843133,PSYC 1,A00,890674,Steiner; Eric Tomas,0,11,45,45
1746555844159,PSYC 2,A00,890676,Albright; Thomas D,21,0,35,14
1746555845186,PSYC 3,A00,890679,Staff,17,0,20,3
1746555846215,PSYC 6,A00,959858,Staff,20,0,20,0
1746555847239,PSYC 60,A01,890684,Rickard; Timothy C.,0,5,45,45
1746555848266,PSYC 70,A01,890689,Geller; Emma Harlan,7,0,30,23
1746555849294,PSYC 71,A01,959860,Staff,21,0,25,4
1746555850322,PSYC 100,A00,890690,Lacefield; Katharine I,0,50,180,180
1746555851346,PSYC 102,A00,890695,Staff,18,0,40,22
1746555852374,PSYC 105,A00,890699,Geller; Emma Harlan,70,0,100,30
1746555853399,PSYC 106,A00,890701,Gorman; Michael R.,6,0,30,24
1746555854425,PSYC 108,A00,890704,Adrian; Julia Anna,0,28,50,50
1746555855450,PSYC 118,A01,890712,Staff,11,0,30,19
1746555856474,PSYC 124,A00,890716,Chapman; Eddie Nathaniel,25,0,60,35
1746555857502,PSYC 131,A00,890717,Anagnostaras; Stephan,0,7,80,80
1746555858526,PSYC 137,A00,890719,Winkielman; Piotr,0,11,30,30
1746555859552,PSYC 144,A00,890721,Adrian; Julia Anna,0,9,45,45
1746555860579,PSYC 162,A00,890805,Staff,2,0,75,73
1746555861604,PSYC 169,A00,890810,Staff,0,14,30,30
1746555862631,PSYC 172,A00,890814,Gorman; Michael R.,9,0,30,21
1746555863658,PSYC 181,A00,890818,Anagnostaras; Stephan,8,0,200,192
1746555864684,PSYC 184,A00,959861,Staff,170,0,175,5
1746555865708,PSYC 189,A00,890823,Staff,0,1,30,30
1746555866733,PSYC 191,A00,890884,Rickard; Timothy C.,0,11,35,35
1746555867757,PSYC 193,A00,890913,Staff,19,0,30,11
1746555867757,PSYC 193,B00,890914,Chapman; Eddie Nathaniel,24,0,30,6
1746555868821,PSYC 193L,A01,890918,Lowe; Angela Beth,20,0,30,10
1746555868821,PSYC 193L,B01,890921,Hurwitz; Ethan Scott,20,0,30,10
1746555868821,PSYC 193L,C01,890928,Staff,30,0,30,0
1746555869847,RELI 149,A00,886806,Rahimi; Babak,23,0,40,17
1746555870877,SE 9,A01,886814,Staff,7,0,20,13
1746555871904,SE 101B,A01,886816,Chadha; Mayank,4,0,35,31
1746555872932,SE 110B,A00,886818,Zhu; Qiang,4,0,75,71
1746555873958,SE 125,A01,886830,Staff,10,0,30,20
1746555874982,SE 130B,A01,886835,Staff,14,0,40,26
1746555876010,SE 131A,A01,886838,Krysl; Petr,34,0,55,21
1746555877037,SE 154,A00,886840,Staff,29,0,50,21
1746555878062,SE 164GS,A01,886849,Staff,6,0,20,14
1746555879088,SE 167GS,A01,886853,Staff,6,0,20,14
1746555880115,SIO 25,A01,890107,Staff,19,0,30,11
1746555881138,SIO 45,A00,890109,Cook; Geoffrey W,117,0,200,83
1746555882162,SIO 109R,A00,890110,Forman; Fonna,0,16,20,20
1746555883187,SIO 187,A01,890114,Kacev; David,15,0,40,25
1746555884215,SOCI 1,A01,890431,Thorpe; Charles Robert,15,0,30,15
1746555884215,SOCI 1,A02,890518,Thorpe; Charles Robert,30,0,30,0
1746555885242,SOCI 2,A01,957978,Staff,25,0,25,0
1746555885242,SOCI 2,A02,957979,Staff,23,0,25,2
1746555886270,SOCI 20,A01,890523,Calderon-Zaks; Michael Aar,23,0,30,7
1746555886270,SOCI 20,A02,890526,Calderon-Zaks; Michael Aar,29,0,30,1
1746555887300,SOCI 30,A01,890533,Pardo Guerra; Juan Pablo,37,0,40,3
1746555888326,SOCI 40,A01,890535,Staff,27,0,45,18
1746555889352,SOCI 104Q,A00,890559,Staff,18,0,30,12
1746555890381,SOCI 106,A00,890560,Arnal; Maud Marie Leonie,20,0,30,10
1746555891405,SOCI 110,A00,890567,Holkenbrink-Monk; Charlene,19,0,30,11
1746555892430,SOCI 112,A00,890568,Victoria Torres; Pablo,2,0,55,53
1746555893456,SOCI 115,A00,890597,Arnal; Maud Marie Leonie,28,0,45,17
1746555895507,SOCI 121,A00,890604,Pardo Guerra; Juan Pablo,38,0,45,7
1746555896536,SOCI 126,A01,890608,Staff,8,0,10,2
1746555897561,SOCI 127,A00,890609,Staff,18,0,30,12
1746555898589,SOCI 131,A00,890610,Thorpe; Charles Robert,37,0,45,8
1746555899614,SOCI 135,A00,890615,Payne; Christine Anna,14,0,45,31
1746555900641,SOCI 139,A00,890620,Staff,38,0,45,7
1746555901666,SOCI 148E,A00,890622,Calderon-Zaks; Michael Aar,36,0,45,9
1746555902692,SOCI 150,A00,890623,Kohler; Kristopher M.,31,0,45,14
1746555903717,SOCI 157,A00,890625,Jules-Rosette; Bennetta W.,18,0,20,2
1746555904742,SOCI 160,A00,890627,Payne; Christine Anna,21,0,45,24
1746555905767,SYN 1,A00,886855,Fish; Gwendolyn Anne,0,0,0,0
1746555905767,SYN 1,B00,906086,Fish; Gwendolyn Anne,0,1,0,2
1746555906794,SYN 2R,A00,886860,Staff,0,17,15,15
1746555906794,SYN 2R,B00,906106,Atkinson; Arthur Laird,0,16,15,15
1746555907819,SYN 100,A01,886866,Browne; Emily,0,28,20,20
1746555907819,SYN 100,B01,906128,Rock; Martin,0,5,20,20
1746555907819,SYN 100,C01,906140,Deavenport; James Cary,0,3,20,20
1746555907819,SYN 100,D01,907816,Deavenport; James Cary,0,5,20,20
1746555908845,TDAC 1,A00,890286,Walsh; Kim C.,9,0,20,11
1746555909869,TDAC 101,A00,890296,Basso; Beatrice,16,0,20,4
1746555910895,TDDE 131,A00,890297,Staff,47,0,50,3
1746555911919,TDDM 1,A00,890287,Weinberg; Sadie,25,0,30,5
1746555912943,TDGE 11,A00,890288,Fulton; Julia,137,0,200,63
1746555912943,TDGE 11,B00,890289,Castro; Robert Jess,184,0,200,16
1746555913971,TDGE 25,B00,957359,Walsh; Kim C.,3,0,20,17
1746555914998,TDGE 40,A01,890292,Power; Jade Yukana,27,0,30,3
1746555916022,TDGE 124,A00,890298,Havis; Allan,0,1,50,50
1746555917046,TDGE 131R,A00,890299,Burelle; Julie Sara Veronique,15,0,42,27
1746555918072,TDHT 101,A00,890300,Staff,10,0,20,10
1746555919102,TDHT 109,A01,890302,Anderson; Mysia Anyse,31,0,40,9
1746555920134,TDMV 1,A00,890293,Arcidiacono; Kristin,18,0,30,12
1746555921161,TDMV 2,A00,890294,Weinberg; Sadie,23,0,30,7
1746555922188,TDMV 3,A00,957878,Arcidiacono; Kristin,28,0,30,2
1746555924237,TDMV 138,A00,890304,Jun; Grace Shin Hae,25,0,40,15
1746555925263,TDMV 140,A00,890305,Corrales; Joseph Bernales,25,0,30,5
1746555926288,TDMV 142,A00,890307,Caligagan; Tony,32,0,40,8
1746555927314,TDMV 144,A00,890308,Camaya; Michelle Ann,25,0,30,5
1746555928341,TDPW 1,A00,890295,Stein; Deborah Isobel,3,0,20,17
1746555929368,USP 2,A01,890272,Lerner; Amy M,6,0,20,14
1746555930395,USP 3,A01,890274,Staff,12,0,30,18
1746555931423,USP 15,A01,890276,Sun; Feiyang,17,0,30,13
1746555932451,USP 25,A00,890277,Shenkman; Michael Thomas,19,0,25,6
1746555933479,USP 138,A00,890278,Staff,13,0,25,12
1746555934508,USP 143,A00,890279,Staff,21,0,70,49
1746555935535,USP 144,A00,890280,Chowdhury; Muhammed Zohir,16,0,30,14
1746555936563,USP 150,A00,890281,Boomhower; Matthew Charles,4,0,30,26
1746555937588,USP 151,A00,890282,Staff,16,0,20,4
1746555938612,USP 162,A00,890283,Andrews; Abigail Leslie,16,0,20,4
1746555939641,USP 168,A00,920477,Kwak; Nancy,1,0,5,4
1746555940670,USP 181,A00,890284,Staff,3,0,20,17
1746555941902,USP 191A,A00,890285,Staff,12,0,20,8
1746555942927,VIS 101,A00,886512,Staff,25,0,75,50
1746555943953,VIS 103,A00,886513,Cruz; Edwin Teddy,61,0,75,14
1746555944981,VIS 108,A00,886514,Staff,3,0,15,12
1746555946007,VIS 127P,A00,886515,Shen; Kuiyi,80,0,146,66
1746555947031,VIS 149,A00,886516,Yoldas; Pinar,0,0,15,15
1746555948060,VIS 164,A00,886526,Erdmann; Dean,19,0,22,3
1746555949087,VIS 194S,A00,886527,Staff,61,0,75,14
1746555950129,WCWP 10A,C00,886484,Martiniuk; Jill,12,0,15,3
1746555951156,WCWP 10B,A00,886490,Uriarte; Emma,0,0,15,15
1746555951156,WCWP 10B,B00,886491,Dhir; Simrita,10,0,15,5
1746555951156,WCWP 10B,C00,886492,Ornelas; Tricia,0,0,15,15
1746555952181,WCWP 100,A00,886494,Young; Mark T,0,6,15,15
1746555954248,AAS 10,A01,886199,Childs; Dennis R.,0,3,0,0
1746555955273,ANAR 104,A01,886940,Shtienberg; Gilad,27,0,30,3
1746555956298,ANAR 120,A00,886953,Staff,12,0,20,8
1746555957327,ANBI 148,A01,886955,Wilder; Linnea Lorene,30,0,40,10
1746555959379,ANSC 122,A00,886957,Staff,25,0,30,5
1746555960406,ANSC 150,A00,886958,Sloane; Julia Kathryn,2,0,15,13
1746555961432,ANSC 156,A00,886959,Jenkins; Janis A.,0,1,15,15
1746555962457,ANSC 180,A00,886960,Staff,11,0,17,6
1746555963483,ANSC 188,A00,886961,Jassal; Aftab,9,0,25,16
1746555964508,ANSC 190,A00,886962,Jassal; Aftab,14,0,25,11
1746555965535,ANSC 191,A00,886963,Staff,18,0,20,2
1746555966559,ANTH 3,A01,891689,Staff,17,0,20,3
1746555967584,ANTH 5,A00,886933,Semendeferi; Ekaterini,16,0,20,4
1746555968608,ANTH 10,A00,886934,Staff,0,12,30,30
1746555969631,ANTH 21,A01,886936,Staff,40,0,60,20
1746555970657,ANTH 23,A01,886938,Staff,92,0,100,8
1746555971685,ANTH 105,A00,886964,Stewart; Alexander B,84,0,100,16
1746555972715,ANTH 108,A00,886965,Pedersen; David,9,0,20,11
1746555973748,AWP 10,001,886147,Staff,0,0,0,0
1746555973748,AWP 10,002,886148,Staff,0,0,0,0
1746555973748,AWP 10,003,886149,Staff,0,0,0,0
1746555973748,AWP 10,004,886150,Staff,0,0,0,0
1746555973748,AWP 10,005,886151,Staff,0,0,0,0
1746555973748,AWP 10,006,886152,Staff,0,0,0,0
1746555973748,AWP 10,007,886153,Staff,0,0,0,0
1746555973748,AWP 10,008,886154,Staff,0,0,0,0
1746555973748,AWP 10,009,886155,Staff,0,0,0,0
1746555973748,AWP 10,010,886156,Staff,0,0,0,0
1746555973748,AWP 10,011,886158,Staff,0,0,0,0
1746555973748,AWP 10,012,886160,Staff,0,0,0,0
1746555973748,AWP 10,013,886161,Staff,0,0,0,0
1746555973748,AWP 10,014,886162,Staff,0,0,0,0
1746555973748,AWP 10,015,886163,Staff,0,0,0,0
1746555973748,AWP 10,016,886164,Staff,0,0,0,0
1746555973748,AWP 10,017,886165,Staff,0,0,0,0
1746555973748,AWP 10,018,886166,Staff,0,0,0,0
1746555973748,AWP 10,019,886168,Staff,0,0,0,0
1746555973748,AWP 10,020,886170,Staff,0,0,0,0
1746555973748,AWP 10,021,886172,Staff,0,0,0,0
1746555974777,AWP 10R,001,886173,Staff,0,1,0,0
1746555974777,AWP 10R,002,886174,Staff,0,1,0,0
1746555974777,AWP 10R,003,886175,Staff,0,0,0,0
1746555974777,AWP 10R,004,886176,Staff,0,0,0,0
1746555974777,AWP 10R,005,886177,Staff,0,0,0,0
1746555974777,AWP 10R,006,886178,Staff,0,0,0,0
1746555974777,AWP 10R,007,886179,Staff,0,0,0,0
1746555974777,AWP 10R,008,886181,Staff,0,0,0,0
1746555974777,AWP 10R,009,886182,Staff,0,0,0,0
1746555974777,AWP 10R,010,886183,Staff,0,0,0,0
1746555974777,AWP 10R,011,886184,Staff,0,0,0,0
1746555974777,AWP 10R,012,886185,Staff,0,0,0,0
1746555974777,AWP 10R,013,886186,Staff,0,0,0,0
1746555974777,AWP 10R,014,886187,Staff,0,0,0,0
1746555974777,AWP 10R,015,886188,Staff,0,0,0,0
1746555974777,AWP 10R,016,886189,Staff,0,0,0,0
1746555974777,AWP 10R,017,960532,Staff,0,0,0,0
1746555974777,AWP 10R,018,960533,Staff,0,0,0,0
1746555974777,AWP 10R,019,960534,Staff,0,0,0,0
1746555974777,AWP 10R,020,960538,Staff,0,0,0,0
1746555974777,AWP 10R,021,960540,Staff,0,0,0,0
1746555974777,AWP 10R,022,960541,Staff,0,0,0,0
1746555974777,AWP 10R,023,960542,Staff,0,0,0,0
1746555974777,AWP 10R,024,960544,Staff,0,0,0,0
1746555974777,AWP 10R,025,960545,Staff,0,0,0,0
1746555974777,AWP 10R,026,960548,Staff,0,0,0,0
1746555975808,AWP 102R,A00,886190,Staff,0,0,0,0
1746555975808,AWP 102R,B00,886191,Staff,0,0,0,0
1746555976837,BENG 100,A01,886193,Staff,17,0,30,13
1746555977866,BENG 122A,A01,886195,Hasty; Jeff M,13,0,30,17
1746555978895,BENG 166A,A00,886196,Sah; Robert Lie-Yuan,0,2,30,30
1746555979921,BENG 190,A00,958050,Khojah; Reem I,23,0,25,2
1746555980947,BIBC 102,A01,894320,Staff,0,0,46,46
1746555980947,BIBC 102,A02,894321,Staff,0,0,46,46
1746555980947,BIBC 102,A03,894344,Staff,7,0,46,39
1746555980947,BIBC 102,A04,894345,Staff,26,0,47,21
1746555981978,BICD 100R,A01,894365,Smith; Laurie,0,4,58,58
1746555981978,BICD 100R,A02,894366,Smith; Laurie,0,5,58,58
1746555981978,BICD 100R,A03,894367,Smith; Laurie,1,0,59,58
1746555981978,BICD 100R,A04,959869,Smith; Laurie,41,0,59,18
1746555983007,BICD 136,A01,894383,Gustafson-Brown; Cindy,14,0,50,36
1746555984035,BIEB 102,A01,894494,Butler; Shannon Rhey,51,0,130,79
1746555986094,BIEB 150,A01,894617,Wills; Christopher,3,0,20,17
1746555986094,BIEB 150,A02,894631,Wills; Christopher,3,0,20,17
1746555986094,BIEB 150,A03,894937,Wills; Christopher,3,0,20,17
1746555986094,BIEB 150,A04,894946,Wills; Christopher,5,0,20,15
1746555987123,BIEB 194,A00,906141,Kurle; Carolyn M.,6,0,20,14
1746555988153,BILD 1,A01,894154,Staff,3,0,19,16
1746555988153,BILD 1,A02,894155,Staff,14,0,19,5
1746555988153,BILD 1,A03,894160,Staff,13,0,19,6
1746555988153,BILD 1,A04,894161,Staff,15,0,18,3
1746555989178,BILD 2,A01,894168,Staff,0,0,50,50
1746555989178,BILD 2,A02,894169,Staff,0,0,50,50
1746555989178,BILD 2,A03,894179,Staff,1,0,50,49
1746555989178,BILD 2,A04,894203,Staff,27,0,50,23
1746555990203,BILD 3,A01,894213,Staff,22,0,31,9
1746555990203,BILD 3,A02,894214,Staff,26,0,31,5
1746555990203,BILD 3,A03,894235,Staff,28,0,31,3
1746555990203,BILD 3,A04,894236,Staff,28,0,32,4
1746555991228,BILD 4,A01,894253,Reuther; Keefe,5,0,24,19
1746555991228,BILD 4,A02,894258,Reuther; Keefe,16,0,24,8
1746555992258,BILD 5,A01,894276,Reuther; Keefe,35,0,50,15
1746555992258,BILD 5,A02,894277,Reuther; Keefe,45,0,50,5
1746555992258,BILD 5,A03,894290,Reuther; Keefe,44,0,50,6
1746555992258,BILD 5,A04,894291,Reuther; Keefe,48,0,50,2
1746555993284,BILD 24,A01,894297,Pirino; Giorgia,40,0,60,20
1746555994314,BIMM 100,B01,958915,Staff,71,0,100,29
1746555995341,BIMM 101,A01,895017,McDonnell; Lisa Marie,0,5,24,24
1746555995341,BIMM 101,A02,895018,McDonnell; Lisa Marie,0,5,24,24
1746555995341,BIMM 101,B01,895020,McDonnell; Lisa Marie,0,6,24,24
1746555995341,BIMM 101,B02,895021,McDonnell; Lisa Marie,0,4,24,24
1746555996367,BIMM 110,A01,895023,Staff,1,0,25,24
1746555996367,BIMM 110,A02,895024,Staff,9,0,25,16
1746555996367,BIMM 110,A03,895025,Staff,18,0,25,7
1746555996367,BIMM 110,A04,895031,Staff,20,0,25,5
1746555997397,BIMM 120,A01,895114,Gustafson-Brown; Cindy,14,0,28,14
1746555997397,BIMM 120,A02,895126,Gustafson-Brown; Cindy,21,0,27,6
1746555998426,BIPN 100,A01,895130,Yang; Mingyu,1,0,38,37
1746555998426,BIPN 100,A02,895131,Yang; Mingyu,32,0,38,6
1746555998426,BIPN 100,A03,895132,Yang; Mingyu,32,0,38,6
1746555998426,BIPN 100,A04,895133,Yang; Mingyu,27,0,36,9
1746555999450,BIPN 120,A01,895135,Cooke; James Edward,0,3,13,13
1746555999450,BIPN 120,A02,895136,Cooke; James Edward,0,1,13,13
1746555999450,BIPN 120,A03,895137,Cooke; James Edward,0,3,13,13
1746555999450,BIPN 120,A04,895156,Cooke; James Edward,0,2,11,11
1746556000494,BIPN 134,A01,895235,Cooke; James Edward,0,2,25,25
1746556000494,BIPN 134,A02,895237,Cooke; James Edward,0,0,25,25
1746556000494,BIPN 134,A03,895240,Cooke; James Edward,3,0,25,22
1746556000494,BIPN 134,A04,895270,Cooke; James Edward,20,0,25,5
1746556001529,BIPN 189,A00,892103,Staff,0,13,14,14
1746556003582,BISP 194,A00,958008,Staff,0,2,0,0
1746556004607,CAT 124,A01,922009,Staff,0,5,20,20
1746556005637,CAT 125R,A00,886390,Morales; Celeste Georgianna,0,2,20,20
1746556005637,CAT 125R,B00,886391,Irwin; Matthew Joseph,0,3,20,20
1746556005637,CAT 125R,C00,886392,Smith; Lauryn Alissa,0,2,20,20
1746556005637,CAT 125R,D00,886393,Vanderschuit; Maya Alysia,0,2,20,20
1746556005637,CAT 125R,E00,886394,Marchisotto; Jennifer Anne,0,4,20,20
1746556006666,CENG 15,A01,886218,Drews; Aaron,3,0,8,5
1746556007700,CENG 113,A00,886219,Opatkiewicz; Justin Paul,15,0,25,10
1746556008724,CGS 101,A00,887044,Staff,7,0,20,13
1746556009749,CGS 105,A01,887046,Staff,14,0,25,11
1746556010776,CGS 112,A00,887047,Cuong; Marisol,12,0,15,3
1746556011801,CGS 113,A00,887048,Staff,23,0,30,7
1746556012826,CGS 120,A00,887049,Staff,10,0,17,7
1746556013854,CHEM 6A,A01,886336,Lam; Tin Yiu,38,0,50,12
1746556013854,CHEM 6A,A02,886338,Lam; Tin Yiu,37,0,50,13
1746556014880,CHEM 6B,A01,886341,Hopkins; Patrycja Anna,16,0,50,34
1746556014880,CHEM 6B,A02,886343,Hopkins; Patrycja Anna,42,0,50,8
1746556015905,CHEM 6C,A01,886346,Albizati; Kim F.,0,2,50,50
1746556015905,CHEM 6C,A02,886348,Albizati; Kim F.,23,0,50,27
1746556016934,CHEM 40A,A01,886352,Klosterman; Jeremy K,65,0,100,35
1746556017960,CHEM 40B,A01,886356,Klosterman; Jeremy K,0,23,100,100
1746556018988,CHEM 41B,A01,886360,Theodorakis; Emmanuel,25,0,50,25
1746556018988,CHEM 41B,A02,886362,Theodorakis; Emmanuel,47,0,50,3
1746556020012,CHIN 165A,A00,886382,Xu; Li,18,0,20,2
1746556021040,CLAS 120,A00,886387,Myerston Santana; Jacobo,33,0,40,7
1746556022068,COGS 9,A01,886967,Shannon; Kyle Michael,42,0,60,18
1746556023092,COGS 11,A01,886969,Staff,11,0,30,19
1746556024117,COGS 14A,A01,886971,Staff,6,0,60,54
1746556025142,COGS 14B,A01,886973,Hoffman; Drew Ellen,4,0,60,56
1746556026168,COGS 18,A01,886975,Morgan; Eric,35,0,60,25
1746556027192,COGS 20,A01,886977,Staff,4,0,8,4
1746556027192,COGS 20,A02,886978,Staff,5,0,7,2
1746556028219,COGS 100,A01,907783,Staff,0,2,30,30
1746556029246,COGS 101B,A01,886980,Staff,0,3,48,48
1746556030275,COGS 101C,A01,886982,Delgado; Tania,0,5,44,44
1746556031299,COGS 102A,A01,886984,Johnson; Christine M.,4,0,30,26
1746556032325,COGS 118B,A01,886986,Staff,0,3,88,88
1746556033352,COGS 150,A01,886988,Bergen; Benjamin,23,0,50,27
1746556034377,COGS 153,A00,886989,Delgado; Tania,0,2,41,41
1746556035403,COGS 186,A01,886991,Staff,0,0,32,32
1746556036444,COGS 187A,A01,886993,Boyle; Mary E. T.,7,0,30,23
1746556037472,COGS 189,A00,886994,Staff,0,1,30,30
1746556038497,COMM 10,A01,886996,Staff,0,0,20,21
1746556038497,COMM 10,A02,886997,Staff,12,0,20,8
1746556038497,COMM 10,A03,959845,Staff,19,0,20,1
1746556039523,COMM 20,A01,886999,Leuning; Grant Maurstad,24,0,40,16
1746556041576,COMM 100A,A01,887002,Staff,0,0,20,25
1746556041576,COMM 100A,A02,887003,Staff,7,0,20,13
1746556042600,COMM 100B,A01,887005,Staff,0,8,20,24
1746556043624,COMM 106D,A00,887006,Staff,14,0,40,26
1746556044649,COMM 110G,A00,887007,Whitworth-Smith; Andrew C,12,0,40,28
1746556045673,COMM 111B,A00,887008,Staff,31,0,40,9
1746556046697,COMM 113T,A00,887009,Abuelhiga; Soraya Jill,28,0,40,12
1746556046697,COMM 113T,B00,906733,Staff,40,0,40,0
1746556047724,COMM 145,A00,887010,Staff,12,0,40,28
1746556048749,COMM 146,A00,887054,Staff,31,0,40,9
1746556049778,COMM 190,A00,887012,Staff,8,0,23,15
1746556050807,CSE 8A,A50,887015,Cao; Yingjun,57,0,85,28
1746556051833,CSE 11,A01,887017,Cao; Yingjun,12,0,70,58
1746556052862,CSE 20,A01,887019,Staff,30,0,50,20
1746556053890,CSE 21,A01,887021,Staff,78,0,100,22
1746556053890,CSE 21,B01,892583,Braun; Oliver,45,0,50,5
1746556054917,CSE 30,A01,887025,Eldon; John,143,0,200,57
1746556055961,CSE 100,A01,887027,Staff,26,0,50,24
1746556055961,CSE 100,A02,887028,Staff,42,0,50,8
1746556056990,CSE 101,A01,887030,Braun; Oliver,74,0,100,26
1746556056990,CSE 101,B01,887032,Jones; Miles E,0,3,50,50
1746556056990,CSE 101,B02,887033,Jones; Miles E,0,1,50,50
1746556058017,CSE 105,A01,908084,Jones; Miles E,32,0,50,18
1746556058017,CSE 105,A02,908087,Jones; Miles E,32,0,50,18
1746556059045,CSE 135,A01,887035,Powell; Thomas Allan,0,4,50,50
1746556060069,CSE 142,A01,887037,Staff,8,0,60,52
1746556061096,CSE 142L,A01,887039,Staff,34,0,60,26
1746556062120,CSE 151A,A01,887041,Solares; Edwin A,47,0,100,53
1746556063147,CSE 175,A01,887043,Kumar; Rakesh,30,0,30,0
1746556064173,CSS 1,A01,886389,Staff,0,1,40,40
1746556065198,DSC 30,A01,908097,Liao; Soohyun Nam,47,0,75,28
1746556066223,DSC 40A,A01,908099,Shannon; Kyle Michael,30,0,50,20
1746556067249,DSC 40B,A01,908112,Staff,16,0,50,34
1746556068277,DSC 80,A01,908116,Staff,19,0,60,41
1746556069302,DSC 197,001,956863,Eldridge; Justin Matthew,9999,0,9999,0
1746556070328,ECE 5,A01,886400,Morris; Karcher William,2,0,6,4
1746556070328,ECE 5,A02,886401,Morris; Karcher William,3,0,6,3
1746556071353,ECE 148,A01,886403,Silberman; Jack,0,14,14,14
1746556072382,ECON 1,A01,887265,Crane; Meredith Helen,12,0,70,58
1746556072382,ECON 1,B01,887268,Staff,43,0,50,7
1746556073409,ECON 2,A01,887273,Crane; Meredith Helen,56,0,70,14
1746556074437,ECON 3,A01,887279,Rondina; Giacomo,32,0,70,38
1746556075463,ECON 4,A01,887282,Anderson; John Charles,0,2,10,10
1746556076491,ECON 5,A01,887285,Staff,33,0,45,12
1746556076491,ECON 5,B01,887292,Staff,41,0,45,4
1746556077517,ECON 100A,A01,887337,Newhouse; Herbert S,54,0,70,16
1746556077517,ECON 100A,B01,887349,Staff,45,0,50,5
1746556078542,ECON 100B,A01,887361,Du; Songzi,29,0,70,41
1746556079568,ECON 100C,A01,887445,Newhouse; Herbert S,59,0,70,11
1746556080593,ECON 105,A00,887488,Vespa; Emanuel Ignacio,23,0,35,12
1746556081621,ECON 109,A01,887506,Shishkin; Denis,28,0,35,7
1746556082649,ECON 110A,A01,887568,Alon; Titan Michael,0,3,35,35
1746556082649,ECON 110A,B01,907601,Alon; Titan Michael,20,0,35,15
1746556083676,ECON 110B,A01,887598,Levkoff; Steven B.,0,24,70,70
1746556084700,ECON 112,A00,887599,Rondina; Giacomo,19,0,35,16
1746556085725,ECON 120A,A01,887603,Dai; Yinlin,35,0,70,35
1746556086751,ECON 120C,A01,887608,Sun; Yixiao,0,1,35,35
1746556086751,ECON 120C,B01,887614,Sun; Yixiao,0,0,35,35
1746556087778,ECON 138,A00,887621,Bharadwaj; Prashant,0,21,20,20
1746556088806,ECON 144,A00,958007,Squires; Dale E,13,0,35,22
1746556089837,ECON 171,A01,907666,Staff,18,0,35,17
1746556090863,ECON 175,A00,887626,Wu; Pak Yeung,23,0,35,12
1746556091890,ECON 190,A00,887640,Vespa; Emanuel Ignacio,23,0,35,12
1746556092916,EDS 25,A01,888197,Staff,0,0,0,0
1746556092916,EDS 25,A02,888209,Staff,0,0,0,0
1746556092916,EDS 25,A03,888210,Staff,0,0,0,0
1746556092916,EDS 25,A04,888212,Staff,0,0,0,0
1746556092916,EDS 25,A05,888213,Staff,0,0,0,0
1746556092916,EDS 25,A06,888214,Staff,0,0,0,0
1746556092916,EDS 25,A07,888235,Staff,0,2,0,0
1746556092916,EDS 25,A08,888236,Staff,0,0,0,0
1746556092916,EDS 25,A09,888240,Staff,0,0,0,0
1746556092916,EDS 25,A10,888244,Staff,0,0,0,0
1746556092916,EDS 25,B01,888273,Staff,0,0,0,0
1746556092916,EDS 25,B02,888285,Staff,0,0,0,0
1746556092916,EDS 25,B03,888423,Staff,0,0,0,1
1746556092916,EDS 25,B04,888432,Staff,0,0,0,0
1746556092916,EDS 25,B05,888433,Staff,0,0,0,0
1746556092916,EDS 25,B06,888467,Staff,0,0,0,0
1746556092916,EDS 25,B07,888468,Staff,0,0,0,0
1746556092916,EDS 25,B08,888479,Staff,0,0,0,0
1746556092916,EDS 25,B09,888484,Staff,0,0,0,0
1746556092916,EDS 25,B10,888487,Staff,0,0,0,0
1746556093940,EDS 38,A01,907700,Choi; Bailey Miyeon,30,0,30,0
1746556094964,EDS 112,A01,888601,Chapman; Thandeka K,14,0,40,26
1746556096005,EDS 115,A00,888697,Mendez; Kathrina Mendoza,10,0,30,20
1746556097030,EDS 116,A01,888893,Staff,35,0,40,5
1746556099082,EDS 124AR,A00,889133,Staff,29,0,50,21
1746556099082,EDS 124AR,B00,907471,Simon; Elizabeth A,37,0,50,13
1746556100112,EDS 124BR,A00,889134,Simon; Elizabeth A,45,0,100,55
1746556101139,EDS 125,A00,889135,Staff,25,0,30,5
1746556102165,EDS 126,A01,889138,Staff,36,0,40,4
1746556103192,EDS 164R,A01,889142,Wishard Guerra; Alison G.,33,0,50,17
1746556104218,ENG 30,A01,886396,Staff,0,0,0,0
1746556104218,ENG 30,B01,886398,Staff,0,0,0,0
1746556105246,ENVR 102,A00,906150,Montejo; Carolina,23,0,25,2
1746556106273,ETHN 103A,A00,887236,Man; Simeon S,0,3,0,0
1746556107299,ETHN 113,A00,887239,Staff,16,0,30,14
1746556108325,ETHN 116,A00,887240,Staff,16,0,25,9
1746556109352,ETHN 117,A00,887241,Choi; Esther Min,28,0,30,2
1746556110377,ETHN 118,A00,887243,Staff,24,0,30,6
1746556111402,ETHN 127,A00,887248,Cuong; Marisol,11,0,15,4
1746556112425,ETHN 139,A00,887250,Staff,7,0,10,3
1746556113449,ETHN 142,A00,887252,Staff,10,0,30,20
1746556114475,ETHN 161,A00,887253,Browne; Errol Tsekani,24,0,30,6
1746556115501,ETHN 163FR,A00,887255,Burelle; Julie Sara Veronique,0,0,5,5
1746556116526,GLBH 20,A00,889149,Elwardani; Nile Regina,8,0,42,34
1746556118579,GLBH 111,A01,889152,Burgos; Jose L.,17,0,17,0
1746556119606,GLBH 150,A00,889181,Sloane; Julia Kathryn,0,5,15,15
1746556121658,HDS 60,A01,886406,Warstadt; Melissa Fawn,73,0,80,7
1746556122684,HIAF 111,A00,889324,Gyamfi; Bright,25,0,32,7
1746556123711,HIEA 131,A00,889328,Staff,16,0,32,16
1746556124734,HIEA 144,A00,889333,Henry; Todd A.,26,0,32,6
1746556125759,HIEA 154,A00,889336,Henry; Todd A.,24,0,32,8
1746556126786,HIEU 106,A00,889339,Staff,22,0,32,10
1746556128835,HIEU 114,A00,889340,Staff,3,0,32,29
1746556129861,HIEU 135GS,A00,889342,Patterson; Patrick H.,0,0,1,24
1746556130889,HIEU 137,A00,889343,Edington; Claire Ellen,9,0,25,16
1746556131912,HIEU 148,A00,889345,Staff,14,0,32,18
1746556132937,HIEU 154,A00,889346,Biess; Frank Peter,21,0,32,11
1746556133961,HILA 102,A00,889351,Staff,12,0,32,20
1746556135010,HILD 2A,A01,889221,Lewandoski; Julia Mavis,1,10,32,31
1746556136034,HILD 7B,A01,889225,Man; Simeon S,0,12,32,32
1746556137063,HILD 7C,A01,889288,Alvarez; Luis A,0,14,32,32
1746556138087,HILD 30,A01,889323,Staff,0,5,32,32
1746556140136,HISC 119,A00,889383,Golan; Tal,20,0,32,12
1746556141161,HIUS 103,A00,889384,Man; Simeon S,0,0,32,32
1746556142184,HIUS 117,A00,919797,Kwak; Nancy,18,0,32,14
1746556143209,HIUS 142A,A00,919788,Staff,22,0,32,10
1746556145257,HIUS 149,A00,889386,Gyamfi; Bright,27,0,32,5
1746556146281,HIUS 155,A00,889387,Alvarez; Luis A,14,0,32,18
1746556147308,HUM 3,A01,886499,Caldwell; Michael Alan,19,0,50,31
1746556148333,HUM 3GS,A00,886500,Rodriguez; Bretton Sigfred,0,0,0,28
1746556149357,HUM 3R,A01,886502,Markman; Kristina,0,36,50,50
1746556150381,HUM 4,A01,886504,Crum; Matthew Stephen,24,0,50,26
1746556150381,HUM 4,B01,886506,West; Geoffrey Scott,17,0,50,33
1746556151407,HUM 4GS,A00,886507,Staff,0,0,0,19
1746556152434,HUM 5,A01,886509,Staff,32,0,50,18
1746556153458,HUM 5R,A01,886511,Zavodny; Tatiana Sophia,0,39,50,50
1746556154484,JAPN 180,A00,886407,Staff,17,0,40,23
1746556155509,LATI 50,A01,886409,Martin-Cabrera; Luis,4,0,22,18
1746556155509,LATI 50,A02,886410,Martin-Cabrera; Luis,19,0,22,3
1746556155509,LATI 50,A03,886411,Martin-Cabrera; Luis,21,0,22,1
1746556155509,LATI 50,A04,886412,Martin-Cabrera; Luis,9,0,22,13
1746556156536,LAWS 101,A00,907664,Staff,28,0,60,32
1746556157565,LIAB 1A,A00,889388,Saab; Dima,17,0,20,3
1746556158594,LIAB 1AX,A00,889389,El Cheddadi; Youniss,17,0,20,3
1746556159618,LIFR 1C,A00,889391,Van Moer; Vinciane G,8,0,20,12
1746556160646,LIFR 1CX,A00,889392,Van Moer; Vinciane G,7,0,20,13
1746556161672,LIFR 1D,A00,889393,Van Moer; Vinciane G,7,0,20,13
1746556162699,LIFR 1DX,A00,889394,Van Moer; Vinciane G,8,0,20,12
1746556163726,LIGN 7,A00,886923,Staff,24,0,50,26
1746556164752,LIGN 17,A00,886924,Kehler; Andrew Scott,125,0,150,25
1746556165782,LTAM 110,A00,889395,Staff,15,0,30,15
1746556166832,LTAM 110GS,A00,958010,Rodriguez; Bretton Sigfred,0,0,0,28
1746556167860,LTCH 101,A00,889397,Staff,23,0,25,2
1746556168884,LTCS 130,A00,889398,Staff,23,0,25,2
1746556169910,LTEA 138,A00,889399,Staff,24,0,40,16
1746556170935,LTEN 149,A00,889400,Wesling; Megan E.,0,3,25,25
1746556171962,LTEN 169,A00,889401,Staff,20,0,25,5
1746556172989,LTEN 180,A00,889402,Staff,10,0,15,5
1746556174015,LTEN 181,A00,889403,Staff,21,0,25,4
1746556175041,LTWL 100,A00,889404,Myerston Santana; Jacobo,3,0,25,22
1746556176066,LTWL 180GS,A00,889405,Staff,0,0,20,20
1746556177090,LTWL 181,A00,889406,Staff,17,0,25,8
1746556178114,LTWL 184,A00,889475,Mukherjee; Silpa,22,0,25,3
1746556179140,LTWR 102C,A00,889486,Staff,29,0,30,1
1746556180166,LTWR 115W,A00,889491,Staff,0,2,15,15
1746556181190,MAE 8,A01,886905,Staff,0,2,0,0
1746556182218,MAE 11,A00,886906,Bandaru; Prabhakar,0,7,50,50
1746556183290,MAE 20,A00,886907,Evdokimenko; Ekaterina,43,0,70,27
1746556184315,MAE 30B,A00,886909,Ghazinejad; Maziar,26,0,45,19
1746556185340,MAE 101B,A00,886910,Saintillan; David,29,0,45,16
1746556186364,MAE 105,A00,886911,Bandaru; Prabhakar,18,0,50,32
1746556187392,MAE 107,B00,958024,Staff,8,0,50,42
1746556188418,MAE 143B,A00,886913,Bewley; Thomas R,7,0,40,33
1746556189444,MAE 148,A01,886915,Silberman; Jack,0,3,14,14
1746556190469,MAE 160,A00,886916,Evdokimenko; Ekaterina,32,0,60,28
1746556191495,MATH 3C,A01,889681,Staff,0,3,30,30
1746556191495,MATH 3C,A02,960048,Staff,25,0,30,5
1746556192518,MATH 10A,A01,889760,Staff,26,0,30,4
1746556192518,MATH 10A,A02,889783,Staff,29,0,30,1
1746556193548,MATH 10B,A01,889785,Verstraete; Jacques Allan,2,0,35,33
1746556193548,MATH 10B,A02,889795,Verstraete; Jacques Allan,4,0,35,31
1746556193548,MATH 10B,B01,889797,Verstraete; Jacques Allan,3,0,35,32
1746556193548,MATH 10B,B02,889828,Verstraete; Jacques Allan,3,0,35,32
1746556194575,MATH 10C,A01,889849,Habib; Yousaf,8,0,30,22
1746556194575,MATH 10C,A02,889852,Habib; Yousaf,14,0,30,16
1746556194575,MATH 10C,A03,889853,Habib; Yousaf,22,0,30,8
1746556194575,MATH 10C,A04,889858,Habib; Yousaf,20,0,30,10
1746556194575,MATH 10C,B01,889861,Staff,1,0,30,29
1746556194575,MATH 10C,B02,889862,Staff,24,0,30,6
1746556194575,MATH 10C,B03,889863,Staff,27,0,30,3
1746556194575,MATH 10C,B04,889967,Staff,23,0,30,7
1746556195606,MATH 18,A01,889974,Staff,7,0,30,23
1746556195606,MATH 18,A02,889977,Staff,20,0,30,10
1746556195606,MATH 18,B01,889984,Hardiman; Liam,21,0,30,9
1746556195606,MATH 18,B02,889985,Hardiman; Liam,25,0,30,5
1746556196635,MATH 20A,A01,889990,Suk; Andrew Hoon,30,0,35,5
1746556197661,MATH 20B,A01,889993,Ohm; Ko Woon,22,0,30,8
1746556197661,MATH 20B,A02,889994,Ohm; Ko Woon,30,0,30,0
1746556197661,MATH 20B,B01,889996,Ohm; Ko Woon,21,0,30,9
1746556197661,MATH 20B,B02,889997,Ohm; Ko Woon,23,0,30,7
1746556198688,MATH 20C,A01,889999,Hammock; Frances H,17,0,30,13
1746556198688,MATH 20C,A02,890003,Hammock; Frances H,23,0,30,7
1746556198688,MATH 20C,B01,890006,Hammock; Frances H,3,0,30,27
1746556198688,MATH 20C,B02,890007,Hammock; Frances H,11,0,30,19
1746556199713,MATH 20D,A01,890011,Cheng; Hsiao-Bing,1,1,30,29
1746556199713,MATH 20D,A02,890012,Cheng; Hsiao-Bing,14,0,30,16
1746556199713,MATH 20D,B01,890016,Cheng; Hsiao-Bing,13,0,30,17
1746556199713,MATH 20D,B02,890017,Cheng; Hsiao-Bing,13,0,30,17
1746556200739,MATH 20E,A01,890026,Harel; Guershon,1,0,30,29
1746556200739,MATH 20E,A02,890029,Harel; Guershon,23,0,30,7
1746556200739,MATH 20E,B01,890033,Harel; Guershon,7,0,30,23
1746556200739,MATH 20E,B02,890101,Harel; Guershon,21,0,30,9
1746556201787,MATH 102,A01,890104,Staff,17,0,30,13
1746556201787,MATH 102,A02,890105,Staff,27,0,30,3
1746556202814,MATH 103B,A01,890116,Salehi Golsefidy; Alireza,3,0,30,27
1746556202814,MATH 103B,B01,890118,Staff,0,3,34,34
1746556203841,MATH 109,A01,890121,Aliabadi Sr.; Mohsen,1,0,30,29
1746556203841,MATH 109,B01,890124,Upadrashta; Pranav Kumar,18,0,30,12
1746556204868,MATH 120A,A01,890126,Eggers; John Dietrich,13,0,30,17
1746556205895,MATH 142B,A01,890128,Ioana; Adrian,19,0,30,11
1746556205895,MATH 142B,A02,890129,Ioana; Adrian,13,0,30,17
1746556206919,MATH 154,A01,890174,Staff,0,0,30,30
1746556206919,MATH 154,A02,890182,Staff,0,0,30,30
1746556207947,MATH 168A,A01,890197,Dumitriu; Ioana,21,0,35,14
1746556208973,MATH 170A,A01,890240,Nie; Jiawang,1,0,30,29
1746556208973,MATH 170A,A02,890241,Nie; Jiawang,11,0,30,19
1746556208973,MATH 170A,A03,890249,Nie; Jiawang,23,0,30,7
1746556210011,MATH 170B,A01,957891,Nag; Panchali,13,0,35,22
1746556212060,MATH 181A,A01,908025,Staff,0,4,35,35
1746556212060,MATH 181A,A02,960115,Staff,27,0,35,8
1746556213086,MATH 181B,A01,959874,Staff,25,0,30,5
1746556214114,MATH 193B,A01,890265,Staff,0,4,35,35
1746556215144,MGT 4,A01,890311,Anderson; John Charles,42,0,88,46
1746556216168,MGT 5,A00,907740,Staff,13,0,98,85
1746556217195,MGT 12,A00,890312,Lindenberger; Wade Douglas,67,0,98,31
1746556218220,MGT 16,A00,957883,Staff,78,0,98,20
1746556220271,MGT 45,A00,890314,Pecore; Joseph P.,46,0,98,52
1746556221301,MGT 71,A00,890315,Staff,0,11,98,98
1746556222326,MGT 100,A00,890316,Yavorsky; Daniel Ryan,44,0,98,54
1746556223352,MGT 103,A00,890317,Ehrich; Kristine R,73,0,98,25
1746556224376,MGT 105,A00,890356,Bates; Kenneth Walter,0,7,98,98
1746556225401,MGT 112,A00,890360,Ehrich; Kristine R,55,0,98,43
1746556226426,MGT 127R,A00,907732,Zhu; Kevin Xiaoguo,24,0,98,74
1746556227453,MGT 131B,A00,890361,Anderson; John Charles,60,0,98,38
1746556228481,MGT 137,A00,890362,Lindenberger; Wade Douglas,65,0,98,33
1746556229505,MGT 160,A00,890369,Johnson; Erik Barry,9,0,98,89
1746556231557,MGT 164,A00,890372,Zimmermann; Carsten,0,39,98,98
1746556232583,MGT 180,A00,890374,Bliss; Barbara Ann,12,0,98,86
1746556233609,MMW 15,A01,886414,Chang; Edmond Yi-Teh,0,12,28,28
1746556233609,MMW 15,A02,886415,Chang; Edmond Yi-Teh,0,8,28,28
1746556233609,MMW 15,A03,886416,Chang; Edmond Yi-Teh,0,8,28,28
1746556233609,MMW 15,A04,886417,Chang; Edmond Yi-Teh,0,8,28,28
1746556233609,MMW 15,B01,886419,Chang; Edmond Yi-Teh,0,7,28,28
1746556233609,MMW 15,B02,886420,Chang; Edmond Yi-Teh,0,8,28,28
1746556233609,MMW 15,B03,886421,Chang; Edmond Yi-Teh,0,7,28,28
1746556233609,MMW 15,B04,886422,Chang; Edmond Yi-Teh,0,8,28,28
1746556233609,MMW 15,C01,886424,Staff,0,9,28,28
1746556233609,MMW 15,C02,886425,Staff,0,8,28,28
1746556233609,MMW 15,C03,886426,Staff,0,8,28,28
1746556233609,MMW 15,C04,886427,Staff,0,8,28,28
1746556233609,MMW 15,C05,958038,Staff,0,7,28,28
1746556233609,MMW 15,C06,958039,Staff,0,8,28,28
1746556234634,MMW 15GS,A00,906910,Patterson; Patrick H.,4,0,28,24
1746556235661,MMW 122R,A01,886429,Rahimi; Babak,0,13,28,28
1746556235661,MMW 122R,A02,886430,Rahimi; Babak,0,12,28,28
1746556235661,MMW 122R,A03,958040,Rahimi; Babak,0,11,28,28
1746556236690,MUS 1A,A01,890937,Staff,2,0,25,23
1746556236690,MUS 1A,A02,891035,Staff,6,0,25,19
1746556236690,MUS 1A,C01,958912,Staff,24,0,25,1
1746556236690,MUS 1A,C02,958913,Staff,25,0,25,0
1746556238744,MUS 2AK,A00,957092,Ohnishi; Takae,15,0,15,0
1746556239771,MUS 4,A01,891044,Staff,2,0,25,23
1746556239771,MUS 4,A02,891045,Staff,23,0,25,2
1746556239771,MUS 4,B01,891048,Staff,17,0,25,8
1746556239771,MUS 4,B02,891050,Staff,25,0,25,0
1746556240798,MUS 5,A01,957506,Dubnov; Shlomo,0,0,25,25
1746556240798,MUS 5,A02,957622,Dubnov; Shlomo,13,0,25,12
1746556240798,MUS 5,A03,957623,Dubnov; Shlomo,20,0,25,5
1746556241824,MUS 6,A01,891053,Freitas Caetano; Marcelo,24,0,25,1
1746556241824,MUS 6,A02,891054,Freitas Caetano; Marcelo,23,0,25,2
1746556242848,MUS 7,A01,891081,Staff,0,0,25,25
1746556242848,MUS 7,A02,891082,Staff,4,0,25,21
1746556243874,MUS 8GS,A00,891118,Borgo; David Garcia,0,0,25,25
1746556244900,MUS 11,A01,891140,Staff,10,0,25,15
1746556244900,MUS 11,A02,891141,Staff,22,0,25,3
1746556245925,MUS 13,A01,891143,Staff,8,0,25,17
1746556245925,MUS 13,A02,891144,Staff,24,0,25,1
1746556246949,MUS 15,A01,891146,Staff,9,0,25,16
1746556246949,MUS 15,A02,891148,Staff,21,0,25,4
1746556246949,MUS 15,B01,891150,Staff,18,0,25,7
1746556246949,MUS 15,B02,891151,Staff,25,0,25,0
1746556247974,MUS 20,A01,891153,Staff,5,0,20,15
1746556247974,MUS 20,A02,891155,Staff,14,0,20,6
1746556249000,MUS 80,A00,891156,Staff,19,0,25,6
1746556249000,MUS 80,B00,891157,Staff,23,0,25,2
1746556250028,MUS 130,A00,891158,Ohnishi; Takae,35,0,35,0
1746556251058,MUS 150GS,A01,891160,Borgo; David Garcia,0,0,25,25
1746556252083,MUS 170,A01,891162,Freitas Caetano; Marcelo,20,0,25,5
1746556252083,MUS 170,A02,891164,Freitas Caetano; Marcelo,21,0,25,4
1746556253109,NANO 11,A00,886220,Vazquez Mena; Oscar,13,0,15,2
1746556254177,NANO 15,A01,886222,Drews; Aaron,4,0,7,3
1746556255203,NANO 104,A00,886224,Sirbuly; Donald,18,0,25,7
1746556256231,PH 40,A00,886528,Staff,23,0,40,17
1746556257256,PH 45,A01,886799,Staff,35,0,40,5
1746556258282,PH 110,A00,886802,Staff,0,7,40,40
1746556259306,PH 172,A00,906716,Staff,19,0,35,16
1746556260354,PH 191,A00,886803,Staff,6,0,40,34
1746556261379,PHIL 1,A00,889500,Staff,20,0,30,10
1746556262417,PHIL 10,A01,889549,Grush; Rick Scott,15,0,22,7
1746556262417,PHIL 10,A02,889551,Grush; Rick Scott,22,0,22,0
1746556263443,PHIL 28,A01,889559,Lamey; Andy M.,0,1,31,31
1746556263443,PHIL 28,A02,889561,Lamey; Andy M.,0,1,30,30
1746556263443,PHIL 28,A03,889572,Lamey; Andy M.,0,1,30,30
1746556264470,PHIL 35,A00,907839,Staff,13,0,15,2
1746556265498,PHIL 60,A00,889574,Staff,73,0,90,17
1746556266522,PHIL 101,A00,958004,Staff,12,0,15,3
1746556268575,PHIL 136,A00,889582,Fulkerson; Matthew Todd,26,0,45,19
1746556269599,PHIL 163,A01,889601,Staff,21,0,30,9
1746556269599,PHIL 163,B01,889606,Brandt; Reuven A,0,3,0,0
1746556270623,PHIL 164,A00,889610,Staff,16,0,30,14
1746556271647,PHIL 165,A00,889613,Staff,23,0,30,7
1746556272673,PHYS 1A,A00,886431,Staff,26,0,70,44
1746556273699,PHYS 1AL,001,886432,Tsai; Philbert S,0,2,30,30
1746556273699,PHYS 1AL,002,886436,Tsai; Philbert S,11,0,30,19
1746556274723,PHYS 1B,A00,886439,Staff,185,0,240,55
1746556275750,PHYS 1BL,001,886441,Tsai; Philbert S,0,4,30,30
1746556275750,PHYS 1BL,002,886444,Tsai; Philbert S,2,0,30,28
1746556276778,PHYS 1C,A00,896092,Arnold; Kam S,78,0,146,68
1746556277807,PHYS 1CL,001,886448,Tsai; Philbert S,0,0,30,30
1746556277807,PHYS 1CL,002,886449,Tsai; Philbert S,0,0,30,30
1746556277807,PHYS 1CL,003,886450,Tsai; Philbert S,16,0,30,14
1746556277807,PHYS 1CL,004,886451,Tsai; Philbert S,15,0,30,15
1746556278835,PHYS 2B,A01,886457,Staff,68,0,115,47
1746556279861,PHYS 2C,A01,886460,Shotwell; Brian,0,9,65,65
1746556280890,PHYS 2CL,A01,886467,Staff,0,4,28,28
1746556280890,PHYS 2CL,A02,886468,Staff,0,3,28,28
1746556281919,PHYS 2D,A01,886470,Staff,10,0,50,40
1746556282944,PHYS 4B,A01,886475,Grinstein; Benjamin,22,0,40,18
1746556283979,POLI 5,A00,891173,Desposato; Scott,7,0,25,18
1746556285005,POLI 5D,A01,891175,Staff,5,0,5,0
1746556285005,POLI 5D,B01,891178,Staff,5,0,5,0
1746556286030,POLI 11,A00,891179,Ferree; Karen E,2,0,35,33
1746556287054,POLI 12,A00,891180,Staff,16,0,30,14
1746556288082,POLI 27,A01,891182,Staff,12,0,75,63
1746556289110,POLI 30,A00,891183,Staff,8,0,50,42
1746556290134,POLI 100B,A00,891244,Staff,5,1,35,30
1746556291162,POLI 100I,A00,891247,Staff,7,0,30,23
1746556292190,POLI 104J,A00,891248,Nichter; Maysa,14,0,30,16
1746556293218,POLI 104U,A00,891250,Nichter; Maysa,2,0,30,28
1746556295267,POLI 110B,A00,891255,Wiens; David,20,0,25,5
1746556296294,POLI 112A,A00,891256,Wiens; David,6,0,25,19
1746556297322,POLI 114BR,A00,891261,Staff,19,0,30,11
1746556298347,POLI 117R,A00,891262,Forman; Fonna,0,6,50,50
1746556299374,POLI 118,A00,891264,Ingham; Sean,17,0,25,8
1746556300398,POLI 124A,A00,891265,Staff,18,0,20,2
1746556301422,POLI 125D,A00,891266,Nichter; Simeon C,2,0,25,23
1746556302446,POLI 126,A00,891268,Nichter; Simeon C,7,0,25,18
1746556303472,POLI 126AA,A00,891272,Staff,17,0,25,8
1746556304495,POLI 130AA,A00,891273,Staff,15,0,20,5
1746556305523,POLI 134AA,A00,891274,Staff,4,0,20,16
1746556307577,POLI 138,A00,891278,Staff,21,0,25,4
1746556308601,POLI 142K,A00,891280,Staff,11,0,25,14
1746556309626,POLI 142M,A00,891281,Gartzke; Erik,17,0,30,13
1746556310649,POLI 142P,A00,891284,Staff,20,0,30,10
1746556311674,POLI 143,A00,891285,Gartzke; Erik,12,0,30,18
1746556312698,POLI 153,A00,891286,Staff,19,0,20,1
1746556314752,POLI 175,A00,891290,Staff,15,0,20,5
1746556315781,PSYC 1,A00,890674,Steiner; Eric Tomas,0,11,45,45
1746556316813,PSYC 2,A00,890676,Albright; Thomas D,21,0,35,14
1746556317840,PSYC 3,A00,890679,Staff,17,0,20,3
1746556318869,PSYC 6,A00,959858,Staff,20,0,20,0
1746556319895,PSYC 60,A01,890684,Rickard; Timothy C.,0,5,45,45
1746556320920,PSYC 70,A01,890689,Geller; Emma Harlan,7,0,30,23
1746556321946,PSYC 71,A01,959860,Staff,21,0,25,4
1746556322974,PSYC 100,A00,890690,Lacefield; Katharine I,0,50,180,180
1746556323999,PSYC 102,A00,890695,Staff,18,0,40,22
1746556325024,PSYC 105,A00,890699,Geller; Emma Harlan,70,0,100,30
1746556326052,PSYC 106,A00,890701,Gorman; Michael R.,6,0,30,24
1746556327076,PSYC 108,A00,890704,Adrian; Julia Anna,0,28,50,50
1746556328101,PSYC 118,A01,890712,Staff,11,0,30,19
1746556329130,PSYC 124,A00,890716,Chapman; Eddie Nathaniel,25,0,60,35
1746556330156,PSYC 131,A00,890717,Anagnostaras; Stephan,0,7,80,80
1746556331180,PSYC 137,A00,890719,Winkielman; Piotr,0,11,30,30
1746556332205,PSYC 144,A00,890721,Adrian; Julia Anna,0,9,45,45
1746556333229,PSYC 162,A00,890805,Staff,2,0,75,73
1746556334255,PSYC 169,A00,890810,Staff,0,14,30,30
1746556335283,PSYC 172,A00,890814,Gorman; Michael R.,9,0,30,21
1746556336310,PSYC 181,A00,890818,Anagnostaras; Stephan,8,0,200,192
1746556337337,PSYC 184,A00,959861,Staff,170,0,175,5
1746556338364,PSYC 189,A00,890823,Staff,0,1,30,30
1746556339391,PSYC 191,A00,890884,Rickard; Timothy C.,0,11,35,35
1746556340421,PSYC 193,A00,890913,Staff,19,0,30,11
1746556340421,PSYC 193,B00,890914,Chapman; Eddie Nathaniel,24,0,30,6
1746556341450,PSYC 193L,A01,890918,Lowe; Angela Beth,20,0,30,10
1746556341450,PSYC 193L,B01,890921,Hurwitz; Ethan Scott,20,0,30,10
1746556341450,PSYC 193L,C01,890928,Staff,30,0,30,0
1746556342479,RELI 149,A00,886806,Rahimi; Babak,23,0,40,17
1746556343505,SE 9,A01,886814,Staff,7,0,20,13
1746556344535,SE 101B,A01,886816,Chadha; Mayank,4,0,35,31
1746556345560,SE 110B,A00,886818,Zhu; Qiang,4,0,75,71
1746556346585,SE 125,A01,886830,Staff,10,0,30,20
1746556347609,SE 130B,A01,886835,Staff,14,0,40,26
1746556348635,SE 131A,A01,886838,Krysl; Petr,34,0,55,21
1746556349659,SE 154,A00,886840,Staff,29,0,50,21
1746556350687,SE 164GS,A01,886849,Staff,6,0,20,14
1746556351715,SE 167GS,A01,886853,Staff,6,0,20,14
1746556352739,SIO 25,A01,890107,Staff,19,0,30,11
1746556353764,SIO 45,A00,890109,Cook; Geoffrey W,117,0,200,83
1746556354790,SIO 109R,A00,890110,Forman; Fonna,0,16,20,20
1746556355814,SIO 187,A01,890114,Kacev; David,15,0,40,25
1746556356839,SOCI 1,A01,890431,Thorpe; Charles Robert,15,0,30,15
1746556356839,SOCI 1,A02,890518,Thorpe; Charles Robert,30,0,30,0
1746556357921,SOCI 2,A01,957978,Staff,25,0,25,0
1746556357921,SOCI 2,A02,957979,Staff,23,0,25,2
1746556359150,SOCI 20,A01,890523,Calderon-Zaks; Michael Aar,23,0,30,7
1746556359150,SOCI 20,A02,890526,Calderon-Zaks; Michael Aar,29,0,30,1
1746556360174,SOCI 30,A01,890533,Pardo Guerra; Juan Pablo,37,0,40,3
1746556361198,SOCI 40,A01,890535,Staff,27,0,45,18
1746556362223,SOCI 104Q,A00,890559,Staff,18,0,30,12
1746556363248,SOCI 106,A00,890560,Arnal; Maud Marie Leonie,20,0,30,10
1746556364273,SOCI 110,A00,890567,Holkenbrink-Monk; Charlene,19,0,30,11
1746556365296,SOCI 112,A00,890568,Victoria Torres; Pablo,2,0,55,53
1746556366320,SOCI 115,A00,890597,Arnal; Maud Marie Leonie,28,0,45,17
1746556368372,SOCI 121,A00,890604,Pardo Guerra; Juan Pablo,38,0,45,7
1746556369400,SOCI 126,A01,890608,Staff,8,0,10,2
1746556370435,SOCI 127,A00,890609,Staff,18,0,30,12
1746556371461,SOCI 131,A00,890610,Thorpe; Charles Robert,37,0,45,8
1746556372488,SOCI 135,A00,890615,Payne; Christine Anna,14,0,45,31
1746556373513,SOCI 139,A00,890620,Staff,38,0,45,7
1746556374541,SOCI 148E,A00,890622,Calderon-Zaks; Michael Aar,36,0,45,9
1746556375565,SOCI 150,A00,890623,Kohler; Kristopher M.,31,0,45,14
1746556376591,SOCI 157,A00,890625,Jules-Rosette; Bennetta W.,18,0,20,2
1746556377614,SOCI 160,A00,890627,Payne; Christine Anna,21,0,45,24
1746556378641,SYN 1,A00,886855,Fish; Gwendolyn Anne,0,0,0,0
1746556378641,SYN 1,B00,906086,Fish; Gwendolyn Anne,0,1,0,2
1746556379666,SYN 2R,A00,886860,Staff,0,17,15,15
1746556379666,SYN 2R,B00,906106,Atkinson; Arthur Laird,0,16,15,15
1746556380690,SYN 100,A01,886866,Browne; Emily,0,28,20,20
1746556380690,SYN 100,B01,906128,Rock; Martin,0,5,20,20
1746556380690,SYN 100,C01,906140,Deavenport; James Cary,0,3,20,20
1746556380690,SYN 100,D01,907816,Deavenport; James Cary,0,5,20,20
1746556381715,TDAC 1,A00,890286,Walsh; Kim C.,9,0,20,11
1746556382743,TDAC 101,A00,890296,Basso; Beatrice,16,0,20,4
1746556383769,TDDE 131,A00,890297,Staff,47,0,50,3
1746556384797,TDDM 1,A00,890287,Weinberg; Sadie,25,0,30,5
1746556385821,TDGE 11,A00,890288,Fulton; Julia,137,0,200,63
1746556385821,TDGE 11,B00,890289,Castro; Robert Jess,184,0,200,16
1746556386867,TDGE 25,B00,957359,Walsh; Kim C.,3,0,20,17
1746556387891,TDGE 40,A01,890292,Power; Jade Yukana,27,0,30,3
1746556388913,TDGE 124,A00,890298,Havis; Allan,0,1,50,50
1746556389937,TDGE 131R,A00,890299,Burelle; Julie Sara Veronique,15,0,42,27
1746556390961,TDHT 101,A00,890300,Staff,10,0,20,10
1746556391986,TDHT 109,A01,890302,Anderson; Mysia Anyse,31,0,40,9
1746556393013,TDMV 1,A00,890293,Arcidiacono; Kristin,18,0,30,12
1746556394041,TDMV 2,A00,890294,Weinberg; Sadie,23,0,30,7
1746556395065,TDMV 3,A00,957878,Arcidiacono; Kristin,28,0,30,2
1746556397114,TDMV 138,A00,890304,Jun; Grace Shin Hae,25,0,40,15
1746556398140,TDMV 140,A00,890305,Corrales; Joseph Bernales,25,0,30,5
1746556399165,TDMV 142,A00,890307,Caligagan; Tony,32,0,40,8
1746556400192,TDMV 144,A00,890308,Camaya; Michelle Ann,25,0,30,5
1746556401220,TDPW 1,A00,890295,Stein; Deborah Isobel,3,0,20,17
1746556402247,USP 2,A01,890272,Lerner; Amy M,6,0,20,14
1746556403285,USP 3,A01,890274,Staff,12,0,30,18
1746556404312,USP 15,A01,890276,Sun; Feiyang,16,0,30,14
1746556405340,USP 25,A00,890277,Shenkman; Michael Thomas,19,0,25,6
1746556406366,USP 138,A00,890278,Staff,13,0,25,12
1746556407391,USP 143,A00,890279,Staff,21,0,70,49
1746556408415,USP 144,A00,890280,Chowdhury; Muhammed Zohir,15,0,30,15
1746556409440,USP 150,A00,890281,Boomhower; Matthew Charles,4,0,30,26
1746556410501,USP 151,A00,890282,Staff,16,0,20,4
1746556411526,USP 162,A00,890283,Andrews; Abigail Leslie,16,0,20,4
1746556412550,USP 168,A00,920477,Kwak; Nancy,1,0,5,4
1746556413577,USP 181,A00,890284,Staff,3,0,20,17
1746556414606,USP 191A,A00,890285,Staff,12,0,20,8
1746556415633,VIS 101,A00,886512,Staff,26,0,75,49
1746556416657,VIS 103,A00,886513,Cruz; Edwin Teddy,61,0,75,14
1746556417684,VIS 108,A00,886514,Staff,3,0,15,12
1746556418710,VIS 127P,A00,886515,Shen; Kuiyi,80,0,146,66
1746556419735,VIS 149,A00,886516,Yoldas; Pinar,0,0,15,15
1746556420759,VIS 164,A00,886526,Erdmann; Dean,19,0,22,3
1746556421782,VIS 194S,A00,886527,Staff,61,0,75,14
1746556422809,WCWP 10A,C00,886484,Martiniuk; Jill,12,0,15,3
1746556423835,WCWP 10B,A00,886490,Uriarte; Emma,0,0,15,15
1746556423835,WCWP 10B,B00,886491,Dhir; Simrita,10,0,15,5
1746556423835,WCWP 10B,C00,886492,Ornelas; Tricia,0,0,15,15
1746556424863,WCWP 100,A00,886494,Young; Mark T,0,6,15,15
1746556426963,AAS 10,A01,886199,Childs; Dennis R.,0,3,0,0
1746556427989,ANAR 104,A01,886940,Shtienberg; Gilad,27,0,30,3
1746556429016,ANAR 120,A00,886953,Staff,12,0,20,8
1746556430044,ANBI 148,A01,886955,Wilder; Linnea Lorene,30,0,40,10
1746556432096,ANSC 122,A00,886957,Staff,25,0,30,5
1746556433121,ANSC 150,A00,886958,Sloane; Julia Kathryn,2,0,15,13
1746556434145,ANSC 156,A00,886959,Jenkins; Janis A.,0,1,15,15
1746556435173,ANSC 180,A00,886960,Staff,11,0,17,6
1746556436200,ANSC 188,A00,886961,Jassal; Aftab,9,0,25,16
1746556437226,ANSC 190,A00,886962,Jassal; Aftab,14,0,25,11
1746556438251,ANSC 191,A00,886963,Staff,18,0,20,2
1746556439273,ANTH 3,A01,891689,Staff,17,0,20,3
1746556440299,ANTH 5,A00,886933,Semendeferi; Ekaterini,16,0,20,4
1746556441326,ANTH 10,A00,886934,Staff,0,12,30,30
1746556442351,ANTH 21,A01,886936,Staff,40,0,60,20
1746556443374,ANTH 23,A01,886938,Staff,92,0,100,8
1746556444399,ANTH 105,A00,886964,Stewart; Alexander B,84,0,100,16
1746556445424,ANTH 108,A00,886965,Pedersen; David,9,0,20,11
1746556446451,AWP 10,001,886147,Staff,0,0,0,0
1746556446451,AWP 10,002,886148,Staff,0,0,0,0
1746556446451,AWP 10,003,886149,Staff,0,0,0,0
1746556446451,AWP 10,004,886150,Staff,0,0,0,0
1746556446451,AWP 10,005,886151,Staff,0,0,0,0
1746556446451,AWP 10,006,886152,Staff,0,0,0,0
1746556446451,AWP 10,007,886153,Staff,0,0,0,0
1746556446451,AWP 10,008,886154,Staff,0,0,0,0
1746556446451,AWP 10,009,886155,Staff,0,0,0,0
1746556446451,AWP 10,010,886156,Staff,0,0,0,0
1746556446451,AWP 10,011,886158,Staff,0,0,0,0
1746556446451,AWP 10,012,886160,Staff,0,0,0,0
1746556446451,AWP 10,013,886161,Staff,0,0,0,0
1746556446451,AWP 10,014,886162,Staff,0,0,0,0
1746556446451,AWP 10,015,886163,Staff,0,0,0,0
1746556446451,AWP 10,016,886164,Staff,0,0,0,0
1746556446451,AWP 10,017,886165,Staff,0,0,0,0
1746556446451,AWP 10,018,886166,Staff,0,0,0,0
1746556446451,AWP 10,019,886168,Staff,0,0,0,0
1746556446451,AWP 10,020,886170,Staff,0,0,0,0
1746556446451,AWP 10,021,886172,Staff,0,0,0,0
1746556447477,AWP 10R,001,886173,Staff,0,1,0,0
1746556447477,AWP 10R,002,886174,Staff,0,1,0,0
1746556447477,AWP 10R,003,886175,Staff,0,0,0,0
1746556447477,AWP 10R,004,886176,Staff,0,0,0,0
1746556447477,AWP 10R,005,886177,Staff,0,0,0,0
1746556447477,AWP 10R,006,886178,Staff,0,0,0,0
1746556447477,AWP 10R,007,886179,Staff,0,0,0,0
1746556447477,AWP 10R,008,886181,Staff,0,0,0,0
1746556447477,AWP 10R,009,886182,Staff,0,0,0,0
1746556447477,AWP 10R,010,886183,Staff,0,0,0,0
1746556447477,AWP 10R,011,886184,Staff,0,0,0,0
1746556447477,AWP 10R,012,886185,Staff,0,0,0,0
1746556447477,AWP 10R,013,886186,Staff,0,0,0,0
1746556447477,AWP 10R,014,886187,Staff,0,0,0,0
1746556447477,AWP 10R,015,886188,Staff,0,0,0,0
1746556447477,AWP 10R,016,886189,Staff,0,0,0,0
1746556447477,AWP 10R,017,960532,Staff,0,0,0,0
1746556447477,AWP 10R,018,960533,Staff,0,0,0,0
1746556447477,AWP 10R,019,960534,Staff,0,0,0,0
1746556447477,AWP 10R,020,960538,Staff,0,0,0,0
1746556447477,AWP 10R,021,960540,Staff,0,0,0,0
1746556447477,AWP 10R,022,960541,Staff,0,0,0,0
1746556447477,AWP 10R,023,960542,Staff,0,0,0,0
1746556447477,AWP 10R,024,960544,Staff,0,0,0,0
1746556447477,AWP 10R,025,960545,Staff,0,0,0,0
1746556447477,AWP 10R,026,960548,Staff,0,0,0,0
1746556448503,AWP 102R,A00,886190,Staff,0,0,0,0
1746556448503,AWP 102R,B00,886191,Staff,0,0,0,0
1746556449529,BENG 100,A01,886193,Staff,17,0,30,13
1746556450560,BENG 122A,A01,886195,Hasty; Jeff M,13,0,30,17
1746556451584,BENG 166A,A00,886196,Sah; Robert Lie-Yuan,0,2,30,30
1746556452611,BENG 190,A00,958050,Khojah; Reem I,23,0,25,2
1746556453642,BIBC 102,A01,894320,Staff,0,0,46,46
1746556453642,BIBC 102,A02,894321,Staff,0,0,46,46
1746556453642,BIBC 102,A03,894344,Staff,7,0,46,39
1746556453642,BIBC 102,A04,894345,Staff,26,0,47,21
1746556454671,BICD 100R,A01,894365,Smith; Laurie,0,4,58,58
1746556454671,BICD 100R,A02,894366,Smith; Laurie,0,5,58,58
1746556454671,BICD 100R,A03,894367,Smith; Laurie,1,0,59,58
1746556454671,BICD 100R,A04,959869,Smith; Laurie,41,0,59,18
1746556455696,BICD 136,A01,894383,Gustafson-Brown; Cindy,14,0,50,36
1746556456722,BIEB 102,A01,894494,Butler; Shannon Rhey,51,0,130,79
1746556458777,BIEB 150,A01,894617,Wills; Christopher,3,0,20,17
1746556458777,BIEB 150,A02,894631,Wills; Christopher,3,0,20,17
1746556458777,BIEB 150,A03,894937,Wills; Christopher,3,0,20,17
1746556458777,BIEB 150,A04,894946,Wills; Christopher,5,0,20,15
1746556459808,BIEB 194,A00,906141,Kurle; Carolyn M.,6,0,20,14
1746556460834,BILD 1,A01,894154,Staff,3,0,19,16
1746556460834,BILD 1,A02,894155,Staff,14,0,19,5
1746556460834,BILD 1,A03,894160,Staff,13,0,19,6
1746556460834,BILD 1,A04,894161,Staff,15,0,18,3
1746556461860,BILD 2,A01,894168,Staff,0,0,50,50
1746556461860,BILD 2,A02,894169,Staff,0,0,50,50
1746556461860,BILD 2,A03,894179,Staff,1,0,50,49
1746556461860,BILD 2,A04,894203,Staff,27,0,50,23
1746556462884,BILD 3,A01,894213,Staff,22,0,31,9
1746556462884,BILD 3,A02,894214,Staff,26,0,31,5
1746556462884,BILD 3,A03,894235,Staff,28,0,31,3
1746556462884,BILD 3,A04,894236,Staff,28,0,32,4
1746556463913,BILD 4,A01,894253,Reuther; Keefe,5,0,24,19
1746556463913,BILD 4,A02,894258,Reuther; Keefe,16,0,24,8
1746556464939,BILD 5,A01,894276,Reuther; Keefe,35,0,50,15
1746556464939,BILD 5,A02,894277,Reuther; Keefe,45,0,50,5
1746556464939,BILD 5,A03,894290,Reuther; Keefe,44,0,50,6
1746556464939,BILD 5,A04,894291,Reuther; Keefe,48,0,50,2
1746556465964,BILD 24,A01,894297,Pirino; Giorgia,40,0,60,20
1746556466994,BIMM 100,B01,958915,Staff,71,0,100,29
1746556468023,BIMM 101,A01,895017,McDonnell; Lisa Marie,0,5,24,24
1746556468023,BIMM 101,A02,895018,McDonnell; Lisa Marie,0,5,24,24
1746556468023,BIMM 101,B01,895020,McDonnell; Lisa Marie,0,6,24,24
1746556468023,BIMM 101,B02,895021,McDonnell; Lisa Marie,0,4,24,24
1746556469047,BIMM 110,A01,895023,Staff,1,0,25,24
1746556469047,BIMM 110,A02,895024,Staff,9,0,25,16
1746556469047,BIMM 110,A03,895025,Staff,18,0,25,7
1746556469047,BIMM 110,A04,895031,Staff,20,0,25,5
1746556470288,BIMM 120,A01,895114,Gustafson-Brown; Cindy,14,0,28,14
1746556470288,BIMM 120,A02,895126,Gustafson-Brown; Cindy,21,0,27,6
1746556471313,BIPN 100,A01,895130,Yang; Mingyu,1,0,38,37
1746556471313,BIPN 100,A02,895131,Yang; Mingyu,32,0,38,6
1746556471313,BIPN 100,A03,895132,Yang; Mingyu,32,0,38,6
1746556471313,BIPN 100,A04,895133,Yang; Mingyu,27,0,36,9
1746556472337,BIPN 120,A01,895135,Cooke; James Edward,0,3,13,13
1746556472337,BIPN 120,A02,895136,Cooke; James Edward,0,1,13,13
1746556472337,BIPN 120,A03,895137,Cooke; James Edward,0,3,13,13
1746556472337,BIPN 120,A04,895156,Cooke; James Edward,0,2,11,11
1746556473366,BIPN 134,A01,895235,Cooke; James Edward,0,2,25,25
1746556473366,BIPN 134,A02,895237,Cooke; James Edward,0,0,25,25
1746556473366,BIPN 134,A03,895240,Cooke; James Edward,3,0,25,22
1746556473366,BIPN 134,A04,895270,Cooke; James Edward,20,0,25,5
1746556474390,BIPN 189,A00,892103,Staff,0,13,14,14
1746556476438,BISP 194,A00,958008,Staff,0,2,0,0
1746556477465,CAT 124,A01,922009,Staff,0,5,20,20
1746556478494,CAT 125R,A00,886390,Morales; Celeste Georgianna,0,2,20,20
1746556478494,CAT 125R,B00,886391,Irwin; Matthew Joseph,0,3,20,20
1746556478494,CAT 125R,C00,886392,Smith; Lauryn Alissa,0,2,20,20
1746556478494,CAT 125R,D00,886393,Vanderschuit; Maya Alysia,0,2,20,20
1746556478494,CAT 125R,E00,886394,Marchisotto; Jennifer Anne,0,4,20,20
1746556479524,CENG 15,A01,886218,Drews; Aaron,3,0,8,5
1746556480551,CENG 113,A00,886219,Opatkiewicz; Justin Paul,15,0,25,10
1746556481575,CGS 101,A00,887044,Staff,7,0,20,13
1746556482603,CGS 105,A01,887046,Staff,14,0,25,11
1746556483631,CGS 112,A00,887047,Cuong; Marisol,12,0,15,3
1746556484868,CGS 113,A00,887048,Staff,23,0,30,7
1746556485892,CGS 120,A00,887049,Staff,10,0,17,7
1746556486917,CHEM 6A,A01,886336,Lam; Tin Yiu,38,0,50,12
1746556486917,CHEM 6A,A02,886338,Lam; Tin Yiu,37,0,50,13
1746556487947,CHEM 6B,A01,886341,Hopkins; Patrycja Anna,16,0,50,34
1746556487947,CHEM 6B,A02,886343,Hopkins; Patrycja Anna,42,0,50,8
1746556488972,CHEM 6C,A01,886346,Albizati; Kim F.,0,2,50,50
1746556488972,CHEM 6C,A02,886348,Albizati; Kim F.,23,0,50,27
1746556490005,CHEM 40A,A01,886352,Klosterman; Jeremy K,65,0,100,35
1746556491033,CHEM 40B,A01,886356,Klosterman; Jeremy K,0,23,100,100
1746556492060,CHEM 41B,A01,886360,Theodorakis; Emmanuel,25,0,50,25
1746556492060,CHEM 41B,A02,886362,Theodorakis; Emmanuel,47,0,50,3
1746556493087,CHIN 165A,A00,886382,Xu; Li,18,0,20,2
1746556494115,CLAS 120,A00,886387,Myerston Santana; Jacobo,33,0,40,7
1746556495143,COGS 9,A01,886967,Shannon; Kyle Michael,42,0,60,18
1746556496173,COGS 11,A01,886969,Staff,11,0,30,19
1746556497202,COGS 14A,A01,886971,Staff,6,0,60,54
1746556498226,COGS 14B,A01,886973,Hoffman; Drew Ellen,4,0,60,56
1746556499254,COGS 18,A01,886975,Morgan; Eric,35,0,60,25
1746556500284,COGS 20,A01,886977,Staff,4,0,8,4
1746556500284,COGS 20,A02,886978,Staff,5,0,7,2
1746556501310,COGS 100,A01,907783,Staff,0,2,30,30
1746556502336,COGS 101B,A01,886980,Staff,0,3,48,48
1746556503364,COGS 101C,A01,886982,Delgado; Tania,0,5,44,44
1746556504388,COGS 102A,A01,886984,Johnson; Christine M.,4,0,30,26
1746556505414,COGS 118B,A01,886986,Staff,0,3,88,88
1746556506439,COGS 150,A01,886988,Bergen; Benjamin,23,0,50,27
1746556507469,COGS 153,A00,886989,Delgado; Tania,0,2,41,41
1746556508495,COGS 186,A01,886991,Staff,0,0,32,32
1746556509522,COGS 187A,A01,886993,Boyle; Mary E. T.,7,0,30,23
1746556510549,COGS 189,A00,886994,Staff,0,1,30,30
1746556511579,COMM 10,A01,886996,Staff,0,0,20,21
1746556511579,COMM 10,A02,886997,Staff,12,0,20,8
1746556511579,COMM 10,A03,959845,Staff,19,0,20,1
1746556512606,COMM 20,A01,886999,Leuning; Grant Maurstad,24,0,40,16
1746556514656,COMM 100A,A01,887002,Staff,0,0,20,25
1746556514656,COMM 100A,A02,887003,Staff,7,0,20,13
1746556515684,COMM 100B,A01,887005,Staff,0,8,20,24
1746556516712,COMM 106D,A00,887006,Staff,14,0,40,26
1746556517737,COMM 110G,A00,887007,Whitworth-Smith; Andrew C,12,0,40,28
1746556518763,COMM 111B,A00,887008,Staff,31,0,40,9
1746556519791,COMM 113T,A00,887009,Abuelhiga; Soraya Jill,28,0,40,12
1746556519791,COMM 113T,B00,906733,Staff,40,0,40,0
1746556520819,COMM 145,A00,887010,Staff,12,0,40,28
1746556521844,COMM 146,A00,887054,Staff,31,0,40,9
1746556522869,COMM 190,A00,887012,Staff,8,0,23,15
1746556523896,CSE 8A,A50,887015,Cao; Yingjun,57,0,85,28
1746556524922,CSE 11,A01,887017,Cao; Yingjun,12,0,70,58
1746556525950,CSE 20,A01,887019,Staff,30,0,50,20
1746556526980,CSE 21,A01,887021,Staff,78,0,100,22
1746556526980,CSE 21,B01,892583,Braun; Oliver,45,0,50,5
1746556528007,CSE 30,A01,887025,Eldon; John,143,0,200,57
1746556529034,CSE 100,A01,887027,Staff,26,0,50,24
1746556529034,CSE 100,A02,887028,Staff,42,0,50,8
1746556530059,CSE 101,A01,887030,Braun; Oliver,74,0,100,26
1746556530059,CSE 101,B01,887032,Jones; Miles E,0,3,50,50
1746556530059,CSE 101,B02,887033,Jones; Miles E,0,1,50,50
1746556531123,CSE 105,A01,908084,Jones; Miles E,32,0,50,18
1746556531123,CSE 105,A02,908087,Jones; Miles E,32,0,50,18
1746556532150,CSE 135,A01,887035,Powell; Thomas Allan,0,4,50,50
1746556533178,CSE 142,A01,887037,Staff,8,0,60,52
1746556534205,CSE 142L,A01,887039,Staff,34,0,60,26
1746556535233,CSE 151A,A01,887041,Solares; Edwin A,47,0,100,53
1746556536260,CSE 175,A01,887043,Kumar; Rakesh,30,0,30,0
1746556537285,CSS 1,A01,886389,Staff,0,1,40,40
1746556538314,DSC 30,A01,908097,Liao; Soohyun Nam,47,0,75,28
1746556539342,DSC 40A,A01,908099,Shannon; Kyle Michael,30,0,50,20
1746556540369,DSC 40B,A01,908112,Staff,16,0,50,34
1746556541392,DSC 80,A01,908116,Staff,19,0,60,41
1746556542417,DSC 197,001,956863,Eldridge; Justin Matthew,9999,0,9999,0
1746556543445,ECE 5,A01,886400,Morris; Karcher William,2,0,6,4
1746556543445,ECE 5,A02,886401,Morris; Karcher William,3,0,6,3
1746556544470,ECE 148,A01,886403,Silberman; Jack,0,14,14,14
1746556545496,ECON 1,A01,887265,Crane; Meredith Helen,12,0,70,58
1746556545496,ECON 1,B01,887268,Staff,43,0,50,7
1746556546521,ECON 2,A01,887273,Crane; Meredith Helen,56,0,70,14
1746556547546,ECON 3,A01,887279,Rondina; Giacomo,32,0,70,38
1746556548573,ECON 4,A01,887282,Anderson; John Charles,0,2,10,10
1746556549600,ECON 5,A01,887285,Staff,33,0,45,12
1746556549600,ECON 5,B01,887292,Staff,41,0,45,4
1746556550629,ECON 100A,A01,887337,Newhouse; Herbert S,54,0,70,16
1746556550629,ECON 100A,B01,887349,Staff,45,0,50,5
1746556551655,ECON 100B,A01,887361,Du; Songzi,29,0,70,41
1746556552679,ECON 100C,A01,887445,Newhouse; Herbert S,59,0,70,11
1746556553704,ECON 105,A00,887488,Vespa; Emanuel Ignacio,23,0,35,12
1746556554733,ECON 109,A01,887506,Shishkin; Denis,28,0,35,7
1746556555763,ECON 110A,A01,887568,Alon; Titan Michael,0,3,35,35
1746556555763,ECON 110A,B01,907601,Alon; Titan Michael,20,0,35,15
1746556556788,ECON 110B,A01,887598,Levkoff; Steven B.,0,24,70,70
1746556557818,ECON 112,A00,887599,Rondina; Giacomo,19,0,35,16
1746556558845,ECON 120A,A01,887603,Dai; Yinlin,35,0,70,35
1746556559870,ECON 120C,A01,887608,Sun; Yixiao,0,1,35,35
1746556559870,ECON 120C,B01,887614,Sun; Yixiao,0,0,35,35
1746556560896,ECON 138,A00,887621,Bharadwaj; Prashant,0,21,20,20
1746556561924,ECON 144,A00,958007,Squires; Dale E,13,0,35,22
1746556562949,ECON 171,A01,907666,Staff,18,0,35,17
1746556563974,ECON 175,A00,887626,Wu; Pak Yeung,23,0,35,12
1746556565006,ECON 190,A00,887640,Vespa; Emanuel Ignacio,23,0,35,12
1746556566039,EDS 25,A01,888197,Staff,0,0,0,0
1746556566039,EDS 25,A02,888209,Staff,0,0,0,0
1746556566039,EDS 25,A03,888210,Staff,0,0,0,0
1746556566039,EDS 25,A04,888212,Staff,0,0,0,0
1746556566039,EDS 25,A05,888213,Staff,0,0,0,0
1746556566039,EDS 25,A06,888214,Staff,0,0,0,0
1746556566039,EDS 25,A07,888235,Staff,0,2,0,0
1746556566039,EDS 25,A08,888236,Staff,0,0,0,0
1746556566039,EDS 25,A09,888240,Staff,0,0,0,0
1746556566039,EDS 25,A10,888244,Staff,0,0,0,0
1746556566039,EDS 25,B01,888273,Staff,0,0,0,0
1746556566039,EDS 25,B02,888285,Staff,0,0,0,0
1746556566039,EDS 25,B03,888423,Staff,0,0,0,1
1746556566039,EDS 25,B04,888432,Staff,0,0,0,0
1746556566039,EDS 25,B05,888433,Staff,0,0,0,0
1746556566039,EDS 25,B06,888467,Staff,0,0,0,0
1746556566039,EDS 25,B07,888468,Staff,0,0,0,0
1746556566039,EDS 25,B08,888479,Staff,0,0,0,0
1746556566039,EDS 25,B09,888484,Staff,0,0,0,0
1746556566039,EDS 25,B10,888487,Staff,0,0,0,0
1746556567067,EDS 38,A01,907700,Choi; Bailey Miyeon,30,0,30,0
1746556568095,EDS 112,A01,888601,Chapman; Thandeka K,14,0,40,26
1746556569123,EDS 115,A00,888697,Mendez; Kathrina Mendoza,10,0,30,20
1746556570152,EDS 116,A01,888893,Staff,35,0,40,5
1746556572205,EDS 124AR,A00,889133,Staff,29,0,50,21
1746556572205,EDS 124AR,B00,907471,Simon; Elizabeth A,37,0,50,13
1746556573229,EDS 124BR,A00,889134,Simon; Elizabeth A,45,0,100,55
1746556574256,EDS 125,A00,889135,Staff,25,0,30,5
1746556575283,EDS 126,A01,889138,Staff,36,0,40,4
1746556576306,EDS 164R,A01,889142,Wishard Guerra; Alison G.,33,0,50,17
1746556577339,ENG 30,A01,886396,Staff,0,0,0,0
1746556577339,ENG 30,B01,886398,Staff,0,0,0,0
1746556578362,ENVR 102,A00,906150,Montejo; Carolina,23,0,25,2
1746556579388,ETHN 103A,A00,887236,Man; Simeon S,0,3,0,0
1746556580412,ETHN 113,A00,887239,Staff,16,0,30,14
1746556581441,ETHN 116,A00,887240,Staff,16,0,25,9
1746556582465,ETHN 117,A00,887241,Choi; Esther Min,28,0,30,2
1746556583493,ETHN 118,A00,887243,Staff,24,0,30,6
1746556584519,ETHN 127,A00,887248,Cuong; Marisol,11,0,15,4
1746556585551,ETHN 139,A00,887250,Staff,7,0,10,3
1746556586576,ETHN 142,A00,887252,Staff,10,0,30,20
1746556587601,ETHN 161,A00,887253,Browne; Errol Tsekani,24,0,30,6
1746556588628,ETHN 163FR,A00,887255,Burelle; Julie Sara Veronique,0,0,5,5
1746556589655,GLBH 20,A00,889149,Elwardani; Nile Regina,8,0,42,34
1746556591706,GLBH 111,A01,889152,Burgos; Jose L.,17,0,17,0
1746556592731,GLBH 150,A00,889181,Sloane; Julia Kathryn,0,5,15,15
1746556594783,HDS 60,A01,886406,Warstadt; Melissa Fawn,73,0,80,7
1746556595808,HIAF 111,A00,889324,Gyamfi; Bright,25,0,32,7
1746556596833,HIEA 131,A00,889328,Staff,16,0,32,16
1746556597862,HIEA 144,A00,889333,Henry; Todd A.,26,0,32,6
1746556598886,HIEA 154,A00,889336,Henry; Todd A.,24,0,32,8
1746556599915,HIEU 106,A00,889339,Staff,22,0,32,10
1746556601964,HIEU 114,A00,889340,Staff,3,0,32,29
1746556602990,HIEU 135GS,A00,889342,Patterson; Patrick H.,0,0,1,24
1746556604014,HIEU 137,A00,889343,Edington; Claire Ellen,9,0,25,16
1746556605039,HIEU 148,A00,889345,Staff,14,0,32,18
1746556606066,HIEU 154,A00,889346,Biess; Frank Peter,21,0,32,11
1746556607094,HILA 102,A00,889351,Staff,12,0,32,20
1746556608120,HILD 2A,A01,889221,Lewandoski; Julia Mavis,1,10,32,31
1746556609145,HILD 7B,A01,889225,Man; Simeon S,0,12,32,32
1746556610172,HILD 7C,A01,889288,Alvarez; Luis A,0,14,32,32
1746556611195,HILD 30,A01,889323,Staff,0,5,32,32
1746556613243,HISC 119,A00,889383,Golan; Tal,20,0,32,12
1746556614270,HIUS 103,A00,889384,Man; Simeon S,0,0,32,32
1746556615294,HIUS 117,A00,919797,Kwak; Nancy,18,0,32,14
1746556616318,HIUS 142A,A00,919788,Staff,22,0,32,10
1746556618369,HIUS 149,A00,889386,Gyamfi; Bright,27,0,32,5
1746556619397,HIUS 155,A00,889387,Alvarez; Luis A,14,0,32,18
1746556620423,HUM 3,A01,886499,Caldwell; Michael Alan,19,0,50,31
1746556621447,HUM 3GS,A00,886500,Rodriguez; Bretton Sigfred,0,0,0,28
1746556622475,HUM 3R,A01,886502,Markman; Kristina,0,36,50,50
1746556624089,HUM 4,A01,886504,Crum; Matthew Stephen,24,0,50,26
1746556624089,HUM 4,B01,886506,West; Geoffrey Scott,17,0,50,33
1746556625114,HUM 4GS,A00,886507,Staff,0,0,0,19
1746556626138,HUM 5,A01,886509,Staff,32,0,50,18
1746556627163,HUM 5R,A01,886511,Zavodny; Tatiana Sophia,0,39,50,50
1746556628190,JAPN 180,A00,886407,Staff,17,0,40,23
1746556629215,LATI 50,A01,886409,Martin-Cabrera; Luis,4,0,22,18
1746556629215,LATI 50,A02,886410,Martin-Cabrera; Luis,19,0,22,3
1746556629215,LATI 50,A03,886411,Martin-Cabrera; Luis,21,0,22,1
1746556629215,LATI 50,A04,886412,Martin-Cabrera; Luis,9,0,22,13
1746556630240,LAWS 101,A00,907664,Staff,28,0,60,32
1746556631266,LIAB 1A,A00,889388,Saab; Dima,17,0,20,3
1746556632293,LIAB 1AX,A00,889389,El Cheddadi; Youniss,17,0,20,3
1746556633318,LIFR 1C,A00,889391,Van Moer; Vinciane G,8,0,20,12
1746556634343,LIFR 1CX,A00,889392,Van Moer; Vinciane G,7,0,20,13
1746556635371,LIFR 1D,A00,889393,Van Moer; Vinciane G,7,0,20,13
1746556636395,LIFR 1DX,A00,889394,Van Moer; Vinciane G,8,0,20,12
1746556637420,LIGN 7,A00,886923,Staff,24,0,50,26
1746556638448,LIGN 17,A00,886924,Kehler; Andrew Scott,125,0,150,25
1746556639505,LTAM 110,A00,889395,Staff,15,0,30,15
1746556640529,LTAM 110GS,A00,958010,Rodriguez; Bretton Sigfred,0,0,0,28
1746556641554,LTCH 101,A00,889397,Staff,23,0,25,2
1746556642579,LTCS 130,A00,889398,Staff,23,0,25,2
1746556643605,LTEA 138,A00,889399,Staff,24,0,40,16
1746556644629,LTEN 149,A00,889400,Wesling; Megan E.,0,3,25,25
1746556645657,LTEN 169,A00,889401,Staff,20,0,25,5
1746556646682,LTEN 180,A00,889402,Staff,10,0,15,5
1746556647709,LTEN 181,A00,889403,Staff,21,0,25,4
1746556648734,LTWL 100,A00,889404,Myerston Santana; Jacobo,3,0,25,22
1746556649763,LTWL 180GS,A00,889405,Staff,0,0,20,20
1746556650788,LTWL 181,A00,889406,Staff,17,0,25,8
1746556651814,LTWL 184,A00,889475,Mukherjee; Silpa,22,0,25,3
1746556652842,LTWR 102C,A00,889486,Staff,29,0,30,1
1746556653869,LTWR 115W,A00,889491,Staff,0,2,15,15
1746556654896,MAE 8,A01,886905,Staff,0,2,0,0
1746556655921,MAE 11,A00,886906,Bandaru; Prabhakar,0,7,50,50
1746556656945,MAE 20,A00,886907,Evdokimenko; Ekaterina,43,0,70,27
1746556657970,MAE 30B,A00,886909,Ghazinejad; Maziar,26,0,45,19
1746556658995,MAE 101B,A00,886910,Saintillan; David,29,0,45,16
1746556660021,MAE 105,A00,886911,Bandaru; Prabhakar,18,0,50,32
1746556661047,MAE 107,B00,958024,Staff,8,0,50,42
1746556662072,MAE 143B,A00,886913,Bewley; Thomas R,6,0,40,34
1746556663099,MAE 148,A01,886915,Silberman; Jack,0,3,14,14
1746556664127,MAE 160,A00,886916,Evdokimenko; Ekaterina,32,0,60,28
1746556665157,MATH 3C,A01,889681,Staff,0,3,30,30
1746556665157,MATH 3C,A02,960048,Staff,25,0,30,5
1746556666184,MATH 10A,A01,889760,Staff,26,0,30,4
1746556666184,MATH 10A,A02,889783,Staff,29,0,30,1
1746556667213,MATH 10B,A01,889785,Verstraete; Jacques Allan,2,0,35,33
1746556667213,MATH 10B,A02,889795,Verstraete; Jacques Allan,4,0,35,31
1746556667213,MATH 10B,B01,889797,Verstraete; Jacques Allan,3,0,35,32
1746556667213,MATH 10B,B02,889828,Verstraete; Jacques Allan,3,0,35,32
1746556668242,MATH 10C,A01,889849,Habib; Yousaf,8,0,30,22
1746556668242,MATH 10C,A02,889852,Habib; Yousaf,14,0,30,16
1746556668242,MATH 10C,A03,889853,Habib; Yousaf,22,0,30,8
1746556668242,MATH 10C,A04,889858,Habib; Yousaf,20,0,30,10
1746556668242,MATH 10C,B01,889861,Staff,1,0,30,29
1746556668242,MATH 10C,B02,889862,Staff,24,0,30,6
1746556668242,MATH 10C,B03,889863,Staff,27,0,30,3
1746556668242,MATH 10C,B04,889967,Staff,23,0,30,7
1746556669271,MATH 18,A01,889974,Staff,7,0,30,23
1746556669271,MATH 18,A02,889977,Staff,20,0,30,10
1746556669271,MATH 18,B01,889984,Hardiman; Liam,21,0,30,9
1746556669271,MATH 18,B02,889985,Hardiman; Liam,25,0,30,5
1746556670297,MATH 20A,A01,889990,Suk; Andrew Hoon,30,0,35,5
1746556671323,MATH 20B,A01,889993,Ohm; Ko Woon,22,0,30,8
1746556671323,MATH 20B,A02,889994,Ohm; Ko Woon,30,0,30,0
1746556671323,MATH 20B,B01,889996,Ohm; Ko Woon,21,0,30,9
1746556671323,MATH 20B,B02,889997,Ohm; Ko Woon,23,0,30,7
1746556672349,MATH 20C,A01,889999,Hammock; Frances H,17,0,30,13
1746556672349,MATH 20C,A02,890003,Hammock; Frances H,23,0,30,7
1746556672349,MATH 20C,B01,890006,Hammock; Frances H,3,0,30,27
1746556672349,MATH 20C,B02,890007,Hammock; Frances H,11,0,30,19
1746556673379,MATH 20D,A01,890011,Cheng; Hsiao-Bing,1,1,30,29
1746556673379,MATH 20D,A02,890012,Cheng; Hsiao-Bing,14,0,30,16
1746556673379,MATH 20D,B01,890016,Cheng; Hsiao-Bing,13,0,30,17
1746556673379,MATH 20D,B02,890017,Cheng; Hsiao-Bing,13,0,30,17
1746556674405,MATH 20E,A01,890026,Harel; Guershon,1,0,30,29
1746556674405,MATH 20E,A02,890029,Harel; Guershon,23,0,30,7
1746556674405,MATH 20E,B01,890033,Harel; Guershon,7,0,30,23
1746556674405,MATH 20E,B02,890101,Harel; Guershon,21,0,30,9
1746556675430,MATH 102,A01,890104,Staff,17,0,30,13
1746556675430,MATH 102,A02,890105,Staff,27,0,30,3
1746556676456,MATH 103B,A01,890116,Salehi Golsefidy; Alireza,3,0,30,27
1746556676456,MATH 103B,B01,890118,Staff,0,3,34,34
1746556677487,MATH 109,A01,890121,Aliabadi Sr.; Mohsen,1,0,30,29
1746556677487,MATH 109,B01,890124,Upadrashta; Pranav Kumar,18,0,30,12
1746556678515,MATH 120A,A01,890126,Eggers; John Dietrich,13,0,30,17
1746556679541,MATH 142B,A01,890128,Ioana; Adrian,19,0,30,11
1746556679541,MATH 142B,A02,890129,Ioana; Adrian,13,0,30,17
1746556680566,MATH 154,A01,890174,Staff,0,0,30,30
1746556680566,MATH 154,A02,890182,Staff,0,0,30,30
1746556681594,MATH 168A,A01,890197,Dumitriu; Ioana,21,0,35,14
1746556682620,MATH 170A,A01,890240,Nie; Jiawang,1,0,30,29
1746556682620,MATH 170A,A02,890241,Nie; Jiawang,11,0,30,19
1746556682620,MATH 170A,A03,890249,Nie; Jiawang,23,0,30,7
1746556683649,MATH 170B,A01,957891,Nag; Panchali,13,0,35,22
1746556685702,MATH 181A,A01,908025,Staff,0,4,35,35
1746556685702,MATH 181A,A02,960115,Staff,27,0,35,8
1746556686730,MATH 181B,A01,959874,Staff,25,0,30,5
1746556687755,MATH 193B,A01,890265,Staff,0,4,35,35
1746556688784,MGT 4,A01,890311,Anderson; John Charles,42,0,88,46
1746556689812,MGT 5,A00,907740,Staff,13,0,98,85
1746556690837,MGT 12,A00,890312,Lindenberger; Wade Douglas,67,0,98,31
1746556691864,MGT 16,A00,957883,Staff,78,0,98,20
1746556693918,MGT 45,A00,890314,Pecore; Joseph P.,46,0,98,52
1746556694943,MGT 71,A00,890315,Staff,0,11,98,98
1746556695972,MGT 100,A00,890316,Yavorsky; Daniel Ryan,44,0,98,54
1746556696998,MGT 103,A00,890317,Ehrich; Kristine R,73,0,98,25
1746556698023,MGT 105,A00,890356,Bates; Kenneth Walter,0,7,98,98
1746556699050,MGT 112,A00,890360,Ehrich; Kristine R,55,0,98,43
1746556700077,MGT 127R,A00,907732,Zhu; Kevin Xiaoguo,24,0,98,74
1746556701104,MGT 131B,A00,890361,Anderson; John Charles,60,0,98,38
1746556702132,MGT 137,A00,890362,Lindenberger; Wade Douglas,65,0,98,33
1746556703156,MGT 160,A00,890369,Johnson; Erik Barry,9,0,98,89
1746556705246,MGT 164,A00,890372,Zimmermann; Carsten,0,39,98,98
1746556706270,MGT 180,A00,890374,Bliss; Barbara Ann,12,0,98,86
1746556707295,MMW 15,A01,886414,Chang; Edmond Yi-Teh,0,12,28,28
1746556707295,MMW 15,A02,886415,Chang; Edmond Yi-Teh,0,8,28,28
1746556707295,MMW 15,A03,886416,Chang; Edmond Yi-Teh,0,8,28,28
1746556707295,MMW 15,A04,886417,Chang; Edmond Yi-Teh,0,8,28,28
1746556707295,MMW 15,B01,886419,Chang; Edmond Yi-Teh,0,7,28,28
1746556707295,MMW 15,B02,886420,Chang; Edmond Yi-Teh,0,8,28,28
1746556707295,MMW 15,B03,886421,Chang; Edmond Yi-Teh,0,7,28,28
1746556707295,MMW 15,B04,886422,Chang; Edmond Yi-Teh,0,8,28,28
1746556707295,MMW 15,C01,886424,Staff,0,9,28,28
1746556707295,MMW 15,C02,886425,Staff,0,8,28,28
1746556707295,MMW 15,C03,886426,Staff,0,8,28,28
1746556707295,MMW 15,C04,886427,Staff,0,8,28,28
1746556707295,MMW 15,C05,958038,Staff,0,7,28,28
1746556707295,MMW 15,C06,958039,Staff,0,8,28,28
1746556708320,MMW 15GS,A00,906910,Patterson; Patrick H.,4,0,28,24
1746556709347,MMW 122R,A01,886429,Rahimi; Babak,0,13,28,28
1746556709347,MMW 122R,A02,886430,Rahimi; Babak,0,12,28,28
1746556709347,MMW 122R,A03,958040,Rahimi; Babak,0,11,28,28
1746556710374,MUS 1A,A01,890937,Staff,2,0,25,23
1746556710374,MUS 1A,A02,891035,Staff,6,0,25,19
1746556710374,MUS 1A,C01,958912,Staff,24,0,25,1
1746556710374,MUS 1A,C02,958913,Staff,25,0,25,0
1746556712423,MUS 2AK,A00,957092,Ohnishi; Takae,15,0,15,0
1746556713449,MUS 4,A01,891044,Staff,2,0,25,23
1746556713449,MUS 4,A02,891045,Staff,23,0,25,2
1746556713449,MUS 4,B01,891048,Staff,17,0,25,8
1746556713449,MUS 4,B02,891050,Staff,25,0,25,0
1746556714477,MUS 5,A01,957506,Dubnov; Shlomo,0,0,25,25
1746556714477,MUS 5,A02,957622,Dubnov; Shlomo,13,0,25,12
1746556714477,MUS 5,A03,957623,Dubnov; Shlomo,20,0,25,5
1746556715503,MUS 6,A01,891053,Freitas Caetano; Marcelo,24,0,25,1
1746556715503,MUS 6,A02,891054,Freitas Caetano; Marcelo,23,0,25,2
1746556716532,MUS 7,A01,891081,Staff,0,0,25,25
1746556716532,MUS 7,A02,891082,Staff,4,0,25,21
1746556717557,MUS 8GS,A00,891118,Borgo; David Garcia,0,0,25,25
1746556718588,MUS 11,A01,891140,Staff,10,0,25,15
1746556718588,MUS 11,A02,891141,Staff,22,0,25,3
1746556719613,MUS 13,A01,891143,Staff,8,0,25,17
1746556719613,MUS 13,A02,891144,Staff,24,0,25,1
1746556720644,MUS 15,A01,891146,Staff,9,0,25,16
1746556720644,MUS 15,A02,891148,Staff,21,0,25,4
1746556720644,MUS 15,B01,891150,Staff,18,0,25,7
1746556720644,MUS 15,B02,891151,Staff,25,0,25,0
1746556721670,MUS 20,A01,891153,Staff,5,0,20,15
1746556721670,MUS 20,A02,891155,Staff,14,0,20,6
1746556722698,MUS 80,A00,891156,Staff,19,0,25,6
1746556722698,MUS 80,B00,891157,Staff,23,0,25,2
1746556723723,MUS 130,A00,891158,Ohnishi; Takae,35,0,35,0
1746556724750,MUS 150GS,A01,891160,Borgo; David Garcia,0,0,25,25
1746556725777,MUS 170,A01,891162,Freitas Caetano; Marcelo,20,0,25,5
1746556725777,MUS 170,A02,891164,Freitas Caetano; Marcelo,21,0,25,4
1746556726802,NANO 11,A00,886220,Vazquez Mena; Oscar,13,0,15,2
1746556727829,NANO 15,A01,886222,Drews; Aaron,4,0,7,3
1746556728858,NANO 104,A00,886224,Sirbuly; Donald,18,0,25,7
1746556729882,PH 40,A00,886528,Staff,23,0,40,17
1746556730907,PH 45,A01,886799,Staff,35,0,40,5
1746556731932,PH 110,A00,886802,Staff,0,7,40,40
1746556732957,PH 172,A00,906716,Staff,19,0,35,16
1746556733985,PH 191,A00,886803,Staff,6,0,40,34
1746556735012,PHIL 1,A00,889500,Staff,20,0,30,10
1746556736037,PHIL 10,A01,889549,Grush; Rick Scott,15,0,22,7
1746556736037,PHIL 10,A02,889551,Grush; Rick Scott,22,0,22,0
1746556737063,PHIL 28,A01,889559,Lamey; Andy M.,0,1,31,31
1746556737063,PHIL 28,A02,889561,Lamey; Andy M.,0,1,30,30
1746556737063,PHIL 28,A03,889572,Lamey; Andy M.,0,1,30,30
1746556738087,PHIL 35,A00,907839,Staff,13,0,15,2
1746556739116,PHIL 60,A00,889574,Staff,74,0,90,16
1746556740141,PHIL 101,A00,958004,Staff,12,0,15,3
1746556742194,PHIL 136,A00,889582,Fulkerson; Matthew Todd,26,0,45,19
1746556743223,PHIL 163,A01,889601,Staff,21,0,30,9
1746556743223,PHIL 163,B01,889606,Brandt; Reuven A,0,3,0,0
1746556744251,PHIL 164,A00,889610,Staff,16,0,30,14
1746556745275,PHIL 165,A00,889613,Staff,23,0,30,7
1746556746301,PHYS 1A,A00,886431,Staff,26,0,70,44
1746556747326,PHYS 1AL,001,886432,Tsai; Philbert S,0,2,30,30
1746556747326,PHYS 1AL,002,886436,Tsai; Philbert S,11,0,30,19
1746556748352,PHYS 1B,A00,886439,Staff,185,0,240,55
1746556749378,PHYS 1BL,001,886441,Tsai; Philbert S,0,4,30,30
1746556749378,PHYS 1BL,002,886444,Tsai; Philbert S,2,0,30,28
1746556750402,PHYS 1C,A00,896092,Arnold; Kam S,78,0,146,68
1746556751429,PHYS 1CL,001,886448,Tsai; Philbert S,0,0,30,30
1746556751429,PHYS 1CL,002,886449,Tsai; Philbert S,0,0,30,30
1746556751429,PHYS 1CL,003,886450,Tsai; Philbert S,16,0,30,14
1746556751429,PHYS 1CL,004,886451,Tsai; Philbert S,15,0,30,15
1746556752457,PHYS 2B,A01,886457,Staff,68,0,115,47
1746556753483,PHYS 2C,A01,886460,Shotwell; Brian,0,9,65,65
1746556754506,PHYS 2CL,A01,886467,Staff,0,4,28,28
1746556754506,PHYS 2CL,A02,886468,Staff,0,3,28,28
1746556755532,PHYS 2D,A01,886470,Staff,10,0,50,40
1746556756557,PHYS 4B,A01,886475,Grinstein; Benjamin,22,0,40,18
1746556757585,POLI 5,A00,891173,Desposato; Scott,7,0,25,18
1746556758615,POLI 5D,A01,891175,Staff,5,0,5,0
1746556758615,POLI 5D,B01,891178,Staff,5,0,5,0
1746556759646,POLI 11,A00,891179,Ferree; Karen E,2,0,35,33
1746556760672,POLI 12,A00,891180,Staff,16,0,30,14
1746556761699,POLI 27,A01,891182,Staff,12,0,75,63
1746556762725,POLI 30,A00,891183,Staff,8,0,50,42
1746556763752,POLI 100B,A00,891244,Staff,5,1,35,30
1746556764778,POLI 100I,A00,891247,Staff,7,0,30,23
1746556765803,POLI 104J,A00,891248,Nichter; Maysa,14,0,30,16
1746556766830,POLI 104U,A00,891250,Nichter; Maysa,2,0,30,28
1746556768882,POLI 110B,A00,891255,Wiens; David,20,0,25,5
1746556769906,POLI 112A,A00,891256,Wiens; David,6,0,25,19
1746556770933,POLI 114BR,A00,891261,Staff,19,0,30,11
1746556771960,POLI 117R,A00,891262,Forman; Fonna,0,6,50,50
1746556772988,POLI 118,A00,891264,Ingham; Sean,17,0,25,8
1746556774015,POLI 124A,A00,891265,Staff,18,0,20,2
1746556775039,POLI 125D,A00,891266,Nichter; Simeon C,2,0,25,23
1746556776067,POLI 126,A00,891268,Nichter; Simeon C,7,0,25,18
1746556777093,POLI 126AA,A00,891272,Staff,17,0,25,8
1746556778117,POLI 130AA,A00,891273,Staff,15,0,20,5
1746556779143,POLI 134AA,A00,891274,Staff,4,0,20,16
1746556781193,POLI 138,A00,891278,Staff,21,0,25,4
1746556782220,POLI 142K,A00,891280,Staff,11,0,25,14
1746556783247,POLI 142M,A00,891281,Gartzke; Erik,17,0,30,13
1746556784275,POLI 142P,A00,891284,Staff,20,0,30,10
1746556785302,POLI 143,A00,891285,Gartzke; Erik,12,0,30,18
1746556786327,POLI 153,A00,891286,Staff,19,0,20,1
1746556788580,POLI 175,A00,891290,Staff,15,0,20,5
1746556789605,PSYC 1,A00,890674,Steiner; Eric Tomas,0,11,45,45
1746556790631,PSYC 2,A00,890676,Albright; Thomas D,21,0,35,14
1746556791656,PSYC 3,A00,890679,Staff,17,0,20,3
1746556792682,PSYC 6,A00,959858,Staff,20,0,20,0
1746556793710,PSYC 60,A01,890684,Rickard; Timothy C.,0,5,45,45
1746556794734,PSYC 70,A01,890689,Geller; Emma Harlan,7,0,30,23
1746556795759,PSYC 71,A01,959860,Staff,21,0,25,4
1746556796787,PSYC 100,A00,890690,Lacefield; Katharine I,0,50,180,180
1746556797812,PSYC 102,A00,890695,Staff,18,0,40,22
1746556798840,PSYC 105,A00,890699,Geller; Emma Harlan,70,0,100,30
1746556799869,PSYC 106,A00,890701,Gorman; Michael R.,6,0,30,24
1746556800894,PSYC 108,A00,890704,Adrian; Julia Anna,0,28,50,50
1746556801919,PSYC 118,A01,890712,Staff,11,0,30,19
1746556802944,PSYC 124,A00,890716,Chapman; Eddie Nathaniel,25,0,60,35
1746556803967,PSYC 131,A00,890717,Anagnostaras; Stephan,0,7,80,80
1746556804992,PSYC 137,A00,890719,Winkielman; Piotr,0,11,30,30
1746556806020,PSYC 144,A00,890721,Adrian; Julia Anna,0,9,45,45
1746556807044,PSYC 162,A00,890805,Staff,2,0,75,73
1746556808108,PSYC 169,A00,890810,Staff,0,14,30,30
1746556809132,PSYC 172,A00,890814,Gorman; Michael R.,9,0,30,21
1746556810160,PSYC 181,A00,890818,Anagnostaras; Stephan,8,0,200,192
1746556811394,PSYC 184,A00,959861,Staff,170,0,175,5
1746556812429,PSYC 189,A00,890823,Staff,0,1,30,30
1746556813461,PSYC 191,A00,890884,Rickard; Timothy C.,0,11,35,35
1746556814487,PSYC 193,A00,890913,Staff,19,0,30,11
1746556814487,PSYC 193,B00,890914,Chapman; Eddie Nathaniel,24,0,30,6
1746556815518,PSYC 193L,A01,890918,Lowe; Angela Beth,20,0,30,10
1746556815518,PSYC 193L,B01,890921,Hurwitz; Ethan Scott,20,0,30,10
1746556815518,PSYC 193L,C01,890928,Staff,30,0,30,0
1746556816546,RELI 149,A00,886806,Rahimi; Babak,23,0,40,17
1746556817570,SE 9,A01,886814,Staff,7,0,20,13
1746556818596,SE 101B,A01,886816,Chadha; Mayank,4,0,35,31
1746556819621,SE 110B,A00,886818,Zhu; Qiang,4,0,75,71
1746556820648,SE 125,A01,886830,Staff,10,0,30,20
1746556821673,SE 130B,A01,886835,Staff,14,0,40,26
1746556822698,SE 131A,A01,886838,Krysl; Petr,34,0,55,21
1746556823728,SE 154,A00,886840,Staff,29,0,50,21
1746556824754,SE 164GS,A01,886849,Staff,6,0,20,14
1746556825784,SE 167GS,A01,886853,Staff,6,0,20,14
1746556826812,SIO 25,A01,890107,Staff,19,0,30,11
1746556827835,SIO 45,A00,890109,Cook; Geoffrey W,117,0,200,83
1746556828860,SIO 109R,A00,890110,Forman; Fonna,0,16,20,20
1746556829887,SIO 187,A01,890114,Kacev; David,15,0,40,25
1746556830912,SOCI 1,A01,890431,Thorpe; Charles Robert,15,0,30,15
1746556830912,SOCI 1,A02,890518,Thorpe; Charles Robert,30,0,30,0
1746556831936,SOCI 2,A01,957978,Staff,25,0,25,0
1746556831936,SOCI 2,A02,957979,Staff,23,0,25,2
1746556832962,SOCI 20,A01,890523,Calderon-Zaks; Michael Aar,23,0,30,7
1746556832962,SOCI 20,A02,890526,Calderon-Zaks; Michael Aar,29,0,30,1
1746556833989,SOCI 30,A01,890533,Pardo Guerra; Juan Pablo,37,0,40,3
1746556835015,SOCI 40,A01,890535,Staff,27,0,45,18
1746556836042,SOCI 104Q,A00,890559,Staff,18,0,30,12
1746556837067,SOCI 106,A00,890560,Arnal; Maud Marie Leonie,20,0,30,10
1746556838096,SOCI 110,A00,890567,Holkenbrink-Monk; Charlene,19,0,30,11
1746556839123,SOCI 112,A00,890568,Victoria Torres; Pablo,2,0,55,53
1746556840150,SOCI 115,A00,890597,Arnal; Maud Marie Leonie,28,0,45,17
1746556842200,SOCI 121,A00,890604,Pardo Guerra; Juan Pablo,38,0,45,7
1746556843224,SOCI 126,A01,890608,Staff,8,0,10,2
1746556844248,SOCI 127,A00,890609,Staff,18,0,30,12
1746556845272,SOCI 131,A00,890610,Thorpe; Charles Robert,37,0,45,8
1746556846298,SOCI 135,A00,890615,Payne; Christine Anna,13,0,45,32
1746556847324,SOCI 139,A00,890620,Staff,38,0,45,7
1746556848349,SOCI 148E,A00,890622,Calderon-Zaks; Michael Aar,36,0,45,9
1746556849376,SOCI 150,A00,890623,Kohler; Kristopher M.,31,0,45,14
1746556850407,SOCI 157,A00,890625,Jules-Rosette; Bennetta W.,18,0,20,2
1746556851431,SOCI 160,A00,890627,Payne; Christine Anna,21,0,45,24
1746556852457,SYN 1,A00,886855,Fish; Gwendolyn Anne,0,0,0,0
1746556852457,SYN 1,B00,906086,Fish; Gwendolyn Anne,0,1,0,2
1746556853483,SYN 2R,A00,886860,Staff,0,17,15,15
1746556853483,SYN 2R,B00,906106,Atkinson; Arthur Laird,0,16,15,15
1746556854512,SYN 100,A01,886866,Browne; Emily,0,28,20,20
1746556854512,SYN 100,B01,906128,Rock; Martin,0,5,20,20
1746556854512,SYN 100,C01,906140,Deavenport; James Cary,0,3,20,20
1746556854512,SYN 100,D01,907816,Deavenport; James Cary,0,5,20,20
1746556855539,TDAC 1,A00,890286,Walsh; Kim C.,8,0,20,12
1746556856564,TDAC 101,A00,890296,Basso; Beatrice,16,0,20,4
1746556857593,TDDE 131,A00,890297,Staff,47,0,50,3
1746556858620,TDDM 1,A00,890287,Weinberg; Sadie,25,0,30,5
1746556859646,TDGE 11,A00,890288,Fulton; Julia,137,0,200,63
1746556859646,TDGE 11,B00,890289,Castro; Robert Jess,184,0,200,16
1746556860675,TDGE 25,B00,957359,Walsh; Kim C.,3,0,20,17
1746556861702,TDGE 40,A01,890292,Power; Jade Yukana,27,0,30,3
1746556862726,TDGE 124,A00,890298,Havis; Allan,0,1,50,50
1746556863752,TDGE 131R,A00,890299,Burelle; Julie Sara Veronique,15,0,42,27
1746556864777,TDHT 101,A00,890300,Staff,10,0,20,10
1746556865805,TDHT 109,A01,890302,Anderson; Mysia Anyse,31,0,40,9
1746556866829,TDMV 1,A00,890293,Arcidiacono; Kristin,18,0,30,12
1746556867871,TDMV 2,A00,890294,Weinberg; Sadie,23,0,30,7
1746556868900,TDMV 3,A00,957878,Arcidiacono; Kristin,28,0,30,2
1746556870961,TDMV 138,A00,890304,Jun; Grace Shin Hae,25,0,40,15
1746556871986,TDMV 140,A00,890305,Corrales; Joseph Bernales,25,0,30,5
1746556873010,TDMV 142,A00,890307,Caligagan; Tony,32,0,40,8
1746556874035,TDMV 144,A00,890308,Camaya; Michelle Ann,25,0,30,5
1746556875060,TDPW 1,A00,890295,Stein; Deborah Isobel,3,0,20,17
1746556876089,USP 2,A01,890272,Lerner; Amy M,6,0,20,14
1746556877122,USP 3,A01,890274,Staff,12,0,30,18
1746556878149,USP 15,A01,890276,Sun; Feiyang,16,0,30,14
1746556879174,USP 25,A00,890277,Shenkman; Michael Thomas,19,0,25,6
1746556880203,USP 138,A00,890278,Staff,13,0,25,12
1746556881231,USP 143,A00,890279,Staff,21,0,70,49
1746556882257,USP 144,A00,890280,Chowdhury; Muhammed Zohir,15,0,30,15
1746556883280,USP 150,A00,890281,Boomhower; Matthew Charles,4,0,30,26
1746556884305,USP 151,A00,890282,Staff,16,0,20,4
1746556885330,USP 162,A00,890283,Andrews; Abigail Leslie,16,0,20,4
1746556886356,USP 168,A00,920477,Kwak; Nancy,1,0,5,4
1746556887380,USP 181,A00,890284,Staff,3,0,20,17
1746556888408,USP 191A,A00,890285,Staff,12,0,20,8
1746556889436,VIS 101,A00,886512,Staff,26,0,75,49
1746556890463,VIS 103,A00,886513,Cruz; Edwin Teddy,61,0,75,14
1746556891504,VIS 108,A00,886514,Staff,3,0,15,12
1746556892533,VIS 127P,A00,886515,Shen; Kuiyi,80,0,146,66
1746556893559,VIS 149,A00,886516,Yoldas; Pinar,0,0,15,15
1746556894587,VIS 164,A00,886526,Erdmann; Dean,19,0,22,3
1746556895613,VIS 194S,A00,886527,Staff,61,0,75,14
1746556896639,WCWP 10A,C00,886484,Martiniuk; Jill,12,0,15,3
1746556897686,WCWP 10B,A00,886490,Uriarte; Emma,0,0,15,15
1746556897686,WCWP 10B,B00,886491,Dhir; Simrita,10,0,15,5
1746556897686,WCWP 10B,C00,886492,Ornelas; Tricia,0,0,15,15
1746556898714,WCWP 100,A00,886494,Young; Mark T,0,6,15,15
1746556900810,AAS 10,A01,886199,Childs; Dennis R.,0,3,0,0
1746556901837,ANAR 104,A01,886940,Shtienberg; Gilad,27,0,30,3
1746556902863,ANAR 120,A00,886953,Staff,12,0,20,8
1746556903887,ANBI 148,A01,886955,Wilder; Linnea Lorene,30,0,40,10
1746556905939,ANSC 122,A00,886957,Staff,25,0,30,5
1746556906964,ANSC 150,A00,886958,Sloane; Julia Kathryn,2,0,15,13
1746556907989,ANSC 156,A00,886959,Jenkins; Janis A.,0,1,15,15
1746556909014,ANSC 180,A00,886960,Staff,11,0,17,6
1746556910040,ANSC 188,A00,886961,Jassal; Aftab,9,0,25,16
1746556911068,ANSC 190,A00,886962,Jassal; Aftab,14,0,25,11
1746556912095,ANSC 191,A00,886963,Staff,18,0,20,2
1746556913120,ANTH 3,A01,891689,Staff,17,0,20,3
1746556914144,ANTH 5,A00,886933,Semendeferi; Ekaterini,16,0,20,4
1746556915168,ANTH 10,A00,886934,Staff,0,12,30,30
1746556916193,ANTH 21,A01,886936,Staff,40,0,60,20
1746556917220,ANTH 23,A01,886938,Staff,92,0,100,8
1746556918244,ANTH 105,A00,886964,Stewart; Alexander B,84,0,100,16
1746556919268,ANTH 108,A00,886965,Pedersen; David,9,0,20,11
1746556920301,AWP 10,001,886147,Staff,0,0,0,0
1746556920301,AWP 10,002,886148,Staff,0,0,0,0
1746556920301,AWP 10,003,886149,Staff,0,0,0,0
1746556920301,AWP 10,004,886150,Staff,0,0,0,0
1746556920301,AWP 10,005,886151,Staff,0,0,0,0
1746556920301,AWP 10,006,886152,Staff,0,0,0,0
1746556920301,AWP 10,007,886153,Staff,0,0,0,0
1746556920301,AWP 10,008,886154,Staff,0,0,0,0
1746556920301,AWP 10,009,886155,Staff,0,0,0,0
1746556920301,AWP 10,010,886156,Staff,0,0,0,0
1746556920301,AWP 10,011,886158,Staff,0,0,0,0
1746556920301,AWP 10,012,886160,Staff,0,0,0,0
1746556920301,AWP 10,013,886161,Staff,0,0,0,0
1746556920301,AWP 10,014,886162,Staff,0,0,0,0
1746556920301,AWP 10,015,886163,Staff,0,0,0,0
1746556920301,AWP 10,016,886164,Staff,0,0,0,0
1746556920301,AWP 10,017,886165,Staff,0,0,0,0
1746556920301,AWP 10,018,886166,Staff,0,0,0,0
1746556920301,AWP 10,019,886168,Staff,0,0,0,0
1746556920301,AWP 10,020,886170,Staff,0,0,0,0
1746556920301,AWP 10,021,886172,Staff,0,0,0,0
1746556921329,AWP 10R,001,886173,Staff,0,1,0,0
1746556921329,AWP 10R,002,886174,Staff,0,1,0,0
1746556921329,AWP 10R,003,886175,Staff,0,0,0,0
1746556921329,AWP 10R,004,886176,Staff,0,0,0,0
1746556921329,AWP 10R,005,886177,Staff,0,0,0,0
1746556921329,AWP 10R,006,886178,Staff,0,0,0,0
1746556921329,AWP 10R,007,886179,Staff,0,0,0,0
1746556921329,AWP 10R,008,886181,Staff,0,0,0,0
1746556921329,AWP 10R,009,886182,Staff,0,0,0,0
1746556921329,AWP 10R,010,886183,Staff,0,0,0,0
1746556921329,AWP 10R,011,886184,Staff,0,0,0,0
1746556921329,AWP 10R,012,886185,Staff,0,0,0,0
1746556921329,AWP 10R,013,886186,Staff,0,0,0,0
1746556921329,AWP 10R,014,886187,Staff,0,0,0,0
1746556921329,AWP 10R,015,886188,Staff,0,0,0,0
1746556921329,AWP 10R,016,886189,Staff,0,0,0,0
1746556921329,AWP 10R,017,960532,Staff,0,0,0,0
1746556921329,AWP 10R,018,960533,Staff,0,0,0,0
1746556921329,AWP 10R,019,960534,Staff,0,0,0,0
1746556921329,AWP 10R,020,960538,Staff,0,0,0,0
1746556921329,AWP 10R,021,960540,Staff,0,0,0,0
1746556921329,AWP 10R,022,960541,Staff,0,0,0,0
1746556921329,AWP 10R,023,960542,Staff,0,0,0,0
1746556921329,AWP 10R,024,960544,Staff,0,0,0,0
1746556921329,AWP 10R,025,960545,Staff,0,0,0,0
1746556921329,AWP 10R,026,960548,Staff,0,0,0,0
1746556922354,AWP 102R,A00,886190,Staff,0,0,0,0
1746556922354,AWP 102R,B00,886191,Staff,0,0,0,0
1746556923379,BENG 100,A01,886193,Staff,17,0,30,13
1746556924403,BENG 122A,A01,886195,Hasty; Jeff M,13,0,30,17
1746556925445,BENG 166A,A00,886196,Sah; Robert Lie-Yuan,0,2,30,30
1746556926469,BENG 190,A00,958050,Khojah; Reem I,22,0,25,3
1746556927494,BIBC 102,A01,894320,Staff,0,0,46,46
1746556927494,BIBC 102,A02,894321,Staff,0,0,46,46
1746556927494,BIBC 102,A03,894344,Staff,7,0,46,39
1746556927494,BIBC 102,A04,894345,Staff,26,0,47,21
1746556928521,BICD 100R,A01,894365,Smith; Laurie,0,4,58,58
1746556928521,BICD 100R,A02,894366,Smith; Laurie,0,5,58,58
1746556928521,BICD 100R,A03,894367,Smith; Laurie,1,0,59,58
1746556928521,BICD 100R,A04,959869,Smith; Laurie,41,0,59,18
1746556929550,BICD 136,A01,894383,Gustafson-Brown; Cindy,14,0,50,36
1746556930577,BIEB 102,A01,894494,Butler; Shannon Rhey,51,0,130,79
1746556932628,BIEB 150,A01,894617,Wills; Christopher,3,0,20,17
1746556932628,BIEB 150,A02,894631,Wills; Christopher,3,0,20,17
1746556932628,BIEB 150,A03,894937,Wills; Christopher,3,0,20,17
1746556932628,BIEB 150,A04,894946,Wills; Christopher,5,0,20,15
1746556933656,BIEB 194,A00,906141,Kurle; Carolyn M.,6,0,20,14
1746556934682,BILD 1,A01,894154,Staff,3,0,19,16
1746556934682,BILD 1,A02,894155,Staff,14,0,19,5
1746556934682,BILD 1,A03,894160,Staff,13,0,19,6
1746556934682,BILD 1,A04,894161,Staff,15,0,18,3
1746556935708,BILD 2,A01,894168,Staff,0,0,50,50
1746556935708,BILD 2,A02,894169,Staff,0,0,50,50
1746556935708,BILD 2,A03,894179,Staff,1,0,50,49
1746556935708,BILD 2,A04,894203,Staff,27,0,50,23
1746556936734,BILD 3,A01,894213,Staff,22,0,31,9
1746556936734,BILD 3,A02,894214,Staff,26,0,31,5
1746556936734,BILD 3,A03,894235,Staff,28,0,31,3
1746556936734,BILD 3,A04,894236,Staff,28,0,32,4
1746556937758,BILD 4,A01,894253,Reuther; Keefe,5,0,24,19
1746556937758,BILD 4,A02,894258,Reuther; Keefe,16,0,24,8
1746556938785,BILD 5,A01,894276,Reuther; Keefe,35,0,50,15
1746556938785,BILD 5,A02,894277,Reuther; Keefe,45,0,50,5
1746556938785,BILD 5,A03,894290,Reuther; Keefe,44,0,50,6
1746556938785,BILD 5,A04,894291,Reuther; Keefe,48,0,50,2
1746556939809,BILD 24,A01,894297,Pirino; Giorgia,40,0,60,20
1746556940838,BIMM 100,B01,958915,Staff,71,0,100,29
1746556941866,BIMM 101,A01,895017,McDonnell; Lisa Marie,0,5,24,24
1746556941866,BIMM 101,A02,895018,McDonnell; Lisa Marie,0,5,24,24
1746556941866,BIMM 101,B01,895020,McDonnell; Lisa Marie,0,6,24,24
1746556941866,BIMM 101,B02,895021,McDonnell; Lisa Marie,0,4,24,24
1746556942894,BIMM 110,A01,895023,Staff,1,0,25,24
1746556942894,BIMM 110,A02,895024,Staff,9,0,25,16
1746556942894,BIMM 110,A03,895025,Staff,18,0,25,7
1746556942894,BIMM 110,A04,895031,Staff,20,0,25,5
1746556943919,BIMM 120,A01,895114,Gustafson-Brown; Cindy,14,0,28,14
1746556943919,BIMM 120,A02,895126,Gustafson-Brown; Cindy,21,0,27,6
1746556944946,BIPN 100,A01,895130,Yang; Mingyu,1,0,38,37
1746556944946,BIPN 100,A02,895131,Yang; Mingyu,32,0,38,6
1746556944946,BIPN 100,A03,895132,Yang; Mingyu,32,0,38,6
1746556944946,BIPN 100,A04,895133,Yang; Mingyu,27,0,36,9
1746556945972,BIPN 120,A01,895135,Cooke; James Edward,0,3,13,13
1746556945972,BIPN 120,A02,895136,Cooke; James Edward,0,1,13,13
1746556945972,BIPN 120,A03,895137,Cooke; James Edward,0,3,13,13
1746556945972,BIPN 120,A04,895156,Cooke; James Edward,0,2,11,11
1746556946997,BIPN 134,A01,895235,Cooke; James Edward,0,2,25,25
1746556946997,BIPN 134,A02,895237,Cooke; James Edward,0,0,25,25
1746556946997,BIPN 134,A03,895240,Cooke; James Edward,3,0,25,22
1746556946997,BIPN 134,A04,895270,Cooke; James Edward,20,0,25,5
1746556948023,BIPN 189,A00,892103,Staff,0,13,14,14
1746556950078,BISP 194,A00,958008,Staff,0,2,0,0
1746556951106,CAT 124,A01,922009,Staff,0,5,20,20
1746556952136,CAT 125R,A00,886390,Morales; Celeste Georgianna,0,2,20,20
1746556952136,CAT 125R,B00,886391,Irwin; Matthew Joseph,0,3,20,20
1746556952136,CAT 125R,C00,886392,Smith; Lauryn Alissa,0,2,20,20
1746556952136,CAT 125R,D00,886393,Vanderschuit; Maya Alysia,0,2,20,20
1746556952136,CAT 125R,E00,886394,Marchisotto; Jennifer Anne,0,4,20,20
1746556953160,CENG 15,A01,886218,Drews; Aaron,3,0,8,5
1746556954187,CENG 113,A00,886219,Opatkiewicz; Justin Paul,15,0,25,10
1746556955266,CGS 101,A00,887044,Staff,7,0,20,13
1746556956293,CGS 105,A01,887046,Staff,14,0,25,11
1746556957317,CGS 112,A00,887047,Cuong; Marisol,12,0,15,3
1746556958344,CGS 113,A00,887048,Staff,23,0,30,7
1746556959373,CGS 120,A00,887049,Staff,10,0,17,7
1746556960398,CHEM 6A,A01,886336,Lam; Tin Yiu,38,0,50,12
1746556960398,CHEM 6A,A02,886338,Lam; Tin Yiu,37,0,50,13
1746556961422,CHEM 6B,A01,886341,Hopkins; Patrycja Anna,16,0,50,34
1746556961422,CHEM 6B,A02,886343,Hopkins; Patrycja Anna,42,0,50,8
1746556962447,CHEM 6C,A01,886346,Albizati; Kim F.,0,2,50,50
1746556962447,CHEM 6C,A02,886348,Albizati; Kim F.,23,0,50,27
1746556963474,CHEM 40A,A01,886352,Klosterman; Jeremy K,65,0,100,35
1746556964502,CHEM 40B,A01,886356,Klosterman; Jeremy K,0,23,100,100
1746556965529,CHEM 41B,A01,886360,Theodorakis; Emmanuel,25,0,50,25
1746556965529,CHEM 41B,A02,886362,Theodorakis; Emmanuel,47,0,50,3
1746556966558,CHIN 165A,A00,886382,Xu; Li,18,0,20,2
1746556967588,CLAS 120,A00,886387,Myerston Santana; Jacobo,33,0,40,7
1746556968613,COGS 9,A01,886967,Shannon; Kyle Michael,42,0,60,18
1746556969637,COGS 11,A01,886969,Staff,11,0,30,19
1746556970664,COGS 14A,A01,886971,Staff,6,0,60,54
1746556971693,COGS 14B,A01,886973,Hoffman; Drew Ellen,4,0,60,56
1746556972718,COGS 18,A01,886975,Morgan; Eric,35,0,60,25
1746556973743,COGS 20,A01,886977,Staff,4,0,8,4
1746556973743,COGS 20,A02,886978,Staff,5,0,7,2
1746556974768,COGS 100,A01,907783,Staff,0,2,30,30
1746556975796,COGS 101B,A01,886980,Staff,0,3,48,48
1746556976824,COGS 101C,A01,886982,Delgado; Tania,0,5,44,44
1746556977851,COGS 102A,A01,886984,Johnson; Christine M.,4,0,30,26
1746556978878,COGS 118B,A01,886986,Staff,0,3,88,88
1746556979907,COGS 150,A01,886988,Bergen; Benjamin,23,0,50,27
1746556980936,COGS 153,A00,886989,Delgado; Tania,0,2,41,41
1746556981962,COGS 186,A01,886991,Staff,0,0,32,32
1746556982987,COGS 187A,A01,886993,Boyle; Mary E. T.,7,0,30,23
1746556984014,COGS 189,A00,886994,Staff,0,1,30,30
1746556985038,COMM 10,A01,886996,Staff,0,0,20,21
1746556985038,COMM 10,A02,886997,Staff,12,0,20,8
1746556985038,COMM 10,A03,959845,Staff,19,0,20,1
1746556986066,COMM 20,A01,886999,Leuning; Grant Maurstad,24,0,40,16
1746556988120,COMM 100A,A01,887002,Staff,0,0,20,25
1746556988120,COMM 100A,A02,887003,Staff,7,0,20,13
1746556989145,COMM 100B,A01,887005,Staff,0,8,20,24
1746556990176,COMM 106D,A00,887006,Staff,14,0,40,26
1746556991203,COMM 110G,A00,887007,Whitworth-Smith; Andrew C,12,0,40,28
1746556992227,COMM 111B,A00,887008,Staff,31,0,40,9
1746556993257,COMM 113T,A00,887009,Abuelhiga; Soraya Jill,28,0,40,12
1746556993257,COMM 113T,B00,906733,Staff,40,0,40,0
1746556994282,COMM 145,A00,887010,Staff,12,0,40,28
1746556995313,COMM 146,A00,887054,Staff,31,0,40,9
1746556996337,COMM 190,A00,887012,Staff,8,0,23,15
1746556997365,CSE 8A,A50,887015,Cao; Yingjun,57,0,85,28
1746556998389,CSE 11,A01,887017,Cao; Yingjun,12,0,70,58
1746556999414,CSE 20,A01,887019,Staff,30,0,50,20
1746557000443,CSE 21,A01,887021,Staff,78,0,100,22
1746557000443,CSE 21,B01,892583,Braun; Oliver,45,0,50,5
1746557001467,CSE 30,A01,887025,Eldon; John,143,0,200,57
1746557002494,CSE 100,A01,887027,Staff,26,0,50,24
1746557002494,CSE 100,A02,887028,Staff,42,0,50,8
1746557003518,CSE 101,A01,887030,Braun; Oliver,74,0,100,26
1746557003518,CSE 101,B01,887032,Jones; Miles E,0,3,50,50
1746557003518,CSE 101,B02,887033,Jones; Miles E,0,1,50,50
1746557004542,CSE 105,A01,908084,Jones; Miles E,32,0,50,18
1746557004542,CSE 105,A02,908087,Jones; Miles E,32,0,50,18
1746557005570,CSE 135,A01,887035,Powell; Thomas Allan,0,4,50,50
1746557006598,CSE 142,A01,887037,Staff,8,0,60,52
1746557007624,CSE 142L,A01,887039,Staff,34,0,60,26
1746557008650,CSE 151A,A01,887041,Solares; Edwin A,47,0,100,53
1746557009674,CSE 175,A01,887043,Kumar; Rakesh,30,0,30,0
1746557010701,CSS 1,A01,886389,Staff,0,1,40,40
1746557011726,DSC 30,A01,908097,Liao; Soohyun Nam,47,0,75,28
1746557012752,DSC 40A,A01,908099,Shannon; Kyle Michael,30,0,50,20
1746557013778,DSC 40B,A01,908112,Staff,16,0,50,34
1746557014803,DSC 80,A01,908116,Staff,19,0,60,41
1746557015827,DSC 197,001,956863,Eldridge; Justin Matthew,9999,0,9999,0
1746557016855,ECE 5,A01,886400,Morris; Karcher William,2,0,6,4
1746557016855,ECE 5,A02,886401,Morris; Karcher William,3,0,6,3
1746557017879,ECE 148,A01,886403,Silberman; Jack,0,14,14,14
1746557018910,ECON 1,A01,887265,Crane; Meredith Helen,12,0,70,58
1746557018910,ECON 1,B01,887268,Staff,43,0,50,7
1746557019934,ECON 2,A01,887273,Crane; Meredith Helen,56,0,70,14
1746557020960,ECON 3,A01,887279,Rondina; Giacomo,32,0,70,38
1746557021989,ECON 4,A01,887282,Anderson; John Charles,0,2,10,10
1746557023017,ECON 5,A01,887285,Staff,33,0,45,12
1746557023017,ECON 5,B01,887292,Staff,41,0,45,4
1746557024040,ECON 100A,A01,887337,Newhouse; Herbert S,54,0,70,16
1746557024040,ECON 100A,B01,887349,Staff,45,0,50,5
1746557025066,ECON 100B,A01,887361,Du; Songzi,29,0,70,41
1746557026094,ECON 100C,A01,887445,Newhouse; Herbert S,59,0,70,11
1746557027118,ECON 105,A00,887488,Vespa; Emanuel Ignacio,23,0,35,12
1746557028144,ECON 109,A01,887506,Shishkin; Denis,28,0,35,7
1746557029170,ECON 110A,A01,887568,Alon; Titan Michael,0,3,35,35
1746557029170,ECON 110A,B01,907601,Alon; Titan Michael,20,0,35,15
1746557030197,ECON 110B,A01,887598,Levkoff; Steven B.,0,24,70,70
1746557031225,ECON 112,A00,887599,Rondina; Giacomo,19,0,35,16
1746557032805,ECON 120A,A01,887603,Dai; Yinlin,35,0,70,35
1746557033834,ECON 120C,A01,887608,Sun; Yixiao,0,1,35,35
1746557033834,ECON 120C,B01,887614,Sun; Yixiao,0,0,35,35
1746557034862,ECON 138,A00,887621,Bharadwaj; Prashant,0,21,20,20
1746557035886,ECON 144,A00,958007,Squires; Dale E,13,0,35,22
1746557036911,ECON 171,A01,907666,Staff,18,0,35,17
1746557037941,ECON 175,A00,887626,Wu; Pak Yeung,23,0,35,12
1746557038967,ECON 190,A00,887640,Vespa; Emanuel Ignacio,23,0,35,12
1746557040001,EDS 25,A01,888197,Staff,0,0,0,0
1746557040001,EDS 25,A02,888209,Staff,0,0,0,0
1746557040001,EDS 25,A03,888210,Staff,0,0,0,0
1746557040001,EDS 25,A04,888212,Staff,0,0,0,0
1746557040001,EDS 25,A05,888213,Staff,0,0,0,0
1746557040001,EDS 25,A06,888214,Staff,0,0,0,0
1746557040001,EDS 25,A07,888235,Staff,0,2,0,0
1746557040001,EDS 25,A08,888236,Staff,0,0,0,0
1746557040001,EDS 25,A09,888240,Staff,0,0,0,0
1746557040001,EDS 25,A10,888244,Staff,0,0,0,0
1746557040001,EDS 25,B01,888273,Staff,0,0,0,0
1746557040001,EDS 25,B02,888285,Staff,0,0,0,0
1746557040001,EDS 25,B03,888423,Staff,0,0,0,1
1746557040001,EDS 25,B04,888432,Staff,0,0,0,0
1746557040001,EDS 25,B05,888433,Staff,0,0,0,0
1746557040001,EDS 25,B06,888467,Staff,0,0,0,0
1746557040001,EDS 25,B07,888468,Staff,0,0,0,0
1746557040001,EDS 25,B08,888479,Staff,0,0,0,0
1746557040001,EDS 25,B09,888484,Staff,0,0,0,0
1746557040001,EDS 25,B10,888487,Staff,0,0,0,0
1746557041028,EDS 38,A01,907700,Choi; Bailey Miyeon,30,0,30,0
1746557042055,EDS 112,A01,888601,Chapman; Thandeka K,13,0,40,27
1746557043101,EDS 115,A00,888697,Mendez; Kathrina Mendoza,10,0,30,20
1746557044126,EDS 116,A01,888893,Staff,35,0,40,5
1746557046178,EDS 124AR,A00,889133,Staff,29,0,50,21
1746557046178,EDS 124AR,B00,907471,Simon; Elizabeth A,37,0,50,13
1746557047203,EDS 124BR,A00,889134,Simon; Elizabeth A,45,0,100,55
1746557048246,EDS 125,A00,889135,Staff,25,0,30,5
1746557049273,EDS 126,A01,889138,Staff,36,0,40,4
1746557050299,EDS 164R,A01,889142,Wishard Guerra; Alison G.,33,0,50,17
1746557051325,ENG 30,A01,886396,Staff,0,0,0,0
1746557051325,ENG 30,B01,886398,Staff,0,0,0,0
1746557052355,ENVR 102,A00,906150,Montejo; Carolina,23,0,25,2
1746557053381,ETHN 103A,A00,887236,Man; Simeon S,0,3,0,0
1746557054407,ETHN 113,A00,887239,Staff,16,0,30,14
1746557055435,ETHN 116,A00,887240,Staff,16,0,25,9
1746557056458,ETHN 117,A00,887241,Choi; Esther Min,28,0,30,2
1746557057485,ETHN 118,A00,887243,Staff,24,0,30,6
1746557058510,ETHN 127,A00,887248,Cuong; Marisol,11,0,15,4
1746557059539,ETHN 139,A00,887250,Staff,7,0,10,3
1746557060564,ETHN 142,A00,887252,Staff,10,0,30,20
1746557061593,ETHN 161,A00,887253,Browne; Errol Tsekani,24,0,30,6
1746557062619,ETHN 163FR,A00,887255,Burelle; Julie Sara Veronique,0,0,5,5
1746557063643,GLBH 20,A00,889149,Elwardani; Nile Regina,8,0,42,34
1746557065694,GLBH 111,A01,889152,Burgos; Jose L.,17,0,17,0
1746557066722,GLBH 150,A00,889181,Sloane; Julia Kathryn,0,5,15,15
1746557068777,HDS 60,A01,886406,Warstadt; Melissa Fawn,73,0,80,7
1746557069802,HIAF 111,A00,889324,Gyamfi; Bright,25,0,32,7
1746557070826,HIEA 131,A00,889328,Staff,16,0,32,16
1746557071854,HIEA 144,A00,889333,Henry; Todd A.,26,0,32,6
1746557072879,HIEA 154,A00,889336,Henry; Todd A.,24,0,32,8
1746557073905,HIEU 106,A00,889339,Staff,22,0,32,10
1746557075962,HIEU 114,A00,889340,Staff,3,0,32,29
1746557076988,HIEU 135GS,A00,889342,Patterson; Patrick H.,0,0,1,24
1746557078014,HIEU 137,A00,889343,Edington; Claire Ellen,9,0,25,16
1746557079040,HIEU 148,A00,889345,Staff,14,0,32,18
1746557080068,HIEU 154,A00,889346,Biess; Frank Peter,21,0,32,11
1746557081096,HILA 102,A00,889351,Staff,12,0,32,20
1746557082120,HILD 2A,A01,889221,Lewandoski; Julia Mavis,1,10,32,31
1746557083346,HILD 7B,A01,889225,Man; Simeon S,0,12,32,32
1746557084374,HILD 7C,A01,889288,Alvarez; Luis A,0,14,32,32
1746557085399,HILD 30,A01,889323,Staff,0,5,32,32
1746557087450,HISC 119,A00,889383,Golan; Tal,20,0,32,12
1746557088478,HIUS 103,A00,889384,Man; Simeon S,0,0,32,32
1746557089507,HIUS 117,A00,919797,Kwak; Nancy,18,0,32,14
1746557090532,HIUS 142A,A00,919788,Staff,22,0,32,10
1746557092581,HIUS 149,A00,889386,Gyamfi; Bright,27,0,32,5
1746557093606,HIUS 155,A00,889387,Alvarez; Luis A,14,0,32,18
1746557094632,HUM 3,A01,886499,Caldwell; Michael Alan,19,0,50,31
1746557095657,HUM 3GS,A00,886500,Rodriguez; Bretton Sigfred,0,0,0,28
1746557096685,HUM 3R,A01,886502,Markman; Kristina,0,36,50,50
1746557097710,HUM 4,A01,886504,Crum; Matthew Stephen,24,0,50,26
1746557097710,HUM 4,B01,886506,West; Geoffrey Scott,17,0,50,33
1746557098739,HUM 4GS,A00,886507,Staff,0,0,0,19
1746557099766,HUM 5,A01,886509,Staff,32,0,50,18
1746557100795,HUM 5R,A01,886511,Zavodny; Tatiana Sophia,0,39,50,50
1746557101822,JAPN 180,A00,886407,Staff,17,0,40,23
1746557102852,LATI 50,A01,886409,Martin-Cabrera; Luis,4,0,22,18
1746557102852,LATI 50,A02,886410,Martin-Cabrera; Luis,19,0,22,3
1746557102852,LATI 50,A03,886411,Martin-Cabrera; Luis,21,0,22,1
1746557102852,LATI 50,A04,886412,Martin-Cabrera; Luis,9,0,22,13
1746557103876,LAWS 101,A00,907664,Staff,28,0,60,32
1746557104901,LIAB 1A,A00,889388,Saab; Dima,17,0,20,3
1746557105926,LIAB 1AX,A00,889389,El Cheddadi; Youniss,17,0,20,3
1746557106952,LIFR 1C,A00,889391,Van Moer; Vinciane G,8,0,20,12
1746557107977,LIFR 1CX,A00,889392,Van Moer; Vinciane G,7,0,20,13
1746557109005,LIFR 1D,A00,889393,Van Moer; Vinciane G,7,0,20,13
1746557110041,LIFR 1DX,A00,889394,Van Moer; Vinciane G,8,0,20,12
1746557111066,LIGN 7,A00,886923,Staff,24,0,50,26
1746557112092,LIGN 17,A00,886924,Kehler; Andrew Scott,125,0,150,25
1746557113118,LTAM 110,A00,889395,Staff,15,0,30,15
1746557114148,LTAM 110GS,A00,958010,Rodriguez; Bretton Sigfred,0,0,0,28
1746557115171,LTCH 101,A00,889397,Staff,23,0,25,2
1746557116194,LTCS 130,A00,889398,Staff,23,0,25,2
1746557117219,LTEA 138,A00,889399,Staff,24,0,40,16
1746557118243,LTEN 149,A00,889400,Wesling; Megan E.,0,3,25,25
1746557119270,LTEN 169,A00,889401,Staff,20,0,25,5
1746557120296,LTEN 180,A00,889402,Staff,10,0,15,5
1746557121322,LTEN 181,A00,889403,Staff,21,0,25,4
1746557122347,LTWL 100,A00,889404,Myerston Santana; Jacobo,3,0,25,22
1746557123373,LTWL 180GS,A00,889405,Staff,0,0,20,20
1746557124400,LTWL 181,A00,889406,Staff,17,0,25,8
1746557125426,LTWL 184,A00,889475,Mukherjee; Silpa,22,0,25,3
1746557126451,LTWR 102C,A00,889486,Staff,29,0,30,1
1746557127478,LTWR 115W,A00,889491,Staff,0,2,15,15
1746557128557,MAE 8,A01,886905,Staff,0,2,0,0
1746557129586,MAE 11,A00,886906,Bandaru; Prabhakar,0,7,50,50
1746557130611,MAE 20,A00,886907,Evdokimenko; Ekaterina,43,0,70,27
1746557131641,MAE 30B,A00,886909,Ghazinejad; Maziar,26,0,45,19
1746557132667,MAE 101B,A00,886910,Saintillan; David,29,0,45,16
1746557133692,MAE 105,A00,886911,Bandaru; Prabhakar,18,0,50,32
1746557134719,MAE 107,B00,958024,Staff,8,0,50,42
1746557135743,MAE 143B,A00,886913,Bewley; Thomas R,6,0,40,34
1746557136769,MAE 148,A01,886915,Silberman; Jack,0,3,14,14
1746557137796,MAE 160,A00,886916,Evdokimenko; Ekaterina,32,0,60,28
1746557138824,MATH 3C,A01,889681,Staff,0,3,30,30
1746557138824,MATH 3C,A02,960048,Staff,25,0,30,5
1746557139852,MATH 10A,A01,889760,Staff,26,0,30,4
1746557139852,MATH 10A,A02,889783,Staff,29,0,30,1
1746557140877,MATH 10B,A01,889785,Verstraete; Jacques Allan,2,0,35,33
1746557140877,MATH 10B,A02,889795,Verstraete; Jacques Allan,4,0,35,31
1746557140877,MATH 10B,B01,889797,Verstraete; Jacques Allan,3,0,35,32
1746557140877,MATH 10B,B02,889828,Verstraete; Jacques Allan,3,0,35,32
1746557141908,MATH 10C,A01,889849,Habib; Yousaf,8,0,30,22
1746557141908,MATH 10C,A02,889852,Habib; Yousaf,14,0,30,16
1746557141908,MATH 10C,A03,889853,Habib; Yousaf,22,0,30,8
1746557141908,MATH 10C,A04,889858,Habib; Yousaf,20,0,30,10
1746557141908,MATH 10C,B01,889861,Staff,1,0,30,29
1746557141908,MATH 10C,B02,889862,Staff,24,0,30,6
1746557141908,MATH 10C,B03,889863,Staff,27,0,30,3
1746557141908,MATH 10C,B04,889967,Staff,23,0,30,7
1746557142933,MATH 18,A01,889974,Staff,7,0,30,23
1746557142933,MATH 18,A02,889977,Staff,20,0,30,10
1746557142933,MATH 18,B01,889984,Hardiman; Liam,21,0,30,9
1746557142933,MATH 18,B02,889985,Hardiman; Liam,25,0,30,5
1746557143959,MATH 20A,A01,889990,Suk; Andrew Hoon,30,0,35,5
1746557144988,MATH 20B,A01,889993,Ohm; Ko Woon,22,0,30,8
1746557144988,MATH 20B,A02,889994,Ohm; Ko Woon,30,0,30,0
1746557144988,MATH 20B,B01,889996,Ohm; Ko Woon,21,0,30,9
1746557144988,MATH 20B,B02,889997,Ohm; Ko Woon,23,0,30,7
1746557146018,MATH 20C,A01,889999,Hammock; Frances H,17,0,30,13
1746557146018,MATH 20C,A02,890003,Hammock; Frances H,23,0,30,7
1746557146018,MATH 20C,B01,890006,Hammock; Frances H,3,0,30,27
1746557146018,MATH 20C,B02,890007,Hammock; Frances H,11,0,30,19
1746557147049,MATH 20D,A01,890011,Cheng; Hsiao-Bing,1,1,30,29
1746557147049,MATH 20D,A02,890012,Cheng; Hsiao-Bing,14,0,30,16
1746557147049,MATH 20D,B01,890016,Cheng; Hsiao-Bing,13,0,30,17
1746557147049,MATH 20D,B02,890017,Cheng; Hsiao-Bing,13,0,30,17
1746557148074,MATH 20E,A01,890026,Harel; Guershon,1,0,30,29
1746557148074,MATH 20E,A02,890029,Harel; Guershon,23,0,30,7
1746557148074,MATH 20E,B01,890033,Harel; Guershon,7,0,30,23
1746557148074,MATH 20E,B02,890101,Harel; Guershon,21,0,30,9
1746557149100,MATH 102,A01,890104,Staff,17,0,30,13
1746557149100,MATH 102,A02,890105,Staff,27,0,30,3
1746557150133,MATH 103B,A01,890116,Salehi Golsefidy; Alireza,3,0,30,27
1746557150133,MATH 103B,B01,890118,Staff,0,3,34,34
1746557151158,MATH 109,A01,890121,Aliabadi Sr.; Mohsen,1,0,30,29
1746557151158,MATH 109,B01,890124,Upadrashta; Pranav Kumar,18,0,30,12
1746557152184,MATH 120A,A01,890126,Eggers; John Dietrich,13,0,30,17
1746557153210,MATH 142B,A01,890128,Ioana; Adrian,19,0,30,11
1746557153210,MATH 142B,A02,890129,Ioana; Adrian,13,0,30,17
1746557154234,MATH 154,A01,890174,Staff,0,0,30,30
1746557154234,MATH 154,A02,890182,Staff,0,0,30,30
1746557155259,MATH 168A,A01,890197,Dumitriu; Ioana,21,0,35,14
1746557156286,MATH 170A,A01,890240,Nie; Jiawang,1,0,30,29
1746557156286,MATH 170A,A02,890241,Nie; Jiawang,11,0,30,19
1746557156286,MATH 170A,A03,890249,Nie; Jiawang,23,0,30,7
1746557157314,MATH 170B,A01,957891,Nag; Panchali,13,0,35,22
1746557159368,MATH 181A,A01,908025,Staff,0,4,35,35
1746557159368,MATH 181A,A02,960115,Staff,27,0,35,8
1746557160392,MATH 181B,A01,959874,Staff,25,0,30,5
1746557161419,MATH 193B,A01,890265,Staff,0,4,35,35
1746557162444,MGT 4,A01,890311,Anderson; John Charles,42,0,88,46
1746557163469,MGT 5,A00,907740,Staff,13,0,98,85
1746557164497,MGT 12,A00,890312,Lindenberger; Wade Douglas,67,0,98,31
1746557165524,MGT 16,A00,957883,Staff,78,0,98,20
1746557167580,MGT 45,A00,890314,Pecore; Joseph P.,46,0,98,52
1746557168606,MGT 71,A00,890315,Staff,0,11,98,98
1746557169631,MGT 100,A00,890316,Yavorsky; Daniel Ryan,44,0,98,54
1746557170657,MGT 103,A00,890317,Ehrich; Kristine R,73,0,98,25
1746557171687,MGT 105,A00,890356,Bates; Kenneth Walter,0,7,98,98
1746557172711,MGT 112,A00,890360,Ehrich; Kristine R,55,0,98,43
1746557173736,MGT 127R,A00,907732,Zhu; Kevin Xiaoguo,24,0,98,74
1746557174762,MGT 131B,A00,890361,Anderson; John Charles,60,0,98,38
1746557175787,MGT 137,A00,890362,Lindenberger; Wade Douglas,65,0,98,33
1746557176813,MGT 160,A00,890369,Johnson; Erik Barry,9,0,98,89
1746557178867,MGT 164,A00,890372,Zimmermann; Carsten,0,39,98,98
1746557179893,MGT 180,A00,890374,Bliss; Barbara Ann,12,0,98,86
1746557180922,MMW 15,A01,886414,Chang; Edmond Yi-Teh,0,12,28,28
1746557180922,MMW 15,A02,886415,Chang; Edmond Yi-Teh,0,8,28,28
1746557180922,MMW 15,A03,886416,Chang; Edmond Yi-Teh,0,8,28,28
1746557180922,MMW 15,A04,886417,Chang; Edmond Yi-Teh,0,8,28,28
1746557180922,MMW 15,B01,886419,Chang; Edmond Yi-Teh,0,7,28,28
1746557180922,MMW 15,B02,886420,Chang; Edmond Yi-Teh,0,8,28,28
1746557180922,MMW 15,B03,886421,Chang; Edmond Yi-Teh,0,7,28,28
1746557180922,MMW 15,B04,886422,Chang; Edmond Yi-Teh,0,8,28,28
1746557180922,MMW 15,C01,886424,Staff,0,9,28,28
1746557180922,MMW 15,C02,886425,Staff,0,8,28,28
1746557180922,MMW 15,C03,886426,Staff,0,8,28,28
1746557180922,MMW 15,C04,886427,Staff,0,8,28,28
1746557180922,MMW 15,C05,958038,Staff,0,7,28,28
1746557180922,MMW 15,C06,958039,Staff,0,8,28,28
1746557181947,MMW 15GS,A00,906910,Patterson; Patrick H.,4,0,28,24
1746557182975,MMW 122R,A01,886429,Rahimi; Babak,0,13,28,28
1746557182975,MMW 122R,A02,886430,Rahimi; Babak,0,12,28,28
1746557182975,MMW 122R,A03,958040,Rahimi; Babak,0,11,28,28
1746557184008,MUS 1A,A01,890937,Staff,2,0,25,23
1746557184008,MUS 1A,A02,891035,Staff,6,0,25,19
1746557184008,MUS 1A,C01,958912,Staff,24,0,25,1
1746557184008,MUS 1A,C02,958913,Staff,25,0,25,0
1746557186059,MUS 2AK,A00,957092,Ohnishi; Takae,15,0,15,0
1746557187083,MUS 4,A01,891044,Staff,2,0,25,23
1746557187083,MUS 4,A02,891045,Staff,23,0,25,2
1746557187083,MUS 4,B01,891048,Staff,17,0,25,8
1746557187083,MUS 4,B02,891050,Staff,25,0,25,0
1746557188113,MUS 5,A01,957506,Dubnov; Shlomo,0,0,25,25
1746557188113,MUS 5,A02,957622,Dubnov; Shlomo,13,0,25,12
1746557188113,MUS 5,A03,957623,Dubnov; Shlomo,20,0,25,5
1746557189140,MUS 6,A01,891053,Freitas Caetano; Marcelo,24,0,25,1
1746557189140,MUS 6,A02,891054,Freitas Caetano; Marcelo,23,0,25,2
1746557190168,MUS 7,A01,891081,Staff,0,0,25,25
1746557190168,MUS 7,A02,891082,Staff,4,0,25,21
1746557191196,MUS 8GS,A00,891118,Borgo; David Garcia,0,0,25,25
1746557192222,MUS 11,A01,891140,Staff,10,0,25,15
1746557192222,MUS 11,A02,891141,Staff,22,0,25,3
1746557193249,MUS 13,A01,891143,Staff,8,0,25,17
1746557193249,MUS 13,A02,891144,Staff,24,0,25,1
1746557194271,MUS 15,A01,891146,Staff,9,0,25,16
1746557194271,MUS 15,A02,891148,Staff,21,0,25,4
1746557194271,MUS 15,B01,891150,Staff,18,0,25,7
1746557194271,MUS 15,B02,891151,Staff,25,0,25,0
1746557195296,MUS 20,A01,891153,Staff,5,0,20,15
1746557195296,MUS 20,A02,891155,Staff,14,0,20,6
1746557196324,MUS 80,A00,891156,Staff,19,0,25,6
1746557196324,MUS 80,B00,891157,Staff,23,0,25,2
1746557197348,MUS 130,A00,891158,Ohnishi; Takae,35,0,35,0
1746557198374,MUS 150GS,A01,891160,Borgo; David Garcia,0,0,25,25
1746557199399,MUS 170,A01,891162,Freitas Caetano; Marcelo,20,0,25,5
1746557199399,MUS 170,A02,891164,Freitas Caetano; Marcelo,21,0,25,4
1746557200424,NANO 11,A00,886220,Vazquez Mena; Oscar,13,0,15,2
1746557201450,NANO 15,A01,886222,Drews; Aaron,4,0,7,3
1746557202475,NANO 104,A00,886224,Sirbuly; Donald,18,0,25,7
1746557203500,PH 40,A00,886528,Staff,23,0,40,17
1746557204524,PH 45,A01,886799,Staff,35,0,40,5
1746557205549,PH 110,A00,886802,Staff,0,7,40,40
1746557206577,PH 172,A00,906716,Staff,19,0,35,16
1746557207603,PH 191,A00,886803,Staff,6,0,40,34
1746557208628,PHIL 1,A00,889500,Staff,20,0,30,10
1746557209653,PHIL 10,A01,889549,Grush; Rick Scott,15,0,22,7
1746557209653,PHIL 10,A02,889551,Grush; Rick Scott,22,0,22,0
1746557210679,PHIL 28,A01,889559,Lamey; Andy M.,0,1,31,31
1746557210679,PHIL 28,A02,889561,Lamey; Andy M.,0,1,30,30
1746557210679,PHIL 28,A03,889572,Lamey; Andy M.,0,1,30,30
1746557211705,PHIL 35,A00,907839,Staff,13,0,15,2
1746557212730,PHIL 60,A00,889574,Staff,74,0,90,16
1746557213754,PHIL 101,A00,958004,Staff,12,0,15,3
1746557215812,PHIL 136,A00,889582,Fulkerson; Matthew Todd,26,0,45,19
1746557216837,PHIL 163,A01,889601,Staff,21,0,30,9
1746557216837,PHIL 163,B01,889606,Brandt; Reuven A,0,3,0,0
1746557217862,PHIL 164,A00,889610,Staff,16,0,30,14
1746557218885,PHIL 165,A00,889613,Staff,23,0,30,7
1746557219911,PHYS 1A,A00,886431,Staff,26,0,70,44
1746557220937,PHYS 1AL,001,886432,Tsai; Philbert S,0,2,30,30
1746557220937,PHYS 1AL,002,886436,Tsai; Philbert S,11,0,30,19
1746557221963,PHYS 1B,A00,886439,Staff,185,0,240,55
1746557222989,PHYS 1BL,001,886441,Tsai; Philbert S,0,4,30,30
1746557222989,PHYS 1BL,002,886444,Tsai; Philbert S,2,0,30,28
1746557224014,PHYS 1C,A00,896092,Arnold; Kam S,78,0,146,68
1746557225041,PHYS 1CL,001,886448,Tsai; Philbert S,0,0,30,30
1746557225041,PHYS 1CL,002,886449,Tsai; Philbert S,0,0,30,30
1746557225041,PHYS 1CL,003,886450,Tsai; Philbert S,16,0,30,14
1746557225041,PHYS 1CL,004,886451,Tsai; Philbert S,15,0,30,15
1746557226068,PHYS 2B,A01,886457,Staff,68,0,115,47
1746557227094,PHYS 2C,A01,886460,Shotwell; Brian,0,9,65,65
1746557228122,PHYS 2CL,A01,886467,Staff,0,4,28,28
1746557228122,PHYS 2CL,A02,886468,Staff,0,3,28,28
1746557229148,PHYS 2D,A01,886470,Staff,10,0,50,40
1746557230173,PHYS 4B,A01,886475,Grinstein; Benjamin,22,0,40,18
1746557231199,POLI 5,A00,891173,Desposato; Scott,7,0,25,18
1746557232262,POLI 5D,A01,891175,Staff,5,0,5,0
1746557232262,POLI 5D,B01,891178,Staff,5,0,5,0
1746557233333,POLI 11,A00,891179,Ferree; Karen E,2,0,35,33
1746557234361,POLI 12,A00,891180,Staff,16,0,30,14
1746557235388,POLI 27,A01,891182,Staff,12,0,75,63
1746557236413,POLI 30,A00,891183,Staff,8,0,50,42
1746557237439,POLI 100B,A00,891244,Staff,5,1,35,30
1746557238464,POLI 100I,A00,891247,Staff,7,0,30,23
1746557239487,POLI 104J,A00,891248,Nichter; Maysa,14,0,30,16
1746557240512,POLI 104U,A00,891250,Nichter; Maysa,2,0,30,28
1746557242563,POLI 110B,A00,891255,Wiens; David,20,0,25,5
1746557243591,POLI 112A,A00,891256,Wiens; David,6,0,25,19
1746557244616,POLI 114BR,A00,891261,Staff,19,0,30,11
1746557245647,POLI 117R,A00,891262,Forman; Fonna,0,6,50,50
1746557246673,POLI 118,A00,891264,Ingham; Sean,17,0,25,8
1746557247698,POLI 124A,A00,891265,Staff,18,0,20,2
1746557248723,POLI 125D,A00,891266,Nichter; Simeon C,2,0,25,23
1746557249748,POLI 126,A00,891268,Nichter; Simeon C,7,0,25,18
1746557250772,POLI 126AA,A00,891272,Staff,17,0,25,8
1746557251796,POLI 130AA,A00,891273,Staff,15,0,20,5
1746557252821,POLI 134AA,A00,891274,Staff,4,0,20,16
1746557254872,POLI 138,A00,891278,Staff,21,0,25,4
1746557255899,POLI 142K,A00,891280,Staff,11,0,25,14
1746557256926,POLI 142M,A00,891281,Gartzke; Erik,17,0,30,13
1746557257953,POLI 142P,A00,891284,Staff,20,0,30,10
1746557258980,POLI 143,A00,891285,Gartzke; Erik,12,0,30,18
1746557260009,POLI 153,A00,891286,Staff,19,0,20,1
1746557262061,POLI 175,A00,891290,Staff,15,0,20,5
1746557263086,PSYC 1,A00,890674,Steiner; Eric Tomas,0,11,45,45
1746557264111,PSYC 2,A00,890676,Albright; Thomas D,21,0,35,14
1746557265147,PSYC 3,A00,890679,Staff,17,0,20,3
1746557266176,PSYC 6,A00,959858,Staff,20,0,20,0
1746557267201,PSYC 60,A01,890684,Rickard; Timothy C.,0,5,45,45
1746557268230,PSYC 70,A01,890689,Geller; Emma Harlan,7,0,30,23
1746557269254,PSYC 71,A01,959860,Staff,21,0,25,4
1746557270286,PSYC 100,A00,890690,Lacefield; Katharine I,0,50,180,180
1746557271311,PSYC 102,A00,890695,Staff,18,0,40,22
1746557272335,PSYC 105,A00,890699,Geller; Emma Harlan,70,0,100,30
1746557273359,PSYC 106,A00,890701,Gorman; Michael R.,6,0,30,24
1746557274385,PSYC 108,A00,890704,Adrian; Julia Anna,0,28,50,50
1746557275409,PSYC 118,A01,890712,Staff,11,0,30,19
1746557276433,PSYC 124,A00,890716,Chapman; Eddie Nathaniel,25,0,60,35
1746557277461,PSYC 131,A00,890717,Anagnostaras; Stephan,0,7,80,80
1746557278490,PSYC 137,A00,890719,Winkielman; Piotr,0,11,30,30
1746557279519,PSYC 144,A00,890721,Adrian; Julia Anna,0,9,45,45
1746557280543,PSYC 162,A00,890805,Staff,2,0,75,73
1746557281570,PSYC 169,A00,890810,Staff,0,14,30,30
1746557282595,PSYC 172,A00,890814,Gorman; Michael R.,9,0,30,21
1746557283622,PSYC 181,A00,890818,Anagnostaras; Stephan,9,0,200,191
1746557284651,PSYC 184,A00,959861,Staff,170,0,175,5
1746557285678,PSYC 189,A00,890823,Staff,0,1,30,30
1746557286708,PSYC 191,A00,890884,Rickard; Timothy C.,0,11,35,35
1746557287735,PSYC 193,A00,890913,Staff,19,0,30,11
1746557287735,PSYC 193,B00,890914,Chapman; Eddie Nathaniel,24,0,30,6
1746557288761,PSYC 193L,A01,890918,Lowe; Angela Beth,20,0,30,10
1746557288761,PSYC 193L,B01,890921,Hurwitz; Ethan Scott,20,0,30,10
1746557288761,PSYC 193L,C01,890928,Staff,30,0,30,0
1746557289786,RELI 149,A00,886806,Rahimi; Babak,23,0,40,17
1746557290868,SE 9,A01,886814,Staff,7,0,20,13
1746557291892,SE 101B,A01,886816,Chadha; Mayank,4,0,35,31
1746557292922,SE 110B,A00,886818,Zhu; Qiang,4,0,75,71
1746557293948,SE 125,A01,886830,Staff,10,0,30,20
1746557294973,SE 130B,A01,886835,Staff,14,0,40,26
1746557295999,SE 131A,A01,886838,Krysl; Petr,34,0,55,21
1746557297023,SE 154,A00,886840,Staff,29,0,50,21
1746557298048,SE 164GS,A01,886849,Staff,6,0,20,14
1746557299074,SE 167GS,A01,886853,Staff,6,0,20,14
1746557300099,SIO 25,A01,890107,Staff,19,0,30,11
1746557301124,SIO 45,A00,890109,Cook; Geoffrey W,117,0,200,83
1746557302190,SIO 109R,A00,890110,Forman; Fonna,0,16,20,20
1746557303218,SIO 187,A01,890114,Kacev; David,15,0,40,25
1746557304246,SOCI 1,A01,890431,Thorpe; Charles Robert,15,0,30,15
1746557304246,SOCI 1,A02,890518,Thorpe; Charles Robert,30,0,30,0
1746557305271,SOCI 2,A01,957978,Staff,25,0,25,0
1746557305271,SOCI 2,A02,957979,Staff,23,0,25,2
1746557306296,SOCI 20,A01,890523,Calderon-Zaks; Michael Aar,23,0,30,7
1746557306296,SOCI 20,A02,890526,Calderon-Zaks; Michael Aar,29,0,30,1
1746557307322,SOCI 30,A01,890533,Pardo Guerra; Juan Pablo,37,0,40,3
1746557308347,SOCI 40,A01,890535,Staff,27,0,45,18
1746557309372,SOCI 104Q,A00,890559,Staff,18,0,30,12
1746557310397,SOCI 106,A00,890560,Arnal; Maud Marie Leonie,20,0,30,10
1746557311425,SOCI 110,A00,890567,Holkenbrink-Monk; Charlene,19,0,30,11
1746557312453,SOCI 112,A00,890568,Victoria Torres; Pablo,2,0,55,53
1746557313479,SOCI 115,A00,890597,Arnal; Maud Marie Leonie,28,0,45,17
1746557315531,SOCI 121,A00,890604,Pardo Guerra; Juan Pablo,38,0,45,7
1746557316561,SOCI 126,A01,890608,Staff,8,0,10,2
1746557317590,SOCI 127,A00,890609,Staff,18,0,30,12
1746557318618,SOCI 131,A00,890610,Thorpe; Charles Robert,37,0,45,8
1746557319642,SOCI 135,A00,890615,Payne; Christine Anna,13,0,45,32
1746557320710,SOCI 139,A00,890620,Staff,38,0,45,7
1746557321737,SOCI 148E,A00,890622,Calderon-Zaks; Michael Aar,36,0,45,9
1746557322788,SOCI 150,A00,890623,Kohler; Kristopher M.,31,0,45,14
1746557323813,SOCI 157,A00,890625,Jules-Rosette; Bennetta W.,18,0,20,2
1746557324839,SOCI 160,A00,890627,Payne; Christine Anna,21,0,45,24
1746557325865,SYN 1,A00,886855,Fish; Gwendolyn Anne,0,0,0,0
1746557325865,SYN 1,B00,906086,Fish; Gwendolyn Anne,0,1,0,2
1746557326892,SYN 2R,A00,886860,Staff,0,17,15,15
1746557326892,SYN 2R,B00,906106,Atkinson; Arthur Laird,0,16,15,15
1746557327926,SYN 100,A01,886866,Browne; Emily,0,28,20,20
1746557327926,SYN 100,B01,906128,Rock; Martin,0,5,20,20
1746557327926,SYN 100,C01,906140,Deavenport; James Cary,0,3,20,20
1746557327926,SYN 100,D01,907816,Deavenport; James Cary,0,5,20,20
1746557328951,TDAC 1,A00,890286,Walsh; Kim C.,8,0,20,12
1746557329979,TDAC 101,A00,890296,Basso; Beatrice,16,0,20,4
1746557331007,TDDE 131,A00,890297,Staff,47,0,50,3
1746557332036,TDDM 1,A00,890287,Weinberg; Sadie,25,0,30,5
1746557333060,TDGE 11,A00,890288,Fulton; Julia,137,0,200,63
1746557333060,TDGE 11,B00,890289,Castro; Robert Jess,184,0,200,16
1746557334088,TDGE 25,B00,957359,Walsh; Kim C.,3,0,20,17
1746557335117,TDGE 40,A01,890292,Power; Jade Yukana,27,0,30,3
1746557336143,TDGE 124,A00,890298,Havis; Allan,0,1,50,50
1746557337173,TDGE 131R,A00,890299,Burelle; Julie Sara Veronique,15,0,42,27
1746557338202,TDHT 101,A00,890300,Staff,10,0,20,10
1746557339229,TDHT 109,A01,890302,Anderson; Mysia Anyse,31,0,40,9
1746557340257,TDMV 1,A00,890293,Arcidiacono; Kristin,18,0,30,12
1746557341286,TDMV 2,A00,890294,Weinberg; Sadie,23,0,30,7
1746557342314,TDMV 3,A00,957878,Arcidiacono; Kristin,28,0,30,2
1746557344368,TDMV 138,A00,890304,Jun; Grace Shin Hae,25,0,40,15
1746557345392,TDMV 140,A00,890305,Corrales; Joseph Bernales,25,0,30,5
1746557346417,TDMV 142,A00,890307,Caligagan; Tony,32,0,40,8
1746557347441,TDMV 144,A00,890308,Camaya; Michelle Ann,25,0,30,5
1746557348469,TDPW 1,A00,890295,Stein; Deborah Isobel,3,0,20,17
1746557349497,USP 2,A01,890272,Lerner; Amy M,6,0,20,14
1746557350521,USP 3,A01,890274,Staff,12,0,30,18
1746557351549,USP 15,A01,890276,Sun; Feiyang,16,0,30,14
1746557352575,USP 25,A00,890277,Shenkman; Michael Thomas,19,0,25,6
1746557353603,USP 138,A00,890278,Staff,13,0,25,12
1746557354628,USP 143,A00,890279,Staff,21,0,70,49
1746557355655,USP 144,A00,890280,Chowdhury; Muhammed Zohir,15,0,30,15
1746557356679,USP 150,A00,890281,Boomhower; Matthew Charles,4,0,30,26
1746557357703,USP 151,A00,890282,Staff,16,0,20,4
1746557358731,USP 162,A00,890283,Andrews; Abigail Leslie,16,0,20,4
1746557359761,USP 168,A00,920477,Kwak; Nancy,1,0,5,4
1746557360786,USP 181,A00,890284,Staff,3,0,20,17
1746557361813,USP 191A,A00,890285,Staff,12,0,20,8
1746557362838,VIS 101,A00,886512,Staff,26,0,75,49
1746557363863,VIS 103,A00,886513,Cruz; Edwin Teddy,61,0,75,14
1746557364887,VIS 108,A00,886514,Staff,3,0,15,12
1746557365913,VIS 127P,A00,886515,Shen; Kuiyi,80,0,146,66
1746557366939,VIS 149,A00,886516,Yoldas; Pinar,0,0,15,15
1746557367968,VIS 164,A00,886526,Erdmann; Dean,19,0,22,3
1746557368996,VIS 194S,A00,886527,Staff,61,0,75,14
1746557370026,WCWP 10A,C00,886484,Martiniuk; Jill,12,0,15,3
1746557371050,WCWP 10B,A00,886490,Uriarte; Emma,0,0,15,15
1746557371050,WCWP 10B,B00,886491,Dhir; Simrita,10,0,15,5
1746557371050,WCWP 10B,C00,886492,Ornelas; Tricia,0,0,15,15
1746557372114,WCWP 100,A00,886494,Young; Mark T,0,6,15,15
1746557374259,AAS 10,A01,886199,Childs; Dennis R.,0,3,0,0
1746557375287,ANAR 104,A01,886940,Shtienberg; Gilad,27,0,30,3
1746557376313,ANAR 120,A00,886953,Staff,12,0,20,8
1746557377338,ANBI 148,A01,886955,Wilder; Linnea Lorene,30,0,40,10
1746557379388,ANSC 122,A00,886957,Staff,25,0,30,5
1746557380411,ANSC 150,A00,886958,Sloane; Julia Kathryn,2,0,15,13
1746557381435,ANSC 156,A00,886959,Jenkins; Janis A.,0,1,15,15
1746557382462,ANSC 180,A00,886960,Staff,11,0,17,6
1746557383489,ANSC 188,A00,886961,Jassal; Aftab,9,0,25,16
1746557384514,ANSC 190,A00,886962,Jassal; Aftab,14,0,25,11
1746557385539,ANSC 191,A00,886963,Staff,18,0,20,2
1746557386563,ANTH 3,A01,891689,Staff,17,0,20,3
1746557387589,ANTH 5,A00,886933,Semendeferi; Ekaterini,16,0,20,4
1746557388613,ANTH 10,A00,886934,Staff,0,12,30,30
1746557389640,ANTH 21,A01,886936,Staff,40,0,60,20
1746557390668,ANTH 23,A01,886938,Staff,92,0,100,8
1746557391693,ANTH 105,A00,886964,Stewart; Alexander B,84,0,100,16
1746557392720,ANTH 108,A00,886965,Pedersen; David,9,0,20,11
1746557393745,AWP 10,001,886147,Staff,0,0,0,0
1746557393745,AWP 10,002,886148,Staff,0,0,0,0
1746557393745,AWP 10,003,886149,Staff,0,0,0,0
1746557393745,AWP 10,004,886150,Staff,0,0,0,0
1746557393745,AWP 10,005,886151,Staff,0,0,0,0
1746557393745,AWP 10,006,886152,Staff,0,0,0,0
1746557393745,AWP 10,007,886153,Staff,0,0,0,0
1746557393745,AWP 10,008,886154,Staff,0,0,0,0
1746557393745,AWP 10,009,886155,Staff,0,0,0,0
1746557393745,AWP 10,010,886156,Staff,0,0,0,0
1746557393745,AWP 10,011,886158,Staff,0,0,0,0
1746557393745,AWP 10,012,886160,Staff,0,0,0,0
1746557393745,AWP 10,013,886161,Staff,0,0,0,0
1746557393745,AWP 10,014,886162,Staff,0,0,0,0
1746557393745,AWP 10,015,886163,Staff,0,0,0,0
1746557393745,AWP 10,016,886164,Staff,0,0,0,0
1746557393745,AWP 10,017,886165,Staff,0,0,0,0
1746557393745,AWP 10,018,886166,Staff,0,0,0,0
1746557393745,AWP 10,019,886168,Staff,0,0,0,0
1746557393745,AWP 10,020,886170,Staff,0,0,0,0
1746557393745,AWP 10,021,886172,Staff,0,0,0,0
1746557394775,AWP 10R,001,886173,Staff,0,1,0,0
1746557394775,AWP 10R,002,886174,Staff,0,1,0,0
1746557394775,AWP 10R,003,886175,Staff,0,0,0,0
1746557394775,AWP 10R,004,886176,Staff,0,0,0,0
1746557394775,AWP 10R,005,886177,Staff,0,0,0,0
1746557394775,AWP 10R,006,886178,Staff,0,0,0,0
1746557394775,AWP 10R,007,886179,Staff,0,0,0,0
1746557394775,AWP 10R,008,886181,Staff,0,0,0,0
1746557394775,AWP 10R,009,886182,Staff,0,0,0,0
1746557394775,AWP 10R,010,886183,Staff,0,0,0,0
1746557394775,AWP 10R,011,886184,Staff,0,0,0,0
1746557394775,AWP 10R,012,886185,Staff,0,0,0,0
1746557394775,AWP 10R,013,886186,Staff,0,0,0,0
1746557394775,AWP 10R,014,886187,Staff,0,0,0,0
1746557394775,AWP 10R,015,886188,Staff,0,0,0,0
1746557394775,AWP 10R,016,886189,Staff,0,0,0,0
1746557394775,AWP 10R,017,960532,Staff,0,0,0,0
1746557394775,AWP 10R,018,960533,Staff,0,0,0,0
1746557394775,AWP 10R,019,960534,Staff,0,0,0,0
1746557394775,AWP 10R,020,960538,Staff,0,0,0,0
1746557394775,AWP 10R,021,960540,Staff,0,0,0,0
1746557394775,AWP 10R,022,960541,Staff,0,0,0,0
1746557394775,AWP 10R,023,960542,Staff,0,0,0,0
1746557394775,AWP 10R,024,960544,Staff,0,0,0,0
1746557394775,AWP 10R,025,960545,Staff,0,0,0,0
1746557394775,AWP 10R,026,960548,Staff,0,0,0,0
1746557395799,AWP 102R,A00,886190,Staff,0,0,0,0
1746557395799,AWP 102R,B00,886191,Staff,0,0,0,0
1746557396825,BENG 100,A01,886193,Staff,17,0,30,13
1746557397850,BENG 122A,A01,886195,Hasty; Jeff M,13,0,30,17
1746557398874,BENG 166A,A00,886196,Sah; Robert Lie-Yuan,0,2,30,30
1746557399902,BENG 190,A00,958050,Khojah; Reem I,22,0,25,3
1746557400930,BIBC 102,A01,894320,Staff,0,0,46,46
1746557400930,BIBC 102,A02,894321,Staff,0,0,46,46
1746557400930,BIBC 102,A03,894344,Staff,7,0,46,39
1746557400930,BIBC 102,A04,894345,Staff,26,0,47,21
1746557401960,BICD 100R,A01,894365,Smith; Laurie,0,4,58,58
1746557401960,BICD 100R,A02,894366,Smith; Laurie,0,5,58,58
1746557401960,BICD 100R,A03,894367,Smith; Laurie,1,0,59,58
1746557401960,BICD 100R,A04,959869,Smith; Laurie,41,0,59,18
1746557402985,BICD 136,A01,894383,Gustafson-Brown; Cindy,14,0,50,36
1746557404009,BIEB 102,A01,894494,Butler; Shannon Rhey,51,0,130,79
1746557406066,BIEB 150,A01,894617,Wills; Christopher,3,0,20,17
1746557406066,BIEB 150,A02,894631,Wills; Christopher,3,0,20,17
1746557406066,BIEB 150,A03,894937,Wills; Christopher,3,0,20,17
1746557406066,BIEB 150,A04,894946,Wills; Christopher,5,0,20,15
1746557407092,BIEB 194,A00,906141,Kurle; Carolyn M.,6,0,20,14
1746557408119,BILD 1,A01,894154,Staff,3,0,19,16
1746557408119,BILD 1,A02,894155,Staff,14,0,19,5
1746557408119,BILD 1,A03,894160,Staff,13,0,19,6
1746557408119,BILD 1,A04,894161,Staff,15,0,18,3
1746557409144,BILD 2,A01,894168,Staff,0,0,50,50
1746557409144,BILD 2,A02,894169,Staff,0,0,50,50
1746557409144,BILD 2,A03,894179,Staff,0,0,50,50
1746557409144,BILD 2,A04,894203,Staff,27,0,50,23
1746557410169,BILD 3,A01,894213,Staff,22,0,31,9
1746557410169,BILD 3,A02,894214,Staff,26,0,31,5
1746557410169,BILD 3,A03,894235,Staff,28,0,31,3
1746557410169,BILD 3,A04,894236,Staff,28,0,32,4
1746557411199,BILD 4,A01,894253,Reuther; Keefe,5,0,24,19
1746557411199,BILD 4,A02,894258,Reuther; Keefe,16,0,24,8
1746557412225,BILD 5,A01,894276,Reuther; Keefe,35,0,50,15
1746557412225,BILD 5,A02,894277,Reuther; Keefe,45,0,50,5
1746557412225,BILD 5,A03,894290,Reuther; Keefe,44,0,50,6
1746557412225,BILD 5,A04,894291,Reuther; Keefe,48,0,50,2
1746557413254,BILD 24,A01,894297,Pirino; Giorgia,40,0,60,20
1746557414280,BIMM 100,B01,958915,Staff,71,0,100,29
1746557415307,BIMM 101,A01,895017,McDonnell; Lisa Marie,0,5,24,24
1746557415307,BIMM 101,A02,895018,McDonnell; Lisa Marie,0,5,24,24
1746557415307,BIMM 101,B01,895020,McDonnell; Lisa Marie,0,6,24,24
1746557415307,BIMM 101,B02,895021,McDonnell; Lisa Marie,0,4,24,24
1746557416397,BIMM 110,A01,895023,Staff,1,0,25,24
1746557416397,BIMM 110,A02,895024,Staff,9,0,25,16
1746557416397,BIMM 110,A03,895025,Staff,18,0,25,7
1746557416397,BIMM 110,A04,895031,Staff,20,0,25,5
1746557417427,BIMM 120,A01,895114,Gustafson-Brown; Cindy,14,0,28,14
1746557417427,BIMM 120,A02,895126,Gustafson-Brown; Cindy,21,0,27,6
1746557418457,BIPN 100,A01,895130,Yang; Mingyu,1,0,38,37
1746557418457,BIPN 100,A02,895131,Yang; Mingyu,32,0,38,6
1746557418457,BIPN 100,A03,895132,Yang; Mingyu,32,0,38,6
1746557418457,BIPN 100,A04,895133,Yang; Mingyu,27,0,36,9
1746557419482,BIPN 120,A01,895135,Cooke; James Edward,0,3,13,13
1746557419482,BIPN 120,A02,895136,Cooke; James Edward,0,1,13,13
1746557419482,BIPN 120,A03,895137,Cooke; James Edward,0,3,13,13
1746557419482,BIPN 120,A04,895156,Cooke; James Edward,0,2,11,11
1746557420512,BIPN 134,A01,895235,Cooke; James Edward,0,2,25,25
1746557420512,BIPN 134,A02,895237,Cooke; James Edward,0,0,25,25
1746557420512,BIPN 134,A03,895240,Cooke; James Edward,3,0,25,22
1746557420512,BIPN 134,A04,895270,Cooke; James Edward,20,0,25,5
1746557421537,BIPN 189,A00,892103,Staff,0,13,14,14
1746557423591,BISP 194,A00,958008,Staff,0,2,0,0
1746557424618,CAT 124,A01,922009,Staff,0,5,20,20
1746557425648,CAT 125R,A00,886390,Morales; Celeste Georgianna,0,2,20,20
1746557425648,CAT 125R,B00,886391,Irwin; Matthew Joseph,0,3,20,20
1746557425648,CAT 125R,C00,886392,Smith; Lauryn Alissa,0,2,20,20
1746557425648,CAT 125R,D00,886393,Vanderschuit; Maya Alysia,0,2,20,20
1746557425648,CAT 125R,E00,886394,Marchisotto; Jennifer Anne,0,4,20,20
1746557426674,CENG 15,A01,886218,Drews; Aaron,3,0,8,5
1746557427703,CENG 113,A00,886219,Opatkiewicz; Justin Paul,15,0,25,10
1746557428726,CGS 101,A00,887044,Staff,7,0,20,13
1746557429754,CGS 105,A01,887046,Staff,14,0,25,11
1746557430782,CGS 112,A00,887047,Cuong; Marisol,12,0,15,3
1746557431807,CGS 113,A00,887048,Staff,23,0,30,7
1746557432831,CGS 120,A00,887049,Staff,10,0,17,7
1746557433863,CHEM 6A,A01,886336,Lam; Tin Yiu,38,0,50,12
1746557433863,CHEM 6A,A02,886338,Lam; Tin Yiu,37,0,50,13
1746557434891,CHEM 6B,A01,886341,Hopkins; Patrycja Anna,16,0,50,34
1746557434891,CHEM 6B,A02,886343,Hopkins; Patrycja Anna,42,0,50,8
1746557435915,CHEM 6C,A01,886346,Albizati; Kim F.,0,2,50,50
1746557435915,CHEM 6C,A02,886348,Albizati; Kim F.,23,0,50,27
1746557436944,CHEM 40A,A01,886352,Klosterman; Jeremy K,65,0,100,35
1746557437968,CHEM 40B,A01,886356,Klosterman; Jeremy K,0,23,100,100
1746557438996,CHEM 41B,A01,886360,Theodorakis; Emmanuel,25,0,50,25
1746557438996,CHEM 41B,A02,886362,Theodorakis; Emmanuel,47,0,50,3
1746557440024,CHIN 165A,A00,886382,Xu; Li,18,0,20,2
1746557441049,CLAS 120,A00,886387,Myerston Santana; Jacobo,33,0,40,7
1746557442077,COGS 9,A01,886967,Shannon; Kyle Michael,42,0,60,18
1746557443102,COGS 11,A01,886969,Staff,11,0,30,19
1746557444129,COGS 14A,A01,886971,Staff,6,0,60,54
1746557445154,COGS 14B,A01,886973,Hoffman; Drew Ellen,4,0,60,56
1746557446182,COGS 18,A01,886975,Morgan; Eric,35,0,60,25
1746557447211,COGS 20,A01,886977,Staff,4,0,8,4
1746557447211,COGS 20,A02,886978,Staff,5,0,7,2
1746557448238,COGS 100,A01,907783,Staff,0,2,30,30
1746557449262,COGS 101B,A01,886980,Staff,0,3,48,48
1746557450325,COGS 101C,A01,886982,Delgado; Tania,0,5,44,44
1746557451353,COGS 102A,A01,886984,Johnson; Christine M.,4,0,30,26
1746557452380,COGS 118B,A01,886986,Staff,0,3,88,88
1746557453404,COGS 150,A01,886988,Bergen; Benjamin,23,0,50,27
1746557454433,COGS 153,A00,886989,Delgado; Tania,0,2,41,41
1746557455458,COGS 186,A01,886991,Staff,0,0,32,32
1746557456485,COGS 187A,A01,886993,Boyle; Mary E. T.,7,0,30,23
1746557457510,COGS 189,A00,886994,Staff,0,1,30,30
1746557458535,COMM 10,A01,886996,Staff,0,0,20,21
1746557458535,COMM 10,A02,886997,Staff,12,0,20,8
1746557458535,COMM 10,A03,959845,Staff,19,0,20,1
1746557459560,COMM 20,A01,886999,Leuning; Grant Maurstad,24,0,40,16
1746557461614,COMM 100A,A01,887002,Staff,0,0,20,25
1746557461614,COMM 100A,A02,887003,Staff,7,0,20,13
1746557462641,COMM 100B,A01,887005,Staff,0,8,20,24
1746557463668,COMM 106D,A00,887006,Staff,14,0,40,26
1746557464693,COMM 110G,A00,887007,Whitworth-Smith; Andrew C,12,0,40,28
1746557465719,COMM 111B,A00,887008,Staff,31,0,40,9
1746557466746,COMM 113T,A00,887009,Abuelhiga; Soraya Jill,28,0,40,12
1746557466746,COMM 113T,B00,906733,Staff,40,0,40,0
1746557467771,COMM 145,A00,887010,Staff,12,0,40,28
1746557468799,COMM 146,A00,887054,Staff,31,0,40,9
1746557469827,COMM 190,A00,887012,Staff,8,0,23,15
1746557470856,CSE 8A,A50,887015,Cao; Yingjun,57,0,85,28
1746557471884,CSE 11,A01,887017,Cao; Yingjun,12,0,70,58
1746557472911,CSE 20,A01,887019,Staff,30,0,50,20
1746557473937,CSE 21,A01,887021,Staff,78,0,100,22
1746557473937,CSE 21,B01,892583,Braun; Oliver,45,0,50,5
1746557474972,CSE 30,A01,887025,Eldon; John,143,0,200,57
1746557475999,CSE 100,A01,887027,Staff,26,0,50,24
1746557475999,CSE 100,A02,887028,Staff,42,0,50,8
1746557477027,CSE 101,A01,887030,Braun; Oliver,74,0,100,26
1746557477027,CSE 101,B01,887032,Jones; Miles E,0,3,50,50
1746557477027,CSE 101,B02,887033,Jones; Miles E,0,1,50,50
1746557478053,CSE 105,A01,908084,Jones; Miles E,32,0,50,18
1746557478053,CSE 105,A02,908087,Jones; Miles E,32,0,50,18
1746557479082,CSE 135,A01,887035,Powell; Thomas Allan,0,4,50,50
1746557480110,CSE 142,A01,887037,Staff,8,0,60,52
1746557481137,CSE 142L,A01,887039,Staff,34,0,60,26
1746557482161,CSE 151A,A01,887041,Solares; Edwin A,47,0,100,53
1746557483186,CSE 175,A01,887043,Kumar; Rakesh,30,0,30,0
1746557484212,CSS 1,A01,886389,Staff,0,1,40,40
1746557485236,DSC 30,A01,908097,Liao; Soohyun Nam,47,0,75,28
1746557486266,DSC 40A,A01,908099,Shannon; Kyle Michael,30,0,50,20
1746557487339,DSC 40B,A01,908112,Staff,16,0,50,34
1746557488365,DSC 80,A01,908116,Staff,19,0,60,41
1746557489390,DSC 197,001,956863,Eldridge; Justin Matthew,9999,0,9999,0
1746557490414,ECE 5,A01,886400,Morris; Karcher William,2,0,6,4
1746557490414,ECE 5,A02,886401,Morris; Karcher William,3,0,6,3
1746557491438,ECE 148,A01,886403,Silberman; Jack,0,14,14,14
1746557492469,ECON 1,A01,887265,Crane; Meredith Helen,12,0,70,58
1746557492469,ECON 1,B01,887268,Staff,43,0,50,7
1746557493494,ECON 2,A01,887273,Crane; Meredith Helen,56,0,70,14
1746557494521,ECON 3,A01,887279,Rondina; Giacomo,32,0,70,38
1746557495548,ECON 4,A01,887282,Anderson; John Charles,0,2,10,10
1746557496577,ECON 5,A01,887285,Staff,33,0,45,12
1746557496577,ECON 5,B01,887292,Staff,41,0,45,4
1746557497602,ECON 100A,A01,887337,Newhouse; Herbert S,54,0,70,16
1746557497602,ECON 100A,B01,887349,Staff,45,0,50,5
1746557498629,ECON 100B,A01,887361,Du; Songzi,29,0,70,41
1746557499653,ECON 100C,A01,887445,Newhouse; Herbert S,59,0,70,11
1746557500682,ECON 105,A00,887488,Vespa; Emanuel Ignacio,23,0,35,12
1746557501708,ECON 109,A01,887506,Shishkin; Denis,28,0,35,7
1746557502733,ECON 110A,A01,887568,Alon; Titan Michael,0,3,35,35
1746557502733,ECON 110A,B01,907601,Alon; Titan Michael,20,0,35,15
1746557503760,ECON 110B,A01,887598,Levkoff; Steven B.,0,24,70,70
1746557504791,ECON 112,A00,887599,Rondina; Giacomo,19,0,35,16
1746557505816,ECON 120A,A01,887603,Dai; Yinlin,35,0,70,35
1746557506840,ECON 120C,A01,887608,Sun; Yixiao,0,1,35,35
1746557506840,ECON 120C,B01,887614,Sun; Yixiao,0,0,35,35
1746557507867,ECON 138,A00,887621,Bharadwaj; Prashant,0,21,20,20
1746557508893,ECON 144,A00,958007,Squires; Dale E,13,0,35,22
1746557509921,ECON 171,A01,907666,Staff,18,0,35,17
1746557510950,ECON 175,A00,887626,Wu; Pak Yeung,23,0,35,12
1746557511975,ECON 190,A00,887640,Vespa; Emanuel Ignacio,23,0,35,12
1746557513003,EDS 25,A01,888197,Staff,0,0,0,0
1746557513003,EDS 25,A02,888209,Staff,0,0,0,0
1746557513003,EDS 25,A03,888210,Staff,0,0,0,0
1746557513003,EDS 25,A04,888212,Staff,0,0,0,0
1746557513003,EDS 25,A05,888213,Staff,0,0,0,0
1746557513003,EDS 25,A06,888214,Staff,0,0,0,0
1746557513003,EDS 25,A07,888235,Staff,0,2,0,0
1746557513003,EDS 25,A08,888236,Staff,0,0,0,0
1746557513003,EDS 25,A09,888240,Staff,0,0,0,0
1746557513003,EDS 25,A10,888244,Staff,0,0,0,0
1746557513003,EDS 25,B01,888273,Staff,0,0,0,0
1746557513003,EDS 25,B02,888285,Staff,0,0,0,0
1746557513003,EDS 25,B03,888423,Staff,0,0,0,1
1746557513003,EDS 25,B04,888432,Staff,0,0,0,0
1746557513003,EDS 25,B05,888433,Staff,0,0,0,0
1746557513003,EDS 25,B06,888467,Staff,0,0,0,0
1746557513003,EDS 25,B07,888468,Staff,0,0,0,0
1746557513003,EDS 25,B08,888479,Staff,0,0,0,0
1746557513003,EDS 25,B09,888484,Staff,0,0,0,0
1746557513003,EDS 25,B10,888487,Staff,0,0,0,0
1746557514032,EDS 38,A01,907700,Choi; Bailey Miyeon,30,0,30,0
1746557515058,EDS 112,A01,888601,Chapman; Thandeka K,13,0,40,27
1746557516086,EDS 115,A00,888697,Mendez; Kathrina Mendoza,10,0,30,20
1746557517111,EDS 116,A01,888893,Staff,35,0,40,5
1746557519162,EDS 124AR,A00,889133,Staff,29,0,50,21
1746557519162,EDS 124AR,B00,907471,Simon; Elizabeth A,37,0,50,13
1746557520187,EDS 124BR,A00,889134,Simon; Elizabeth A,44,0,100,56
1746557521213,EDS 125,A00,889135,Staff,25,0,30,5
1746557522237,EDS 126,A01,889138,Staff,36,0,40,4
1746557523263,EDS 164R,A01,889142,Wishard Guerra; Alison G.,33,0,50,17
1746557524289,ENG 30,A01,886396,Staff,0,0,0,0
1746557524289,ENG 30,B01,886398,Staff,0,0,0,0
1746557525318,ENVR 102,A00,906150,Montejo; Carolina,23,0,25,2
1746557526344,ETHN 103A,A00,887236,Man; Simeon S,0,3,0,0
1746557527371,ETHN 113,A00,887239,Staff,16,0,30,14
1746557528397,ETHN 116,A00,887240,Staff,16,0,25,9
1746557529426,ETHN 117,A00,887241,Choi; Esther Min,28,0,30,2
1746557530452,ETHN 118,A00,887243,Staff,24,0,30,6
1746557531479,ETHN 127,A00,887248,Cuong; Marisol,11,0,15,4
1746557532507,ETHN 139,A00,887250,Staff,7,0,10,3
1746557533533,ETHN 142,A00,887252,Staff,10,0,30,20
1746557534558,ETHN 161,A00,887253,Browne; Errol Tsekani,24,0,30,6
1746557535584,ETHN 163FR,A00,887255,Burelle; Julie Sara Veronique,0,0,5,5
1746557536610,GLBH 20,A00,889149,Elwardani; Nile Regina,8,0,42,34
1746557538660,GLBH 111,A01,889152,Burgos; Jose L.,17,0,17,0
1746557539685,GLBH 150,A00,889181,Sloane; Julia Kathryn,0,5,15,15
1746557541736,HDS 60,A01,886406,Warstadt; Melissa Fawn,73,0,80,7
1746557542763,HIAF 111,A00,889324,Gyamfi; Bright,25,0,32,7
1746557543790,HIEA 131,A00,889328,Staff,16,0,32,16
1746557544815,HIEA 144,A00,889333,Henry; Todd A.,26,0,32,6
1746557545843,HIEA 154,A00,889336,Henry; Todd A.,24,0,32,8
1746557546869,HIEU 106,A00,889339,Staff,22,0,32,10
1746557548918,HIEU 114,A00,889340,Staff,3,0,32,29
1746557549942,HIEU 135GS,A00,889342,Patterson; Patrick H.,0,0,1,24
1746557550967,HIEU 137,A00,889343,Edington; Claire Ellen,9,0,25,16
1746557551992,HIEU 148,A00,889345,Staff,14,0,32,18
1746557553016,HIEU 154,A00,889346,Biess; Frank Peter,21,0,32,11
1746557554043,HILA 102,A00,889351,Staff,12,0,32,20
1746557555067,HILD 2A,A01,889221,Lewandoski; Julia Mavis,1,10,32,31
1746557556095,HILD 7B,A01,889225,Man; Simeon S,0,12,32,32
1746557557120,HILD 7C,A01,889288,Alvarez; Luis A,0,14,32,32
1746557558147,HILD 30,A01,889323,Staff,0,5,32,32
1746557560201,HISC 119,A00,889383,Golan; Tal,20,0,32,12
1746557561227,HIUS 103,A00,889384,Man; Simeon S,0,0,32,32
1746557562254,HIUS 117,A00,919797,Kwak; Nancy,18,0,32,14
1746557563280,HIUS 142A,A00,919788,Staff,22,0,32,10
1746557565330,HIUS 149,A00,889386,Gyamfi; Bright,27,0,32,5
1746557566354,HIUS 155,A00,889387,Alvarez; Luis A,14,0,32,18
1746557567382,HUM 3,A01,886499,Caldwell; Michael Alan,19,0,50,31
1746557568407,HUM 3GS,A00,886500,Rodriguez; Bretton Sigfred,0,0,0,28
1746557569438,HUM 3R,A01,886502,Markman; Kristina,0,36,50,50
1746557570463,HUM 4,A01,886504,Crum; Matthew Stephen,24,0,50,26
1746557570463,HUM 4,B01,886506,West; Geoffrey Scott,17,0,50,33
1746557571489,HUM 4GS,A00,886507,Staff,0,0,0,19
1746557572519,HUM 5,A01,886509,Staff,32,0,50,18
1746557573548,HUM 5R,A01,886511,Zavodny; Tatiana Sophia,0,39,50,50
1746557574572,JAPN 180,A00,886407,Staff,17,0,40,23
1746557575599,LATI 50,A01,886409,Martin-Cabrera; Luis,4,0,22,18
1746557575599,LATI 50,A02,886410,Martin-Cabrera; Luis,19,0,22,3
1746557575599,LATI 50,A03,886411,Martin-Cabrera; Luis,21,0,22,1
1746557575599,LATI 50,A04,886412,Martin-Cabrera; Luis,9,0,22,13
1746557576627,LAWS 101,A00,907664,Staff,28,0,60,32
1746557577651,LIAB 1A,A00,889388,Saab; Dima,17,0,20,3
1746557578681,LIAB 1AX,A00,889389,El Cheddadi; Youniss,17,0,20,3
1746557579706,LIFR 1C,A00,889391,Van Moer; Vinciane G,8,0,20,12
1746557580732,LIFR 1CX,A00,889392,Van Moer; Vinciane G,7,0,20,13
1746557581760,LIFR 1D,A00,889393,Van Moer; Vinciane G,7,0,20,13
1746557582788,LIFR 1DX,A00,889394,Van Moer; Vinciane G,8,0,20,12
1746557583815,LIGN 7,A00,886923,Staff,24,0,50,26
1746557584843,LIGN 17,A00,886924,Kehler; Andrew Scott,125,0,150,25
1746557585869,LTAM 110,A00,889395,Staff,15,0,30,15
1746557586895,LTAM 110GS,A00,958010,Rodriguez; Bretton Sigfred,0,0,0,28
1746557587924,LTCH 101,A00,889397,Staff,23,0,25,2
1746557588952,LTCS 130,A00,889398,Staff,23,0,25,2
1746557589978,LTEA 138,A00,889399,Staff,24,0,40,16
1746557591008,LTEN 149,A00,889400,Wesling; Megan E.,0,3,25,25
1746557592033,LTEN 169,A00,889401,Staff,20,0,25,5
1746557593061,LTEN 180,A00,889402,Staff,10,0,15,5
1746557594088,LTEN 181,A00,889403,Staff,21,0,25,4
1746557595113,LTWL 100,A00,889404,Myerston Santana; Jacobo,3,0,25,22
1746557596138,LTWL 180GS,A00,889405,Staff,0,0,20,20
1746557597167,LTWL 181,A00,889406,Staff,17,0,25,8
1746557598192,LTWL 184,A00,889475,Mukherjee; Silpa,22,0,25,3
1746557599219,LTWR 102C,A00,889486,Staff,29,0,30,1
1746557600246,LTWR 115W,A00,889491,Staff,0,2,15,15
1746557601272,MAE 8,A01,886905,Staff,0,2,0,0
1746557602301,MAE 11,A00,886906,Bandaru; Prabhakar,0,7,50,50
1746557603331,MAE 20,A00,886907,Evdokimenko; Ekaterina,43,0,70,27
1746557604355,MAE 30B,A00,886909,Ghazinejad; Maziar,26,0,45,19
1746557605384,MAE 101B,A00,886910,Saintillan; David,29,0,45,16
1746557606409,MAE 105,A00,886911,Bandaru; Prabhakar,18,0,50,32
1746557607434,MAE 107,B00,958024,Staff,8,0,50,42
1746557608461,MAE 143B,A00,886913,Bewley; Thomas R,6,0,40,34
1746557609484,MAE 148,A01,886915,Silberman; Jack,0,3,14,14
1746557610512,MAE 160,A00,886916,Evdokimenko; Ekaterina,32,0,60,28
1746557611536,MATH 3C,A01,889681,Staff,0,3,30,30
1746557611536,MATH 3C,A02,960048,Staff,25,0,30,5
1746557612559,MATH 10A,A01,889760,Staff,26,0,30,4
1746557612559,MATH 10A,A02,889783,Staff,29,0,30,1
1746557613587,MATH 10B,A01,889785,Verstraete; Jacques Allan,2,0,35,33
1746557613587,MATH 10B,A02,889795,Verstraete; Jacques Allan,4,0,35,31
1746557613587,MATH 10B,B01,889797,Verstraete; Jacques Allan,3,0,35,32
1746557613587,MATH 10B,B02,889828,Verstraete; Jacques Allan,3,0,35,32
1746557614612,MATH 10C,A01,889849,Habib; Yousaf,8,0,30,22
1746557614612,MATH 10C,A02,889852,Habib; Yousaf,14,0,30,16
1746557614612,MATH 10C,A03,889853,Habib; Yousaf,22,0,30,8
1746557614612,MATH 10C,A04,889858,Habib; Yousaf,20,0,30,10
1746557614612,MATH 10C,B01,889861,Staff,1,0,30,29
1746557614612,MATH 10C,B02,889862,Staff,24,0,30,6
1746557614612,MATH 10C,B03,889863,Staff,27,0,30,3
1746557614612,MATH 10C,B04,889967,Staff,23,0,30,7
1746557615638,MATH 18,A01,889974,Staff,7,0,30,23
1746557615638,MATH 18,A02,889977,Staff,20,0,30,10
1746557615638,MATH 18,B01,889984,Hardiman; Liam,21,0,30,9
1746557615638,MATH 18,B02,889985,Hardiman; Liam,25,0,30,5
1746557616663,MATH 20A,A01,889990,Suk; Andrew Hoon,30,0,35,5
1746557617692,MATH 20B,A01,889993,Ohm; Ko Woon,22,0,30,8
1746557617692,MATH 20B,A02,889994,Ohm; Ko Woon,30,0,30,0
1746557617692,MATH 20B,B01,889996,Ohm; Ko Woon,21,0,30,9
1746557617692,MATH 20B,B02,889997,Ohm; Ko Woon,23,0,30,7
1746557618923,MATH 20C,A01,889999,Hammock; Frances H,17,0,30,13
1746557618923,MATH 20C,A02,890003,Hammock; Frances H,23,0,30,7
1746557618923,MATH 20C,B01,890006,Hammock; Frances H,3,0,30,27
1746557618923,MATH 20C,B02,890007,Hammock; Frances H,11,0,30,19
1746557619949,MATH 20D,A01,890011,Cheng; Hsiao-Bing,1,1,30,29
1746557619949,MATH 20D,A02,890012,Cheng; Hsiao-Bing,14,0,30,16
1746557619949,MATH 20D,B01,890016,Cheng; Hsiao-Bing,13,0,30,17
1746557619949,MATH 20D,B02,890017,Cheng; Hsiao-Bing,13,0,30,17
1746557620976,MATH 20E,A01,890026,Harel; Guershon,1,0,30,29
1746557620976,MATH 20E,A02,890029,Harel; Guershon,23,0,30,7
1746557620976,MATH 20E,B01,890033,Harel; Guershon,7,0,30,23
1746557620976,MATH 20E,B02,890101,Harel; Guershon,21,0,30,9
1746557622001,MATH 102,A01,890104,Staff,17,0,30,13
1746557622001,MATH 102,A02,890105,Staff,27,0,30,3
1746557623027,MATH 103B,A01,890116,Salehi Golsefidy; Alireza,3,0,30,27
1746557623027,MATH 103B,B01,890118,Staff,0,3,34,34
1746557624051,MATH 109,A01,890121,Aliabadi Sr.; Mohsen,1,0,30,29
1746557624051,MATH 109,B01,890124,Upadrashta; Pranav Kumar,18,0,30,12
1746557625081,MATH 120A,A01,890126,Eggers; John Dietrich,13,0,30,17
1746557626107,MATH 142B,A01,890128,Ioana; Adrian,19,0,30,11
1746557626107,MATH 142B,A02,890129,Ioana; Adrian,13,0,30,17
1746557627132,MATH 154,A01,890174,Staff,0,0,30,30
1746557627132,MATH 154,A02,890182,Staff,0,0,30,30
1746557628155,MATH 168A,A01,890197,Dumitriu; Ioana,21,0,35,14
1746557629182,MATH 170A,A01,890240,Nie; Jiawang,1,0,30,29
1746557629182,MATH 170A,A02,890241,Nie; Jiawang,11,0,30,19
1746557629182,MATH 170A,A03,890249,Nie; Jiawang,23,0,30,7
1746557630207,MATH 170B,A01,957891,Nag; Panchali,13,0,35,22
1746557632258,MATH 181A,A01,908025,Staff,0,4,35,35
1746557632258,MATH 181A,A02,960115,Staff,27,0,35,8
1746557633282,MATH 181B,A01,959874,Staff,25,0,30,5
1746557634307,MATH 193B,A01,890265,Staff,0,4,35,35
1746557635336,MGT 4,A01,890311,Anderson; John Charles,42,0,88,46
1746557636360,MGT 5,A00,907740,Staff,13,0,98,85
1746557637389,MGT 12,A00,890312,Lindenberger; Wade Douglas,67,0,98,31
1746557638414,MGT 16,A00,957883,Staff,78,0,98,20
1746557640466,MGT 45,A00,890314,Pecore; Joseph P.,46,0,98,52
1746557641490,MGT 71,A00,890315,Staff,0,11,98,98
1746557642515,MGT 100,A00,890316,Yavorsky; Daniel Ryan,44,0,98,54
1746557643539,MGT 103,A00,890317,Ehrich; Kristine R,73,0,98,25
1746557644567,MGT 105,A00,890356,Bates; Kenneth Walter,0,7,98,98
1746557645593,MGT 112,A00,890360,Ehrich; Kristine R,55,0,98,43
1746557646620,MGT 127R,A00,907732,Zhu; Kevin Xiaoguo,24,0,98,74
1746557647645,MGT 131B,A00,890361,Anderson; John Charles,60,0,98,38
1746557648672,MGT 137,A00,890362,Lindenberger; Wade Douglas,65,0,98,33
1746557649697,MGT 160,A00,890369,Johnson; Erik Barry,9,0,98,89
1746557651745,MGT 164,A00,890372,Zimmermann; Carsten,0,39,98,98
1746557652773,MGT 180,A00,890374,Bliss; Barbara Ann,12,0,98,86
1746557653803,MMW 15,A01,886414,Chang; Edmond Yi-Teh,0,12,28,28
1746557653803,MMW 15,A02,886415,Chang; Edmond Yi-Teh,0,8,28,28
1746557653803,MMW 15,A03,886416,Chang; Edmond Yi-Teh,0,8,28,28
1746557653803,MMW 15,A04,886417,Chang; Edmond Yi-Teh,0,8,28,28
1746557653803,MMW 15,B01,886419,Chang; Edmond Yi-Teh,0,7,28,28
1746557653803,MMW 15,B02,886420,Chang; Edmond Yi-Teh,0,8,28,28
1746557653803,MMW 15,B03,886421,Chang; Edmond Yi-Teh,0,7,28,28
1746557653803,MMW 15,B04,886422,Chang; Edmond Yi-Teh,0,8,28,28
1746557653803,MMW 15,C01,886424,Staff,0,9,28,28
1746557653803,MMW 15,C02,886425,Staff,0,8,28,28
1746557653803,MMW 15,C03,886426,Staff,0,8,28,28
1746557653803,MMW 15,C04,886427,Staff,0,8,28,28
1746557653803,MMW 15,C05,958038,Staff,0,7,28,28
1746557653803,MMW 15,C06,958039,Staff,0,8,28,28
1746557654827,MMW 15GS,A00,906910,Patterson; Patrick H.,4,0,28,24
1746557655856,MMW 122R,A01,886429,Rahimi; Babak,0,13,28,28
1746557655856,MMW 122R,A02,886430,Rahimi; Babak,0,12,28,28
1746557655856,MMW 122R,A03,958040,Rahimi; Babak,0,11,28,28
1746557656884,MUS 1A,A01,890937,Staff,2,0,25,23
1746557656884,MUS 1A,A02,891035,Staff,6,0,25,19
1746557656884,MUS 1A,C01,958912,Staff,24,0,25,1
1746557656884,MUS 1A,C02,958913,Staff,25,0,25,0
1746557658941,MUS 2AK,A00,957092,Ohnishi; Takae,15,0,15,0
1746557659970,MUS 4,A01,891044,Staff,2,0,25,23
1746557659970,MUS 4,A02,891045,Staff,23,0,25,2
1746557659970,MUS 4,B01,891048,Staff,17,0,25,8
1746557659970,MUS 4,B02,891050,Staff,25,0,25,0
1746557661000,MUS 5,A01,957506,Dubnov; Shlomo,0,0,25,25
1746557661000,MUS 5,A02,957622,Dubnov; Shlomo,13,0,25,12
1746557661000,MUS 5,A03,957623,Dubnov; Shlomo,20,0,25,5
1746557662027,MUS 6,A01,891053,Freitas Caetano; Marcelo,24,0,25,1
1746557662027,MUS 6,A02,891054,Freitas Caetano; Marcelo,23,0,25,2
1746557663053,MUS 7,A01,891081,Staff,0,0,25,25
1746557663053,MUS 7,A02,891082,Staff,4,0,25,21
1746557664081,MUS 8GS,A00,891118,Borgo; David Garcia,0,0,25,25
1746557665104,MUS 11,A01,891140,Staff,10,0,25,15
1746557665104,MUS 11,A02,891141,Staff,22,0,25,3
1746557666130,MUS 13,A01,891143,Staff,8,0,25,17
1746557666130,MUS 13,A02,891144,Staff,24,0,25,1
1746557667157,MUS 15,A01,891146,Staff,9,0,25,16
1746557667157,MUS 15,A02,891148,Staff,21,0,25,4
1746557667157,MUS 15,B01,891150,Staff,18,0,25,7
1746557667157,MUS 15,B02,891151,Staff,25,0,25,0
1746557668186,MUS 20,A01,891153,Staff,5,0,20,15
1746557668186,MUS 20,A02,891155,Staff,14,0,20,6
1746557669213,MUS 80,A00,891156,Staff,19,0,25,6
1746557669213,MUS 80,B00,891157,Staff,23,0,25,2
1746557670237,MUS 130,A00,891158,Ohnishi; Takae,35,0,35,0
1746557671264,MUS 150GS,A01,891160,Borgo; David Garcia,0,0,25,25
1746557672294,MUS 170,A01,891162,Freitas Caetano; Marcelo,20,0,25,5
1746557672294,MUS 170,A02,891164,Freitas Caetano; Marcelo,21,0,25,4
1746557673319,NANO 11,A00,886220,Vazquez Mena; Oscar,13,0,15,2
1746557674343,NANO 15,A01,886222,Drews; Aaron,4,0,7,3
1746557675368,NANO 104,A00,886224,Sirbuly; Donald,18,0,25,7
1746557676394,PH 40,A00,886528,Staff,23,0,40,17
1746557677418,PH 45,A01,886799,Staff,35,0,40,5
1746557678443,PH 110,A00,886802,Staff,0,7,40,40
1746557679466,PH 172,A00,906716,Staff,19,0,35,16
1746557680490,PH 191,A00,886803,Staff,6,0,40,34
1746557681514,PHIL 1,A00,889500,Staff,20,0,30,10
1746557682542,PHIL 10,A01,889549,Grush; Rick Scott,15,0,22,7
1746557682542,PHIL 10,A02,889551,Grush; Rick Scott,22,0,22,0
1746557683567,PHIL 28,A01,889559,Lamey; Andy M.,0,1,31,31
1746557683567,PHIL 28,A02,889561,Lamey; Andy M.,0,1,30,30
1746557683567,PHIL 28,A03,889572,Lamey; Andy M.,0,1,30,30
1746557684591,PHIL 35,A00,907839,Staff,13,0,15,2
1746557685616,PHIL 60,A00,889574,Staff,73,0,90,17
1746557686641,PHIL 101,A00,958004,Staff,12,0,15,3
1746557688694,PHIL 136,A00,889582,Fulkerson; Matthew Todd,26,0,45,19
1746557689722,PHIL 163,A01,889601,Staff,21,0,30,9
1746557689722,PHIL 163,B01,889606,Brandt; Reuven A,0,3,0,0
1746557690748,PHIL 164,A00,889610,Staff,16,0,30,14
1746557691773,PHIL 165,A00,889613,Staff,23,0,30,7
1746557692799,PHYS 1A,A00,886431,Staff,26,0,70,44
1746557693824,PHYS 1AL,001,886432,Tsai; Philbert S,0,2,30,30
1746557693824,PHYS 1AL,002,886436,Tsai; Philbert S,11,0,30,19
1746557694850,PHYS 1B,A00,886439,Staff,185,0,240,55
1746557695875,PHYS 1BL,001,886441,Tsai; Philbert S,0,4,30,30
1746557695875,PHYS 1BL,002,886444,Tsai; Philbert S,2,0,30,28
1746557696901,PHYS 1C,A00,896092,Arnold; Kam S,78,0,146,68
1746557697930,PHYS 1CL,001,886448,Tsai; Philbert S,0,0,30,30
1746557697930,PHYS 1CL,002,886449,Tsai; Philbert S,0,0,30,30
1746557697930,PHYS 1CL,003,886450,Tsai; Philbert S,16,0,30,14
1746557697930,PHYS 1CL,004,886451,Tsai; Philbert S,15,0,30,15
1746557698954,PHYS 2B,A01,886457,Staff,68,0,115,47
1746557699979,PHYS 2C,A01,886460,Shotwell; Brian,0,9,65,65
1746557701009,PHYS 2CL,A01,886467,Staff,0,4,28,28
1746557701009,PHYS 2CL,A02,886468,Staff,0,3,28,28
1746557702039,PHYS 2D,A01,886470,Staff,10,0,50,40
1746557703070,PHYS 4B,A01,886475,Grinstein; Benjamin,22,0,40,18
1746557704099,POLI 5,A00,891173,Desposato; Scott,7,0,25,18
1746557705124,POLI 5D,A01,891175,Staff,5,0,5,0
1746557705124,POLI 5D,B01,891178,Staff,5,0,5,0
1746557706151,POLI 11,A00,891179,Ferree; Karen E,2,0,35,33
1746557707175,POLI 12,A00,891180,Staff,16,0,30,14
1746557708199,POLI 27,A01,891182,Staff,12,0,75,63
1746557709224,POLI 30,A00,891183,Staff,8,0,50,42
1746557710252,POLI 100B,A00,891244,Staff,5,1,35,30
1746557711276,POLI 100I,A00,891247,Staff,7,0,30,23
1746557712301,POLI 104J,A00,891248,Nichter; Maysa,14,0,30,16
1746557713325,POLI 104U,A00,891250,Nichter; Maysa,2,0,30,28
1746557715959,POLI 110B,A00,891255,Wiens; David,20,0,25,5
1746557716983,POLI 112A,A00,891256,Wiens; David,6,0,25,19
1746557718008,POLI 114BR,A00,891261,Staff,19,0,30,11
1746557719034,POLI 117R,A00,891262,Forman; Fonna,0,6,50,50
1746557720063,POLI 118,A00,891264,Ingham; Sean,17,0,25,8
1746557721090,POLI 124A,A00,891265,Staff,18,0,20,2
1746557722118,POLI 125D,A00,891266,Nichter; Simeon C,2,0,25,23
1746557723141,POLI 126,A00,891268,Nichter; Simeon C,7,0,25,18
1746557724170,POLI 126AA,A00,891272,Staff,17,0,25,8
1746557725196,POLI 130AA,A00,891273,Staff,15,0,20,5
1746557726224,POLI 134AA,A00,891274,Staff,4,0,20,16
1746557728276,POLI 138,A00,891278,Staff,21,0,25,4
1746557729304,POLI 142K,A00,891280,Staff,11,0,25,14
1746557730328,POLI 142M,A00,891281,Gartzke; Erik,17,0,30,13
1746557731357,POLI 142P,A00,891284,Staff,20,0,30,10
1746557732380,POLI 143,A00,891285,Gartzke; Erik,12,0,30,18
1746557733408,POLI 153,A00,891286,Staff,19,0,20,1
1746557735459,POLI 175,A00,891290,Staff,15,0,20,5
1746557736486,PSYC 1,A00,890674,Steiner; Eric Tomas,0,11,45,45
1746557737513,PSYC 2,A00,890676,Albright; Thomas D,21,0,35,14
1746557738537,PSYC 3,A00,890679,Staff,17,0,20,3
1746557739561,PSYC 6,A00,959858,Staff,20,0,20,0
1746557740586,PSYC 60,A01,890684,Rickard; Timothy C.,0,5,45,45
1746557741610,PSYC 70,A01,890689,Geller; Emma Harlan,7,0,30,23
1746557742635,PSYC 71,A01,959860,Staff,21,0,25,4
1746557743661,PSYC 100,A00,890690,Lacefield; Katharine I,0,50,180,180
1746557744685,PSYC 102,A00,890695,Staff,18,0,40,22
1746557745715,PSYC 105,A00,890699,Geller; Emma Harlan,70,0,100,30
1746557746742,PSYC 106,A00,890701,Gorman; Michael R.,6,0,30,24
1746557747771,PSYC 108,A00,890704,Adrian; Julia Anna,0,28,50,50
1746557748798,PSYC 118,A01,890712,Staff,11,0,30,19
1746557749821,PSYC 124,A00,890716,Chapman; Eddie Nathaniel,25,0,60,35
1746557750847,PSYC 131,A00,890717,Anagnostaras; Stephan,0,7,80,80
1746557751873,PSYC 137,A00,890719,Winkielman; Piotr,0,11,30,30
1746557752900,PSYC 144,A00,890721,Adrian; Julia Anna,0,9,45,45
1746557753925,PSYC 162,A00,890805,Staff,2,0,75,73
1746557754953,PSYC 169,A00,890810,Staff,0,14,30,30
1746557755978,PSYC 172,A00,890814,Gorman; Michael R.,9,0,30,21
1746557757006,PSYC 181,A00,890818,Anagnostaras; Stephan,9,0,200,191
1746557758033,PSYC 184,A00,959861,Staff,170,0,175,5
1746557759058,PSYC 189,A00,890823,Staff,0,1,30,30
1746557760082,PSYC 191,A00,890884,Rickard; Timothy C.,0,11,35,35
1746557761107,PSYC 193,A00,890913,Staff,19,0,30,11
1746557761107,PSYC 193,B00,890914,Chapman; Eddie Nathaniel,24,0,30,6
1746557762135,PSYC 193L,A01,890918,Lowe; Angela Beth,20,0,30,10
1746557762135,PSYC 193L,B01,890921,Hurwitz; Ethan Scott,20,0,30,10
1746557762135,PSYC 193L,C01,890928,Staff,30,0,30,0
1746557763160,RELI 149,A00,886806,Rahimi; Babak,23,0,40,17
1746557764185,SE 9,A01,886814,Staff,7,0,20,13
1746557765213,SE 101B,A01,886816,Chadha; Mayank,4,0,35,31
1746557766242,SE 110B,A00,886818,Zhu; Qiang,4,0,75,71
1746557767270,SE 125,A01,886830,Staff,10,0,30,20
1746557768297,SE 130B,A01,886835,Staff,14,0,40,26
1746557769883,SE 131A,A01,886838,Krysl; Petr,34,0,55,21
1746557770911,SE 154,A00,886840,Staff,29,0,50,21
1746557771937,SE 164GS,A01,886849,Staff,6,0,20,14
1746557772960,SE 167GS,A01,886853,Staff,6,0,20,14
1746557773985,SIO 25,A01,890107,Staff,19,0,30,11
1746557775014,SIO 45,A00,890109,Cook; Geoffrey W,117,0,200,83
1746557776039,SIO 109R,A00,890110,Forman; Fonna,0,16,20,20
1746557777070,SIO 187,A01,890114,Kacev; David,15,0,40,25
1746557778100,SOCI 1,A01,890431,Thorpe; Charles Robert,15,0,30,15
1746557778100,SOCI 1,A02,890518,Thorpe; Charles Robert,30,0,30,0
1746557779127,SOCI 2,A01,957978,Staff,25,0,25,0
1746557779127,SOCI 2,A02,957979,Staff,23,0,25,2
1746557780154,SOCI 20,A01,890523,Calderon-Zaks; Michael Aar,23,0,30,7
1746557780154,SOCI 20,A02,890526,Calderon-Zaks; Michael Aar,29,0,30,1
1746557781181,SOCI 30,A01,890533,Pardo Guerra; Juan Pablo,37,0,40,3
1746557782209,SOCI 40,A01,890535,Staff,27,0,45,18
1746557783233,SOCI 104Q,A00,890559,Staff,18,0,30,12
1746557784258,SOCI 106,A00,890560,Arnal; Maud Marie Leonie,20,0,30,10
1746557785284,SOCI 110,A00,890567,Holkenbrink-Monk; Charlene,19,0,30,11
1746557786308,SOCI 112,A00,890568,Victoria Torres; Pablo,2,0,55,53
1746557787337,SOCI 115,A00,890597,Arnal; Maud Marie Leonie,28,0,45,17
1746557789385,SOCI 121,A00,890604,Pardo Guerra; Juan Pablo,38,0,45,7
1746557790411,SOCI 126,A01,890608,Staff,8,0,10,2
1746557791437,SOCI 127,A00,890609,Staff,18,0,30,12
1746557792463,SOCI 131,A00,890610,Thorpe; Charles Robert,37,0,45,8
1746557793492,SOCI 135,A00,890615,Payne; Christine Anna,13,0,45,32
1746557794518,SOCI 139,A00,890620,Staff,38,0,45,7
1746557795542,SOCI 148E,A00,890622,Calderon-Zaks; Michael Aar,36,0,45,9
1746557796571,SOCI 150,A00,890623,Kohler; Kristopher M.,31,0,45,14
1746557797598,SOCI 157,A00,890625,Jules-Rosette; Bennetta W.,18,0,20,2
1746557798624,SOCI 160,A00,890627,Payne; Christine Anna,21,0,45,24
1746557799650,SYN 1,A00,886855,Fish; Gwendolyn Anne,0,0,0,0
1746557799650,SYN 1,B00,906086,Fish; Gwendolyn Anne,0,1,0,2
1746557800677,SYN 2R,A00,886860,Staff,0,17,15,15
1746557800677,SYN 2R,B00,906106,Atkinson; Arthur Laird,0,16,15,15
1746557801703,SYN 100,A01,886866,Browne; Emily,0,28,20,20
1746557801703,SYN 100,B01,906128,Rock; Martin,0,5,20,20
1746557801703,SYN 100,C01,906140,Deavenport; James Cary,0,3,20,20
1746557801703,SYN 100,D01,907816,Deavenport; James Cary,0,5,20,20
1746557802729,TDAC 1,A00,890286,Walsh; Kim C.,8,0,20,12
1746557803757,TDAC 101,A00,890296,Basso; Beatrice,16,0,20,4
1746557804782,TDDE 131,A00,890297,Staff,47,0,50,3
1746557805808,TDDM 1,A00,890287,Weinberg; Sadie,25,0,30,5
1746557806838,TDGE 11,A00,890288,Fulton; Julia,137,0,200,63
1746557806838,TDGE 11,B00,890289,Castro; Robert Jess,184,0,200,16
1746557807864,TDGE 25,B00,957359,Walsh; Kim C.,3,0,20,17
1746557808891,TDGE 40,A01,890292,Power; Jade Yukana,27,0,30,3
1746557809916,TDGE 124,A00,890298,Havis; Allan,0,1,50,50
1746557810941,TDGE 131R,A00,890299,Burelle; Julie Sara Veronique,15,0,42,27
1746557811968,TDHT 101,A00,890300,Staff,10,0,20,10
1746557812997,TDHT 109,A01,890302,Anderson; Mysia Anyse,31,0,40,9
1746557814021,TDMV 1,A00,890293,Arcidiacono; Kristin,18,0,30,12
1746557815050,TDMV 2,A00,890294,Weinberg; Sadie,23,0,30,7
1746557816077,TDMV 3,A00,957878,Arcidiacono; Kristin,28,0,30,2
1746557818127,TDMV 138,A00,890304,Jun; Grace Shin Hae,25,0,40,15
1746557819156,TDMV 140,A00,890305,Corrales; Joseph Bernales,25,0,30,5
1746557820185,TDMV 142,A00,890307,Caligagan; Tony,32,0,40,8
1746557821209,TDMV 144,A00,890308,Camaya; Michelle Ann,25,0,30,5
1746557822234,TDPW 1,A00,890295,Stein; Deborah Isobel,3,0,20,17
1746557823259,USP 2,A01,890272,Lerner; Amy M,6,0,20,14
1746557824287,USP 3,A01,890274,Staff,12,0,30,18
1746557825311,USP 15,A01,890276,Sun; Feiyang,16,0,30,14
1746557826337,USP 25,A00,890277,Shenkman; Michael Thomas,19,0,25,6
1746557827363,USP 138,A00,890278,Staff,13,0,25,12
1746557828389,USP 143,A00,890279,Staff,21,0,70,49
1746557829413,USP 144,A00,890280,Chowdhury; Muhammed Zohir,15,0,30,15
1746557830439,USP 150,A00,890281,Boomhower; Matthew Charles,4,0,30,26
1746557831465,USP 151,A00,890282,Staff,16,0,20,4
1746557832489,USP 162,A00,890283,Andrews; Abigail Leslie,16,0,20,4
1746557833514,USP 168,A00,920477,Kwak; Nancy,1,0,5,4
1746557834541,USP 181,A00,890284,Staff,3,0,20,17
1746557835574,USP 191A,A00,890285,Staff,12,0,20,8
1746557836599,VIS 101,A00,886512,Staff,26,0,75,49
1746557837623,VIS 103,A00,886513,Cruz; Edwin Teddy,61,0,75,14
1746557838648,VIS 108,A00,886514,Staff,3,0,15,12
1746557839673,VIS 127P,A00,886515,Shen; Kuiyi,80,0,146,66
1746557840699,VIS 149,A00,886516,Yoldas; Pinar,0,0,15,15
1746557841727,VIS 164,A00,886526,Erdmann; Dean,19,0,22,3
1746557842753,VIS 194S,A00,886527,Staff,61,0,75,14
1746557843778,WCWP 10A,C00,886484,Martiniuk; Jill,12,0,15,3
1746557844807,WCWP 10B,A00,886490,Uriarte; Emma,0,0,15,15
1746557844807,WCWP 10B,B00,886491,Dhir; Simrita,10,0,15,5
1746557844807,WCWP 10B,C00,886492,Ornelas; Tricia,0,0,15,15
1746557845832,WCWP 100,A00,886494,Young; Mark T,0,6,15,15
1746557847947,AAS 10,A01,886199,Childs; Dennis R.,0,3,0,0
1746557848972,ANAR 104,A01,886940,Shtienberg; Gilad,27,0,30,3
1746557849999,ANAR 120,A00,886953,Staff,12,0,20,8
1746557851025,ANBI 148,A01,886955,Wilder; Linnea Lorene,30,0,40,10
1746557853074,ANSC 122,A00,886957,Staff,25,0,30,5
1746557854101,ANSC 150,A00,886958,Sloane; Julia Kathryn,2,0,15,13
1746557855125,ANSC 156,A00,886959,Jenkins; Janis A.,0,1,15,15
1746557856149,ANSC 180,A00,886960,Staff,11,0,17,6
1746557857177,ANSC 188,A00,886961,Jassal; Aftab,9,0,25,16
1746557858203,ANSC 190,A00,886962,Jassal; Aftab,14,0,25,11
1746557859230,ANSC 191,A00,886963,Staff,18,0,20,2
1746557860256,ANTH 3,A01,891689,Staff,17,0,20,3
1746557861281,ANTH 5,A00,886933,Semendeferi; Ekaterini,16,0,20,4
1746557862309,ANTH 10,A00,886934,Staff,0,12,30,30
1746557863335,ANTH 21,A01,886936,Staff,40,0,60,20
1746557864363,ANTH 23,A01,886938,Staff,92,0,100,8
1746557865389,ANTH 105,A00,886964,Stewart; Alexander B,84,0,100,16
1746557866416,ANTH 108,A00,886965,Pedersen; David,9,0,20,11
1746557867442,AWP 10,001,886147,Staff,0,0,0,0
1746557867442,AWP 10,002,886148,Staff,0,0,0,0
1746557867442,AWP 10,003,886149,Staff,0,0,0,0
1746557867442,AWP 10,004,886150,Staff,0,0,0,0
1746557867442,AWP 10,005,886151,Staff,0,0,0,0
1746557867442,AWP 10,006,886152,Staff,0,0,0,0
1746557867442,AWP 10,007,886153,Staff,0,0,0,0
1746557867442,AWP 10,008,886154,Staff,0,0,0,0
1746557867442,AWP 10,009,886155,Staff,0,0,0,0
1746557867442,AWP 10,010,886156,Staff,0,0,0,0
1746557867442,AWP 10,011,886158,Staff,0,0,0,0
1746557867442,AWP 10,012,886160,Staff,0,0,0,0
1746557867442,AWP 10,013,886161,Staff,0,0,0,0
1746557867442,AWP 10,014,886162,Staff,0,0,0,0
1746557867442,AWP 10,015,886163,Staff,0,0,0,0
1746557867442,AWP 10,016,886164,Staff,0,0,0,0
1746557867442,AWP 10,017,886165,Staff,0,0,0,0
1746557867442,AWP 10,018,886166,Staff,0,0,0,0
1746557867442,AWP 10,019,886168,Staff,0,0,0,0
1746557867442,AWP 10,020,886170,Staff,0,0,0,0
1746557867442,AWP 10,021,886172,Staff,0,0,0,0
1746557868470,AWP 10R,001,886173,Staff,0,1,0,0
1746557868470,AWP 10R,002,886174,Staff,0,1,0,0
1746557868470,AWP 10R,003,886175,Staff,0,0,0,0
1746557868470,AWP 10R,004,886176,Staff,0,0,0,0
1746557868470,AWP 10R,005,886177,Staff,0,0,0,0
1746557868470,AWP 10R,006,886178,Staff,0,0,0,0
1746557868470,AWP 10R,007,886179,Staff,0,0,0,0
1746557868470,AWP 10R,008,886181,Staff,0,0,0,0
1746557868470,AWP 10R,009,886182,Staff,0,0,0,0
1746557868470,AWP 10R,010,886183,Staff,0,0,0,0
1746557868470,AWP 10R,011,886184,Staff,0,0,0,0
1746557868470,AWP 10R,012,886185,Staff,0,0,0,0
1746557868470,AWP 10R,013,886186,Staff,0,0,0,0
1746557868470,AWP 10R,014,886187,Staff,0,0,0,0
1746557868470,AWP 10R,015,886188,Staff,0,0,0,0
1746557868470,AWP 10R,016,886189,Staff,0,0,0,0
1746557868470,AWP 10R,017,960532,Staff,0,0,0,0
1746557868470,AWP 10R,018,960533,Staff,0,0,0,0
1746557868470,AWP 10R,019,960534,Staff,0,0,0,0
1746557868470,AWP 10R,020,960538,Staff,0,0,0,0
1746557868470,AWP 10R,021,960540,Staff,0,0,0,0
1746557868470,AWP 10R,022,960541,Staff,0,0,0,0
1746557868470,AWP 10R,023,960542,Staff,0,0,0,0
1746557868470,AWP 10R,024,960544,Staff,0,0,0,0
1746557868470,AWP 10R,025,960545,Staff,0,0,0,0
1746557868470,AWP 10R,026,960548,Staff,0,0,0,0
1746557869496,AWP 102R,A00,886190,Staff,0,0,0,0
1746557869496,AWP 102R,B00,886191,Staff,0,0,0,0
1746557870525,BENG 100,A01,886193,Staff,17,0,30,13
1746557871552,BENG 122A,A01,886195,Hasty; Jeff M,13,0,30,17
1746557872577,BENG 166A,A00,886196,Sah; Robert Lie-Yuan,0,2,30,30
1746557873605,BENG 190,A00,958050,Khojah; Reem I,22,0,25,3
1746557874630,BIBC 102,A01,894320,Staff,0,0,46,46
1746557874630,BIBC 102,A02,894321,Staff,0,0,46,46
1746557874630,BIBC 102,A03,894344,Staff,7,0,46,39
1746557874630,BIBC 102,A04,894345,Staff,26,0,47,21
1746557875655,BICD 100R,A01,894365,Smith; Laurie,0,4,58,58
1746557875655,BICD 100R,A02,894366,Smith; Laurie,0,5,58,58
1746557875655,BICD 100R,A03,894367,Smith; Laurie,1,0,59,58
1746557875655,BICD 100R,A04,959869,Smith; Laurie,41,0,59,18
1746557876680,BICD 136,A01,894383,Gustafson-Brown; Cindy,14,0,50,36
1746557877705,BIEB 102,A01,894494,Butler; Shannon Rhey,51,0,130,79
1746557879759,BIEB 150,A01,894617,Wills; Christopher,3,0,20,17
1746557879759,BIEB 150,A02,894631,Wills; Christopher,3,0,20,17
1746557879759,BIEB 150,A03,894937,Wills; Christopher,3,0,20,17
1746557879759,BIEB 150,A04,894946,Wills; Christopher,5,0,20,15
1746557880784,BIEB 194,A00,906141,Kurle; Carolyn M.,6,0,20,14
1746557881833,BILD 1,A01,894154,Staff,3,0,19,16
1746557881833,BILD 1,A02,894155,Staff,14,0,19,5
1746557881833,BILD 1,A03,894160,Staff,13,0,19,6
1746557881833,BILD 1,A04,894161,Staff,15,0,18,3
1746557882859,BILD 2,A01,894168,Staff,0,0,50,50
1746557882859,BILD 2,A02,894169,Staff,0,0,50,50
1746557882859,BILD 2,A03,894179,Staff,0,0,50,50
1746557882859,BILD 2,A04,894203,Staff,27,0,50,23
1746557883888,BILD 3,A01,894213,Staff,22,0,31,9
1746557883888,BILD 3,A02,894214,Staff,26,0,31,5
1746557883888,BILD 3,A03,894235,Staff,28,0,31,3
1746557883888,BILD 3,A04,894236,Staff,28,0,32,4
1746557884915,BILD 4,A01,894253,Reuther; Keefe,5,0,24,19
1746557884915,BILD 4,A02,894258,Reuther; Keefe,16,0,24,8
1746557885940,BILD 5,A01,894276,Reuther; Keefe,35,0,50,15
1746557885940,BILD 5,A02,894277,Reuther; Keefe,45,0,50,5
1746557885940,BILD 5,A03,894290,Reuther; Keefe,44,0,50,6
1746557885940,BILD 5,A04,894291,Reuther; Keefe,48,0,50,2
1746557886967,BILD 24,A01,894297,Pirino; Giorgia,40,0,60,20
1746557887991,BIMM 100,B01,958915,Staff,71,0,100,29
1746557889018,BIMM 101,A01,895017,McDonnell; Lisa Marie,0,5,24,24
1746557889018,BIMM 101,A02,895018,McDonnell; Lisa Marie,0,5,24,24
1746557889018,BIMM 101,B01,895020,McDonnell; Lisa Marie,0,6,24,24
1746557889018,BIMM 101,B02,895021,McDonnell; Lisa Marie,0,4,24,24
1746557890043,BIMM 110,A01,895023,Staff,1,0,25,24
1746557890043,BIMM 110,A02,895024,Staff,9,0,25,16
1746557890043,BIMM 110,A03,895025,Staff,18,0,25,7
1746557890043,BIMM 110,A04,895031,Staff,20,0,25,5
1746557891073,BIMM 120,A01,895114,Gustafson-Brown; Cindy,14,0,28,14
1746557891073,BIMM 120,A02,895126,Gustafson-Brown; Cindy,21,0,27,6
1746557892098,BIPN 100,A01,895130,Yang; Mingyu,1,0,38,37
1746557892098,BIPN 100,A02,895131,Yang; Mingyu,32,0,38,6
1746557892098,BIPN 100,A03,895132,Yang; Mingyu,32,0,38,6
1746557892098,BIPN 100,A04,895133,Yang; Mingyu,27,0,36,9
1746557893124,BIPN 120,A01,895135,Cooke; James Edward,0,3,13,13
1746557893124,BIPN 120,A02,895136,Cooke; James Edward,0,1,13,13
1746557893124,BIPN 120,A03,895137,Cooke; James Edward,0,3,13,13
1746557893124,BIPN 120,A04,895156,Cooke; James Edward,0,2,11,11
1746557894148,BIPN 134,A01,895235,Cooke; James Edward,0,2,25,25
1746557894148,BIPN 134,A02,895237,Cooke; James Edward,0,0,25,25
1746557894148,BIPN 134,A03,895240,Cooke; James Edward,3,0,25,22
1746557894148,BIPN 134,A04,895270,Cooke; James Edward,20,0,25,5
1746557895173,BIPN 189,A00,892103,Staff,0,13,14,14
1746557897224,BISP 194,A00,958008,Staff,0,2,0,0
1746557898250,CAT 124,A01,922009,Staff,0,5,20,20
1746557899276,CAT 125R,A00,886390,Morales; Celeste Georgianna,0,2,20,20
1746557899276,CAT 125R,B00,886391,Irwin; Matthew Joseph,0,3,20,20
1746557899276,CAT 125R,C00,886392,Smith; Lauryn Alissa,0,2,20,20
1746557899276,CAT 125R,D00,886393,Vanderschuit; Maya Alysia,0,2,20,20
1746557899276,CAT 125R,E00,886394,Marchisotto; Jennifer Anne,0,4,20,20
1746557900306,CENG 15,A01,886218,Drews; Aaron,3,0,8,5
1746557901331,CENG 113,A00,886219,Opatkiewicz; Justin Paul,15,0,25,10
1746557902355,CGS 101,A00,887044,Staff,7,0,20,13
1746557903381,CGS 105,A01,887046,Staff,14,0,25,11
1746557904408,CGS 112,A00,887047,Cuong; Marisol,12,0,15,3
1746557905436,CGS 113,A00,887048,Staff,23,0,30,7
1746557906461,CGS 120,A00,887049,Staff,10,0,17,7
1746557907489,CHEM 6A,A01,886336,Lam; Tin Yiu,38,0,50,12
1746557907489,CHEM 6A,A02,886338,Lam; Tin Yiu,37,0,50,13
1746557908514,CHEM 6B,A01,886341,Hopkins; Patrycja Anna,16,0,50,34
1746557908514,CHEM 6B,A02,886343,Hopkins; Patrycja Anna,42,0,50,8
1746557909540,CHEM 6C,A01,886346,Albizati; Kim F.,0,2,50,50
1746557909540,CHEM 6C,A02,886348,Albizati; Kim F.,23,0,50,27
1746557910565,CHEM 40A,A01,886352,Klosterman; Jeremy K,65,0,100,35
1746557911591,CHEM 40B,A01,886356,Klosterman; Jeremy K,0,23,100,100
1746557912616,CHEM 41B,A01,886360,Theodorakis; Emmanuel,25,0,50,25
1746557912616,CHEM 41B,A02,886362,Theodorakis; Emmanuel,47,0,50,3
1746557913643,CHIN 165A,A00,886382,Xu; Li,18,0,20,2
1746557914667,CLAS 120,A00,886387,Myerston Santana; Jacobo,33,0,40,7
1746557915693,COGS 9,A01,886967,Shannon; Kyle Michael,42,0,60,18
1746557916717,COGS 11,A01,886969,Staff,11,0,30,19
1746557917744,COGS 14A,A01,886971,Staff,6,0,60,54
1746557918772,COGS 14B,A01,886973,Hoffman; Drew Ellen,4,0,60,56
1746557919797,COGS 18,A01,886975,Morgan; Eric,35,0,60,25
1746557920824,COGS 20,A01,886977,Staff,4,0,8,4
1746557920824,COGS 20,A02,886978,Staff,5,0,7,2
1746557921853,COGS 100,A01,907783,Staff,0,2,30,30
1746557922877,COGS 101B,A01,886980,Staff,0,3,48,48
1746557923903,COGS 101C,A01,886982,Delgado; Tania,0,5,44,44
1746557924927,COGS 102A,A01,886984,Johnson; Christine M.,4,0,30,26
1746557925956,COGS 118B,A01,886986,Staff,0,3,88,88
1746557926981,COGS 150,A01,886988,Bergen; Benjamin,23,0,50,27
1746557928007,COGS 153,A00,886989,Delgado; Tania,0,2,41,41
1746557929075,COGS 186,A01,886991,Staff,0,0,32,32
1746557930108,COGS 187A,A01,886993,Boyle; Mary E. T.,7,0,30,23
1746557931133,COGS 189,A00,886994,Staff,0,1,30,30
1746557932158,COMM 10,A01,886996,Staff,0,0,20,21
1746557932158,COMM 10,A02,886997,Staff,12,0,20,8
1746557932158,COMM 10,A03,959845,Staff,19,0,20,1
1746557933188,COMM 20,A01,886999,Leuning; Grant Maurstad,24,0,40,16
1746557935240,COMM 100A,A01,887002,Staff,0,0,20,25
1746557935240,COMM 100A,A02,887003,Staff,7,0,20,13
1746557936270,COMM 100B,A01,887005,Staff,0,8,20,24
1746557937295,COMM 106D,A00,887006,Staff,14,0,40,26
1746557938323,COMM 110G,A00,887007,Whitworth-Smith; Andrew C,12,0,40,28
1746557939349,COMM 111B,A00,887008,Staff,31,0,40,9
1746557940378,COMM 113T,A00,887009,Abuelhiga; Soraya Jill,28,0,40,12
1746557940378,COMM 113T,B00,906733,Staff,40,0,40,0
1746557941404,COMM 145,A00,887010,Staff,12,0,40,28
1746557942431,COMM 146,A00,887054,Staff,31,0,40,9
1746557943458,COMM 190,A00,887012,Staff,8,0,23,15
1746557944487,CSE 8A,A50,887015,Cao; Yingjun,57,0,85,28
1746557945515,CSE 11,A01,887017,Cao; Yingjun,12,0,70,58
1746557946541,CSE 20,A01,887019,Staff,30,0,50,20
1746557947571,CSE 21,A01,887021,Staff,78,0,100,22
1746557947571,CSE 21,B01,892583,Braun; Oliver,45,0,50,5
1746557948595,CSE 30,A01,887025,Eldon; John,143,0,200,57
1746557949623,CSE 100,A01,887027,Staff,26,0,50,24
1746557949623,CSE 100,A02,887028,Staff,42,0,50,8
1746557950650,CSE 101,A01,887030,Braun; Oliver,74,0,100,26
1746557950650,CSE 101,B01,887032,Jones; Miles E,0,3,50,50
1746557950650,CSE 101,B02,887033,Jones; Miles E,0,1,50,50
1746557951677,CSE 105,A01,908084,Jones; Miles E,32,0,50,18
1746557951677,CSE 105,A02,908087,Jones; Miles E,32,0,50,18
1746557952702,CSE 135,A01,887035,Powell; Thomas Allan,0,4,50,50
1746557953731,CSE 142,A01,887037,Staff,8,0,60,52
1746557954757,CSE 142L,A01,887039,Staff,34,0,60,26
1746557955786,CSE 151A,A01,887041,Solares; Edwin A,47,0,100,53
1746557956814,CSE 175,A01,887043,Kumar; Rakesh,30,0,30,0
1746557957841,CSS 1,A01,886389,Staff,1,1,40,39
1746557958867,DSC 30,A01,908097,Liao; Soohyun Nam,47,0,75,28
1746557959894,DSC 40A,A01,908099,Shannon; Kyle Michael,30,0,50,20
1746557960925,DSC 40B,A01,908112,Staff,16,0,50,34
1746557961949,DSC 80,A01,908116,Staff,19,0,60,41
1746557962977,DSC 197,001,956863,Eldridge; Justin Matthew,9999,0,9999,0
1746557964003,ECE 5,A01,886400,Morris; Karcher William,2,0,6,4
1746557964003,ECE 5,A02,886401,Morris; Karcher William,3,0,6,3
1746557965028,ECE 148,A01,886403,Silberman; Jack,0,14,14,14
1746557966054,ECON 1,A01,887265,Crane; Meredith Helen,12,0,70,58
1746557966054,ECON 1,B01,887268,Staff,43,0,50,7
1746557967082,ECON 2,A01,887273,Crane; Meredith Helen,56,0,70,14
1746557968107,ECON 3,A01,887279,Rondina; Giacomo,32,0,70,38
1746557969133,ECON 4,A01,887282,Anderson; John Charles,0,2,10,10
1746557970158,ECON 5,A01,887285,Staff,33,0,45,12
1746557970158,ECON 5,B01,887292,Staff,41,0,45,4
1746557971181,ECON 100A,A01,887337,Newhouse; Herbert S,54,0,70,16
1746557971181,ECON 100A,B01,887349,Staff,45,0,50,5
1746557972207,ECON 100B,A01,887361,Du; Songzi,29,0,70,41
1746557973232,ECON 100C,A01,887445,Newhouse; Herbert S,59,0,70,11
1746557974256,ECON 105,A00,887488,Vespa; Emanuel Ignacio,23,0,35,12
1746557975280,ECON 109,A01,887506,Shishkin; Denis,28,0,35,7
1746557976310,ECON 110A,A01,887568,Alon; Titan Michael,0,3,35,35
1746557976310,ECON 110A,B01,907601,Alon; Titan Michael,20,0,35,15
1746557977339,ECON 110B,A01,887598,Levkoff; Steven B.,0,24,70,70
1746557978366,ECON 112,A00,887599,Rondina; Giacomo,19,0,35,16
1746557979393,ECON 120A,A01,887603,Dai; Yinlin,35,0,70,35
1746557980424,ECON 120C,A01,887608,Sun; Yixiao,0,1,35,35
1746557980424,ECON 120C,B01,887614,Sun; Yixiao,0,0,35,35
1746557981450,ECON 138,A00,887621,Bharadwaj; Prashant,0,21,20,20
1746557982475,ECON 144,A00,958007,Squires; Dale E,13,0,35,22
1746557983501,ECON 171,A01,907666,Staff,18,0,35,17
1746557984528,ECON 175,A00,887626,Wu; Pak Yeung,23,0,35,12
1746557985553,ECON 190,A00,887640,Vespa; Emanuel Ignacio,23,0,35,12
1746557986580,EDS 25,A01,888197,Staff,0,0,0,0
1746557986580,EDS 25,A02,888209,Staff,0,0,0,0
1746557986580,EDS 25,A03,888210,Staff,0,0,0,0
1746557986580,EDS 25,A04,888212,Staff,0,0,0,0
1746557986580,EDS 25,A05,888213,Staff,0,0,0,0
1746557986580,EDS 25,A06,888214,Staff,0,0,0,0
1746557986580,EDS 25,A07,888235,Staff,0,2,0,0
1746557986580,EDS 25,A08,888236,Staff,0,0,0,0
1746557986580,EDS 25,A09,888240,Staff,0,0,0,0
1746557986580,EDS 25,A10,888244,Staff,0,0,0,0
1746557986580,EDS 25,B01,888273,Staff,0,0,0,0
1746557986580,EDS 25,B02,888285,Staff,0,0,0,0
1746557986580,EDS 25,B03,888423,Staff,0,0,0,1
1746557986580,EDS 25,B04,888432,Staff,0,0,0,0
1746557986580,EDS 25,B05,888433,Staff,0,0,0,0
1746557986580,EDS 25,B06,888467,Staff,0,0,0,0
1746557986580,EDS 25,B07,888468,Staff,0,0,0,0
1746557986580,EDS 25,B08,888479,Staff,0,0,0,0
1746557986580,EDS 25,B09,888484,Staff,0,0,0,0
1746557986580,EDS 25,B10,888487,Staff,0,0,0,0
1746557987609,EDS 38,A01,907700,Choi; Bailey Miyeon,30,0,30,0
1746557988633,EDS 112,A01,888601,Chapman; Thandeka K,13,0,40,27
1746557989662,EDS 115,A00,888697,Mendez; Kathrina Mendoza,10,0,30,20
1746557990688,EDS 116,A01,888893,Staff,35,0,40,5
1746557992743,EDS 124AR,A00,889133,Staff,29,0,50,21
1746557992743,EDS 124AR,B00,907471,Simon; Elizabeth A,37,0,50,13
1746557993769,EDS 124BR,A00,889134,Simon; Elizabeth A,44,0,100,56
1746557994797,EDS 125,A00,889135,Staff,25,0,30,5
1746557995825,EDS 126,A01,889138,Staff,36,0,40,4
1746557996856,EDS 164R,A01,889142,Wishard Guerra; Alison G.,33,0,50,17
1746557997881,ENG 30,A01,886396,Staff,0,0,0,0
1746557997881,ENG 30,B01,886398,Staff,0,0,0,0
1746557998907,ENVR 102,A00,906150,Montejo; Carolina,23,0,25,2
1746557999932,ETHN 103A,A00,887236,Man; Simeon S,0,3,0,0
1746558000956,ETHN 113,A00,887239,Staff,16,0,30,14
1746558001989,ETHN 116,A00,887240,Staff,16,0,25,9
1746558003018,ETHN 117,A00,887241,Choi; Esther Min,28,0,30,2
1746558004043,ETHN 118,A00,887243,Staff,24,0,30,6
1746558005071,ETHN 127,A00,887248,Cuong; Marisol,11,0,15,4
1746558006105,ETHN 139,A00,887250,Staff,7,0,10,3
1746558007131,ETHN 142,A00,887252,Staff,10,0,30,20
1746558008161,ETHN 161,A00,887253,Browne; Errol Tsekani,24,0,30,6
1746558009186,ETHN 163FR,A00,887255,Burelle; Julie Sara Veronique,0,0,5,5
1746558010213,GLBH 20,A00,889149,Elwardani; Nile Regina,8,0,42,34
1746558012264,GLBH 111,A01,889152,Burgos; Jose L.,17,0,17,0
1746558013289,GLBH 150,A00,889181,Sloane; Julia Kathryn,0,5,15,15
1746558015345,HDS 60,A01,886406,Warstadt; Melissa Fawn,73,0,80,7
1746558016373,HIAF 111,A00,889324,Gyamfi; Bright,25,0,32,7
1746558017402,HIEA 131,A00,889328,Staff,16,0,32,16
1746558018427,HIEA 144,A00,889333,Henry; Todd A.,26,0,32,6
1746558019450,HIEA 154,A00,889336,Henry; Todd A.,24,0,32,8
1746558020475,HIEU 106,A00,889339,Staff,22,0,32,10
1746558022527,HIEU 114,A00,889340,Staff,3,0,32,29
1746558023554,HIEU 135GS,A00,889342,Patterson; Patrick H.,0,0,1,24
1746558024578,HIEU 137,A00,889343,Edington; Claire Ellen,9,0,25,16
1746558025815,HIEU 148,A00,889345,Staff,14,0,32,18
1746558026841,HIEU 154,A00,889346,Biess; Frank Peter,21,0,32,11
1746558027868,HILA 102,A00,889351,Staff,12,0,32,20
1746558028895,HILD 2A,A01,889221,Lewandoski; Julia Mavis,1,10,32,31
1746558029921,HILD 7B,A01,889225,Man; Simeon S,0,12,32,32
1746558030947,HILD 7C,A01,889288,Alvarez; Luis A,0,14,32,32
1746558031975,HILD 30,A01,889323,Staff,0,5,32,32
1746558034027,HISC 119,A00,889383,Golan; Tal,20,0,32,12
1746558035052,HIUS 103,A00,889384,Man; Simeon S,0,0,32,32
1746558036077,HIUS 117,A00,919797,Kwak; Nancy,18,0,32,14
1746558037101,HIUS 142A,A00,919788,Staff,22,0,32,10
1746558039152,HIUS 149,A00,889386,Gyamfi; Bright,27,0,32,5
1746558040176,HIUS 155,A00,889387,Alvarez; Luis A,14,0,32,18
1746558041202,HUM 3,A01,886499,Caldwell; Michael Alan,19,0,50,31
1746558042229,HUM 3GS,A00,886500,Rodriguez; Bretton Sigfred,0,0,0,28
1746558043255,HUM 3R,A01,886502,Markman; Kristina,0,36,50,50
1746558044323,HUM 4,A01,886504,Crum; Matthew Stephen,24,0,50,26
1746558044323,HUM 4,B01,886506,West; Geoffrey Scott,17,0,50,33
1746558045348,HUM 4GS,A00,886507,Staff,0,0,0,19
1746558046373,HUM 5,A01,886509,Staff,32,0,50,18
1746558047398,HUM 5R,A01,886511,Zavodny; Tatiana Sophia,0,39,50,50
1746558048422,JAPN 180,A00,886407,Staff,17,0,40,23
1746558049449,LATI 50,A01,886409,Martin-Cabrera; Luis,4,0,22,18
1746558049449,LATI 50,A02,886410,Martin-Cabrera; Luis,19,0,22,3
1746558049449,LATI 50,A03,886411,Martin-Cabrera; Luis,21,0,22,1
1746558049449,LATI 50,A04,886412,Martin-Cabrera; Luis,9,0,22,13
1746558050476,LAWS 101,A00,907664,Staff,28,0,60,32
1746558051502,LIAB 1A,A00,889388,Saab; Dima,17,0,20,3
1746558052528,LIAB 1AX,A00,889389,El Cheddadi; Youniss,17,0,20,3
1746558053553,LIFR 1C,A00,889391,Van Moer; Vinciane G,8,0,20,12
1746558054577,LIFR 1CX,A00,889392,Van Moer; Vinciane G,7,0,20,13
1746558055606,LIFR 1D,A00,889393,Van Moer; Vinciane G,7,0,20,13
1746558056631,LIFR 1DX,A00,889394,Van Moer; Vinciane G,8,0,20,12
1746558057658,LIGN 7,A00,886923,Staff,24,0,50,26
1746558058683,LIGN 17,A00,886924,Kehler; Andrew Scott,125,0,150,25
1746558059708,LTAM 110,A00,889395,Staff,15,0,30,15
1746558060733,LTAM 110GS,A00,958010,Rodriguez; Bretton Sigfred,0,0,0,28
1746558061758,LTCH 101,A00,889397,Staff,23,0,25,2
1746558062788,LTCS 130,A00,889398,Staff,23,0,25,2
1746558063812,LTEA 138,A00,889399,Staff,24,0,40,16
1746558064838,LTEN 149,A00,889400,Wesling; Megan E.,0,3,25,25
1746558065866,LTEN 169,A00,889401,Staff,20,0,25,5
1746558066893,LTEN 180,A00,889402,Staff,10,0,15,5
1746558067921,LTEN 181,A00,889403,Staff,21,0,25,4
1746558068946,LTWL 100,A00,889404,Myerston Santana; Jacobo,3,0,25,22
1746558069973,LTWL 180GS,A00,889405,Staff,0,0,20,20
1746558070998,LTWL 181,A00,889406,Staff,17,0,25,8
1746558072025,LTWL 184,A00,889475,Mukherjee; Silpa,22,0,25,3
1746558073050,LTWR 102C,A00,889486,Staff,29,0,30,1
1746558074077,LTWR 115W,A00,889491,Staff,0,2,15,15
1746558075183,MAE 8,A01,886905,Staff,0,2,0,0
1746558076209,MAE 11,A00,886906,Bandaru; Prabhakar,0,7,50,50
1746558077238,MAE 20,A00,886907,Evdokimenko; Ekaterina,43,0,70,27
1746558078264,MAE 30B,A00,886909,Ghazinejad; Maziar,26,0,45,19
1746558079292,MAE 101B,A00,886910,Saintillan; David,29,0,45,16
1746558080319,MAE 105,A00,886911,Bandaru; Prabhakar,18,0,50,32
1746558081343,MAE 107,B00,958024,Staff,8,0,50,42
1746558082369,MAE 143B,A00,886913,Bewley; Thomas R,6,0,40,34
1746558083395,MAE 148,A01,886915,Silberman; Jack,0,3,14,14
1746558084463,MAE 160,A00,886916,Evdokimenko; Ekaterina,32,0,60,28
1746558085491,MATH 3C,A01,889681,Staff,0,3,30,30
1746558085491,MATH 3C,A02,960048,Staff,25,0,30,5
1746558086516,MATH 10A,A01,889760,Staff,26,0,30,4
1746558086516,MATH 10A,A02,889783,Staff,29,0,30,1
1746558087547,MATH 10B,A01,889785,Verstraete; Jacques Allan,2,0,35,33
1746558087547,MATH 10B,A02,889795,Verstraete; Jacques Allan,4,0,35,31
1746558087547,MATH 10B,B01,889797,Verstraete; Jacques Allan,3,0,35,32
1746558087547,MATH 10B,B02,889828,Verstraete; Jacques Allan,3,0,35,32
1746558088573,MATH 10C,A01,889849,Habib; Yousaf,8,0,30,22
1746558088573,MATH 10C,A02,889852,Habib; Yousaf,14,0,30,16
1746558088573,MATH 10C,A03,889853,Habib; Yousaf,22,0,30,8
1746558088573,MATH 10C,A04,889858,Habib; Yousaf,20,0,30,10
1746558088573,MATH 10C,B01,889861,Staff,1,0,30,29
1746558088573,MATH 10C,B02,889862,Staff,24,0,30,6
1746558088573,MATH 10C,B03,889863,Staff,27,0,30,3
1746558088573,MATH 10C,B04,889967,Staff,23,0,30,7
1746558089598,MATH 18,A01,889974,Staff,7,0,30,23
1746558089598,MATH 18,A02,889977,Staff,20,0,30,10
1746558089598,MATH 18,B01,889984,Hardiman; Liam,21,0,30,9
1746558089598,MATH 18,B02,889985,Hardiman; Liam,25,0,30,5
1746558090625,MATH 20A,A01,889990,Suk; Andrew Hoon,30,0,35,5
1746558091650,MATH 20B,A01,889993,Ohm; Ko Woon,22,0,30,8
1746558091650,MATH 20B,A02,889994,Ohm; Ko Woon,30,0,30,0
1746558091650,MATH 20B,B01,889996,Ohm; Ko Woon,21,0,30,9
1746558091650,MATH 20B,B02,889997,Ohm; Ko Woon,23,0,30,7
1746558092676,MATH 20C,A01,889999,Hammock; Frances H,17,0,30,13
1746558092676,MATH 20C,A02,890003,Hammock; Frances H,23,0,30,7
1746558092676,MATH 20C,B01,890006,Hammock; Frances H,3,0,30,27
1746558092676,MATH 20C,B02,890007,Hammock; Frances H,11,0,30,19
1746558093702,MATH 20D,A01,890011,Cheng; Hsiao-Bing,1,1,30,29
1746558093702,MATH 20D,A02,890012,Cheng; Hsiao-Bing,14,0,30,16
1746558093702,MATH 20D,B01,890016,Cheng; Hsiao-Bing,13,0,30,17
1746558093702,MATH 20D,B02,890017,Cheng; Hsiao-Bing,13,0,30,17
1746558094732,MATH 20E,A01,890026,Harel; Guershon,1,0,30,29
1746558094732,MATH 20E,A02,890029,Harel; Guershon,23,0,30,7
1746558094732,MATH 20E,B01,890033,Harel; Guershon,7,0,30,23
1746558094732,MATH 20E,B02,890101,Harel; Guershon,21,0,30,9
1746558095756,MATH 102,A01,890104,Staff,17,0,30,13
1746558095756,MATH 102,A02,890105,Staff,27,0,30,3
1746558096782,MATH 103B,A01,890116,Salehi Golsefidy; Alireza,3,0,30,27
1746558096782,MATH 103B,B01,890118,Staff,0,3,34,34
1746558097809,MATH 109,A01,890121,Aliabadi Sr.; Mohsen,1,0,30,29
1746558097809,MATH 109,B01,890124,Upadrashta; Pranav Kumar,18,0,30,12
1746558098834,MATH 120A,A01,890126,Eggers; John Dietrich,13,0,30,17
1746558099864,MATH 142B,A01,890128,Ioana; Adrian,19,0,30,11
1746558099864,MATH 142B,A02,890129,Ioana; Adrian,13,0,30,17
1746558100889,MATH 154,A01,890174,Staff,0,0,30,30
1746558100889,MATH 154,A02,890182,Staff,0,0,30,30
1746558101914,MATH 168A,A01,890197,Dumitriu; Ioana,21,0,35,14
1746558102944,MATH 170A,A01,890240,Nie; Jiawang,1,0,30,29
1746558102944,MATH 170A,A02,890241,Nie; Jiawang,11,0,30,19
1746558102944,MATH 170A,A03,890249,Nie; Jiawang,23,0,30,7
1746558103976,MATH 170B,A01,957891,Nag; Panchali,13,0,35,22
1746558106237,MATH 181A,A01,908025,Staff,0,4,35,35
1746558106237,MATH 181A,A02,960115,Staff,27,0,35,8
1746558107264,MATH 181B,A01,959874,Staff,25,0,30,5
1746558108291,MATH 193B,A01,890265,Staff,0,4,35,35
1746558109316,MGT 4,A01,890311,Anderson; John Charles,42,0,88,46
1746558110340,MGT 5,A00,907740,Staff,13,0,98,85
1746558111367,MGT 12,A00,890312,Lindenberger; Wade Douglas,67,0,98,31
1746558112402,MGT 16,A00,957883,Staff,78,0,98,20
1746558114457,MGT 45,A00,890314,Pecore; Joseph P.,46,0,98,52
1746558115485,MGT 71,A00,890315,Staff,0,11,98,98
1746558116511,MGT 100,A00,890316,Yavorsky; Daniel Ryan,44,0,98,54
1746558117539,MGT 103,A00,890317,Ehrich; Kristine R,73,0,98,25
1746558118564,MGT 105,A00,890356,Bates; Kenneth Walter,0,7,98,98
1746558119589,MGT 112,A00,890360,Ehrich; Kristine R,55,0,98,43
1746558120617,MGT 127R,A00,907732,Zhu; Kevin Xiaoguo,24,0,98,74
1746558121642,MGT 131B,A00,890361,Anderson; John Charles,60,0,98,38
1746558122667,MGT 137,A00,890362,Lindenberger; Wade Douglas,65,0,98,33
1746558123694,MGT 160,A00,890369,Johnson; Erik Barry,9,0,98,89
1746558125758,MGT 164,A00,890372,Zimmermann; Carsten,0,40,98,98
1746558126786,MGT 180,A00,890374,Bliss; Barbara Ann,12,0,98,86
1746558127817,MMW 15,A01,886414,Chang; Edmond Yi-Teh,0,12,28,28
1746558127817,MMW 15,A02,886415,Chang; Edmond Yi-Teh,0,8,28,28
1746558127817,MMW 15,A03,886416,Chang; Edmond Yi-Teh,0,8,28,28
1746558127817,MMW 15,A04,886417,Chang; Edmond Yi-Teh,0,8,28,28
1746558127817,MMW 15,B01,886419,Chang; Edmond Yi-Teh,0,7,28,28
1746558127817,MMW 15,B02,886420,Chang; Edmond Yi-Teh,0,8,28,28
1746558127817,MMW 15,B03,886421,Chang; Edmond Yi-Teh,0,7,28,28
1746558127817,MMW 15,B04,886422,Chang; Edmond Yi-Teh,0,8,28,28
1746558127817,MMW 15,C01,886424,Staff,0,9,28,28
1746558127817,MMW 15,C02,886425,Staff,0,8,28,28
1746558127817,MMW 15,C03,886426,Staff,0,8,28,28
1746558127817,MMW 15,C04,886427,Staff,0,8,28,28
1746558127817,MMW 15,C05,958038,Staff,0,8,28,28
1746558127817,MMW 15,C06,958039,Staff,0,8,28,28
1746558128847,MMW 15GS,A00,906910,Patterson; Patrick H.,4,0,28,24
1746558129873,MMW 122R,A01,886429,Rahimi; Babak,0,13,28,28
1746558129873,MMW 122R,A02,886430,Rahimi; Babak,0,12,28,28
1746558129873,MMW 122R,A03,958040,Rahimi; Babak,0,11,28,28
1746558130899,MUS 1A,A01,890937,Staff,2,0,25,23
1746558130899,MUS 1A,A02,891035,Staff,6,0,25,19
1746558130899,MUS 1A,C01,958912,Staff,24,0,25,1
1746558130899,MUS 1A,C02,958913,Staff,25,0,25,0
1746558132951,MUS 2AK,A00,957092,Ohnishi; Takae,15,0,15,0
1746558133980,MUS 4,A01,891044,Staff,2,0,25,23
1746558133980,MUS 4,A02,891045,Staff,23,0,25,2
1746558133980,MUS 4,B01,891048,Staff,17,0,25,8
1746558133980,MUS 4,B02,891050,Staff,25,0,25,0
1746558135015,MUS 5,A01,957506,Dubnov; Shlomo,0,0,25,25
1746558135015,MUS 5,A02,957622,Dubnov; Shlomo,13,0,25,12
1746558135015,MUS 5,A03,957623,Dubnov; Shlomo,20,0,25,5
1746558136043,MUS 6,A01,891053,Freitas Caetano; Marcelo,24,0,25,1
1746558136043,MUS 6,A02,891054,Freitas Caetano; Marcelo,23,0,25,2
1746558137069,MUS 7,A01,891081,Staff,0,0,25,25
1746558137069,MUS 7,A02,891082,Staff,4,0,25,21
1746558138094,MUS 8GS,A00,891118,Borgo; David Garcia,0,0,25,25
1746558139120,MUS 11,A01,891140,Staff,10,0,25,15
1746558139120,MUS 11,A02,891141,Staff,22,0,25,3
1746558140152,MUS 13,A01,891143,Staff,8,0,25,17
1746558140152,MUS 13,A02,891144,Staff,24,0,25,1
1746558141179,MUS 15,A01,891146,Staff,9,0,25,16
1746558141179,MUS 15,A02,891148,Staff,21,0,25,4
1746558141179,MUS 15,B01,891150,Staff,18,0,25,7
1746558141179,MUS 15,B02,891151,Staff,25,0,25,0
1746558142209,MUS 20,A01,891153,Staff,5,0,20,15
1746558142209,MUS 20,A02,891155,Staff,14,0,20,6
1746558143233,MUS 80,A00,891156,Staff,19,0,25,6
1746558143233,MUS 80,B00,891157,Staff,23,0,25,2
1746558144262,MUS 130,A00,891158,Ohnishi; Takae,35,0,35,0
1746558145289,MUS 150GS,A01,891160,Borgo; David Garcia,0,0,25,25
1746558146314,MUS 170,A01,891162,Freitas Caetano; Marcelo,20,0,25,5
1746558146314,MUS 170,A02,891164,Freitas Caetano; Marcelo,21,0,25,4
1746558147337,NANO 11,A00,886220,Vazquez Mena; Oscar,13,0,15,2
1746558148362,NANO 15,A01,886222,Drews; Aaron,4,0,7,3
1746558149387,NANO 104,A00,886224,Sirbuly; Donald,18,0,25,7
1746558150414,PH 40,A00,886528,Staff,23,0,40,17
1746558151438,PH 45,A01,886799,Staff,35,0,40,5
1746558152463,PH 110,A00,886802,Staff,0,7,40,40
1746558153490,PH 172,A00,906716,Staff,19,0,35,16
1746558154514,PH 191,A00,886803,Staff,6,0,40,34
1746558155541,PHIL 1,A00,889500,Staff,20,0,30,10
1746558156567,PHIL 10,A01,889549,Grush; Rick Scott,15,0,22,7
1746558156567,PHIL 10,A02,889551,Grush; Rick Scott,22,0,22,0
1746558157595,PHIL 28,A01,889559,Lamey; Andy M.,0,1,31,31
1746558157595,PHIL 28,A02,889561,Lamey; Andy M.,0,1,30,30
1746558157595,PHIL 28,A03,889572,Lamey; Andy M.,0,1,30,30
1746558158621,PHIL 35,A00,907839,Staff,13,0,15,2
1746558159647,PHIL 60,A00,889574,Staff,73,0,90,17
1746558160672,PHIL 101,A00,958004,Staff,12,0,15,3
1746558162724,PHIL 136,A00,889582,Fulkerson; Matthew Todd,26,0,45,19
1746558163749,PHIL 163,A01,889601,Staff,21,0,30,9
1746558163749,PHIL 163,B01,889606,Brandt; Reuven A,0,3,0,0
1746558164775,PHIL 164,A00,889610,Staff,16,0,30,14
1746558165801,PHIL 165,A00,889613,Staff,23,0,30,7
1746558166829,PHYS 1A,A00,886431,Staff,26,0,70,44
1746558167854,PHYS 1AL,001,886432,Tsai; Philbert S,0,2,30,30
1746558167854,PHYS 1AL,002,886436,Tsai; Philbert S,11,0,30,19
1746558168879,PHYS 1B,A00,886439,Staff,185,0,240,55
1746558169904,PHYS 1BL,001,886441,Tsai; Philbert S,0,4,30,30
1746558169904,PHYS 1BL,002,886444,Tsai; Philbert S,2,0,30,28
1746558170932,PHYS 1C,A00,896092,Arnold; Kam S,78,0,146,68
1746558171960,PHYS 1CL,001,886448,Tsai; Philbert S,0,0,30,30
1746558171960,PHYS 1CL,002,886449,Tsai; Philbert S,0,0,30,30
1746558171960,PHYS 1CL,003,886450,Tsai; Philbert S,16,0,30,14
1746558171960,PHYS 1CL,004,886451,Tsai; Philbert S,15,0,30,15
1746558173223,PHYS 2B,A01,886457,Staff,68,0,115,47
1746558174250,PHYS 2C,A01,886460,Shotwell; Brian,0,9,65,65
1746558175280,PHYS 2CL,A01,886467,Staff,0,4,28,28
1746558175280,PHYS 2CL,A02,886468,Staff,0,3,28,28
1746558176307,PHYS 2D,A01,886470,Staff,10,0,50,40
1746558177335,PHYS 4B,A01,886475,Grinstein; Benjamin,22,0,40,18
1746558178359,POLI 5,A00,891173,Desposato; Scott,7,0,25,18
1746558179385,POLI 5D,A01,891175,Staff,5,0,5,0
1746558179385,POLI 5D,B01,891178,Staff,5,0,5,0
1746558180411,POLI 11,A00,891179,Ferree; Karen E,2,0,35,33
1746558181436,POLI 12,A00,891180,Staff,16,0,30,14
1746558182461,POLI 27,A01,891182,Staff,12,0,75,63
1746558183487,POLI 30,A00,891183,Staff,8,0,50,42
1746558184513,POLI 100B,A00,891244,Staff,5,1,35,30
1746558185539,POLI 100I,A00,891247,Staff,7,0,30,23
1746558186563,POLI 104J,A00,891248,Nichter; Maysa,14,0,30,16
1746558187588,POLI 104U,A00,891250,Nichter; Maysa,2,0,30,28
1746558189638,POLI 110B,A00,891255,Wiens; David,20,0,25,5
1746558190662,POLI 112A,A00,891256,Wiens; David,6,0,25,19
1746558191687,POLI 114BR,A00,891261,Staff,19,0,30,11
1746558192710,POLI 117R,A00,891262,Forman; Fonna,0,6,50,50
1746558193737,POLI 118,A00,891264,Ingham; Sean,17,0,25,8
1746558194762,POLI 124A,A00,891265,Staff,18,0,20,2
1746558195789,POLI 125D,A00,891266,Nichter; Simeon C,2,0,25,23
1746558196813,POLI 126,A00,891268,Nichter; Simeon C,7,0,25,18
1746558197841,POLI 126AA,A00,891272,Staff,17,0,25,8
1746558198867,POLI 130AA,A00,891273,Staff,15,0,20,5
1746558199891,POLI 134AA,A00,891274,Staff,4,0,20,16
1746558201948,POLI 138,A00,891278,Staff,21,0,25,4
1746558202976,POLI 142K,A00,891280,Staff,11,0,25,14
1746558204003,POLI 142M,A00,891281,Gartzke; Erik,17,0,30,13
1746558205029,POLI 142P,A00,891284,Staff,20,0,30,10
1746558206057,POLI 143,A00,891285,Gartzke; Erik,12,0,30,18
1746558207082,POLI 153,A00,891286,Staff,19,0,20,1
1746558209134,POLI 175,A00,891290,Staff,15,0,20,5
1746558210162,PSYC 1,A00,890674,Steiner; Eric Tomas,0,11,45,45
1746558211189,PSYC 2,A00,890676,Albright; Thomas D,21,0,35,14
1746558212213,PSYC 3,A00,890679,Staff,17,0,20,3
1746558213240,PSYC 6,A00,959858,Staff,20,0,20,0
1746558214264,PSYC 60,A01,890684,Rickard; Timothy C.,0,5,45,45
1746558215289,PSYC 70,A01,890689,Geller; Emma Harlan,7,0,30,23
1746558216315,PSYC 71,A01,959860,Staff,21,0,25,4
1746558217340,PSYC 100,A00,890690,Lacefield; Katharine I,0,50,180,180
1746558218367,PSYC 102,A00,890695,Staff,18,0,40,22
1746558219390,PSYC 105,A00,890699,Geller; Emma Harlan,70,0,100,30
1746558220414,PSYC 106,A00,890701,Gorman; Michael R.,6,0,30,24
1746558221438,PSYC 108,A00,890704,Adrian; Julia Anna,0,28,50,50
1746558222464,PSYC 118,A01,890712,Staff,11,0,30,19
1746558223491,PSYC 124,A00,890716,Chapman; Eddie Nathaniel,25,0,60,35
1746558224518,PSYC 131,A00,890717,Anagnostaras; Stephan,0,7,80,80
1746558225548,PSYC 137,A00,890719,Winkielman; Piotr,0,11,30,30
1746558226576,PSYC 144,A00,890721,Adrian; Julia Anna,0,9,45,45
1746558227601,PSYC 162,A00,890805,Staff,2,0,75,73
1746558228627,PSYC 169,A00,890810,Staff,0,14,30,30
1746558229653,PSYC 172,A00,890814,Gorman; Michael R.,9,0,30,21
1746558230680,PSYC 181,A00,890818,Anagnostaras; Stephan,9,0,200,191
1746558231705,PSYC 184,A00,959861,Staff,170,0,175,5
1746558232730,PSYC 189,A00,890823,Staff,0,1,30,30
1746558233754,PSYC 191,A00,890884,Rickard; Timothy C.,0,11,35,35
1746558234784,PSYC 193,A00,890913,Staff,19,0,30,11
1746558234784,PSYC 193,B00,890914,Chapman; Eddie Nathaniel,24,0,30,6
1746558235814,PSYC 193L,A01,890918,Lowe; Angela Beth,20,0,30,10
1746558235814,PSYC 193L,B01,890921,Hurwitz; Ethan Scott,20,0,30,10
1746558235814,PSYC 193L,C01,890928,Staff,30,0,30,0
1746558236838,RELI 149,A00,886806,Rahimi; Babak,23,0,40,17
1746558237863,SE 9,A01,886814,Staff,7,0,20,13
1746558238892,SE 101B,A01,886816,Chadha; Mayank,4,0,35,31
1746558239919,SE 110B,A00,886818,Zhu; Qiang,4,0,75,71
1746558240948,SE 125,A01,886830,Staff,10,0,30,20
1746558241972,SE 130B,A01,886835,Staff,14,0,40,26
1746558243003,SE 131A,A01,886838,Krysl; Petr,34,0,55,21
1746558244028,SE 154,A00,886840,Staff,29,0,50,21
1746558245054,SE 164GS,A01,886849,Staff,6,0,20,14
1746558246080,SE 167GS,A01,886853,Staff,6,0,20,14
1746558247104,SIO 25,A01,890107,Staff,19,0,30,11
1746558248131,SIO 45,A00,890109,Cook; Geoffrey W,117,0,200,83
1746558249156,SIO 109R,A00,890110,Forman; Fonna,0,16,20,20
1746558250179,SIO 187,A01,890114,Kacev; David,15,0,40,25
1746558251208,SOCI 1,A01,890431,Thorpe; Charles Robert,15,0,30,15
1746558251208,SOCI 1,A02,890518,Thorpe; Charles Robert,30,0,30,0
1746558252237,SOCI 2,A01,957978,Staff,25,0,25,0
1746558252237,SOCI 2,A02,957979,Staff,23,0,25,2
1746558253262,SOCI 20,A01,890523,Calderon-Zaks; Michael Aar,23,0,30,7
1746558253262,SOCI 20,A02,890526,Calderon-Zaks; Michael Aar,29,0,30,1
1746558254286,SOCI 30,A01,890533,Pardo Guerra; Juan Pablo,37,0,40,3
1746558255310,SOCI 40,A01,890535,Staff,27,0,45,18
1746558256337,SOCI 104Q,A00,890559,Staff,18,0,30,12
1746558257362,SOCI 106,A00,890560,Arnal; Maud Marie Leonie,20,0,30,10
1746558258388,SOCI 110,A00,890567,Holkenbrink-Monk; Charlene,19,0,30,11
1746558259413,SOCI 112,A00,890568,Victoria Torres; Pablo,2,0,55,53
1746558260438,SOCI 115,A00,890597,Arnal; Maud Marie Leonie,28,0,45,17
1746558262496,SOCI 121,A00,890604,Pardo Guerra; Juan Pablo,38,0,45,7
1746558263523,SOCI 126,A01,890608,Staff,8,0,10,2
1746558264551,SOCI 127,A00,890609,Staff,18,0,30,12
1746558265577,SOCI 131,A00,890610,Thorpe; Charles Robert,37,0,45,8
1746558266603,SOCI 135,A00,890615,Payne; Christine Anna,13,0,45,32
1746558267626,SOCI 139,A00,890620,Staff,38,0,45,7
1746558268654,SOCI 148E,A00,890622,Calderon-Zaks; Michael Aar,36,0,45,9
1746558269681,SOCI 150,A00,890623,Kohler; Kristopher M.,31,0,45,14
1746558270705,SOCI 157,A00,890625,Jules-Rosette; Bennetta W.,18,0,20,2
1746558271731,SOCI 160,A00,890627,Payne; Christine Anna,21,0,45,24
1746558272760,SYN 1,A00,886855,Fish; Gwendolyn Anne,0,0,0,0
1746558272760,SYN 1,B00,906086,Fish; Gwendolyn Anne,0,1,0,2
1746558273785,SYN 2R,A00,886860,Staff,0,17,15,15
1746558273785,SYN 2R,B00,906106,Atkinson; Arthur Laird,0,16,15,15
1746558274817,SYN 100,A01,886866,Browne; Emily,0,28,20,20
1746558274817,SYN 100,B01,906128,Rock; Martin,0,5,20,20
1746558274817,SYN 100,C01,906140,Deavenport; James Cary,0,3,20,20
1746558274817,SYN 100,D01,907816,Deavenport; James Cary,0,5,20,20
1746558275844,TDAC 1,A00,890286,Walsh; Kim C.,8,0,20,12
1746558276871,TDAC 101,A00,890296,Basso; Beatrice,15,0,20,5
1746558277897,TDDE 131,A00,890297,Staff,47,0,50,3
1746558278926,TDDM 1,A00,890287,Weinberg; Sadie,25,0,30,5
1746558279951,TDGE 11,A00,890288,Fulton; Julia,137,0,200,63
1746558279951,TDGE 11,B00,890289,Castro; Robert Jess,184,0,200,16
1746558280979,TDGE 25,B00,957359,Walsh; Kim C.,3,0,20,17
1746558282005,TDGE 40,A01,890292,Power; Jade Yukana,27,0,30,3
1746558283032,TDGE 124,A00,890298,Havis; Allan,0,1,50,50
1746558284057,TDGE 131R,A00,890299,Burelle; Julie Sara Veronique,15,0,42,27
1746558285082,TDHT 101,A00,890300,Staff,10,0,20,10
1746558286109,TDHT 109,A01,890302,Anderson; Mysia Anyse,31,0,40,9
1746558287135,TDMV 1,A00,890293,Arcidiacono; Kristin,18,0,30,12
1746558288161,TDMV 2,A00,890294,Weinberg; Sadie,23,0,30,7
1746558289197,TDMV 3,A00,957878,Arcidiacono; Kristin,28,0,30,2
1746558291247,TDMV 138,A00,890304,Jun; Grace Shin Hae,25,0,40,15
1746558292272,TDMV 140,A00,890305,Corrales; Joseph Bernales,25,0,30,5
1746558293300,TDMV 142,A00,890307,Caligagan; Tony,32,0,40,8
1746558294329,TDMV 144,A00,890308,Camaya; Michelle Ann,25,0,30,5
1746558295353,TDPW 1,A00,890295,Stein; Deborah Isobel,3,0,20,17
1746558296381,USP 2,A01,890272,Lerner; Amy M,6,0,20,14
1746558297408,USP 3,A01,890274,Staff,12,0,30,18
1746558298436,USP 15,A01,890276,Sun; Feiyang,16,0,30,14
1746558299464,USP 25,A00,890277,Shenkman; Michael Thomas,19,0,25,6
1746558300489,USP 138,A00,890278,Staff,13,0,25,12
1746558301517,USP 143,A00,890279,Staff,21,0,70,49
1746558302542,USP 144,A00,890280,Chowdhury; Muhammed Zohir,15,0,30,15
1746558303569,USP 150,A00,890281,Boomhower; Matthew Charles,4,0,30,26
1746558304597,USP 151,A00,890282,Staff,16,0,20,4
1746558305623,USP 162,A00,890283,Andrews; Abigail Leslie,16,0,20,4
1746558306649,USP 168,A00,920477,Kwak; Nancy,1,0,5,4
1746558307674,USP 181,A00,890284,Staff,3,0,20,17
1746558308702,USP 191A,A00,890285,Staff,12,0,20,8
1746558309729,VIS 101,A00,886512,Staff,26,0,75,49
1746558310757,VIS 103,A00,886513,Cruz; Edwin Teddy,61,0,75,14
1746558311783,VIS 108,A00,886514,Staff,3,0,15,12
1746558312810,VIS 127P,A00,886515,Shen; Kuiyi,80,0,146,66
1746558313836,VIS 149,A00,886516,Yoldas; Pinar,0,0,15,15
1746558314862,VIS 164,A00,886526,Erdmann; Dean,19,0,22,3
1746558315887,VIS 194S,A00,886527,Staff,61,0,75,14
1746558316915,WCWP 10A,C00,886484,Martiniuk; Jill,12,0,15,3
1746558317944,WCWP 10B,A00,886490,Uriarte; Emma,0,0,15,15
1746558317944,WCWP 10B,B00,886491,Dhir; Simrita,10,0,15,5
1746558317944,WCWP 10B,C00,886492,Ornelas; Tricia,0,0,15,15
1746558318969,WCWP 100,A00,886494,Young; Mark T,0,6,15,15
1746558321068,AAS 10,A01,886199,Childs; Dennis R.,0,3,0,0
1746558322092,ANAR 104,A01,886940,Shtienberg; Gilad,27,0,30,3
1746558323121,ANAR 120,A00,886953,Staff,12,0,20,8
1746558324149,ANBI 148,A01,886955,Wilder; Linnea Lorene,30,0,40,10
1746558326201,ANSC 122,A00,886957,Staff,25,0,30,5
1746558327227,ANSC 150,A00,886958,Sloane; Julia Kathryn,2,0,15,13
1746558328253,ANSC 156,A00,886959,Jenkins; Janis A.,0,1,15,15
1746558329279,ANSC 180,A00,886960,Staff,11,0,17,6
1746558330304,ANSC 188,A00,886961,Jassal; Aftab,9,0,25,16
1746558331358,ANSC 190,A00,886962,Jassal; Aftab,14,0,25,11
1746558332381,ANSC 191,A00,886963,Staff,18,0,20,2
1746558333409,ANTH 3,A01,891689,Staff,17,0,20,3
1746558334434,ANTH 5,A00,886933,Semendeferi; Ekaterini,16,0,20,4
1746558335460,ANTH 10,A00,886934,Staff,0,12,30,30
1746558336486,ANTH 21,A01,886936,Staff,40,0,60,20
1746558337513,ANTH 23,A01,886938,Staff,92,0,100,8
1746558338537,ANTH 105,A00,886964,Stewart; Alexander B,84,0,100,16
1746558339561,ANTH 108,A00,886965,Pedersen; David,9,0,20,11
1746558340591,AWP 10,001,886147,Staff,0,0,0,0
1746558340591,AWP 10,002,886148,Staff,0,0,0,0
1746558340591,AWP 10,003,886149,Staff,0,0,0,0
1746558340591,AWP 10,004,886150,Staff,0,0,0,0
1746558340591,AWP 10,005,886151,Staff,0,0,0,0
1746558340591,AWP 10,006,886152,Staff,0,0,0,0
1746558340591,AWP 10,007,886153,Staff,0,0,0,0
1746558340591,AWP 10,008,886154,Staff,0,0,0,0
1746558340591,AWP 10,009,886155,Staff,0,0,0,0
1746558340591,AWP 10,010,886156,Staff,0,0,0,0
1746558340591,AWP 10,011,886158,Staff,0,0,0,0
1746558340591,AWP 10,012,886160,Staff,0,0,0,0
1746558340591,AWP 10,013,886161,Staff,0,0,0,0
1746558340591,AWP 10,014,886162,Staff,0,0,0,0
1746558340591,AWP 10,015,886163,Staff,0,0,0,0
1746558340591,AWP 10,016,886164,Staff,0,0,0,0
1746558340591,AWP 10,017,886165,Staff,0,0,0,0
1746558340591,AWP 10,018,886166,Staff,0,0,0,0
1746558340591,AWP 10,019,886168,Staff,0,0,0,0
1746558340591,AWP 10,020,886170,Staff,0,0,0,0
1746558340591,AWP 10,021,886172,Staff,0,0,0,0
1746558341618,AWP 10R,001,886173,Staff,0,1,0,0
1746558341618,AWP 10R,002,886174,Staff,0,1,0,0
1746558341618,AWP 10R,003,886175,Staff,0,0,0,0
1746558341618,AWP 10R,004,886176,Staff,0,0,0,0
1746558341618,AWP 10R,005,886177,Staff,0,0,0,0
1746558341618,AWP 10R,006,886178,Staff,0,0,0,0
1746558341618,AWP 10R,007,886179,Staff,0,0,0,0
1746558341618,AWP 10R,008,886181,Staff,0,0,0,0
1746558341618,AWP 10R,009,886182,Staff,0,0,0,0
1746558341618,AWP 10R,010,886183,Staff,0,0,0,0
1746558341618,AWP 10R,011,886184,Staff,0,0,0,0
1746558341618,AWP 10R,012,886185,Staff,0,0,0,0
1746558341618,AWP 10R,013,886186,Staff,0,0,0,0
1746558341618,AWP 10R,014,886187,Staff,0,0,0,0
1746558341618,AWP 10R,015,886188,Staff,0,0,0,0
1746558341618,AWP 10R,016,886189,Staff,0,0,0,0
1746558341618,AWP 10R,017,960532,Staff,0,0,0,0
1746558341618,AWP 10R,018,960533,Staff,0,0,0,0
1746558341618,AWP 10R,019,960534,Staff,0,0,0,0
1746558341618,AWP 10R,020,960538,Staff,0,0,0,0
1746558341618,AWP 10R,021,960540,Staff,0,0,0,0
1746558341618,AWP 10R,022,960541,Staff,0,0,0,0
1746558341618,AWP 10R,023,960542,Staff,0,0,0,0
1746558341618,AWP 10R,024,960544,Staff,0,0,0,0
1746558341618,AWP 10R,025,960545,Staff,0,0,0,0
1746558341618,AWP 10R,026,960548,Staff,0,0,0,0
1746558342643,AWP 102R,A00,886190,Staff,0,0,0,0
1746558342643,AWP 102R,B00,886191,Staff,0,0,0,0
1746558343672,BENG 100,A01,886193,Staff,17,0,30,13
1746558344697,BENG 122A,A01,886195,Hasty; Jeff M,13,0,30,17
1746558345723,BENG 166A,A00,886196,Sah; Robert Lie-Yuan,0,2,30,30
1746558346750,BENG 190,A00,958050,Khojah; Reem I,22,0,25,3
1746558347776,BIBC 102,A01,894320,Staff,0,0,46,46
1746558347776,BIBC 102,A02,894321,Staff,0,0,46,46
1746558347776,BIBC 102,A03,894344,Staff,7,0,46,39
1746558347776,BIBC 102,A04,894345,Staff,26,0,47,21
1746558348806,BICD 100R,A01,894365,Smith; Laurie,0,4,58,58
1746558348806,BICD 100R,A02,894366,Smith; Laurie,0,5,58,58
1746558348806,BICD 100R,A03,894367,Smith; Laurie,1,0,59,58
1746558348806,BICD 100R,A04,959869,Smith; Laurie,41,0,59,18
1746558349832,BICD 136,A01,894383,Gustafson-Brown; Cindy,14,0,50,36
1746558350859,BIEB 102,A01,894494,Butler; Shannon Rhey,51,0,130,79
1746558352914,BIEB 150,A01,894617,Wills; Christopher,3,0,20,17
1746558352914,BIEB 150,A02,894631,Wills; Christopher,3,0,20,17
1746558352914,BIEB 150,A03,894937,Wills; Christopher,3,0,20,17
1746558352914,BIEB 150,A04,894946,Wills; Christopher,5,0,20,15
1746558354145,BIEB 194,A00,906141,Kurle; Carolyn M.,6,0,20,14
1746558355172,BILD 1,A01,894154,Staff,3,0,19,16
1746558355172,BILD 1,A02,894155,Staff,14,0,19,5
1746558355172,BILD 1,A03,894160,Staff,13,0,19,6
1746558355172,BILD 1,A04,894161,Staff,15,0,18,3
1746558356198,BILD 2,A01,894168,Staff,0,0,50,50
1746558356198,BILD 2,A02,894169,Staff,0,0,50,50
1746558356198,BILD 2,A03,894179,Staff,0,0,50,50
1746558356198,BILD 2,A04,894203,Staff,26,0,50,24
1746558357226,BILD 3,A01,894213,Staff,22,0,31,9
1746558357226,BILD 3,A02,894214,Staff,26,0,31,5
1746558357226,BILD 3,A03,894235,Staff,28,0,31,3
1746558357226,BILD 3,A04,894236,Staff,28,0,32,4
1746558358253,BILD 4,A01,894253,Reuther; Keefe,5,0,24,19
1746558358253,BILD 4,A02,894258,Reuther; Keefe,16,0,24,8
1746558359277,BILD 5,A01,894276,Reuther; Keefe,35,0,50,15
1746558359277,BILD 5,A02,894277,Reuther; Keefe,45,0,50,5
1746558359277,BILD 5,A03,894290,Reuther; Keefe,44,0,50,6
1746558359277,BILD 5,A04,894291,Reuther; Keefe,48,0,50,2
1746558360301,BILD 24,A01,894297,Pirino; Giorgia,40,0,60,20
1746558361329,BIMM 100,B01,958915,Staff,71,0,100,29
1746558362361,BIMM 101,A01,895017,McDonnell; Lisa Marie,0,5,24,24
1746558362361,BIMM 101,A02,895018,McDonnell; Lisa Marie,0,5,24,24
1746558362361,BIMM 101,B01,895020,McDonnell; Lisa Marie,0,6,24,24
1746558362361,BIMM 101,B02,895021,McDonnell; Lisa Marie,0,4,24,24
1746558363391,BIMM 110,A01,895023,Staff,1,0,25,24
1746558363391,BIMM 110,A02,895024,Staff,9,0,25,16
1746558363391,BIMM 110,A03,895025,Staff,18,0,25,7
1746558363391,BIMM 110,A04,895031,Staff,20,0,25,5
1746558364419,BIMM 120,A01,895114,Gustafson-Brown; Cindy,14,0,28,14
1746558364419,BIMM 120,A02,895126,Gustafson-Brown; Cindy,21,0,27,6
1746558365449,BIPN 100,A01,895130,Yang; Mingyu,1,0,38,37
1746558365449,BIPN 100,A02,895131,Yang; Mingyu,32,0,38,6
1746558365449,BIPN 100,A03,895132,Yang; Mingyu,32,0,38,6
1746558365449,BIPN 100,A04,895133,Yang; Mingyu,27,0,36,9
1746558366476,BIPN 120,A01,895135,Cooke; James Edward,0,3,13,13
1746558366476,BIPN 120,A02,895136,Cooke; James Edward,0,1,13,13
1746558366476,BIPN 120,A03,895137,Cooke; James Edward,0,3,13,13
1746558366476,BIPN 120,A04,895156,Cooke; James Edward,0,2,11,11
1746558367501,BIPN 134,A01,895235,Cooke; James Edward,0,2,25,25
1746558367501,BIPN 134,A02,895237,Cooke; James Edward,0,0,25,25
1746558367501,BIPN 134,A03,895240,Cooke; James Edward,3,0,25,22
1746558367501,BIPN 134,A04,895270,Cooke; James Edward,20,0,25,5
1746558368527,BIPN 189,A00,892103,Staff,0,13,14,14
1746558370582,BISP 194,A00,958008,Staff,0,2,0,0
1746558371607,CAT 124,A01,922009,Staff,0,5,20,20
1746558372634,CAT 125R,A00,886390,Morales; Celeste Georgianna,0,2,20,20
1746558372634,CAT 125R,B00,886391,Irwin; Matthew Joseph,0,3,20,20
1746558372634,CAT 125R,C00,886392,Smith; Lauryn Alissa,0,2,20,20
1746558372634,CAT 125R,D00,886393,Vanderschuit; Maya Alysia,0,2,20,20
1746558372634,CAT 125R,E00,886394,Marchisotto; Jennifer Anne,0,4,20,20
1746558373703,CENG 15,A01,886218,Drews; Aaron,3,0,8,5
1746558374729,CENG 113,A00,886219,Opatkiewicz; Justin Paul,15,0,25,10
1746558375755,CGS 101,A00,887044,Staff,7,0,20,13
1746558376780,CGS 105,A01,887046,Staff,14,0,25,11
1746558377805,CGS 112,A00,887047,Cuong; Marisol,12,0,15,3
1746558378833,CGS 113,A00,887048,Staff,23,0,30,7
1746558379859,CGS 120,A00,887049,Staff,10,0,17,7
1746558380889,CHEM 6A,A01,886336,Lam; Tin Yiu,38,0,50,12
1746558380889,CHEM 6A,A02,886338,Lam; Tin Yiu,37,0,50,13
1746558381917,CHEM 6B,A01,886341,Hopkins; Patrycja Anna,16,0,50,34
1746558381917,CHEM 6B,A02,886343,Hopkins; Patrycja Anna,42,0,50,8
1746558382947,CHEM 6C,A01,886346,Albizati; Kim F.,0,2,50,50
1746558382947,CHEM 6C,A02,886348,Albizati; Kim F.,23,0,50,27
1746558383974,CHEM 40A,A01,886352,Klosterman; Jeremy K,65,0,100,35
1746558385005,CHEM 40B,A01,886356,Klosterman; Jeremy K,0,23,100,100
1746558386034,CHEM 41B,A01,886360,Theodorakis; Emmanuel,25,0,50,25
1746558386034,CHEM 41B,A02,886362,Theodorakis; Emmanuel,47,0,50,3
1746558387062,CHIN 165A,A00,886382,Xu; Li,18,0,20,2
1746558388086,CLAS 120,A00,886387,Myerston Santana; Jacobo,33,0,40,7
1746558389111,COGS 9,A01,886967,Shannon; Kyle Michael,42,0,60,18
1746558390136,COGS 11,A01,886969,Staff,11,0,30,19
1746558391163,COGS 14A,A01,886971,Staff,6,0,60,54
1746558392191,COGS 14B,A01,886973,Hoffman; Drew Ellen,4,0,60,56
1746558393217,COGS 18,A01,886975,Morgan; Eric,35,0,60,25
1746558394243,COGS 20,A01,886977,Staff,4,0,8,4
1746558394243,COGS 20,A02,886978,Staff,5,0,7,2
1746558395292,COGS 100,A01,907783,Staff,0,2,30,30
1746558396318,COGS 101B,A01,886980,Staff,0,3,48,48
1746558397345,COGS 101C,A01,886982,Delgado; Tania,0,5,44,44
1746558398374,COGS 102A,A01,886984,Johnson; Christine M.,4,0,30,26
1746558399401,COGS 118B,A01,886986,Staff,0,3,88,88
1746558400428,COGS 150,A01,886988,Bergen; Benjamin,23,0,50,27
1746558401452,COGS 153,A00,886989,Delgado; Tania,0,2,41,41
1746558402477,COGS 186,A01,886991,Staff,0,0,32,32
1746558403500,COGS 187A,A01,886993,Boyle; Mary E. T.,7,0,30,23
1746558404526,COGS 189,A00,886994,Staff,0,1,30,30
1746558405753,COMM 10,A01,886996,Staff,0,0,20,21
1746558405753,COMM 10,A02,886997,Staff,12,0,20,8
1746558405753,COMM 10,A03,959845,Staff,19,0,20,1
1746558406783,COMM 20,A01,886999,Leuning; Grant Maurstad,24,0,40,16
1746558408836,COMM 100A,A01,887002,Staff,0,0,20,25
1746558408836,COMM 100A,A02,887003,Staff,7,0,20,13
1746558409861,COMM 100B,A01,887005,Staff,0,8,20,24
1746558410889,COMM 106D,A00,887006,Staff,14,0,40,26
1746558411917,COMM 110G,A00,887007,Whitworth-Smith; Andrew C,12,0,40,28
1746558412941,COMM 111B,A00,887008,Staff,31,0,40,9
1746558413965,COMM 113T,A00,887009,Abuelhiga; Soraya Jill,28,0,40,12
1746558413965,COMM 113T,B00,906733,Staff,40,0,40,0
1746558414990,COMM 145,A00,887010,Staff,12,0,40,28
1746558416018,COMM 146,A00,887054,Staff,31,0,40,9
1746558417042,COMM 190,A00,887012,Staff,8,0,23,15
1746558418070,CSE 8A,A50,887015,Cao; Yingjun,57,0,85,28
1746558419097,CSE 11,A01,887017,Cao; Yingjun,12,0,70,58
1746558420124,CSE 20,A01,887019,Staff,30,0,50,20
1746558421155,CSE 21,A01,887021,Staff,78,0,100,22
1746558421155,CSE 21,B01,892583,Braun; Oliver,45,0,50,5
1746558422181,CSE 30,A01,887025,Eldon; John,143,0,200,57
1746558423207,CSE 100,A01,887027,Staff,26,0,50,24
1746558423207,CSE 100,A02,887028,Staff,42,0,50,8
1746558424237,CSE 101,A01,887030,Braun; Oliver,74,0,100,26
1746558424237,CSE 101,B01,887032,Jones; Miles E,0,3,50,50
1746558424237,CSE 101,B02,887033,Jones; Miles E,0,1,50,50
1746558425264,CSE 105,A01,908084,Jones; Miles E,32,0,50,18
1746558425264,CSE 105,A02,908087,Jones; Miles E,32,0,50,18
1746558426289,CSE 135,A01,887035,Powell; Thomas Allan,0,4,50,50
1746558427316,CSE 142,A01,887037,Staff,8,0,60,52
1746558428341,CSE 142L,A01,887039,Staff,34,0,60,26
1746558429365,CSE 151A,A01,887041,Solares; Edwin A,47,0,100,53
1746558430391,CSE 175,A01,887043,Kumar; Rakesh,30,0,30,0
1746558431417,CSS 1,A01,886389,Staff,1,1,40,39
1746558432445,DSC 30,A01,908097,Liao; Soohyun Nam,47,0,75,28
1746558433473,DSC 40A,A01,908099,Shannon; Kyle Michael,30,0,50,20
1746558434498,DSC 40B,A01,908112,Staff,16,0,50,34
1746558435579,DSC 80,A01,908116,Staff,19,0,60,41
1746558436607,DSC 197,001,956863,Eldridge; Justin Matthew,9999,0,9999,0
1746558437633,ECE 5,A01,886400,Morris; Karcher William,2,0,6,4
1746558437633,ECE 5,A02,886401,Morris; Karcher William,3,0,6,3
1746558438660,ECE 148,A01,886403,Silberman; Jack,0,14,14,14
1746558439686,ECON 1,A01,887265,Crane; Meredith Helen,12,0,70,58
1746558439686,ECON 1,B01,887268,Staff,43,0,50,7
1746558440711,ECON 2,A01,887273,Crane; Meredith Helen,56,0,70,14
1746558441735,ECON 3,A01,887279,Rondina; Giacomo,32,0,70,38
1746558442761,ECON 4,A01,887282,Anderson; John Charles,0,2,10,10
1746558443786,ECON 5,A01,887285,Staff,33,0,45,12
1746558443786,ECON 5,B01,887292,Staff,41,0,45,4
1746558444811,ECON 100A,A01,887337,Newhouse; Herbert S,54,0,70,16
1746558444811,ECON 100A,B01,887349,Staff,45,0,50,5
1746558445836,ECON 100B,A01,887361,Du; Songzi,29,0,70,41
1746558446861,ECON 100C,A01,887445,Newhouse; Herbert S,59,0,70,11
1746558447885,ECON 105,A00,887488,Vespa; Emanuel Ignacio,23,0,35,12
1746558448909,ECON 109,A01,887506,Shishkin; Denis,28,0,35,7
1746558449933,ECON 110A,A01,887568,Alon; Titan Michael,0,3,35,35
1746558449933,ECON 110A,B01,907601,Alon; Titan Michael,20,0,35,15
1746558450957,ECON 110B,A01,887598,Levkoff; Steven B.,0,24,70,70
1746558451984,ECON 112,A00,887599,Rondina; Giacomo,19,0,35,16
1746558453009,ECON 120A,A01,887603,Dai; Yinlin,35,0,70,35
1746558454034,ECON 120C,A01,887608,Sun; Yixiao,0,1,35,35
1746558454034,ECON 120C,B01,887614,Sun; Yixiao,0,0,35,35
1746558455059,ECON 138,A00,887621,Bharadwaj; Prashant,0,21,20,20
1746558456082,ECON 144,A00,958007,Squires; Dale E,13,0,35,22
1746558457109,ECON 171,A01,907666,Staff,18,0,35,17
1746558458132,ECON 175,A00,887626,Wu; Pak Yeung,23,0,35,12
1746558459161,ECON 190,A00,887640,Vespa; Emanuel Ignacio,23,0,35,12
1746558460187,EDS 25,A01,888197,Staff,0,0,0,0
1746558460187,EDS 25,A02,888209,Staff,0,0,0,0
1746558460187,EDS 25,A03,888210,Staff,0,0,0,0
1746558460187,EDS 25,A04,888212,Staff,0,0,0,0
1746558460187,EDS 25,A05,888213,Staff,0,0,0,0
1746558460187,EDS 25,A06,888214,Staff,0,0,0,0
1746558460187,EDS 25,A07,888235,Staff,0,2,0,0
1746558460187,EDS 25,A08,888236,Staff,0,0,0,0
1746558460187,EDS 25,A09,888240,Staff,0,0,0,0
1746558460187,EDS 25,A10,888244,Staff,0,0,0,0
1746558460187,EDS 25,B01,888273,Staff,0,0,0,0
1746558460187,EDS 25,B02,888285,Staff,0,0,0,0
1746558460187,EDS 25,B03,888423,Staff,0,0,0,1
1746558460187,EDS 25,B04,888432,Staff,0,0,0,0
1746558460187,EDS 25,B05,888433,Staff,0,0,0,0
1746558460187,EDS 25,B06,888467,Staff,0,0,0,0
1746558460187,EDS 25,B07,888468,Staff,0,0,0,0
1746558460187,EDS 25,B08,888479,Staff,0,0,0,0
1746558460187,EDS 25,B09,888484,Staff,0,0,0,0
1746558460187,EDS 25,B10,888487,Staff,0,0,0,0
1746558461212,EDS 38,A01,907700,Choi; Bailey Miyeon,30,0,30,0
1746558462236,EDS 112,A01,888601,Chapman; Thandeka K,13,0,40,27
1746558463262,EDS 115,A00,888697,Mendez; Kathrina Mendoza,10,0,30,20
1746558464287,EDS 116,A01,888893,Staff,35,0,40,5
1746558466337,EDS 124AR,A00,889133,Staff,29,0,50,21
1746558466337,EDS 124AR,B00,907471,Simon; Elizabeth A,37,0,50,13
1746558467362,EDS 124BR,A00,889134,Simon; Elizabeth A,44,0,100,56
1746558468388,EDS 125,A00,889135,Staff,25,0,30,5
1746558469415,EDS 126,A01,889138,Staff,36,0,40,4
1746558470441,EDS 164R,A01,889142,Wishard Guerra; Alison G.,33,0,50,17
1746558471465,ENG 30,A01,886396,Staff,0,0,0,0
1746558471465,ENG 30,B01,886398,Staff,0,0,0,0
1746558472491,ENVR 102,A00,906150,Montejo; Carolina,23,0,25,2
1746558473518,ETHN 103A,A00,887236,Man; Simeon S,0,3,0,0
1746558474543,ETHN 113,A00,887239,Staff,16,0,30,14
1746558475570,ETHN 116,A00,887240,Staff,16,0,25,9
1746558476595,ETHN 117,A00,887241,Choi; Esther Min,28,0,30,2
1746558477618,ETHN 118,A00,887243,Staff,24,0,30,6
1746558478644,ETHN 127,A00,887248,Cuong; Marisol,11,0,15,4
1746558479671,ETHN 139,A00,887250,Staff,7,0,10,3
1746558480698,ETHN 142,A00,887252,Staff,10,0,30,20
1746558481722,ETHN 161,A00,887253,Browne; Errol Tsekani,24,0,30,6
1746558482750,ETHN 163FR,A00,887255,Burelle; Julie Sara Veronique,0,0,5,5
1746558483781,GLBH 20,A00,889149,Elwardani; Nile Regina,8,0,42,34
1746558485833,GLBH 111,A01,889152,Burgos; Jose L.,17,0,17,0
1746558486859,GLBH 150,A00,889181,Sloane; Julia Kathryn,0,5,15,15
1746558488909,HDS 60,A01,886406,Warstadt; Melissa Fawn,73,0,80,7
1746558489935,HIAF 111,A00,889324,Gyamfi; Bright,25,0,32,7
1746558490960,HIEA 131,A00,889328,Staff,16,0,32,16
1746558491985,HIEA 144,A00,889333,Henry; Todd A.,26,0,32,6
1746558493010,HIEA 154,A00,889336,Henry; Todd A.,24,0,32,8
1746558494035,HIEU 106,A00,889339,Staff,22,0,32,10
1746558496086,HIEU 114,A00,889340,Staff,3,0,32,29
1746558497111,HIEU 135GS,A00,889342,Patterson; Patrick H.,0,0,1,24
1746558498140,HIEU 137,A00,889343,Edington; Claire Ellen,9,0,25,16
1746558499166,HIEU 148,A00,889345,Staff,14,0,32,18
1746558500194,HIEU 154,A00,889346,Biess; Frank Peter,21,0,32,11
1746558501222,HILA 102,A00,889351,Staff,12,0,32,20
1746558502249,HILD 2A,A01,889221,Lewandoski; Julia Mavis,1,10,32,31
1746558503276,HILD 7B,A01,889225,Man; Simeon S,0,12,32,32
1746558504304,HILD 7C,A01,889288,Alvarez; Luis A,0,14,32,32
1746558505384,HILD 30,A01,889323,Staff,0,5,32,32
1746558507438,HISC 119,A00,889383,Golan; Tal,20,0,32,12
1746558508463,HIUS 103,A00,889384,Man; Simeon S,0,0,32,32
1746558509488,HIUS 117,A00,919797,Kwak; Nancy,18,0,32,14
1746558510513,HIUS 142A,A00,919788,Staff,22,0,32,10
1746558512565,HIUS 149,A00,889386,Gyamfi; Bright,27,0,32,5
1746558513589,HIUS 155,A00,889387,Alvarez; Luis A,14,0,32,18
1746558514616,HUM 3,A01,886499,Caldwell; Michael Alan,19,0,50,31
1746558515641,HUM 3GS,A00,886500,Rodriguez; Bretton Sigfred,0,0,0,28
1746558516668,HUM 3R,A01,886502,Markman; Kristina,0,36,50,50
1746558517694,HUM 4,A01,886504,Crum; Matthew Stephen,24,0,50,26
1746558517694,HUM 4,B01,886506,West; Geoffrey Scott,17,0,50,33
1746558518719,HUM 4GS,A00,886507,Staff,0,0,0,19
1746558519746,HUM 5,A01,886509,Staff,32,0,50,18
1746558520772,HUM 5R,A01,886511,Zavodny; Tatiana Sophia,0,39,50,50
1746558521800,JAPN 180,A00,886407,Staff,17,0,40,23
1746558522830,LATI 50,A01,886409,Martin-Cabrera; Luis,4,0,22,18
1746558522830,LATI 50,A02,886410,Martin-Cabrera; Luis,19,0,22,3
1746558522830,LATI 50,A03,886411,Martin-Cabrera; Luis,21,0,22,1
1746558522830,LATI 50,A04,886412,Martin-Cabrera; Luis,9,0,22,13
1746558523854,LAWS 101,A00,907664,Staff,28,0,60,32
1746558524880,LIAB 1A,A00,889388,Saab; Dima,17,0,20,3
1746558525905,LIAB 1AX,A00,889389,El Cheddadi; Youniss,17,0,20,3
1746558526930,LIFR 1C,A00,889391,Van Moer; Vinciane G,8,0,20,12
1746558527954,LIFR 1CX,A00,889392,Van Moer; Vinciane G,7,0,20,13
1746558528981,LIFR 1D,A00,889393,Van Moer; Vinciane G,7,0,20,13
1746558530008,LIFR 1DX,A00,889394,Van Moer; Vinciane G,8,0,20,12
1746558531033,LIGN 7,A00,886923,Staff,24,0,50,26
1746558532064,LIGN 17,A00,886924,Kehler; Andrew Scott,125,0,150,25
1746558533091,LTAM 110,A00,889395,Staff,15,0,30,15
1746558534116,LTAM 110GS,A00,958010,Rodriguez; Bretton Sigfred,0,0,0,28
1746558535149,LTCH 101,A00,889397,Staff,23,0,25,2
1746558536175,LTCS 130,A00,889398,Staff,23,0,25,2
1746558537203,LTEA 138,A00,889399,Staff,24,0,40,16
1746558538230,LTEN 149,A00,889400,Wesling; Megan E.,0,3,25,25
1746558539256,LTEN 169,A00,889401,Staff,20,0,25,5
1746558540282,LTEN 180,A00,889402,Staff,10,0,15,5
1746558541313,LTEN 181,A00,889403,Staff,21,0,25,4
1746558542339,LTWL 100,A00,889404,Myerston Santana; Jacobo,2,0,25,23
1746558543367,LTWL 180GS,A00,889405,Staff,0,0,20,20
1746558544391,LTWL 181,A00,889406,Staff,16,0,25,9
1746558545417,LTWL 184,A00,889475,Mukherjee; Silpa,22,0,25,3
1746558546445,LTWR 102C,A00,889486,Staff,29,0,30,1
1746558547470,LTWR 115W,A00,889491,Staff,0,2,15,15
1746558548497,MAE 8,A01,886905,Staff,0,2,0,0
1746558549525,MAE 11,A00,886906,Bandaru; Prabhakar,0,7,50,50
1746558550551,MAE 20,A00,886907,Evdokimenko; Ekaterina,43,0,70,27
1746558551575,MAE 30B,A00,886909,Ghazinejad; Maziar,26,0,45,19
1746558552604,MAE 101B,A00,886910,Saintillan; David,29,0,45,16
1746558553634,MAE 105,A00,886911,Bandaru; Prabhakar,18,0,50,32
1746558554661,MAE 107,B00,958024,Staff,8,0,50,42
1746558555685,MAE 143B,A00,886913,Bewley; Thomas R,6,0,40,34
1746558556712,MAE 148,A01,886915,Silberman; Jack,0,3,14,14
1746558557736,MAE 160,A00,886916,Evdokimenko; Ekaterina,32,0,60,28
1746558558763,MATH 3C,A01,889681,Staff,0,3,30,30
1746558558763,MATH 3C,A02,960048,Staff,25,0,30,5
1746558559787,MATH 10A,A01,889760,Staff,26,0,30,4
1746558559787,MATH 10A,A02,889783,Staff,29,0,30,1
1746558560814,MATH 10B,A01,889785,Verstraete; Jacques Allan,2,0,35,33
1746558560814,MATH 10B,A02,889795,Verstraete; Jacques Allan,4,0,35,31
1746558560814,MATH 10B,B01,889797,Verstraete; Jacques Allan,3,0,35,32
1746558560814,MATH 10B,B02,889828,Verstraete; Jacques Allan,3,0,35,32
1746558561839,MATH 10C,A01,889849,Habib; Yousaf,8,0,30,22
1746558561839,MATH 10C,A02,889852,Habib; Yousaf,14,0,30,16
1746558561839,MATH 10C,A03,889853,Habib; Yousaf,22,0,30,8
1746558561839,MATH 10C,A04,889858,Habib; Yousaf,20,0,30,10
1746558561839,MATH 10C,B01,889861,Staff,1,0,30,29
1746558561839,MATH 10C,B02,889862,Staff,24,0,30,6
1746558561839,MATH 10C,B03,889863,Staff,27,0,30,3
1746558561839,MATH 10C,B04,889967,Staff,23,0,30,7
1746558562865,MATH 18,A01,889974,Staff,7,0,30,23
1746558562865,MATH 18,A02,889977,Staff,20,0,30,10
1746558562865,MATH 18,B01,889984,Hardiman; Liam,21,0,30,9
1746558562865,MATH 18,B02,889985,Hardiman; Liam,25,0,30,5
1746558563893,MATH 20A,A01,889990,Suk; Andrew Hoon,30,0,35,5
1746558564924,MATH 20B,A01,889993,Ohm; Ko Woon,22,0,30,8
1746558564924,MATH 20B,A02,889994,Ohm; Ko Woon,30,0,30,0
1746558564924,MATH 20B,B01,889996,Ohm; Ko Woon,21,0,30,9
1746558564924,MATH 20B,B02,889997,Ohm; Ko Woon,23,0,30,7
1746558565951,MATH 20C,A01,889999,Hammock; Frances H,17,0,30,13
1746558565951,MATH 20C,A02,890003,Hammock; Frances H,23,0,30,7
1746558565951,MATH 20C,B01,890006,Hammock; Frances H,3,0,30,27
1746558565951,MATH 20C,B02,890007,Hammock; Frances H,11,0,30,19
1746558566977,MATH 20D,A01,890011,Cheng; Hsiao-Bing,1,1,30,29
1746558566977,MATH 20D,A02,890012,Cheng; Hsiao-Bing,14,0,30,16
1746558566977,MATH 20D,B01,890016,Cheng; Hsiao-Bing,13,0,30,17
1746558566977,MATH 20D,B02,890017,Cheng; Hsiao-Bing,13,0,30,17
1746558568007,MATH 20E,A01,890026,Harel; Guershon,1,0,30,29
1746558568007,MATH 20E,A02,890029,Harel; Guershon,23,0,30,7
1746558568007,MATH 20E,B01,890033,Harel; Guershon,7,0,30,23
1746558568007,MATH 20E,B02,890101,Harel; Guershon,21,0,30,9
1746558569030,MATH 102,A01,890104,Staff,17,0,30,13
1746558569030,MATH 102,A02,890105,Staff,27,0,30,3
1746558570057,MATH 103B,A01,890116,Salehi Golsefidy; Alireza,3,0,30,27
1746558570057,MATH 103B,B01,890118,Staff,0,3,34,34
1746558571082,MATH 109,A01,890121,Aliabadi Sr.; Mohsen,1,0,30,29
1746558571082,MATH 109,B01,890124,Upadrashta; Pranav Kumar,18,0,30,12
1746558572108,MATH 120A,A01,890126,Eggers; John Dietrich,13,0,30,17
1746558573133,MATH 142B,A01,890128,Ioana; Adrian,19,0,30,11
1746558573133,MATH 142B,A02,890129,Ioana; Adrian,13,0,30,17
1746558574162,MATH 154,A01,890174,Staff,0,0,30,30
1746558574162,MATH 154,A02,890182,Staff,0,0,30,30
1746558575190,MATH 168A,A01,890197,Dumitriu; Ioana,21,0,35,14
1746558576216,MATH 170A,A01,890240,Nie; Jiawang,1,0,30,29
1746558576216,MATH 170A,A02,890241,Nie; Jiawang,11,0,30,19
1746558576216,MATH 170A,A03,890249,Nie; Jiawang,23,0,30,7
1746558577242,MATH 170B,A01,957891,Nag; Panchali,13,0,35,22
1746558579294,MATH 181A,A01,908025,Staff,0,4,35,35
1746558579294,MATH 181A,A02,960115,Staff,27,0,35,8
1746558580318,MATH 181B,A01,959874,Staff,25,0,30,5
1746558581342,MATH 193B,A01,890265,Staff,0,4,35,35
1746558582369,MGT 4,A01,890311,Anderson; John Charles,42,0,88,46
1746558583394,MGT 5,A00,907740,Staff,13,0,98,85
1746558584421,MGT 12,A00,890312,Lindenberger; Wade Douglas,67,0,98,31
1746558585449,MGT 16,A00,957883,Staff,78,0,98,20
1746558587498,MGT 45,A00,890314,Pecore; Joseph P.,46,0,98,52
1746558588525,MGT 71,A00,890315,Staff,0,11,98,98
1746558589553,MGT 100,A00,890316,Yavorsky; Daniel Ryan,44,0,98,54
1746558590577,MGT 103,A00,890317,Ehrich; Kristine R,73,0,98,25
1746558591601,MGT 105,A00,890356,Bates; Kenneth Walter,0,8,98,98
1746558592626,MGT 112,A00,890360,Ehrich; Kristine R,55,0,98,43
1746558593652,MGT 127R,A00,907732,Zhu; Kevin Xiaoguo,24,0,98,74
1746558594677,MGT 131B,A00,890361,Anderson; John Charles,60,0,98,38
1746558595701,MGT 137,A00,890362,Lindenberger; Wade Douglas,65,0,98,33
1746558596728,MGT 160,A00,890369,Johnson; Erik Barry,9,0,98,89
1746558598785,MGT 164,A00,890372,Zimmermann; Carsten,0,40,98,98
1746558599811,MGT 180,A00,890374,Bliss; Barbara Ann,12,0,98,86
1746558600844,MMW 15,A01,886414,Chang; Edmond Yi-Teh,0,12,28,28
1746558600844,MMW 15,A02,886415,Chang; Edmond Yi-Teh,0,8,28,28
1746558600844,MMW 15,A03,886416,Chang; Edmond Yi-Teh,0,8,28,28
1746558600844,MMW 15,A04,886417,Chang; Edmond Yi-Teh,0,8,28,28
1746558600844,MMW 15,B01,886419,Chang; Edmond Yi-Teh,0,7,28,28
1746558600844,MMW 15,B02,886420,Chang; Edmond Yi-Teh,0,8,28,28
1746558600844,MMW 15,B03,886421,Chang; Edmond Yi-Teh,0,7,28,28
1746558600844,MMW 15,B04,886422,Chang; Edmond Yi-Teh,0,8,28,28
1746558600844,MMW 15,C01,886424,Staff,0,9,28,28
1746558600844,MMW 15,C02,886425,Staff,0,8,28,28
1746558600844,MMW 15,C03,886426,Staff,0,8,28,28
1746558600844,MMW 15,C04,886427,Staff,0,8,28,28
1746558600844,MMW 15,C05,958038,Staff,0,8,28,28
1746558600844,MMW 15,C06,958039,Staff,0,8,28,28
1746558601872,MMW 15GS,A00,906910,Patterson; Patrick H.,4,0,28,24
1746558602901,MMW 122R,A01,886429,Rahimi; Babak,0,13,28,28
1746558602901,MMW 122R,A02,886430,Rahimi; Babak,0,12,28,28
1746558602901,MMW 122R,A03,958040,Rahimi; Babak,0,11,28,28
1746558603927,MUS 1A,A01,890937,Staff,2,0,25,23
1746558603927,MUS 1A,A02,891035,Staff,6,0,25,19
1746558603927,MUS 1A,C01,958912,Staff,24,0,25,1
1746558603927,MUS 1A,C02,958913,Staff,25,0,25,0
1746558605979,MUS 2AK,A00,957092,Ohnishi; Takae,15,0,15,0
1746558607009,MUS 4,A01,891044,Staff,2,0,25,23
1746558607009,MUS 4,A02,891045,Staff,23,0,25,2
1746558607009,MUS 4,B01,891048,Staff,17,0,25,8
1746558607009,MUS 4,B02,891050,Staff,25,0,25,0
1746558608035,MUS 5,A01,957506,Dubnov; Shlomo,0,0,25,25
1746558608035,MUS 5,A02,957622,Dubnov; Shlomo,13,0,25,12
1746558608035,MUS 5,A03,957623,Dubnov; Shlomo,20,0,25,5
1746558609100,MUS 6,A01,891053,Freitas Caetano; Marcelo,24,0,25,1
1746558609100,MUS 6,A02,891054,Freitas Caetano; Marcelo,23,0,25,2
1746558610125,MUS 7,A01,891081,Staff,0,0,25,25
1746558610125,MUS 7,A02,891082,Staff,4,0,25,21
1746558629888,MUS 8GS,A00,891118,Borgo; David Garcia,0,0,25,25
1746558630914,MUS 11,A01,891140,Staff,10,0,25,15
1746558630914,MUS 11,A02,891141,Staff,22,0,25,3
1746558631939,MUS 13,A01,891143,Staff,8,0,25,17
1746558631939,MUS 13,A02,891144,Staff,24,0,25,1
1746558632966,MUS 15,A01,891146,Staff,9,0,25,16
1746558632966,MUS 15,A02,891148,Staff,21,0,25,4
1746558632966,MUS 15,B01,891150,Staff,18,0,25,7
1746558632966,MUS 15,B02,891151,Staff,25,0,25,0
1746558633992,MUS 20,A01,891153,Staff,5,0,20,15
1746558633992,MUS 20,A02,891155,Staff,14,0,20,6
1746558635018,MUS 80,A00,891156,Staff,19,0,25,6
1746558635018,MUS 80,B00,891157,Staff,23,0,25,2
1746558636046,MUS 130,A00,891158,Ohnishi; Takae,35,0,35,0
1746558637074,MUS 150GS,A01,891160,Borgo; David Garcia,0,0,25,25
1746558638100,MUS 170,A01,891162,Freitas Caetano; Marcelo,20,0,25,5
1746558638100,MUS 170,A02,891164,Freitas Caetano; Marcelo,21,0,25,4
1746558639166,NANO 11,A00,886220,Vazquez Mena; Oscar,13,0,15,2
1746558640194,NANO 15,A01,886222,Drews; Aaron,4,0,7,3
1746558641222,NANO 104,A00,886224,Sirbuly; Donald,18,0,25,7
1746558642249,PH 40,A00,886528,Staff,23,0,40,17
1746558643277,PH 45,A01,886799,Staff,35,0,40,5
1746558644302,PH 110,A00,886802,Staff,0,7,40,40
1746558645326,PH 172,A00,906716,Staff,19,0,35,16
1746558646351,PH 191,A00,886803,Staff,6,0,40,34
1746558647376,PHIL 1,A00,889500,Staff,20,0,30,10
1746558648404,PHIL 10,A01,889549,Grush; Rick Scott,15,0,22,7
1746558648404,PHIL 10,A02,889551,Grush; Rick Scott,22,0,22,0
1746558649432,PHIL 28,A01,889559,Lamey; Andy M.,0,1,31,31
1746558649432,PHIL 28,A02,889561,Lamey; Andy M.,0,1,30,30
1746558649432,PHIL 28,A03,889572,Lamey; Andy M.,0,1,30,30
1746558650461,PHIL 35,A00,907839,Staff,13,0,15,2
1746558651489,PHIL 60,A00,889574,Staff,73,0,90,17
1746558652515,PHIL 101,A00,958004,Staff,12,0,15,3
1746558654569,PHIL 136,A00,889582,Fulkerson; Matthew Todd,26,0,45,19
1746558655599,PHIL 163,A01,889601,Staff,21,0,30,9
1746558655599,PHIL 163,B01,889606,Brandt; Reuven A,0,3,0,0
1746558656624,PHIL 164,A00,889610,Staff,16,0,30,14
1746558657652,PHIL 165,A00,889613,Staff,23,0,30,7
1746558658680,PHYS 1A,A00,886431,Staff,26,0,70,44
1746558659711,PHYS 1AL,001,886432,Tsai; Philbert S,0,2,30,30
1746558659711,PHYS 1AL,002,886436,Tsai; Philbert S,11,0,30,19
1746558660738,PHYS 1B,A00,886439,Staff,185,0,240,55
1746558661763,PHYS 1BL,001,886441,Tsai; Philbert S,0,4,30,30
1746558661763,PHYS 1BL,002,886444,Tsai; Philbert S,2,0,30,28
1746558662790,PHYS 1C,A00,896092,Arnold; Kam S,78,0,146,68
1746558663818,PHYS 1CL,001,886448,Tsai; Philbert S,0,0,30,30
1746558663818,PHYS 1CL,002,886449,Tsai; Philbert S,0,0,30,30
1746558663818,PHYS 1CL,003,886450,Tsai; Philbert S,16,0,30,14
1746558663818,PHYS 1CL,004,886451,Tsai; Philbert S,15,0,30,15
1746558664845,PHYS 2B,A01,886457,Staff,68,0,115,47
1746558665873,PHYS 2C,A01,886460,Shotwell; Brian,0,9,65,65
1746558666898,PHYS 2CL,A01,886467,Staff,0,4,28,28
1746558666898,PHYS 2CL,A02,886468,Staff,0,3,28,28
1746558667923,PHYS 2D,A01,886470,Staff,10,0,50,40
1746558668950,PHYS 4B,A01,886475,Grinstein; Benjamin,22,0,40,18
1746558669976,POLI 5,A00,891173,Desposato; Scott,7,0,25,18
1746558671004,POLI 5D,A01,891175,Staff,5,0,5,0
1746558671004,POLI 5D,B01,891178,Staff,5,0,5,0
1746558672029,POLI 11,A00,891179,Ferree; Karen E,2,0,35,33
1746558673058,POLI 12,A00,891180,Staff,16,0,30,14
1746558674086,POLI 27,A01,891182,Staff,12,0,75,63
1746558675115,POLI 30,A00,891183,Staff,8,0,50,42
1746558676139,POLI 100B,A00,891244,Staff,5,1,35,30
1746558677167,POLI 100I,A00,891247,Staff,7,0,30,23
1746558678191,POLI 104J,A00,891248,Nichter; Maysa,14,0,30,16
1746558679217,POLI 104U,A00,891250,Nichter; Maysa,2,0,30,28
1746558681272,POLI 110B,A00,891255,Wiens; David,20,0,25,5
1746558682303,POLI 112A,A00,891256,Wiens; David,6,0,25,19
1746558683327,POLI 114BR,A00,891261,Staff,19,0,30,11
1746558684357,POLI 117R,A00,891262,Forman; Fonna,0,6,50,50
1746558685382,POLI 118,A00,891264,Ingham; Sean,17,0,25,8
1746558686406,POLI 124A,A00,891265,Staff,18,0,20,2
1746558687433,POLI 125D,A00,891266,Nichter; Simeon C,2,0,25,23
1746558688461,POLI 126,A00,891268,Nichter; Simeon C,7,0,25,18
1746558689490,POLI 126AA,A00,891272,Staff,17,0,25,8
1746558690518,POLI 130AA,A00,891273,Staff,15,0,20,5
1746558691545,POLI 134AA,A00,891274,Staff,4,0,20,16
1746558693599,POLI 138,A00,891278,Staff,21,0,25,4
1746558694626,POLI 142K,A00,891280,Staff,11,0,25,14
1746558695653,POLI 142M,A00,891281,Gartzke; Erik,17,0,30,13
1746558696677,POLI 142P,A00,891284,Staff,20,0,30,10
1746558697703,POLI 143,A00,891285,Gartzke; Erik,12,0,30,18
1746558698731,POLI 153,A00,891286,Staff,19,0,20,1
1746558700781,POLI 175,A00,891290,Staff,15,0,20,5
1746558701808,PSYC 1,A00,890674,Steiner; Eric Tomas,0,11,45,45
1746558702833,PSYC 2,A00,890676,Albright; Thomas D,21,0,35,14
1746558703858,PSYC 3,A00,890679,Staff,17,0,20,3
1746558704908,PSYC 6,A00,959858,Staff,20,0,20,0
1746558705935,PSYC 60,A01,890684,Rickard; Timothy C.,0,5,45,45
1746558706959,PSYC 70,A01,890689,Geller; Emma Harlan,7,0,30,23
1746558707984,PSYC 71,A01,959860,Staff,21,0,25,4
1746558709010,PSYC 100,A00,890690,Lacefield; Katharine I,0,50,180,180
1746558710037,PSYC 102,A00,890695,Staff,18,0,40,22
1746558711065,PSYC 105,A00,890699,Geller; Emma Harlan,70,0,100,30
1746558712089,PSYC 106,A00,890701,Gorman; Michael R.,6,0,30,24
1746558713120,PSYC 108,A00,890704,Adrian; Julia Anna,0,28,50,50
1746558714144,PSYC 118,A01,890712,Staff,11,0,30,19
1746558715172,PSYC 124,A00,890716,Chapman; Eddie Nathaniel,25,0,60,35
1746558716196,PSYC 131,A00,890717,Anagnostaras; Stephan,0,7,80,80
1746558717220,PSYC 137,A00,890719,Winkielman; Piotr,0,11,30,30
1746558718248,PSYC 144,A00,890721,Adrian; Julia Anna,0,9,45,45
1746558719276,PSYC 162,A00,890805,Staff,2,0,75,73
1746558720305,PSYC 169,A00,890810,Staff,0,14,30,30
1746558721333,PSYC 172,A00,890814,Gorman; Michael R.,9,0,30,21
1746558722359,PSYC 181,A00,890818,Anagnostaras; Stephan,9,0,200,191
1746558723387,PSYC 184,A00,959861,Staff,170,0,175,5
1746558724413,PSYC 189,A00,890823,Staff,0,1,30,30
1746558725440,PSYC 191,A00,890884,Rickard; Timothy C.,0,11,35,35
1746558726464,PSYC 193,A00,890913,Staff,19,0,30,11
1746558726464,PSYC 193,B00,890914,Chapman; Eddie Nathaniel,24,0,30,6
1746558727492,PSYC 193L,A01,890918,Lowe; Angela Beth,20,0,30,10
1746558727492,PSYC 193L,B01,890921,Hurwitz; Ethan Scott,20,0,30,10
1746558727492,PSYC 193L,C01,890928,Staff,30,0,30,0
1746558728520,RELI 149,A00,886806,Rahimi; Babak,23,0,40,17
1746558729545,SE 9,A01,886814,Staff,7,0,20,13
1746558730574,SE 101B,A01,886816,Chadha; Mayank,4,0,35,31
1746558731600,SE 110B,A00,886818,Zhu; Qiang,4,0,75,71
1746558732629,SE 125,A01,886830,Staff,10,0,30,20
1746558733657,SE 130B,A01,886835,Staff,14,0,40,26
1746558734685,SE 131A,A01,886838,Krysl; Petr,34,0,55,21
1746558735709,SE 154,A00,886840,Staff,29,0,50,21
1746558736736,SE 164GS,A01,886849,Staff,6,0,20,14
1746558737762,SE 167GS,A01,886853,Staff,6,0,20,14
1746558738790,SIO 25,A01,890107,Staff,19,0,30,11
1746558739815,SIO 45,A00,890109,Cook; Geoffrey W,117,0,200,83
1746558740845,SIO 109R,A00,890110,Forman; Fonna,0,16,20,20
1746558741871,SIO 187,A01,890114,Kacev; David,15,0,40,25
1746558742896,SOCI 1,A01,890431,Thorpe; Charles Robert,15,0,30,15
1746558742896,SOCI 1,A02,890518,Thorpe; Charles Robert,30,0,30,0
1746558743923,SOCI 2,A01,957978,Staff,25,0,25,0
1746558743923,SOCI 2,A02,957979,Staff,23,0,25,2
1746558744955,SOCI 20,A01,890523,Calderon-Zaks; Michael Aar,23,0,30,7
1746558744955,SOCI 20,A02,890526,Calderon-Zaks; Michael Aar,29,0,30,1
1746558745979,SOCI 30,A01,890533,Pardo Guerra; Juan Pablo,37,0,40,3
1746558747006,SOCI 40,A01,890535,Staff,27,0,45,18
1746558748031,SOCI 104Q,A00,890559,Staff,18,0,30,12
1746558749057,SOCI 106,A00,890560,Arnal; Maud Marie Leonie,20,0,30,10
1746558750083,SOCI 110,A00,890567,Holkenbrink-Monk; Charlene,19,0,30,11
1746558751131,SOCI 112,A00,890568,Victoria Torres; Pablo,2,0,55,53
1746558752157,SOCI 115,A00,890597,Arnal; Maud Marie Leonie,28,0,45,17
1746558754207,SOCI 121,A00,890604,Pardo Guerra; Juan Pablo,38,0,45,7
1746558755232,SOCI 126,A01,890608,Staff,8,0,10,2
1746558756258,SOCI 127,A00,890609,Staff,18,0,30,12
1746558757285,SOCI 131,A00,890610,Thorpe; Charles Robert,37,0,45,8
1746558758315,SOCI 135,A00,890615,Payne; Christine Anna,13,0,45,32
1746558759345,SOCI 139,A00,890620,Staff,38,0,45,7
1746558760374,SOCI 148E,A00,890622,Calderon-Zaks; Michael Aar,36,0,45,9
1746558761402,SOCI 150,A00,890623,Kohler; Kristopher M.,31,0,45,14
1746558762429,SOCI 157,A00,890625,Jules-Rosette; Bennetta W.,18,0,20,2
1746558763458,SOCI 160,A00,890627,Payne; Christine Anna,21,0,45,24
1746558764485,SYN 1,A00,886855,Fish; Gwendolyn Anne,0,0,0,0
1746558764485,SYN 1,B00,906086,Fish; Gwendolyn Anne,0,1,0,2
1746558765512,SYN 2R,A00,886860,Staff,0,17,15,15
1746558765512,SYN 2R,B00,906106,Atkinson; Arthur Laird,0,16,15,15
1746558766544,SYN 100,A01,886866,Browne; Emily,0,28,20,20
1746558766544,SYN 100,B01,906128,Rock; Martin,0,5,20,20
1746558766544,SYN 100,C01,906140,Deavenport; James Cary,0,3,20,20
1746558766544,SYN 100,D01,907816,Deavenport; James Cary,0,5,20,20
1746558767574,TDAC 1,A00,890286,Walsh; Kim C.,8,0,20,12
1746558768597,TDAC 101,A00,890296,Basso; Beatrice,15,0,20,5
1746558769624,TDDE 131,A00,890297,Staff,47,0,50,3
1746558770652,TDDM 1,A00,890287,Weinberg; Sadie,25,0,30,5
1746558771682,TDGE 11,A00,890288,Fulton; Julia,137,0,200,63
1746558771682,TDGE 11,B00,890289,Castro; Robert Jess,184,0,200,16
1746558772708,TDGE 25,B00,957359,Walsh; Kim C.,3,0,20,17
1746558773734,TDGE 40,A01,890292,Power; Jade Yukana,27,0,30,3
1746558774763,TDGE 124,A00,890298,Havis; Allan,0,1,50,50
1746558775789,TDGE 131R,A00,890299,Burelle; Julie Sara Veronique,15,0,42,27
1746558776813,TDHT 101,A00,890300,Staff,10,0,20,10
1746558777839,TDHT 109,A01,890302,Anderson; Mysia Anyse,31,0,40,9
1746558778868,TDMV 1,A00,890293,Arcidiacono; Kristin,18,0,30,12
1746558779895,TDMV 2,A00,890294,Weinberg; Sadie,23,0,30,7
1746558780924,TDMV 3,A00,957878,Arcidiacono; Kristin,28,0,30,2
1746558782978,TDMV 138,A00,890304,Jun; Grace Shin Hae,25,0,40,15
1746558784003,TDMV 140,A00,890305,Corrales; Joseph Bernales,25,0,30,5
1746558785028,TDMV 142,A00,890307,Caligagan; Tony,32,0,40,8
1746558786052,TDMV 144,A00,890308,Camaya; Michelle Ann,25,0,30,5
1746558787080,TDPW 1,A00,890295,Stein; Deborah Isobel,3,0,20,17
1746558788107,USP 2,A01,890272,Lerner; Amy M,6,0,20,14
1746558789136,USP 3,A01,890274,Staff,12,0,30,18
1746558790160,USP 15,A01,890276,Sun; Feiyang,16,0,30,14
1746558791187,USP 25,A00,890277,Shenkman; Michael Thomas,19,0,25,6
1746558792212,USP 138,A00,890278,Staff,13,0,25,12
1746558793239,USP 143,A00,890279,Staff,21,0,70,49
1746558794266,USP 144,A00,890280,Chowdhury; Muhammed Zohir,15,0,30,15
1746558795291,USP 150,A00,890281,Boomhower; Matthew Charles,4,0,30,26
1746558796315,USP 151,A00,890282,Staff,16,0,20,4
1746558797341,USP 162,A00,890283,Andrews; Abigail Leslie,16,0,20,4
1746558798369,USP 168,A00,920477,Kwak; Nancy,1,0,5,4
1746558799396,USP 181,A00,890284,Staff,3,0,20,17
1746558800423,USP 191A,A00,890285,Staff,12,0,20,8
1746558801449,VIS 101,A00,886512,Staff,26,0,75,49
1746558802476,VIS 103,A00,886513,Cruz; Edwin Teddy,61,0,75,14
1746558803501,VIS 108,A00,886514,Staff,3,0,15,12
1746558804527,VIS 127P,A00,886515,Shen; Kuiyi,80,0,146,66
1746558805552,VIS 149,A00,886516,Yoldas; Pinar,0,0,15,15
1746558806578,VIS 164,A00,886526,Erdmann; Dean,19,0,22,3
1746558807606,VIS 194S,A00,886527,Staff,61,0,75,14
1746558808636,WCWP 10A,C00,886484,Martiniuk; Jill,12,0,15,3
1746558809660,WCWP 10B,A00,886490,Uriarte; Emma,0,0,15,15
1746558809660,WCWP 10B,B00,886491,Dhir; Simrita,10,0,15,5
1746558809660,WCWP 10B,C00,886492,Ornelas; Tricia,0,0,15,15
1746558810685,WCWP 100,A00,886494,Young; Mark T,0,6,15,15
1746558812810,AAS 10,A01,886199,Childs; Dennis R.,0,3,0,0
1746558813837,ANAR 104,A01,886940,Shtienberg; Gilad,27,0,30,3
1746558814864,ANAR 120,A00,886953,Staff,12,0,20,8
1746558815891,ANBI 148,A01,886955,Wilder; Linnea Lorene,30,0,40,10
1746558817939,ANSC 122,A00,886957,Staff,25,0,30,5
1746558818962,ANSC 150,A00,886958,Sloane; Julia Kathryn,2,0,15,13
1746558819992,ANSC 156,A00,886959,Jenkins; Janis A.,0,1,15,15
1746558821016,ANSC 180,A00,886960,Staff,11,0,17,6
1746558822044,ANSC 188,A00,886961,Jassal; Aftab,9,0,25,16
1746558823071,ANSC 190,A00,886962,Jassal; Aftab,14,0,25,11
1746558824099,ANSC 191,A00,886963,Staff,18,0,20,2
1746558825123,ANTH 3,A01,891689,Staff,17,0,20,3
1746558826147,ANTH 5,A00,886933,Semendeferi; Ekaterini,16,0,20,4
1746558827171,ANTH 10,A00,886934,Staff,0,12,30,30
1746558828198,ANTH 21,A01,886936,Staff,40,0,60,20
1746558829226,ANTH 23,A01,886938,Staff,92,0,100,8
1746558830253,ANTH 105,A00,886964,Stewart; Alexander B,84,0,100,16
1746558831278,ANTH 108,A00,886965,Pedersen; David,9,0,20,11
1746558832309,AWP 10,001,886147,Staff,0,0,0,0
1746558832309,AWP 10,002,886148,Staff,0,0,0,0
1746558832309,AWP 10,003,886149,Staff,0,0,0,0
1746558832309,AWP 10,004,886150,Staff,0,0,0,0
1746558832309,AWP 10,005,886151,Staff,0,0,0,0
1746558832309,AWP 10,006,886152,Staff,0,0,0,0
1746558832309,AWP 10,007,886153,Staff,0,0,0,0
1746558832309,AWP 10,008,886154,Staff,0,0,0,0
1746558832309,AWP 10,009,886155,Staff,0,0,0,0
1746558832309,AWP 10,010,886156,Staff,0,0,0,0
1746558832309,AWP 10,011,886158,Staff,0,0,0,0
1746558832309,AWP 10,012,886160,Staff,0,0,0,0
1746558832309,AWP 10,013,886161,Staff,0,0,0,0
1746558832309,AWP 10,014,886162,Staff,0,0,0,0
1746558832309,AWP 10,015,886163,Staff,0,0,0,0
1746558832309,AWP 10,016,886164,Staff,0,0,0,0
1746558832309,AWP 10,017,886165,Staff,0,0,0,0
1746558832309,AWP 10,018,886166,Staff,0,0,0,0
1746558832309,AWP 10,019,886168,Staff,0,0,0,0
1746558832309,AWP 10,020,886170,Staff,0,0,0,0
1746558832309,AWP 10,021,886172,Staff,0,0,0,0
1746558833335,AWP 10R,001,886173,Staff,0,1,0,0
1746558833335,AWP 10R,002,886174,Staff,0,1,0,0
1746558833335,AWP 10R,003,886175,Staff,0,0,0,0
1746558833335,AWP 10R,004,886176,Staff,0,0,0,0
1746558833335,AWP 10R,005,886177,Staff,0,0,0,0
1746558833335,AWP 10R,006,886178,Staff,0,0,0,0
1746558833335,AWP 10R,007,886179,Staff,0,0,0,0
1746558833335,AWP 10R,008,886181,Staff,0,0,0,0
1746558833335,AWP 10R,009,886182,Staff,0,0,0,0
1746558833335,AWP 10R,010,886183,Staff,0,0,0,0
1746558833335,AWP 10R,011,886184,Staff,0,0,0,0
1746558833335,AWP 10R,012,886185,Staff,0,0,0,0
1746558833335,AWP 10R,013,886186,Staff,0,0,0,0
1746558833335,AWP 10R,014,886187,Staff,0,0,0,0
1746558833335,AWP 10R,015,886188,Staff,0,0,0,0
1746558833335,AWP 10R,016,886189,Staff,0,0,0,0
1746558833335,AWP 10R,017,960532,Staff,0,0,0,0
1746558833335,AWP 10R,018,960533,Staff,0,0,0,0
1746558833335,AWP 10R,019,960534,Staff,0,0,0,0
1746558833335,AWP 10R,020,960538,Staff,0,0,0,0
1746558833335,AWP 10R,021,960540,Staff,0,0,0,0
1746558833335,AWP 10R,022,960541,Staff,0,0,0,0
1746558833335,AWP 10R,023,960542,Staff,0,0,0,0
1746558833335,AWP 10R,024,960544,Staff,0,0,0,0
1746558833335,AWP 10R,025,960545,Staff,0,0,0,0
1746558833335,AWP 10R,026,960548,Staff,0,0,0,0
1746558834365,AWP 102R,A00,886190,Staff,0,0,0,0
1746558834365,AWP 102R,B00,886191,Staff,0,0,0,0
1746558835392,BENG 100,A01,886193,Staff,17,0,30,13
1746558836420,BENG 122A,A01,886195,Hasty; Jeff M,13,0,30,17
1746558837445,BENG 166A,A00,886196,Sah; Robert Lie-Yuan,0,2,30,30
1746558838474,BENG 190,A00,958050,Khojah; Reem I,22,0,25,3
1746558839501,BIBC 102,A01,894320,Staff,0,0,46,46
1746558839501,BIBC 102,A02,894321,Staff,0,0,46,46
1746558839501,BIBC 102,A03,894344,Staff,7,0,46,39
1746558839501,BIBC 102,A04,894345,Staff,26,0,47,21
1746558840527,BICD 100R,A01,894365,Smith; Laurie,0,4,58,58
1746558840527,BICD 100R,A02,894366,Smith; Laurie,0,5,58,58
1746558840527,BICD 100R,A03,894367,Smith; Laurie,1,0,59,58
1746558840527,BICD 100R,A04,959869,Smith; Laurie,41,0,59,18
1746558841551,BICD 136,A01,894383,Gustafson-Brown; Cindy,14,0,50,36
1746558842577,BIEB 102,A01,894494,Butler; Shannon Rhey,51,0,130,79
1746558844625,BIEB 150,A01,894617,Wills; Christopher,3,0,20,17
1746558844625,BIEB 150,A02,894631,Wills; Christopher,3,0,20,17
1746558844625,BIEB 150,A03,894937,Wills; Christopher,3,0,20,17
1746558844625,BIEB 150,A04,894946,Wills; Christopher,5,0,20,15
1746558845651,BIEB 194,A00,906141,Kurle; Carolyn M.,6,0,20,14
1746558846677,BILD 1,A01,894154,Staff,3,0,19,16
1746558846677,BILD 1,A02,894155,Staff,14,0,19,5
1746558846677,BILD 1,A03,894160,Staff,13,0,19,6
1746558846677,BILD 1,A04,894161,Staff,15,0,18,3
1746558847703,BILD 2,A01,894168,Staff,0,0,50,50
1746558847703,BILD 2,A02,894169,Staff,0,0,50,50
1746558847703,BILD 2,A03,894179,Staff,0,0,50,50
1746558847703,BILD 2,A04,894203,Staff,26,0,50,24
1746558848728,BILD 3,A01,894213,Staff,22,0,31,9
1746558848728,BILD 3,A02,894214,Staff,26,0,31,5
1746558848728,BILD 3,A03,894235,Staff,28,0,31,3
1746558848728,BILD 3,A04,894236,Staff,28,0,32,4
1746558849756,BILD 4,A01,894253,Reuther; Keefe,5,0,24,19
1746558849756,BILD 4,A02,894258,Reuther; Keefe,16,0,24,8
1746558850781,BILD 5,A01,894276,Reuther; Keefe,35,0,50,15
1746558850781,BILD 5,A02,894277,Reuther; Keefe,45,0,50,5
1746558850781,BILD 5,A03,894290,Reuther; Keefe,44,0,50,6
1746558850781,BILD 5,A04,894291,Reuther; Keefe,48,0,50,2
1746558851808,BILD 24,A01,894297,Pirino; Giorgia,40,0,60,20
1746558852832,BIMM 100,B01,958915,Staff,71,0,100,29
1746558853856,BIMM 101,A01,895017,McDonnell; Lisa Marie,0,5,24,24
1746558853856,BIMM 101,A02,895018,McDonnell; Lisa Marie,0,5,24,24
1746558853856,BIMM 101,B01,895020,McDonnell; Lisa Marie,0,6,24,24
1746558853856,BIMM 101,B02,895021,McDonnell; Lisa Marie,0,4,24,24
1746558854883,BIMM 110,A01,895023,Staff,1,0,25,24
1746558854883,BIMM 110,A02,895024,Staff,9,0,25,16
1746558854883,BIMM 110,A03,895025,Staff,18,0,25,7
1746558854883,BIMM 110,A04,895031,Staff,20,0,25,5
1746558855908,BIMM 120,A01,895114,Gustafson-Brown; Cindy,14,0,28,14
1746558855908,BIMM 120,A02,895126,Gustafson-Brown; Cindy,21,0,27,6
1746558856937,BIPN 100,A01,895130,Yang; Mingyu,1,0,38,37
1746558856937,BIPN 100,A02,895131,Yang; Mingyu,32,0,38,6
1746558856937,BIPN 100,A03,895132,Yang; Mingyu,32,0,38,6
1746558856937,BIPN 100,A04,895133,Yang; Mingyu,27,0,36,9
1746558857965,BIPN 120,A01,895135,Cooke; James Edward,0,3,13,13
1746558857965,BIPN 120,A02,895136,Cooke; James Edward,0,1,13,13
1746558857965,BIPN 120,A03,895137,Cooke; James Edward,0,3,13,13
1746558857965,BIPN 120,A04,895156,Cooke; James Edward,0,2,11,11
1746558858993,BIPN 134,A01,895235,Cooke; James Edward,0,2,25,25
1746558858993,BIPN 134,A02,895237,Cooke; James Edward,0,0,25,25
1746558858993,BIPN 134,A03,895240,Cooke; James Edward,3,0,25,22
1746558858993,BIPN 134,A04,895270,Cooke; James Edward,20,0,25,5
1746558860019,BIPN 189,A00,892103,Staff,0,13,14,14
1746558862073,BISP 194,A00,958008,Staff,0,2,0,0
1746558863100,CAT 124,A01,922009,Staff,0,5,20,20
1746558864126,CAT 125R,A00,886390,Morales; Celeste Georgianna,0,2,20,20
1746558864126,CAT 125R,B00,886391,Irwin; Matthew Joseph,0,3,20,20
1746558864126,CAT 125R,C00,886392,Smith; Lauryn Alissa,0,2,20,20
1746558864126,CAT 125R,D00,886393,Vanderschuit; Maya Alysia,0,2,20,20
1746558864126,CAT 125R,E00,886394,Marchisotto; Jennifer Anne,0,4,20,20
1746558865159,CENG 15,A01,886218,Drews; Aaron,3,0,8,5
1746558866183,CENG 113,A00,886219,Opatkiewicz; Justin Paul,15,0,25,10
1746558867207,CGS 101,A00,887044,Staff,7,0,20,13
1746558868232,CGS 105,A01,887046,Staff,14,0,25,11
1746558869257,CGS 112,A00,887047,Cuong; Marisol,12,0,15,3
1746558870284,CGS 113,A00,887048,Staff,23,0,30,7
1746558871311,CGS 120,A00,887049,Staff,10,0,17,7
1746558872337,CHEM 6A,A01,886336,Lam; Tin Yiu,38,0,50,12
1746558872337,CHEM 6A,A02,886338,Lam; Tin Yiu,37,0,50,13
1746558873363,CHEM 6B,A01,886341,Hopkins; Patrycja Anna,16,0,50,34
1746558873363,CHEM 6B,A02,886343,Hopkins; Patrycja Anna,42,0,50,8
1746558874386,CHEM 6C,A01,886346,Albizati; Kim F.,0,2,50,50
1746558874386,CHEM 6C,A02,886348,Albizati; Kim F.,23,0,50,27
1746558875413,CHEM 40A,A01,886352,Klosterman; Jeremy K,65,0,100,35
1746558876442,CHEM 40B,A01,886356,Klosterman; Jeremy K,0,23,100,100
1746558877467,CHEM 41B,A01,886360,Theodorakis; Emmanuel,25,0,50,25
1746558877467,CHEM 41B,A02,886362,Theodorakis; Emmanuel,47,0,50,3
1746558878496,CHIN 165A,A00,886382,Xu; Li,18,0,20,2
1746558879561,CLAS 120,A00,886387,Myerston Santana; Jacobo,33,0,40,7
1746558880585,COGS 9,A01,886967,Shannon; Kyle Michael,42,0,60,18
1746558881612,COGS 11,A01,886969,Staff,11,0,30,19
1746558882637,COGS 14A,A01,886971,Staff,6,0,60,54
1746558883665,COGS 14B,A01,886973,Hoffman; Drew Ellen,4,0,60,56
1746558884689,COGS 18,A01,886975,Morgan; Eric,35,0,60,25
1746558885714,COGS 20,A01,886977,Staff,4,0,8,4
1746558885714,COGS 20,A02,886978,Staff,5,0,7,2
1746558886740,COGS 100,A01,907783,Staff,0,2,30,30
1746558887764,COGS 101B,A01,886980,Staff,0,3,48,48
1746558888789,COGS 101C,A01,886982,Delgado; Tania,0,5,44,44
1746558889813,COGS 102A,A01,886984,Johnson; Christine M.,4,0,30,26
1746558890837,COGS 118B,A01,886986,Staff,0,3,88,88
1746558891865,COGS 150,A01,886988,Bergen; Benjamin,23,0,50,27
1746558892893,COGS 153,A00,886989,Delgado; Tania,0,2,41,41
1746558893918,COGS 186,A01,886991,Staff,0,0,32,32
1746558894943,COGS 187A,A01,886993,Boyle; Mary E. T.,7,0,30,23
1746558895971,COGS 189,A00,886994,Staff,0,1,30,30
1746558897000,COMM 10,A01,886996,Staff,0,0,20,21
1746558897000,COMM 10,A02,886997,Staff,12,0,20,8
1746558897000,COMM 10,A03,959845,Staff,19,0,20,1
1746558898027,COMM 20,A01,886999,Leuning; Grant Maurstad,24,0,40,16
1746558900077,COMM 100A,A01,887002,Staff,0,0,20,25
1746558900077,COMM 100A,A02,887003,Staff,7,0,20,13
1746558901102,COMM 100B,A01,887005,Staff,0,8,20,24
1746558902130,COMM 106D,A00,887006,Staff,14,0,40,26
1746558903156,COMM 110G,A00,887007,Whitworth-Smith; Andrew C,12,0,40,28
1746558904183,COMM 111B,A00,887008,Staff,31,0,40,9
1746558905209,COMM 113T,A00,887009,Abuelhiga; Soraya Jill,28,0,40,12
1746558905209,COMM 113T,B00,906733,Staff,40,0,40,0
1746558906237,COMM 145,A00,887010,Staff,12,0,40,28
1746558907263,COMM 146,A00,887054,Staff,31,0,40,9
1746558908293,COMM 190,A00,887012,Staff,8,0,23,15
1746558909321,CSE 8A,A50,887015,Cao; Yingjun,57,0,85,28
1746558910350,CSE 11,A01,887017,Cao; Yingjun,12,0,70,58
1746558911376,CSE 20,A01,887019,Staff,30,0,50,20
1746558912416,CSE 21,A01,887021,Staff,78,0,100,22
1746558912416,CSE 21,B01,892583,Braun; Oliver,45,0,50,5
1746558913441,CSE 30,A01,887025,Eldon; John,143,0,200,57
1746558914467,CSE 100,A01,887027,Staff,26,0,50,24
1746558914467,CSE 100,A02,887028,Staff,42,0,50,8
1746558915496,CSE 101,A01,887030,Braun; Oliver,74,0,100,26
1746558915496,CSE 101,B01,887032,Jones; Miles E,0,3,50,50
1746558915496,CSE 101,B02,887033,Jones; Miles E,0,1,50,50
1746558916523,CSE 105,A01,908084,Jones; Miles E,32,0,50,18
1746558916523,CSE 105,A02,908087,Jones; Miles E,32,0,50,18
1746558917549,CSE 135,A01,887035,Powell; Thomas Allan,0,4,50,50
1746558918576,CSE 142,A01,887037,Staff,8,0,60,52
1746558919600,CSE 142L,A01,887039,Staff,34,0,60,26
1746558920626,CSE 151A,A01,887041,Solares; Edwin A,47,0,100,53
1746558921653,CSE 175,A01,887043,Kumar; Rakesh,30,0,30,0
1746558922679,CSS 1,A01,886389,Staff,1,1,40,39
1746558923708,DSC 30,A01,908097,Liao; Soohyun Nam,47,0,75,28
1746558924733,DSC 40A,A01,908099,Shannon; Kyle Michael,30,0,50,20
1746558925756,DSC 40B,A01,908112,Staff,16,0,50,34
1746558926988,DSC 80,A01,908116,Staff,19,0,60,41
1746558928014,DSC 197,001,956863,Eldridge; Justin Matthew,9999,0,9999,0
1746558929042,ECE 5,A01,886400,Morris; Karcher William,2,0,6,4
1746558929042,ECE 5,A02,886401,Morris; Karcher William,3,0,6,3
1746558930068,ECE 148,A01,886403,Silberman; Jack,0,14,14,14
1746558931126,ECON 1,A01,887265,Crane; Meredith Helen,12,0,70,58
1746558931126,ECON 1,B01,887268,Staff,43,0,50,7
1746558932151,ECON 2,A01,887273,Crane; Meredith Helen,55,0,70,15
1746558933178,ECON 3,A01,887279,Rondina; Giacomo,32,0,70,38
1746558934206,ECON 4,A01,887282,Anderson; John Charles,0,2,10,10
1746558935231,ECON 5,A01,887285,Staff,33,0,45,12
1746558935231,ECON 5,B01,887292,Staff,41,0,45,4
1746558936257,ECON 100A,A01,887337,Newhouse; Herbert S,54,0,70,16
1746558936257,ECON 100A,B01,887349,Staff,45,0,50,5
1746558937284,ECON 100B,A01,887361,Du; Songzi,29,0,70,41
1746558938314,ECON 100C,A01,887445,Newhouse; Herbert S,59,0,70,11
1746558939343,ECON 105,A00,887488,Vespa; Emanuel Ignacio,23,0,35,12
1746558940366,ECON 109,A01,887506,Shishkin; Denis,28,0,35,7
1746558941396,ECON 110A,A01,887568,Alon; Titan Michael,0,3,35,35
1746558941396,ECON 110A,B01,907601,Alon; Titan Michael,20,0,35,15
1746558942421,ECON 110B,A01,887598,Levkoff; Steven B.,0,24,70,70
1746558943446,ECON 112,A00,887599,Rondina; Giacomo,19,0,35,16
1746558944472,ECON 120A,A01,887603,Dai; Yinlin,35,0,70,35
1746558945499,ECON 120C,A01,887608,Sun; Yixiao,0,1,35,35
1746558945499,ECON 120C,B01,887614,Sun; Yixiao,0,0,35,35
1746558946525,ECON 138,A00,887621,Bharadwaj; Prashant,0,21,20,20
1746558947551,ECON 144,A00,958007,Squires; Dale E,13,0,35,22
1746558948576,ECON 171,A01,907666,Staff,18,0,35,17
1746558949602,ECON 175,A00,887626,Wu; Pak Yeung,23,0,35,12
1746558950629,ECON 190,A00,887640,Vespa; Emanuel Ignacio,23,0,35,12
1746558951655,EDS 25,A01,888197,Staff,0,0,0,0
1746558951655,EDS 25,A02,888209,Staff,0,0,0,0
1746558951655,EDS 25,A03,888210,Staff,0,0,0,0
1746558951655,EDS 25,A04,888212,Staff,0,0,0,0
1746558951655,EDS 25,A05,888213,Staff,0,0,0,0
1746558951655,EDS 25,A06,888214,Staff,0,0,0,0
1746558951655,EDS 25,A07,888235,Staff,0,2,0,0
1746558951655,EDS 25,A08,888236,Staff,0,0,0,0
1746558951655,EDS 25,A09,888240,Staff,0,0,0,0
1746558951655,EDS 25,A10,888244,Staff,0,0,0,0
1746558951655,EDS 25,B01,888273,Staff,0,0,0,0
1746558951655,EDS 25,B02,888285,Staff,0,0,0,0
1746558951655,EDS 25,B03,888423,Staff,0,0,0,1
1746558951655,EDS 25,B04,888432,Staff,0,0,0,0
1746558951655,EDS 25,B05,888433,Staff,0,0,0,0
1746558951655,EDS 25,B06,888467,Staff,0,0,0,0
1746558951655,EDS 25,B07,888468,Staff,0,0,0,0
1746558951655,EDS 25,B08,888479,Staff,0,0,0,0
1746558951655,EDS 25,B09,888484,Staff,0,0,0,0
1746558951655,EDS 25,B10,888487,Staff,0,0,0,0
1746558952681,EDS 38,A01,907700,Choi; Bailey Miyeon,30,0,30,0
1746558953706,EDS 112,A01,888601,Chapman; Thandeka K,13,0,40,27
1746558954733,EDS 115,A00,888697,Mendez; Kathrina Mendoza,10,0,30,20
1746558955758,EDS 116,A01,888893,Staff,35,0,40,5
1746558957812,EDS 124AR,A00,889133,Staff,29,0,50,21
1746558957812,EDS 124AR,B00,907471,Simon; Elizabeth A,37,0,50,13
1746558958837,EDS 124BR,A00,889134,Simon; Elizabeth A,44,0,100,56
1746558959862,EDS 125,A00,889135,Staff,25,0,30,5
1746558960887,EDS 126,A01,889138,Staff,36,0,40,4
1746558961910,EDS 164R,A01,889142,Wishard Guerra; Alison G.,33,0,50,17
1746558962935,ENG 30,A01,886396,Staff,0,0,0,0
1746558962935,ENG 30,B01,886398,Staff,0,0,0,0
1746558963962,ENVR 102,A00,906150,Montejo; Carolina,23,0,25,2
1746558964994,ETHN 103A,A00,887236,Man; Simeon S,0,3,0,0
1746558966019,ETHN 113,A00,887239,Staff,16,0,30,14
1746558967043,ETHN 116,A00,887240,Staff,16,0,25,9
1746558968070,ETHN 117,A00,887241,Choi; Esther Min,28,0,30,2
1746558969094,ETHN 118,A00,887243,Staff,24,0,30,6
1746558970120,ETHN 127,A00,887248,Cuong; Marisol,11,0,15,4
1746558971146,ETHN 139,A00,887250,Staff,7,0,10,3
1746558972173,ETHN 142,A00,887252,Staff,10,0,30,20
1746558973197,ETHN 161,A00,887253,Browne; Errol Tsekani,24,0,30,6
1746558974222,ETHN 163FR,A00,887255,Burelle; Julie Sara Veronique,0,0,5,5
1746558975250,GLBH 20,A00,889149,Elwardani; Nile Regina,8,0,42,34
1746558977302,GLBH 111,A01,889152,Burgos; Jose L.,17,0,17,0
1746558978326,GLBH 150,A00,889181,Sloane; Julia Kathryn,0,5,15,15
1746558980379,HDS 60,A01,886406,Warstadt; Melissa Fawn,73,0,80,7
1746558981405,HIAF 111,A00,889324,Gyamfi; Bright,25,0,32,7
1746558982430,HIEA 131,A00,889328,Staff,16,0,32,16
1746558983457,HIEA 144,A00,889333,Henry; Todd A.,26,0,32,6
1746558984482,HIEA 154,A00,889336,Henry; Todd A.,24,0,32,8
1746558985505,HIEU 106,A00,889339,Staff,22,0,32,10
1746558987558,HIEU 114,A00,889340,Staff,3,0,32,29
1746558988582,HIEU 135GS,A00,889342,Patterson; Patrick H.,0,0,1,24
1746558989607,HIEU 137,A00,889343,Edington; Claire Ellen,9,0,25,16
1746558990633,HIEU 148,A00,889345,Staff,14,0,32,18
1746558991657,HIEU 154,A00,889346,Biess; Frank Peter,21,0,32,11
1746558992682,HILA 102,A00,889351,Staff,12,0,32,20
1746558993710,HILD 2A,A01,889221,Lewandoski; Julia Mavis,1,10,32,31
1746558994736,HILD 7B,A01,889225,Man; Simeon S,0,12,32,32
1746558995760,HILD 7C,A01,889288,Alvarez; Luis A,0,14,32,32
1746558996785,HILD 30,A01,889323,Staff,0,5,32,32
1746558998834,HISC 119,A00,889383,Golan; Tal,20,0,32,12
1746558999863,HIUS 103,A00,889384,Man; Simeon S,0,0,32,32
1746559000891,HIUS 117,A00,919797,Kwak; Nancy,18,0,32,14
1746559001916,HIUS 142A,A00,919788,Staff,22,0,32,10
1746559003972,HIUS 149,A00,889386,Gyamfi; Bright,27,0,32,5
1746559005000,HIUS 155,A00,889387,Alvarez; Luis A,14,0,32,18
1746559006026,HUM 3,A01,886499,Caldwell; Michael Alan,19,0,50,31
1746559007053,HUM 3GS,A00,886500,Rodriguez; Bretton Sigfred,0,0,0,28
1746559008082,HUM 3R,A01,886502,Markman; Kristina,0,36,50,50
1746559009107,HUM 4,A01,886504,Crum; Matthew Stephen,24,0,50,26
1746559009107,HUM 4,B01,886506,West; Geoffrey Scott,17,0,50,33
1746559010136,HUM 4GS,A00,886507,Staff,0,0,0,19
1746559011164,HUM 5,A01,886509,Staff,32,0,50,18
1746559012189,HUM 5R,A01,886511,Zavodny; Tatiana Sophia,0,39,50,50
1746559013214,JAPN 180,A00,886407,Staff,17,0,40,23
1746559014240,LATI 50,A01,886409,Martin-Cabrera; Luis,4,0,22,18
1746559014240,LATI 50,A02,886410,Martin-Cabrera; Luis,19,0,22,3
1746559014240,LATI 50,A03,886411,Martin-Cabrera; Luis,21,0,22,1
1746559014240,LATI 50,A04,886412,Martin-Cabrera; Luis,9,0,22,13
1746559015265,LAWS 101,A00,907664,Staff,28,0,60,32
1746559016291,LIAB 1A,A00,889388,Saab; Dima,17,0,20,3
1746559017318,LIAB 1AX,A00,889389,El Cheddadi; Youniss,17,0,20,3
1746559018343,LIFR 1C,A00,889391,Van Moer; Vinciane G,8,0,20,12
1746559019369,LIFR 1CX,A00,889392,Van Moer; Vinciane G,7,0,20,13
1746559020397,LIFR 1D,A00,889393,Van Moer; Vinciane G,7,0,20,13
1746559021422,LIFR 1DX,A00,889394,Van Moer; Vinciane G,8,0,20,12
1746559022446,LIGN 7,A00,886923,Staff,24,0,50,26
1746559023472,LIGN 17,A00,886924,Kehler; Andrew Scott,125,0,150,25
1746559024497,LTAM 110,A00,889395,Staff,15,0,30,15
1746559025526,LTAM 110GS,A00,958010,Rodriguez; Bretton Sigfred,0,0,0,28
1746559026553,LTCH 101,A00,889397,Staff,23,0,25,2
1746559027581,LTCS 130,A00,889398,Staff,23,0,25,2
1746559028610,LTEA 138,A00,889399,Staff,24,0,40,16
1746559029636,LTEN 149,A00,889400,Wesling; Megan E.,0,3,25,25
1746559030664,LTEN 169,A00,889401,Staff,20,0,25,5
1746559031689,LTEN 180,A00,889402,Staff,10,0,15,5
1746559032714,LTEN 181,A00,889403,Staff,21,0,25,4
1746559033737,LTWL 100,A00,889404,Myerston Santana; Jacobo,2,0,25,23
1746559034762,LTWL 180GS,A00,889405,Staff,0,0,20,20
1746559035787,LTWL 181,A00,889406,Staff,16,0,25,9
1746559036812,LTWL 184,A00,889475,Mukherjee; Silpa,22,0,25,3
1746559037837,LTWR 102C,A00,889486,Staff,29,0,30,1
1746559038863,LTWR 115W,A00,889491,Staff,0,2,15,15
1746559039890,MAE 8,A01,886905,Staff,0,2,0,0
1746559040915,MAE 11,A00,886906,Bandaru; Prabhakar,0,7,50,50
1746559041941,MAE 20,A00,886907,Evdokimenko; Ekaterina,43,0,70,27
1746559042970,MAE 30B,A00,886909,Ghazinejad; Maziar,26,0,45,19
1746559043999,MAE 101B,A00,886910,Saintillan; David,29,0,45,16
1746559045025,MAE 105,A00,886911,Bandaru; Prabhakar,18,0,50,32
1746559046053,MAE 107,B00,958024,Staff,8,0,50,42
1746559047079,MAE 143B,A00,886913,Bewley; Thomas R,6,0,40,34
1746559048110,MAE 148,A01,886915,Silberman; Jack,0,3,14,14
1746559049137,MAE 160,A00,886916,Evdokimenko; Ekaterina,32,0,60,28
1746559050161,MATH 3C,A01,889681,Staff,0,3,30,30
1746559050161,MATH 3C,A02,960048,Staff,25,0,30,5
1746559051186,MATH 10A,A01,889760,Staff,26,0,30,4
1746559051186,MATH 10A,A02,889783,Staff,29,0,30,1
1746559052213,MATH 10B,A01,889785,Verstraete; Jacques Allan,2,0,35,33
1746559052213,MATH 10B,A02,889795,Verstraete; Jacques Allan,4,0,35,31
1746559052213,MATH 10B,B01,889797,Verstraete; Jacques Allan,3,0,35,32
1746559052213,MATH 10B,B02,889828,Verstraete; Jacques Allan,3,0,35,32
1746559053239,MATH 10C,A01,889849,Habib; Yousaf,8,0,30,22
1746559053239,MATH 10C,A02,889852,Habib; Yousaf,14,0,30,16
1746559053239,MATH 10C,A03,889853,Habib; Yousaf,22,0,30,8
1746559053239,MATH 10C,A04,889858,Habib; Yousaf,20,0,30,10
1746559053239,MATH 10C,B01,889861,Staff,1,0,30,29
1746559053239,MATH 10C,B02,889862,Staff,24,0,30,6
1746559053239,MATH 10C,B03,889863,Staff,27,0,30,3
1746559053239,MATH 10C,B04,889967,Staff,23,0,30,7
1746559054318,MATH 18,A01,889974,Staff,7,0,30,23
1746559054318,MATH 18,A02,889977,Staff,20,0,30,10
1746559054318,MATH 18,B01,889984,Hardiman; Liam,21,0,30,9
1746559054318,MATH 18,B02,889985,Hardiman; Liam,25,0,30,5
1746559055345,MATH 20A,A01,889990,Suk; Andrew Hoon,30,0,35,5
1746559056374,MATH 20B,A01,889993,Ohm; Ko Woon,22,0,30,8
1746559056374,MATH 20B,A02,889994,Ohm; Ko Woon,30,0,30,0
1746559056374,MATH 20B,B01,889996,Ohm; Ko Woon,21,0,30,9
1746559056374,MATH 20B,B02,889997,Ohm; Ko Woon,23,0,30,7
1746559057399,MATH 20C,A01,889999,Hammock; Frances H,17,0,30,13
1746559057399,MATH 20C,A02,890003,Hammock; Frances H,23,0,30,7
1746559057399,MATH 20C,B01,890006,Hammock; Frances H,3,0,30,27
1746559057399,MATH 20C,B02,890007,Hammock; Frances H,11,0,30,19
1746559058428,MATH 20D,A01,890011,Cheng; Hsiao-Bing,1,1,30,29
1746559058428,MATH 20D,A02,890012,Cheng; Hsiao-Bing,14,0,30,16
1746559058428,MATH 20D,B01,890016,Cheng; Hsiao-Bing,13,0,30,17
1746559058428,MATH 20D,B02,890017,Cheng; Hsiao-Bing,13,0,30,17
1746559059457,MATH 20E,A01,890026,Harel; Guershon,1,0,30,29
1746559059457,MATH 20E,A02,890029,Harel; Guershon,23,0,30,7
1746559059457,MATH 20E,B01,890033,Harel; Guershon,7,0,30,23
1746559059457,MATH 20E,B02,890101,Harel; Guershon,21,0,30,9
1746559060483,MATH 102,A01,890104,Staff,17,0,30,13
1746559060483,MATH 102,A02,890105,Staff,27,0,30,3
1746559061510,MATH 103B,A01,890116,Salehi Golsefidy; Alireza,3,0,30,27
1746559061510,MATH 103B,B01,890118,Staff,0,3,34,34
1746559062541,MATH 109,A01,890121,Aliabadi Sr.; Mohsen,1,0,30,29
1746559062541,MATH 109,B01,890124,Upadrashta; Pranav Kumar,18,0,30,12
1746559063565,MATH 120A,A01,890126,Eggers; John Dietrich,13,0,30,17
1746559064590,MATH 142B,A01,890128,Ioana; Adrian,19,0,30,11
1746559064590,MATH 142B,A02,890129,Ioana; Adrian,13,0,30,17
1746559065616,MATH 154,A01,890174,Staff,0,0,30,30
1746559065616,MATH 154,A02,890182,Staff,0,0,30,30
1746559066641,MATH 168A,A01,890197,Dumitriu; Ioana,21,0,35,14
1746559067669,MATH 170A,A01,890240,Nie; Jiawang,1,0,30,29
1746559067669,MATH 170A,A02,890241,Nie; Jiawang,11,0,30,19
1746559067669,MATH 170A,A03,890249,Nie; Jiawang,23,0,30,7
1746559068697,MATH 170B,A01,957891,Nag; Panchali,13,0,35,22
1746559070747,MATH 181A,A01,908025,Staff,0,4,35,35
1746559070747,MATH 181A,A02,960115,Staff,27,0,35,8
1746559071772,MATH 181B,A01,959874,Staff,25,0,30,5
1746559072798,MATH 193B,A01,890265,Staff,0,4,35,35
1746559073826,MGT 4,A01,890311,Anderson; John Charles,42,0,88,46
1746559074851,MGT 5,A00,907740,Staff,13,0,98,85
1746559075877,MGT 12,A00,890312,Lindenberger; Wade Douglas,67,0,98,31
1746559076903,MGT 16,A00,957883,Staff,78,0,98,20
1746559078958,MGT 45,A00,890314,Pecore; Joseph P.,46,0,98,52
1746559079982,MGT 71,A00,890315,Staff,0,11,98,98
1746559081008,MGT 100,A00,890316,Yavorsky; Daniel Ryan,44,0,98,54
1746559082034,MGT 103,A00,890317,Ehrich; Kristine R,73,0,98,25
1746559083058,MGT 105,A00,890356,Bates; Kenneth Walter,0,8,98,98
1746559084082,MGT 112,A00,890360,Ehrich; Kristine R,55,0,98,43
1746559085111,MGT 127R,A00,907732,Zhu; Kevin Xiaoguo,23,0,98,75
1746559086139,MGT 131B,A00,890361,Anderson; John Charles,60,0,98,38
1746559087167,MGT 137,A00,890362,Lindenberger; Wade Douglas,65,0,98,33
1746559088192,MGT 160,A00,890369,Johnson; Erik Barry,9,0,98,89
1746559090245,MGT 164,A00,890372,Zimmermann; Carsten,0,40,98,98
1746559091268,MGT 180,A00,890374,Bliss; Barbara Ann,12,0,98,86
1746559092293,MMW 15,A01,886414,Chang; Edmond Yi-Teh,0,12,28,28
1746559092293,MMW 15,A02,886415,Chang; Edmond Yi-Teh,0,8,28,28
1746559092293,MMW 15,A03,886416,Chang; Edmond Yi-Teh,0,8,28,28
1746559092293,MMW 15,A04,886417,Chang; Edmond Yi-Teh,0,8,28,28
1746559092293,MMW 15,B01,886419,Chang; Edmond Yi-Teh,0,7,28,28
1746559092293,MMW 15,B02,886420,Chang; Edmond Yi-Teh,0,8,28,28
1746559092293,MMW 15,B03,886421,Chang; Edmond Yi-Teh,0,7,28,28
1746559092293,MMW 15,B04,886422,Chang; Edmond Yi-Teh,0,8,28,28
1746559092293,MMW 15,C01,886424,Staff,0,9,28,28
1746559092293,MMW 15,C02,886425,Staff,0,8,28,28
1746559092293,MMW 15,C03,886426,Staff,0,8,28,28
1746559092293,MMW 15,C04,886427,Staff,0,8,28,28
1746559092293,MMW 15,C05,958038,Staff,0,8,28,28
1746559092293,MMW 15,C06,958039,Staff,0,8,28,28
1746559093317,MMW 15GS,A00,906910,Patterson; Patrick H.,4,0,28,24
1746559094343,MMW 122R,A01,886429,Rahimi; Babak,0,13,28,28
1746559094343,MMW 122R,A02,886430,Rahimi; Babak,0,12,28,28
1746559094343,MMW 122R,A03,958040,Rahimi; Babak,0,11,28,28
1746559095368,MUS 1A,A01,890937,Staff,2,0,25,23
1746559095368,MUS 1A,A02,891035,Staff,6,0,25,19
1746559095368,MUS 1A,C01,958912,Staff,24,0,25,1
1746559095368,MUS 1A,C02,958913,Staff,25,0,25,0
1746559097418,MUS 2AK,A00,957092,Ohnishi; Takae,15,0,15,0
1746559098444,MUS 4,A01,891044,Staff,2,0,25,23
1746559098444,MUS 4,A02,891045,Staff,23,0,25,2
1746559098444,MUS 4,B01,891048,Staff,17,0,25,8
1746559098444,MUS 4,B02,891050,Staff,25,0,25,0
1746559099473,MUS 5,A01,957506,Dubnov; Shlomo,0,0,25,25
1746559099473,MUS 5,A02,957622,Dubnov; Shlomo,13,0,25,12
1746559099473,MUS 5,A03,957623,Dubnov; Shlomo,20,0,25,5
1746559100502,MUS 6,A01,891053,Freitas Caetano; Marcelo,24,0,25,1
1746559100502,MUS 6,A02,891054,Freitas Caetano; Marcelo,23,0,25,2
1746559101532,MUS 7,A01,891081,Staff,0,0,25,25
1746559101532,MUS 7,A02,891082,Staff,4,0,25,21
1746559102560,MUS 8GS,A00,891118,Borgo; David Garcia,0,0,25,25
1746559103584,MUS 11,A01,891140,Staff,10,0,25,15
1746559103584,MUS 11,A02,891141,Staff,22,0,25,3
1746559104611,MUS 13,A01,891143,Staff,8,0,25,17
1746559104611,MUS 13,A02,891144,Staff,24,0,25,1
1746559105640,MUS 15,A01,891146,Staff,9,0,25,16
1746559105640,MUS 15,A02,891148,Staff,21,0,25,4
1746559105640,MUS 15,B01,891150,Staff,18,0,25,7
1746559105640,MUS 15,B02,891151,Staff,25,0,25,0
1746559106667,MUS 20,A01,891153,Staff,5,0,20,15
1746559106667,MUS 20,A02,891155,Staff,14,0,20,6
1746559107694,MUS 80,A00,891156,Staff,19,0,25,6
1746559107694,MUS 80,B00,891157,Staff,23,0,25,2
1746559108721,MUS 130,A00,891158,Ohnishi; Takae,35,0,35,0
1746559109746,MUS 150GS,A01,891160,Borgo; David Garcia,0,0,25,25
1746559110776,MUS 170,A01,891162,Freitas Caetano; Marcelo,20,0,25,5
1746559110776,MUS 170,A02,891164,Freitas Caetano; Marcelo,21,0,25,4
1746559111801,NANO 11,A00,886220,Vazquez Mena; Oscar,13,0,15,2
1746559112829,NANO 15,A01,886222,Drews; Aaron,4,0,7,3
1746559113858,NANO 104,A00,886224,Sirbuly; Donald,18,0,25,7
1746559114886,PH 40,A00,886528,Staff,23,0,40,17
1746559115928,PH 45,A01,886799,Staff,35,0,40,5
1746559116955,PH 110,A00,886802,Staff,0,7,40,40
1746559117980,PH 172,A00,906716,Staff,19,0,35,16
1746559119007,PH 191,A00,886803,Staff,6,0,40,34
1746559120034,PHIL 1,A00,889500,Staff,20,0,30,10
1746559121081,PHIL 10,A01,889549,Grush; Rick Scott,15,0,22,7
1746559121081,PHIL 10,A02,889551,Grush; Rick Scott,22,0,22,0
1746559122109,PHIL 28,A01,889559,Lamey; Andy M.,0,1,31,31
1746559122109,PHIL 28,A02,889561,Lamey; Andy M.,0,1,30,30
1746559122109,PHIL 28,A03,889572,Lamey; Andy M.,0,1,30,30
1746559123137,PHIL 35,A00,907839,Staff,13,0,15,2
1746559124162,PHIL 60,A00,889574,Staff,73,0,90,17
1746559125189,PHIL 101,A00,958004,Staff,12,0,15,3
1746559127256,PHIL 136,A00,889582,Fulkerson; Matthew Todd,26,0,45,19
1746559128281,PHIL 163,A01,889601,Staff,21,0,30,9
1746559128281,PHIL 163,B01,889606,Brandt; Reuven A,0,3,0,0
1746559129308,PHIL 164,A00,889610,Staff,16,0,30,14
1746559130336,PHIL 165,A00,889613,Staff,23,0,30,7
1746559131361,PHYS 1A,A00,886431,Staff,26,0,70,44
1746559132538,PHYS 1AL,001,886432,Tsai; Philbert S,0,2,30,30
1746559132538,PHYS 1AL,002,886436,Tsai; Philbert S,11,0,30,19
1746559133565,PHYS 1B,A00,886439,Staff,185,0,240,55
1746559134588,PHYS 1BL,001,886441,Tsai; Philbert S,0,4,30,30
1746559134588,PHYS 1BL,002,886444,Tsai; Philbert S,2,0,30,28
1746559135615,PHYS 1C,A00,896092,Arnold; Kam S,78,0,146,68
1746559136645,PHYS 1CL,001,886448,Tsai; Philbert S,0,0,30,30
1746559136645,PHYS 1CL,002,886449,Tsai; Philbert S,0,0,30,30
1746559136645,PHYS 1CL,003,886450,Tsai; Philbert S,16,0,30,14
1746559136645,PHYS 1CL,004,886451,Tsai; Philbert S,15,0,30,15
1746559137671,PHYS 2B,A01,886457,Staff,68,0,115,47
1746559138699,PHYS 2C,A01,886460,Shotwell; Brian,0,9,65,65
1746559139725,PHYS 2CL,A01,886467,Staff,0,4,28,28
1746559139725,PHYS 2CL,A02,886468,Staff,0,3,28,28
1746559140750,PHYS 2D,A01,886470,Staff,10,0,50,40
1746559141786,PHYS 4B,A01,886475,Grinstein; Benjamin,22,0,40,18
1746559142813,POLI 5,A00,891173,Desposato; Scott,7,0,25,18
1746559143839,POLI 5D,A01,891175,Staff,5,0,5,0
1746559143839,POLI 5D,B01,891178,Staff,5,0,5,0
1746559144864,POLI 11,A00,891179,Ferree; Karen E,2,0,35,33
1746559145892,POLI 12,A00,891180,Staff,16,0,30,14
1746559146922,POLI 27,A01,891182,Staff,12,0,75,63
1746559147946,POLI 30,A00,891183,Staff,8,0,50,42
1746559148975,POLI 100B,A00,891244,Staff,5,1,35,30
1746559150010,POLI 100I,A00,891247,Staff,7,0,30,23
1746559151037,POLI 104J,A00,891248,Nichter; Maysa,14,0,30,16
1746559152065,POLI 104U,A00,891250,Nichter; Maysa,2,0,30,28
1746559154118,POLI 110B,A00,891255,Wiens; David,20,0,25,5
1746559155143,POLI 112A,A00,891256,Wiens; David,6,0,25,19
1746559156170,POLI 114BR,A00,891261,Staff,19,0,30,11
1746559157201,POLI 117R,A00,891262,Forman; Fonna,0,6,50,50
1746559158280,POLI 118,A00,891264,Ingham; Sean,17,0,25,8
1746559159305,POLI 124A,A00,891265,Staff,18,0,20,2
1746559160329,POLI 125D,A00,891266,Nichter; Simeon C,2,0,25,23
1746559161358,POLI 126,A00,891268,Nichter; Simeon C,7,0,25,18
1746559162383,POLI 126AA,A00,891272,Staff,17,0,25,8
1746559163406,POLI 130AA,A00,891273,Staff,15,0,20,5
1746559164435,POLI 134AA,A00,891274,Staff,4,0,20,16
1746559166487,POLI 138,A00,891278,Staff,21,0,25,4
1746559167512,POLI 142K,A00,891280,Staff,11,0,25,14
1746559168540,POLI 142M,A00,891281,Gartzke; Erik,17,0,30,13
1746559169566,POLI 142P,A00,891284,Staff,20,0,30,10
1746559170589,POLI 143,A00,891285,Gartzke; Erik,12,0,30,18
1746559171614,POLI 153,A00,891286,Staff,19,0,20,1
1746559173667,POLI 175,A00,891290,Staff,15,0,20,5
1746559174696,PSYC 1,A00,890674,Steiner; Eric Tomas,0,11,45,45
1746559175724,PSYC 2,A00,890676,Albright; Thomas D,21,0,35,14
1746559176752,PSYC 3,A00,890679,Staff,17,0,20,3
1746559177779,PSYC 6,A00,959858,Staff,20,0,20,0
1746559178802,PSYC 60,A01,890684,Rickard; Timothy C.,0,5,45,45
1746559179833,PSYC 70,A01,890689,Geller; Emma Harlan,7,0,30,23
1746559180861,PSYC 71,A01,959860,Staff,21,0,25,4
1746559181891,PSYC 100,A00,890690,Lacefield; Katharine I,0,50,180,180
1746559182917,PSYC 102,A00,890695,Staff,18,0,40,22
1746559183943,PSYC 105,A00,890699,Geller; Emma Harlan,70,0,100,30
1746559184973,PSYC 106,A00,890701,Gorman; Michael R.,6,0,30,24
1746559186002,PSYC 108,A00,890704,Adrian; Julia Anna,0,28,50,50
1746559187037,PSYC 118,A01,890712,Staff,11,0,30,19
1746559188064,PSYC 124,A00,890716,Chapman; Eddie Nathaniel,25,0,60,35
1746559189089,PSYC 131,A00,890717,Anagnostaras; Stephan,0,7,80,80
1746559190115,PSYC 137,A00,890719,Winkielman; Piotr,0,11,30,30
1746559191150,PSYC 144,A00,890721,Adrian; Julia Anna,0,9,45,45
1746559192174,PSYC 162,A00,890805,Staff,2,0,75,73
1746559193198,PSYC 169,A00,890810,Staff,0,14,30,30
1746559194227,PSYC 172,A00,890814,Gorman; Michael R.,9,0,30,21
1746559195255,PSYC 181,A00,890818,Anagnostaras; Stephan,9,0,200,191
1746559196282,PSYC 184,A00,959861,Staff,170,0,175,5
1746559197311,PSYC 189,A00,890823,Staff,0,1,30,30
1746559198337,PSYC 191,A00,890884,Rickard; Timothy C.,0,11,35,35
1746559199367,PSYC 193,A00,890913,Staff,19,0,30,11
1746559199367,PSYC 193,B00,890914,Chapman; Eddie Nathaniel,24,0,30,6
1746559200396,PSYC 193L,A01,890918,Lowe; Angela Beth,20,0,30,10
1746559200396,PSYC 193L,B01,890921,Hurwitz; Ethan Scott,20,0,30,10
1746559200396,PSYC 193L,C01,890928,Staff,30,0,30,0
1746559201420,RELI 149,A00,886806,Rahimi; Babak,23,0,40,17
1746559202447,SE 9,A01,886814,Staff,7,0,20,13
1746559203478,SE 101B,A01,886816,Chadha; Mayank,4,0,35,31
1746559204504,SE 110B,A00,886818,Zhu; Qiang,4,0,75,71
1746559205533,SE 125,A01,886830,Staff,10,0,30,20
1746559206559,SE 130B,A01,886835,Staff,14,0,40,26
1746559207584,SE 131A,A01,886838,Krysl; Petr,34,0,55,21
1746559208610,SE 154,A00,886840,Staff,29,0,50,21
1746559209635,SE 164GS,A01,886849,Staff,6,0,20,14
1746559210664,SE 167GS,A01,886853,Staff,6,0,20,14
1746559211691,SIO 25,A01,890107,Staff,19,0,30,11
1746559212717,SIO 45,A00,890109,Cook; Geoffrey W,117,0,200,83
1746559213743,SIO 109R,A00,890110,Forman; Fonna,0,16,20,20
1746559214769,SIO 187,A01,890114,Kacev; David,15,0,40,25
1746559215793,SOCI 1,A01,890431,Thorpe; Charles Robert,15,0,30,15
1746559215793,SOCI 1,A02,890518,Thorpe; Charles Robert,30,0,30,0
1746559216820,SOCI 2,A01,957978,Staff,25,0,25,0
1746559216820,SOCI 2,A02,957979,Staff,23,0,25,2
1746559217958,SOCI 20,A01,890523,Calderon-Zaks; Michael Aar,23,0,30,7
1746559217958,SOCI 20,A02,890526,Calderon-Zaks; Michael Aar,29,0,30,1
1746559218983,SOCI 30,A01,890533,Pardo Guerra; Juan Pablo,37,0,40,3
1746559220034,SOCI 40,A01,890535,Staff,27,0,45,18
1746559221060,SOCI 104Q,A00,890559,Staff,18,0,30,12
1746559222088,SOCI 106,A00,890560,Arnal; Maud Marie Leonie,20,0,30,10
1746559223117,SOCI 110,A00,890567,Holkenbrink-Monk; Charlene,19,0,30,11
1746559224144,SOCI 112,A00,890568,Victoria Torres; Pablo,2,0,55,53
1746559225170,SOCI 115,A00,890597,Arnal; Maud Marie Leonie,28,0,45,17
1746559227220,SOCI 121,A00,890604,Pardo Guerra; Juan Pablo,38,0,45,7
1746559228249,SOCI 126,A01,890608,Staff,8,0,10,2
1746559229275,SOCI 127,A00,890609,Staff,18,0,30,12
1746559230303,SOCI 131,A00,890610,Thorpe; Charles Robert,37,0,45,8
1746559231329,SOCI 135,A00,890615,Payne; Christine Anna,13,0,45,32
1746559232355,SOCI 139,A00,890620,Staff,38,0,45,7
1746559233384,SOCI 148E,A00,890622,Calderon-Zaks; Michael Aar,36,0,45,9
1746559234454,SOCI 150,A00,890623,Kohler; Kristopher M.,31,0,45,14
1746559235485,SOCI 157,A00,890625,Jules-Rosette; Bennetta W.,18,0,20,2
1746559236516,SOCI 160,A00,890627,Payne; Christine Anna,21,0,45,24
1746559237541,SYN 1,A00,886855,Fish; Gwendolyn Anne,0,0,0,0
1746559237541,SYN 1,B00,906086,Fish; Gwendolyn Anne,0,1,0,2
1746559238570,SYN 2R,A00,886860,Staff,0,17,15,15
1746559238570,SYN 2R,B00,906106,Atkinson; Arthur Laird,0,16,15,15
1746559239602,SYN 100,A01,886866,Browne; Emily,0,28,20,20
1746559239602,SYN 100,B01,906128,Rock; Martin,0,5,20,20
1746559239602,SYN 100,C01,906140,Deavenport; James Cary,0,3,20,20
1746559239602,SYN 100,D01,907816,Deavenport; James Cary,0,5,20,20
1746559240628,TDAC 1,A00,890286,Walsh; Kim C.,8,0,20,12
1746559241663,TDAC 101,A00,890296,Basso; Beatrice,15,0,20,5
1746559242689,TDDE 131,A00,890297,Staff,47,0,50,3
1746559243714,TDDM 1,A00,890287,Weinberg; Sadie,25,0,30,5
1746559244740,TDGE 11,A00,890288,Fulton; Julia,137,0,200,63
1746559244740,TDGE 11,B00,890289,Castro; Robert Jess,184,0,200,16
1746559245772,TDGE 25,B00,957359,Walsh; Kim C.,3,0,20,17
1746559246797,TDGE 40,A01,890292,Power; Jade Yukana,27,0,30,3
1746559247825,TDGE 124,A00,890298,Havis; Allan,0,1,50,50
1746559248850,TDGE 131R,A00,890299,Burelle; Julie Sara Veronique,15,0,42,27
1746559249874,TDHT 101,A00,890300,Staff,10,0,20,10
1746559250902,TDHT 109,A01,890302,Anderson; Mysia Anyse,31,0,40,9
1746559251930,TDMV 1,A00,890293,Arcidiacono; Kristin,18,0,30,12
1746559252953,TDMV 2,A00,890294,Weinberg; Sadie,23,0,30,7
1746559253981,TDMV 3,A00,957878,Arcidiacono; Kristin,28,0,30,2
1746559256043,TDMV 138,A00,890304,Jun; Grace Shin Hae,25,0,40,15
1746559257072,TDMV 140,A00,890305,Corrales; Joseph Bernales,25,0,30,5
1746559258151,TDMV 142,A00,890307,Caligagan; Tony,32,0,40,8
1746559259176,TDMV 144,A00,890308,Camaya; Michelle Ann,25,0,30,5
1746559260204,TDPW 1,A00,890295,Stein; Deborah Isobel,3,0,20,17
1746559261229,USP 2,A01,890272,Lerner; Amy M,6,0,20,14
1746559262253,USP 3,A01,890274,Staff,12,0,30,18
1746559263277,USP 15,A01,890276,Sun; Feiyang,16,0,30,14
1746559264317,USP 25,A00,890277,Shenkman; Michael Thomas,19,0,25,6
1746559265347,USP 138,A00,890278,Staff,13,0,25,12
1746559266372,USP 143,A00,890279,Staff,21,0,70,49
1746559267400,USP 144,A00,890280,Chowdhury; Muhammed Zohir,15,0,30,15
1746559268425,USP 150,A00,890281,Boomhower; Matthew Charles,4,0,30,26
1746559269456,USP 151,A00,890282,Staff,16,0,20,4
1746559270485,USP 162,A00,890283,Andrews; Abigail Leslie,16,0,20,4
1746559271509,USP 168,A00,920477,Kwak; Nancy,1,0,5,4
1746559272537,USP 181,A00,890284,Staff,3,0,20,17
1746559273568,USP 191A,A00,890285,Staff,12,0,20,8
1746559274595,VIS 101,A00,886512,Staff,26,0,75,49
1746559275621,VIS 103,A00,886513,Cruz; Edwin Teddy,61,0,75,14
1746559276647,VIS 108,A00,886514,Staff,3,0,15,12
1746559277673,VIS 127P,A00,886515,Shen; Kuiyi,80,0,146,66
1746559278701,VIS 149,A00,886516,Yoldas; Pinar,0,0,15,15
1746559279740,VIS 164,A00,886526,Erdmann; Dean,19,0,22,3
1746559280765,VIS 194S,A00,886527,Staff,61,0,75,14
1746559281793,WCWP 10A,C00,886484,Martiniuk; Jill,12,0,15,3
1746559282860,WCWP 10B,A00,886490,Uriarte; Emma,0,0,15,15
1746559282860,WCWP 10B,B00,886491,Dhir; Simrita,10,0,15,5
1746559282860,WCWP 10B,C00,886492,Ornelas; Tricia,0,0,15,15
1746559283884,WCWP 100,A00,886494,Young; Mark T,0,6,15,15
1746559285998,AAS 10,A01,886199,Childs; Dennis R.,0,3,0,0
1746559287023,ANAR 104,A01,886940,Shtienberg; Gilad,27,0,30,3
1746559288049,ANAR 120,A00,886953,Staff,12,0,20,8
1746559289074,ANBI 148,A01,886955,Wilder; Linnea Lorene,30,0,40,10
1746559291125,ANSC 122,A00,886957,Staff,25,0,30,5
1746559292150,ANSC 150,A00,886958,Sloane; Julia Kathryn,2,0,15,13
1746559293178,ANSC 156,A00,886959,Jenkins; Janis A.,0,1,15,15
1746559294203,ANSC 180,A00,886960,Staff,11,0,17,6
1746559295231,ANSC 188,A00,886961,Jassal; Aftab,9,0,25,16
1746559296260,ANSC 190,A00,886962,Jassal; Aftab,14,0,25,11
1746559297289,ANSC 191,A00,886963,Staff,18,0,20,2
1746559298316,ANTH 3,A01,891689,Staff,17,0,20,3
1746559299345,ANTH 5,A00,886933,Semendeferi; Ekaterini,16,0,20,4
1746559300371,ANTH 10,A00,886934,Staff,0,12,30,30
1746559301394,ANTH 21,A01,886936,Staff,40,0,60,20
1746559302427,ANTH 23,A01,886938,Staff,92,0,100,8
1746559303456,ANTH 105,A00,886964,Stewart; Alexander B,84,0,100,16
1746559304486,ANTH 108,A00,886965,Pedersen; David,9,0,20,11
1746559305514,AWP 10,001,886147,Staff,0,0,0,0
1746559305514,AWP 10,002,886148,Staff,0,0,0,0
1746559305514,AWP 10,003,886149,Staff,0,0,0,0
1746559305514,AWP 10,004,886150,Staff,0,0,0,0
1746559305514,AWP 10,005,886151,Staff,0,0,0,0
1746559305514,AWP 10,006,886152,Staff,0,0,0,0
1746559305514,AWP 10,007,886153,Staff,0,0,0,0
1746559305514,AWP 10,008,886154,Staff,0,0,0,0
1746559305514,AWP 10,009,886155,Staff,0,0,0,0
1746559305514,AWP 10,010,886156,Staff,0,0,0,0
1746559305514,AWP 10,011,886158,Staff,0,0,0,0
1746559305514,AWP 10,012,886160,Staff,0,0,0,0
1746559305514,AWP 10,013,886161,Staff,0,0,0,0
1746559305514,AWP 10,014,886162,Staff,0,0,0,0
1746559305514,AWP 10,015,886163,Staff,0,0,0,0
1746559305514,AWP 10,016,886164,Staff,0,0,0,0
1746559305514,AWP 10,017,886165,Staff,0,0,0,0
1746559305514,AWP 10,018,886166,Staff,0,0,0,0
1746559305514,AWP 10,019,886168,Staff,0,0,0,0
1746559305514,AWP 10,020,886170,Staff,0,0,0,0
1746559305514,AWP 10,021,886172,Staff,0,0,0,0
1746559306541,AWP 10R,001,886173,Staff,0,1,0,0
1746559306541,AWP 10R,002,886174,Staff,0,1,0,0
1746559306541,AWP 10R,003,886175,Staff,0,0,0,0
1746559306541,AWP 10R,004,886176,Staff,0,0,0,0
1746559306541,AWP 10R,005,886177,Staff,0,0,0,0
1746559306541,AWP 10R,006,886178,Staff,0,0,0,0
1746559306541,AWP 10R,007,886179,Staff,0,0,0,0
1746559306541,AWP 10R,008,886181,Staff,0,0,0,0
1746559306541,AWP 10R,009,886182,Staff,0,0,0,0
1746559306541,AWP 10R,010,886183,Staff,0,0,0,0
1746559306541,AWP 10R,011,886184,Staff,0,0,0,0
1746559306541,AWP 10R,012,886185,Staff,0,0,0,0
1746559306541,AWP 10R,013,886186,Staff,0,0,0,0
1746559306541,AWP 10R,014,886187,Staff,0,0,0,0
1746559306541,AWP 10R,015,886188,Staff,0,0,0,0
1746559306541,AWP 10R,016,886189,Staff,0,0,0,0
1746559306541,AWP 10R,017,960532,Staff,0,0,0,0
1746559306541,AWP 10R,018,960533,Staff,0,0,0,0
1746559306541,AWP 10R,019,960534,Staff,0,0,0,0
1746559306541,AWP 10R,020,960538,Staff,0,0,0,0
1746559306541,AWP 10R,021,960540,Staff,0,0,0,0
1746559306541,AWP 10R,022,960541,Staff,0,0,0,0
1746559306541,AWP 10R,023,960542,Staff,0,0,0,0
1746559306541,AWP 10R,024,960544,Staff,0,0,0,0
1746559306541,AWP 10R,025,960545,Staff,0,0,0,0
1746559306541,AWP 10R,026,960548,Staff,0,0,0,0
1746559307566,AWP 102R,A00,886190,Staff,0,0,0,0
1746559307566,AWP 102R,B00,886191,Staff,0,0,0,0
1746559308593,BENG 100,A01,886193,Staff,17,0,30,13
1746559309618,BENG 122A,A01,886195,Hasty; Jeff M,13,0,30,17
1746559310642,BENG 166A,A00,886196,Sah; Robert Lie-Yuan,0,2,30,30
1746559311670,BENG 190,A00,958050,Khojah; Reem I,22,0,25,3
1746559312700,BIBC 102,A01,894320,Staff,0,0,46,46
1746559312700,BIBC 102,A02,894321,Staff,0,0,46,46
1746559312700,BIBC 102,A03,894344,Staff,7,0,46,39
1746559312700,BIBC 102,A04,894345,Staff,26,0,47,21
1746559313725,BICD 100R,A01,894365,Smith; Laurie,0,3,58,58
1746559313725,BICD 100R,A02,894366,Smith; Laurie,0,5,58,58
1746559313725,BICD 100R,A03,894367,Smith; Laurie,1,0,59,58
1746559313725,BICD 100R,A04,959869,Smith; Laurie,40,0,59,19
1746559314753,BICD 136,A01,894383,Gustafson-Brown; Cindy,14,0,50,36
1746559315777,BIEB 102,A01,894494,Butler; Shannon Rhey,51,0,130,79
1746559317831,BIEB 150,A01,894617,Wills; Christopher,3,0,20,17
1746559317831,BIEB 150,A02,894631,Wills; Christopher,3,0,20,17
1746559317831,BIEB 150,A03,894937,Wills; Christopher,3,0,20,17
1746559317831,BIEB 150,A04,894946,Wills; Christopher,5,0,20,15
1746559318895,BIEB 194,A00,906141,Kurle; Carolyn M.,6,0,20,14
1746559319922,BILD 1,A01,894154,Staff,3,0,19,16
1746559319922,BILD 1,A02,894155,Staff,14,0,19,5
1746559319922,BILD 1,A03,894160,Staff,13,0,19,6
1746559319922,BILD 1,A04,894161,Staff,15,0,18,3
1746559320947,BILD 2,A01,894168,Staff,0,0,50,50
1746559320947,BILD 2,A02,894169,Staff,0,0,50,50
1746559320947,BILD 2,A03,894179,Staff,0,0,50,50
1746559320947,BILD 2,A04,894203,Staff,26,0,50,24
1746559321975,BILD 3,A01,894213,Staff,22,0,31,9
1746559321975,BILD 3,A02,894214,Staff,26,0,31,5
1746559321975,BILD 3,A03,894235,Staff,28,0,31,3
1746559321975,BILD 3,A04,894236,Staff,28,0,32,4
1746559323004,BILD 4,A01,894253,Reuther; Keefe,5,0,24,19
1746559323004,BILD 4,A02,894258,Reuther; Keefe,16,0,24,8
1746559324035,BILD 5,A01,894276,Reuther; Keefe,35,0,50,15
1746559324035,BILD 5,A02,894277,Reuther; Keefe,45,0,50,5
1746559324035,BILD 5,A03,894290,Reuther; Keefe,44,0,50,6
1746559324035,BILD 5,A04,894291,Reuther; Keefe,48,0,50,2
1746559325060,BILD 24,A01,894297,Pirino; Giorgia,40,0,60,20
1746559326087,BIMM 100,B01,958915,Staff,71,0,100,29
1746559327114,BIMM 101,A01,895017,McDonnell; Lisa Marie,0,5,24,24
1746559327114,BIMM 101,A02,895018,McDonnell; Lisa Marie,0,5,24,24
1746559327114,BIMM 101,B01,895020,McDonnell; Lisa Marie,0,6,24,24
1746559327114,BIMM 101,B02,895021,McDonnell; Lisa Marie,0,4,24,24
1746559328138,BIMM 110,A01,895023,Staff,1,0,25,24
1746559328138,BIMM 110,A02,895024,Staff,9,0,25,16
1746559328138,BIMM 110,A03,895025,Staff,18,0,25,7
1746559328138,BIMM 110,A04,895031,Staff,20,0,25,5
1746559329163,BIMM 120,A01,895114,Gustafson-Brown; Cindy,14,0,28,14
1746559329163,BIMM 120,A02,895126,Gustafson-Brown; Cindy,21,0,27,6
1746559330188,BIPN 100,A01,895130,Yang; Mingyu,1,0,38,37
1746559330188,BIPN 100,A02,895131,Yang; Mingyu,32,0,38,6
1746559330188,BIPN 100,A03,895132,Yang; Mingyu,32,0,38,6
1746559330188,BIPN 100,A04,895133,Yang; Mingyu,27,0,36,9
1746559331215,BIPN 120,A01,895135,Cooke; James Edward,0,3,13,13
1746559331215,BIPN 120,A02,895136,Cooke; James Edward,0,1,13,13
1746559331215,BIPN 120,A03,895137,Cooke; James Edward,0,3,13,13
1746559331215,BIPN 120,A04,895156,Cooke; James Edward,0,2,11,11
1746559332241,BIPN 134,A01,895235,Cooke; James Edward,0,2,25,25
1746559332241,BIPN 134,A02,895237,Cooke; James Edward,0,0,25,25
1746559332241,BIPN 134,A03,895240,Cooke; James Edward,3,0,25,22
1746559332241,BIPN 134,A04,895270,Cooke; James Edward,20,0,25,5
1746559333265,BIPN 189,A00,892103,Staff,0,13,14,14
1746559335318,BISP 194,A00,958008,Staff,0,2,0,0
1746559336344,CAT 124,A01,922009,Staff,0,5,20,20
1746559337376,CAT 125R,A00,886390,Morales; Celeste Georgianna,0,2,20,20
1746559337376,CAT 125R,B00,886391,Irwin; Matthew Joseph,0,3,20,20
1746559337376,CAT 125R,C00,886392,Smith; Lauryn Alissa,0,2,20,20
1746559337376,CAT 125R,D00,886393,Vanderschuit; Maya Alysia,0,2,20,20
1746559337376,CAT 125R,E00,886394,Marchisotto; Jennifer Anne,0,4,20,20
1746559338405,CENG 15,A01,886218,Drews; Aaron,3,0,8,5
1746559339432,CENG 113,A00,886219,Opatkiewicz; Justin Paul,15,0,25,10
1746559340458,CGS 101,A00,887044,Staff,7,0,20,13
1746559341485,CGS 105,A01,887046,Staff,14,0,25,11
1746559342513,CGS 112,A00,887047,Cuong; Marisol,12,0,15,3
1746559343538,CGS 113,A00,887048,Staff,23,0,30,7
1746559344563,CGS 120,A00,887049,Staff,10,0,17,7
1746559345593,CHEM 6A,A01,886336,Lam; Tin Yiu,38,0,50,12
1746559345593,CHEM 6A,A02,886338,Lam; Tin Yiu,37,0,50,13
1746559346621,CHEM 6B,A01,886341,Hopkins; Patrycja Anna,16,0,50,34
1746559346621,CHEM 6B,A02,886343,Hopkins; Patrycja Anna,42,0,50,8
1746559347648,CHEM 6C,A01,886346,Albizati; Kim F.,0,2,50,50
1746559347648,CHEM 6C,A02,886348,Albizati; Kim F.,23,0,50,27
1746559348674,CHEM 40A,A01,886352,Klosterman; Jeremy K,65,0,100,35
1746559349698,CHEM 40B,A01,886356,Klosterman; Jeremy K,0,23,100,100
1746559350724,CHEM 41B,A01,886360,Theodorakis; Emmanuel,25,0,50,25
1746559350724,CHEM 41B,A02,886362,Theodorakis; Emmanuel,47,0,50,3
1746559351749,CHIN 165A,A00,886382,Xu; Li,18,0,20,2
1746559352774,CLAS 120,A00,886387,Myerston Santana; Jacobo,33,0,40,7
1746559353800,COGS 9,A01,886967,Shannon; Kyle Michael,42,0,60,18
1746559354827,COGS 11,A01,886969,Staff,11,0,30,19
1746559355852,COGS 14A,A01,886971,Staff,6,0,60,54
1746559356876,COGS 14B,A01,886973,Hoffman; Drew Ellen,4,0,60,56
1746559357901,COGS 18,A01,886975,Morgan; Eric,35,0,60,25
1746559358928,COGS 20,A01,886977,Staff,4,0,8,4
1746559358928,COGS 20,A02,886978,Staff,5,0,7,2
1746559359957,COGS 100,A01,907783,Staff,0,2,30,30
1746559360981,COGS 101B,A01,886980,Staff,0,3,48,48
1746559362006,COGS 101C,A01,886982,Delgado; Tania,0,5,44,44
1746559363031,COGS 102A,A01,886984,Johnson; Christine M.,4,0,30,26
1746559364058,COGS 118B,A01,886986,Staff,0,3,88,88
1746559365087,COGS 150,A01,886988,Bergen; Benjamin,23,0,50,27
1746559366112,COGS 153,A00,886989,Delgado; Tania,0,2,41,41
1746559367137,COGS 186,A01,886991,Staff,0,0,32,32
1746559368164,COGS 187A,A01,886993,Boyle; Mary E. T.,7,0,30,23
1746559369190,COGS 189,A00,886994,Staff,0,1,30,30
1746559370214,COMM 10,A01,886996,Staff,0,0,20,21
1746559370214,COMM 10,A02,886997,Staff,12,0,20,8
1746559370214,COMM 10,A03,959845,Staff,19,0,20,1
1746559371242,COMM 20,A01,886999,Leuning; Grant Maurstad,24,0,40,16
1746559373291,COMM 100A,A01,887002,Staff,0,0,20,25
1746559373291,COMM 100A,A02,887003,Staff,7,0,20,13
1746559374319,COMM 100B,A01,887005,Staff,0,8,20,24
1746559375342,COMM 106D,A00,887006,Staff,14,0,40,26
1746559376369,COMM 110G,A00,887007,Whitworth-Smith; Andrew C,12,0,40,28
1746559377394,COMM 111B,A00,887008,Staff,31,0,40,9
1746559378419,COMM 113T,A00,887009,Abuelhiga; Soraya Jill,28,0,40,12
1746559378419,COMM 113T,B00,906733,Staff,40,0,40,0
1746559379446,COMM 145,A00,887010,Staff,12,0,40,28
1746559380476,COMM 146,A00,887054,Staff,31,0,40,9
1746559381500,COMM 190,A00,887012,Staff,8,0,23,15
1746559382527,CSE 8A,A50,887015,Cao; Yingjun,57,0,85,28
1746559383553,CSE 11,A01,887017,Cao; Yingjun,12,0,70,58
1746559384579,CSE 20,A01,887019,Staff,30,0,50,20
1746559385604,CSE 21,A01,887021,Staff,78,0,100,22
1746559385604,CSE 21,B01,892583,Braun; Oliver,45,0,50,5
1746559386629,CSE 30,A01,887025,Eldon; John,143,0,200,57
1746559387655,CSE 100,A01,887027,Staff,26,0,50,24
1746559387655,CSE 100,A02,887028,Staff,42,0,50,8
1746559388680,CSE 101,A01,887030,Braun; Oliver,74,0,100,26
1746559388680,CSE 101,B01,887032,Jones; Miles E,0,3,50,50
1746559388680,CSE 101,B02,887033,Jones; Miles E,0,2,50,50
1746559389709,CSE 105,A01,908084,Jones; Miles E,32,0,50,18
1746559389709,CSE 105,A02,908087,Jones; Miles E,32,0,50,18
1746559390735,CSE 135,A01,887035,Powell; Thomas Allan,0,4,50,50
1746559391760,CSE 142,A01,887037,Staff,8,0,60,52
1746559392787,CSE 142L,A01,887039,Staff,34,0,60,26
1746559393813,CSE 151A,A01,887041,Solares; Edwin A,47,0,100,53
1746559394836,CSE 175,A01,887043,Kumar; Rakesh,30,0,30,0
1746559395861,CSS 1,A01,886389,Staff,1,1,40,39
1746559396887,DSC 30,A01,908097,Liao; Soohyun Nam,47,0,75,28
1746559397913,DSC 40A,A01,908099,Shannon; Kyle Michael,30,0,50,20
1746559398940,DSC 40B,A01,908112,Staff,16,0,50,34
1746559399967,DSC 80,A01,908116,Staff,19,0,60,41
1746559400994,DSC 197,001,956863,Eldridge; Justin Matthew,9999,0,9999,0
1746559402022,ECE 5,A01,886400,Morris; Karcher William,2,0,6,4
1746559402022,ECE 5,A02,886401,Morris; Karcher William,3,0,6,3
1746559403047,ECE 148,A01,886403,Silberman; Jack,0,14,14,14
1746559404073,ECON 1,A01,887265,Crane; Meredith Helen,12,0,70,58
1746559404073,ECON 1,B01,887268,Staff,43,0,50,7
1746559405099,ECON 2,A01,887273,Crane; Meredith Helen,55,0,70,15
1746559406126,ECON 3,A01,887279,Rondina; Giacomo,32,0,70,38
1746559407151,ECON 4,A01,887282,Anderson; John Charles,0,2,10,10
1746559408179,ECON 5,A01,887285,Staff,33,0,45,12
1746559408179,ECON 5,B01,887292,Staff,41,0,45,4
1746559409205,ECON 100A,A01,887337,Newhouse; Herbert S,54,0,70,16
1746559409205,ECON 100A,B01,887349,Staff,45,0,50,5
1746559410229,ECON 100B,A01,887361,Du; Songzi,30,0,70,40
1746559411255,ECON 100C,A01,887445,Newhouse; Herbert S,59,0,70,11
1746559412281,ECON 105,A00,887488,Vespa; Emanuel Ignacio,23,0,35,12
1746559413320,ECON 109,A01,887506,Shishkin; Denis,28,0,35,7
1746559414345,ECON 110A,A01,887568,Alon; Titan Michael,0,3,35,35
1746559414345,ECON 110A,B01,907601,Alon; Titan Michael,20,0,35,15
1746559415368,ECON 110B,A01,887598,Levkoff; Steven B.,0,24,70,70
1746559416397,ECON 112,A00,887599,Rondina; Giacomo,19,0,35,16
1746559417430,ECON 120A,A01,887603,Dai; Yinlin,35,0,70,35
1746559418456,ECON 120C,A01,887608,Sun; Yixiao,0,1,35,35
1746559418456,ECON 120C,B01,887614,Sun; Yixiao,0,0,35,35
1746559419485,ECON 138,A00,887621,Bharadwaj; Prashant,0,21,20,20
1746559420510,ECON 144,A00,958007,Squires; Dale E,13,0,35,22
1746559421540,ECON 171,A01,907666,Staff,18,0,35,17
1746559422603,ECON 175,A00,887626,Wu; Pak Yeung,23,0,35,12
1746559423629,ECON 190,A00,887640,Vespa; Emanuel Ignacio,23,0,35,12
1746559424655,EDS 25,A01,888197,Staff,0,0,0,0
1746559424655,EDS 25,A02,888209,Staff,0,0,0,0
1746559424655,EDS 25,A03,888210,Staff,0,0,0,0
1746559424655,EDS 25,A04,888212,Staff,0,0,0,0
1746559424655,EDS 25,A05,888213,Staff,0,0,0,0
1746559424655,EDS 25,A06,888214,Staff,0,0,0,0
1746559424655,EDS 25,A07,888235,Staff,0,2,0,0
1746559424655,EDS 25,A08,888236,Staff,0,0,0,0
1746559424655,EDS 25,A09,888240,Staff,0,0,0,0
1746559424655,EDS 25,A10,888244,Staff,0,0,0,0
1746559424655,EDS 25,B01,888273,Staff,0,0,0,0
1746559424655,EDS 25,B02,888285,Staff,0,0,0,0
1746559424655,EDS 25,B03,888423,Staff,0,0,0,1
1746559424655,EDS 25,B04,888432,Staff,0,0,0,0
1746559424655,EDS 25,B05,888433,Staff,0,0,0,0
1746559424655,EDS 25,B06,888467,Staff,0,0,0,0
1746559424655,EDS 25,B07,888468,Staff,0,0,0,0
1746559424655,EDS 25,B08,888479,Staff,0,0,0,0
1746559424655,EDS 25,B09,888484,Staff,0,0,0,0
1746559424655,EDS 25,B10,888487,Staff,0,0,0,0
1746559425692,EDS 38,A01,907700,Choi; Bailey Miyeon,30,0,30,0
1746559426718,EDS 112,A01,888601,Chapman; Thandeka K,13,0,40,27
1746559427745,EDS 115,A00,888697,Mendez; Kathrina Mendoza,10,0,30,20
1746559428771,EDS 116,A01,888893,Staff,35,0,40,5
1746559430823,EDS 124AR,A00,889133,Staff,29,0,50,21
1746559430823,EDS 124AR,B00,907471,Simon; Elizabeth A,37,0,50,13
1746559431851,EDS 124BR,A00,889134,Simon; Elizabeth A,44,0,100,56
1746559432879,EDS 125,A00,889135,Staff,25,0,30,5
1746559433905,EDS 126,A01,889138,Staff,36,0,40,4
1746559434933,EDS 164R,A01,889142,Wishard Guerra; Alison G.,33,0,50,17
1746559435957,ENG 30,A01,886396,Staff,0,0,0,0
1746559435957,ENG 30,B01,886398,Staff,0,0,0,0
1746559436994,ENVR 102,A00,906150,Montejo; Carolina,23,0,25,2
1746559438022,ETHN 103A,A00,887236,Man; Simeon S,0,3,0,0
1746559439047,ETHN 113,A00,887239,Staff,16,0,30,14
1746559440072,ETHN 116,A00,887240,Staff,16,0,25,9
1746559441098,ETHN 117,A00,887241,Choi; Esther Min,28,0,30,2
1746559442125,ETHN 118,A00,887243,Staff,24,0,30,6
1746559443150,ETHN 127,A00,887248,Cuong; Marisol,11,0,15,4
1746559444176,ETHN 139,A00,887250,Staff,7,0,10,3
1746559445203,ETHN 142,A00,887252,Staff,10,0,30,20
1746559446228,ETHN 161,A00,887253,Browne; Errol Tsekani,24,0,30,6
1746559447257,ETHN 163FR,A00,887255,Burelle; Julie Sara Veronique,0,0,5,5
1746559448284,GLBH 20,A00,889149,Elwardani; Nile Regina,8,0,42,34
1746559450337,GLBH 111,A01,889152,Burgos; Jose L.,17,0,17,0
1746559451360,GLBH 150,A00,889181,Sloane; Julia Kathryn,0,5,15,15
1746559453411,HDS 60,A01,886406,Warstadt; Melissa Fawn,73,0,80,7
1746559454437,HIAF 111,A00,889324,Gyamfi; Bright,25,0,32,7
1746559455461,HIEA 131,A00,889328,Staff,16,0,32,16
1746559456485,HIEA 144,A00,889333,Henry; Todd A.,26,0,32,6
1746559457510,HIEA 154,A00,889336,Henry; Todd A.,24,0,32,8
1746559458538,HIEU 106,A00,889339,Staff,22,0,32,10
1746559460593,HIEU 114,A00,889340,Staff,3,0,32,29
1746559461620,HIEU 135GS,A00,889342,Patterson; Patrick H.,0,0,1,24
1746559462643,HIEU 137,A00,889343,Edington; Claire Ellen,9,0,25,16
1746559463668,HIEU 148,A00,889345,Staff,14,0,32,18
1746559464693,HIEU 154,A00,889346,Biess; Frank Peter,21,0,32,11
1746559465718,HILA 102,A00,889351,Staff,12,0,32,20
1746559466743,HILD 2A,A01,889221,Lewandoski; Julia Mavis,1,10,32,31
1746559467771,HILD 7B,A01,889225,Man; Simeon S,0,12,32,32
1746559468797,HILD 7C,A01,889288,Alvarez; Luis A,0,14,32,32
1746559469825,HILD 30,A01,889323,Staff,0,5,32,32
1746559471875,HISC 119,A00,889383,Golan; Tal,20,0,32,12
1746559472899,HIUS 103,A00,889384,Man; Simeon S,0,0,32,32
1746559473924,HIUS 117,A00,919797,Kwak; Nancy,18,0,32,14
1746559474951,HIUS 142A,A00,919788,Staff,22,0,32,10
1746559477005,HIUS 149,A00,889386,Gyamfi; Bright,27,0,32,5
1746559478029,HIUS 155,A00,889387,Alvarez; Luis A,14,0,32,18
1746559479054,HUM 3,A01,886499,Caldwell; Michael Alan,19,0,50,31
1746559480082,HUM 3GS,A00,886500,Rodriguez; Bretton Sigfred,0,0,0,28
1746559481111,HUM 3R,A01,886502,Markman; Kristina,0,36,50,50
1746559482137,HUM 4,A01,886504,Crum; Matthew Stephen,24,0,50,26
1746559482137,HUM 4,B01,886506,West; Geoffrey Scott,17,0,50,33
1746559483161,HUM 4GS,A00,886507,Staff,0,0,0,19
1746559484189,HUM 5,A01,886509,Staff,32,0,50,18
1746559485217,HUM 5R,A01,886511,Zavodny; Tatiana Sophia,0,39,50,50
1746559486243,JAPN 180,A00,886407,Staff,17,0,40,23
1746559487269,LATI 50,A01,886409,Martin-Cabrera; Luis,4,0,22,18
1746559487269,LATI 50,A02,886410,Martin-Cabrera; Luis,19,0,22,3
1746559487269,LATI 50,A03,886411,Martin-Cabrera; Luis,21,0,22,1
1746559487269,LATI 50,A04,886412,Martin-Cabrera; Luis,9,0,22,13
1746559488296,LAWS 101,A00,907664,Staff,28,0,60,32
1746559489324,LIAB 1A,A00,889388,Saab; Dima,17,0,20,3
1746559490352,LIAB 1AX,A00,889389,El Cheddadi; Youniss,17,0,20,3
1746559491380,LIFR 1C,A00,889391,Van Moer; Vinciane G,8,0,20,12
1746559492417,LIFR 1CX,A00,889392,Van Moer; Vinciane G,7,0,20,13
1746559493445,LIFR 1D,A00,889393,Van Moer; Vinciane G,7,0,20,13
1746559494472,LIFR 1DX,A00,889394,Van Moer; Vinciane G,8,0,20,12
1746559495497,LIGN 7,A00,886923,Staff,24,0,50,26
1746559496522,LIGN 17,A00,886924,Kehler; Andrew Scott,125,0,150,25
1746559497549,LTAM 110,A00,889395,Staff,15,0,30,15
1746559498575,LTAM 110GS,A00,958010,Rodriguez; Bretton Sigfred,0,0,0,28
1746559499604,LTCH 101,A00,889397,Staff,23,0,25,2
1746559500632,LTCS 130,A00,889398,Staff,23,0,25,2
1746559501658,LTEA 138,A00,889399,Staff,24,0,40,16
1746559502684,LTEN 149,A00,889400,Wesling; Megan E.,0,3,25,25
1746559503713,LTEN 169,A00,889401,Staff,20,0,25,5
1746559504741,LTEN 180,A00,889402,Staff,10,0,15,5
1746559505766,LTEN 181,A00,889403,Staff,21,0,25,4
1746559506791,LTWL 100,A00,889404,Myerston Santana; Jacobo,2,0,25,23
1746559507814,LTWL 180GS,A00,889405,Staff,0,0,20,20
1746559508841,LTWL 181,A00,889406,Staff,16,0,25,9
1746559509866,LTWL 184,A00,889475,Mukherjee; Silpa,22,0,25,3
1746559510891,LTWR 102C,A00,889486,Staff,30,0,30,0
1746559511917,LTWR 115W,A00,889491,Staff,0,2,15,15
1746559512943,MAE 8,A01,886905,Staff,0,2,0,0
1746559513967,MAE 11,A00,886906,Bandaru; Prabhakar,0,7,50,50
1746559514994,MAE 20,A00,886907,Evdokimenko; Ekaterina,43,0,70,27
1746559516019,MAE 30B,A00,886909,Ghazinejad; Maziar,26,0,45,19
1746559517045,MAE 101B,A00,886910,Saintillan; David,29,0,45,16
1746559518071,MAE 105,A00,886911,Bandaru; Prabhakar,18,0,50,32
1746559519100,MAE 107,B00,958024,Staff,8,0,50,42
1746559520129,MAE 143B,A00,886913,Bewley; Thomas R,6,0,40,34
1746559521154,MAE 148,A01,886915,Silberman; Jack,0,3,14,14
1746559522180,MAE 160,A00,886916,Evdokimenko; Ekaterina,32,0,60,28
1746559523206,MATH 3C,A01,889681,Staff,0,3,30,30
1746559523206,MATH 3C,A02,960048,Staff,25,0,30,5
1746559524232,MATH 10A,A01,889760,Staff,26,0,30,4
1746559524232,MATH 10A,A02,889783,Staff,29,0,30,1
1746559525264,MATH 10B,A01,889785,Verstraete; Jacques Allan,2,0,35,33
1746559525264,MATH 10B,A02,889795,Verstraete; Jacques Allan,4,0,35,31
1746559525264,MATH 10B,B01,889797,Verstraete; Jacques Allan,3,0,35,32
1746559525264,MATH 10B,B02,889828,Verstraete; Jacques Allan,3,0,35,32
1746559526333,MATH 10C,A01,889849,Habib; Yousaf,8,0,30,22
1746559526333,MATH 10C,A02,889852,Habib; Yousaf,14,0,30,16
1746559526333,MATH 10C,A03,889853,Habib; Yousaf,22,0,30,8
1746559526333,MATH 10C,A04,889858,Habib; Yousaf,20,0,30,10
1746559526333,MATH 10C,B01,889861,Staff,1,0,30,29
1746559526333,MATH 10C,B02,889862,Staff,24,0,30,6
1746559526333,MATH 10C,B03,889863,Staff,27,0,30,3
1746559526333,MATH 10C,B04,889967,Staff,23,0,30,7
1746559527365,MATH 18,A01,889974,Staff,7,0,30,23
1746559527365,MATH 18,A02,889977,Staff,20,0,30,10
1746559527365,MATH 18,B01,889984,Hardiman; Liam,21,0,30,9
1746559527365,MATH 18,B02,889985,Hardiman; Liam,25,0,30,5
1746559528393,MATH 20A,A01,889990,Suk; Andrew Hoon,30,0,35,5
1746559529424,MATH 20B,A01,889993,Ohm; Ko Woon,22,0,30,8
1746559529424,MATH 20B,A02,889994,Ohm; Ko Woon,30,0,30,0
1746559529424,MATH 20B,B01,889996,Ohm; Ko Woon,21,0,30,9
1746559529424,MATH 20B,B02,889997,Ohm; Ko Woon,23,0,30,7
1746559530454,MATH 20C,A01,889999,Hammock; Frances H,17,0,30,13
1746559530454,MATH 20C,A02,890003,Hammock; Frances H,23,0,30,7
1746559530454,MATH 20C,B01,890006,Hammock; Frances H,3,0,30,27
1746559530454,MATH 20C,B02,890007,Hammock; Frances H,11,0,30,19
1746559531485,MATH 20D,A01,890011,Cheng; Hsiao-Bing,1,1,30,29
1746559531485,MATH 20D,A02,890012,Cheng; Hsiao-Bing,14,0,30,16
1746559531485,MATH 20D,B01,890016,Cheng; Hsiao-Bing,13,0,30,17
1746559531485,MATH 20D,B02,890017,Cheng; Hsiao-Bing,13,0,30,17
1746559532516,MATH 20E,A01,890026,Harel; Guershon,1,0,30,29
1746559532516,MATH 20E,A02,890029,Harel; Guershon,23,0,30,7
1746559532516,MATH 20E,B01,890033,Harel; Guershon,7,0,30,23
1746559532516,MATH 20E,B02,890101,Harel; Guershon,21,0,30,9
1746559533544,MATH 102,A01,890104,Staff,17,0,30,13
1746559533544,MATH 102,A02,890105,Staff,27,0,30,3
1746559534571,MATH 103B,A01,890116,Salehi Golsefidy; Alireza,3,0,30,27
1746559534571,MATH 103B,B01,890118,Staff,0,3,34,34
1746559535595,MATH 109,A01,890121,Aliabadi Sr.; Mohsen,1,0,30,29
1746559535595,MATH 109,B01,890124,Upadrashta; Pranav Kumar,18,0,30,12
1746559536622,MATH 120A,A01,890126,Eggers; John Dietrich,13,0,30,17
1746559537651,MATH 142B,A01,890128,Ioana; Adrian,19,0,30,11
1746559537651,MATH 142B,A02,890129,Ioana; Adrian,13,0,30,17
1746559538678,MATH 154,A01,890174,Staff,0,0,30,30
1746559538678,MATH 154,A02,890182,Staff,0,0,30,30
1746559539703,MATH 168A,A01,890197,Dumitriu; Ioana,21,0,35,14
1746559540731,MATH 170A,A01,890240,Nie; Jiawang,1,0,30,29
1746559540731,MATH 170A,A02,890241,Nie; Jiawang,11,0,30,19
1746559540731,MATH 170A,A03,890249,Nie; Jiawang,23,0,30,7
1746559541756,MATH 170B,A01,957891,Nag; Panchali,13,0,35,22
1746559543807,MATH 181A,A01,908025,Staff,0,4,35,35
1746559543807,MATH 181A,A02,960115,Staff,27,0,35,8
1746559544835,MATH 181B,A01,959874,Staff,25,0,30,5
1746559545860,MATH 193B,A01,890265,Staff,0,4,35,35
1746559546889,MGT 4,A01,890311,Anderson; John Charles,42,0,88,46
1746559547913,MGT 5,A00,907740,Staff,13,0,98,85
1746559548941,MGT 12,A00,890312,Lindenberger; Wade Douglas,67,0,98,31
1746559549967,MGT 16,A00,957883,Staff,78,0,98,20
1746559552021,MGT 45,A00,890314,Pecore; Joseph P.,46,0,98,52
1746559553047,MGT 71,A00,890315,Staff,0,11,98,98
1746559554072,MGT 100,A00,890316,Yavorsky; Daniel Ryan,44,0,98,54
1746559555097,MGT 103,A00,890317,Ehrich; Kristine R,73,0,98,25
1746559556126,MGT 105,A00,890356,Bates; Kenneth Walter,0,8,98,98
1746559557152,MGT 112,A00,890360,Ehrich; Kristine R,55,0,98,43
1746559558177,MGT 127R,A00,907732,Zhu; Kevin Xiaoguo,23,0,98,75
1746559559206,MGT 131B,A00,890361,Anderson; John Charles,60,0,98,38
1746559560231,MGT 137,A00,890362,Lindenberger; Wade Douglas,65,0,98,33
1746559561258,MGT 160,A00,890369,Johnson; Erik Barry,9,0,98,89
1746559563313,MGT 164,A00,890372,Zimmermann; Carsten,0,40,98,98
1746559564339,MGT 180,A00,890374,Bliss; Barbara Ann,12,0,98,86
1746559565368,MMW 15,A01,886414,Chang; Edmond Yi-Teh,0,12,28,28
1746559565368,MMW 15,A02,886415,Chang; Edmond Yi-Teh,0,8,28,28
1746559565368,MMW 15,A03,886416,Chang; Edmond Yi-Teh,0,8,28,28
1746559565368,MMW 15,A04,886417,Chang; Edmond Yi-Teh,0,8,28,28
1746559565368,MMW 15,B01,886419,Chang; Edmond Yi-Teh,0,7,28,28
1746559565368,MMW 15,B02,886420,Chang; Edmond Yi-Teh,0,8,28,28
1746559565368,MMW 15,B03,886421,Chang; Edmond Yi-Teh,0,7,28,28
1746559565368,MMW 15,B04,886422,Chang; Edmond Yi-Teh,0,8,28,28
1746559565368,MMW 15,C01,886424,Staff,0,9,28,28
1746559565368,MMW 15,C02,886425,Staff,0,8,28,28
1746559565368,MMW 15,C03,886426,Staff,0,8,28,28
1746559565368,MMW 15,C04,886427,Staff,0,8,28,28
1746559565368,MMW 15,C05,958038,Staff,0,8,28,28
1746559565368,MMW 15,C06,958039,Staff,0,8,28,28
1746559566395,MMW 15GS,A00,906910,Patterson; Patrick H.,4,0,28,24
1746559567420,MMW 122R,A01,886429,Rahimi; Babak,0,13,28,28
1746559567420,MMW 122R,A02,886430,Rahimi; Babak,0,12,28,28
1746559567420,MMW 122R,A03,958040,Rahimi; Babak,0,11,28,28
1746559568449,MUS 1A,A01,890937,Staff,2,0,25,23
1746559568449,MUS 1A,A02,891035,Staff,6,0,25,19
1746559568449,MUS 1A,C01,958912,Staff,24,0,25,1
1746559568449,MUS 1A,C02,958913,Staff,25,0,25,0
1746559570499,MUS 2AK,A00,957092,Ohnishi; Takae,15,0,15,0
1746559571526,MUS 4,A01,891044,Staff,2,0,25,23
1746559571526,MUS 4,A02,891045,Staff,23,0,25,2
1746559571526,MUS 4,B01,891048,Staff,17,0,25,8
1746559571526,MUS 4,B02,891050,Staff,25,0,25,0
1746559572556,MUS 5,A01,957506,Dubnov; Shlomo,0,0,25,25
1746559572556,MUS 5,A02,957622,Dubnov; Shlomo,13,0,25,12
1746559572556,MUS 5,A03,957623,Dubnov; Shlomo,20,0,25,5
1746559573585,MUS 6,A01,891053,Freitas Caetano; Marcelo,24,0,25,1
1746559573585,MUS 6,A02,891054,Freitas Caetano; Marcelo,23,0,25,2
1746559574610,MUS 7,A01,891081,Staff,0,0,25,25
1746559574610,MUS 7,A02,891082,Staff,4,0,25,21
1746559575637,MUS 8GS,A00,891118,Borgo; David Garcia,0,0,25,25
1746559576662,MUS 11,A01,891140,Staff,10,0,25,15
1746559576662,MUS 11,A02,891141,Staff,22,0,25,3
1746559577686,MUS 13,A01,891143,Staff,8,0,25,17
1746559577686,MUS 13,A02,891144,Staff,24,0,25,1
1746559578712,MUS 15,A01,891146,Staff,9,0,25,16
1746559578712,MUS 15,A02,891148,Staff,21,0,25,4
1746559578712,MUS 15,B01,891150,Staff,18,0,25,7
1746559578712,MUS 15,B02,891151,Staff,25,0,25,0
1746559579739,MUS 20,A01,891153,Staff,5,0,20,15
1746559579739,MUS 20,A02,891155,Staff,14,0,20,6
1746559580767,MUS 80,A00,891156,Staff,19,0,25,6
1746559580767,MUS 80,B00,891157,Staff,23,0,25,2
1746559581793,MUS 130,A00,891158,Ohnishi; Takae,35,0,35,0
1746559582824,MUS 150GS,A01,891160,Borgo; David Garcia,0,0,25,25
1746559583853,MUS 170,A01,891162,Freitas Caetano; Marcelo,20,0,25,5
1746559583853,MUS 170,A02,891164,Freitas Caetano; Marcelo,21,0,25,4
1746559584878,NANO 11,A00,886220,Vazquez Mena; Oscar,13,0,15,2
1746559585904,NANO 15,A01,886222,Drews; Aaron,4,0,7,3
1746559586931,NANO 104,A00,886224,Sirbuly; Donald,18,0,25,7
1746559587955,PH 40,A00,886528,Staff,23,0,40,17
1746559588980,PH 45,A01,886799,Staff,35,0,40,5
1746559590009,PH 110,A00,886802,Staff,0,7,40,40
1746559591034,PH 172,A00,906716,Staff,19,0,35,16
1746559592059,PH 191,A00,886803,Staff,6,0,40,34
1746559593087,PHIL 1,A00,889500,Staff,20,0,30,10
1746559594115,PHIL 10,A01,889549,Grush; Rick Scott,15,0,22,7
1746559594115,PHIL 10,A02,889551,Grush; Rick Scott,22,0,22,0
1746559595144,PHIL 28,A01,889559,Lamey; Andy M.,0,1,31,31
1746559595144,PHIL 28,A02,889561,Lamey; Andy M.,0,1,30,30
1746559595144,PHIL 28,A03,889572,Lamey; Andy M.,0,1,30,30
1746559596170,PHIL 35,A00,907839,Staff,13,0,15,2
1746559597198,PHIL 60,A00,889574,Staff,73,0,90,17
1746559598223,PHIL 101,A00,958004,Staff,12,0,15,3
1746559600276,PHIL 136,A00,889582,Fulkerson; Matthew Todd,26,0,45,19
1746559601299,PHIL 163,A01,889601,Staff,21,0,30,9
1746559601299,PHIL 163,B01,889606,Brandt; Reuven A,0,3,0,0
1746559602327,PHIL 164,A00,889610,Staff,16,0,30,14
1746559603363,PHIL 165,A00,889613,Staff,23,0,30,7
1746559604389,PHYS 1A,A00,886431,Staff,26,0,70,44
1746559605415,PHYS 1AL,001,886432,Tsai; Philbert S,0,2,30,30
1746559605415,PHYS 1AL,002,886436,Tsai; Philbert S,11,0,30,19
1746559606443,PHYS 1B,A00,886439,Staff,185,0,240,55
1746559607468,PHYS 1BL,001,886441,Tsai; Philbert S,0,4,30,30
1746559607468,PHYS 1BL,002,886444,Tsai; Philbert S,2,0,30,28
1746559608495,PHYS 1C,A00,896092,Arnold; Kam S,78,0,146,68
1746559609523,PHYS 1CL,001,886448,Tsai; Philbert S,0,0,30,30
1746559609523,PHYS 1CL,002,886449,Tsai; Philbert S,0,0,30,30
1746559609523,PHYS 1CL,003,886450,Tsai; Philbert S,16,0,30,14
1746559609523,PHYS 1CL,004,886451,Tsai; Philbert S,15,0,30,15
1746559610549,PHYS 2B,A01,886457,Staff,68,0,115,47
1746559611575,PHYS 2C,A01,886460,Shotwell; Brian,0,9,65,65
1746559612600,PHYS 2CL,A01,886467,Staff,0,4,28,28
1746559612600,PHYS 2CL,A02,886468,Staff,0,3,28,28
1746559613625,PHYS 2D,A01,886470,Staff,10,0,50,40
1746559614654,PHYS 4B,A01,886475,Grinstein; Benjamin,22,0,40,18
1746559615682,POLI 5,A00,891173,Desposato; Scott,7,0,25,18
1746559616708,POLI 5D,A01,891175,Staff,5,0,5,0
1746559616708,POLI 5D,B01,891178,Staff,5,0,5,0
1746559617733,POLI 11,A00,891179,Ferree; Karen E,2,0,35,33
1746559618761,POLI 12,A00,891180,Staff,16,0,30,14
1746559619786,POLI 27,A01,891182,Staff,12,0,75,63
1746559620811,POLI 30,A00,891183,Staff,8,0,50,42
1746559621836,POLI 100B,A00,891244,Staff,5,1,35,30
1746559622862,POLI 100I,A00,891247,Staff,7,0,30,23
1746559623889,POLI 104J,A00,891248,Nichter; Maysa,14,0,30,16
1746559624917,POLI 104U,A00,891250,Nichter; Maysa,2,0,30,28
1746559626970,POLI 110B,A00,891255,Wiens; David,20,0,25,5
1746559627995,POLI 112A,A00,891256,Wiens; David,6,0,25,19
1746559629022,POLI 114BR,A00,891261,Staff,19,0,30,11
1746559630099,POLI 117R,A00,891262,Forman; Fonna,0,6,50,50
1746559631125,POLI 118,A00,891264,Ingham; Sean,17,0,25,8
1746559632152,POLI 124A,A00,891265,Staff,18,0,20,2
1746559633178,POLI 125D,A00,891266,Nichter; Simeon C,2,0,25,23
1746559634203,POLI 126,A00,891268,Nichter; Simeon C,7,0,25,18
1746559635232,POLI 126AA,A00,891272,Staff,17,0,25,8
1746559636257,POLI 130AA,A00,891273,Staff,15,0,20,5
1746559637281,POLI 134AA,A00,891274,Staff,4,0,20,16
1746559639335,POLI 138,A00,891278,Staff,21,0,25,4
1746559640363,POLI 142K,A00,891280,Staff,11,0,25,14
1746559641389,POLI 142M,A00,891281,Gartzke; Erik,17,0,30,13
1746559642423,POLI 142P,A00,891284,Staff,20,0,30,10
1746559643453,POLI 143,A00,891285,Gartzke; Erik,12,0,30,18
1746559644481,POLI 153,A00,891286,Staff,19,0,20,1
1746559646533,POLI 175,A00,891290,Staff,15,0,20,5
1746559647562,PSYC 1,A00,890674,Steiner; Eric Tomas,0,11,45,45
1746559648586,PSYC 2,A00,890676,Albright; Thomas D,21,0,35,14
1746559649615,PSYC 3,A00,890679,Staff,17,0,20,3
1746559650639,PSYC 6,A00,959858,Staff,20,0,20,0
1746559651665,PSYC 60,A01,890684,Rickard; Timothy C.,0,5,45,45
1746559652691,PSYC 70,A01,890689,Geller; Emma Harlan,7,0,30,23
1746559653719,PSYC 71,A01,959860,Staff,21,0,25,4
1746559654746,PSYC 100,A00,890690,Lacefield; Katharine I,0,50,180,180
1746559655773,PSYC 102,A00,890695,Staff,18,0,40,22
1746559656802,PSYC 105,A00,890699,Geller; Emma Harlan,70,0,100,30
1746559657828,PSYC 106,A00,890701,Gorman; Michael R.,6,0,30,24
1746559658857,PSYC 108,A00,890704,Adrian; Julia Anna,0,28,50,50
1746559659885,PSYC 118,A01,890712,Staff,11,0,30,19
1746559660911,PSYC 124,A00,890716,Chapman; Eddie Nathaniel,25,0,60,35
1746559661938,PSYC 131,A00,890717,Anagnostaras; Stephan,0,7,80,80
1746559662966,PSYC 137,A00,890719,Winkielman; Piotr,0,11,30,30
1746559663992,PSYC 144,A00,890721,Adrian; Julia Anna,0,9,45,45
1746559665016,PSYC 162,A00,890805,Staff,2,0,75,73
1746559666041,PSYC 169,A00,890810,Staff,0,14,30,30
1746559667067,PSYC 172,A00,890814,Gorman; Michael R.,9,0,30,21
1746559668095,PSYC 181,A00,890818,Anagnostaras; Stephan,9,0,200,191
1746559669120,PSYC 184,A00,959861,Staff,170,0,175,5
1746559670147,PSYC 189,A00,890823,Staff,0,1,30,30
1746559671174,PSYC 191,A00,890884,Rickard; Timothy C.,0,11,35,35
1746559672200,PSYC 193,A00,890913,Staff,19,0,30,11
1746559672200,PSYC 193,B00,890914,Chapman; Eddie Nathaniel,24,0,30,6
1746559673226,PSYC 193L,A01,890918,Lowe; Angela Beth,20,0,30,10
1746559673226,PSYC 193L,B01,890921,Hurwitz; Ethan Scott,20,0,30,10
1746559673226,PSYC 193L,C01,890928,Staff,30,0,30,0
1746559674250,RELI 149,A00,886806,Rahimi; Babak,23,0,40,17
1746559675278,SE 9,A01,886814,Staff,7,0,20,13
1746559676308,SE 101B,A01,886816,Chadha; Mayank,4,0,35,31
1746559677333,SE 110B,A00,886818,Zhu; Qiang,4,0,75,71
1746559678360,SE 125,A01,886830,Staff,10,0,30,20
1746559679387,SE 130B,A01,886835,Staff,14,0,40,26
1746559680415,SE 131A,A01,886838,Krysl; Petr,34,0,55,21
1746559681442,SE 154,A00,886840,Staff,29,0,50,21
1746559682467,SE 164GS,A01,886849,Staff,6,0,20,14
1746559683492,SE 167GS,A01,886853,Staff,6,0,20,14
1746559684541,SIO 25,A01,890107,Staff,19,0,30,11
1746559685565,SIO 45,A00,890109,Cook; Geoffrey W,117,0,200,83
1746559686590,SIO 109R,A00,890110,Forman; Fonna,0,16,20,20
1746559687619,SIO 187,A01,890114,Kacev; David,15,0,40,25
1746559688644,SOCI 1,A01,890431,Thorpe; Charles Robert,15,0,30,15
1746559688644,SOCI 1,A02,890518,Thorpe; Charles Robert,30,0,30,0
1746559689670,SOCI 2,A01,957978,Staff,25,0,25,0
1746559689670,SOCI 2,A02,957979,Staff,23,0,25,2
1746559690695,SOCI 20,A01,890523,Calderon-Zaks; Michael Aar,23,0,30,7
1746559690695,SOCI 20,A02,890526,Calderon-Zaks; Michael Aar,29,0,30,1
1746559691723,SOCI 30,A01,890533,Pardo Guerra; Juan Pablo,37,0,40,3
1746559692747,SOCI 40,A01,890535,Staff,27,0,45,18
1746559693773,SOCI 104Q,A00,890559,Staff,18,0,30,12
1746559694799,SOCI 106,A00,890560,Arnal; Maud Marie Leonie,20,0,30,10
1746559695827,SOCI 110,A00,890567,Holkenbrink-Monk; Charlene,19,0,30,11
1746559696853,SOCI 112,A00,890568,Victoria Torres; Pablo,2,0,55,53
1746559697878,SOCI 115,A00,890597,Arnal; Maud Marie Leonie,28,0,45,17
1746559699932,SOCI 121,A00,890604,Pardo Guerra; Juan Pablo,38,0,45,7
1746559700960,SOCI 126,A01,890608,Staff,8,0,10,2
1746559701984,SOCI 127,A00,890609,Staff,18,0,30,12
1746559703009,SOCI 131,A00,890610,Thorpe; Charles Robert,37,0,45,8
1746559704036,SOCI 135,A00,890615,Payne; Christine Anna,13,0,45,32
1746559705065,SOCI 139,A00,890620,Staff,38,0,45,7
1746559706089,SOCI 148E,A00,890622,Calderon-Zaks; Michael Aar,36,0,45,9
1746559707116,SOCI 150,A00,890623,Kohler; Kristopher M.,31,0,45,14
1746559708142,SOCI 157,A00,890625,Jules-Rosette; Bennetta W.,18,0,20,2
1746559709168,SOCI 160,A00,890627,Payne; Christine Anna,21,0,45,24
1746559710194,SYN 1,A00,886855,Fish; Gwendolyn Anne,0,0,0,0
1746559710194,SYN 1,B00,906086,Fish; Gwendolyn Anne,0,1,0,2
1746559711224,SYN 2R,A00,886860,Staff,0,17,15,15
1746559711224,SYN 2R,B00,906106,Atkinson; Arthur Laird,0,16,15,15
1746559712255,SYN 100,A01,886866,Browne; Emily,0,28,20,20
1746559712255,SYN 100,B01,906128,Rock; Martin,0,5,20,20
1746559712255,SYN 100,C01,906140,Deavenport; James Cary,0,3,20,20
1746559712255,SYN 100,D01,907816,Deavenport; James Cary,0,5,20,20
1746559713280,TDAC 1,A00,890286,Walsh; Kim C.,8,0,20,12
1746559714303,TDAC 101,A00,890296,Basso; Beatrice,15,0,20,5
1746559715327,TDDE 131,A00,890297,Staff,47,0,50,3
1746559716356,TDDM 1,A00,890287,Weinberg; Sadie,25,0,30,5
1746559717382,TDGE 11,A00,890288,Fulton; Julia,137,0,200,63
1746559717382,TDGE 11,B00,890289,Castro; Robert Jess,184,0,200,16
1746559718406,TDGE 25,B00,957359,Walsh; Kim C.,3,0,20,17
1746559719432,TDGE 40,A01,890292,Power; Jade Yukana,27,0,30,3
1746559720460,TDGE 124,A00,890298,Havis; Allan,0,1,50,50
1746559721484,TDGE 131R,A00,890299,Burelle; Julie Sara Veronique,15,0,42,27
1746559722510,TDHT 101,A00,890300,Staff,10,0,20,10
1746559723540,TDHT 109,A01,890302,Anderson; Mysia Anyse,31,0,40,9
1746559724567,TDMV 1,A00,890293,Arcidiacono; Kristin,18,0,30,12
1746559725594,TDMV 2,A00,890294,Weinberg; Sadie,23,0,30,7
1746559726622,TDMV 3,A00,957878,Arcidiacono; Kristin,28,0,30,2
1746559728676,TDMV 138,A00,890304,Jun; Grace Shin Hae,25,0,40,15
1746559729703,TDMV 140,A00,890305,Corrales; Joseph Bernales,25,0,30,5
1746559730733,TDMV 142,A00,890307,Caligagan; Tony,32,0,40,8
1746559731757,TDMV 144,A00,890308,Camaya; Michelle Ann,25,0,30,5
1746559732784,TDPW 1,A00,890295,Stein; Deborah Isobel,3,0,20,17
1746559733851,USP 2,A01,890272,Lerner; Amy M,6,0,20,14
1746559734876,USP 3,A01,890274,Staff,12,0,30,18
1746559735906,USP 15,A01,890276,Sun; Feiyang,16,0,30,14
1746559736935,USP 25,A00,890277,Shenkman; Michael Thomas,19,0,25,6
1746559737960,USP 138,A00,890278,Staff,13,0,25,12
1746559738988,USP 143,A00,890279,Staff,21,0,70,49
1746559740013,USP 144,A00,890280,Chowdhury; Muhammed Zohir,15,0,30,15
1746559741041,USP 150,A00,890281,Boomhower; Matthew Charles,4,0,30,26
1746559742068,USP 151,A00,890282,Staff,16,0,20,4
1746559743093,USP 162,A00,890283,Andrews; Abigail Leslie,16,0,20,4
1746559744123,USP 168,A00,920477,Kwak; Nancy,1,0,5,4
1746559745147,USP 181,A00,890284,Staff,3,0,20,17
1746559746174,USP 191A,A00,890285,Staff,12,0,20,8
1746559747198,VIS 101,A00,886512,Staff,26,0,75,49
1746559748223,VIS 103,A00,886513,Cruz; Edwin Teddy,61,0,75,14
1746559749248,VIS 108,A00,886514,Staff,3,0,15,12
1746559750272,VIS 127P,A00,886515,Shen; Kuiyi,80,0,146,66
1746559751299,VIS 149,A00,886516,Yoldas; Pinar,0,0,15,15
1746559752329,VIS 164,A00,886526,Erdmann; Dean,19,0,22,3
1746559753356,VIS 194S,A00,886527,Staff,61,0,75,14
1746559754384,WCWP 10A,C00,886484,Martiniuk; Jill,12,0,15,3
1746559755417,WCWP 10B,A00,886490,Uriarte; Emma,0,0,15,15
1746559755417,WCWP 10B,B00,886491,Dhir; Simrita,10,0,15,5
1746559755417,WCWP 10B,C00,886492,Ornelas; Tricia,0,0,15,15
1746559756446,WCWP 100,A00,886494,Young; Mark T,0,6,15,15
1746559758544,AAS 10,A01,886199,Childs; Dennis R.,0,3,0,0
1746559759572,ANAR 104,A01,886940,Shtienberg; Gilad,27,0,30,3
1746559760597,ANAR 120,A00,886953,Staff,12,0,20,8
1746559761623,ANBI 148,A01,886955,Wilder; Linnea Lorene,30,0,40,10
1746559763673,ANSC 122,A00,886957,Staff,25,0,30,5
1746559764700,ANSC 150,A00,886958,Sloane; Julia Kathryn,2,0,15,13
1746559765728,ANSC 156,A00,886959,Jenkins; Janis A.,0,1,15,15
1746559766753,ANSC 180,A00,886960,Staff,11,0,17,6
1746559767777,ANSC 188,A00,886961,Jassal; Aftab,9,0,25,16
1746559768805,ANSC 190,A00,886962,Jassal; Aftab,14,0,25,11
1746559769832,ANSC 191,A00,886963,Staff,18,0,20,2
1746559770862,ANTH 3,A01,891689,Staff,17,0,20,3
1746559771887,ANTH 5,A00,886933,Semendeferi; Ekaterini,16,0,20,4
1746559772917,ANTH 10,A00,886934,Staff,0,12,30,30
1746559773944,ANTH 21,A01,886936,Staff,40,0,60,20
1746559774970,ANTH 23,A01,886938,Staff,92,0,100,8
1746559775995,ANTH 105,A00,886964,Stewart; Alexander B,84,0,100,16
1746559777023,ANTH 108,A00,886965,Pedersen; David,9,0,20,11
1746559778053,AWP 10,001,886147,Staff,0,0,0,0
1746559778053,AWP 10,002,886148,Staff,0,0,0,0
1746559778053,AWP 10,003,886149,Staff,0,0,0,0
1746559778053,AWP 10,004,886150,Staff,0,0,0,0
1746559778053,AWP 10,005,886151,Staff,0,0,0,0
1746559778053,AWP 10,006,886152,Staff,0,0,0,0
1746559778053,AWP 10,007,886153,Staff,0,0,0,0
1746559778053,AWP 10,008,886154,Staff,0,0,0,0
1746559778053,AWP 10,009,886155,Staff,0,0,0,0
1746559778053,AWP 10,010,886156,Staff,0,0,0,0
1746559778053,AWP 10,011,886158,Staff,0,0,0,0
1746559778053,AWP 10,012,886160,Staff,0,0,0,0
1746559778053,AWP 10,013,886161,Staff,0,0,0,0
1746559778053,AWP 10,014,886162,Staff,0,0,0,0
1746559778053,AWP 10,015,886163,Staff,0,0,0,0
1746559778053,AWP 10,016,886164,Staff,0,0,0,0
1746559778053,AWP 10,017,886165,Staff,0,0,0,0
1746559778053,AWP 10,018,886166,Staff,0,0,0,0
1746559778053,AWP 10,019,886168,Staff,0,0,0,0
1746559778053,AWP 10,020,886170,Staff,0,0,0,0
1746559778053,AWP 10,021,886172,Staff,0,0,0,0
1746559779081,AWP 10R,001,886173,Staff,0,1,0,0
1746559779081,AWP 10R,002,886174,Staff,0,1,0,0
1746559779081,AWP 10R,003,886175,Staff,0,0,0,0
1746559779081,AWP 10R,004,886176,Staff,0,0,0,0
1746559779081,AWP 10R,005,886177,Staff,0,0,0,0
1746559779081,AWP 10R,006,886178,Staff,0,0,0,0
1746559779081,AWP 10R,007,886179,Staff,0,0,0,0
1746559779081,AWP 10R,008,886181,Staff,0,0,0,0
1746559779081,AWP 10R,009,886182,Staff,0,0,0,0
1746559779081,AWP 10R,010,886183,Staff,0,0,0,0
1746559779081,AWP 10R,011,886184,Staff,0,0,0,0
1746559779081,AWP 10R,012,886185,Staff,0,0,0,0
1746559779081,AWP 10R,013,886186,Staff,0,0,0,0
1746559779081,AWP 10R,014,886187,Staff,0,0,0,0
1746559779081,AWP 10R,015,886188,Staff,0,0,0,0
1746559779081,AWP 10R,016,886189,Staff,0,0,0,0
1746559779081,AWP 10R,017,960532,Staff,0,0,0,0
1746559779081,AWP 10R,018,960533,Staff,0,0,0,0
1746559779081,AWP 10R,019,960534,Staff,0,0,0,0
1746559779081,AWP 10R,020,960538,Staff,0,0,0,0
1746559779081,AWP 10R,021,960540,Staff,0,0,0,0
1746559779081,AWP 10R,022,960541,Staff,0,0,0,0
1746559779081,AWP 10R,023,960542,Staff,0,0,0,0
1746559779081,AWP 10R,024,960544,Staff,0,0,0,0
1746559779081,AWP 10R,025,960545,Staff,0,0,0,0
1746559779081,AWP 10R,026,960548,Staff,0,0,0,0
1746559780109,AWP 102R,A00,886190,Staff,0,0,0,0
1746559780109,AWP 102R,B00,886191,Staff,0,0,0,0
1746559781135,BENG 100,A01,886193,Staff,17,0,30,13
1746559782161,BENG 122A,A01,886195,Hasty; Jeff M,13,0,30,17
1746559783190,BENG 166A,A00,886196,Sah; Robert Lie-Yuan,0,2,30,30
1746559784218,BENG 190,A00,958050,Khojah; Reem I,22,0,25,3
1746559785243,BIBC 102,A01,894320,Staff,0,0,46,46
1746559785243,BIBC 102,A02,894321,Staff,0,0,46,46
1746559785243,BIBC 102,A03,894344,Staff,7,0,46,39
1746559785243,BIBC 102,A04,894345,Staff,26,0,47,21
1746559786275,BICD 100R,A01,894365,Smith; Laurie,0,3,58,58
1746559786275,BICD 100R,A02,894366,Smith; Laurie,0,5,58,58
1746559786275,BICD 100R,A03,894367,Smith; Laurie,1,0,59,58
1746559786275,BICD 100R,A04,959869,Smith; Laurie,40,0,59,19
1746559787304,BICD 136,A01,894383,Gustafson-Brown; Cindy,14,0,50,36
1746559788332,BIEB 102,A01,894494,Butler; Shannon Rhey,51,0,130,79
1746559790385,BIEB 150,A01,894617,Wills; Christopher,3,0,20,17
1746559790385,BIEB 150,A02,894631,Wills; Christopher,3,0,20,17
1746559790385,BIEB 150,A03,894937,Wills; Christopher,3,0,20,17
1746559790385,BIEB 150,A04,894946,Wills; Christopher,5,0,20,15
1746559791411,BIEB 194,A00,906141,Kurle; Carolyn M.,6,0,20,14
1746559792438,BILD 1,A01,894154,Staff,3,0,19,16
1746559792438,BILD 1,A02,894155,Staff,14,0,19,5
1746559792438,BILD 1,A03,894160,Staff,13,0,19,6
1746559792438,BILD 1,A04,894161,Staff,15,0,18,3
1746559793465,BILD 2,A01,894168,Staff,0,0,50,50
1746559793465,BILD 2,A02,894169,Staff,0,0,50,50
1746559793465,BILD 2,A03,894179,Staff,0,0,50,50
1746559793465,BILD 2,A04,894203,Staff,26,0,50,24
1746559794491,BILD 3,A01,894213,Staff,22,0,31,9
1746559794491,BILD 3,A02,894214,Staff,26,0,31,5
1746559794491,BILD 3,A03,894235,Staff,28,0,31,3
1746559794491,BILD 3,A04,894236,Staff,28,0,32,4
1746559795517,BILD 4,A01,894253,Reuther; Keefe,5,0,24,19
1746559795517,BILD 4,A02,894258,Reuther; Keefe,16,0,24,8
1746559796545,BILD 5,A01,894276,Reuther; Keefe,35,0,50,15
1746559796545,BILD 5,A02,894277,Reuther; Keefe,45,0,50,5
1746559796545,BILD 5,A03,894290,Reuther; Keefe,44,0,50,6
1746559796545,BILD 5,A04,894291,Reuther; Keefe,48,0,50,2
1746559797575,BILD 24,A01,894297,Pirino; Giorgia,40,0,60,20
1746559798604,BIMM 100,B01,958915,Staff,71,0,100,29
1746559799630,BIMM 101,A01,895017,McDonnell; Lisa Marie,0,5,24,24
1746559799630,BIMM 101,A02,895018,McDonnell; Lisa Marie,0,5,24,24
1746559799630,BIMM 101,B01,895020,McDonnell; Lisa Marie,0,6,24,24
1746559799630,BIMM 101,B02,895021,McDonnell; Lisa Marie,0,4,24,24
1746559800656,BIMM 110,A01,895023,Staff,1,0,25,24
1746559800656,BIMM 110,A02,895024,Staff,9,0,25,16
1746559800656,BIMM 110,A03,895025,Staff,18,0,25,7
1746559800656,BIMM 110,A04,895031,Staff,20,0,25,5
1746559801686,BIMM 120,A01,895114,Gustafson-Brown; Cindy,14,0,28,14
1746559801686,BIMM 120,A02,895126,Gustafson-Brown; Cindy,21,0,27,6
1746559802715,BIPN 100,A01,895130,Yang; Mingyu,1,0,38,37
1746559802715,BIPN 100,A02,895131,Yang; Mingyu,32,0,38,6
1746559802715,BIPN 100,A03,895132,Yang; Mingyu,32,0,38,6
1746559802715,BIPN 100,A04,895133,Yang; Mingyu,27,0,36,9
1746559803744,BIPN 120,A01,895135,Cooke; James Edward,0,3,13,13
1746559803744,BIPN 120,A02,895136,Cooke; James Edward,0,1,13,13
1746559803744,BIPN 120,A03,895137,Cooke; James Edward,0,3,13,13
1746559803744,BIPN 120,A04,895156,Cooke; James Edward,0,2,11,11
1746559804769,BIPN 134,A01,895235,Cooke; James Edward,0,2,25,25
1746559804769,BIPN 134,A02,895237,Cooke; James Edward,0,0,25,25
1746559804769,BIPN 134,A03,895240,Cooke; James Edward,3,0,25,22
1746559804769,BIPN 134,A04,895270,Cooke; James Edward,20,0,25,5
1746559805794,BIPN 189,A00,892103,Staff,0,13,14,14
1746559807847,BISP 194,A00,958008,Staff,0,2,0,0
1746559808874,CAT 124,A01,922009,Staff,0,5,20,20
1746559809908,CAT 125R,A00,886390,Morales; Celeste Georgianna,0,2,20,20
1746559809908,CAT 125R,B00,886391,Irwin; Matthew Joseph,0,3,20,20
1746559809908,CAT 125R,C00,886392,Smith; Lauryn Alissa,0,2,20,20
1746559809908,CAT 125R,D00,886393,Vanderschuit; Maya Alysia,0,2,20,20
1746559809908,CAT 125R,E00,886394,Marchisotto; Jennifer Anne,0,4,20,20
1746559810939,CENG 15,A01,886218,Drews; Aaron,3,0,8,5
1746559811964,CENG 113,A00,886219,Opatkiewicz; Justin Paul,15,0,25,10
1746559812987,CGS 101,A00,887044,Staff,7,0,20,13
1746559814016,CGS 105,A01,887046,Staff,14,0,25,11
1746559815072,CGS 112,A00,887047,Cuong; Marisol,12,0,15,3
1746559816098,CGS 113,A00,887048,Staff,23,0,30,7
1746559817124,CGS 120,A00,887049,Staff,10,0,17,7
1746559818150,CHEM 6A,A01,886336,Lam; Tin Yiu,38,0,50,12
1746559818150,CHEM 6A,A02,886338,Lam; Tin Yiu,37,0,50,13
1746559819176,CHEM 6B,A01,886341,Hopkins; Patrycja Anna,16,0,50,34
1746559819176,CHEM 6B,A02,886343,Hopkins; Patrycja Anna,42,0,50,8
1746559820205,CHEM 6C,A01,886346,Albizati; Kim F.,0,2,50,50
1746559820205,CHEM 6C,A02,886348,Albizati; Kim F.,23,0,50,27
1746559821235,CHEM 40A,A01,886352,Klosterman; Jeremy K,65,0,100,35
1746559822261,CHEM 40B,A01,886356,Klosterman; Jeremy K,0,23,100,100
1746559823496,CHEM 41B,A01,886360,Theodorakis; Emmanuel,25,0,50,25
1746559823496,CHEM 41B,A02,886362,Theodorakis; Emmanuel,47,0,50,3
1746559824524,CHIN 165A,A00,886382,Xu; Li,18,0,20,2
1746559825549,CLAS 120,A00,886387,Myerston Santana; Jacobo,33,0,40,7
1746559826577,COGS 9,A01,886967,Shannon; Kyle Michael,42,0,60,18
1746559827604,COGS 11,A01,886969,Staff,11,0,30,19
1746559828629,COGS 14A,A01,886971,Staff,6,0,60,54
1746559829658,COGS 14B,A01,886973,Hoffman; Drew Ellen,4,0,60,56
1746559830684,COGS 18,A01,886975,Morgan; Eric,35,0,60,25
1746559831709,COGS 20,A01,886977,Staff,4,0,8,4
1746559831709,COGS 20,A02,886978,Staff,5,0,7,2
1746559832735,COGS 100,A01,907783,Staff,0,2,30,30
1746559833764,COGS 101B,A01,886980,Staff,0,3,48,48
1746559834791,COGS 101C,A01,886982,Delgado; Tania,0,5,44,44
1746559835820,COGS 102A,A01,886984,Johnson; Christine M.,4,0,30,26
1746559836844,COGS 118B,A01,886986,Staff,0,3,88,88
1746559837875,COGS 150,A01,886988,Bergen; Benjamin,22,0,50,28
1746559838903,COGS 153,A00,886989,Delgado; Tania,0,2,41,41
1746559839932,COGS 186,A01,886991,Staff,0,0,32,32
1746559840958,COGS 187A,A01,886993,Boyle; Mary E. T.,7,0,30,23
1746559841984,COGS 189,A00,886994,Staff,0,1,30,30
1746559843008,COMM 10,A01,886996,Staff,0,0,20,21
1746559843008,COMM 10,A02,886997,Staff,12,0,20,8
1746559843008,COMM 10,A03,959845,Staff,19,0,20,1
1746559844033,COMM 20,A01,886999,Leuning; Grant Maurstad,24,0,40,16
1746559847699,COMM 100A,A01,887002,Staff,0,0,20,25
1746559847699,COMM 100A,A02,887003,Staff,7,0,20,13
1746559848728,COMM 100B,A01,887005,Staff,0,8,20,24
1746559849756,COMM 106D,A00,887006,Staff,14,0,40,26
1746559850783,COMM 110G,A00,887007,Whitworth-Smith; Andrew C,12,0,40,28
1746559851808,COMM 111B,A00,887008,Staff,31,0,40,9
1746559852834,COMM 113T,A00,887009,Abuelhiga; Soraya Jill,28,0,40,12
1746559852834,COMM 113T,B00,906733,Staff,40,0,40,0
1746559853860,COMM 145,A00,887010,Staff,12,0,40,28
1746559854888,COMM 146,A00,887054,Staff,31,0,40,9
1746559855915,COMM 190,A00,887012,Staff,8,0,23,15
1746559856940,CSE 8A,A50,887015,Cao; Yingjun,57,0,85,28
1746559857965,CSE 11,A01,887017,Cao; Yingjun,12,0,70,58
1746559858990,CSE 20,A01,887019,Staff,30,0,50,20
1746559860018,CSE 21,A01,887021,Staff,78,0,100,22
1746559860018,CSE 21,B01,892583,Braun; Oliver,45,0,50,5
1746559861047,CSE 30,A01,887025,Eldon; John,143,0,200,57
1746559862073,CSE 100,A01,887027,Staff,26,0,50,24
1746559862073,CSE 100,A02,887028,Staff,42,0,50,8
1746559863099,CSE 101,A01,887030,Braun; Oliver,74,0,100,26
1746559863099,CSE 101,B01,887032,Jones; Miles E,0,3,50,50
1746559863099,CSE 101,B02,887033,Jones; Miles E,0,2,50,50
1746559864124,CSE 105,A01,908084,Jones; Miles E,32,0,50,18
1746559864124,CSE 105,A02,908087,Jones; Miles E,32,0,50,18
1746559865150,CSE 135,A01,887035,Powell; Thomas Allan,0,4,50,50
1746559866178,CSE 142,A01,887037,Staff,8,0,60,52
1746559867203,CSE 142L,A01,887039,Staff,34,0,60,26
1746559868230,CSE 151A,A01,887041,Solares; Edwin A,47,0,100,53
1746559869256,CSE 175,A01,887043,Kumar; Rakesh,30,0,30,0
1746559870282,CSS 1,A01,886389,Staff,1,1,40,39
1746559871310,DSC 30,A01,908097,Liao; Soohyun Nam,47,0,75,28
1746559872340,DSC 40A,A01,908099,Shannon; Kyle Michael,30,0,50,20
1746559873368,DSC 40B,A01,908112,Staff,16,0,50,34
1746559874392,DSC 80,A01,908116,Staff,19,0,60,41
1746559875420,DSC 197,001,956863,Eldridge; Justin Matthew,9999,0,9999,0
1746559876448,ECE 5,A01,886400,Morris; Karcher William,2,0,6,4
1746559876448,ECE 5,A02,886401,Morris; Karcher William,3,0,6,3
1746559877476,ECE 148,A01,886403,Silberman; Jack,0,14,14,14
1746559878506,ECON 1,A01,887265,Crane; Meredith Helen,12,0,70,58
1746559878506,ECON 1,B01,887268,Staff,43,0,50,7
1746559879537,ECON 2,A01,887273,Crane; Meredith Helen,55,0,70,15
1746559880562,ECON 3,A01,887279,Rondina; Giacomo,32,0,70,38
1746559881587,ECON 4,A01,887282,Anderson; John Charles,0,2,10,10
1746559882613,ECON 5,A01,887285,Staff,34,0,45,11
1746559882613,ECON 5,B01,887292,Staff,41,0,45,4
1746559883639,ECON 100A,A01,887337,Newhouse; Herbert S,54,0,70,16
1746559883639,ECON 100A,B01,887349,Staff,45,0,50,5
1746559884665,ECON 100B,A01,887361,Du; Songzi,29,0,70,41
1746559885690,ECON 100C,A01,887445,Newhouse; Herbert S,59,0,70,11
1746559886716,ECON 105,A00,887488,Vespa; Emanuel Ignacio,23,0,35,12
1746559887744,ECON 109,A01,887506,Shishkin; Denis,28,0,35,7
1746559888769,ECON 110A,A01,887568,Alon; Titan Michael,0,3,35,35
1746559888769,ECON 110A,B01,907601,Alon; Titan Michael,20,0,35,15
1746559889794,ECON 110B,A01,887598,Levkoff; Steven B.,0,24,70,70
1746559890823,ECON 112,A00,887599,Rondina; Giacomo,19,0,35,16
1746559891853,ECON 120A,A01,887603,Dai; Yinlin,35,0,70,35
1746559892880,ECON 120C,A01,887608,Sun; Yixiao,0,1,35,35
1746559892880,ECON 120C,B01,887614,Sun; Yixiao,0,0,35,35
1746559893905,ECON 138,A00,887621,Bharadwaj; Prashant,0,21,20,20
1746559894930,ECON 144,A00,958007,Squires; Dale E,13,0,35,22
1746559895955,ECON 171,A01,907666,Staff,18,0,35,17
1746559896981,ECON 175,A00,887626,Wu; Pak Yeung,23,0,35,12
1746559898005,ECON 190,A00,887640,Vespa; Emanuel Ignacio,23,0,35,12
1746559899039,EDS 25,A01,888197,Staff,0,0,0,0
1746559899039,EDS 25,A02,888209,Staff,0,0,0,0
1746559899039,EDS 25,A03,888210,Staff,0,0,0,0
1746559899039,EDS 25,A04,888212,Staff,0,0,0,0
1746559899039,EDS 25,A05,888213,Staff,0,0,0,0
1746559899039,EDS 25,A06,888214,Staff,0,0,0,0
1746559899039,EDS 25,A07,888235,Staff,0,2,0,0
1746559899039,EDS 25,A08,888236,Staff,0,0,0,0
1746559899039,EDS 25,A09,888240,Staff,0,0,0,0
1746559899039,EDS 25,A10,888244,Staff,0,0,0,0
1746559899039,EDS 25,B01,888273,Staff,0,0,0,0
1746559899039,EDS 25,B02,888285,Staff,0,0,0,0
1746559899039,EDS 25,B03,888423,Staff,0,0,0,1
1746559899039,EDS 25,B04,888432,Staff,0,0,0,0
1746559899039,EDS 25,B05,888433,Staff,0,0,0,0
1746559899039,EDS 25,B06,888467,Staff,0,0,0,0
1746559899039,EDS 25,B07,888468,Staff,0,0,0,0
1746559899039,EDS 25,B08,888479,Staff,0,0,0,0
1746559899039,EDS 25,B09,888484,Staff,0,0,0,0
1746559899039,EDS 25,B10,888487,Staff,0,0,0,0
1746559900069,EDS 38,A01,907700,Choi; Bailey Miyeon,30,0,30,0
1746559901092,EDS 112,A01,888601,Chapman; Thandeka K,13,0,40,27
1746559902124,EDS 115,A00,888697,Mendez; Kathrina Mendoza,10,0,30,20
1746559903149,EDS 116,A01,888893,Staff,35,0,40,5
1746559905207,EDS 124AR,A00,889133,Staff,29,0,50,21
1746559905207,EDS 124AR,B00,907471,Simon; Elizabeth A,37,0,50,13
1746559906233,EDS 124BR,A00,889134,Simon; Elizabeth A,44,0,100,56
1746559907263,EDS 125,A00,889135,Staff,25,0,30,5
1746559908291,EDS 126,A01,889138,Staff,36,0,40,4
1746559909319,EDS 164R,A01,889142,Wishard Guerra; Alison G.,33,0,50,17
1746559910348,ENG 30,A01,886396,Staff,0,0,0,0
1746559910348,ENG 30,B01,886398,Staff,0,0,0,0
1746559911372,ENVR 102,A00,906150,Montejo; Carolina,23,0,25,2
1746559912407,ETHN 103A,A00,887236,Man; Simeon S,0,3,0,0
1746559913431,ETHN 113,A00,887239,Staff,16,0,30,14
1746559914456,ETHN 116,A00,887240,Staff,16,0,25,9
1746559915486,ETHN 117,A00,887241,Choi; Esther Min,28,0,30,2
1746559916511,ETHN 118,A00,887243,Staff,24,0,30,6
1746559917535,ETHN 127,A00,887248,Cuong; Marisol,11,0,15,4
1746559918563,ETHN 139,A00,887250,Staff,7,0,10,3
1746559919587,ETHN 142,A00,887252,Staff,10,0,30,20
1746559920614,ETHN 161,A00,887253,Browne; Errol Tsekani,24,0,30,6
1746559921640,ETHN 163FR,A00,887255,Burelle; Julie Sara Veronique,0,0,5,5
1746559922670,GLBH 20,A00,889149,Elwardani; Nile Regina,8,0,42,34
1746559924719,GLBH 111,A01,889152,Burgos; Jose L.,17,0,17,0
1746559925744,GLBH 150,A00,889181,Sloane; Julia Kathryn,0,5,15,15
1746559927797,HDS 60,A01,886406,Warstadt; Melissa Fawn,73,0,80,7
1746559928823,HIAF 111,A00,889324,Gyamfi; Bright,25,0,32,7
1746559929848,HIEA 131,A00,889328,Staff,16,0,32,16
1746559930874,HIEA 144,A00,889333,Henry; Todd A.,26,0,32,6
1746559931901,HIEA 154,A00,889336,Henry; Todd A.,24,0,32,8
1746559932929,HIEU 106,A00,889339,Staff,22,0,32,10
1746559934985,HIEU 114,A00,889340,Staff,3,0,32,29
1746559936011,HIEU 135GS,A00,889342,Patterson; Patrick H.,0,0,1,24
1746559937035,HIEU 137,A00,889343,Edington; Claire Ellen,9,0,25,16
1746559938061,HIEU 148,A00,889345,Staff,14,0,32,18
1746559939088,HIEU 154,A00,889346,Biess; Frank Peter,21,0,32,11
1746559940115,HILA 102,A00,889351,Staff,12,0,32,20
1746559941141,HILD 2A,A01,889221,Lewandoski; Julia Mavis,1,10,32,31
1746559942169,HILD 7B,A01,889225,Man; Simeon S,0,12,32,32
1746559943198,HILD 7C,A01,889288,Alvarez; Luis A,0,14,32,32
1746559944222,HILD 30,A01,889323,Staff,0,5,32,32
1746559946277,HISC 119,A00,889383,Golan; Tal,20,0,32,12
1746559947304,HIUS 103,A00,889384,Man; Simeon S,0,0,32,32
1746559948330,HIUS 117,A00,919797,Kwak; Nancy,18,0,32,14
1746559949358,HIUS 142A,A00,919788,Staff,22,0,32,10
1746559951415,HIUS 149,A00,889386,Gyamfi; Bright,27,0,32,5
1746559952443,HIUS 155,A00,889387,Alvarez; Luis A,14,0,32,18
1746559953472,HUM 3,A01,886499,Caldwell; Michael Alan,19,0,50,31
1746559954500,HUM 3GS,A00,886500,Rodriguez; Bretton Sigfred,0,0,0,28
1746559955529,HUM 3R,A01,886502,Markman; Kristina,0,36,50,50
1746559956554,HUM 4,A01,886504,Crum; Matthew Stephen,24,0,50,26
1746559956554,HUM 4,B01,886506,West; Geoffrey Scott,17,0,50,33
1746559957580,HUM 4GS,A00,886507,Staff,0,0,0,19
1746559958606,HUM 5,A01,886509,Staff,32,0,50,18
1746559959629,HUM 5R,A01,886511,Zavodny; Tatiana Sophia,0,39,50,50
1746559960657,JAPN 180,A00,886407,Staff,17,0,40,23
1746559961684,LATI 50,A01,886409,Martin-Cabrera; Luis,4,0,22,18
1746559961684,LATI 50,A02,886410,Martin-Cabrera; Luis,19,0,22,3
1746559961684,LATI 50,A03,886411,Martin-Cabrera; Luis,21,0,22,1
1746559961684,LATI 50,A04,886412,Martin-Cabrera; Luis,9,0,22,13
1746559962710,LAWS 101,A00,907664,Staff,28,0,60,32
1746559963737,LIAB 1A,A00,889388,Saab; Dima,17,0,20,3
1746559964763,LIAB 1AX,A00,889389,El Cheddadi; Youniss,18,0,20,2
1746559965790,LIFR 1C,A00,889391,Van Moer; Vinciane G,8,0,20,12
1746559966816,LIFR 1CX,A00,889392,Van Moer; Vinciane G,7,0,20,13
1746559967841,LIFR 1D,A00,889393,Van Moer; Vinciane G,7,0,20,13
1746559968869,LIFR 1DX,A00,889394,Van Moer; Vinciane G,8,0,20,12
1746559969896,LIGN 7,A00,886923,Staff,24,0,50,26
1746559970923,LIGN 17,A00,886924,Kehler; Andrew Scott,125,0,150,25
1746559971950,LTAM 110,A00,889395,Staff,15,0,30,15
1746559972980,LTAM 110GS,A00,958010,Rodriguez; Bretton Sigfred,0,0,0,28
1746559974008,LTCH 101,A00,889397,Staff,23,0,25,2
1746559975035,LTCS 130,A00,889398,Staff,23,0,25,2
1746559976062,LTEA 138,A00,889399,Staff,24,0,40,16
1746559977091,LTEN 149,A00,889400,Wesling; Megan E.,0,3,25,25
1746559978121,LTEN 169,A00,889401,Staff,20,0,25,5
1746559979145,LTEN 180,A00,889402,Staff,10,0,15,5
1746559980171,LTEN 181,A00,889403,Staff,21,0,25,4
1746559981195,LTWL 100,A00,889404,Myerston Santana; Jacobo,2,0,25,23
1746559982221,LTWL 180GS,A00,889405,Staff,0,0,20,20
1746559983253,LTWL 181,A00,889406,Staff,16,0,25,9
1746559984277,LTWL 184,A00,889475,Mukherjee; Silpa,22,0,25,3
1746559985301,LTWR 102C,A00,889486,Staff,30,0,30,0
1746559986326,LTWR 115W,A00,889491,Staff,0,2,15,15
1746559987352,MAE 8,A01,886905,Staff,0,2,0,0
1746559988378,MAE 11,A00,886906,Bandaru; Prabhakar,0,7,50,50
1746559989403,MAE 20,A00,886907,Evdokimenko; Ekaterina,43,0,70,27
1746559990429,MAE 30B,A00,886909,Ghazinejad; Maziar,26,0,45,19
1746559991460,MAE 101B,A00,886910,Saintillan; David,29,0,45,16
1746559992488,MAE 105,A00,886911,Bandaru; Prabhakar,18,0,50,32
1746559993514,MAE 107,B00,958024,Staff,8,0,50,42
1746559994540,MAE 143B,A00,886913,Bewley; Thomas R,6,0,40,34
1746559995570,MAE 148,A01,886915,Silberman; Jack,0,3,14,14
1746559996599,MAE 160,A00,886916,Evdokimenko; Ekaterina,32,0,60,28
1746559997623,MATH 3C,A01,889681,Staff,0,3,30,30
1746559997623,MATH 3C,A02,960048,Staff,25,0,30,5
1746559998651,MATH 10A,A01,889760,Staff,26,0,30,4
1746559998651,MATH 10A,A02,889783,Staff,29,0,30,1
1746559999677,MATH 10B,A01,889785,Verstraete; Jacques Allan,2,0,35,33
1746559999677,MATH 10B,A02,889795,Verstraete; Jacques Allan,4,0,35,31
1746559999677,MATH 10B,B01,889797,Verstraete; Jacques Allan,3,0,35,32
1746559999677,MATH 10B,B02,889828,Verstraete; Jacques Allan,3,0,35,32
1746560000708,MATH 10C,A01,889849,Habib; Yousaf,8,0,30,22
1746560000708,MATH 10C,A02,889852,Habib; Yousaf,14,0,30,16
1746560000708,MATH 10C,A03,889853,Habib; Yousaf,22,0,30,8
1746560000708,MATH 10C,A04,889858,Habib; Yousaf,20,0,30,10
1746560000708,MATH 10C,B01,889861,Staff,1,0,30,29
1746560000708,MATH 10C,B02,889862,Staff,24,0,30,6
1746560000708,MATH 10C,B03,889863,Staff,27,0,30,3
1746560000708,MATH 10C,B04,889967,Staff,23,0,30,7
1746560001739,MATH 18,A01,889974,Staff,7,0,30,23
1746560001739,MATH 18,A02,889977,Staff,20,0,30,10
1746560001739,MATH 18,B01,889984,Hardiman; Liam,21,0,30,9
1746560001739,MATH 18,B02,889985,Hardiman; Liam,25,0,30,5
1746560002766,MATH 20A,A01,889990,Suk; Andrew Hoon,30,0,35,5
1746560003798,MATH 20B,A01,889993,Ohm; Ko Woon,22,0,30,8
1746560003798,MATH 20B,A02,889994,Ohm; Ko Woon,30,0,30,0
1746560003798,MATH 20B,B01,889996,Ohm; Ko Woon,21,0,30,9
1746560003798,MATH 20B,B02,889997,Ohm; Ko Woon,23,0,30,7
1746560004823,MATH 20C,A01,889999,Hammock; Frances H,17,0,30,13
1746560004823,MATH 20C,A02,890003,Hammock; Frances H,23,0,30,7
1746560004823,MATH 20C,B01,890006,Hammock; Frances H,3,0,30,27
1746560004823,MATH 20C,B02,890007,Hammock; Frances H,11,0,30,19
1746560005851,MATH 20D,A01,890011,Cheng; Hsiao-Bing,1,1,30,29
1746560005851,MATH 20D,A02,890012,Cheng; Hsiao-Bing,14,0,30,16
1746560005851,MATH 20D,B01,890016,Cheng; Hsiao-Bing,13,0,30,17
1746560005851,MATH 20D,B02,890017,Cheng; Hsiao-Bing,13,0,30,17
1746560006877,MATH 20E,A01,890026,Harel; Guershon,1,0,30,29
1746560006877,MATH 20E,A02,890029,Harel; Guershon,23,0,30,7
1746560006877,MATH 20E,B01,890033,Harel; Guershon,7,0,30,23
1746560006877,MATH 20E,B02,890101,Harel; Guershon,21,0,30,9
1746560007902,MATH 102,A01,890104,Staff,17,0,30,13
1746560007902,MATH 102,A02,890105,Staff,27,0,30,3
1746560008932,MATH 103B,A01,890116,Salehi Golsefidy; Alireza,3,0,30,27
1746560008932,MATH 103B,B01,890118,Staff,0,3,34,34
1746560009963,MATH 109,A01,890121,Aliabadi Sr.; Mohsen,1,0,30,29
1746560009963,MATH 109,B01,890124,Upadrashta; Pranav Kumar,18,0,30,12
1746560010990,MATH 120A,A01,890126,Eggers; John Dietrich,13,0,30,17
1746560012014,MATH 142B,A01,890128,Ioana; Adrian,19,0,30,11
1746560012014,MATH 142B,A02,890129,Ioana; Adrian,13,0,30,17
1746560013041,MATH 154,A01,890174,Staff,0,0,30,30
1746560013041,MATH 154,A02,890182,Staff,0,0,30,30
1746560014070,MATH 168A,A01,890197,Dumitriu; Ioana,21,0,35,14
1746560015097,MATH 170A,A01,890240,Nie; Jiawang,1,0,30,29
1746560015097,MATH 170A,A02,890241,Nie; Jiawang,11,0,30,19
1746560015097,MATH 170A,A03,890249,Nie; Jiawang,23,0,30,7
1746560016125,MATH 170B,A01,957891,Nag; Panchali,13,0,35,22
1746560018174,MATH 181A,A01,908025,Staff,0,4,35,35
1746560018174,MATH 181A,A02,960115,Staff,27,0,35,8
1746560019199,MATH 181B,A01,959874,Staff,25,0,30,5
1746560020224,MATH 193B,A01,890265,Staff,0,4,35,35
1746560021250,MGT 4,A01,890311,Anderson; John Charles,42,0,88,46
1746560022275,MGT 5,A00,907740,Staff,13,0,98,85
1746560023302,MGT 12,A00,890312,Lindenberger; Wade Douglas,67,0,98,31
1746560024330,MGT 16,A00,957883,Staff,78,0,98,20
1746560026380,MGT 45,A00,890314,Pecore; Joseph P.,46,0,98,52
1746560027410,MGT 71,A00,890315,Staff,0,11,98,98
1746560028435,MGT 100,A00,890316,Yavorsky; Daniel Ryan,44,0,98,54
1746560029460,MGT 103,A00,890317,Ehrich; Kristine R,73,0,98,25
1746560030492,MGT 105,A00,890356,Bates; Kenneth Walter,0,8,98,98
1746560031518,MGT 112,A00,890360,Ehrich; Kristine R,55,0,98,43
1746560032549,MGT 127R,A00,907732,Zhu; Kevin Xiaoguo,23,0,98,75
1746560033575,MGT 131B,A00,890361,Anderson; John Charles,60,0,98,38
1746560034602,MGT 137,A00,890362,Lindenberger; Wade Douglas,65,0,98,33
1746560035631,MGT 160,A00,890369,Johnson; Erik Barry,9,0,98,89
1746560037686,MGT 164,A00,890372,Zimmermann; Carsten,0,40,98,98
1746560038713,MGT 180,A00,890374,Bliss; Barbara Ann,12,0,98,86
1746560039737,MMW 15,A01,886414,Chang; Edmond Yi-Teh,0,12,28,28
1746560039737,MMW 15,A02,886415,Chang; Edmond Yi-Teh,0,8,28,28
1746560039737,MMW 15,A03,886416,Chang; Edmond Yi-Teh,0,8,28,28
1746560039737,MMW 15,A04,886417,Chang; Edmond Yi-Teh,0,8,28,28
1746560039737,MMW 15,B01,886419,Chang; Edmond Yi-Teh,0,7,28,28
1746560039737,MMW 15,B02,886420,Chang; Edmond Yi-Teh,0,8,28,28
1746560039737,MMW 15,B03,886421,Chang; Edmond Yi-Teh,0,7,28,28
1746560039737,MMW 15,B04,886422,Chang; Edmond Yi-Teh,0,8,28,28
1746560039737,MMW 15,C01,886424,Staff,0,9,28,28
1746560039737,MMW 15,C02,886425,Staff,0,8,28,28
1746560039737,MMW 15,C03,886426,Staff,0,8,28,28
1746560039737,MMW 15,C04,886427,Staff,0,8,28,28
1746560039737,MMW 15,C05,958038,Staff,0,8,28,28
1746560039737,MMW 15,C06,958039,Staff,0,8,28,28
1746560040762,MMW 15GS,A00,906910,Patterson; Patrick H.,4,0,28,24
1746560041787,MMW 122R,A01,886429,Rahimi; Babak,0,13,28,28
1746560041787,MMW 122R,A02,886430,Rahimi; Babak,0,12,28,28
1746560041787,MMW 122R,A03,958040,Rahimi; Babak,0,11,28,28
1746560042819,MUS 1A,A01,890937,Staff,2,0,25,23
1746560042819,MUS 1A,A02,891035,Staff,6,0,25,19
1746560042819,MUS 1A,C01,958912,Staff,24,0,25,1
1746560042819,MUS 1A,C02,958913,Staff,25,0,25,0
1746560044872,MUS 2AK,A00,957092,Ohnishi; Takae,15,0,15,0
1746560045912,MUS 4,A01,891044,Staff,2,0,25,23
1746560045912,MUS 4,A02,891045,Staff,23,0,25,2
1746560045912,MUS 4,B01,891048,Staff,17,0,25,8
1746560045912,MUS 4,B02,891050,Staff,25,0,25,0
1746560046940,MUS 5,A01,957506,Dubnov; Shlomo,0,0,25,25
1746560046940,MUS 5,A02,957622,Dubnov; Shlomo,13,0,25,12
1746560046940,MUS 5,A03,957623,Dubnov; Shlomo,20,0,25,5
1746560047968,MUS 6,A01,891053,Freitas Caetano; Marcelo,24,0,25,1
1746560047968,MUS 6,A02,891054,Freitas Caetano; Marcelo,23,0,25,2
1746560048993,MUS 7,A01,891081,Staff,0,0,25,25
1746560048993,MUS 7,A02,891082,Staff,4,0,25,21
1746560050043,MUS 8GS,A00,891118,Borgo; David Garcia,0,0,25,25
1746560051065,MUS 11,A01,891140,Staff,10,0,25,15
1746560051065,MUS 11,A02,891141,Staff,22,0,25,3
1746560052090,MUS 13,A01,891143,Staff,8,0,25,17
1746560052090,MUS 13,A02,891144,Staff,24,0,25,1
1746560053116,MUS 15,A01,891146,Staff,9,0,25,16
1746560053116,MUS 15,A02,891148,Staff,21,0,25,4
1746560053116,MUS 15,B01,891150,Staff,18,0,25,7
1746560053116,MUS 15,B02,891151,Staff,25,0,25,0
1746560054144,MUS 20,A01,891153,Staff,5,0,20,15
1746560054144,MUS 20,A02,891155,Staff,14,0,20,6
1746560055170,MUS 80,A00,891156,Staff,19,0,25,6
1746560055170,MUS 80,B00,891157,Staff,23,0,25,2
1746560056195,MUS 130,A00,891158,Ohnishi; Takae,35,0,35,0
1746560057219,MUS 150GS,A01,891160,Borgo; David Garcia,0,0,25,25
1746560058243,MUS 170,A01,891162,Freitas Caetano; Marcelo,20,0,25,5
1746560058243,MUS 170,A02,891164,Freitas Caetano; Marcelo,21,0,25,4
1746560059271,NANO 11,A00,886220,Vazquez Mena; Oscar,13,0,15,2
1746560060300,NANO 15,A01,886222,Drews; Aaron,4,0,7,3
1746560061325,NANO 104,A00,886224,Sirbuly; Donald,18,0,25,7
1746560062351,PH 40,A00,886528,Staff,23,0,40,17
1746560063380,PH 45,A01,886799,Staff,35,0,40,5
1746560064405,PH 110,A00,886802,Staff,0,7,40,40
1746560065428,PH 172,A00,906716,Staff,19,0,35,16
1746560066453,PH 191,A00,886803,Staff,6,0,40,34
1746560067478,PHIL 1,A00,889500,Staff,20,0,30,10
1746560068502,PHIL 10,A01,889549,Grush; Rick Scott,15,0,22,7
1746560068502,PHIL 10,A02,889551,Grush; Rick Scott,22,0,22,0
1746560069537,PHIL 28,A01,889559,Lamey; Andy M.,0,1,31,31
1746560069537,PHIL 28,A02,889561,Lamey; Andy M.,0,1,30,30
1746560069537,PHIL 28,A03,889572,Lamey; Andy M.,0,1,30,30
1746560070565,PHIL 35,A00,907839,Staff,13,0,15,2
1746560071588,PHIL 60,A00,889574,Staff,73,0,90,17
1746560072611,PHIL 101,A00,958004,Staff,12,0,15,3
1746560074671,PHIL 136,A00,889582,Fulkerson; Matthew Todd,26,0,45,19
1746560075696,PHIL 163,A01,889601,Staff,21,0,30,9
1746560075696,PHIL 163,B01,889606,Brandt; Reuven A,0,3,0,0
1746560076721,PHIL 164,A00,889610,Staff,16,0,30,14
1746560077746,PHIL 165,A00,889613,Staff,23,0,30,7
1746560078773,PHYS 1A,A00,886431,Staff,26,0,70,44
1746560079797,PHYS 1AL,001,886432,Tsai; Philbert S,0,2,30,30
1746560079797,PHYS 1AL,002,886436,Tsai; Philbert S,11,0,30,19
1746560080821,PHYS 1B,A00,886439,Staff,185,0,240,55
1746560081846,PHYS 1BL,001,886441,Tsai; Philbert S,0,4,30,30
1746560081846,PHYS 1BL,002,886444,Tsai; Philbert S,2,0,30,28
1746560082871,PHYS 1C,A00,896092,Arnold; Kam S,79,0,146,67
1746560083894,PHYS 1CL,001,886448,Tsai; Philbert S,0,0,30,30
1746560083894,PHYS 1CL,002,886449,Tsai; Philbert S,1,0,30,29
1746560083894,PHYS 1CL,003,886450,Tsai; Philbert S,16,0,30,14
1746560083894,PHYS 1CL,004,886451,Tsai; Philbert S,15,0,30,15
1746560084919,PHYS 2B,A01,886457,Staff,68,0,115,47
1746560085944,PHYS 2C,A01,886460,Shotwell; Brian,0,9,65,65
1746560086972,PHYS 2CL,A01,886467,Staff,0,4,28,28
1746560086972,PHYS 2CL,A02,886468,Staff,0,3,28,28
1746560088000,PHYS 2D,A01,886470,Staff,10,0,50,40
1746560089025,PHYS 4B,A01,886475,Grinstein; Benjamin,22,0,40,18
1746560090050,POLI 5,A00,891173,Desposato; Scott,7,0,25,18
1746560091078,POLI 5D,A01,891175,Staff,5,0,5,0
1746560091078,POLI 5D,B01,891178,Staff,5,0,5,0
1746560092107,POLI 11,A00,891179,Ferree; Karen E,2,0,35,33
1746560093133,POLI 12,A00,891180,Staff,16,0,30,14
1746560094160,POLI 27,A01,891182,Staff,12,0,75,63
1746560095188,POLI 30,A00,891183,Staff,8,0,50,42
1746560096217,POLI 100B,A00,891244,Staff,5,1,35,30
1746560097241,POLI 100I,A00,891247,Staff,7,0,30,23
1746560098267,POLI 104J,A00,891248,Nichter; Maysa,14,0,30,16
1746560099292,POLI 104U,A00,891250,Nichter; Maysa,2,0,30,28
1746560101341,POLI 110B,A00,891255,Wiens; David,20,0,25,5
1746560102371,POLI 112A,A00,891256,Wiens; David,6,0,25,19
1746560103396,POLI 114BR,A00,891261,Staff,19,0,30,11
1746560104422,POLI 117R,A00,891262,Forman; Fonna,0,6,50,50
1746560105450,POLI 118,A00,891264,Ingham; Sean,17,0,25,8
1746560106478,POLI 124A,A00,891265,Staff,18,0,20,2
1746560107505,POLI 125D,A00,891266,Nichter; Simeon C,2,0,25,23
1746560108532,POLI 126,A00,891268,Nichter; Simeon C,7,0,25,18
1746560109560,POLI 126AA,A00,891272,Staff,17,0,25,8
1746560110590,POLI 130AA,A00,891273,Staff,15,0,20,5
1746560111614,POLI 134AA,A00,891274,Staff,4,0,20,16
1746560113666,POLI 138,A00,891278,Staff,21,0,25,4
1746560114695,POLI 142K,A00,891280,Staff,11,0,25,14
1746560115722,POLI 142M,A00,891281,Gartzke; Erik,17,0,30,13
1746560116751,POLI 142P,A00,891284,Staff,20,0,30,10
1746560117779,POLI 143,A00,891285,Gartzke; Erik,12,0,30,18
1746560118806,POLI 153,A00,891286,Staff,19,0,20,1
1746560120859,POLI 175,A00,891290,Staff,15,0,20,5
1746560121886,PSYC 1,A00,890674,Steiner; Eric Tomas,0,11,45,45
1746560122916,PSYC 2,A00,890676,Albright; Thomas D,21,0,35,14
1746560123941,PSYC 3,A00,890679,Staff,17,0,20,3
1746560124967,PSYC 6,A00,959858,Staff,20,0,20,0
1746560125993,PSYC 60,A01,890684,Rickard; Timothy C.,0,5,45,45
1746560127020,PSYC 70,A01,890689,Geller; Emma Harlan,7,0,30,23
1746560128044,PSYC 71,A01,959860,Staff,21,0,25,4
1746560129069,PSYC 100,A00,890690,Lacefield; Katharine I,0,50,180,180
1746560130099,PSYC 102,A00,890695,Staff,18,0,40,22
1746560131131,PSYC 105,A00,890699,Geller; Emma Harlan,70,0,100,30
1746560132156,PSYC 106,A00,890701,Gorman; Michael R.,6,0,30,24
1746560133182,PSYC 108,A00,890704,Adrian; Julia Anna,0,28,50,50
1746560134207,PSYC 118,A01,890712,Staff,11,0,30,19
1746560135231,PSYC 124,A00,890716,Chapman; Eddie Nathaniel,25,0,60,35
1746560136256,PSYC 131,A00,890717,Anagnostaras; Stephan,0,7,80,80
1746560137283,PSYC 137,A00,890719,Winkielman; Piotr,0,11,30,30
1746560138309,PSYC 144,A00,890721,Adrian; Julia Anna,0,9,45,45
1746560139337,PSYC 162,A00,890805,Staff,2,0,75,73
1746560140366,PSYC 169,A00,890810,Staff,0,14,30,30
1746560141391,PSYC 172,A00,890814,Gorman; Michael R.,9,0,30,21
1746560142422,PSYC 181,A00,890818,Anagnostaras; Stephan,9,0,200,191
1746560143449,PSYC 184,A00,959861,Staff,170,0,175,5
1746560144475,PSYC 189,A00,890823,Staff,0,1,30,30
1746560145502,PSYC 191,A00,890884,Rickard; Timothy C.,0,11,35,35
1746560146532,PSYC 193,A00,890913,Staff,19,0,30,11
1746560146532,PSYC 193,B00,890914,Chapman; Eddie Nathaniel,24,0,30,6
1746560147558,PSYC 193L,A01,890918,Lowe; Angela Beth,20,0,30,10
1746560147558,PSYC 193L,B01,890921,Hurwitz; Ethan Scott,20,0,30,10
1746560147558,PSYC 193L,C01,890928,Staff,30,0,30,0
1746560148583,RELI 149,A00,886806,Rahimi; Babak,23,0,40,17
1746560149609,SE 9,A01,886814,Staff,7,0,20,13
1746560150635,SE 101B,A01,886816,Chadha; Mayank,4,0,35,31
1746560151664,SE 110B,A00,886818,Zhu; Qiang,4,0,75,71
1746560152690,SE 125,A01,886830,Staff,10,0,30,20
1746560153718,SE 130B,A01,886835,Staff,14,0,40,26
1746560154744,SE 131A,A01,886838,Krysl; Petr,34,0,55,21
1746560155770,SE 154,A00,886840,Staff,29,0,50,21
1746560156797,SE 164GS,A01,886849,Staff,6,0,20,14
1746560157822,SE 167GS,A01,886853,Staff,6,0,20,14
1746560158848,SIO 25,A01,890107,Staff,19,0,30,11
1746560159877,SIO 45,A00,890109,Cook; Geoffrey W,117,0,200,83
1746560160905,SIO 109R,A00,890110,Forman; Fonna,0,16,20,20
1746560161929,SIO 187,A01,890114,Kacev; David,15,0,40,25
1746560162958,SOCI 1,A01,890431,Thorpe; Charles Robert,15,0,30,15
1746560162958,SOCI 1,A02,890518,Thorpe; Charles Robert,30,0,30,0
1746560163986,SOCI 2,A01,957978,Staff,25,0,25,0
1746560163986,SOCI 2,A02,957979,Staff,23,0,25,2
1746560165016,SOCI 20,A01,890523,Calderon-Zaks; Michael Aar,23,0,30,7
1746560165016,SOCI 20,A02,890526,Calderon-Zaks; Michael Aar,29,0,30,1
1746560166041,SOCI 30,A01,890533,Pardo Guerra; Juan Pablo,37,0,40,3
1746560167068,SOCI 40,A01,890535,Staff,27,0,45,18
1746560168094,SOCI 104Q,A00,890559,Staff,18,0,30,12
1746560169121,SOCI 106,A00,890560,Arnal; Maud Marie Leonie,20,0,30,10
1746560170151,SOCI 110,A00,890567,Holkenbrink-Monk; Charlene,19,0,30,11
1746560171179,SOCI 112,A00,890568,Victoria Torres; Pablo,2,0,55,53
1746560172206,SOCI 115,A00,890597,Arnal; Maud Marie Leonie,28,0,45,17
1746560174261,SOCI 121,A00,890604,Pardo Guerra; Juan Pablo,38,0,45,7
1746560175284,SOCI 126,A01,890608,Staff,8,0,10,2
1746560176308,SOCI 127,A00,890609,Staff,18,0,30,12
1746560177335,SOCI 131,A00,890610,Thorpe; Charles Robert,37,0,45,8
1746560178362,SOCI 135,A00,890615,Payne; Christine Anna,13,0,45,32
1746560179388,SOCI 139,A00,890620,Staff,38,0,45,7
1746560180416,SOCI 148E,A00,890622,Calderon-Zaks; Michael Aar,36,0,45,9
1746560181442,SOCI 150,A00,890623,Kohler; Kristopher M.,31,0,45,14
1746560182468,SOCI 157,A00,890625,Jules-Rosette; Bennetta W.,18,0,20,2
1746560183497,SOCI 160,A00,890627,Payne; Christine Anna,21,0,45,24
1746560184522,SYN 1,A00,886855,Fish; Gwendolyn Anne,0,0,0,0
1746560184522,SYN 1,B00,906086,Fish; Gwendolyn Anne,0,1,0,2
1746560185546,SYN 2R,A00,886860,Staff,0,17,15,15
1746560185546,SYN 2R,B00,906106,Atkinson; Arthur Laird,0,16,15,15
1746560186575,SYN 100,A01,886866,Browne; Emily,0,28,20,20
1746560186575,SYN 100,B01,906128,Rock; Martin,0,5,20,20
1746560186575,SYN 100,C01,906140,Deavenport; James Cary,0,3,20,20
1746560186575,SYN 100,D01,907816,Deavenport; James Cary,0,5,20,20
1746560187603,TDAC 1,A00,890286,Walsh; Kim C.,8,0,20,12
1746560188628,TDAC 101,A00,890296,Basso; Beatrice,15,0,20,5
1746560189653,TDDE 131,A00,890297,Staff,47,0,50,3
1746560190681,TDDM 1,A00,890287,Weinberg; Sadie,25,0,30,5
1746560191708,TDGE 11,A00,890288,Fulton; Julia,137,0,200,63
1746560191708,TDGE 11,B00,890289,Castro; Robert Jess,184,0,200,16
1746560192735,TDGE 25,B00,957359,Walsh; Kim C.,3,0,20,17
1746560193761,TDGE 40,A01,890292,Power; Jade Yukana,27,0,30,3
1746560194786,TDGE 124,A00,890298,Havis; Allan,0,1,50,50
1746560195813,TDGE 131R,A00,890299,Burelle; Julie Sara Veronique,15,0,42,27
1746560196841,TDHT 101,A00,890300,Staff,10,0,20,10
1746560197869,TDHT 109,A01,890302,Anderson; Mysia Anyse,31,0,40,9
1746560198893,TDMV 1,A00,890293,Arcidiacono; Kristin,18,0,30,12
1746560199920,TDMV 2,A00,890294,Weinberg; Sadie,23,0,30,7
1746560200950,TDMV 3,A00,957878,Arcidiacono; Kristin,28,0,30,2
1746560203003,TDMV 138,A00,890304,Jun; Grace Shin Hae,25,0,40,15
1746560204034,TDMV 140,A00,890305,Corrales; Joseph Bernales,25,0,30,5
1746560205060,TDMV 142,A00,890307,Caligagan; Tony,32,0,40,8
1746560206088,TDMV 144,A00,890308,Camaya; Michelle Ann,25,0,30,5
1746560207116,TDPW 1,A00,890295,Stein; Deborah Isobel,3,0,20,17
1746560208141,USP 2,A01,890272,Lerner; Amy M,6,0,20,14
1746560209165,USP 3,A01,890274,Staff,12,0,30,18
1746560210191,USP 15,A01,890276,Sun; Feiyang,16,0,30,14
1746560211216,USP 25,A00,890277,Shenkman; Michael Thomas,19,0,25,6
1746560212244,USP 138,A00,890278,Staff,13,0,25,12
1746560213269,USP 143,A00,890279,Staff,21,0,70,49
1746560214294,USP 144,A00,890280,Chowdhury; Muhammed Zohir,15,0,30,15
1746560215321,USP 150,A00,890281,Boomhower; Matthew Charles,4,0,30,26
1746560216350,USP 151,A00,890282,Staff,16,0,20,4
1746560217376,USP 162,A00,890283,Andrews; Abigail Leslie,16,0,20,4
1746560218402,USP 168,A00,920477,Kwak; Nancy,1,0,5,4
1746560219430,USP 181,A00,890284,Staff,3,0,20,17
1746560220455,USP 191A,A00,890285,Staff,12,0,20,8
1746560221479,VIS 101,A00,886512,Staff,26,0,75,49
1746560222506,VIS 103,A00,886513,Cruz; Edwin Teddy,61,0,75,14
1746560223532,VIS 108,A00,886514,Staff,3,0,15,12
1746560224559,VIS 127P,A00,886515,Shen; Kuiyi,80,0,146,66
1746560225586,VIS 149,A00,886516,Yoldas; Pinar,0,0,15,15
1746560226613,VIS 164,A00,886526,Erdmann; Dean,19,0,22,3
1746560227638,VIS 194S,A00,886527,Staff,61,0,75,14
1746560228661,WCWP 10A,C00,886484,Martiniuk; Jill,12,0,15,3
1746560229687,WCWP 10B,A00,886490,Uriarte; Emma,0,0,15,15
1746560229687,WCWP 10B,B00,886491,Dhir; Simrita,10,0,15,5
1746560229687,WCWP 10B,C00,886492,Ornelas; Tricia,0,0,15,15
1746560230717,WCWP 100,A00,886494,Young; Mark T,0,6,15,15
1746560232809,AAS 10,A01,886199,Childs; Dennis R.,0,3,0,0
1746560233833,ANAR 104,A01,886940,Shtienberg; Gilad,27,0,30,3
1746560234858,ANAR 120,A00,886953,Staff,12,0,20,8
1746560235883,ANBI 148,A01,886955,Wilder; Linnea Lorene,30,0,40,10
1746560237931,ANSC 122,A00,886957,Staff,25,0,30,5
1746560238958,ANSC 150,A00,886958,Sloane; Julia Kathryn,2,0,15,13
1746560239982,ANSC 156,A00,886959,Jenkins; Janis A.,0,1,15,15
1746560241008,ANSC 180,A00,886960,Staff,11,0,17,6
1746560242039,ANSC 188,A00,886961,Jassal; Aftab,9,0,25,16
1746560243063,ANSC 190,A00,886962,Jassal; Aftab,14,0,25,11
1746560244087,ANSC 191,A00,886963,Staff,18,0,20,2
1746560245115,ANTH 3,A01,891689,Staff,17,0,20,3
1746560246140,ANTH 5,A00,886933,Semendeferi; Ekaterini,16,0,20,4
1746560247166,ANTH 10,A00,886934,Staff,0,12,30,30
1746560248192,ANTH 21,A01,886936,Staff,40,0,60,20
1746560249216,ANTH 23,A01,886938,Staff,92,0,100,8
1746560250242,ANTH 105,A00,886964,Stewart; Alexander B,84,0,100,16
1746560251268,ANTH 108,A00,886965,Pedersen; David,9,0,20,11
1746560252299,AWP 10,001,886147,Staff,0,0,0,0
1746560252299,AWP 10,002,886148,Staff,0,0,0,0
1746560252299,AWP 10,003,886149,Staff,0,0,0,0
1746560252299,AWP 10,004,886150,Staff,0,0,0,0
1746560252299,AWP 10,005,886151,Staff,0,0,0,0
1746560252299,AWP 10,006,886152,Staff,0,0,0,0
1746560252299,AWP 10,007,886153,Staff,0,0,0,0
1746560252299,AWP 10,008,886154,Staff,0,0,0,0
1746560252299,AWP 10,009,886155,Staff,0,0,0,0
1746560252299,AWP 10,010,886156,Staff,0,0,0,0
1746560252299,AWP 10,011,886158,Staff,0,0,0,0
1746560252299,AWP 10,012,886160,Staff,0,0,0,0
1746560252299,AWP 10,013,886161,Staff,0,0,0,0
1746560252299,AWP 10,014,886162,Staff,0,0,0,0
1746560252299,AWP 10,015,886163,Staff,0,0,0,0
1746560252299,AWP 10,016,886164,Staff,0,0,0,0
1746560252299,AWP 10,017,886165,Staff,0,0,0,0
1746560252299,AWP 10,018,886166,Staff,0,0,0,0
1746560252299,AWP 10,019,886168,Staff,0,0,0,0
1746560252299,AWP 10,020,886170,Staff,0,0,0,0
1746560252299,AWP 10,021,886172,Staff,0,0,0,0
1746560253334,AWP 10R,001,886173,Staff,0,1,0,0
1746560253334,AWP 10R,002,886174,Staff,0,1,0,0
1746560253334,AWP 10R,003,886175,Staff,0,0,0,0
1746560253334,AWP 10R,004,886176,Staff,0,0,0,0
1746560253334,AWP 10R,005,886177,Staff,0,0,0,0
1746560253334,AWP 10R,006,886178,Staff,0,0,0,0
1746560253334,AWP 10R,007,886179,Staff,0,0,0,0
1746560253334,AWP 10R,008,886181,Staff,0,0,0,0
1746560253334,AWP 10R,009,886182,Staff,0,0,0,0
1746560253334,AWP 10R,010,886183,Staff,0,0,0,0
1746560253334,AWP 10R,011,886184,Staff,0,0,0,0
1746560253334,AWP 10R,012,886185,Staff,0,0,0,0
1746560253334,AWP 10R,013,886186,Staff,0,0,0,0
1746560253334,AWP 10R,014,886187,Staff,0,0,0,0
1746560253334,AWP 10R,015,886188,Staff,0,0,0,0
1746560253334,AWP 10R,016,886189,Staff,0,0,0,0
1746560253334,AWP 10R,017,960532,Staff,0,0,0,0
1746560253334,AWP 10R,018,960533,Staff,0,0,0,0
1746560253334,AWP 10R,019,960534,Staff,0,0,0,0
1746560253334,AWP 10R,020,960538,Staff,0,0,0,0
1746560253334,AWP 10R,021,960540,Staff,0,0,0,0
1746560253334,AWP 10R,022,960541,Staff,0,0,0,0
1746560253334,AWP 10R,023,960542,Staff,0,0,0,0
1746560253334,AWP 10R,024,960544,Staff,0,0,0,0
1746560253334,AWP 10R,025,960545,Staff,0,0,0,0
1746560253334,AWP 10R,026,960548,Staff,0,0,0,0
1746560254360,AWP 102R,A00,886190,Staff,0,0,0,0
1746560254360,AWP 102R,B00,886191,Staff,0,0,0,0
1746560255384,BENG 100,A01,886193,Staff,17,0,30,13
1746560256409,BENG 122A,A01,886195,Hasty; Jeff M,13,0,30,17
1746560257432,BENG 166A,A00,886196,Sah; Robert Lie-Yuan,0,2,30,30
1746560258457,BENG 190,A00,958050,Khojah; Reem I,22,0,25,3
1746560259483,BIBC 102,A01,894320,Staff,0,0,46,46
1746560259483,BIBC 102,A02,894321,Staff,0,0,46,46
1746560259483,BIBC 102,A03,894344,Staff,7,0,46,39
1746560259483,BIBC 102,A04,894345,Staff,26,0,47,21
1746560260506,BICD 100R,A01,894365,Smith; Laurie,0,3,58,58
1746560260506,BICD 100R,A02,894366,Smith; Laurie,0,5,58,58
1746560260506,BICD 100R,A03,894367,Smith; Laurie,1,0,59,58
1746560260506,BICD 100R,A04,959869,Smith; Laurie,40,0,59,19
1746560261531,BICD 136,A01,894383,Gustafson-Brown; Cindy,14,0,50,36
1746560262559,BIEB 102,A01,894494,Butler; Shannon Rhey,51,0,130,79
1746560264625,BIEB 150,A01,894617,Wills; Christopher,3,0,20,17
1746560264625,BIEB 150,A02,894631,Wills; Christopher,3,0,20,17
1746560264625,BIEB 150,A03,894937,Wills; Christopher,3,0,20,17
1746560264625,BIEB 150,A04,894946,Wills; Christopher,5,0,20,15
1746560265649,BIEB 194,A00,906141,Kurle; Carolyn M.,6,0,20,14
1746560266678,BILD 1,A01,894154,Staff,3,0,19,16
1746560266678,BILD 1,A02,894155,Staff,14,0,19,5
1746560266678,BILD 1,A03,894160,Staff,13,0,19,6
1746560266678,BILD 1,A04,894161,Staff,15,0,18,3
1746560267705,BILD 2,A01,894168,Staff,0,0,50,50
1746560267705,BILD 2,A02,894169,Staff,0,0,50,50
1746560267705,BILD 2,A03,894179,Staff,0,0,50,50
1746560267705,BILD 2,A04,894203,Staff,26,0,50,24
1746560268734,BILD 3,A01,894213,Staff,22,0,31,9
1746560268734,BILD 3,A02,894214,Staff,26,0,31,5
1746560268734,BILD 3,A03,894235,Staff,28,0,31,3
1746560268734,BILD 3,A04,894236,Staff,28,0,32,4
1746560269759,BILD 4,A01,894253,Reuther; Keefe,5,0,24,19
1746560269759,BILD 4,A02,894258,Reuther; Keefe,16,0,24,8
1746560270786,BILD 5,A01,894276,Reuther; Keefe,35,0,50,15
1746560270786,BILD 5,A02,894277,Reuther; Keefe,45,0,50,5
1746560270786,BILD 5,A03,894290,Reuther; Keefe,44,0,50,6
1746560270786,BILD 5,A04,894291,Reuther; Keefe,48,0,50,2
1746560271810,BILD 24,A01,894297,Pirino; Giorgia,40,0,60,20
1746560272834,BIMM 100,B01,958915,Staff,71,0,100,29
1746560273865,BIMM 101,A01,895017,McDonnell; Lisa Marie,0,5,24,24
1746560273865,BIMM 101,A02,895018,McDonnell; Lisa Marie,0,5,24,24
1746560273865,BIMM 101,B01,895020,McDonnell; Lisa Marie,0,6,24,24
1746560273865,BIMM 101,B02,895021,McDonnell; Lisa Marie,0,4,24,24
1746560274892,BIMM 110,A01,895023,Staff,1,0,25,24
1746560274892,BIMM 110,A02,895024,Staff,9,0,25,16
1746560274892,BIMM 110,A03,895025,Staff,18,0,25,7
1746560274892,BIMM 110,A04,895031,Staff,20,0,25,5
1746560275917,BIMM 120,A01,895114,Gustafson-Brown; Cindy,14,0,28,14
1746560275917,BIMM 120,A02,895126,Gustafson-Brown; Cindy,21,0,27,6
1746560276942,BIPN 100,A01,895130,Yang; Mingyu,1,0,38,37
1746560276942,BIPN 100,A02,895131,Yang; Mingyu,32,0,38,6
1746560276942,BIPN 100,A03,895132,Yang; Mingyu,32,0,38,6
1746560276942,BIPN 100,A04,895133,Yang; Mingyu,27,0,36,9
1746560277968,BIPN 120,A01,895135,Cooke; James Edward,0,3,13,13
1746560277968,BIPN 120,A02,895136,Cooke; James Edward,0,1,13,13
1746560277968,BIPN 120,A03,895137,Cooke; James Edward,0,3,13,13
1746560277968,BIPN 120,A04,895156,Cooke; James Edward,0,2,11,11
1746560278997,BIPN 134,A01,895235,Cooke; James Edward,0,2,25,25
1746560278997,BIPN 134,A02,895237,Cooke; James Edward,0,0,25,25
1746560278997,BIPN 134,A03,895240,Cooke; James Edward,3,0,25,22
1746560278997,BIPN 134,A04,895270,Cooke; James Edward,20,0,25,5
1746560280025,BIPN 189,A00,892103,Staff,0,13,14,14
1746560282092,BISP 194,A00,958008,Staff,0,2,0,0
1746560283118,CAT 124,A01,922009,Staff,0,5,20,20
1746560284145,CAT 125R,A00,886390,Morales; Celeste Georgianna,0,2,20,20
1746560284145,CAT 125R,B00,886391,Irwin; Matthew Joseph,0,3,20,20
1746560284145,CAT 125R,C00,886392,Smith; Lauryn Alissa,0,2,20,20
1746560284145,CAT 125R,D00,886393,Vanderschuit; Maya Alysia,0,2,20,20
1746560284145,CAT 125R,E00,886394,Marchisotto; Jennifer Anne,0,4,20,20
1746560285170,CENG 15,A01,886218,Drews; Aaron,3,0,8,5
1746560286199,CENG 113,A00,886219,Opatkiewicz; Justin Paul,15,0,25,10
1746560287222,CGS 101,A00,887044,Staff,7,0,20,13
1746560288247,CGS 105,A01,887046,Staff,14,0,25,11
1746560289273,CGS 112,A00,887047,Cuong; Marisol,12,0,15,3
1746560290297,CGS 113,A00,887048,Staff,23,0,30,7
1746560291324,CGS 120,A00,887049,Staff,10,0,17,7
1746560292353,CHEM 6A,A01,886336,Lam; Tin Yiu,38,0,50,12
1746560292353,CHEM 6A,A02,886338,Lam; Tin Yiu,37,0,50,13
1746560293377,CHEM 6B,A01,886341,Hopkins; Patrycja Anna,16,0,50,34
1746560293377,CHEM 6B,A02,886343,Hopkins; Patrycja Anna,42,0,50,8
1746560294403,CHEM 6C,A01,886346,Albizati; Kim F.,0,2,50,50
1746560294403,CHEM 6C,A02,886348,Albizati; Kim F.,23,0,50,27
1746560295427,CHEM 40A,A01,886352,Klosterman; Jeremy K,65,0,100,35
1746560296467,CHEM 40B,A01,886356,Klosterman; Jeremy K,0,23,100,100
1746560297494,CHEM 41B,A01,886360,Theodorakis; Emmanuel,25,0,50,25
1746560297494,CHEM 41B,A02,886362,Theodorakis; Emmanuel,47,0,50,3
1746560298522,CHIN 165A,A00,886382,Xu; Li,18,0,20,2
1746560299550,CLAS 120,A00,886387,Myerston Santana; Jacobo,33,0,40,7
1746560300575,COGS 9,A01,886967,Shannon; Kyle Michael,42,0,60,18
1746560301599,COGS 11,A01,886969,Staff,10,0,30,20
1746560302627,COGS 14A,A01,886971,Staff,6,0,60,54
1746560303656,COGS 14B,A01,886973,Hoffman; Drew Ellen,4,0,60,56
1746560304683,COGS 18,A01,886975,Morgan; Eric,35,0,60,25
1746560305711,COGS 20,A01,886977,Staff,4,0,8,4
1746560305711,COGS 20,A02,886978,Staff,5,0,7,2
1746560306737,COGS 100,A01,907783,Staff,0,2,30,30
1746560307764,COGS 101B,A01,886980,Staff,0,3,48,48
1746560308791,COGS 101C,A01,886982,Delgado; Tania,0,5,44,44
1746560309815,COGS 102A,A01,886984,Johnson; Christine M.,4,0,30,26
1746560310839,COGS 118B,A01,886986,Staff,0,3,88,88
1746560311865,COGS 150,A01,886988,Bergen; Benjamin,22,0,50,28
1746560312891,COGS 153,A00,886989,Delgado; Tania,0,2,41,41
1746560313915,COGS 186,A01,886991,Staff,0,0,32,32
1746560314943,COGS 187A,A01,886993,Boyle; Mary E. T.,7,0,30,23
1746560315967,COGS 189,A00,886994,Staff,0,1,30,30
1746560316992,COMM 10,A01,886996,Staff,0,0,20,21
1746560316992,COMM 10,A02,886997,Staff,12,0,20,8
1746560316992,COMM 10,A03,959845,Staff,19,0,20,1
1746560318020,COMM 20,A01,886999,Leuning; Grant Maurstad,24,0,40,16
1746560320069,COMM 100A,A01,887002,Staff,0,0,20,25
1746560320069,COMM 100A,A02,887003,Staff,7,0,20,13
1746560321097,COMM 100B,A01,887005,Staff,0,8,20,24
1746560322126,COMM 106D,A00,887006,Staff,14,0,40,26
1746560323155,COMM 110G,A00,887007,Whitworth-Smith; Andrew C,12,0,40,28
1746560324182,COMM 111B,A00,887008,Staff,31,0,40,9
1746560325208,COMM 113T,A00,887009,Abuelhiga; Soraya Jill,28,0,40,12
1746560325208,COMM 113T,B00,906733,Staff,40,0,40,0
1746560326234,COMM 145,A00,887010,Staff,12,0,40,28
1746560327259,COMM 146,A00,887054,Staff,31,0,40,9
1746560328285,COMM 190,A00,887012,Staff,8,0,23,15
1746560329314,CSE 8A,A50,887015,Cao; Yingjun,57,0,85,28
1746560330339,CSE 11,A01,887017,Cao; Yingjun,12,0,70,58
1746560331364,CSE 20,A01,887019,Staff,30,0,50,20
1746560332389,CSE 21,A01,887021,Staff,78,0,100,22
1746560332389,CSE 21,B01,892583,Braun; Oliver,45,0,50,5
1746560333418,CSE 30,A01,887025,Eldon; John,143,0,200,57
1746560334444,CSE 100,A01,887027,Staff,26,0,50,24
1746560334444,CSE 100,A02,887028,Staff,42,0,50,8
1746560335472,CSE 101,A01,887030,Braun; Oliver,74,0,100,26
1746560335472,CSE 101,B01,887032,Jones; Miles E,0,3,50,50
1746560335472,CSE 101,B02,887033,Jones; Miles E,0,2,50,50
1746560336497,CSE 105,A01,908084,Jones; Miles E,32,0,50,18
1746560336497,CSE 105,A02,908087,Jones; Miles E,32,0,50,18
1746560337527,CSE 135,A01,887035,Powell; Thomas Allan,0,4,50,50
1746560338554,CSE 142,A01,887037,Staff,8,0,60,52
1746560339582,CSE 142L,A01,887039,Staff,34,0,60,26
1746560340613,CSE 151A,A01,887041,Solares; Edwin A,47,0,100,53
1746560341639,CSE 175,A01,887043,Kumar; Rakesh,30,0,30,0
1746560342668,CSS 1,A01,886389,Staff,1,1,40,39
1746560343694,DSC 30,A01,908097,Liao; Soohyun Nam,47,0,75,28
1746560344722,DSC 40A,A01,908099,Shannon; Kyle Michael,30,0,50,20
1746560345749,DSC 40B,A01,908112,Staff,16,0,50,34
1746560346775,DSC 80,A01,908116,Staff,19,0,60,41
1746560347802,DSC 197,001,956863,Eldridge; Justin Matthew,9999,0,9999,0
1746560348829,ECE 5,A01,886400,Morris; Karcher William,2,0,6,4
1746560348829,ECE 5,A02,886401,Morris; Karcher William,3,0,6,3
1746560349858,ECE 148,A01,886403,Silberman; Jack,0,14,14,14
1746560350887,ECON 1,A01,887265,Crane; Meredith Helen,12,0,70,58
1746560350887,ECON 1,B01,887268,Staff,43,0,50,7
1746560351910,ECON 2,A01,887273,Crane; Meredith Helen,55,0,70,15
1746560352935,ECON 3,A01,887279,Rondina; Giacomo,32,0,70,38
1746560353962,ECON 4,A01,887282,Anderson; John Charles,0,2,10,10
1746560354987,ECON 5,A01,887285,Staff,34,0,45,11
1746560354987,ECON 5,B01,887292,Staff,41,0,45,4
1746560356017,ECON 100A,A01,887337,Newhouse; Herbert S,54,0,70,16
1746560356017,ECON 100A,B01,887349,Staff,45,0,50,5
1746560357046,ECON 100B,A01,887361,Du; Songzi,29,0,70,41
1746560358069,ECON 100C,A01,887445,Newhouse; Herbert S,59,0,70,11
1746560359099,ECON 105,A00,887488,Vespa; Emanuel Ignacio,23,0,35,12
1746560360127,ECON 109,A01,887506,Shishkin; Denis,28,0,35,7
1746560361157,ECON 110A,A01,887568,Alon; Titan Michael,0,3,35,35
1746560361157,ECON 110A,B01,907601,Alon; Titan Michael,20,0,35,15
1746560362183,ECON 110B,A01,887598,Levkoff; Steven B.,0,24,70,70
1746560363209,ECON 112,A00,887599,Rondina; Giacomo,19,0,35,16
1746560364237,ECON 120A,A01,887603,Dai; Yinlin,35,0,70,35
1746560365267,ECON 120C,A01,887608,Sun; Yixiao,0,1,35,35
1746560365267,ECON 120C,B01,887614,Sun; Yixiao,0,0,35,35
1746560366292,ECON 138,A00,887621,Bharadwaj; Prashant,0,21,20,20
1746560367317,ECON 144,A00,958007,Squires; Dale E,13,0,35,22
1746560368341,ECON 171,A01,907666,Staff,18,0,35,17
1746560369365,ECON 175,A00,887626,Wu; Pak Yeung,23,0,35,12
1746560370390,ECON 190,A00,887640,Vespa; Emanuel Ignacio,23,0,35,12
1746560371422,EDS 25,A01,888197,Staff,0,0,0,0
1746560371422,EDS 25,A02,888209,Staff,0,0,0,0
1746560371422,EDS 25,A03,888210,Staff,0,0,0,0
1746560371422,EDS 25,A04,888212,Staff,0,0,0,0
1746560371422,EDS 25,A05,888213,Staff,0,0,0,0
1746560371422,EDS 25,A06,888214,Staff,0,0,0,0
1746560371422,EDS 25,A07,888235,Staff,0,2,0,0
1746560371422,EDS 25,A08,888236,Staff,0,0,0,0
1746560371422,EDS 25,A09,888240,Staff,0,0,0,0
1746560371422,EDS 25,A10,888244,Staff,0,0,0,0
1746560371422,EDS 25,B01,888273,Staff,0,0,0,0
1746560371422,EDS 25,B02,888285,Staff,0,0,0,0
1746560371422,EDS 25,B03,888423,Staff,0,0,0,1
1746560371422,EDS 25,B04,888432,Staff,0,0,0,0
1746560371422,EDS 25,B05,888433,Staff,0,0,0,0
1746560371422,EDS 25,B06,888467,Staff,0,0,0,0
1746560371422,EDS 25,B07,888468,Staff,0,0,0,0
1746560371422,EDS 25,B08,888479,Staff,0,0,0,0
1746560371422,EDS 25,B09,888484,Staff,0,0,0,0
1746560371422,EDS 25,B10,888487,Staff,0,0,0,0
1746560372447,EDS 38,A01,907700,Choi; Bailey Miyeon,30,0,30,0
1746560373474,EDS 112,A01,888601,Chapman; Thandeka K,13,0,40,27
1746560374499,EDS 115,A00,888697,Mendez; Kathrina Mendoza,10,0,30,20
1746560375526,EDS 116,A01,888893,Staff,35,0,40,5
1746560377579,EDS 124AR,A00,889133,Staff,29,0,50,21
1746560377579,EDS 124AR,B00,907471,Simon; Elizabeth A,37,0,50,13
1746560378606,EDS 124BR,A00,889134,Simon; Elizabeth A,44,0,100,56
1746560379631,EDS 125,A00,889135,Staff,25,0,30,5
1746560380657,EDS 126,A01,889138,Staff,36,0,40,4
1746560381683,EDS 164R,A01,889142,Wishard Guerra; Alison G.,33,0,50,17
1746560382708,ENG 30,A01,886396,Staff,0,0,0,0
1746560382708,ENG 30,B01,886398,Staff,0,0,0,0
1746560383734,ENVR 102,A00,906150,Montejo; Carolina,23,0,25,2
1746560384762,ETHN 103A,A00,887236,Man; Simeon S,0,3,0,0
1746560385788,ETHN 113,A00,887239,Staff,16,0,30,14
1746560386818,ETHN 116,A00,887240,Staff,16,0,25,9
1746560387843,ETHN 117,A00,887241,Choi; Esther Min,28,0,30,2
1746560388868,ETHN 118,A00,887243,Staff,24,0,30,6
1746560389895,ETHN 127,A00,887248,Cuong; Marisol,11,0,15,4
1746560390921,ETHN 139,A00,887250,Staff,7,0,10,3
1746560391945,ETHN 142,A00,887252,Staff,10,0,30,20
1746560392971,ETHN 161,A00,887253,Browne; Errol Tsekani,24,0,30,6
1746560394000,ETHN 163FR,A00,887255,Burelle; Julie Sara Veronique,0,0,5,5
1746560395032,GLBH 20,A00,889149,Elwardani; Nile Regina,8,0,42,34
1746560397084,GLBH 111,A01,889152,Burgos; Jose L.,17,0,17,0
1746560398112,GLBH 150,A00,889181,Sloane; Julia Kathryn,0,5,15,15
1746560400165,HDS 60,A01,886406,Warstadt; Melissa Fawn,73,0,80,7
1746560401193,HIAF 111,A00,889324,Gyamfi; Bright,25,0,32,7
1746560402221,HIEA 131,A00,889328,Staff,16,0,32,16
1746560403247,HIEA 144,A00,889333,Henry; Todd A.,26,0,32,6
1746560404276,HIEA 154,A00,889336,Henry; Todd A.,24,0,32,8
1746560405302,HIEU 106,A00,889339,Staff,22,0,32,10
1746560407356,HIEU 114,A00,889340,Staff,3,0,32,29
1746560408380,HIEU 135GS,A00,889342,Patterson; Patrick H.,0,0,1,24
1746560409407,HIEU 137,A00,889343,Edington; Claire Ellen,9,0,25,16
1746560410435,HIEU 148,A00,889345,Staff,14,0,32,18
1746560411460,HIEU 154,A00,889346,Biess; Frank Peter,21,0,32,11
1746560412485,HILA 102,A00,889351,Staff,12,0,32,20
1746560413511,HILD 2A,A01,889221,Lewandoski; Julia Mavis,1,10,32,31
1746560414536,HILD 7B,A01,889225,Man; Simeon S,0,12,32,32
1746560415563,HILD 7C,A01,889288,Alvarez; Luis A,0,14,32,32
1746560416591,HILD 30,A01,889323,Staff,0,5,32,32
1746560418643,HISC 119,A00,889383,Golan; Tal,20,0,32,12
1746560419671,HIUS 103,A00,889384,Man; Simeon S,0,0,32,32
1746560420699,HIUS 117,A00,919797,Kwak; Nancy,18,0,32,14
1746560421724,HIUS 142A,A00,919788,Staff,22,0,32,10
1746560423775,HIUS 149,A00,889386,Gyamfi; Bright,27,0,32,5
1746560424805,HIUS 155,A00,889387,Alvarez; Luis A,14,0,32,18
1746560425835,HUM 3,A01,886499,Caldwell; Michael Alan,19,0,50,31
1746560426858,HUM 3GS,A00,886500,Rodriguez; Bretton Sigfred,0,0,0,28
1746560427884,HUM 3R,A01,886502,Markman; Kristina,0,36,50,50
1746560428914,HUM 4,A01,886504,Crum; Matthew Stephen,24,0,50,26
1746560428914,HUM 4,B01,886506,West; Geoffrey Scott,17,0,50,33
1746560429942,HUM 4GS,A00,886507,Staff,0,0,0,19
1746560430970,HUM 5,A01,886509,Staff,32,0,50,18
1746560431994,HUM 5R,A01,886511,Zavodny; Tatiana Sophia,0,39,50,50
1746560433020,JAPN 180,A00,886407,Staff,17,0,40,23
1746560434046,LATI 50,A01,886409,Martin-Cabrera; Luis,4,0,22,18
1746560434046,LATI 50,A02,886410,Martin-Cabrera; Luis,19,0,22,3
1746560434046,LATI 50,A03,886411,Martin-Cabrera; Luis,21,0,22,1
1746560434046,LATI 50,A04,886412,Martin-Cabrera; Luis,9,0,22,13
1746560435072,LAWS 101,A00,907664,Staff,28,0,60,32
1746560436101,LIAB 1A,A00,889388,Saab; Dima,17,0,20,3
1746560437130,LIAB 1AX,A00,889389,El Cheddadi; Youniss,18,0,20,2
1746560438159,LIFR 1C,A00,889391,Van Moer; Vinciane G,8,0,20,12
1746560439184,LIFR 1CX,A00,889392,Van Moer; Vinciane G,7,0,20,13
1746560440213,LIFR 1D,A00,889393,Van Moer; Vinciane G,7,0,20,13
1746560441245,LIFR 1DX,A00,889394,Van Moer; Vinciane G,8,0,20,12
1746560442273,LIGN 7,A00,886923,Staff,24,0,50,26
1746560443303,LIGN 17,A00,886924,Kehler; Andrew Scott,125,0,150,25
1746560444332,LTAM 110,A00,889395,Staff,15,0,30,15
1746560445359,LTAM 110GS,A00,958010,Rodriguez; Bretton Sigfred,0,0,0,28
1746560446384,LTCH 101,A00,889397,Staff,23,0,25,2
1746560447414,LTCS 130,A00,889398,Staff,23,0,25,2
1746560448442,LTEA 138,A00,889399,Staff,24,0,40,16
1746560449467,LTEN 149,A00,889400,Wesling; Megan E.,0,3,25,25
1746560450495,LTEN 169,A00,889401,Staff,20,0,25,5
1746560451523,LTEN 180,A00,889402,Staff,10,0,15,5
1746560452550,LTEN 181,A00,889403,Staff,21,0,25,4
1746560453575,LTWL 100,A00,889404,Myerston Santana; Jacobo,2,0,25,23
1746560454601,LTWL 180GS,A00,889405,Staff,0,0,20,20
1746560455626,LTWL 181,A00,889406,Staff,16,0,25,9
1746560456652,LTWL 184,A00,889475,Mukherjee; Silpa,22,0,25,3
1746560457677,LTWR 102C,A00,889486,Staff,30,0,30,0
1746560458704,LTWR 115W,A00,889491,Staff,0,2,15,15
1746560459733,MAE 8,A01,886905,Staff,0,2,0,0
1746560460760,MAE 11,A00,886906,Bandaru; Prabhakar,0,7,50,50
1746560461786,MAE 20,A00,886907,Evdokimenko; Ekaterina,43,0,70,27
1746560462813,MAE 30B,A00,886909,Ghazinejad; Maziar,26,0,45,19
1746560463843,MAE 101B,A00,886910,Saintillan; David,29,0,45,16
1746560464870,MAE 105,A00,886911,Bandaru; Prabhakar,18,0,50,32
1746560465897,MAE 107,B00,958024,Staff,8,0,50,42
1746560466923,MAE 143B,A00,886913,Bewley; Thomas R,6,0,40,34
1746560467951,MAE 148,A01,886915,Silberman; Jack,0,3,14,14
1746560468978,MAE 160,A00,886916,Evdokimenko; Ekaterina,32,0,60,28
1746560470003,MATH 3C,A01,889681,Staff,0,3,30,30
1746560470003,MATH 3C,A02,960048,Staff,25,0,30,5
1746560471032,MATH 10A,A01,889760,Staff,26,0,30,4
1746560471032,MATH 10A,A02,889783,Staff,29,0,30,1
1746560472063,MATH 10B,A01,889785,Verstraete; Jacques Allan,2,0,35,33
1746560472063,MATH 10B,A02,889795,Verstraete; Jacques Allan,4,0,35,31
1746560472063,MATH 10B,B01,889797,Verstraete; Jacques Allan,3,0,35,32
1746560472063,MATH 10B,B02,889828,Verstraete; Jacques Allan,3,0,35,32
1746560473087,MATH 10C,A01,889849,Habib; Yousaf,8,0,30,22
1746560473087,MATH 10C,A02,889852,Habib; Yousaf,14,0,30,16
1746560473087,MATH 10C,A03,889853,Habib; Yousaf,22,0,30,8
1746560473087,MATH 10C,A04,889858,Habib; Yousaf,20,0,30,10
1746560473087,MATH 10C,B01,889861,Staff,1,0,30,29
1746560473087,MATH 10C,B02,889862,Staff,24,0,30,6
1746560473087,MATH 10C,B03,889863,Staff,27,0,30,3
1746560473087,MATH 10C,B04,889967,Staff,23,0,30,7
1746560474113,MATH 18,A01,889974,Staff,7,0,30,23
1746560474113,MATH 18,A02,889977,Staff,20,0,30,10
1746560474113,MATH 18,B01,889984,Hardiman; Liam,21,0,30,9
1746560474113,MATH 18,B02,889985,Hardiman; Liam,25,0,30,5
1746560475137,MATH 20A,A01,889990,Suk; Andrew Hoon,30,0,35,5
1746560476163,MATH 20B,A01,889993,Ohm; Ko Woon,22,0,30,8
1746560476163,MATH 20B,A02,889994,Ohm; Ko Woon,30,0,30,0
1746560476163,MATH 20B,B01,889996,Ohm; Ko Woon,21,0,30,9
1746560476163,MATH 20B,B02,889997,Ohm; Ko Woon,23,0,30,7
1746560477193,MATH 20C,A01,889999,Hammock; Frances H,17,0,30,13
1746560477193,MATH 20C,A02,890003,Hammock; Frances H,23,0,30,7
1746560477193,MATH 20C,B01,890006,Hammock; Frances H,3,0,30,27
1746560477193,MATH 20C,B02,890007,Hammock; Frances H,11,0,30,19
1746560478225,MATH 20D,A01,890011,Cheng; Hsiao-Bing,1,1,30,29
1746560478225,MATH 20D,A02,890012,Cheng; Hsiao-Bing,14,0,30,16
1746560478225,MATH 20D,B01,890016,Cheng; Hsiao-Bing,13,0,30,17
1746560478225,MATH 20D,B02,890017,Cheng; Hsiao-Bing,13,0,30,17
1746560479249,MATH 20E,A01,890026,Harel; Guershon,1,0,30,29
1746560479249,MATH 20E,A02,890029,Harel; Guershon,23,0,30,7
1746560479249,MATH 20E,B01,890033,Harel; Guershon,7,0,30,23
1746560479249,MATH 20E,B02,890101,Harel; Guershon,21,0,30,9
1746560480274,MATH 102,A01,890104,Staff,17,0,30,13
1746560480274,MATH 102,A02,890105,Staff,27,0,30,3
1746560481299,MATH 103B,A01,890116,Salehi Golsefidy; Alireza,3,0,30,27
1746560481299,MATH 103B,B01,890118,Staff,0,3,34,34
1746560482326,MATH 109,A01,890121,Aliabadi Sr.; Mohsen,1,0,30,29
1746560482326,MATH 109,B01,890124,Upadrashta; Pranav Kumar,18,0,30,12
1746560483351,MATH 120A,A01,890126,Eggers; John Dietrich,13,0,30,17
1746560484376,MATH 142B,A01,890128,Ioana; Adrian,19,0,30,11
1746560484376,MATH 142B,A02,890129,Ioana; Adrian,13,0,30,17
1746560485402,MATH 154,A01,890174,Staff,0,0,30,30
1746560485402,MATH 154,A02,890182,Staff,0,0,30,30
1746560486429,MATH 168A,A01,890197,Dumitriu; Ioana,21,0,35,14
1746560487454,MATH 170A,A01,890240,Nie; Jiawang,1,0,30,29
1746560487454,MATH 170A,A02,890241,Nie; Jiawang,11,0,30,19
1746560487454,MATH 170A,A03,890249,Nie; Jiawang,23,0,30,7
1746560488484,MATH 170B,A01,957891,Nag; Panchali,13,0,35,22
1746560490554,MATH 181A,A01,908025,Staff,0,4,35,35
1746560490554,MATH 181A,A02,960115,Staff,27,0,35,8
1746560491578,MATH 181B,A01,959874,Staff,25,0,30,5
1746560492601,MATH 193B,A01,890265,Staff,0,4,35,35
1746560493628,MGT 4,A01,890311,Anderson; John Charles,42,0,88,46
1746560494653,MGT 5,A00,907740,Staff,13,0,98,85
1746560495676,MGT 12,A00,890312,Lindenberger; Wade Douglas,67,0,98,31
1746560496701,MGT 16,A00,957883,Staff,78,0,98,20
1746560498755,MGT 45,A00,890314,Pecore; Joseph P.,46,0,98,52
1746560499779,MGT 71,A00,890315,Staff,0,11,98,98
1746560500804,MGT 100,A00,890316,Yavorsky; Daniel Ryan,44,0,98,54
1746560501844,MGT 103,A00,890317,Ehrich; Kristine R,73,0,98,25
1746560502870,MGT 105,A00,890356,Bates; Kenneth Walter,0,8,98,98
1746560503898,MGT 112,A00,890360,Ehrich; Kristine R,55,0,98,43
1746560504924,MGT 127R,A00,907732,Zhu; Kevin Xiaoguo,23,0,98,75
1746560505949,MGT 131B,A00,890361,Anderson; John Charles,60,0,98,38
1746560506973,MGT 137,A00,890362,Lindenberger; Wade Douglas,65,0,98,33
1746560507998,MGT 160,A00,890369,Johnson; Erik Barry,9,0,98,89
1746560510052,MGT 164,A00,890372,Zimmermann; Carsten,0,40,98,98
1746560511078,MGT 180,A00,890374,Bliss; Barbara Ann,12,0,98,86
1746560512107,MMW 15,A01,886414,Chang; Edmond Yi-Teh,0,12,28,28
1746560512107,MMW 15,A02,886415,Chang; Edmond Yi-Teh,0,8,28,28
1746560512107,MMW 15,A03,886416,Chang; Edmond Yi-Teh,0,8,28,28
1746560512107,MMW 15,A04,886417,Chang; Edmond Yi-Teh,0,8,28,28
1746560512107,MMW 15,B01,886419,Chang; Edmond Yi-Teh,0,7,28,28
1746560512107,MMW 15,B02,886420,Chang; Edmond Yi-Teh,0,8,28,28
1746560512107,MMW 15,B03,886421,Chang; Edmond Yi-Teh,0,7,28,28
1746560512107,MMW 15,B04,886422,Chang; Edmond Yi-Teh,0,8,28,28
1746560512107,MMW 15,C01,886424,Staff,0,9,28,28
1746560512107,MMW 15,C02,886425,Staff,0,8,28,28
1746560512107,MMW 15,C03,886426,Staff,0,8,28,28
1746560512107,MMW 15,C04,886427,Staff,0,8,28,28
1746560512107,MMW 15,C05,958038,Staff,0,8,28,28
1746560512107,MMW 15,C06,958039,Staff,0,8,28,28
1746560513131,MMW 15GS,A00,906910,Patterson; Patrick H.,4,0,28,24
1746560514160,MMW 122R,A01,886429,Rahimi; Babak,0,13,28,28
1746560514160,MMW 122R,A02,886430,Rahimi; Babak,0,12,28,28
1746560514160,MMW 122R,A03,958040,Rahimi; Babak,0,11,28,28
1746560515187,MUS 1A,A01,890937,Staff,2,0,25,23
1746560515187,MUS 1A,A02,891035,Staff,6,0,25,19
1746560515187,MUS 1A,C01,958912,Staff,24,0,25,1
1746560515187,MUS 1A,C02,958913,Staff,25,0,25,0
1746560517241,MUS 2AK,A00,957092,Ohnishi; Takae,15,0,15,0
1746560518269,MUS 4,A01,891044,Staff,2,0,25,23
1746560518269,MUS 4,A02,891045,Staff,23,0,25,2
1746560518269,MUS 4,B01,891048,Staff,17,0,25,8
1746560518269,MUS 4,B02,891050,Staff,25,0,25,0
1746560519298,MUS 5,A01,957506,Dubnov; Shlomo,0,0,25,25
1746560519298,MUS 5,A02,957622,Dubnov; Shlomo,13,0,25,12
1746560519298,MUS 5,A03,957623,Dubnov; Shlomo,20,0,25,5
1746560520322,MUS 6,A01,891053,Freitas Caetano; Marcelo,24,0,25,1
1746560520322,MUS 6,A02,891054,Freitas Caetano; Marcelo,23,0,25,2
1746560521348,MUS 7,A01,891081,Staff,0,0,25,25
1746560521348,MUS 7,A02,891082,Staff,4,0,25,21
1746560522374,MUS 8GS,A00,891118,Borgo; David Garcia,0,0,25,25
1746560523401,MUS 11,A01,891140,Staff,10,0,25,15
1746560523401,MUS 11,A02,891141,Staff,22,0,25,3
1746560524424,MUS 13,A01,891143,Staff,8,0,25,17
1746560524424,MUS 13,A02,891144,Staff,24,0,25,1
1746560525450,MUS 15,A01,891146,Staff,9,0,25,16
1746560525450,MUS 15,A02,891148,Staff,21,0,25,4
1746560525450,MUS 15,B01,891150,Staff,18,0,25,7
1746560525450,MUS 15,B02,891151,Staff,25,0,25,0
1746560526494,MUS 20,A01,891153,Staff,5,0,20,15
1746560526494,MUS 20,A02,891155,Staff,14,0,20,6
1746560527520,MUS 80,A00,891156,Staff,19,0,25,6
1746560527520,MUS 80,B00,891157,Staff,23,0,25,2
1746560528548,MUS 130,A00,891158,Ohnishi; Takae,35,0,35,0
1746560529575,MUS 150GS,A01,891160,Borgo; David Garcia,0,0,25,25
1746560530602,MUS 170,A01,891162,Freitas Caetano; Marcelo,20,0,25,5
1746560530602,MUS 170,A02,891164,Freitas Caetano; Marcelo,21,0,25,4
1746560531626,NANO 11,A00,886220,Vazquez Mena; Oscar,13,0,15,2
1746560532652,NANO 15,A01,886222,Drews; Aaron,4,0,7,3
1746560533679,NANO 104,A00,886224,Sirbuly; Donald,18,0,25,7
1746560534707,PH 40,A00,886528,Staff,23,0,40,17
1746560535733,PH 45,A01,886799,Staff,35,0,40,5
1746560536758,PH 110,A00,886802,Staff,0,7,40,40
1746560537783,PH 172,A00,906716,Staff,19,0,35,16
1746560538808,PH 191,A00,886803,Staff,6,0,40,34
1746560539835,PHIL 1,A00,889500,Staff,20,0,30,10
1746560540861,PHIL 10,A01,889549,Grush; Rick Scott,15,0,22,7
1746560540861,PHIL 10,A02,889551,Grush; Rick Scott,22,0,22,0
1746560541887,PHIL 28,A01,889559,Lamey; Andy M.,0,1,31,31
1746560541887,PHIL 28,A02,889561,Lamey; Andy M.,0,1,30,30
1746560541887,PHIL 28,A03,889572,Lamey; Andy M.,0,1,30,30
1746560542910,PHIL 35,A00,907839,Staff,13,0,15,2
1746560543936,PHIL 60,A00,889574,Staff,73,0,90,17
1746560544965,PHIL 101,A00,958004,Staff,12,0,15,3
1746560547013,PHIL 136,A00,889582,Fulkerson; Matthew Todd,26,0,45,19
1746560548042,PHIL 163,A01,889601,Staff,21,0,30,9
1746560548042,PHIL 163,B01,889606,Brandt; Reuven A,0,3,0,0
1746560549072,PHIL 164,A00,889610,Staff,16,0,30,14
1746560550098,PHIL 165,A00,889613,Staff,23,0,30,7
1746560551124,PHYS 1A,A00,886431,Staff,26,0,70,44
1746560552150,PHYS 1AL,001,886432,Tsai; Philbert S,0,2,30,30
1746560552150,PHYS 1AL,002,886436,Tsai; Philbert S,11,0,30,19
1746560553174,PHYS 1B,A00,886439,Staff,185,0,240,55
1746560554200,PHYS 1BL,001,886441,Tsai; Philbert S,0,4,30,30
1746560554200,PHYS 1BL,002,886444,Tsai; Philbert S,2,0,30,28
1746560555225,PHYS 1C,A00,896092,Arnold; Kam S,79,0,146,67
1746560556251,PHYS 1CL,001,886448,Tsai; Philbert S,0,0,30,30
1746560556251,PHYS 1CL,002,886449,Tsai; Philbert S,1,0,30,29
1746560556251,PHYS 1CL,003,886450,Tsai; Philbert S,16,0,30,14
1746560556251,PHYS 1CL,004,886451,Tsai; Philbert S,15,0,30,15
1746560557274,PHYS 2B,A01,886457,Staff,68,0,115,47
1746560558299,PHYS 2C,A01,886460,Shotwell; Brian,0,9,65,65
1746560559327,PHYS 2CL,A01,886467,Staff,0,4,28,28
1746560559327,PHYS 2CL,A02,886468,Staff,0,3,28,28
1746560560350,PHYS 2D,A01,886470,Staff,10,0,50,40
1746560561379,PHYS 4B,A01,886475,Grinstein; Benjamin,22,0,40,18
1746560562416,POLI 5,A00,891173,Desposato; Scott,7,0,25,18
1746560563440,POLI 5D,A01,891175,Staff,5,0,5,0
1746560563440,POLI 5D,B01,891178,Staff,5,0,5,0
1746560564464,POLI 11,A00,891179,Ferree; Karen E,2,0,35,33
1746560565491,POLI 12,A00,891180,Staff,16,0,30,14
1746560566515,POLI 27,A01,891182,Staff,12,0,75,63
1746560567541,POLI 30,A00,891183,Staff,8,0,50,42
1746560568572,POLI 100B,A00,891244,Staff,5,1,35,30
1746560569597,POLI 100I,A00,891247,Staff,7,0,30,23
1746560570626,POLI 104J,A00,891248,Nichter; Maysa,14,0,30,16
1746560571650,POLI 104U,A00,891250,Nichter; Maysa,2,0,30,28
1746560573698,POLI 110B,A00,891255,Wiens; David,20,0,25,5
1746560574729,POLI 112A,A00,891256,Wiens; David,6,0,25,19
1746560575754,POLI 114BR,A00,891261,Staff,19,0,30,11
1746560576779,POLI 117R,A00,891262,Forman; Fonna,0,6,50,50
1746560577802,POLI 118,A00,891264,Ingham; Sean,17,0,25,8
1746560578827,POLI 124A,A00,891265,Staff,18,0,20,2
1746560579852,POLI 125D,A00,891266,Nichter; Simeon C,2,0,25,23
1746560580877,POLI 126,A00,891268,Nichter; Simeon C,7,0,25,18
1746560581902,POLI 126AA,A00,891272,Staff,17,0,25,8
1746560582927,POLI 130AA,A00,891273,Staff,15,0,20,5
1746560583955,POLI 134AA,A00,891274,Staff,4,0,20,16
1746560586013,POLI 138,A00,891278,Staff,21,0,25,4
1746560587038,POLI 142K,A00,891280,Staff,11,0,25,14
1746560588063,POLI 142M,A00,891281,Gartzke; Erik,17,0,30,13
1746560589087,POLI 142P,A00,891284,Staff,20,0,30,10
1746560590115,POLI 143,A00,891285,Gartzke; Erik,12,0,30,18
1746560591139,POLI 153,A00,891286,Staff,19,0,20,1
1746560593192,POLI 175,A00,891290,Staff,15,0,20,5
1746560594224,PSYC 1,A00,890674,Steiner; Eric Tomas,0,11,45,45
1746560595251,PSYC 2,A00,890676,Albright; Thomas D,21,0,35,14
1746560596279,PSYC 3,A00,890679,Staff,17,0,20,3
1746560597306,PSYC 6,A00,959858,Staff,20,0,20,0
1746560598333,PSYC 60,A01,890684,Rickard; Timothy C.,0,5,45,45
1746560599358,PSYC 70,A01,890689,Geller; Emma Harlan,7,0,30,23
1746560600386,PSYC 71,A01,959860,Staff,21,0,25,4
1746560601415,PSYC 100,A00,890690,Lacefield; Katharine I,0,50,180,180
1746560602440,PSYC 102,A00,890695,Staff,18,0,40,22
1746560603470,PSYC 105,A00,890699,Geller; Emma Harlan,70,0,100,30
1746560604498,PSYC 106,A00,890701,Gorman; Michael R.,6,0,30,24
1746560605523,PSYC 108,A00,890704,Adrian; Julia Anna,0,28,50,50
1746560606551,PSYC 118,A01,890712,Staff,11,0,30,19
1746560607581,PSYC 124,A00,890716,Chapman; Eddie Nathaniel,25,0,60,35
1746560608606,PSYC 131,A00,890717,Anagnostaras; Stephan,0,7,80,80
1746560609632,PSYC 137,A00,890719,Winkielman; Piotr,0,11,30,30
1746560610660,PSYC 144,A00,890721,Adrian; Julia Anna,0,9,45,45
1746560611685,PSYC 162,A00,890805,Staff,2,0,75,73
1746560612710,PSYC 169,A00,890810,Staff,0,14,30,30
1746560613737,PSYC 172,A00,890814,Gorman; Michael R.,9,0,30,21
1746560614764,PSYC 181,A00,890818,Anagnostaras; Stephan,9,0,200,191
1746560615789,PSYC 184,A00,959861,Staff,170,0,175,5
1746560616819,PSYC 189,A00,890823,Staff,0,1,30,30
1746560617842,PSYC 191,A00,890884,Rickard; Timothy C.,0,11,35,35
1746560618868,PSYC 193,A00,890913,Staff,19,0,30,11
1746560618868,PSYC 193,B00,890914,Chapman; Eddie Nathaniel,24,0,30,6
1746560619900,PSYC 193L,A01,890918,Lowe; Angela Beth,20,0,30,10
1746560619900,PSYC 193L,B01,890921,Hurwitz; Ethan Scott,20,0,30,10
1746560619900,PSYC 193L,C01,890928,Staff,30,0,30,0
1746560620926,RELI 149,A00,886806,Rahimi; Babak,23,0,40,17
1746560621953,SE 9,A01,886814,Staff,7,0,20,13
1746560622981,SE 101B,A01,886816,Chadha; Mayank,4,0,35,31
1746560624009,SE 110B,A00,886818,Zhu; Qiang,4,0,75,71
1746560625036,SE 125,A01,886830,Staff,10,0,30,20
1746560626063,SE 130B,A01,886835,Staff,14,0,40,26
1746560627088,SE 131A,A01,886838,Krysl; Petr,34,0,55,21
1746560628115,SE 154,A00,886840,Staff,29,0,50,21
1746560629139,SE 164GS,A01,886849,Staff,6,0,20,14
1746560630163,SE 167GS,A01,886853,Staff,6,0,20,14
1746560631193,SIO 25,A01,890107,Staff,19,0,30,11
1746560632220,SIO 45,A00,890109,Cook; Geoffrey W,117,0,200,83
1746560633245,SIO 109R,A00,890110,Forman; Fonna,0,16,20,20
1746560634274,SIO 187,A01,890114,Kacev; David,15,0,40,25
1746560635305,SOCI 1,A01,890431,Thorpe; Charles Robert,15,0,30,15
1746560635305,SOCI 1,A02,890518,Thorpe; Charles Robert,30,0,30,0
1746560636332,SOCI 2,A01,957978,Staff,25,0,25,0
1746560636332,SOCI 2,A02,957979,Staff,23,0,25,2
1746560637361,SOCI 20,A01,890523,Calderon-Zaks; Michael Aar,23,0,30,7
1746560637361,SOCI 20,A02,890526,Calderon-Zaks; Michael Aar,29,0,30,1
1746560638385,SOCI 30,A01,890533,Pardo Guerra; Juan Pablo,37,0,40,3
1746560639412,SOCI 40,A01,890535,Staff,27,0,45,18
1746560640437,SOCI 104Q,A00,890559,Staff,18,0,30,12
1746560641466,SOCI 106,A00,890560,Arnal; Maud Marie Leonie,20,0,30,10
1746560642495,SOCI 110,A00,890567,Holkenbrink-Monk; Charlene,19,0,30,11
1746560643519,SOCI 112,A00,890568,Victoria Torres; Pablo,2,0,55,53
1746560644543,SOCI 115,A00,890597,Arnal; Maud Marie Leonie,28,0,45,17
1746560646600,SOCI 121,A00,890604,Pardo Guerra; Juan Pablo,38,0,45,7
1746560647626,SOCI 126,A01,890608,Staff,8,0,10,2
1746560648653,SOCI 127,A00,890609,Staff,18,0,30,12
1746560649680,SOCI 131,A00,890610,Thorpe; Charles Robert,37,0,45,8
1746560650706,SOCI 135,A00,890615,Payne; Christine Anna,13,0,45,32
1746560651731,SOCI 139,A00,890620,Staff,38,0,45,7
1746560652760,SOCI 148E,A00,890622,Calderon-Zaks; Michael Aar,36,0,45,9
1746560653786,SOCI 150,A00,890623,Kohler; Kristopher M.,31,0,45,14
1746560654812,SOCI 157,A00,890625,Jules-Rosette; Bennetta W.,18,0,20,2
1746560655838,SOCI 160,A00,890627,Payne; Christine Anna,21,0,45,24
1746560656869,SYN 1,A00,886855,Fish; Gwendolyn Anne,0,0,0,0
1746560656869,SYN 1,B00,906086,Fish; Gwendolyn Anne,0,1,0,2
1746560657894,SYN 2R,A00,886860,Staff,0,17,15,15
1746560657894,SYN 2R,B00,906106,Atkinson; Arthur Laird,0,16,15,15
1746560658922,SYN 100,A01,886866,Browne; Emily,0,28,20,20
1746560658922,SYN 100,B01,906128,Rock; Martin,0,5,20,20
1746560658922,SYN 100,C01,906140,Deavenport; James Cary,0,3,20,20
1746560658922,SYN 100,D01,907816,Deavenport; James Cary,0,5,20,20
1746560659952,TDAC 1,A00,890286,Walsh; Kim C.,8,0,20,12
1746560660979,TDAC 101,A00,890296,Basso; Beatrice,15,0,20,5
1746560662006,TDDE 131,A00,890297,Staff,47,0,50,3
1746560663035,TDDM 1,A00,890287,Weinberg; Sadie,25,0,30,5
1746560664060,TDGE 11,A00,890288,Fulton; Julia,137,0,200,63
1746560664060,TDGE 11,B00,890289,Castro; Robert Jess,184,0,200,16
1746560665085,TDGE 25,B00,957359,Walsh; Kim C.,3,0,20,17
1746560666112,TDGE 40,A01,890292,Power; Jade Yukana,27,0,30,3
1746560667140,TDGE 124,A00,890298,Havis; Allan,0,1,50,50
1746560668165,TDGE 131R,A00,890299,Burelle; Julie Sara Veronique,15,0,42,27
1746560669190,TDHT 101,A00,890300,Staff,10,0,20,10
1746560670215,TDHT 109,A01,890302,Anderson; Mysia Anyse,31,0,40,9
1746560671241,TDMV 1,A00,890293,Arcidiacono; Kristin,18,0,30,12
1746560672269,TDMV 2,A00,890294,Weinberg; Sadie,23,0,30,7
1746560673296,TDMV 3,A00,957878,Arcidiacono; Kristin,28,0,30,2
1746560675345,TDMV 138,A00,890304,Jun; Grace Shin Hae,25,0,40,15
1746560676376,TDMV 140,A00,890305,Corrales; Joseph Bernales,25,0,30,5
1746560677399,TDMV 142,A00,890307,Caligagan; Tony,32,0,40,8
1746560678429,TDMV 144,A00,890308,Camaya; Michelle Ann,25,0,30,5
1746560679456,TDPW 1,A00,890295,Stein; Deborah Isobel,3,0,20,17
1746560680484,USP 2,A01,890272,Lerner; Amy M,6,0,20,14
1746560681511,USP 3,A01,890274,Staff,12,0,30,18
1746560682539,USP 15,A01,890276,Sun; Feiyang,16,0,30,14
1746560683563,USP 25,A00,890277,Shenkman; Michael Thomas,19,0,25,6
1746560684590,USP 138,A00,890278,Staff,13,0,25,12
1746560685616,USP 143,A00,890279,Staff,22,0,70,48
1746560686646,USP 144,A00,890280,Chowdhury; Muhammed Zohir,16,0,30,14
1746560687673,USP 150,A00,890281,Boomhower; Matthew Charles,4,0,30,26
1746560688696,USP 151,A00,890282,Staff,16,0,20,4
1746560689720,USP 162,A00,890283,Andrews; Abigail Leslie,16,0,20,4
1746560690745,USP 168,A00,920477,Kwak; Nancy,1,0,5,4
1746560691769,USP 181,A00,890284,Staff,3,0,20,17
1746560692793,USP 191A,A00,890285,Staff,12,0,20,8
1746560693819,VIS 101,A00,886512,Staff,26,0,75,49
1746560694848,VIS 103,A00,886513,Cruz; Edwin Teddy,61,0,75,14
1746560695876,VIS 108,A00,886514,Staff,3,0,15,12
1746560696904,VIS 127P,A00,886515,Shen; Kuiyi,80,0,146,66
1746560697931,VIS 149,A00,886516,Yoldas; Pinar,0,0,15,15
1746560698958,VIS 164,A00,886526,Erdmann; Dean,19,0,22,3
1746560700026,VIS 194S,A00,886527,Staff,61,0,75,14
1746560701055,WCWP 10A,C00,886484,Martiniuk; Jill,12,0,15,3
1746560702091,WCWP 10B,A00,886490,Uriarte; Emma,0,0,15,15
1746560702091,WCWP 10B,B00,886491,Dhir; Simrita,10,0,15,5
1746560702091,WCWP 10B,C00,886492,Ornelas; Tricia,0,0,15,15
1746560703120,WCWP 100,A00,886494,Young; Mark T,0,6,15,15
1746560705190,AAS 10,A01,886199,Childs; Dennis R.,0,3,0,0
1746560706216,ANAR 104,A01,886940,Shtienberg; Gilad,27,0,30,3
1746560707242,ANAR 120,A00,886953,Staff,12,0,20,8
1746560708269,ANBI 148,A01,886955,Wilder; Linnea Lorene,30,0,40,10
1746560710320,ANSC 122,A00,886957,Staff,25,0,30,5
1746560711351,ANSC 150,A00,886958,Sloane; Julia Kathryn,2,0,15,13
1746560712375,ANSC 156,A00,886959,Jenkins; Janis A.,0,1,15,15
1746560713399,ANSC 180,A00,886960,Staff,11,0,17,6
1746560714423,ANSC 188,A00,886961,Jassal; Aftab,9,0,25,16
1746560715450,ANSC 190,A00,886962,Jassal; Aftab,14,0,25,11
1746560716475,ANSC 191,A00,886963,Staff,18,0,20,2
1746560717499,ANTH 3,A01,891689,Staff,17,0,20,3
1746560718526,ANTH 5,A00,886933,Semendeferi; Ekaterini,16,0,20,4
1746560719554,ANTH 10,A00,886934,Staff,0,12,30,30
1746560720581,ANTH 21,A01,886936,Staff,40,0,60,20
1746560721609,ANTH 23,A01,886938,Staff,92,0,100,8
1746560722637,ANTH 105,A00,886964,Stewart; Alexander B,84,0,100,16
1746560723665,ANTH 108,A00,886965,Pedersen; David,9,0,20,11
1746560724689,AWP 10,001,886147,Staff,0,0,0,0
1746560724689,AWP 10,002,886148,Staff,0,0,0,0
1746560724689,AWP 10,003,886149,Staff,0,0,0,0
1746560724689,AWP 10,004,886150,Staff,0,0,0,0
1746560724689,AWP 10,005,886151,Staff,0,0,0,0
1746560724689,AWP 10,006,886152,Staff,0,0,0,0
1746560724689,AWP 10,007,886153,Staff,0,0,0,0
1746560724689,AWP 10,008,886154,Staff,0,0,0,0
1746560724689,AWP 10,009,886155,Staff,0,0,0,0
1746560724689,AWP 10,010,886156,Staff,0,0,0,0
1746560724689,AWP 10,011,886158,Staff,0,0,0,0
1746560724689,AWP 10,012,886160,Staff,0,0,0,0
1746560724689,AWP 10,013,886161,Staff,0,0,0,0
1746560724689,AWP 10,014,886162,Staff,0,0,0,0
1746560724689,AWP 10,015,886163,Staff,0,0,0,0
1746560724689,AWP 10,016,886164,Staff,0,0,0,0
1746560724689,AWP 10,017,886165,Staff,0,0,0,0
1746560724689,AWP 10,018,886166,Staff,0,0,0,0
1746560724689,AWP 10,019,886168,Staff,0,0,0,0
1746560724689,AWP 10,020,886170,Staff,0,0,0,0
1746560724689,AWP 10,021,886172,Staff,0,0,0,0
1746560725720,AWP 10R,001,886173,Staff,0,1,0,0
1746560725720,AWP 10R,002,886174,Staff,0,1,0,0
1746560725720,AWP 10R,003,886175,Staff,0,0,0,0
1746560725720,AWP 10R,004,886176,Staff,0,0,0,0
1746560725720,AWP 10R,005,886177,Staff,0,0,0,0
1746560725720,AWP 10R,006,886178,Staff,0,0,0,0
1746560725720,AWP 10R,007,886179,Staff,0,0,0,0
1746560725720,AWP 10R,008,886181,Staff,0,0,0,0
1746560725720,AWP 10R,009,886182,Staff,0,0,0,0
1746560725720,AWP 10R,010,886183,Staff,0,0,0,0
1746560725720,AWP 10R,011,886184,Staff,0,0,0,0
1746560725720,AWP 10R,012,886185,Staff,0,0,0,0
1746560725720,AWP 10R,013,886186,Staff,0,0,0,0
1746560725720,AWP 10R,014,886187,Staff,0,0,0,0
1746560725720,AWP 10R,015,886188,Staff,0,0,0,0
1746560725720,AWP 10R,016,886189,Staff,0,0,0,0
1746560725720,AWP 10R,017,960532,Staff,0,0,0,0
1746560725720,AWP 10R,018,960533,Staff,0,0,0,0
1746560725720,AWP 10R,019,960534,Staff,0,0,0,0
1746560725720,AWP 10R,020,960538,Staff,0,0,0,0
1746560725720,AWP 10R,021,960540,Staff,0,0,0,0
1746560725720,AWP 10R,022,960541,Staff,0,0,0,0
1746560725720,AWP 10R,023,960542,Staff,0,0,0,0
1746560725720,AWP 10R,024,960544,Staff,0,0,0,0
1746560725720,AWP 10R,025,960545,Staff,0,0,0,0
1746560725720,AWP 10R,026,960548,Staff,0,0,0,0
1746560726744,AWP 102R,A00,886190,Staff,0,0,0,0
1746560726744,AWP 102R,B00,886191,Staff,0,0,0,0
1746560727769,BENG 100,A01,886193,Staff,17,0,30,13
1746560728799,BENG 122A,A01,886195,Hasty; Jeff M,13,0,30,17
1746560729827,BENG 166A,A00,886196,Sah; Robert Lie-Yuan,0,2,30,30
1746560730853,BENG 190,A00,958050,Khojah; Reem I,22,0,25,3
1746560731882,BIBC 102,A01,894320,Staff,0,0,46,46
1746560731882,BIBC 102,A02,894321,Staff,0,0,46,46
1746560731882,BIBC 102,A03,894344,Staff,7,0,46,39
1746560731882,BIBC 102,A04,894345,Staff,26,0,47,21
1746560732913,BICD 100R,A01,894365,Smith; Laurie,0,3,58,58
1746560732913,BICD 100R,A02,894366,Smith; Laurie,0,5,58,58
1746560732913,BICD 100R,A03,894367,Smith; Laurie,1,0,59,58
1746560732913,BICD 100R,A04,959869,Smith; Laurie,40,0,59,19
1746560733939,BICD 136,A01,894383,Gustafson-Brown; Cindy,14,0,50,36
1746560734964,BIEB 102,A01,894494,Butler; Shannon Rhey,51,0,130,79
1746560737017,BIEB 150,A01,894617,Wills; Christopher,3,0,20,17
1746560737017,BIEB 150,A02,894631,Wills; Christopher,3,0,20,17
1746560737017,BIEB 150,A03,894937,Wills; Christopher,3,0,20,17
1746560737017,BIEB 150,A04,894946,Wills; Christopher,5,0,20,15
1746560738047,BIEB 194,A00,906141,Kurle; Carolyn M.,6,0,20,14
1746560739072,BILD 1,A01,894154,Staff,3,0,19,16
1746560739072,BILD 1,A02,894155,Staff,14,0,19,5
1746560739072,BILD 1,A03,894160,Staff,13,0,19,6
1746560739072,BILD 1,A04,894161,Staff,15,0,18,3
1746560740097,BILD 2,A01,894168,Staff,0,0,50,50
1746560740097,BILD 2,A02,894169,Staff,0,0,50,50
1746560740097,BILD 2,A03,894179,Staff,0,0,50,50
1746560740097,BILD 2,A04,894203,Staff,26,0,50,24
1746560741127,BILD 3,A01,894213,Staff,22,0,31,9
1746560741127,BILD 3,A02,894214,Staff,26,0,31,5
1746560741127,BILD 3,A03,894235,Staff,28,0,31,3
1746560741127,BILD 3,A04,894236,Staff,28,0,32,4
1746560742157,BILD 4,A01,894253,Reuther; Keefe,5,0,24,19
1746560742157,BILD 4,A02,894258,Reuther; Keefe,16,0,24,8
1746560743181,BILD 5,A01,894276,Reuther; Keefe,35,0,50,15
1746560743181,BILD 5,A02,894277,Reuther; Keefe,45,0,50,5
1746560743181,BILD 5,A03,894290,Reuther; Keefe,44,0,50,6
1746560743181,BILD 5,A04,894291,Reuther; Keefe,48,0,50,2
1746560744208,BILD 24,A01,894297,Pirino; Giorgia,40,0,60,20
1746560745235,BIMM 100,B01,958915,Staff,71,0,100,29
1746560746259,BIMM 101,A01,895017,McDonnell; Lisa Marie,0,5,24,24
1746560746259,BIMM 101,A02,895018,McDonnell; Lisa Marie,0,5,24,24
1746560746259,BIMM 101,B01,895020,McDonnell; Lisa Marie,0,6,24,24
1746560746259,BIMM 101,B02,895021,McDonnell; Lisa Marie,0,4,24,24
1746560747286,BIMM 110,A01,895023,Staff,1,0,25,24
1746560747286,BIMM 110,A02,895024,Staff,9,0,25,16
1746560747286,BIMM 110,A03,895025,Staff,18,0,25,7
1746560747286,BIMM 110,A04,895031,Staff,20,0,25,5
1746560748313,BIMM 120,A01,895114,Gustafson-Brown; Cindy,14,0,28,14
1746560748313,BIMM 120,A02,895126,Gustafson-Brown; Cindy,21,0,27,6
1746560749338,BIPN 100,A01,895130,Yang; Mingyu,1,0,38,37
1746560749338,BIPN 100,A02,895131,Yang; Mingyu,32,0,38,6
1746560749338,BIPN 100,A03,895132,Yang; Mingyu,32,0,38,6
1746560749338,BIPN 100,A04,895133,Yang; Mingyu,27,0,36,9
1746560750362,BIPN 120,A01,895135,Cooke; James Edward,0,3,13,13
1746560750362,BIPN 120,A02,895136,Cooke; James Edward,0,1,13,13
1746560750362,BIPN 120,A03,895137,Cooke; James Edward,0,3,13,13
1746560750362,BIPN 120,A04,895156,Cooke; James Edward,0,2,11,11
1746560751387,BIPN 134,A01,895235,Cooke; James Edward,0,2,25,25
1746560751387,BIPN 134,A02,895237,Cooke; James Edward,0,0,25,25
1746560751387,BIPN 134,A03,895240,Cooke; James Edward,3,0,25,22
1746560751387,BIPN 134,A04,895270,Cooke; James Edward,20,0,25,5
1746560752420,BIPN 189,A00,892103,Staff,0,13,14,14
1746560754475,BISP 194,A00,958008,Staff,0,2,0,0
1746560755498,CAT 124,A01,922009,Staff,0,5,20,20
1746560756528,CAT 125R,A00,886390,Morales; Celeste Georgianna,0,2,20,20
1746560756528,CAT 125R,B00,886391,Irwin; Matthew Joseph,0,3,20,20
1746560756528,CAT 125R,C00,886392,Smith; Lauryn Alissa,0,2,20,20
1746560756528,CAT 125R,D00,886393,Vanderschuit; Maya Alysia,0,2,20,20
1746560756528,CAT 125R,E00,886394,Marchisotto; Jennifer Anne,0,4,20,20
1746560757552,CENG 15,A01,886218,Drews; Aaron,3,0,8,5
1746560758582,CENG 113,A00,886219,Opatkiewicz; Justin Paul,15,0,25,10
1746560759634,CGS 101,A00,887044,Staff,7,0,20,13
1746560760660,CGS 105,A01,887046,Staff,14,0,25,11
1746560761689,CGS 112,A00,887047,Cuong; Marisol,12,0,15,3
1746560762715,CGS 113,A00,887048,Staff,23,0,30,7
1746560763740,CGS 120,A00,887049,Staff,10,0,17,7
1746560764770,CHEM 6A,A01,886336,Lam; Tin Yiu,38,0,50,12
1746560764770,CHEM 6A,A02,886338,Lam; Tin Yiu,37,0,50,13
1746560765799,CHEM 6B,A01,886341,Hopkins; Patrycja Anna,16,0,50,34
1746560765799,CHEM 6B,A02,886343,Hopkins; Patrycja Anna,42,0,50,8
1746560766829,CHEM 6C,A01,886346,Albizati; Kim F.,0,2,50,50
1746560766829,CHEM 6C,A02,886348,Albizati; Kim F.,23,0,50,27
1746560767854,CHEM 40A,A01,886352,Klosterman; Jeremy K,65,0,100,35
1746560768880,CHEM 40B,A01,886356,Klosterman; Jeremy K,0,23,100,100
1746560769908,CHEM 41B,A01,886360,Theodorakis; Emmanuel,25,0,50,25
1746560769908,CHEM 41B,A02,886362,Theodorakis; Emmanuel,47,0,50,3
1746560770934,CHIN 165A,A00,886382,Xu; Li,18,0,20,2
1746560771958,CLAS 120,A00,886387,Myerston Santana; Jacobo,33,0,40,7
1746560772986,COGS 9,A01,886967,Shannon; Kyle Michael,42,0,60,18
1746560774013,COGS 11,A01,886969,Staff,10,0,30,20
1746560775038,COGS 14A,A01,886971,Staff,6,0,60,54
1746560776067,COGS 14B,A01,886973,Hoffman; Drew Ellen,4,0,60,56
1746560777093,COGS 18,A01,886975,Morgan; Eric,35,0,60,25
1746560778118,COGS 20,A01,886977,Staff,4,0,8,4
1746560778118,COGS 20,A02,886978,Staff,5,0,7,2
1746560779143,COGS 100,A01,907783,Staff,0,2,30,30
1746560780169,COGS 101B,A01,886980,Staff,0,3,48,48
1746560781198,COGS 101C,A01,886982,Delgado; Tania,0,5,44,44
1746560782224,COGS 102A,A01,886984,Johnson; Christine M.,4,0,30,26
1746560783250,COGS 118B,A01,886986,Staff,0,3,88,88
1746560784278,COGS 150,A01,886988,Bergen; Benjamin,22,0,50,28
1746560785305,COGS 153,A00,886989,Delgado; Tania,0,2,41,41
1746560786329,COGS 186,A01,886991,Staff,0,0,32,32
1746560787357,COGS 187A,A01,886993,Boyle; Mary E. T.,7,0,30,23
1746560788381,COGS 189,A00,886994,Staff,0,1,30,30
1746560789411,COMM 10,A01,886996,Staff,0,0,20,21
1746560789411,COMM 10,A02,886997,Staff,12,0,20,8
1746560789411,COMM 10,A03,959845,Staff,19,0,20,1
1746560790440,COMM 20,A01,886999,Leuning; Grant Maurstad,24,0,40,16
1746560792489,COMM 100A,A01,887002,Staff,0,0,20,25
1746560792489,COMM 100A,A02,887003,Staff,7,0,20,13
1746560793517,COMM 100B,A01,887005,Staff,0,8,20,24
1746560794543,COMM 106D,A00,887006,Staff,14,0,40,26
1746560795567,COMM 110G,A00,887007,Whitworth-Smith; Andrew C,12,0,40,28
1746560796591,COMM 111B,A00,887008,Staff,31,0,40,9
1746560797616,COMM 113T,A00,887009,Abuelhiga; Soraya Jill,28,0,40,12
1746560797616,COMM 113T,B00,906733,Staff,40,0,40,0
1746560798640,COMM 145,A00,887010,Staff,12,0,40,28
1746560799669,COMM 146,A00,887054,Staff,31,0,40,9
1746560800695,COMM 190,A00,887012,Staff,8,0,23,15
1746560801721,CSE 8A,A50,887015,Cao; Yingjun,57,0,85,28
1746560802745,CSE 11,A01,887017,Cao; Yingjun,12,0,70,58
1746560803769,CSE 20,A01,887019,Staff,30,0,50,20
1746560804796,CSE 21,A01,887021,Staff,78,0,100,22
1746560804796,CSE 21,B01,892583,Braun; Oliver,45,0,50,5
1746560805820,CSE 30,A01,887025,Eldon; John,143,0,200,57
1746560806848,CSE 100,A01,887027,Staff,26,0,50,24
1746560806848,CSE 100,A02,887028,Staff,42,0,50,8
1746560807873,CSE 101,A01,887030,Braun; Oliver,74,0,100,26
1746560807873,CSE 101,B01,887032,Jones; Miles E,0,3,50,50
1746560807873,CSE 101,B02,887033,Jones; Miles E,0,2,50,50
1746560808901,CSE 105,A01,908084,Jones; Miles E,32,0,50,18
1746560808901,CSE 105,A02,908087,Jones; Miles E,32,0,50,18
1746560809924,CSE 135,A01,887035,Powell; Thomas Allan,0,4,50,50
1746560810951,CSE 142,A01,887037,Staff,8,0,60,52
1746560811977,CSE 142L,A01,887039,Staff,34,0,60,26
1746560813003,CSE 151A,A01,887041,Solares; Edwin A,47,0,100,53
1746560814029,CSE 175,A01,887043,Kumar; Rakesh,30,0,30,0
1746560815053,CSS 1,A01,886389,Staff,1,1,40,39
1746560816080,DSC 30,A01,908097,Liao; Soohyun Nam,47,0,75,28
1746560817105,DSC 40A,A01,908099,Shannon; Kyle Michael,30,0,50,20
1746560818130,DSC 40B,A01,908112,Staff,16,0,50,34
1746560819157,DSC 80,A01,908116,Staff,19,0,60,41
1746560820185,DSC 197,001,956863,Eldridge; Justin Matthew,9999,0,9999,0
1746560821210,ECE 5,A01,886400,Morris; Karcher William,2,0,6,4
1746560821210,ECE 5,A02,886401,Morris; Karcher William,3,0,6,3
1746560822244,ECE 148,A01,886403,Silberman; Jack,0,14,14,14
1746560823271,ECON 1,A01,887265,Crane; Meredith Helen,12,0,70,58
1746560823271,ECON 1,B01,887268,Staff,43,0,50,7
1746560824298,ECON 2,A01,887273,Crane; Meredith Helen,55,0,70,15
1746560825326,ECON 3,A01,887279,Rondina; Giacomo,32,0,70,38
1746560826350,ECON 4,A01,887282,Anderson; John Charles,0,2,10,10
1746560827377,ECON 5,A01,887285,Staff,34,0,45,11
1746560827377,ECON 5,B01,887292,Staff,41,0,45,4
1746560828406,ECON 100A,A01,887337,Newhouse; Herbert S,54,0,70,16
1746560828406,ECON 100A,B01,887349,Staff,45,0,50,5
1746560829435,ECON 100B,A01,887361,Du; Songzi,29,0,70,41
1746560830461,ECON 100C,A01,887445,Newhouse; Herbert S,59,0,70,11
1746560831485,ECON 105,A00,887488,Vespa; Emanuel Ignacio,23,0,35,12
1746560832512,ECON 109,A01,887506,Shishkin; Denis,28,0,35,7
1746560833535,ECON 110A,A01,887568,Alon; Titan Michael,0,3,35,35
1746560833535,ECON 110A,B01,907601,Alon; Titan Michael,20,0,35,15
1746560834560,ECON 110B,A01,887598,Levkoff; Steven B.,0,24,70,70
1746560835587,ECON 112,A00,887599,Rondina; Giacomo,19,0,35,16
1746560836614,ECON 120A,A01,887603,Dai; Yinlin,35,0,70,35
1746560837644,ECON 120C,A01,887608,Sun; Yixiao,0,1,35,35
1746560837644,ECON 120C,B01,887614,Sun; Yixiao,0,0,35,35
1746560838670,ECON 138,A00,887621,Bharadwaj; Prashant,0,21,20,20
1746560839698,ECON 144,A00,958007,Squires; Dale E,13,0,35,22
1746560840723,ECON 171,A01,907666,Staff,18,0,35,17
1746560841751,ECON 175,A00,887626,Wu; Pak Yeung,23,0,35,12
1746560842779,ECON 190,A00,887640,Vespa; Emanuel Ignacio,23,0,35,12
1746560843806,EDS 25,A01,888197,Staff,0,0,0,0
1746560843806,EDS 25,A02,888209,Staff,0,0,0,0
1746560843806,EDS 25,A03,888210,Staff,0,0,0,0
1746560843806,EDS 25,A04,888212,Staff,0,0,0,0
1746560843806,EDS 25,A05,888213,Staff,0,0,0,0
1746560843806,EDS 25,A06,888214,Staff,0,0,0,0
1746560843806,EDS 25,A07,888235,Staff,0,2,0,0
1746560843806,EDS 25,A08,888236,Staff,0,0,0,0
1746560843806,EDS 25,A09,888240,Staff,0,0,0,0
1746560843806,EDS 25,A10,888244,Staff,0,0,0,0
1746560843806,EDS 25,B01,888273,Staff,0,0,0,0
1746560843806,EDS 25,B02,888285,Staff,0,0,0,0
1746560843806,EDS 25,B03,888423,Staff,0,0,0,1
1746560843806,EDS 25,B04,888432,Staff,0,0,0,0
1746560843806,EDS 25,B05,888433,Staff,0,0,0,0
1746560843806,EDS 25,B06,888467,Staff,0,0,0,0
1746560843806,EDS 25,B07,888468,Staff,0,0,0,0
1746560843806,EDS 25,B08,888479,Staff,0,0,0,0
1746560843806,EDS 25,B09,888484,Staff,0,0,0,0
1746560843806,EDS 25,B10,888487,Staff,0,0,0,0
1746560844831,EDS 38,A01,907700,Choi; Bailey Miyeon,30,0,30,0
1746560845856,EDS 112,A01,888601,Chapman; Thandeka K,13,0,40,27
1746560846880,EDS 115,A00,888697,Mendez; Kathrina Mendoza,10,0,30,20
1746560847906,EDS 116,A01,888893,Staff,35,0,40,5
1746560849957,EDS 124AR,A00,889133,Staff,29,0,50,21
1746560849957,EDS 124AR,B00,907471,Simon; Elizabeth A,37,0,50,13
1746560850984,EDS 124BR,A00,889134,Simon; Elizabeth A,44,0,100,56
1746560852011,EDS 125,A00,889135,Staff,25,0,30,5
1746560853036,EDS 126,A01,889138,Staff,36,0,40,4
1746560854061,EDS 164R,A01,889142,Wishard Guerra; Alison G.,33,0,50,17
1746560855088,ENG 30,A01,886396,Staff,0,0,0,0
1746560855088,ENG 30,B01,886398,Staff,0,0,0,0
1746560856113,ENVR 102,A00,906150,Montejo; Carolina,23,0,25,2
1746560857138,ETHN 103A,A00,887236,Man; Simeon S,0,3,0,0
1746560858164,ETHN 113,A00,887239,Staff,16,0,30,14
1746560859188,ETHN 116,A00,887240,Staff,16,0,25,9
1746560860212,ETHN 117,A00,887241,Choi; Esther Min,28,0,30,2
1746560861240,ETHN 118,A00,887243,Staff,24,0,30,6
1746560862264,ETHN 127,A00,887248,Cuong; Marisol,11,0,15,4
1746560863295,ETHN 139,A00,887250,Staff,7,0,10,3
1746560864318,ETHN 142,A00,887252,Staff,10,0,30,20
1746560865344,ETHN 161,A00,887253,Browne; Errol Tsekani,24,0,30,6
1746560866373,ETHN 163FR,A00,887255,Burelle; Julie Sara Veronique,0,0,5,5
1746560867401,GLBH 20,A00,889149,Elwardani; Nile Regina,8,0,42,34
1746560869452,GLBH 111,A01,889152,Burgos; Jose L.,17,0,17,0
1746560870479,GLBH 150,A00,889181,Sloane; Julia Kathryn,0,5,15,15
1746560872527,HDS 60,A01,886406,Warstadt; Melissa Fawn,73,0,80,7
1746560873553,HIAF 111,A00,889324,Gyamfi; Bright,25,0,32,7
1746560874577,HIEA 131,A00,889328,Staff,16,0,32,16
1746560875606,HIEA 144,A00,889333,Henry; Todd A.,26,0,32,6
1746560876632,HIEA 154,A00,889336,Henry; Todd A.,24,0,32,8
1746560877656,HIEU 106,A00,889339,Staff,22,0,32,10
1746560879704,HIEU 114,A00,889340,Staff,3,0,32,29
1746560880731,HIEU 135GS,A00,889342,Patterson; Patrick H.,0,0,1,24
1746560881757,HIEU 137,A00,889343,Edington; Claire Ellen,9,0,25,16
1746560882785,HIEU 148,A00,889345,Staff,14,0,32,18
1746560883814,HIEU 154,A00,889346,Biess; Frank Peter,21,0,32,11
1746560884839,HILA 102,A00,889351,Staff,12,0,32,20
1746560885864,HILD 2A,A01,889221,Lewandoski; Julia Mavis,1,10,32,31
1746560886889,HILD 7B,A01,889225,Man; Simeon S,0,12,32,32
1746560887915,HILD 7C,A01,889288,Alvarez; Luis A,0,14,32,32
1746560888941,HILD 30,A01,889323,Staff,0,5,32,32
1746560890991,HISC 119,A00,889383,Golan; Tal,20,0,32,12
1746560892019,HIUS 103,A00,889384,Man; Simeon S,0,0,32,32
1746560893044,HIUS 117,A00,919797,Kwak; Nancy,18,0,32,14
1746560894070,HIUS 142A,A00,919788,Staff,22,0,32,10
1746560896136,HIUS 149,A00,889386,Gyamfi; Bright,27,0,32,5
1746560897159,HIUS 155,A00,889387,Alvarez; Luis A,14,0,32,18
1746560898186,HUM 3,A01,886499,Caldwell; Michael Alan,19,0,50,31
1746560899214,HUM 3GS,A00,886500,Rodriguez; Bretton Sigfred,0,0,0,28
1746560900237,HUM 3R,A01,886502,Markman; Kristina,0,36,50,50
1746560901269,HUM 4,A01,886504,Crum; Matthew Stephen,24,0,50,26
1746560901269,HUM 4,B01,886506,West; Geoffrey Scott,17,0,50,33
1746560902297,HUM 4GS,A00,886507,Staff,0,0,0,19
1746560903322,HUM 5,A01,886509,Staff,32,0,50,18
1746560904347,HUM 5R,A01,886511,Zavodny; Tatiana Sophia,0,39,50,50
1746560905373,JAPN 180,A00,886407,Staff,17,0,40,23
1746560906398,LATI 50,A01,886409,Martin-Cabrera; Luis,4,0,22,18
1746560906398,LATI 50,A02,886410,Martin-Cabrera; Luis,19,0,22,3
1746560906398,LATI 50,A03,886411,Martin-Cabrera; Luis,21,0,22,1
1746560906398,LATI 50,A04,886412,Martin-Cabrera; Luis,9,0,22,13
1746560907421,LAWS 101,A00,907664,Staff,28,0,60,32
1746560908446,LIAB 1A,A00,889388,Saab; Dima,17,0,20,3
1746560909473,LIAB 1AX,A00,889389,El Cheddadi; Youniss,18,0,20,2
1746560910499,LIFR 1C,A00,889391,Van Moer; Vinciane G,8,0,20,12
1746560911524,LIFR 1CX,A00,889392,Van Moer; Vinciane G,7,0,20,13
1746560912551,LIFR 1D,A00,889393,Van Moer; Vinciane G,7,0,20,13
1746560913576,LIFR 1DX,A00,889394,Van Moer; Vinciane G,8,0,20,12
1746560914604,LIGN 7,A00,886923,Staff,24,0,50,26
1746560915631,LIGN 17,A00,886924,Kehler; Andrew Scott,125,0,150,25
1746560916658,LTAM 110,A00,889395,Staff,15,0,30,15
1746560917685,LTAM 110GS,A00,958010,Rodriguez; Bretton Sigfred,0,0,0,28
1746560918713,LTCH 101,A00,889397,Staff,23,0,25,2
1746560919743,LTCS 130,A00,889398,Staff,23,0,25,2
1746560920768,LTEA 138,A00,889399,Staff,24,0,40,16
1746560921794,LTEN 149,A00,889400,Wesling; Megan E.,0,3,25,25
1746560922819,LTEN 169,A00,889401,Staff,20,0,25,5
1746560923844,LTEN 180,A00,889402,Staff,10,0,15,5
1746560924872,LTEN 181,A00,889403,Staff,21,0,25,4
1746560925897,LTWL 100,A00,889404,Myerston Santana; Jacobo,2,0,25,23
1746560926922,LTWL 180GS,A00,889405,Staff,0,0,20,20
1746560927947,LTWL 181,A00,889406,Staff,16,0,25,9
1746560928971,LTWL 184,A00,889475,Mukherjee; Silpa,22,0,25,3
1746560929996,LTWR 102C,A00,889486,Staff,30,0,30,0
1746560931020,LTWR 115W,A00,889491,Staff,0,2,15,15
1746560932049,MAE 8,A01,886905,Staff,0,2,0,0
1746560933077,MAE 11,A00,886906,Bandaru; Prabhakar,0,7,50,50
1746560934101,MAE 20,A00,886907,Evdokimenko; Ekaterina,43,0,70,27
1746560935130,MAE 30B,A00,886909,Ghazinejad; Maziar,26,0,45,19
1746560936155,MAE 101B,A00,886910,Saintillan; David,29,0,45,16
1746560937180,MAE 105,A00,886911,Bandaru; Prabhakar,18,0,50,32
1746560938205,MAE 107,B00,958024,Staff,8,0,50,42
1746560939234,MAE 143B,A00,886913,Bewley; Thomas R,6,0,40,34
1746560940267,MAE 148,A01,886915,Silberman; Jack,0,3,14,14
1746560941293,MAE 160,A00,886916,Evdokimenko; Ekaterina,32,0,60,28
1746560942320,MATH 3C,A01,889681,Staff,0,2,30,30
1746560942320,MATH 3C,A02,960048,Staff,24,0,30,6
1746560943344,MATH 10A,A01,889760,Staff,26,0,30,4
1746560943344,MATH 10A,A02,889783,Staff,29,0,30,1
1746560944465,MATH 10B,A01,889785,Verstraete; Jacques Allan,2,0,35,33
1746560944465,MATH 10B,A02,889795,Verstraete; Jacques Allan,4,0,35,31
1746560944465,MATH 10B,B01,889797,Verstraete; Jacques Allan,3,0,35,32
1746560944465,MATH 10B,B02,889828,Verstraete; Jacques Allan,3,0,35,32
1746560945492,MATH 10C,A01,889849,Habib; Yousaf,8,0,30,22
1746560945492,MATH 10C,A02,889852,Habib; Yousaf,14,0,30,16
1746560945492,MATH 10C,A03,889853,Habib; Yousaf,22,0,30,8
1746560945492,MATH 10C,A04,889858,Habib; Yousaf,20,0,30,10
1746560945492,MATH 10C,B01,889861,Staff,1,0,30,29
1746560945492,MATH 10C,B02,889862,Staff,24,0,30,6
1746560945492,MATH 10C,B03,889863,Staff,27,0,30,3
1746560945492,MATH 10C,B04,889967,Staff,23,0,30,7
1746560946521,MATH 18,A01,889974,Staff,7,0,30,23
1746560946521,MATH 18,A02,889977,Staff,20,0,30,10
1746560946521,MATH 18,B01,889984,Hardiman; Liam,21,0,30,9
1746560946521,MATH 18,B02,889985,Hardiman; Liam,25,0,30,5
1746560947549,MATH 20A,A01,889990,Suk; Andrew Hoon,30,0,35,5
1746560948575,MATH 20B,A01,889993,Ohm; Ko Woon,22,0,30,8
1746560948575,MATH 20B,A02,889994,Ohm; Ko Woon,30,0,30,0
1746560948575,MATH 20B,B01,889996,Ohm; Ko Woon,21,0,30,9
1746560948575,MATH 20B,B02,889997,Ohm; Ko Woon,23,0,30,7
1746560949600,MATH 20C,A01,889999,Hammock; Frances H,17,0,30,13
1746560949600,MATH 20C,A02,890003,Hammock; Frances H,23,0,30,7
1746560949600,MATH 20C,B01,890006,Hammock; Frances H,3,0,30,27
1746560949600,MATH 20C,B02,890007,Hammock; Frances H,11,0,30,19
1746560950630,MATH 20D,A01,890011,Cheng; Hsiao-Bing,1,1,30,29
1746560950630,MATH 20D,A02,890012,Cheng; Hsiao-Bing,14,0,30,16
1746560950630,MATH 20D,B01,890016,Cheng; Hsiao-Bing,13,0,30,17
1746560950630,MATH 20D,B02,890017,Cheng; Hsiao-Bing,13,0,30,17
1746560951660,MATH 20E,A01,890026,Harel; Guershon,1,0,30,29
1746560951660,MATH 20E,A02,890029,Harel; Guershon,23,0,30,7
1746560951660,MATH 20E,B01,890033,Harel; Guershon,7,0,30,23
1746560951660,MATH 20E,B02,890101,Harel; Guershon,21,0,30,9
1746560952689,MATH 102,A01,890104,Staff,17,0,30,13
1746560952689,MATH 102,A02,890105,Staff,27,0,30,3
1746560953714,MATH 103B,A01,890116,Salehi Golsefidy; Alireza,3,0,30,27
1746560953714,MATH 103B,B01,890118,Staff,0,3,34,34
1746560954736,MATH 109,A01,890121,Aliabadi Sr.; Mohsen,1,0,30,29
1746560954736,MATH 109,B01,890124,Upadrashta; Pranav Kumar,18,0,30,12
1746560955760,MATH 120A,A01,890126,Eggers; John Dietrich,13,0,30,17
1746560956787,MATH 142B,A01,890128,Ioana; Adrian,19,0,30,11
1746560956787,MATH 142B,A02,890129,Ioana; Adrian,13,0,30,17
1746560957814,MATH 154,A01,890174,Staff,0,0,30,30
1746560957814,MATH 154,A02,890182,Staff,0,0,30,30
1746560958841,MATH 168A,A01,890197,Dumitriu; Ioana,21,0,35,14
1746560959867,MATH 170A,A01,890240,Nie; Jiawang,1,0,30,29
1746560959867,MATH 170A,A02,890241,Nie; Jiawang,11,0,30,19
1746560959867,MATH 170A,A03,890249,Nie; Jiawang,23,0,30,7
1746560960892,MATH 170B,A01,957891,Nag; Panchali,13,0,35,22
1746560962946,MATH 181A,A01,908025,Staff,0,4,35,35
1746560962946,MATH 181A,A02,960115,Staff,27,0,35,8
1746560963971,MATH 181B,A01,959874,Staff,25,0,30,5
1746560964995,MATH 193B,A01,890265,Staff,0,4,35,35
1746560966019,MGT 4,A01,890311,Anderson; John Charles,42,0,88,46
1746560967049,MGT 5,A00,907740,Staff,13,0,98,85
1746560968077,MGT 12,A00,890312,Lindenberger; Wade Douglas,67,0,98,31
1746560969102,MGT 16,A00,957883,Staff,78,0,98,20
1746560971165,MGT 45,A00,890314,Pecore; Joseph P.,46,0,98,52
1746560972217,MGT 71,A00,890315,Staff,0,11,98,98
1746560973243,MGT 100,A00,890316,Yavorsky; Daniel Ryan,44,0,98,54
1746560974268,MGT 103,A00,890317,Ehrich; Kristine R,73,0,98,25
1746560975293,MGT 105,A00,890356,Bates; Kenneth Walter,0,8,98,98
1746560976318,MGT 112,A00,890360,Ehrich; Kristine R,55,0,98,43
1746560977345,MGT 127R,A00,907732,Zhu; Kevin Xiaoguo,23,0,98,75
1746560978371,MGT 131B,A00,890361,Anderson; John Charles,60,0,98,38
1746560979400,MGT 137,A00,890362,Lindenberger; Wade Douglas,65,0,98,33
1746560980427,MGT 160,A00,890369,Johnson; Erik Barry,9,0,98,89
1746560982483,MGT 164,A00,890372,Zimmermann; Carsten,0,40,98,98
1746560983508,MGT 180,A00,890374,Bliss; Barbara Ann,12,0,98,86
1746560984533,MMW 15,A01,886414,Chang; Edmond Yi-Teh,0,12,28,28
1746560984533,MMW 15,A02,886415,Chang; Edmond Yi-Teh,0,8,28,28
1746560984533,MMW 15,A03,886416,Chang; Edmond Yi-Teh,0,8,28,28
1746560984533,MMW 15,A04,886417,Chang; Edmond Yi-Teh,0,8,28,28
1746560984533,MMW 15,B01,886419,Chang; Edmond Yi-Teh,0,7,28,28
1746560984533,MMW 15,B02,886420,Chang; Edmond Yi-Teh,0,8,28,28
1746560984533,MMW 15,B03,886421,Chang; Edmond Yi-Teh,0,7,28,28
1746560984533,MMW 15,B04,886422,Chang; Edmond Yi-Teh,0,8,28,28
1746560984533,MMW 15,C01,886424,Staff,0,9,28,28
1746560984533,MMW 15,C02,886425,Staff,0,8,28,28
1746560984533,MMW 15,C03,886426,Staff,0,8,28,28
1746560984533,MMW 15,C04,886427,Staff,0,8,28,28
1746560984533,MMW 15,C05,958038,Staff,0,8,28,28
1746560984533,MMW 15,C06,958039,Staff,0,8,28,28
1746560985559,MMW 15GS,A00,906910,Patterson; Patrick H.,4,0,28,24
1746560986587,MMW 122R,A01,886429,Rahimi; Babak,0,13,28,28
1746560986587,MMW 122R,A02,886430,Rahimi; Babak,0,12,28,28
1746560986587,MMW 122R,A03,958040,Rahimi; Babak,0,11,28,28
1746560987614,MUS 1A,A01,890937,Staff,2,0,25,23
1746560987614,MUS 1A,A02,891035,Staff,6,0,25,19
1746560987614,MUS 1A,C01,958912,Staff,24,0,25,1
1746560987614,MUS 1A,C02,958913,Staff,25,0,25,0
1746560989667,MUS 2AK,A00,957092,Ohnishi; Takae,15,0,15,0
1746560990694,MUS 4,A01,891044,Staff,2,0,25,23
1746560990694,MUS 4,A02,891045,Staff,23,0,25,2
1746560990694,MUS 4,B01,891048,Staff,17,0,25,8
1746560990694,MUS 4,B02,891050,Staff,25,0,25,0
1746560991720,MUS 5,A01,957506,Dubnov; Shlomo,0,0,25,25
1746560991720,MUS 5,A02,957622,Dubnov; Shlomo,13,0,25,12
1746560991720,MUS 5,A03,957623,Dubnov; Shlomo,20,0,25,5
1746560992747,MUS 6,A01,891053,Freitas Caetano; Marcelo,24,0,25,1
1746560992747,MUS 6,A02,891054,Freitas Caetano; Marcelo,23,0,25,2
1746560993775,MUS 7,A01,891081,Staff,0,0,25,25
1746560993775,MUS 7,A02,891082,Staff,4,0,25,21
1746560994800,MUS 8GS,A00,891118,Borgo; David Garcia,0,0,25,25
1746560995825,MUS 11,A01,891140,Staff,10,0,25,15
1746560995825,MUS 11,A02,891141,Staff,22,0,25,3
1746560996850,MUS 13,A01,891143,Staff,8,0,25,17
1746560996850,MUS 13,A02,891144,Staff,24,0,25,1
1746560997879,MUS 15,A01,891146,Staff,9,0,25,16
1746560997879,MUS 15,A02,891148,Staff,21,0,25,4
1746560997879,MUS 15,B01,891150,Staff,18,0,25,7
1746560997879,MUS 15,B02,891151,Staff,25,0,25,0
1746560998906,MUS 20,A01,891153,Staff,5,0,20,15
1746560998906,MUS 20,A02,891155,Staff,14,0,20,6
1746560999930,MUS 80,A00,891156,Staff,19,0,25,6
1746560999930,MUS 80,B00,891157,Staff,23,0,25,2
1746561000957,MUS 130,A00,891158,Ohnishi; Takae,35,0,35,0
1746561001981,MUS 150GS,A01,891160,Borgo; David Garcia,0,0,25,25
1746561003031,MUS 170,A01,891162,Freitas Caetano; Marcelo,20,0,25,5
1746561003031,MUS 170,A02,891164,Freitas Caetano; Marcelo,21,0,25,4
1746561004056,NANO 11,A00,886220,Vazquez Mena; Oscar,13,0,15,2
1746561005081,NANO 15,A01,886222,Drews; Aaron,4,0,7,3
1746561006106,NANO 104,A00,886224,Sirbuly; Donald,18,0,25,7
1746561007134,PH 40,A00,886528,Staff,23,0,40,17
1746561008162,PH 45,A01,886799,Staff,35,0,40,5
1746561009187,PH 110,A00,886802,Staff,0,7,40,40
1746561010213,PH 172,A00,906716,Staff,19,0,35,16
1746561011237,PH 191,A00,886803,Staff,6,0,40,34
1746561012263,PHIL 1,A00,889500,Staff,20,0,30,10
1746561013286,PHIL 10,A01,889549,Grush; Rick Scott,15,0,22,7
1746561013286,PHIL 10,A02,889551,Grush; Rick Scott,22,0,22,0
1746561014315,PHIL 28,A01,889559,Lamey; Andy M.,0,1,31,31
1746561014315,PHIL 28,A02,889561,Lamey; Andy M.,0,1,30,30
1746561014315,PHIL 28,A03,889572,Lamey; Andy M.,0,1,30,30
1746561015343,PHIL 35,A00,907839,Staff,13,0,15,2
1746561016367,PHIL 60,A00,889574,Staff,73,0,90,17
1746561017393,PHIL 101,A00,958004,Staff,12,0,15,3
1746561019459,PHIL 136,A00,889582,Fulkerson; Matthew Todd,26,0,45,19
1746561020490,PHIL 163,A01,889601,Staff,21,0,30,9
1746561020490,PHIL 163,B01,889606,Brandt; Reuven A,0,3,0,0
1746561021518,PHIL 164,A00,889610,Staff,16,0,30,14
1746561022544,PHIL 165,A00,889613,Staff,23,0,30,7
1746561023568,PHYS 1A,A00,886431,Staff,26,0,70,44
1746561024592,PHYS 1AL,001,886432,Tsai; Philbert S,0,2,30,30
1746561024592,PHYS 1AL,002,886436,Tsai; Philbert S,11,0,30,19
1746561025617,PHYS 1B,A00,886439,Staff,185,0,240,55
1746561026644,PHYS 1BL,001,886441,Tsai; Philbert S,0,4,30,30
1746561026644,PHYS 1BL,002,886444,Tsai; Philbert S,2,0,30,28
1746561027670,PHYS 1C,A00,896092,Arnold; Kam S,79,0,146,67
1746561028697,PHYS 1CL,001,886448,Tsai; Philbert S,0,0,30,30
1746561028697,PHYS 1CL,002,886449,Tsai; Philbert S,1,0,30,29
1746561028697,PHYS 1CL,003,886450,Tsai; Philbert S,16,0,30,14
1746561028697,PHYS 1CL,004,886451,Tsai; Philbert S,15,0,30,15
1746561029724,PHYS 2B,A01,886457,Staff,68,0,115,47
1746561030748,PHYS 2C,A01,886460,Shotwell; Brian,0,9,65,65
1746561031772,PHYS 2CL,A01,886467,Staff,0,4,28,28
1746561031772,PHYS 2CL,A02,886468,Staff,0,3,28,28
1746561032800,PHYS 2D,A01,886470,Staff,10,0,50,40
1746561033824,PHYS 4B,A01,886475,Grinstein; Benjamin,22,0,40,18
1746561034849,POLI 5,A00,891173,Desposato; Scott,7,0,25,18
1746561035876,POLI 5D,A01,891175,Staff,5,0,5,0
1746561035876,POLI 5D,B01,891178,Staff,5,0,5,0
1746561036902,POLI 11,A00,891179,Ferree; Karen E,2,0,35,33
1746561037926,POLI 12,A00,891180,Staff,16,0,30,14
1746561038950,POLI 27,A01,891182,Staff,12,0,75,63
1746561039977,POLI 30,A00,891183,Staff,8,0,50,42
1746561041003,POLI 100B,A00,891244,Staff,5,1,35,30
1746561042028,POLI 100I,A00,891247,Staff,7,0,30,23
1746561043054,POLI 104J,A00,891248,Nichter; Maysa,14,0,30,16
1746561044079,POLI 104U,A00,891250,Nichter; Maysa,2,0,30,28
1746561046129,POLI 110B,A00,891255,Wiens; David,20,0,25,5
1746561047156,POLI 112A,A00,891256,Wiens; David,6,0,25,19
1746561048184,POLI 114BR,A00,891261,Staff,19,0,30,11
1746561049211,POLI 117R,A00,891262,Forman; Fonna,0,6,50,50
1746561050239,POLI 118,A00,891264,Ingham; Sean,17,0,25,8
1746561051267,POLI 124A,A00,891265,Staff,18,0,20,2
1746561052293,POLI 125D,A00,891266,Nichter; Simeon C,2,0,25,23
1746561053317,POLI 126,A00,891268,Nichter; Simeon C,7,0,25,18
1746561054343,POLI 126AA,A00,891272,Staff,17,0,25,8
1746561055370,POLI 130AA,A00,891273,Staff,15,0,20,5
1746561056397,POLI 134AA,A00,891274,Staff,4,0,20,16
1746561058459,POLI 138,A00,891278,Staff,21,0,25,4
1746561059488,POLI 142K,A00,891280,Staff,11,0,25,14
1746561060535,POLI 142M,A00,891281,Gartzke; Erik,17,0,30,13
1746561061561,POLI 142P,A00,891284,Staff,20,0,30,10
1746561062587,POLI 143,A00,891285,Gartzke; Erik,12,0,30,18
1746561063610,POLI 153,A00,891286,Staff,19,0,20,1
1746561065663,POLI 175,A00,891290,Staff,15,0,20,5
1746561066688,PSYC 1,A00,890674,Steiner; Eric Tomas,0,11,45,45
1746561067712,PSYC 2,A00,890676,Albright; Thomas D,21,0,35,14
1746561068738,PSYC 3,A00,890679,Staff,17,0,20,3
1746561069763,PSYC 6,A00,959858,Staff,20,0,20,0
1746561070791,PSYC 60,A01,890684,Rickard; Timothy C.,0,5,45,45
1746561071817,PSYC 70,A01,890689,Geller; Emma Harlan,7,0,30,23
1746561072841,PSYC 71,A01,959860,Staff,21,0,25,4
1746561073867,PSYC 100,A00,890690,Lacefield; Katharine I,0,50,180,180
1746561074892,PSYC 102,A00,890695,Staff,18,0,40,22
1746561075917,PSYC 105,A00,890699,Geller; Emma Harlan,70,0,100,30
1746561076942,PSYC 106,A00,890701,Gorman; Michael R.,6,0,30,24
1746561077969,PSYC 108,A00,890704,Adrian; Julia Anna,0,28,50,50
1746561078996,PSYC 118,A01,890712,Staff,11,0,30,19
1746561080021,PSYC 124,A00,890716,Chapman; Eddie Nathaniel,25,0,60,35
1746561081046,PSYC 131,A00,890717,Anagnostaras; Stephan,0,7,80,80
1746561082074,PSYC 137,A00,890719,Winkielman; Piotr,0,11,30,30
1746561083105,PSYC 144,A00,890721,Adrian; Julia Anna,0,9,45,45
1746561084131,PSYC 162,A00,890805,Staff,2,0,75,73
1746561085163,PSYC 169,A00,890810,Staff,0,14,30,30
1746561086191,PSYC 172,A00,890814,Gorman; Michael R.,9,0,30,21
1746561087216,PSYC 181,A00,890818,Anagnostaras; Stephan,9,0,200,191
1746561088241,PSYC 184,A00,959861,Staff,170,0,175,5
1746561089268,PSYC 189,A00,890823,Staff,0,1,30,30
1746561090293,PSYC 191,A00,890884,Rickard; Timothy C.,0,11,35,35
1746561091317,PSYC 193,A00,890913,Staff,19,0,30,11
1746561091317,PSYC 193,B00,890914,Chapman; Eddie Nathaniel,24,0,30,6
1746561092347,PSYC 193L,A01,890918,Lowe; Angela Beth,20,0,30,10
1746561092347,PSYC 193L,B01,890921,Hurwitz; Ethan Scott,20,0,30,10
1746561092347,PSYC 193L,C01,890928,Staff,30,0,30,0
1746561093375,RELI 149,A00,886806,Rahimi; Babak,23,0,40,17
1746561094399,SE 9,A01,886814,Staff,7,0,20,13
1746561095427,SE 101B,A01,886816,Chadha; Mayank,4,0,35,31
1746561096453,SE 110B,A00,886818,Zhu; Qiang,4,0,75,71
1746561097480,SE 125,A01,886830,Staff,10,0,30,20
1746561098506,SE 130B,A01,886835,Staff,14,0,40,26
1746561099530,SE 131A,A01,886838,Krysl; Petr,34,0,55,21
1746561100558,SE 154,A00,886840,Staff,29,0,50,21
1746561101586,SE 164GS,A01,886849,Staff,6,0,20,14
1746561102612,SE 167GS,A01,886853,Staff,6,0,20,14
1746561103655,SIO 25,A01,890107,Staff,19,0,30,11
1746561104681,SIO 45,A00,890109,Cook; Geoffrey W,117,0,200,83
1746561105703,SIO 109R,A00,890110,Forman; Fonna,0,16,20,20
1746561106728,SIO 187,A01,890114,Kacev; David,15,0,40,25
1746561107752,SOCI 1,A01,890431,Thorpe; Charles Robert,15,0,30,15
1746561107752,SOCI 1,A02,890518,Thorpe; Charles Robert,30,0,30,0
1746561108776,SOCI 2,A01,957978,Staff,25,0,25,0
1746561108776,SOCI 2,A02,957979,Staff,23,0,25,2
1746561109801,SOCI 20,A01,890523,Calderon-Zaks; Michael Aar,23,0,30,7
1746561109801,SOCI 20,A02,890526,Calderon-Zaks; Michael Aar,29,0,30,1
1746561110826,SOCI 30,A01,890533,Pardo Guerra; Juan Pablo,37,0,40,3
1746561111853,SOCI 40,A01,890535,Staff,27,0,45,18
1746561112879,SOCI 104Q,A00,890559,Staff,18,0,30,12
1746561113905,SOCI 106,A00,890560,Arnal; Maud Marie Leonie,20,0,30,10
1746561114932,SOCI 110,A00,890567,Holkenbrink-Monk; Charlene,19,0,30,11
1746561115957,SOCI 112,A00,890568,Victoria Torres; Pablo,2,0,55,53
1746561116983,SOCI 115,A00,890597,Arnal; Maud Marie Leonie,28,0,45,17
1746561119032,SOCI 121,A00,890604,Pardo Guerra; Juan Pablo,38,0,45,7
1746561120058,SOCI 126,A01,890608,Staff,8,0,10,2
1746561121084,SOCI 127,A00,890609,Staff,18,0,30,12
1746561122114,SOCI 131,A00,890610,Thorpe; Charles Robert,37,0,45,8
1746561123142,SOCI 135,A00,890615,Payne; Christine Anna,13,0,45,32
1746561124168,SOCI 139,A00,890620,Staff,38,0,45,7
1746561125196,SOCI 148E,A00,890622,Calderon-Zaks; Michael Aar,36,0,45,9
1746561126221,SOCI 150,A00,890623,Kohler; Kristopher M.,31,0,45,14
1746561127247,SOCI 157,A00,890625,Jules-Rosette; Bennetta W.,18,0,20,2
1746561128275,SOCI 160,A00,890627,Payne; Christine Anna,21,0,45,24
1746561129299,SYN 1,A00,886855,Fish; Gwendolyn Anne,0,0,0,0
1746561129299,SYN 1,B00,906086,Fish; Gwendolyn Anne,0,1,0,2
1746561130327,SYN 2R,A00,886860,Staff,0,17,15,15
1746561130327,SYN 2R,B00,906106,Atkinson; Arthur Laird,0,16,15,15
1746561131354,SYN 100,A01,886866,Browne; Emily,0,28,20,20
1746561131354,SYN 100,B01,906128,Rock; Martin,0,5,20,20
1746561131354,SYN 100,C01,906140,Deavenport; James Cary,0,3,20,20
1746561131354,SYN 100,D01,907816,Deavenport; James Cary,0,5,20,20
1746561132379,TDAC 1,A00,890286,Walsh; Kim C.,8,0,20,12
1746561133406,TDAC 101,A00,890296,Basso; Beatrice,15,0,20,5
1746561134433,TDDE 131,A00,890297,Staff,47,0,50,3
1746561135461,TDDM 1,A00,890287,Weinberg; Sadie,25,0,30,5
1746561136488,TDGE 11,A00,890288,Fulton; Julia,137,0,200,63
1746561136488,TDGE 11,B00,890289,Castro; Robert Jess,184,0,200,16
1746561137514,TDGE 25,B00,957359,Walsh; Kim C.,3,0,20,17
1746561138542,TDGE 40,A01,890292,Power; Jade Yukana,27,0,30,3
1746561139567,TDGE 124,A00,890298,Havis; Allan,0,1,50,50
1746561140592,TDGE 131R,A00,890299,Burelle; Julie Sara Veronique,15,0,42,27
1746561141618,TDHT 101,A00,890300,Staff,10,0,20,10
1746561142645,TDHT 109,A01,890302,Anderson; Mysia Anyse,31,0,40,9
1746561143670,TDMV 1,A00,890293,Arcidiacono; Kristin,18,0,30,12
1746561144699,TDMV 2,A00,890294,Weinberg; Sadie,23,0,30,7
1746561145729,TDMV 3,A00,957878,Arcidiacono; Kristin,28,0,30,2
1746561147786,TDMV 138,A00,890304,Jun; Grace Shin Hae,25,0,40,15
1746561148812,TDMV 140,A00,890305,Corrales; Joseph Bernales,25,0,30,5
1746561149840,TDMV 142,A00,890307,Caligagan; Tony,32,0,40,8
1746561150869,TDMV 144,A00,890308,Camaya; Michelle Ann,25,0,30,5
1746561151894,TDPW 1,A00,890295,Stein; Deborah Isobel,3,0,20,17
1746561152922,USP 2,A01,890272,Lerner; Amy M,6,0,20,14
1746561153949,USP 3,A01,890274,Staff,12,0,30,18
1746561154974,USP 15,A01,890276,Sun; Feiyang,16,0,30,14
1746561156000,USP 25,A00,890277,Shenkman; Michael Thomas,19,0,25,6
1746561157028,USP 138,A00,890278,Staff,14,0,25,11
1746561158053,USP 143,A00,890279,Staff,22,0,70,48
1746561159081,USP 144,A00,890280,Chowdhury; Muhammed Zohir,16,0,30,14
1746561160111,USP 150,A00,890281,Boomhower; Matthew Charles,4,0,30,26
1746561161134,USP 151,A00,890282,Staff,16,0,20,4
1746561162161,USP 162,A00,890283,Andrews; Abigail Leslie,16,0,20,4
1746561163187,USP 168,A00,920477,Kwak; Nancy,0,0,5,5
1746561164211,USP 181,A00,890284,Staff,3,0,20,17
1746561165236,USP 191A,A00,890285,Staff,12,0,20,8
1746561166264,VIS 101,A00,886512,Staff,26,0,75,49
1746561167291,VIS 103,A00,886513,Cruz; Edwin Teddy,61,0,75,14
1746561168314,VIS 108,A00,886514,Staff,3,0,15,12
1746561169340,VIS 127P,A00,886515,Shen; Kuiyi,80,0,146,66
1746561170367,VIS 149,A00,886516,Yoldas; Pinar,0,0,15,15
1746561171394,VIS 164,A00,886526,Erdmann; Dean,19,0,22,3
1746561172425,VIS 194S,A00,886527,Staff,61,0,75,14
1746561173454,WCWP 10A,C00,886484,Martiniuk; Jill,12,0,15,3
1746561174483,WCWP 10B,A00,886490,Uriarte; Emma,0,0,15,15
1746561174483,WCWP 10B,B00,886491,Dhir; Simrita,10,0,15,5
1746561174483,WCWP 10B,C00,886492,Ornelas; Tricia,0,0,15,15
1746561175510,WCWP 100,A00,886494,Young; Mark T,0,6,15,15
1746561177645,AAS 10,A01,886199,Childs; Dennis R.,0,3,0,0
1746561178671,ANAR 104,A01,886940,Shtienberg; Gilad,27,0,30,3
1746561179695,ANAR 120,A00,886953,Staff,12,0,20,8
1746561180721,ANBI 148,A01,886955,Wilder; Linnea Lorene,30,0,40,10
1746561182773,ANSC 122,A00,886957,Staff,25,0,30,5
1746561183799,ANSC 150,A00,886958,Sloane; Julia Kathryn,2,0,15,13
1746561184828,ANSC 156,A00,886959,Jenkins; Janis A.,0,1,15,15
1746561185853,ANSC 180,A00,886960,Staff,11,0,17,6
1746561186878,ANSC 188,A00,886961,Jassal; Aftab,9,0,25,16
1746561187903,ANSC 190,A00,886962,Jassal; Aftab,14,0,25,11
1746561188927,ANSC 191,A00,886963,Staff,18,0,20,2
1746561189955,ANTH 3,A01,891689,Staff,17,0,20,3
1746561190983,ANTH 5,A00,886933,Semendeferi; Ekaterini,16,0,20,4
1746561192006,ANTH 10,A00,886934,Staff,0,12,30,30
1746561193031,ANTH 21,A01,886936,Staff,40,0,60,20
1746561194056,ANTH 23,A01,886938,Staff,92,0,100,8
1746561195082,ANTH 105,A00,886964,Stewart; Alexander B,84,0,100,16
1746561196108,ANTH 108,A00,886965,Pedersen; David,9,0,20,11
1746561197140,AWP 10,001,886147,Staff,0,0,0,0
1746561197140,AWP 10,002,886148,Staff,0,0,0,0
1746561197140,AWP 10,003,886149,Staff,0,0,0,0
1746561197140,AWP 10,004,886150,Staff,0,0,0,0
1746561197140,AWP 10,005,886151,Staff,0,0,0,0
1746561197140,AWP 10,006,886152,Staff,0,0,0,0
1746561197140,AWP 10,007,886153,Staff,0,0,0,0
1746561197140,AWP 10,008,886154,Staff,0,0,0,0
1746561197140,AWP 10,009,886155,Staff,0,0,0,0
1746561197140,AWP 10,010,886156,Staff,0,0,0,0
1746561197140,AWP 10,011,886158,Staff,0,0,0,0
1746561197140,AWP 10,012,886160,Staff,0,0,0,0
1746561197140,AWP 10,013,886161,Staff,0,0,0,0
1746561197140,AWP 10,014,886162,Staff,0,0,0,0
1746561197140,AWP 10,015,886163,Staff,0,0,0,0
1746561197140,AWP 10,016,886164,Staff,0,0,0,0
1746561197140,AWP 10,017,886165,Staff,0,0,0,0
1746561197140,AWP 10,018,886166,Staff,0,0,0,0
1746561197140,AWP 10,019,886168,Staff,0,0,0,0
1746561197140,AWP 10,020,886170,Staff,0,0,0,0
1746561197140,AWP 10,021,886172,Staff,0,0,0,0
1746561198167,AWP 10R,001,886173,Staff,0,1,0,0
1746561198167,AWP 10R,002,886174,Staff,0,1,0,0
1746561198167,AWP 10R,003,886175,Staff,0,0,0,0
1746561198167,AWP 10R,004,886176,Staff,0,0,0,0
1746561198167,AWP 10R,005,886177,Staff,0,0,0,0
1746561198167,AWP 10R,006,886178,Staff,0,0,0,0
1746561198167,AWP 10R,007,886179,Staff,0,0,0,0
1746561198167,AWP 10R,008,886181,Staff,0,0,0,0
1746561198167,AWP 10R,009,886182,Staff,0,0,0,0
1746561198167,AWP 10R,010,886183,Staff,0,0,0,0
1746561198167,AWP 10R,011,886184,Staff,0,0,0,0
1746561198167,AWP 10R,012,886185,Staff,0,0,0,0
1746561198167,AWP 10R,013,886186,Staff,0,0,0,0
1746561198167,AWP 10R,014,886187,Staff,0,0,0,0
1746561198167,AWP 10R,015,886188,Staff,0,0,0,0
1746561198167,AWP 10R,016,886189,Staff,0,0,0,0
1746561198167,AWP 10R,017,960532,Staff,0,0,0,0
1746561198167,AWP 10R,018,960533,Staff,0,0,0,0
1746561198167,AWP 10R,019,960534,Staff,0,0,0,0
1746561198167,AWP 10R,020,960538,Staff,0,0,0,0
1746561198167,AWP 10R,021,960540,Staff,0,0,0,0
1746561198167,AWP 10R,022,960541,Staff,0,0,0,0
1746561198167,AWP 10R,023,960542,Staff,0,0,0,0
1746561198167,AWP 10R,024,960544,Staff,0,0,0,0
1746561198167,AWP 10R,025,960545,Staff,0,0,0,0
1746561198167,AWP 10R,026,960548,Staff,0,0,0,0
1746561199194,AWP 102R,A00,886190,Staff,0,0,0,0
1746561199194,AWP 102R,B00,886191,Staff,0,0,0,0
1746561200223,BENG 100,A01,886193,Staff,17,0,30,13
1746561201248,BENG 122A,A01,886195,Hasty; Jeff M,13,0,30,17
1746561202275,BENG 166A,A00,886196,Sah; Robert Lie-Yuan,0,2,30,30
1746561203300,BENG 190,A00,958050,Khojah; Reem I,22,0,25,3
1746561204323,BIBC 102,A01,894320,Staff,0,0,46,46
1746561204323,BIBC 102,A02,894321,Staff,0,0,46,46
1746561204323,BIBC 102,A03,894344,Staff,7,0,46,39
1746561204323,BIBC 102,A04,894345,Staff,26,0,47,21
1746561205351,BICD 100R,A01,894365,Smith; Laurie,0,3,58,58
1746561205351,BICD 100R,A02,894366,Smith; Laurie,0,5,58,58
1746561205351,BICD 100R,A03,894367,Smith; Laurie,1,0,59,58
1746561205351,BICD 100R,A04,959869,Smith; Laurie,40,0,59,19
1746561206376,BICD 136,A01,894383,Gustafson-Brown; Cindy,14,0,50,36
1746561207402,BIEB 102,A01,894494,Butler; Shannon Rhey,51,0,130,79
1746561209455,BIEB 150,A01,894617,Wills; Christopher,3,0,20,17
1746561209455,BIEB 150,A02,894631,Wills; Christopher,3,0,20,17
1746561209455,BIEB 150,A03,894937,Wills; Christopher,3,0,20,17
1746561209455,BIEB 150,A04,894946,Wills; Christopher,5,0,20,15
1746561210481,BIEB 194,A00,906141,Kurle; Carolyn M.,6,0,20,14
1746561211506,BILD 1,A01,894154,Staff,3,0,19,16
1746561211506,BILD 1,A02,894155,Staff,14,0,19,5
1746561211506,BILD 1,A03,894160,Staff,13,0,19,6
1746561211506,BILD 1,A04,894161,Staff,15,0,18,3
1746561212535,BILD 2,A01,894168,Staff,0,0,50,50
1746561212535,BILD 2,A02,894169,Staff,0,0,50,50
1746561212535,BILD 2,A03,894179,Staff,0,0,50,50
1746561212535,BILD 2,A04,894203,Staff,26,0,50,24
1746561213559,BILD 3,A01,894213,Staff,22,0,31,9
1746561213559,BILD 3,A02,894214,Staff,26,0,31,5
1746561213559,BILD 3,A03,894235,Staff,28,0,31,3
1746561213559,BILD 3,A04,894236,Staff,28,0,32,4
1746561214587,BILD 4,A01,894253,Reuther; Keefe,5,0,24,19
1746561214587,BILD 4,A02,894258,Reuther; Keefe,16,0,24,8
1746561215614,BILD 5,A01,894276,Reuther; Keefe,35,0,50,15
1746561215614,BILD 5,A02,894277,Reuther; Keefe,45,0,50,5
1746561215614,BILD 5,A03,894290,Reuther; Keefe,44,0,50,6
1746561215614,BILD 5,A04,894291,Reuther; Keefe,48,0,50,2
1746561216639,BILD 24,A01,894297,Pirino; Giorgia,40,0,60,20
1746561217667,BIMM 100,B01,958915,Staff,71,0,100,29
1746561218692,BIMM 101,A01,895017,McDonnell; Lisa Marie,0,5,24,24
1746561218692,BIMM 101,A02,895018,McDonnell; Lisa Marie,0,5,24,24
1746561218692,BIMM 101,B01,895020,McDonnell; Lisa Marie,0,6,24,24
1746561218692,BIMM 101,B02,895021,McDonnell; Lisa Marie,0,4,24,24
1746561219719,BIMM 110,A01,895023,Staff,1,0,25,24
1746561219719,BIMM 110,A02,895024,Staff,9,0,25,16
1746561219719,BIMM 110,A03,895025,Staff,18,0,25,7
1746561219719,BIMM 110,A04,895031,Staff,20,0,25,5
1746561220749,BIMM 120,A01,895114,Gustafson-Brown; Cindy,14,0,28,14
1746561220749,BIMM 120,A02,895126,Gustafson-Brown; Cindy,21,0,27,6
1746561221778,BIPN 100,A01,895130,Yang; Mingyu,1,0,38,37
1746561221778,BIPN 100,A02,895131,Yang; Mingyu,32,0,38,6
1746561221778,BIPN 100,A03,895132,Yang; Mingyu,32,0,38,6
1746561221778,BIPN 100,A04,895133,Yang; Mingyu,27,0,36,9
1746561222806,BIPN 120,A01,895135,Cooke; James Edward,0,3,13,13
1746561222806,BIPN 120,A02,895136,Cooke; James Edward,0,1,13,13
1746561222806,BIPN 120,A03,895137,Cooke; James Edward,0,3,13,13
1746561222806,BIPN 120,A04,895156,Cooke; James Edward,0,2,11,11
1746561223833,BIPN 134,A01,895235,Cooke; James Edward,0,2,25,25
1746561223833,BIPN 134,A02,895237,Cooke; James Edward,0,0,25,25
1746561223833,BIPN 134,A03,895240,Cooke; James Edward,3,0,25,22
1746561223833,BIPN 134,A04,895270,Cooke; James Edward,20,0,25,5
1746561224861,BIPN 189,A00,892103,Staff,0,13,14,14
1746561226914,BISP 194,A00,958008,Staff,0,2,0,0
1746561227941,CAT 124,A01,922009,Staff,0,5,20,20
1746561228975,CAT 125R,A00,886390,Morales; Celeste Georgianna,0,2,20,20
1746561228975,CAT 125R,B00,886391,Irwin; Matthew Joseph,0,3,20,20
1746561228975,CAT 125R,C00,886392,Smith; Lauryn Alissa,0,2,20,20
1746561228975,CAT 125R,D00,886393,Vanderschuit; Maya Alysia,0,2,20,20
1746561228975,CAT 125R,E00,886394,Marchisotto; Jennifer Anne,0,4,20,20
1746561230002,CENG 15,A01,886218,Drews; Aaron,3,0,8,5
1746561231028,CENG 113,A00,886219,Opatkiewicz; Justin Paul,15,0,25,10
1746561232052,CGS 101,A00,887044,Staff,7,0,20,13
1746561233077,CGS 105,A01,887046,Staff,14,0,25,11
1746561234105,CGS 112,A00,887047,Cuong; Marisol,12,0,15,3
1746561235132,CGS 113,A00,887048,Staff,23,0,30,7
1746561236159,CGS 120,A00,887049,Staff,10,0,17,7
1746561237188,CHEM 6A,A01,886336,Lam; Tin Yiu,38,0,50,12
1746561237188,CHEM 6A,A02,886338,Lam; Tin Yiu,37,0,50,13
1746561238213,CHEM 6B,A01,886341,Hopkins; Patrycja Anna,16,0,50,34
1746561238213,CHEM 6B,A02,886343,Hopkins; Patrycja Anna,42,0,50,8
1746561239237,CHEM 6C,A01,886346,Albizati; Kim F.,0,2,50,50
1746561239237,CHEM 6C,A02,886348,Albizati; Kim F.,23,0,50,27
1746561240265,CHEM 40A,A01,886352,Klosterman; Jeremy K,65,0,100,35
1746561241290,CHEM 40B,A01,886356,Klosterman; Jeremy K,0,23,100,100
1746561242315,CHEM 41B,A01,886360,Theodorakis; Emmanuel,25,0,50,25
1746561242315,CHEM 41B,A02,886362,Theodorakis; Emmanuel,47,0,50,3
1746561243343,CHIN 165A,A00,886382,Xu; Li,18,0,20,2
1746561244370,CLAS 120,A00,886387,Myerston Santana; Jacobo,33,0,40,7
1746561245395,COGS 9,A01,886967,Shannon; Kyle Michael,42,0,60,18
1746561246421,COGS 11,A01,886969,Staff,10,0,30,20
1746561247444,COGS 14A,A01,886971,Staff,6,0,60,54
1746561248468,COGS 14B,A01,886973,Hoffman; Drew Ellen,4,0,60,56
1746561249494,COGS 18,A01,886975,Morgan; Eric,35,0,60,25
1746561250519,COGS 20,A01,886977,Staff,4,0,8,4
1746561250519,COGS 20,A02,886978,Staff,5,0,7,2
1746561251545,COGS 100,A01,907783,Staff,0,2,30,30
1746561252573,COGS 101B,A01,886980,Staff,0,3,48,48
1746561253598,COGS 101C,A01,886982,Delgado; Tania,0,5,44,44
1746561254624,COGS 102A,A01,886984,Johnson; Christine M.,4,0,30,26
1746561255651,COGS 118B,A01,886986,Staff,0,3,88,88
1746561256677,COGS 150,A01,886988,Bergen; Benjamin,22,0,50,28
1746561257701,COGS 153,A00,886989,Delgado; Tania,0,2,41,41
1746561258729,COGS 186,A01,886991,Staff,0,0,32,32
1746561259753,COGS 187A,A01,886993,Boyle; Mary E. T.,7,0,30,23
1746561260780,COGS 189,A00,886994,Staff,0,1,30,30
1746561261806,COMM 10,A01,886996,Staff,0,0,20,21
1746561261806,COMM 10,A02,886997,Staff,12,0,20,8
1746561261806,COMM 10,A03,959845,Staff,19,0,20,1
1746561262834,COMM 20,A01,886999,Leuning; Grant Maurstad,24,0,40,16
1746561264885,COMM 100A,A01,887002,Staff,0,0,20,25
1746561264885,COMM 100A,A02,887003,Staff,7,0,20,13
1746561265910,COMM 100B,A01,887005,Staff,0,8,20,24
1746561266935,COMM 106D,A00,887006,Staff,14,0,40,26
1746561267964,COMM 110G,A00,887007,Whitworth-Smith; Andrew C,12,0,40,28
1746561268988,COMM 111B,A00,887008,Staff,31,0,40,9
1746561270012,COMM 113T,A00,887009,Abuelhiga; Soraya Jill,28,0,40,12
1746561270012,COMM 113T,B00,906733,Staff,40,0,40,0
1746561271036,COMM 145,A00,887010,Staff,12,0,40,28
1746561272061,COMM 146,A00,887054,Staff,31,0,40,9
1746561273087,COMM 190,A00,887012,Staff,8,0,23,15
1746561274116,CSE 8A,A50,887015,Cao; Yingjun,57,0,85,28
1746561275144,CSE 11,A01,887017,Cao; Yingjun,12,0,70,58
1746561276172,CSE 20,A01,887019,Staff,30,0,50,20
1746561277203,CSE 21,A01,887021,Staff,78,0,100,22
1746561277203,CSE 21,B01,892583,Braun; Oliver,45,0,50,5
1746561278228,CSE 30,A01,887025,Eldon; John,143,0,200,57
1746561279252,CSE 100,A01,887027,Staff,26,0,50,24
1746561279252,CSE 100,A02,887028,Staff,42,0,50,8
1746561280278,CSE 101,A01,887030,Braun; Oliver,74,0,100,26
1746561280278,CSE 101,B01,887032,Jones; Miles E,0,3,50,50
1746561280278,CSE 101,B02,887033,Jones; Miles E,0,2,50,50
1746561281304,CSE 105,A01,908084,Jones; Miles E,32,0,50,18
1746561281304,CSE 105,A02,908087,Jones; Miles E,32,0,50,18
1746561282329,CSE 135,A01,887035,Powell; Thomas Allan,0,4,50,50
1746561283353,CSE 142,A01,887037,Staff,8,0,60,52
1746561284378,CSE 142L,A01,887039,Staff,34,0,60,26
1746561285403,CSE 151A,A01,887041,Solares; Edwin A,47,0,100,53
1746561286427,CSE 175,A01,887043,Kumar; Rakesh,30,0,30,0
1746561287452,CSS 1,A01,886389,Staff,1,1,40,39
1746561288481,DSC 30,A01,908097,Liao; Soohyun Nam,47,0,75,28
1746561289504,DSC 40A,A01,908099,Shannon; Kyle Michael,30,0,50,20
1746561290531,DSC 40B,A01,908112,Staff,16,0,50,34
1746561291555,DSC 80,A01,908116,Staff,19,0,60,41
1746561292579,DSC 197,001,956863,Eldridge; Justin Matthew,9999,0,9999,0
1746561293607,ECE 5,A01,886400,Morris; Karcher William,2,0,6,4
1746561293607,ECE 5,A02,886401,Morris; Karcher William,3,0,6,3
1746561294634,ECE 148,A01,886403,Silberman; Jack,0,14,14,14
1746561295659,ECON 1,A01,887265,Crane; Meredith Helen,12,0,70,58
1746561295659,ECON 1,B01,887268,Staff,43,0,50,7
1746561296682,ECON 2,A01,887273,Crane; Meredith Helen,55,0,70,15
1746561297705,ECON 3,A01,887279,Rondina; Giacomo,32,0,70,38
1746561298734,ECON 4,A01,887282,Anderson; John Charles,0,2,10,10
1746561299759,ECON 5,A01,887285,Staff,34,0,45,11
1746561299759,ECON 5,B01,887292,Staff,41,0,45,4
1746561300786,ECON 100A,A01,887337,Newhouse; Herbert S,54,0,70,16
1746561300786,ECON 100A,B01,887349,Staff,45,0,50,5
1746561301814,ECON 100B,A01,887361,Du; Songzi,29,0,70,41
1746561302840,ECON 100C,A01,887445,Newhouse; Herbert S,59,0,70,11
1746561303864,ECON 105,A00,887488,Vespa; Emanuel Ignacio,23,0,35,12
1746561304888,ECON 109,A01,887506,Shishkin; Denis,28,0,35,7
1746561305914,ECON 110A,A01,887568,Alon; Titan Michael,0,3,35,35
1746561305914,ECON 110A,B01,907601,Alon; Titan Michael,20,0,35,15
1746561306940,ECON 110B,A01,887598,Levkoff; Steven B.,0,24,70,70
1746561307967,ECON 112,A00,887599,Rondina; Giacomo,19,0,35,16
1746561308991,ECON 120A,A01,887603,Dai; Yinlin,35,0,70,35
1746561310017,ECON 120C,A01,887608,Sun; Yixiao,0,1,35,35
1746561310017,ECON 120C,B01,887614,Sun; Yixiao,0,0,35,35
1746561311043,ECON 138,A00,887621,Bharadwaj; Prashant,0,21,20,20
1746561312068,ECON 144,A00,958007,Squires; Dale E,13,0,35,22
1746561313094,ECON 171,A01,907666,Staff,18,0,35,17
1746561314121,ECON 175,A00,887626,Wu; Pak Yeung,23,0,35,12
1746561315146,ECON 190,A00,887640,Vespa; Emanuel Ignacio,23,0,35,12
1746561316174,EDS 25,A01,888197,Staff,0,0,0,0
1746561316174,EDS 25,A02,888209,Staff,0,0,0,0
1746561316174,EDS 25,A03,888210,Staff,0,0,0,0
1746561316174,EDS 25,A04,888212,Staff,0,0,0,0
1746561316174,EDS 25,A05,888213,Staff,0,0,0,0
1746561316174,EDS 25,A06,888214,Staff,0,0,0,0
1746561316174,EDS 25,A07,888235,Staff,0,2,0,0
1746561316174,EDS 25,A08,888236,Staff,0,0,0,0
1746561316174,EDS 25,A09,888240,Staff,0,0,0,0
1746561316174,EDS 25,A10,888244,Staff,0,0,0,0
1746561316174,EDS 25,B01,888273,Staff,0,0,0,0
1746561316174,EDS 25,B02,888285,Staff,0,0,0,0
1746561316174,EDS 25,B03,888423,Staff,0,0,0,1
1746561316174,EDS 25,B04,888432,Staff,0,0,0,0
1746561316174,EDS 25,B05,888433,Staff,0,0,0,0
1746561316174,EDS 25,B06,888467,Staff,0,0,0,0
1746561316174,EDS 25,B07,888468,Staff,0,0,0,0
1746561316174,EDS 25,B08,888479,Staff,0,0,0,0
1746561316174,EDS 25,B09,888484,Staff,0,0,0,0
1746561316174,EDS 25,B10,888487,Staff,0,0,0,0
1746561317223,EDS 38,A01,907700,Choi; Bailey Miyeon,30,0,30,0
1746561318249,EDS 112,A01,888601,Chapman; Thandeka K,13,0,40,27
1746561319273,EDS 115,A00,888697,Mendez; Kathrina Mendoza,10,0,30,20
1746561320299,EDS 116,A01,888893,Staff,35,0,40,5
1746561322352,EDS 124AR,A00,889133,Staff,29,0,50,21
1746561322352,EDS 124AR,B00,907471,Simon; Elizabeth A,37,0,50,13
1746561323376,EDS 124BR,A00,889134,Simon; Elizabeth A,44,0,100,56
1746561324403,EDS 125,A00,889135,Staff,25,0,30,5
1746561325638,EDS 126,A01,889138,Staff,36,0,40,4
1746561326666,EDS 164R,A01,889142,Wishard Guerra; Alison G.,33,0,50,17
1746561327692,ENG 30,A01,886396,Staff,0,0,0,0
1746561327692,ENG 30,B01,886398,Staff,0,0,0,0
1746561328718,ENVR 102,A00,906150,Montejo; Carolina,23,0,25,2
1746561329741,ETHN 103A,A00,887236,Man; Simeon S,0,3,0,0
1746561330768,ETHN 113,A00,887239,Staff,16,0,30,14
1746561331798,ETHN 116,A00,887240,Staff,16,0,25,9
1746561332823,ETHN 117,A00,887241,Choi; Esther Min,28,0,30,2
1746561333848,ETHN 118,A00,887243,Staff,24,0,30,6
1746561334875,ETHN 127,A00,887248,Cuong; Marisol,11,0,15,4
1746561335902,ETHN 139,A00,887250,Staff,7,0,10,3
1746561336929,ETHN 142,A00,887252,Staff,10,0,30,20
1746561337953,ETHN 161,A00,887253,Browne; Errol Tsekani,24,0,30,6
1746561338980,ETHN 163FR,A00,887255,Burelle; Julie Sara Veronique,0,0,5,5
1746561340005,GLBH 20,A00,889149,Elwardani; Nile Regina,8,0,42,34
1746561342054,GLBH 111,A01,889152,Burgos; Jose L.,17,0,17,0
1746561343080,GLBH 150,A00,889181,Sloane; Julia Kathryn,0,5,15,15
1746561345133,HDS 60,A01,886406,Warstadt; Melissa Fawn,73,0,80,7
1746561346159,HIAF 111,A00,889324,Gyamfi; Bright,25,0,32,7
1746561347182,HIEA 131,A00,889328,Staff,15,0,32,17
1746561348209,HIEA 144,A00,889333,Henry; Todd A.,26,0,32,6
1746561349235,HIEA 154,A00,889336,Henry; Todd A.,24,0,32,8
1746561350259,HIEU 106,A00,889339,Staff,22,0,32,10
1746561352317,HIEU 114,A00,889340,Staff,3,0,32,29
1746561353344,HIEU 135GS,A00,889342,Patterson; Patrick H.,0,0,1,24
1746561354368,HIEU 137,A00,889343,Edington; Claire Ellen,9,0,25,16
1746561355393,HIEU 148,A00,889345,Staff,14,0,32,18
1746561356418,HIEU 154,A00,889346,Biess; Frank Peter,21,0,32,11
1746561357443,HILA 102,A00,889351,Staff,12,0,32,20
1746561358470,HILD 2A,A01,889221,Lewandoski; Julia Mavis,1,10,32,31
1746561359497,HILD 7B,A01,889225,Man; Simeon S,0,12,32,32
1746561360524,HILD 7C,A01,889288,Alvarez; Luis A,0,14,32,32
1746561361550,HILD 30,A01,889323,Staff,0,5,32,32
1746561363599,HISC 119,A00,889383,Golan; Tal,20,0,32,12
1746561364652,HIUS 103,A00,889384,Man; Simeon S,0,0,32,32
1746561365682,HIUS 117,A00,919797,Kwak; Nancy,18,0,32,14
1746561366705,HIUS 142A,A00,919788,Staff,22,0,32,10
1746561368756,HIUS 149,A00,889386,Gyamfi; Bright,27,0,32,5
1746561369782,HIUS 155,A00,889387,Alvarez; Luis A,14,0,32,18
1746561370810,HUM 3,A01,886499,Caldwell; Michael Alan,19,0,50,31
1746561371836,HUM 3GS,A00,886500,Rodriguez; Bretton Sigfred,0,0,0,28
1746561372863,HUM 3R,A01,886502,Markman; Kristina,0,36,50,50
1746561373890,HUM 4,A01,886504,Crum; Matthew Stephen,24,0,50,26
1746561373890,HUM 4,B01,886506,West; Geoffrey Scott,17,0,50,33
1746561374915,HUM 4GS,A00,886507,Staff,0,0,0,19
1746561375942,HUM 5,A01,886509,Staff,32,0,50,18
1746561376970,HUM 5R,A01,886511,Zavodny; Tatiana Sophia,0,39,50,50
1746561377994,JAPN 180,A00,886407,Staff,17,0,40,23
1746561379018,LATI 50,A01,886409,Martin-Cabrera; Luis,4,0,22,18
1746561379018,LATI 50,A02,886410,Martin-Cabrera; Luis,19,0,22,3
1746561379018,LATI 50,A03,886411,Martin-Cabrera; Luis,21,0,22,1
1746561379018,LATI 50,A04,886412,Martin-Cabrera; Luis,9,0,22,13
1746561380044,LAWS 101,A00,907664,Staff,28,0,60,32
1746561381068,LIAB 1A,A00,889388,Saab; Dima,17,0,20,3
1746561382094,LIAB 1AX,A00,889389,El Cheddadi; Youniss,18,0,20,2
1746561383141,LIFR 1C,A00,889391,Van Moer; Vinciane G,8,0,20,12
1746561384167,LIFR 1CX,A00,889392,Van Moer; Vinciane G,7,0,20,13
1746561385192,LIFR 1D,A00,889393,Van Moer; Vinciane G,7,0,20,13
1746561386219,LIFR 1DX,A00,889394,Van Moer; Vinciane G,8,0,20,12
1746561387244,LIGN 7,A00,886923,Staff,24,0,50,26
1746561388268,LIGN 17,A00,886924,Kehler; Andrew Scott,125,0,150,25
1746561389307,LTAM 110,A00,889395,Staff,15,0,30,15
1746561390332,LTAM 110GS,A00,958010,Rodriguez; Bretton Sigfred,0,0,0,28
1746561391360,LTCH 101,A00,889397,Staff,23,0,25,2
1746561392387,LTCS 130,A00,889398,Staff,23,0,25,2
1746561393415,LTEA 138,A00,889399,Staff,24,0,40,16
1746561394438,LTEN 149,A00,889400,Wesling; Megan E.,0,3,25,25
1746561395465,LTEN 169,A00,889401,Staff,20,0,25,5
1746561396492,LTEN 180,A00,889402,Staff,10,0,15,5
1746561397516,LTEN 181,A00,889403,Staff,21,0,25,4
1746561398540,LTWL 100,A00,889404,Myerston Santana; Jacobo,2,0,25,23
1746561399566,LTWL 180GS,A00,889405,Staff,0,0,20,20
1746561400590,LTWL 181,A00,889406,Staff,16,0,25,9
1746561401616,LTWL 184,A00,889475,Mukherjee; Silpa,22,0,25,3
1746561402642,LTWR 102C,A00,889486,Staff,30,0,30,0
1746561403666,LTWR 115W,A00,889491,Staff,0,2,15,15
1746561404694,MAE 8,A01,886905,Staff,0,2,0,0
1746561405721,MAE 11,A00,886906,Bandaru; Prabhakar,0,7,50,50
1746561406746,MAE 20,A00,886907,Evdokimenko; Ekaterina,43,0,70,27
1746561407771,MAE 30B,A00,886909,Ghazinejad; Maziar,26,0,45,19
1746561408794,MAE 101B,A00,886910,Saintillan; David,29,0,45,16
1746561409820,MAE 105,A00,886911,Bandaru; Prabhakar,18,0,50,32
1746561410846,MAE 107,B00,958024,Staff,8,0,50,42
1746561411870,MAE 143B,A00,886913,Bewley; Thomas R,6,0,40,34
1746561412898,MAE 148,A01,886915,Silberman; Jack,0,3,14,14
1746561413922,MAE 160,A00,886916,Evdokimenko; Ekaterina,32,0,60,28
1746561414945,MATH 3C,A01,889681,Staff,0,2,30,30
1746561414945,MATH 3C,A02,960048,Staff,24,0,30,6
1746561415970,MATH 10A,A01,889760,Staff,26,0,30,4
1746561415970,MATH 10A,A02,889783,Staff,29,0,30,1
1746561416997,MATH 10B,A01,889785,Verstraete; Jacques Allan,2,0,35,33
1746561416997,MATH 10B,A02,889795,Verstraete; Jacques Allan,4,0,35,31
1746561416997,MATH 10B,B01,889797,Verstraete; Jacques Allan,3,0,35,32
1746561416997,MATH 10B,B02,889828,Verstraete; Jacques Allan,3,0,35,32
1746561418024,MATH 10C,A01,889849,Habib; Yousaf,8,0,30,22
1746561418024,MATH 10C,A02,889852,Habib; Yousaf,14,0,30,16
1746561418024,MATH 10C,A03,889853,Habib; Yousaf,22,0,30,8
1746561418024,MATH 10C,A04,889858,Habib; Yousaf,20,0,30,10
1746561418024,MATH 10C,B01,889861,Staff,1,0,30,29
1746561418024,MATH 10C,B02,889862,Staff,24,0,30,6
1746561418024,MATH 10C,B03,889863,Staff,27,0,30,3
1746561418024,MATH 10C,B04,889967,Staff,23,0,30,7
1746561419056,MATH 18,A01,889974,Staff,7,0,30,23
1746561419056,MATH 18,A02,889977,Staff,20,0,30,10
1746561419056,MATH 18,B01,889984,Hardiman; Liam,21,0,30,9
1746561419056,MATH 18,B02,889985,Hardiman; Liam,25,0,30,5
1746561420085,MATH 20A,A01,889990,Suk; Andrew Hoon,30,0,35,5
1746561421115,MATH 20B,A01,889993,Ohm; Ko Woon,22,0,30,8
1746561421115,MATH 20B,A02,889994,Ohm; Ko Woon,30,0,30,0
1746561421115,MATH 20B,B01,889996,Ohm; Ko Woon,21,0,30,9
1746561421115,MATH 20B,B02,889997,Ohm; Ko Woon,23,0,30,7
1746561422147,MATH 20C,A01,889999,Hammock; Frances H,17,0,30,13
1746561422147,MATH 20C,A02,890003,Hammock; Frances H,23,0,30,7
1746561422147,MATH 20C,B01,890006,Hammock; Frances H,3,0,30,27
1746561422147,MATH 20C,B02,890007,Hammock; Frances H,11,0,30,19
1746561423173,MATH 20D,A01,890011,Cheng; Hsiao-Bing,1,1,30,29
1746561423173,MATH 20D,A02,890012,Cheng; Hsiao-Bing,14,0,30,16
1746561423173,MATH 20D,B01,890016,Cheng; Hsiao-Bing,13,0,30,17
1746561423173,MATH 20D,B02,890017,Cheng; Hsiao-Bing,13,0,30,17
1746561424202,MATH 20E,A01,890026,Harel; Guershon,1,0,30,29
1746561424202,MATH 20E,A02,890029,Harel; Guershon,23,0,30,7
1746561424202,MATH 20E,B01,890033,Harel; Guershon,7,0,30,23
1746561424202,MATH 20E,B02,890101,Harel; Guershon,21,0,30,9
1746561425230,MATH 102,A01,890104,Staff,17,0,30,13
1746561425230,MATH 102,A02,890105,Staff,27,0,30,3
1746561426255,MATH 103B,A01,890116,Salehi Golsefidy; Alireza,3,0,30,27
1746561426255,MATH 103B,B01,890118,Staff,0,3,34,34
1746561427280,MATH 109,A01,890121,Aliabadi Sr.; Mohsen,1,0,30,29
1746561427280,MATH 109,B01,890124,Upadrashta; Pranav Kumar,18,0,30,12
1746561428308,MATH 120A,A01,890126,Eggers; John Dietrich,13,0,30,17
1746561429335,MATH 142B,A01,890128,Ioana; Adrian,19,0,30,11
1746561429335,MATH 142B,A02,890129,Ioana; Adrian,13,0,30,17
1746561430359,MATH 154,A01,890174,Staff,0,0,30,30
1746561430359,MATH 154,A02,890182,Staff,0,0,30,30
1746561431388,MATH 168A,A01,890197,Dumitriu; Ioana,21,0,35,14
1746561432422,MATH 170A,A01,890240,Nie; Jiawang,1,0,30,29
1746561432422,MATH 170A,A02,890241,Nie; Jiawang,11,0,30,19
1746561432422,MATH 170A,A03,890249,Nie; Jiawang,23,0,30,7
1746561433447,MATH 170B,A01,957891,Nag; Panchali,13,0,35,22
1746561435501,MATH 181A,A01,908025,Staff,0,4,35,35
1746561435501,MATH 181A,A02,960115,Staff,27,0,35,8
1746561436527,MATH 181B,A01,959874,Staff,25,0,30,5
1746561437550,MATH 193B,A01,890265,Staff,0,4,35,35
1746561438575,MGT 4,A01,890311,Anderson; John Charles,42,0,88,46
1746561439604,MGT 5,A00,907740,Staff,13,0,98,85
1746561440630,MGT 12,A00,890312,Lindenberger; Wade Douglas,67,0,98,31
1746561441654,MGT 16,A00,957883,Staff,78,0,98,20
1746561443702,MGT 45,A00,890314,Pecore; Joseph P.,46,0,98,52
1746561444728,MGT 71,A00,890315,Staff,0,11,98,98
1746561445755,MGT 100,A00,890316,Yavorsky; Daniel Ryan,44,0,98,54
1746561446783,MGT 103,A00,890317,Ehrich; Kristine R,73,0,98,25
1746561447809,MGT 105,A00,890356,Bates; Kenneth Walter,0,8,98,98
1746561448836,MGT 112,A00,890360,Ehrich; Kristine R,55,0,98,43
1746561449860,MGT 127R,A00,907732,Zhu; Kevin Xiaoguo,23,0,98,75
1746561450886,MGT 131B,A00,890361,Anderson; John Charles,60,0,98,38
1746561451913,MGT 137,A00,890362,Lindenberger; Wade Douglas,65,0,98,33
1746561452940,MGT 160,A00,890369,Johnson; Erik Barry,9,0,98,89
1746561454995,MGT 164,A00,890372,Zimmermann; Carsten,0,40,98,98
1746561456020,MGT 180,A00,890374,Bliss; Barbara Ann,12,0,98,86
1746561457059,MMW 15,A01,886414,Chang; Edmond Yi-Teh,0,12,28,28
1746561457059,MMW 15,A02,886415,Chang; Edmond Yi-Teh,0,8,28,28
1746561457059,MMW 15,A03,886416,Chang; Edmond Yi-Teh,0,8,28,28
1746561457059,MMW 15,A04,886417,Chang; Edmond Yi-Teh,0,8,28,28
1746561457059,MMW 15,B01,886419,Chang; Edmond Yi-Teh,0,7,28,28
1746561457059,MMW 15,B02,886420,Chang; Edmond Yi-Teh,0,8,28,28
1746561457059,MMW 15,B03,886421,Chang; Edmond Yi-Teh,0,7,28,28
1746561457059,MMW 15,B04,886422,Chang; Edmond Yi-Teh,0,8,28,28
1746561457059,MMW 15,C01,886424,Staff,0,9,28,28
1746561457059,MMW 15,C02,886425,Staff,0,8,28,28
1746561457059,MMW 15,C03,886426,Staff,0,8,28,28
1746561457059,MMW 15,C04,886427,Staff,0,8,28,28
1746561457059,MMW 15,C05,958038,Staff,0,8,28,28
1746561457059,MMW 15,C06,958039,Staff,0,8,28,28
1746561458086,MMW 15GS,A00,906910,Patterson; Patrick H.,4,0,28,24
1746561459109,MMW 122R,A01,886429,Rahimi; Babak,0,13,28,28
1746561459109,MMW 122R,A02,886430,Rahimi; Babak,0,12,28,28
1746561459109,MMW 122R,A03,958040,Rahimi; Babak,0,11,28,28
1746561460135,MUS 1A,A01,890937,Staff,2,0,25,23
1746561460135,MUS 1A,A02,891035,Staff,6,0,25,19
1746561460135,MUS 1A,C01,958912,Staff,24,0,25,1
1746561460135,MUS 1A,C02,958913,Staff,25,0,25,0
1746561462184,MUS 2AK,A00,957092,Ohnishi; Takae,15,0,15,0
1746561463209,MUS 4,A01,891044,Staff,2,0,25,23
1746561463209,MUS 4,A02,891045,Staff,23,0,25,2
1746561463209,MUS 4,B01,891048,Staff,17,0,25,8
1746561463209,MUS 4,B02,891050,Staff,25,0,25,0
1746561464233,MUS 5,A01,957506,Dubnov; Shlomo,0,0,25,25
1746561464233,MUS 5,A02,957622,Dubnov; Shlomo,13,0,25,12
1746561464233,MUS 5,A03,957623,Dubnov; Shlomo,20,0,25,5
1746561465257,MUS 6,A01,891053,Freitas Caetano; Marcelo,24,0,25,1
1746561465257,MUS 6,A02,891054,Freitas Caetano; Marcelo,23,0,25,2
1746561466280,MUS 7,A01,891081,Staff,0,0,25,25
1746561466280,MUS 7,A02,891082,Staff,4,0,25,21
1746561467305,MUS 8GS,A00,891118,Borgo; David Garcia,0,0,25,25
1746561468329,MUS 11,A01,891140,Staff,10,0,25,15
1746561468329,MUS 11,A02,891141,Staff,22,0,25,3
1746561469370,MUS 13,A01,891143,Staff,8,0,25,17
1746561469370,MUS 13,A02,891144,Staff,24,0,25,1
1746561470395,MUS 15,A01,891146,Staff,9,0,25,16
1746561470395,MUS 15,A02,891148,Staff,21,0,25,4
1746561470395,MUS 15,B01,891150,Staff,18,0,25,7
1746561470395,MUS 15,B02,891151,Staff,25,0,25,0
1746561471419,MUS 20,A01,891153,Staff,5,0,20,15
1746561471419,MUS 20,A02,891155,Staff,14,0,20,6
1746561472443,MUS 80,A00,891156,Staff,19,0,25,6
1746561472443,MUS 80,B00,891157,Staff,23,0,25,2
1746561473468,MUS 130,A00,891158,Ohnishi; Takae,35,0,35,0
1746561474495,MUS 150GS,A01,891160,Borgo; David Garcia,0,0,25,25
1746561475523,MUS 170,A01,891162,Freitas Caetano; Marcelo,20,0,25,5
1746561475523,MUS 170,A02,891164,Freitas Caetano; Marcelo,21,0,25,4
1746561476550,NANO 11,A00,886220,Vazquez Mena; Oscar,13,0,15,2
1746561477579,NANO 15,A01,886222,Drews; Aaron,4,0,7,3
1746561478605,NANO 104,A00,886224,Sirbuly; Donald,18,0,25,7
1746561479632,PH 40,A00,886528,Staff,23,0,40,17
1746561480657,PH 45,A01,886799,Staff,35,0,40,5
1746561481685,PH 110,A00,886802,Staff,0,7,40,40
1746561482711,PH 172,A00,906716,Staff,19,0,35,16
1746561483737,PH 191,A00,886803,Staff,6,0,40,34
1746561484765,PHIL 1,A00,889500,Staff,20,0,30,10
1746561485793,PHIL 10,A01,889549,Grush; Rick Scott,15,0,22,7
1746561485793,PHIL 10,A02,889551,Grush; Rick Scott,22,0,22,0
1746561486819,PHIL 28,A01,889559,Lamey; Andy M.,0,1,31,31
1746561486819,PHIL 28,A02,889561,Lamey; Andy M.,0,1,30,30
1746561486819,PHIL 28,A03,889572,Lamey; Andy M.,0,1,30,30
1746561487842,PHIL 35,A00,907839,Staff,13,0,15,2
1746561488866,PHIL 60,A00,889574,Staff,73,0,90,17
1746561489895,PHIL 101,A00,958004,Staff,12,0,15,3
1746561491947,PHIL 136,A00,889582,Fulkerson; Matthew Todd,26,0,45,19
1746561492972,PHIL 163,A01,889601,Staff,21,0,30,9
1746561492972,PHIL 163,B01,889606,Brandt; Reuven A,0,3,0,0
1746561494000,PHIL 164,A00,889610,Staff,16,0,30,14
1746561495029,PHIL 165,A00,889613,Staff,23,0,30,7
1746561496053,PHYS 1A,A00,886431,Staff,26,0,70,44
1746561497080,PHYS 1AL,001,886432,Tsai; Philbert S,0,2,30,30
1746561497080,PHYS 1AL,002,886436,Tsai; Philbert S,11,0,30,19
1746561498105,PHYS 1B,A00,886439,Staff,185,0,240,55
1746561499131,PHYS 1BL,001,886441,Tsai; Philbert S,0,4,30,30
1746561499131,PHYS 1BL,002,886444,Tsai; Philbert S,2,0,30,28
1746561500156,PHYS 1C,A00,896092,Arnold; Kam S,79,0,146,67
1746561501186,PHYS 1CL,001,886448,Tsai; Philbert S,0,0,30,30
1746561501186,PHYS 1CL,002,886449,Tsai; Philbert S,1,0,30,29
1746561501186,PHYS 1CL,003,886450,Tsai; Philbert S,16,0,30,14
1746561501186,PHYS 1CL,004,886451,Tsai; Philbert S,15,0,30,15
1746561502210,PHYS 2B,A01,886457,Staff,68,0,115,47
1746561503241,PHYS 2C,A01,886460,Shotwell; Brian,0,9,65,65
1746561504269,PHYS 2CL,A01,886467,Staff,0,4,28,28
1746561504269,PHYS 2CL,A02,886468,Staff,0,3,28,28
1746561505293,PHYS 2D,A01,886470,Staff,10,0,50,40
1746561506317,PHYS 4B,A01,886475,Grinstein; Benjamin,22,0,40,18
1746561507342,POLI 5,A00,891173,Desposato; Scott,7,0,25,18
1746561508366,POLI 5D,A01,891175,Staff,5,0,5,0
1746561508366,POLI 5D,B01,891178,Staff,5,0,5,0
1746561509393,POLI 11,A00,891179,Ferree; Karen E,2,0,35,33
1746561510418,POLI 12,A00,891180,Staff,16,0,30,14
1746561511445,POLI 27,A01,891182,Staff,12,0,75,63
1746561512473,POLI 30,A00,891183,Staff,8,0,50,42
1746561513504,POLI 100B,A00,891244,Staff,5,1,35,30
1746561514530,POLI 100I,A00,891247,Staff,7,0,30,23
1746561515559,POLI 104J,A00,891248,Nichter; Maysa,14,0,30,16
1746561516585,POLI 104U,A00,891250,Nichter; Maysa,2,0,30,28
1746561518637,POLI 110B,A00,891255,Wiens; David,20,0,25,5
1746561519664,POLI 112A,A00,891256,Wiens; David,6,0,25,19
1746561520691,POLI 114BR,A00,891261,Staff,19,0,30,11
1746561521716,POLI 117R,A00,891262,Forman; Fonna,0,6,50,50
1746561522742,POLI 118,A00,891264,Ingham; Sean,17,0,25,8
1746561523768,POLI 124A,A00,891265,Staff,18,0,20,2
1746561524793,POLI 125D,A00,891266,Nichter; Simeon C,2,0,25,23
1746561525819,POLI 126,A00,891268,Nichter; Simeon C,7,0,25,18
1746561526846,POLI 126AA,A00,891272,Staff,17,0,25,8
1746561527872,POLI 130AA,A00,891273,Staff,15,0,20,5
1746561528897,POLI 134AA,A00,891274,Staff,4,0,20,16
1746561530950,POLI 138,A00,891278,Staff,21,0,25,4
1746561531974,POLI 142K,A00,891280,Staff,11,0,25,14
1746561533000,POLI 142M,A00,891281,Gartzke; Erik,17,0,30,13
1746561534025,POLI 142P,A00,891284,Staff,20,0,30,10
1746561535054,POLI 143,A00,891285,Gartzke; Erik,12,0,30,18
1746561536079,POLI 153,A00,891286,Staff,19,0,20,1
1746561538131,POLI 175,A00,891290,Staff,15,0,20,5
1746561539160,PSYC 1,A00,890674,Steiner; Eric Tomas,0,11,45,45
1746561540185,PSYC 2,A00,890676,Albright; Thomas D,21,0,35,14
1746561541210,PSYC 3,A00,890679,Staff,17,0,20,3
1746561542238,PSYC 6,A00,959858,Staff,20,0,20,0
1746561543264,PSYC 60,A01,890684,Rickard; Timothy C.,0,5,45,45
1746561544291,PSYC 70,A01,890689,Geller; Emma Harlan,7,0,30,23
1746561545315,PSYC 71,A01,959860,Staff,21,0,25,4
1746561546342,PSYC 100,A00,890690,Lacefield; Katharine I,0,50,180,180
1746561547367,PSYC 102,A00,890695,Staff,18,0,40,22
1746561548396,PSYC 105,A00,890699,Geller; Emma Harlan,70,0,100,30
1746561549425,PSYC 106,A00,890701,Gorman; Michael R.,6,0,30,24
1746561550452,PSYC 108,A00,890704,Adrian; Julia Anna,0,28,50,50
1746561551476,PSYC 118,A01,890712,Staff,11,0,30,19
1746561552502,PSYC 124,A00,890716,Chapman; Eddie Nathaniel,25,0,60,35
1746561553527,PSYC 131,A00,890717,Anagnostaras; Stephan,0,7,80,80
1746561554553,PSYC 137,A00,890719,Winkielman; Piotr,0,11,30,30
1746561555577,PSYC 144,A00,890721,Adrian; Julia Anna,0,9,45,45
1746561556602,PSYC 162,A00,890805,Staff,2,0,75,73
1746561557630,PSYC 169,A00,890810,Staff,0,14,30,30
1746561558655,PSYC 172,A00,890814,Gorman; Michael R.,9,0,30,21
1746561559679,PSYC 181,A00,890818,Anagnostaras; Stephan,9,0,200,191
1746561560743,PSYC 184,A00,959861,Staff,170,0,175,5
1746561561772,PSYC 189,A00,890823,Staff,0,1,30,30
1746561562796,PSYC 191,A00,890884,Rickard; Timothy C.,0,11,35,35
1746561563821,PSYC 193,A00,890913,Staff,19,0,30,11
1746561563821,PSYC 193,B00,890914,Chapman; Eddie Nathaniel,24,0,30,6
1746561564847,PSYC 193L,A01,890918,Lowe; Angela Beth,20,0,30,10
1746561564847,PSYC 193L,B01,890921,Hurwitz; Ethan Scott,20,0,30,10
1746561564847,PSYC 193L,C01,890928,Staff,30,0,30,0
1746561565875,RELI 149,A00,886806,Rahimi; Babak,23,0,40,17
1746561566906,SE 9,A01,886814,Staff,7,0,20,13
1746561567930,SE 101B,A01,886816,Chadha; Mayank,4,0,35,31
1746561568956,SE 110B,A00,886818,Zhu; Qiang,4,0,75,71
1746561569983,SE 125,A01,886830,Staff,10,0,30,20
1746561571009,SE 130B,A01,886835,Staff,14,0,40,26
1746561572037,SE 131A,A01,886838,Krysl; Petr,34,0,55,21
1746561573068,SE 154,A00,886840,Staff,29,0,50,21
1746561574093,SE 164GS,A01,886849,Staff,6,0,20,14
1746561575119,SE 167GS,A01,886853,Staff,6,0,20,14
1746561576143,SIO 25,A01,890107,Staff,19,0,30,11
1746561577172,SIO 45,A00,890109,Cook; Geoffrey W,117,0,200,83
1746561578199,SIO 109R,A00,890110,Forman; Fonna,0,16,20,20
1746561579226,SIO 187,A01,890114,Kacev; David,15,0,40,25
1746561580251,SOCI 1,A01,890431,Thorpe; Charles Robert,15,0,30,15
1746561580251,SOCI 1,A02,890518,Thorpe; Charles Robert,30,0,30,0
1746561581276,SOCI 2,A01,957978,Staff,25,0,25,0
1746561581276,SOCI 2,A02,957979,Staff,23,0,25,2
1746561582304,SOCI 20,A01,890523,Calderon-Zaks; Michael Aar,23,0,30,7
1746561582304,SOCI 20,A02,890526,Calderon-Zaks; Michael Aar,29,0,30,1
1746561583329,SOCI 30,A01,890533,Pardo Guerra; Juan Pablo,37,0,40,3
1746561584368,SOCI 40,A01,890535,Staff,27,0,45,18
1746561585395,SOCI 104Q,A00,890559,Staff,18,0,30,12
1746561586424,SOCI 106,A00,890560,Arnal; Maud Marie Leonie,20,0,30,10
1746561587451,SOCI 110,A00,890567,Holkenbrink-Monk; Charlene,19,0,30,11
1746561588479,SOCI 112,A00,890568,Victoria Torres; Pablo,2,0,55,53
1746561589505,SOCI 115,A00,890597,Arnal; Maud Marie Leonie,28,0,45,17
1746561591558,SOCI 121,A00,890604,Pardo Guerra; Juan Pablo,38,0,45,7
1746561592585,SOCI 126,A01,890608,Staff,8,0,10,2
1746561593614,SOCI 127,A00,890609,Staff,18,0,30,12
1746561594642,SOCI 131,A00,890610,Thorpe; Charles Robert,37,0,45,8
1746561595668,SOCI 135,A00,890615,Payne; Christine Anna,13,0,45,32
1746561596692,SOCI 139,A00,890620,Staff,38,0,45,7
1746561597717,SOCI 148E,A00,890622,Calderon-Zaks; Michael Aar,36,0,45,9
1746561598743,SOCI 150,A00,890623,Kohler; Kristopher M.,31,0,45,14
1746561599767,SOCI 157,A00,890625,Jules-Rosette; Bennetta W.,18,0,20,2
1746561600796,SOCI 160,A00,890627,Payne; Christine Anna,21,0,45,24
1746561601822,SYN 1,A00,886855,Fish; Gwendolyn Anne,0,0,0,0
1746561601822,SYN 1,B00,906086,Fish; Gwendolyn Anne,0,1,0,2
1746561602846,SYN 2R,A00,886860,Staff,0,17,15,15
1746561602846,SYN 2R,B00,906106,Atkinson; Arthur Laird,0,16,15,15
1746561603878,SYN 100,A01,886866,Browne; Emily,0,28,20,20
1746561603878,SYN 100,B01,906128,Rock; Martin,0,5,20,20
1746561603878,SYN 100,C01,906140,Deavenport; James Cary,0,3,20,20
1746561603878,SYN 100,D01,907816,Deavenport; James Cary,0,5,20,20
1746561604913,TDAC 1,A00,890286,Walsh; Kim C.,8,0,20,12
1746561605937,TDAC 101,A00,890296,Basso; Beatrice,15,0,20,5
1746561606965,TDDE 131,A00,890297,Staff,47,0,50,3
1746561607989,TDDM 1,A00,890287,Weinberg; Sadie,25,0,30,5
1746561609019,TDGE 11,A00,890288,Fulton; Julia,137,0,200,63
1746561609019,TDGE 11,B00,890289,Castro; Robert Jess,184,0,200,16
1746561610048,TDGE 25,B00,957359,Walsh; Kim C.,3,0,20,17
1746561611080,TDGE 40,A01,890292,Power; Jade Yukana,27,0,30,3
1746561612109,TDGE 124,A00,890298,Havis; Allan,0,1,50,50
1746561613134,TDGE 131R,A00,890299,Burelle; Julie Sara Veronique,15,0,42,27
1746561614159,TDHT 101,A00,890300,Staff,10,0,20,10
1746561615183,TDHT 109,A01,890302,Anderson; Mysia Anyse,31,0,40,9
1746561616211,TDMV 1,A00,890293,Arcidiacono; Kristin,18,0,30,12
1746561617238,TDMV 2,A00,890294,Weinberg; Sadie,23,0,30,7
1746561618263,TDMV 3,A00,957878,Arcidiacono; Kristin,28,0,30,2
1746561620317,TDMV 138,A00,890304,Jun; Grace Shin Hae,25,0,40,15
1746561621342,TDMV 140,A00,890305,Corrales; Joseph Bernales,25,0,30,5
1746561622371,TDMV 142,A00,890307,Caligagan; Tony,32,0,40,8
1746561623399,TDMV 144,A00,890308,Camaya; Michelle Ann,25,0,30,5
1746561624636,TDPW 1,A00,890295,Stein; Deborah Isobel,3,0,20,17
1746561625660,USP 2,A01,890272,Lerner; Amy M,6,0,20,14
1746561627090,USP 3,A01,890274,Staff,12,0,30,18
1746561628113,USP 15,A01,890276,Sun; Feiyang,16,0,30,14
1746561629138,USP 25,A00,890277,Shenkman; Michael Thomas,19,0,25,6
1746561630163,USP 138,A00,890278,Staff,14,0,25,11
1746561631189,USP 143,A00,890279,Staff,22,0,70,48
1746561632217,USP 144,A00,890280,Chowdhury; Muhammed Zohir,16,0,30,14
1746561633246,USP 150,A00,890281,Boomhower; Matthew Charles,4,0,30,26
1746561634274,USP 151,A00,890282,Staff,16,0,20,4
1746561635298,USP 162,A00,890283,Andrews; Abigail Leslie,16,0,20,4
1746561636325,USP 168,A00,920477,Kwak; Nancy,0,0,5,5
1746561637353,USP 181,A00,890284,Staff,3,0,20,17
1746561638377,USP 191A,A00,890285,Staff,12,0,20,8
1746561639402,VIS 101,A00,886512,Staff,26,0,75,49
1746561640427,VIS 103,A00,886513,Cruz; Edwin Teddy,61,0,75,14
1746561641452,VIS 108,A00,886514,Staff,3,0,15,12
1746561642479,VIS 127P,A00,886515,Shen; Kuiyi,80,0,146,66
1746561643507,VIS 149,A00,886516,Yoldas; Pinar,0,0,15,15
1746561644535,VIS 164,A00,886526,Erdmann; Dean,19,0,22,3
1746561645561,VIS 194S,A00,886527,Staff,61,0,75,14
1746561646590,WCWP 10A,C00,886484,Martiniuk; Jill,12,0,15,3
1746561647617,WCWP 10B,A00,886490,Uriarte; Emma,0,0,15,15
1746561647617,WCWP 10B,B00,886491,Dhir; Simrita,10,0,15,5
1746561647617,WCWP 10B,C00,886492,Ornelas; Tricia,0,0,15,15
1746561648641,WCWP 100,A00,886494,Young; Mark T,0,6,15,15
1746561650775,AAS 10,A01,886199,Childs; Dennis R.,0,3,0,0
1746561651801,ANAR 104,A01,886940,Shtienberg; Gilad,27,0,30,3
1746561652825,ANAR 120,A00,886953,Staff,12,0,20,8
1746561653851,ANBI 148,A01,886955,Wilder; Linnea Lorene,30,0,40,10
1746561655904,ANSC 122,A00,886957,Staff,25,0,30,5
1746561656932,ANSC 150,A00,886958,Sloane; Julia Kathryn,2,0,15,13
1746561657959,ANSC 156,A00,886959,Jenkins; Janis A.,0,1,15,15
1746561658987,ANSC 180,A00,886960,Staff,11,0,17,6
1746561660046,ANSC 188,A00,886961,Jassal; Aftab,9,0,25,16
1746561661077,ANSC 190,A00,886962,Jassal; Aftab,14,0,25,11
1746561662105,ANSC 191,A00,886963,Staff,18,0,20,2
1746561663158,ANTH 3,A01,891689,Staff,17,0,20,3
1746561664184,ANTH 5,A00,886933,Semendeferi; Ekaterini,16,0,20,4
1746561665208,ANTH 10,A00,886934,Staff,0,12,30,30
1746561666232,ANTH 21,A01,886936,Staff,40,0,60,20
1746561667258,ANTH 23,A01,886938,Staff,92,0,100,8
1746561668282,ANTH 105,A00,886964,Stewart; Alexander B,84,0,100,16
1746561669307,ANTH 108,A00,886965,Pedersen; David,9,0,20,11
1746561670340,AWP 10,001,886147,Staff,0,0,0,0
1746561670340,AWP 10,002,886148,Staff,0,0,0,0
1746561670340,AWP 10,003,886149,Staff,0,0,0,0
1746561670340,AWP 10,004,886150,Staff,0,0,0,0
1746561670340,AWP 10,005,886151,Staff,0,0,0,0
1746561670340,AWP 10,006,886152,Staff,0,0,0,0
1746561670340,AWP 10,007,886153,Staff,0,0,0,0
1746561670340,AWP 10,008,886154,Staff,0,0,0,0
1746561670340,AWP 10,009,886155,Staff,0,0,0,0
1746561670340,AWP 10,010,886156,Staff,0,0,0,0
1746561670340,AWP 10,011,886158,Staff,0,0,0,0
1746561670340,AWP 10,012,886160,Staff,0,0,0,0
1746561670340,AWP 10,013,886161,Staff,0,0,0,0
1746561670340,AWP 10,014,886162,Staff,0,0,0,0
1746561670340,AWP 10,015,886163,Staff,0,0,0,0
1746561670340,AWP 10,016,886164,Staff,0,0,0,0
1746561670340,AWP 10,017,886165,Staff,0,0,0,0
1746561670340,AWP 10,018,886166,Staff,0,0,0,0
1746561670340,AWP 10,019,886168,Staff,0,0,0,0
1746561670340,AWP 10,020,886170,Staff,0,0,0,0
1746561670340,AWP 10,021,886172,Staff,0,0,0,0
1746561671369,AWP 10R,001,886173,Staff,0,1,0,0
1746561671369,AWP 10R,002,886174,Staff,0,1,0,0
1746561671369,AWP 10R,003,886175,Staff,0,0,0,0
1746561671369,AWP 10R,004,886176,Staff,0,0,0,0
1746561671369,AWP 10R,005,886177,Staff,0,0,0,0
1746561671369,AWP 10R,006,886178,Staff,0,0,0,0
1746561671369,AWP 10R,007,886179,Staff,0,0,0,0
1746561671369,AWP 10R,008,886181,Staff,0,0,0,0
1746561671369,AWP 10R,009,886182,Staff,0,0,0,0
1746561671369,AWP 10R,010,886183,Staff,0,0,0,0
1746561671369,AWP 10R,011,886184,Staff,0,0,0,0
1746561671369,AWP 10R,012,886185,Staff,0,0,0,0
1746561671369,AWP 10R,013,886186,Staff,0,0,0,0
1746561671369,AWP 10R,014,886187,Staff,0,0,0,0
1746561671369,AWP 10R,015,886188,Staff,0,0,0,0
1746561671369,AWP 10R,016,886189,Staff,0,0,0,0
1746561671369,AWP 10R,017,960532,Staff,0,0,0,0
1746561671369,AWP 10R,018,960533,Staff,0,0,0,0
1746561671369,AWP 10R,019,960534,Staff,0,0,0,0
1746561671369,AWP 10R,020,960538,Staff,0,0,0,0
1746561671369,AWP 10R,021,960540,Staff,0,0,0,0
1746561671369,AWP 10R,022,960541,Staff,0,0,0,0
1746561671369,AWP 10R,023,960542,Staff,0,0,0,0
1746561671369,AWP 10R,024,960544,Staff,0,0,0,0
1746561671369,AWP 10R,025,960545,Staff,0,0,0,0
1746561671369,AWP 10R,026,960548,Staff,0,0,0,0
1746561672393,AWP 102R,A00,886190,Staff,0,0,0,0
1746561672393,AWP 102R,B00,886191,Staff,0,0,0,0
1746561673417,BENG 100,A01,886193,Staff,17,0,30,13
1746561674446,BENG 122A,A01,886195,Hasty; Jeff M,13,0,30,17
1746561675471,BENG 166A,A00,886196,Sah; Robert Lie-Yuan,0,2,30,30
1746561676494,BENG 190,A00,958050,Khojah; Reem I,22,0,25,3
1746561677519,BIBC 102,A01,894320,Staff,0,0,46,46
1746561677519,BIBC 102,A02,894321,Staff,0,0,46,46
1746561677519,BIBC 102,A03,894344,Staff,7,0,46,39
1746561677519,BIBC 102,A04,894345,Staff,26,0,47,21
1746561678544,BICD 100R,A01,894365,Smith; Laurie,0,3,58,58
1746561678544,BICD 100R,A02,894366,Smith; Laurie,0,5,58,58
1746561678544,BICD 100R,A03,894367,Smith; Laurie,1,0,59,58
1746561678544,BICD 100R,A04,959869,Smith; Laurie,40,0,59,19
1746561679575,BICD 136,A01,894383,Gustafson-Brown; Cindy,14,0,50,36
1746561680600,BIEB 102,A01,894494,Butler; Shannon Rhey,51,0,130,79
1746561682652,BIEB 150,A01,894617,Wills; Christopher,3,0,20,17
1746561682652,BIEB 150,A02,894631,Wills; Christopher,3,0,20,17
1746561682652,BIEB 150,A03,894937,Wills; Christopher,3,0,20,17
1746561682652,BIEB 150,A04,894946,Wills; Christopher,5,0,20,15
1746561683678,BIEB 194,A00,906141,Kurle; Carolyn M.,6,0,20,14
1746561684702,BILD 1,A01,894154,Staff,3,0,19,16
1746561684702,BILD 1,A02,894155,Staff,14,0,19,5
1746561684702,BILD 1,A03,894160,Staff,13,0,19,6
1746561684702,BILD 1,A04,894161,Staff,15,0,18,3
1746561685729,BILD 2,A01,894168,Staff,0,0,50,50
1746561685729,BILD 2,A02,894169,Staff,0,0,50,50
1746561685729,BILD 2,A03,894179,Staff,0,0,50,50
1746561685729,BILD 2,A04,894203,Staff,26,0,50,24
1746561686753,BILD 3,A01,894213,Staff,22,0,31,9
1746561686753,BILD 3,A02,894214,Staff,26,0,31,5
1746561686753,BILD 3,A03,894235,Staff,28,0,31,3
1746561686753,BILD 3,A04,894236,Staff,28,0,32,4
1746561687780,BILD 4,A01,894253,Reuther; Keefe,5,0,24,19
1746561687780,BILD 4,A02,894258,Reuther; Keefe,16,0,24,8
1746561688808,BILD 5,A01,894276,Reuther; Keefe,35,0,50,15
1746561688808,BILD 5,A02,894277,Reuther; Keefe,45,0,50,5
1746561688808,BILD 5,A03,894290,Reuther; Keefe,44,0,50,6
1746561688808,BILD 5,A04,894291,Reuther; Keefe,48,0,50,2
1746561689836,BILD 24,A01,894297,Pirino; Giorgia,40,0,60,20
1746561690864,BIMM 100,B01,958915,Staff,71,0,100,29
1746561691890,BIMM 101,A01,895017,McDonnell; Lisa Marie,0,5,24,24
1746561691890,BIMM 101,A02,895018,McDonnell; Lisa Marie,0,5,24,24
1746561691890,BIMM 101,B01,895020,McDonnell; Lisa Marie,0,6,24,24
1746561691890,BIMM 101,B02,895021,McDonnell; Lisa Marie,0,4,24,24
1746561692919,BIMM 110,A01,895023,Staff,1,0,25,24
1746561692919,BIMM 110,A02,895024,Staff,9,0,25,16
1746561692919,BIMM 110,A03,895025,Staff,18,0,25,7
1746561692919,BIMM 110,A04,895031,Staff,20,0,25,5
1746561693944,BIMM 120,A01,895114,Gustafson-Brown; Cindy,14,0,28,14
1746561693944,BIMM 120,A02,895126,Gustafson-Brown; Cindy,21,0,27,6
1746561694969,BIPN 100,A01,895130,Yang; Mingyu,1,0,38,37
1746561694969,BIPN 100,A02,895131,Yang; Mingyu,32,0,38,6
1746561694969,BIPN 100,A03,895132,Yang; Mingyu,32,0,38,6
1746561694969,BIPN 100,A04,895133,Yang; Mingyu,27,0,36,9
1746561695992,BIPN 120,A01,895135,Cooke; James Edward,0,3,13,13
1746561695992,BIPN 120,A02,895136,Cooke; James Edward,0,1,13,13
1746561695992,BIPN 120,A03,895137,Cooke; James Edward,0,3,13,13
1746561695992,BIPN 120,A04,895156,Cooke; James Edward,0,2,11,11
1746561697017,BIPN 134,A01,895235,Cooke; James Edward,0,2,25,25
1746561697017,BIPN 134,A02,895237,Cooke; James Edward,0,0,25,25
1746561697017,BIPN 134,A03,895240,Cooke; James Edward,3,0,25,22
1746561697017,BIPN 134,A04,895270,Cooke; James Edward,20,0,25,5
1746561698042,BIPN 189,A00,892103,Staff,0,13,14,14
1746561700090,BISP 194,A00,958008,Staff,0,2,0,0
1746561701117,CAT 124,A01,922009,Staff,0,5,20,20
1746561702144,CAT 125R,A00,886390,Morales; Celeste Georgianna,0,2,20,20
1746561702144,CAT 125R,B00,886391,Irwin; Matthew Joseph,0,4,20,20
1746561702144,CAT 125R,C00,886392,Smith; Lauryn Alissa,0,2,20,20
1746561702144,CAT 125R,D00,886393,Vanderschuit; Maya Alysia,0,2,20,20
1746561702144,CAT 125R,E00,886394,Marchisotto; Jennifer Anne,0,3,20,20
1746561703170,CENG 15,A01,886218,Drews; Aaron,3,0,8,5
1746561704195,CENG 113,A00,886219,Opatkiewicz; Justin Paul,15,0,25,10
1746561705223,CGS 101,A00,887044,Staff,7,0,20,13
1746561706247,CGS 105,A01,887046,Staff,14,0,25,11
1746561707276,CGS 112,A00,887047,Cuong; Marisol,12,0,15,3
1746561708301,CGS 113,A00,887048,Staff,23,0,30,7
1746561709325,CGS 120,A00,887049,Staff,10,0,17,7
1746561710350,CHEM 6A,A01,886336,Lam; Tin Yiu,38,0,50,12
1746561710350,CHEM 6A,A02,886338,Lam; Tin Yiu,37,0,50,13
1746561711379,CHEM 6B,A01,886341,Hopkins; Patrycja Anna,16,0,50,34
1746561711379,CHEM 6B,A02,886343,Hopkins; Patrycja Anna,42,0,50,8
1746561712415,CHEM 6C,A01,886346,Albizati; Kim F.,0,2,50,50
1746561712415,CHEM 6C,A02,886348,Albizati; Kim F.,23,0,50,27
1746561713444,CHEM 40A,A01,886352,Klosterman; Jeremy K,65,0,100,35
1746561714472,CHEM 40B,A01,886356,Klosterman; Jeremy K,0,23,100,100
1746561715499,CHEM 41B,A01,886360,Theodorakis; Emmanuel,25,0,50,25
1746561715499,CHEM 41B,A02,886362,Theodorakis; Emmanuel,47,0,50,3
1746561716527,CHIN 165A,A00,886382,Xu; Li,18,0,20,2
1746561717553,CLAS 120,A00,886387,Myerston Santana; Jacobo,33,0,40,7
1746561718586,COGS 9,A01,886967,Shannon; Kyle Michael,42,0,60,18
1746561719613,COGS 11,A01,886969,Staff,10,0,30,20
1746561720640,COGS 14A,A01,886971,Staff,6,0,60,54
1746561721665,COGS 14B,A01,886973,Hoffman; Drew Ellen,4,0,60,56
1746561722695,COGS 18,A01,886975,Morgan; Eric,35,0,60,25
1746561723720,COGS 20,A01,886977,Staff,4,0,8,4
1746561723720,COGS 20,A02,886978,Staff,5,0,7,2
1746561724746,COGS 100,A01,907783,Staff,0,2,30,30
1746561725774,COGS 101B,A01,886980,Staff,0,3,48,48
1746561726800,COGS 101C,A01,886982,Delgado; Tania,0,5,44,44
1746561727828,COGS 102A,A01,886984,Johnson; Christine M.,4,0,30,26
1746561728855,COGS 118B,A01,886986,Staff,0,3,88,88
1746561729882,COGS 150,A01,886988,Bergen; Benjamin,22,0,50,28
1746561730908,COGS 153,A00,886989,Delgado; Tania,0,2,41,41
1746561731937,COGS 186,A01,886991,Staff,0,0,32,32
1746561732964,COGS 187A,A01,886993,Boyle; Mary E. T.,7,0,30,23
1746561733992,COGS 189,A00,886994,Staff,0,1,30,30
1746561735020,COMM 10,A01,886996,Staff,0,0,20,21
1746561735020,COMM 10,A02,886997,Staff,12,0,20,8
1746561735020,COMM 10,A03,959845,Staff,19,0,20,1
1746561736044,COMM 20,A01,886999,Leuning; Grant Maurstad,24,0,40,16
1746561738100,COMM 100A,A01,887002,Staff,0,0,20,25
1746561738100,COMM 100A,A02,887003,Staff,7,0,20,13
1746561739129,COMM 100B,A01,887005,Staff,0,8,20,24
1746561740158,COMM 106D,A00,887006,Staff,14,0,40,26
1746561741185,COMM 110G,A00,887007,Whitworth-Smith; Andrew C,12,0,40,28
1746561742210,COMM 111B,A00,887008,Staff,31,0,40,9
1746561743238,COMM 113T,A00,887009,Abuelhiga; Soraya Jill,28,0,40,12
1746561743238,COMM 113T,B00,906733,Staff,40,0,40,0
1746561744265,COMM 145,A00,887010,Staff,12,0,40,28
1746561745289,COMM 146,A00,887054,Staff,31,0,40,9
1746561746316,COMM 190,A00,887012,Staff,8,0,23,15
1746561747343,CSE 8A,A50,887015,Cao; Yingjun,57,0,85,28
1746561748371,CSE 11,A01,887017,Cao; Yingjun,12,0,70,58
1746561749399,CSE 20,A01,887019,Staff,30,0,50,20
1746561750431,CSE 21,A01,887021,Staff,78,0,100,22
1746561750431,CSE 21,B01,892583,Braun; Oliver,45,0,50,5
1746561751458,CSE 30,A01,887025,Eldon; John,143,0,200,57
1746561752481,CSE 100,A01,887027,Staff,26,0,50,24
1746561752481,CSE 100,A02,887028,Staff,42,0,50,8
1746561753511,CSE 101,A01,887030,Braun; Oliver,74,0,100,26
1746561753511,CSE 101,B01,887032,Jones; Miles E,0,3,50,50
1746561753511,CSE 101,B02,887033,Jones; Miles E,0,2,50,50
1746561754537,CSE 105,A01,908084,Jones; Miles E,32,0,50,18
1746561754537,CSE 105,A02,908087,Jones; Miles E,32,0,50,18
1746561755561,CSE 135,A01,887035,Powell; Thomas Allan,0,4,50,50
1746561756589,CSE 142,A01,887037,Staff,8,0,60,52
1746561757617,CSE 142L,A01,887039,Staff,34,0,60,26
1746561758643,CSE 151A,A01,887041,Solares; Edwin A,47,0,100,53
1746561759668,CSE 175,A01,887043,Kumar; Rakesh,30,0,30,0
1746561760693,CSS 1,A01,886389,Staff,1,1,40,39
1746561761721,DSC 30,A01,908097,Liao; Soohyun Nam,47,0,75,28
1746561762746,DSC 40A,A01,908099,Shannon; Kyle Michael,30,0,50,20
1746561763773,DSC 40B,A01,908112,Staff,16,0,50,34
1746561764807,DSC 80,A01,908116,Staff,19,0,60,41
1746561765832,DSC 197,001,956863,Eldridge; Justin Matthew,9999,0,9999,0
1746561766859,ECE 5,A01,886400,Morris; Karcher William,2,0,6,4
1746561766859,ECE 5,A02,886401,Morris; Karcher William,3,0,6,3
1746561767886,ECE 148,A01,886403,Silberman; Jack,0,14,14,14
1746561768915,ECON 1,A01,887265,Crane; Meredith Helen,12,0,70,58
1746561768915,ECON 1,B01,887268,Staff,43,0,50,7
1746561769939,ECON 2,A01,887273,Crane; Meredith Helen,55,0,70,15
1746561770966,ECON 3,A01,887279,Rondina; Giacomo,32,0,70,38
1746561771991,ECON 4,A01,887282,Anderson; John Charles,0,2,10,10
1746561773021,ECON 5,A01,887285,Staff,34,0,45,11
1746561773021,ECON 5,B01,887292,Staff,41,0,45,4
1746561774052,ECON 100A,A01,887337,Newhouse; Herbert S,54,0,70,16
1746561774052,ECON 100A,B01,887349,Staff,45,0,50,5
1746561775080,ECON 100B,A01,887361,Du; Songzi,29,0,70,41
1746561776106,ECON 100C,A01,887445,Newhouse; Herbert S,59,0,70,11
1746561777130,ECON 105,A00,887488,Vespa; Emanuel Ignacio,23,0,35,12
1746561778159,ECON 109,A01,887506,Shishkin; Denis,28,0,35,7
1746561779188,ECON 110A,A01,887568,Alon; Titan Michael,0,3,35,35
1746561779188,ECON 110A,B01,907601,Alon; Titan Michael,20,0,35,15
1746561780213,ECON 110B,A01,887598,Levkoff; Steven B.,0,24,70,70
1746561781236,ECON 112,A00,887599,Rondina; Giacomo,19,0,35,16
1746561782266,ECON 120A,A01,887603,Dai; Yinlin,35,0,70,35
1746561783296,ECON 120C,A01,887608,Sun; Yixiao,0,1,35,35
1746561783296,ECON 120C,B01,887614,Sun; Yixiao,0,0,35,35
1746561784324,ECON 138,A00,887621,Bharadwaj; Prashant,0,21,20,20
1746561785352,ECON 144,A00,958007,Squires; Dale E,13,0,35,22
1746561786379,ECON 171,A01,907666,Staff,18,0,35,17
1746561787406,ECON 175,A00,887626,Wu; Pak Yeung,23,0,35,12
1746561788433,ECON 190,A00,887640,Vespa; Emanuel Ignacio,23,0,35,12
1746561789459,EDS 25,A01,888197,Staff,0,0,0,0
1746561789459,EDS 25,A02,888209,Staff,0,0,0,0
1746561789459,EDS 25,A03,888210,Staff,0,0,0,0
1746561789459,EDS 25,A04,888212,Staff,0,0,0,0
1746561789459,EDS 25,A05,888213,Staff,0,0,0,0
1746561789459,EDS 25,A06,888214,Staff,0,0,0,0
1746561789459,EDS 25,A07,888235,Staff,0,2,0,0
1746561789459,EDS 25,A08,888236,Staff,0,0,0,0
1746561789459,EDS 25,A09,888240,Staff,0,0,0,0
1746561789459,EDS 25,A10,888244,Staff,0,0,0,0
1746561789459,EDS 25,B01,888273,Staff,0,0,0,0
1746561789459,EDS 25,B02,888285,Staff,0,0,0,0
1746561789459,EDS 25,B03,888423,Staff,0,0,0,1
1746561789459,EDS 25,B04,888432,Staff,0,0,0,0
1746561789459,EDS 25,B05,888433,Staff,0,0,0,0
1746561789459,EDS 25,B06,888467,Staff,0,0,0,0
1746561789459,EDS 25,B07,888468,Staff,0,0,0,0
1746561789459,EDS 25,B08,888479,Staff,0,0,0,0
1746561789459,EDS 25,B09,888484,Staff,0,0,0,0
1746561789459,EDS 25,B10,888487,Staff,0,0,0,0
1746561790485,EDS 38,A01,907700,Choi; Bailey Miyeon,30,0,30,0
1746561791509,EDS 112,A01,888601,Chapman; Thandeka K,13,0,40,27
1746561792536,EDS 115,A00,888697,Mendez; Kathrina Mendoza,10,0,30,20
1746561793560,EDS 116,A01,888893,Staff,35,0,40,5
1746561795612,EDS 124AR,A00,889133,Staff,29,0,50,21
1746561795612,EDS 124AR,B00,907471,Simon; Elizabeth A,37,0,50,13
1746561796640,EDS 124BR,A00,889134,Simon; Elizabeth A,44,0,100,56
1746561797664,EDS 125,A00,889135,Staff,25,0,30,5
1746561798688,EDS 126,A01,889138,Staff,36,0,40,4
1746561799735,EDS 164R,A01,889142,Wishard Guerra; Alison G.,33,0,50,17
1746561800761,ENG 30,A01,886396,Staff,0,0,0,0
1746561800761,ENG 30,B01,886398,Staff,0,0,0,0
1746561801787,ENVR 102,A00,906150,Montejo; Carolina,23,0,25,2
1746561802811,ETHN 103A,A00,887236,Man; Simeon S,0,3,0,0
1746561803838,ETHN 113,A00,887239,Staff,16,0,30,14
1746561804864,ETHN 116,A00,887240,Staff,16,0,25,9
1746561805889,ETHN 117,A00,887241,Choi; Esther Min,28,0,30,2
1746561806913,ETHN 118,A00,887243,Staff,24,0,30,6
1746561807938,ETHN 127,A00,887248,Cuong; Marisol,11,0,15,4
1746561808967,ETHN 139,A00,887250,Staff,7,0,10,3
1746561809993,ETHN 142,A00,887252,Staff,10,0,30,20
1746561811018,ETHN 161,A00,887253,Browne; Errol Tsekani,24,0,30,6
1746561812045,ETHN 163FR,A00,887255,Burelle; Julie Sara Veronique,0,0,5,5
1746561813072,GLBH 20,A00,889149,Elwardani; Nile Regina,8,0,42,34
1746561815127,GLBH 111,A01,889152,Burgos; Jose L.,17,0,17,0
1746561816152,GLBH 150,A00,889181,Sloane; Julia Kathryn,0,5,15,15
1746561818209,HDS 60,A01,886406,Warstadt; Melissa Fawn,73,0,80,7
1746561819237,HIAF 111,A00,889324,Gyamfi; Bright,25,0,32,7
1746561820263,HIEA 131,A00,889328,Staff,15,0,32,17
1746561821291,HIEA 144,A00,889333,Henry; Todd A.,26,0,32,6
1746561822321,HIEA 154,A00,889336,Henry; Todd A.,24,0,32,8
1746561823346,HIEU 106,A00,889339,Staff,22,0,32,10
1746561825398,HIEU 114,A00,889340,Staff,3,0,32,29
1746561826422,HIEU 135GS,A00,889342,Patterson; Patrick H.,0,0,1,24
1746561827446,HIEU 137,A00,889343,Edington; Claire Ellen,9,0,25,16
1746561828472,HIEU 148,A00,889345,Staff,14,0,32,18
1746561829499,HIEU 154,A00,889346,Biess; Frank Peter,21,0,32,11
1746561830526,HILA 102,A00,889351,Staff,12,0,32,20
1746561831550,HILD 2A,A01,889221,Lewandoski; Julia Mavis,1,10,32,31
1746561832576,HILD 7B,A01,889225,Man; Simeon S,0,12,32,32
1746561833602,HILD 7C,A01,889288,Alvarez; Luis A,0,14,32,32
1746561834626,HILD 30,A01,889323,Staff,0,5,32,32
1746561836683,HISC 119,A00,889383,Golan; Tal,20,0,32,12
1746561837709,HIUS 103,A00,889384,Man; Simeon S,0,0,32,32
1746561838733,HIUS 117,A00,919797,Kwak; Nancy,18,0,32,14
1746561839760,HIUS 142A,A00,919788,Staff,22,0,32,10
1746561841812,HIUS 149,A00,889386,Gyamfi; Bright,27,0,32,5
1746561842839,HIUS 155,A00,889387,Alvarez; Luis A,14,0,32,18
1746561843865,HUM 3,A01,886499,Caldwell; Michael Alan,19,0,50,31
1746561844891,HUM 3GS,A00,886500,Rodriguez; Bretton Sigfred,0,0,0,28
1746561845919,HUM 3R,A01,886502,Markman; Kristina,0,36,50,50
1746561846948,HUM 4,A01,886504,Crum; Matthew Stephen,24,0,50,26
1746561846948,HUM 4,B01,886506,West; Geoffrey Scott,17,0,50,33
1746561847975,HUM 4GS,A00,886507,Staff,0,0,0,19
1746561849002,HUM 5,A01,886509,Staff,32,0,50,18
1746561850027,HUM 5R,A01,886511,Zavodny; Tatiana Sophia,0,39,50,50
1746561851056,JAPN 180,A00,886407,Staff,17,0,40,23
1746561852082,LATI 50,A01,886409,Martin-Cabrera; Luis,4,0,22,18
1746561852082,LATI 50,A02,886410,Martin-Cabrera; Luis,19,0,22,3
1746561852082,LATI 50,A03,886411,Martin-Cabrera; Luis,21,0,22,1
1746561852082,LATI 50,A04,886412,Martin-Cabrera; Luis,9,0,22,13
1746561853107,LAWS 101,A00,907664,Staff,28,0,60,32
1746561854135,LIAB 1A,A00,889388,Saab; Dima,17,0,20,3
1746561855166,LIAB 1AX,A00,889389,El Cheddadi; Youniss,18,0,20,2
1746561856191,LIFR 1C,A00,889391,Van Moer; Vinciane G,8,0,20,12
1746561857216,LIFR 1CX,A00,889392,Van Moer; Vinciane G,7,0,20,13
1746561858242,LIFR 1D,A00,889393,Van Moer; Vinciane G,7,0,20,13
1746561859274,LIFR 1DX,A00,889394,Van Moer; Vinciane G,8,0,20,12
1746561860300,LIGN 7,A00,886923,Staff,24,0,50,26
1746561861328,LIGN 17,A00,886924,Kehler; Andrew Scott,125,0,150,25
1746561862353,LTAM 110,A00,889395,Staff,15,0,30,15
1746561863379,LTAM 110GS,A00,958010,Rodriguez; Bretton Sigfred,0,0,0,28
1746561864404,LTCH 101,A00,889397,Staff,23,0,25,2
1746561865431,LTCS 130,A00,889398,Staff,23,0,25,2
1746561866454,LTEA 138,A00,889399,Staff,24,0,40,16
1746561867501,LTEN 149,A00,889400,Wesling; Megan E.,0,3,25,25
1746561868525,LTEN 169,A00,889401,Staff,20,0,25,5
1746561869552,LTEN 180,A00,889402,Staff,10,0,15,5
1746561870580,LTEN 181,A00,889403,Staff,21,0,25,4
1746561871604,LTWL 100,A00,889404,Myerston Santana; Jacobo,2,0,25,23
1746561872631,LTWL 180GS,A00,889405,Staff,0,0,20,20
1746561873659,LTWL 181,A00,889406,Staff,16,0,25,9
1746561874686,LTWL 184,A00,889475,Mukherjee; Silpa,22,0,25,3
1746561875710,LTWR 102C,A00,889486,Staff,29,0,30,1
1746561876737,LTWR 115W,A00,889491,Staff,0,2,15,15
1746561877762,MAE 8,A01,886905,Staff,0,2,0,0
1746561878790,MAE 11,A00,886906,Bandaru; Prabhakar,0,7,50,50
1746561879815,MAE 20,A00,886907,Evdokimenko; Ekaterina,43,0,70,27
1746561880845,MAE 30B,A00,886909,Ghazinejad; Maziar,26,0,45,19
1746561881874,MAE 101B,A00,886910,Saintillan; David,29,0,45,16
1746561882900,MAE 105,A00,886911,Bandaru; Prabhakar,18,0,50,32
1746561883926,MAE 107,B00,958024,Staff,8,0,50,42
1746561884950,MAE 143B,A00,886913,Bewley; Thomas R,6,0,40,34
1746561885978,MAE 148,A01,886915,Silberman; Jack,0,3,14,14
1746561887002,MAE 160,A00,886916,Evdokimenko; Ekaterina,32,0,60,28
1746561888025,MATH 3C,A01,889681,Staff,0,2,30,30
1746561888025,MATH 3C,A02,960048,Staff,24,0,30,6
1746561889049,MATH 10A,A01,889760,Staff,26,0,30,4
1746561889049,MATH 10A,A02,889783,Staff,29,0,30,1
1746561890079,MATH 10B,A01,889785,Verstraete; Jacques Allan,2,0,35,33
1746561890079,MATH 10B,A02,889795,Verstraete; Jacques Allan,4,0,35,31
1746561890079,MATH 10B,B01,889797,Verstraete; Jacques Allan,3,0,35,32
1746561890079,MATH 10B,B02,889828,Verstraete; Jacques Allan,3,0,35,32
1746561891106,MATH 10C,A01,889849,Habib; Yousaf,8,0,30,22
1746561891106,MATH 10C,A02,889852,Habib; Yousaf,14,0,30,16
1746561891106,MATH 10C,A03,889853,Habib; Yousaf,22,0,30,8
1746561891106,MATH 10C,A04,889858,Habib; Yousaf,20,0,30,10
1746561891106,MATH 10C,B01,889861,Staff,1,0,30,29
1746561891106,MATH 10C,B02,889862,Staff,24,0,30,6
1746561891106,MATH 10C,B03,889863,Staff,27,0,30,3
1746561891106,MATH 10C,B04,889967,Staff,23,0,30,7
1746561892130,MATH 18,A01,889974,Staff,7,0,30,23
1746561892130,MATH 18,A02,889977,Staff,20,0,30,10
1746561892130,MATH 18,B01,889984,Hardiman; Liam,21,0,30,9
1746561892130,MATH 18,B02,889985,Hardiman; Liam,25,0,30,5
1746561893155,MATH 20A,A01,889990,Suk; Andrew Hoon,30,0,35,5
1746561894185,MATH 20B,A01,889993,Ohm; Ko Woon,22,0,30,8
1746561894185,MATH 20B,A02,889994,Ohm; Ko Woon,30,0,30,0
1746561894185,MATH 20B,B01,889996,Ohm; Ko Woon,21,0,30,9
1746561894185,MATH 20B,B02,889997,Ohm; Ko Woon,23,0,30,7
1746561895220,MATH 20C,A01,889999,Hammock; Frances H,17,0,30,13
1746561895220,MATH 20C,A02,890003,Hammock; Frances H,23,0,30,7
1746561895220,MATH 20C,B01,890006,Hammock; Frances H,3,0,30,27
1746561895220,MATH 20C,B02,890007,Hammock; Frances H,11,0,30,19
1746561896247,MATH 20D,A01,890011,Cheng; Hsiao-Bing,1,1,30,29
1746561896247,MATH 20D,A02,890012,Cheng; Hsiao-Bing,14,0,30,16
1746561896247,MATH 20D,B01,890016,Cheng; Hsiao-Bing,13,0,30,17
1746561896247,MATH 20D,B02,890017,Cheng; Hsiao-Bing,13,0,30,17
1746561897278,MATH 20E,A01,890026,Harel; Guershon,1,0,30,29
1746561897278,MATH 20E,A02,890029,Harel; Guershon,23,0,30,7
1746561897278,MATH 20E,B01,890033,Harel; Guershon,7,0,30,23
1746561897278,MATH 20E,B02,890101,Harel; Guershon,21,0,30,9
1746561898302,MATH 102,A01,890104,Staff,17,0,30,13
1746561898302,MATH 102,A02,890105,Staff,27,0,30,3
1746561899333,MATH 103B,A01,890116,Salehi Golsefidy; Alireza,3,0,30,27
1746561899333,MATH 103B,B01,890118,Staff,0,3,34,34
1746561900362,MATH 109,A01,890121,Aliabadi Sr.; Mohsen,1,0,30,29
1746561900362,MATH 109,B01,890124,Upadrashta; Pranav Kumar,18,0,30,12
1746561901389,MATH 120A,A01,890126,Eggers; John Dietrich,13,0,30,17
1746561902419,MATH 142B,A01,890128,Ioana; Adrian,19,0,30,11
1746561902419,MATH 142B,A02,890129,Ioana; Adrian,13,0,30,17
1746561903445,MATH 154,A01,890174,Staff,0,0,30,30
1746561903445,MATH 154,A02,890182,Staff,0,0,30,30
1746561904469,MATH 168A,A01,890197,Dumitriu; Ioana,21,0,35,14
1746561905500,MATH 170A,A01,890240,Nie; Jiawang,1,0,30,29
1746561905500,MATH 170A,A02,890241,Nie; Jiawang,11,0,30,19
1746561905500,MATH 170A,A03,890249,Nie; Jiawang,23,0,30,7
1746561906524,MATH 170B,A01,957891,Nag; Panchali,13,0,35,22
1746561908573,MATH 181A,A01,908025,Staff,0,4,35,35
1746561908573,MATH 181A,A02,960115,Staff,27,0,35,8
1746561909603,MATH 181B,A01,959874,Staff,25,0,30,5
1746561910632,MATH 193B,A01,890265,Staff,0,4,35,35
1746561911662,MGT 4,A01,890311,Anderson; John Charles,42,0,88,46
1746561912686,MGT 5,A00,907740,Staff,13,0,98,85
1746561913750,MGT 12,A00,890312,Lindenberger; Wade Douglas,67,0,98,31
1746561914776,MGT 16,A00,957883,Staff,78,0,98,20
1746561916828,MGT 45,A00,890314,Pecore; Joseph P.,46,0,98,52
1746561917857,MGT 71,A00,890315,Staff,0,11,98,98
1746561918884,MGT 100,A00,890316,Yavorsky; Daniel Ryan,44,0,98,54
1746561919912,MGT 103,A00,890317,Ehrich; Kristine R,73,0,98,25
1746561920939,MGT 105,A00,890356,Bates; Kenneth Walter,0,8,98,98
1746561921967,MGT 112,A00,890360,Ehrich; Kristine R,55,0,98,43
1746561922993,MGT 127R,A00,907732,Zhu; Kevin Xiaoguo,23,0,98,75
1746561924019,MGT 131B,A00,890361,Anderson; John Charles,60,0,98,38
1746561925044,MGT 137,A00,890362,Lindenberger; Wade Douglas,65,0,98,33
1746561926072,MGT 160,A00,890369,Johnson; Erik Barry,9,0,98,89
1746561928125,MGT 164,A00,890372,Zimmermann; Carsten,0,40,98,98
1746561929149,MGT 180,A00,890374,Bliss; Barbara Ann,12,0,98,86
1746561930175,MMW 15,A01,886414,Chang; Edmond Yi-Teh,0,12,28,28
1746561930175,MMW 15,A02,886415,Chang; Edmond Yi-Teh,0,8,28,28
1746561930175,MMW 15,A03,886416,Chang; Edmond Yi-Teh,0,8,28,28
1746561930175,MMW 15,A04,886417,Chang; Edmond Yi-Teh,0,8,28,28
1746561930175,MMW 15,B01,886419,Chang; Edmond Yi-Teh,0,7,28,28
1746561930175,MMW 15,B02,886420,Chang; Edmond Yi-Teh,0,8,28,28
1746561930175,MMW 15,B03,886421,Chang; Edmond Yi-Teh,0,7,28,28
1746561930175,MMW 15,B04,886422,Chang; Edmond Yi-Teh,0,8,28,28
1746561930175,MMW 15,C01,886424,Staff,0,9,28,28
1746561930175,MMW 15,C02,886425,Staff,0,8,28,28
1746561930175,MMW 15,C03,886426,Staff,0,8,28,28
1746561930175,MMW 15,C04,886427,Staff,0,8,28,28
1746561930175,MMW 15,C05,958038,Staff,0,8,28,28
1746561930175,MMW 15,C06,958039,Staff,0,8,28,28
1746561931202,MMW 15GS,A00,906910,Patterson; Patrick H.,4,0,28,24
1746561932227,MMW 122R,A01,886429,Rahimi; Babak,0,13,28,28
1746561932227,MMW 122R,A02,886430,Rahimi; Babak,0,12,28,28
1746561932227,MMW 122R,A03,958040,Rahimi; Babak,0,11,28,28
1746561933257,MUS 1A,A01,890937,Staff,2,0,25,23
1746561933257,MUS 1A,A02,891035,Staff,6,0,25,19
1746561933257,MUS 1A,C01,958912,Staff,24,0,25,1
1746561933257,MUS 1A,C02,958913,Staff,25,0,25,0
1746561935312,MUS 2AK,A00,957092,Ohnishi; Takae,15,0,15,0
1746561936337,MUS 4,A01,891044,Staff,2,0,25,23
1746561936337,MUS 4,A02,891045,Staff,23,0,25,2
1746561936337,MUS 4,B01,891048,Staff,17,0,25,8
1746561936337,MUS 4,B02,891050,Staff,25,0,25,0
1746561937363,MUS 5,A01,957506,Dubnov; Shlomo,0,0,25,25
1746561937363,MUS 5,A02,957622,Dubnov; Shlomo,13,0,25,12
1746561937363,MUS 5,A03,957623,Dubnov; Shlomo,20,0,25,5
1746561938392,MUS 6,A01,891053,Freitas Caetano; Marcelo,24,0,25,1
1746561938392,MUS 6,A02,891054,Freitas Caetano; Marcelo,23,0,25,2
1746561939418,MUS 7,A01,891081,Staff,0,0,25,25
1746561939418,MUS 7,A02,891082,Staff,4,0,25,21
1746561940445,MUS 8GS,A00,891118,Borgo; David Garcia,0,0,25,25
1746561941471,MUS 11,A01,891140,Staff,10,0,25,15
1746561941471,MUS 11,A02,891141,Staff,22,0,25,3
1746561942498,MUS 13,A01,891143,Staff,8,0,25,17
1746561942498,MUS 13,A02,891144,Staff,24,0,25,1
1746561943524,MUS 15,A01,891146,Staff,9,0,25,16
1746561943524,MUS 15,A02,891148,Staff,21,0,25,4
1746561943524,MUS 15,B01,891150,Staff,18,0,25,7
1746561943524,MUS 15,B02,891151,Staff,25,0,25,0
1746561944549,MUS 20,A01,891153,Staff,5,0,20,15
1746561944549,MUS 20,A02,891155,Staff,14,0,20,6
1746561945576,MUS 80,A00,891156,Staff,19,0,25,6
1746561945576,MUS 80,B00,891157,Staff,23,0,25,2
1746561946605,MUS 130,A00,891158,Ohnishi; Takae,35,0,35,0
1746561947634,MUS 150GS,A01,891160,Borgo; David Garcia,0,0,25,25
1746561948658,MUS 170,A01,891162,Freitas Caetano; Marcelo,20,0,25,5
1746561948658,MUS 170,A02,891164,Freitas Caetano; Marcelo,21,0,25,4
1746561949685,NANO 11,A00,886220,Vazquez Mena; Oscar,13,0,15,2
1746561950714,NANO 15,A01,886222,Drews; Aaron,4,0,7,3
1746561951741,NANO 104,A00,886224,Sirbuly; Donald,18,0,25,7
1746561952765,PH 40,A00,886528,Staff,23,0,40,17
1746561953792,PH 45,A01,886799,Staff,35,0,40,5
1746561954820,PH 110,A00,886802,Staff,0,7,40,40
1746561955845,PH 172,A00,906716,Staff,19,0,35,16
1746561956869,PH 191,A00,886803,Staff,6,0,40,34
1746561957893,PHIL 1,A00,889500,Staff,20,0,30,10
1746561958921,PHIL 10,A01,889549,Grush; Rick Scott,15,0,22,7
1746561958921,PHIL 10,A02,889551,Grush; Rick Scott,22,0,22,0
1746561959947,PHIL 28,A01,889559,Lamey; Andy M.,0,1,31,31
1746561959947,PHIL 28,A02,889561,Lamey; Andy M.,0,1,30,30
1746561959947,PHIL 28,A03,889572,Lamey; Andy M.,0,1,30,30
1746561960973,PHIL 35,A00,907839,Staff,13,0,15,2
1746561961998,PHIL 60,A00,889574,Staff,73,0,90,17
1746561963026,PHIL 101,A00,958004,Staff,12,0,15,3
1746561965076,PHIL 136,A00,889582,Fulkerson; Matthew Todd,26,0,45,19
1746561966102,PHIL 163,A01,889601,Staff,21,0,30,9
1746561966102,PHIL 163,B01,889606,Brandt; Reuven A,0,3,0,0
1746561967129,PHIL 164,A00,889610,Staff,16,0,30,14
1746561968156,PHIL 165,A00,889613,Staff,23,0,30,7
1746561969181,PHYS 1A,A00,886431,Staff,26,0,70,44
1746561970210,PHYS 1AL,001,886432,Tsai; Philbert S,0,2,30,30
1746561970210,PHYS 1AL,002,886436,Tsai; Philbert S,11,0,30,19
1746561971238,PHYS 1B,A00,886439,Staff,185,0,240,55
1746561972262,PHYS 1BL,001,886441,Tsai; Philbert S,0,4,30,30
1746561972262,PHYS 1BL,002,886444,Tsai; Philbert S,2,0,30,28
1746561973287,PHYS 1C,A00,896092,Arnold; Kam S,79,0,146,67
1746561974313,PHYS 1CL,001,886448,Tsai; Philbert S,0,0,30,30
1746561974313,PHYS 1CL,002,886449,Tsai; Philbert S,1,0,30,29
1746561974313,PHYS 1CL,003,886450,Tsai; Philbert S,16,0,30,14
1746561974313,PHYS 1CL,004,886451,Tsai; Philbert S,15,0,30,15
1746561975338,PHYS 2B,A01,886457,Staff,68,0,115,47
1746561976362,PHYS 2C,A01,886460,Shotwell; Brian,0,9,65,65
1746561977385,PHYS 2CL,A01,886467,Staff,0,4,28,28
1746561977385,PHYS 2CL,A02,886468,Staff,0,3,28,28
1746561978411,PHYS 2D,A01,886470,Staff,10,0,50,40
1746561979438,PHYS 4B,A01,886475,Grinstein; Benjamin,22,0,40,18
1746561980467,POLI 5,A00,891173,Desposato; Scott,7,0,25,18
1746561981492,POLI 5D,A01,891175,Staff,5,0,5,0
1746561981492,POLI 5D,B01,891178,Staff,5,0,5,0
1746561982518,POLI 11,A00,891179,Ferree; Karen E,2,0,35,33
1746561983546,POLI 12,A00,891180,Staff,16,0,30,14
1746561984572,POLI 27,A01,891182,Staff,12,0,75,63
1746561985599,POLI 30,A00,891183,Staff,8,0,50,42
1746561986629,POLI 100B,A00,891244,Staff,5,1,35,30
1746561987652,POLI 100I,A00,891247,Staff,7,0,30,23
1746561988676,POLI 104J,A00,891248,Nichter; Maysa,14,0,30,16
1746561989701,POLI 104U,A00,891250,Nichter; Maysa,2,0,30,28
1746561991751,POLI 110B,A00,891255,Wiens; David,20,0,25,5
1746561992778,POLI 112A,A00,891256,Wiens; David,6,0,25,19
1746561993801,POLI 114BR,A00,891261,Staff,19,0,30,11
1746561994830,POLI 117R,A00,891262,Forman; Fonna,0,6,50,50
1746561995859,POLI 118,A00,891264,Ingham; Sean,17,0,25,8
1746561996886,POLI 124A,A00,891265,Staff,18,0,20,2
1746561997910,POLI 125D,A00,891266,Nichter; Simeon C,2,0,25,23
1746561998934,POLI 126,A00,891268,Nichter; Simeon C,7,0,25,18
1746561999959,POLI 126AA,A00,891272,Staff,17,0,25,8
1746562000983,POLI 130AA,A00,891273,Staff,15,0,20,5
1746562002008,POLI 134AA,A00,891274,Staff,4,0,20,16
1746562004060,POLI 138,A00,891278,Staff,21,0,25,4
1746562005085,POLI 142K,A00,891280,Staff,11,0,25,14
1746562006113,POLI 142M,A00,891281,Gartzke; Erik,17,0,30,13
1746562007136,POLI 142P,A00,891284,Staff,20,0,30,10
1746562008162,POLI 143,A00,891285,Gartzke; Erik,12,0,30,18
1746562009186,POLI 153,A00,891286,Staff,19,0,20,1
1746562011232,POLI 175,A00,891290,Staff,15,0,20,5
1746562012259,PSYC 1,A00,890674,Steiner; Eric Tomas,0,11,45,45
1746562013283,PSYC 2,A00,890676,Albright; Thomas D,21,0,35,14
1746562014308,PSYC 3,A00,890679,Staff,17,0,20,3
1746562015332,PSYC 6,A00,959858,Staff,20,0,20,0
1746562016357,PSYC 60,A01,890684,Rickard; Timothy C.,0,5,45,45
1746562017424,PSYC 70,A01,890689,Geller; Emma Harlan,7,0,30,23
1746562018448,PSYC 71,A01,959860,Staff,21,0,25,4
1746562019473,PSYC 100,A00,890690,Lacefield; Katharine I,0,50,180,180
1746562020497,PSYC 102,A00,890695,Staff,18,0,40,22
1746562021525,PSYC 105,A00,890699,Geller; Emma Harlan,70,0,100,30
1746562022549,PSYC 106,A00,890701,Gorman; Michael R.,6,0,30,24
1746562023575,PSYC 108,A00,890704,Adrian; Julia Anna,0,28,50,50
1746562024600,PSYC 118,A01,890712,Staff,11,0,30,19
1746562025625,PSYC 124,A00,890716,Chapman; Eddie Nathaniel,25,0,60,35
1746562026649,PSYC 131,A00,890717,Anagnostaras; Stephan,0,7,80,80
1746562027676,PSYC 137,A00,890719,Winkielman; Piotr,0,11,30,30
1746562028702,PSYC 144,A00,890721,Adrian; Julia Anna,0,9,45,45
1746562029729,PSYC 162,A00,890805,Staff,2,0,75,73
1746562030755,PSYC 169,A00,890810,Staff,0,14,30,30
1746562031780,PSYC 172,A00,890814,Gorman; Michael R.,9,0,30,21
1746562032807,PSYC 181,A00,890818,Anagnostaras; Stephan,9,0,200,191
1746562033832,PSYC 184,A00,959861,Staff,170,0,175,5
1746562034859,PSYC 189,A00,890823,Staff,0,1,30,30
1746562035887,PSYC 191,A00,890884,Rickard; Timothy C.,0,11,35,35
1746562036911,PSYC 193,A00,890913,Staff,19,0,30,11
1746562036911,PSYC 193,B00,890914,Chapman; Eddie Nathaniel,24,0,30,6
1746562037937,PSYC 193L,A01,890918,Lowe; Angela Beth,20,0,30,10
1746562037937,PSYC 193L,B01,890921,Hurwitz; Ethan Scott,20,0,30,10
1746562037937,PSYC 193L,C01,890928,Staff,30,0,30,0
1746562038961,RELI 149,A00,886806,Rahimi; Babak,23,0,40,17
1746562039986,SE 9,A01,886814,Staff,7,0,20,13
1746562041014,SE 101B,A01,886816,Chadha; Mayank,4,0,35,31
1746562042042,SE 110B,A00,886818,Zhu; Qiang,4,0,75,71
1746562043067,SE 125,A01,886830,Staff,10,0,30,20
1746562044092,SE 130B,A01,886835,Staff,14,0,40,26
1746562045117,SE 131A,A01,886838,Krysl; Petr,34,0,55,21
1746562046141,SE 154,A00,886840,Staff,29,0,50,21
1746562047166,SE 164GS,A01,886849,Staff,6,0,20,14
1746562048190,SE 167GS,A01,886853,Staff,6,0,20,14
1746562049218,SIO 25,A01,890107,Staff,19,0,30,11
1746562050244,SIO 45,A00,890109,Cook; Geoffrey W,117,0,200,83
1746562051271,SIO 109R,A00,890110,Forman; Fonna,0,16,20,20
1746562052309,SIO 187,A01,890114,Kacev; David,15,0,40,25
1746562053332,SOCI 1,A01,890431,Thorpe; Charles Robert,15,0,30,15
1746562053332,SOCI 1,A02,890518,Thorpe; Charles Robert,30,0,30,0
1746562054359,SOCI 2,A01,957978,Staff,25,0,25,0
1746562054359,SOCI 2,A02,957979,Staff,23,0,25,2
1746562055382,SOCI 20,A01,890523,Calderon-Zaks; Michael Aar,23,0,30,7
1746562055382,SOCI 20,A02,890526,Calderon-Zaks; Michael Aar,29,0,30,1
1746562056408,SOCI 30,A01,890533,Pardo Guerra; Juan Pablo,37,0,40,3
1746562057435,SOCI 40,A01,890535,Staff,27,0,45,18
1746562058460,SOCI 104Q,A00,890559,Staff,18,0,30,12
1746562059485,SOCI 106,A00,890560,Arnal; Maud Marie Leonie,20,0,30,10
1746562060510,SOCI 110,A00,890567,Holkenbrink-Monk; Charlene,19,0,30,11
1746562061537,SOCI 112,A00,890568,Victoria Torres; Pablo,2,0,55,53
1746562062564,SOCI 115,A00,890597,Arnal; Maud Marie Leonie,28,0,45,17
1746562064616,SOCI 121,A00,890604,Pardo Guerra; Juan Pablo,38,0,45,7
1746562065641,SOCI 126,A01,890608,Staff,8,0,10,2
1746562066665,SOCI 127,A00,890609,Staff,18,0,30,12
1746562067692,SOCI 131,A00,890610,Thorpe; Charles Robert,37,0,45,8
1746562068719,SOCI 135,A00,890615,Payne; Christine Anna,13,0,45,32
1746562069745,SOCI 139,A00,890620,Staff,38,0,45,7
1746562070772,SOCI 148E,A00,890622,Calderon-Zaks; Michael Aar,36,0,45,9
1746562071795,SOCI 150,A00,890623,Kohler; Kristopher M.,31,0,45,14
1746562072820,SOCI 157,A00,890625,Jules-Rosette; Bennetta W.,18,0,20,2
1746562073850,SOCI 160,A00,890627,Payne; Christine Anna,21,0,45,24
1746562074875,SYN 1,A00,886855,Fish; Gwendolyn Anne,0,0,0,0
1746562074875,SYN 1,B00,906086,Fish; Gwendolyn Anne,0,1,0,2
1746562075902,SYN 2R,A00,886860,Staff,0,17,15,15
1746562075902,SYN 2R,B00,906106,Atkinson; Arthur Laird,0,16,15,15
1746562076928,SYN 100,A01,886866,Browne; Emily,0,28,20,20
1746562076928,SYN 100,B01,906128,Rock; Martin,0,5,20,20
1746562076928,SYN 100,C01,906140,Deavenport; James Cary,0,3,20,20
1746562076928,SYN 100,D01,907816,Deavenport; James Cary,0,5,20,20
1746562077956,TDAC 1,A00,890286,Walsh; Kim C.,8,0,20,12
1746562078981,TDAC 101,A00,890296,Basso; Beatrice,15,0,20,5
1746562080010,TDDE 131,A00,890297,Staff,47,0,50,3
1746562081038,TDDM 1,A00,890287,Weinberg; Sadie,25,0,30,5
1746562082065,TDGE 11,A00,890288,Fulton; Julia,137,0,200,63
1746562082065,TDGE 11,B00,890289,Castro; Robert Jess,184,0,200,16
1746562083090,TDGE 25,B00,957359,Walsh; Kim C.,3,0,20,17
1746562084115,TDGE 40,A01,890292,Power; Jade Yukana,27,0,30,3
1746562085138,TDGE 124,A00,890298,Havis; Allan,0,1,50,50
1746562086168,TDGE 131R,A00,890299,Burelle; Julie Sara Veronique,15,0,42,27
1746562087192,TDHT 101,A00,890300,Staff,10,0,20,10
1746562088219,TDHT 109,A01,890302,Anderson; Mysia Anyse,31,0,40,9
1746562089246,TDMV 1,A00,890293,Arcidiacono; Kristin,18,0,30,12
1746562090273,TDMV 2,A00,890294,Weinberg; Sadie,23,0,30,7
1746562091298,TDMV 3,A00,957878,Arcidiacono; Kristin,28,0,30,2
1746562093351,TDMV 138,A00,890304,Jun; Grace Shin Hae,25,0,40,15
1746562094377,TDMV 140,A00,890305,Corrales; Joseph Bernales,25,0,30,5
1746562095402,TDMV 142,A00,890307,Caligagan; Tony,32,0,40,8
1746562096429,TDMV 144,A00,890308,Camaya; Michelle Ann,25,0,30,5
1746562097454,TDPW 1,A00,890295,Stein; Deborah Isobel,3,0,20,17
1746562098484,USP 2,A01,890272,Lerner; Amy M,6,0,20,14
1746562099509,USP 3,A01,890274,Staff,12,0,30,18
1746562100534,USP 15,A01,890276,Sun; Feiyang,16,0,30,14
1746562101563,USP 25,A00,890277,Shenkman; Michael Thomas,19,0,25,6
1746562102588,USP 138,A00,890278,Staff,14,0,25,11
1746562103615,USP 143,A00,890279,Staff,22,0,70,48
1746562104641,USP 144,A00,890280,Chowdhury; Muhammed Zohir,16,0,30,14
1746562105665,USP 150,A00,890281,Boomhower; Matthew Charles,4,0,30,26
1746562106692,USP 151,A00,890282,Staff,16,0,20,4
1746562107717,USP 162,A00,890283,Andrews; Abigail Leslie,16,0,20,4
1746562108741,USP 168,A00,920477,Kwak; Nancy,0,0,5,5
1746562109768,USP 181,A00,890284,Staff,3,0,20,17
1746562110797,USP 191A,A00,890285,Staff,12,0,20,8
1746562111821,VIS 101,A00,886512,Staff,26,0,75,49
1746562112849,VIS 103,A00,886513,Cruz; Edwin Teddy,61,0,75,14
1746562113875,VIS 108,A00,886514,Staff,3,0,15,12
1746562114900,VIS 127P,A00,886515,Shen; Kuiyi,80,0,146,66
1746562115925,VIS 149,A00,886516,Yoldas; Pinar,0,0,15,15
1746562116949,VIS 164,A00,886526,Erdmann; Dean,19,0,22,3
1746562117988,VIS 194S,A00,886527,Staff,61,0,75,14
1746562119013,WCWP 10A,C00,886484,Martiniuk; Jill,12,0,15,3
1746562120044,WCWP 10B,A00,886490,Uriarte; Emma,0,0,15,15
1746562120044,WCWP 10B,B00,886491,Dhir; Simrita,10,0,15,5
1746562120044,WCWP 10B,C00,886492,Ornelas; Tricia,0,0,15,15
1746562121068,WCWP 100,A00,886494,Young; Mark T,0,6,15,15
1746562123161,AAS 10,A01,886199,Childs; Dennis R.,0,3,0,0
1746562124187,ANAR 104,A01,886940,Shtienberg; Gilad,27,0,30,3
1746562125212,ANAR 120,A00,886953,Staff,12,0,20,8
1746562126237,ANBI 148,A01,886955,Wilder; Linnea Lorene,30,0,40,10
1746562128290,ANSC 122,A00,886957,Staff,25,0,30,5
1746562129315,ANSC 150,A00,886958,Sloane; Julia Kathryn,2,0,15,13
1746562130342,ANSC 156,A00,886959,Jenkins; Janis A.,0,1,15,15
1746562131373,ANSC 180,A00,886960,Staff,11,0,17,6
1746562132407,ANSC 188,A00,886961,Jassal; Aftab,9,0,25,16
1746562133431,ANSC 190,A00,886962,Jassal; Aftab,14,0,25,11
1746562134455,ANSC 191,A00,886963,Staff,18,0,20,2
1746562135480,ANTH 3,A01,891689,Staff,17,0,20,3
1746562136505,ANTH 5,A00,886933,Semendeferi; Ekaterini,16,0,20,4
1746562137530,ANTH 10,A00,886934,Staff,0,12,30,30
1746562138555,ANTH 21,A01,886936,Staff,40,0,60,20
1746562139582,ANTH 23,A01,886938,Staff,92,0,100,8
1746562140608,ANTH 105,A00,886964,Stewart; Alexander B,84,0,100,16
1746562141633,ANTH 108,A00,886965,Pedersen; David,9,0,20,11
1746562142658,AWP 10,001,886147,Staff,0,0,0,0
1746562142658,AWP 10,002,886148,Staff,0,0,0,0
1746562142658,AWP 10,003,886149,Staff,0,0,0,0
1746562142658,AWP 10,004,886150,Staff,0,0,0,0
1746562142658,AWP 10,005,886151,Staff,0,0,0,0
1746562142658,AWP 10,006,886152,Staff,0,0,0,0
1746562142658,AWP 10,007,886153,Staff,0,0,0,0
1746562142658,AWP 10,008,886154,Staff,0,0,0,0
1746562142658,AWP 10,009,886155,Staff,0,0,0,0
1746562142658,AWP 10,010,886156,Staff,0,0,0,0
1746562142658,AWP 10,011,886158,Staff,0,0,0,0
1746562142658,AWP 10,012,886160,Staff,0,0,0,0
1746562142658,AWP 10,013,886161,Staff,0,0,0,0
1746562142658,AWP 10,014,886162,Staff,0,0,0,0
1746562142658,AWP 10,015,886163,Staff,0,0,0,0
1746562142658,AWP 10,016,886164,Staff,0,0,0,0
1746562142658,AWP 10,017,886165,Staff,0,0,0,0
1746562142658,AWP 10,018,886166,Staff,0,0,0,0
1746562142658,AWP 10,019,886168,Staff,0,0,0,0
1746562142658,AWP 10,020,886170,Staff,0,0,0,0
1746562142658,AWP 10,021,886172,Staff,0,0,0,0
1746562143687,AWP 10R,001,886173,Staff,0,1,0,0
1746562143687,AWP 10R,002,886174,Staff,0,1,0,0
1746562143687,AWP 10R,003,886175,Staff,0,0,0,0
1746562143687,AWP 10R,004,886176,Staff,0,0,0,0
1746562143687,AWP 10R,005,886177,Staff,0,0,0,0
1746562143687,AWP 10R,006,886178,Staff,0,0,0,0
1746562143687,AWP 10R,007,886179,Staff,0,0,0,0
1746562143687,AWP 10R,008,886181,Staff,0,0,0,0
1746562143687,AWP 10R,009,886182,Staff,0,0,0,0
1746562143687,AWP 10R,010,886183,Staff,0,0,0,0
1746562143687,AWP 10R,011,886184,Staff,0,0,0,0
1746562143687,AWP 10R,012,886185,Staff,0,0,0,0
1746562143687,AWP 10R,013,886186,Staff,0,0,0,0
1746562143687,AWP 10R,014,886187,Staff,0,0,0,0
1746562143687,AWP 10R,015,886188,Staff,0,0,0,0
1746562143687,AWP 10R,016,886189,Staff,0,0,0,0
1746562143687,AWP 10R,017,960532,Staff,0,0,0,0
1746562143687,AWP 10R,018,960533,Staff,0,0,0,0
1746562143687,AWP 10R,019,960534,Staff,0,0,0,0
1746562143687,AWP 10R,020,960538,Staff,0,0,0,0
1746562143687,AWP 10R,021,960540,Staff,0,0,0,0
1746562143687,AWP 10R,022,960541,Staff,0,0,0,0
1746562143687,AWP 10R,023,960542,Staff,0,0,0,0
1746562143687,AWP 10R,024,960544,Staff,0,0,0,0
1746562143687,AWP 10R,025,960545,Staff,0,0,0,0
1746562143687,AWP 10R,026,960548,Staff,0,0,0,0
1746562144717,AWP 102R,A00,886190,Staff,0,0,0,0
1746562144717,AWP 102R,B00,886191,Staff,0,0,0,0
1746562145742,BENG 100,A01,886193,Staff,17,0,30,13
1746562146767,BENG 122A,A01,886195,Hasty; Jeff M,13,0,30,17
1746562147791,BENG 166A,A00,886196,Sah; Robert Lie-Yuan,0,2,30,30
1746562148818,BENG 190,A00,958050,Khojah; Reem I,21,0,25,4
1746562149851,BIBC 102,A01,894320,Staff,0,0,46,46
1746562149851,BIBC 102,A02,894321,Staff,0,0,46,46
1746562149851,BIBC 102,A03,894344,Staff,7,0,46,39
1746562149851,BIBC 102,A04,894345,Staff,26,0,47,21
1746562150878,BICD 100R,A01,894365,Smith; Laurie,0,3,58,58
1746562150878,BICD 100R,A02,894366,Smith; Laurie,0,5,58,58
1746562150878,BICD 100R,A03,894367,Smith; Laurie,1,0,59,58
1746562150878,BICD 100R,A04,959869,Smith; Laurie,40,0,59,19
1746562151903,BICD 136,A01,894383,Gustafson-Brown; Cindy,14,0,50,36
1746562152928,BIEB 102,A01,894494,Butler; Shannon Rhey,51,0,130,79
1746562154980,BIEB 150,A01,894617,Wills; Christopher,3,0,20,17
1746562154980,BIEB 150,A02,894631,Wills; Christopher,3,0,20,17
1746562154980,BIEB 150,A03,894937,Wills; Christopher,3,0,20,17
1746562154980,BIEB 150,A04,894946,Wills; Christopher,5,0,20,15
1746562156010,BIEB 194,A00,906141,Kurle; Carolyn M.,6,0,20,14
1746562157037,BILD 1,A01,894154,Staff,3,0,19,16
1746562157037,BILD 1,A02,894155,Staff,14,0,19,5
1746562157037,BILD 1,A03,894160,Staff,13,0,19,6
1746562157037,BILD 1,A04,894161,Staff,15,0,18,3
1746562158065,BILD 2,A01,894168,Staff,0,0,50,50
1746562158065,BILD 2,A02,894169,Staff,0,0,50,50
1746562158065,BILD 2,A03,894179,Staff,0,0,50,50
1746562158065,BILD 2,A04,894203,Staff,26,0,50,24
1746562159091,BILD 3,A01,894213,Staff,22,0,31,9
1746562159091,BILD 3,A02,894214,Staff,26,0,31,5
1746562159091,BILD 3,A03,894235,Staff,28,0,31,3
1746562159091,BILD 3,A04,894236,Staff,28,0,32,4
1746562160116,BILD 4,A01,894253,Reuther; Keefe,5,0,24,19
1746562160116,BILD 4,A02,894258,Reuther; Keefe,16,0,24,8
1746562161142,BILD 5,A01,894276,Reuther; Keefe,35,0,50,15
1746562161142,BILD 5,A02,894277,Reuther; Keefe,45,0,50,5
1746562161142,BILD 5,A03,894290,Reuther; Keefe,44,0,50,6
1746562161142,BILD 5,A04,894291,Reuther; Keefe,48,0,50,2
1746562162166,BILD 24,A01,894297,Pirino; Giorgia,40,0,60,20
1746562163190,BIMM 100,B01,958915,Staff,71,0,100,29
1746562164216,BIMM 101,A01,895017,McDonnell; Lisa Marie,0,5,24,24
1746562164216,BIMM 101,A02,895018,McDonnell; Lisa Marie,0,5,24,24
1746562164216,BIMM 101,B01,895020,McDonnell; Lisa Marie,0,6,24,24
1746562164216,BIMM 101,B02,895021,McDonnell; Lisa Marie,0,4,24,24
1746562165240,BIMM 110,A01,895023,Staff,1,0,25,24
1746562165240,BIMM 110,A02,895024,Staff,9,0,25,16
1746562165240,BIMM 110,A03,895025,Staff,18,0,25,7
1746562165240,BIMM 110,A04,895031,Staff,20,0,25,5
1746562166265,BIMM 120,A01,895114,Gustafson-Brown; Cindy,14,0,28,14
1746562166265,BIMM 120,A02,895126,Gustafson-Brown; Cindy,21,0,27,6
1746562167290,BIPN 100,A01,895130,Yang; Mingyu,1,0,38,37
1746562167290,BIPN 100,A02,895131,Yang; Mingyu,32,0,38,6
1746562167290,BIPN 100,A03,895132,Yang; Mingyu,32,0,38,6
1746562167290,BIPN 100,A04,895133,Yang; Mingyu,27,0,36,9
1746562168314,BIPN 120,A01,895135,Cooke; James Edward,0,3,13,13
1746562168314,BIPN 120,A02,895136,Cooke; James Edward,0,1,13,13
1746562168314,BIPN 120,A03,895137,Cooke; James Edward,0,3,13,13
1746562168314,BIPN 120,A04,895156,Cooke; James Edward,0,2,11,11
1746562169342,BIPN 134,A01,895235,Cooke; James Edward,0,2,25,25
1746562169342,BIPN 134,A02,895237,Cooke; James Edward,0,0,25,25
1746562169342,BIPN 134,A03,895240,Cooke; James Edward,3,0,25,22
1746562169342,BIPN 134,A04,895270,Cooke; James Edward,20,0,25,5
1746562170369,BIPN 189,A00,892103,Staff,0,13,14,14
1746562172426,BISP 194,A00,958008,Staff,0,2,0,0
1746562173450,CAT 124,A01,922009,Staff,0,5,20,20
1746562174479,CAT 125R,A00,886390,Morales; Celeste Georgianna,0,2,20,20
1746562174479,CAT 125R,B00,886391,Irwin; Matthew Joseph,0,4,20,20
1746562174479,CAT 125R,C00,886392,Smith; Lauryn Alissa,0,2,20,20
1746562174479,CAT 125R,D00,886393,Vanderschuit; Maya Alysia,0,2,20,20
1746562174479,CAT 125R,E00,886394,Marchisotto; Jennifer Anne,0,3,20,20
1746562175504,CENG 15,A01,886218,Drews; Aaron,3,0,8,5
1746562176533,CENG 113,A00,886219,Opatkiewicz; Justin Paul,15,0,25,10
1746562177560,CGS 101,A00,887044,Staff,7,0,20,13
1746562178585,CGS 105,A01,887046,Staff,14,0,25,11
1746562179610,CGS 112,A00,887047,Cuong; Marisol,12,0,15,3
1746562180633,CGS 113,A00,887048,Staff,23,0,30,7
1746562181661,CGS 120,A00,887049,Staff,10,0,17,7
1746562182690,CHEM 6A,A01,886336,Lam; Tin Yiu,38,0,50,12
1746562182690,CHEM 6A,A02,886338,Lam; Tin Yiu,37,0,50,13
1746562183715,CHEM 6B,A01,886341,Hopkins; Patrycja Anna,16,0,50,34
1746562183715,CHEM 6B,A02,886343,Hopkins; Patrycja Anna,42,0,50,8
1746562184739,CHEM 6C,A01,886346,Albizati; Kim F.,0,2,50,50
1746562184739,CHEM 6C,A02,886348,Albizati; Kim F.,23,0,50,27
1746562185768,CHEM 40A,A01,886352,Klosterman; Jeremy K,65,0,100,35
1746562186794,CHEM 40B,A01,886356,Klosterman; Jeremy K,0,23,100,100
1746562187819,CHEM 41B,A01,886360,Theodorakis; Emmanuel,25,0,50,25
1746562187819,CHEM 41B,A02,886362,Theodorakis; Emmanuel,47,0,50,3
1746562188844,CHIN 165A,A00,886382,Xu; Li,18,0,20,2
1746562189869,CLAS 120,A00,886387,Myerston Santana; Jacobo,33,0,40,7
1746562190898,COGS 9,A01,886967,Shannon; Kyle Michael,42,0,60,18
1746562191922,COGS 11,A01,886969,Staff,10,0,30,20
1746562192946,COGS 14A,A01,886971,Staff,6,0,60,54
1746562193971,COGS 14B,A01,886973,Hoffman; Drew Ellen,4,0,60,56
1746562194997,COGS 18,A01,886975,Morgan; Eric,35,0,60,25
1746562196033,COGS 20,A01,886977,Staff,4,0,8,4
1746562196033,COGS 20,A02,886978,Staff,5,0,7,2
1746562197060,COGS 100,A01,907783,Staff,0,2,30,30
1746562198085,COGS 101B,A01,886980,Staff,0,3,48,48
1746562199108,COGS 101C,A01,886982,Delgado; Tania,0,5,44,44
1746562200135,COGS 102A,A01,886984,Johnson; Christine M.,4,0,30,26
1746562201159,COGS 118B,A01,886986,Staff,0,3,88,88
1746562202197,COGS 150,A01,886988,Bergen; Benjamin,22,0,50,28
1746562203223,COGS 153,A00,886989,Delgado; Tania,0,2,41,41
1746562204252,COGS 186,A01,886991,Staff,0,0,32,32
1746562205276,COGS 187A,A01,886993,Boyle; Mary E. T.,7,0,30,23
1746562206301,COGS 189,A00,886994,Staff,0,1,30,30
1746562207326,COMM 10,A01,886996,Staff,0,0,20,21
1746562207326,COMM 10,A02,886997,Staff,12,0,20,8
1746562207326,COMM 10,A03,959845,Staff,19,0,20,1
1746562208351,COMM 20,A01,886999,Leuning; Grant Maurstad,24,0,40,16
1746562210402,COMM 100A,A01,887002,Staff,0,0,20,25
1746562210402,COMM 100A,A02,887003,Staff,7,0,20,13
1746562211425,COMM 100B,A01,887005,Staff,0,8,20,24
1746562212451,COMM 106D,A00,887006,Staff,14,0,40,26
1746562213477,COMM 110G,A00,887007,Whitworth-Smith; Andrew C,12,0,40,28
1746562214507,COMM 111B,A00,887008,Staff,31,0,40,9
1746562215531,COMM 113T,A00,887009,Abuelhiga; Soraya Jill,28,0,40,12
1746562215531,COMM 113T,B00,906733,Staff,40,0,40,0
1746562216555,COMM 145,A00,887010,Staff,12,0,40,28
1746562217580,COMM 146,A00,887054,Staff,31,0,40,9
1746562218606,COMM 190,A00,887012,Staff,8,0,23,15
1746562219632,CSE 8A,A50,887015,Cao; Yingjun,57,0,85,28
1746562220657,CSE 11,A01,887017,Cao; Yingjun,12,0,70,58
1746562221682,CSE 20,A01,887019,Staff,30,0,50,20
1746562222708,CSE 21,A01,887021,Staff,78,0,100,22
1746562222708,CSE 21,B01,892583,Braun; Oliver,45,0,50,5
1746562223738,CSE 30,A01,887025,Eldon; John,143,0,200,57
1746562224765,CSE 100,A01,887027,Staff,26,0,50,24
1746562224765,CSE 100,A02,887028,Staff,42,0,50,8
1746562225792,CSE 101,A01,887030,Braun; Oliver,74,0,100,26
1746562225792,CSE 101,B01,887032,Jones; Miles E,0,3,50,50
1746562225792,CSE 101,B02,887033,Jones; Miles E,0,2,50,50
1746562226817,CSE 105,A01,908084,Jones; Miles E,32,0,50,18
1746562226817,CSE 105,A02,908087,Jones; Miles E,32,0,50,18
1746562227842,CSE 135,A01,887035,Powell; Thomas Allan,0,4,50,50
1746562228869,CSE 142,A01,887037,Staff,8,0,60,52
1746562229919,CSE 142L,A01,887039,Staff,34,0,60,26
1746562230945,CSE 151A,A01,887041,Solares; Edwin A,47,0,100,53
1746562231972,CSE 175,A01,887043,Kumar; Rakesh,30,0,30,0
1746562233005,CSS 1,A01,886389,Staff,1,1,40,39
1746562234030,DSC 30,A01,908097,Liao; Soohyun Nam,47,0,75,28
1746562235058,DSC 40A,A01,908099,Shannon; Kyle Michael,30,0,50,20
1746562236086,DSC 40B,A01,908112,Staff,16,0,50,34
1746562237113,DSC 80,A01,908116,Staff,19,0,60,41
1746562238136,DSC 197,001,956863,Eldridge; Justin Matthew,9999,0,9999,0
1746562239164,ECE 5,A01,886400,Morris; Karcher William,2,0,6,4
1746562239164,ECE 5,A02,886401,Morris; Karcher William,3,0,6,3
1746562240197,ECE 148,A01,886403,Silberman; Jack,0,14,14,14
1746562241222,ECON 1,A01,887265,Crane; Meredith Helen,12,0,70,58
1746562241222,ECON 1,B01,887268,Staff,43,0,50,7
1746562242250,ECON 2,A01,887273,Crane; Meredith Helen,55,0,70,15
1746562243274,ECON 3,A01,887279,Rondina; Giacomo,32,0,70,38
1746562244300,ECON 4,A01,887282,Anderson; John Charles,0,2,10,10
1746562245328,ECON 5,A01,887285,Staff,34,0,45,11
1746562245328,ECON 5,B01,887292,Staff,41,0,45,4
1746562246356,ECON 100A,A01,887337,Newhouse; Herbert S,54,0,70,16
1746562246356,ECON 100A,B01,887349,Staff,45,0,50,5
1746562247381,ECON 100B,A01,887361,Du; Songzi,29,0,70,41
1746562248407,ECON 100C,A01,887445,Newhouse; Herbert S,59,0,70,11
1746562249432,ECON 105,A00,887488,Vespa; Emanuel Ignacio,23,0,35,12
1746562250457,ECON 109,A01,887506,Shishkin; Denis,28,0,35,7
1746562251486,ECON 110A,A01,887568,Alon; Titan Michael,0,3,35,35
1746562251486,ECON 110A,B01,907601,Alon; Titan Michael,20,0,35,15
1746562252512,ECON 110B,A01,887598,Levkoff; Steven B.,0,24,70,70
1746562253539,ECON 112,A00,887599,Rondina; Giacomo,19,0,35,16
1746562254568,ECON 120A,A01,887603,Dai; Yinlin,35,0,70,35
1746562255594,ECON 120C,A01,887608,Sun; Yixiao,0,1,35,35
1746562255594,ECON 120C,B01,887614,Sun; Yixiao,0,0,35,35
1746562256618,ECON 138,A00,887621,Bharadwaj; Prashant,0,21,20,20
1746562257647,ECON 144,A00,958007,Squires; Dale E,13,0,35,22
1746562258671,ECON 171,A01,907666,Staff,18,0,35,17
1746562259696,ECON 175,A00,887626,Wu; Pak Yeung,23,0,35,12
1746562260723,ECON 190,A00,887640,Vespa; Emanuel Ignacio,23,0,35,12
1746562261756,EDS 25,A01,888197,Staff,0,0,0,0
1746562261756,EDS 25,A02,888209,Staff,0,0,0,0
1746562261756,EDS 25,A03,888210,Staff,0,0,0,0
1746562261756,EDS 25,A04,888212,Staff,0,0,0,0
1746562261756,EDS 25,A05,888213,Staff,0,0,0,0
1746562261756,EDS 25,A06,888214,Staff,0,0,0,0
1746562261756,EDS 25,A07,888235,Staff,0,2,0,0
1746562261756,EDS 25,A08,888236,Staff,0,0,0,0
1746562261756,EDS 25,A09,888240,Staff,0,0,0,0
1746562261756,EDS 25,A10,888244,Staff,0,0,0,0
1746562261756,EDS 25,B01,888273,Staff,0,0,0,0
1746562261756,EDS 25,B02,888285,Staff,0,0,0,0
1746562261756,EDS 25,B03,888423,Staff,0,0,0,1
1746562261756,EDS 25,B04,888432,Staff,0,0,0,0
1746562261756,EDS 25,B05,888433,Staff,0,0,0,0
1746562261756,EDS 25,B06,888467,Staff,0,0,0,0
1746562261756,EDS 25,B07,888468,Staff,0,0,0,0
1746562261756,EDS 25,B08,888479,Staff,0,0,0,0
1746562261756,EDS 25,B09,888484,Staff,0,0,0,0
1746562261756,EDS 25,B10,888487,Staff,0,0,0,0
1746562262780,EDS 38,A01,907700,Choi; Bailey Miyeon,30,0,30,0
1746562263807,EDS 112,A01,888601,Chapman; Thandeka K,13,0,40,27
1746562264835,EDS 115,A00,888697,Mendez; Kathrina Mendoza,10,0,30,20
1746562265862,EDS 116,A01,888893,Staff,35,0,40,5
1746562267916,EDS 124AR,A00,889133,Staff,29,0,50,21
1746562267916,EDS 124AR,B00,907471,Simon; Elizabeth A,37,0,50,13
1746562268945,EDS 124BR,A00,889134,Simon; Elizabeth A,44,0,100,56
1746562269973,EDS 125,A00,889135,Staff,25,0,30,5
1746562271002,EDS 126,A01,889138,Staff,36,0,40,4
1746562272029,EDS 164R,A01,889142,Wishard Guerra; Alison G.,33,0,50,17
1746562273058,ENG 30,A01,886396,Staff,0,0,0,0
1746562273058,ENG 30,B01,886398,Staff,0,0,0,0
1746562274080,ENVR 102,A00,906150,Montejo; Carolina,23,0,25,2
1746562275106,ETHN 103A,A00,887236,Man; Simeon S,0,3,0,0
1746562276131,ETHN 113,A00,887239,Staff,16,0,30,14
1746562277158,ETHN 116,A00,887240,Staff,16,0,25,9
1746562278186,ETHN 117,A00,887241,Choi; Esther Min,28,0,30,2
1746562279214,ETHN 118,A00,887243,Staff,24,0,30,6
1746562280239,ETHN 127,A00,887248,Cuong; Marisol,11,0,15,4
1746562281267,ETHN 139,A00,887250,Staff,7,0,10,3
1746562282294,ETHN 142,A00,887252,Staff,10,0,30,20
1746562283318,ETHN 161,A00,887253,Browne; Errol Tsekani,24,0,30,6
1746562284342,ETHN 163FR,A00,887255,Burelle; Julie Sara Veronique,0,0,5,5
1746562285367,GLBH 20,A00,889149,Elwardani; Nile Regina,8,0,42,34
1746562287423,GLBH 111,A01,889152,Burgos; Jose L.,17,0,17,0
1746562288447,GLBH 150,A00,889181,Sloane; Julia Kathryn,0,5,15,15
1746562290499,HDS 60,A01,886406,Warstadt; Melissa Fawn,73,0,80,7
1746562291525,HIAF 111,A00,889324,Gyamfi; Bright,25,0,32,7
1746562292552,HIEA 131,A00,889328,Staff,15,0,32,17
1746562293580,HIEA 144,A00,889333,Henry; Todd A.,26,0,32,6
1746562294605,HIEA 154,A00,889336,Henry; Todd A.,24,0,32,8
1746562295631,HIEU 106,A00,889339,Staff,22,0,32,10
1746562297685,HIEU 114,A00,889340,Staff,3,0,32,29
1746562298710,HIEU 135GS,A00,889342,Patterson; Patrick H.,0,0,1,24
1746562299737,HIEU 137,A00,889343,Edington; Claire Ellen,9,0,25,16
1746562300761,HIEU 148,A00,889345,Staff,14,0,32,18
1746562301788,HIEU 154,A00,889346,Biess; Frank Peter,21,0,32,11
1746562302812,HILA 102,A00,889351,Staff,12,0,32,20
1746562303840,HILD 2A,A01,889221,Lewandoski; Julia Mavis,1,10,32,31
1746562304865,HILD 7B,A01,889225,Man; Simeon S,0,12,32,32
1746562305891,HILD 7C,A01,889288,Alvarez; Luis A,0,14,32,32
1746562306918,HILD 30,A01,889323,Staff,0,5,32,32
1746562308971,HISC 119,A00,889383,Golan; Tal,20,0,32,12
1746562309998,HIUS 103,A00,889384,Man; Simeon S,0,0,32,32
1746562311024,HIUS 117,A00,919797,Kwak; Nancy,18,0,32,14
1746562312049,HIUS 142A,A00,919788,Staff,22,0,32,10
1746562314101,HIUS 149,A00,889386,Gyamfi; Bright,27,0,32,5
1746562315128,HIUS 155,A00,889387,Alvarez; Luis A,14,0,32,18
1746562316156,HUM 3,A01,886499,Caldwell; Michael Alan,19,0,50,31
1746562317181,HUM 3GS,A00,886500,Rodriguez; Bretton Sigfred,0,0,0,28
1746562318206,HUM 3R,A01,886502,Markman; Kristina,0,36,50,50
1746562319232,HUM 4,A01,886504,Crum; Matthew Stephen,24,0,50,26
1746562319232,HUM 4,B01,886506,West; Geoffrey Scott,17,0,50,33
1746562320257,HUM 4GS,A00,886507,Staff,0,0,0,19
1746562321280,HUM 5,A01,886509,Staff,32,0,50,18
1746562322305,HUM 5R,A01,886511,Zavodny; Tatiana Sophia,0,39,50,50
1746562323331,JAPN 180,A00,886407,Staff,17,0,40,23
1746562324354,LATI 50,A01,886409,Martin-Cabrera; Luis,4,0,22,18
1746562324354,LATI 50,A02,886410,Martin-Cabrera; Luis,19,0,22,3
1746562324354,LATI 50,A03,886411,Martin-Cabrera; Luis,21,0,22,1
1746562324354,LATI 50,A04,886412,Martin-Cabrera; Luis,9,0,22,13
1746562325378,LAWS 101,A00,907664,Staff,28,0,60,32
1746562326402,LIAB 1A,A00,889388,Saab; Dima,17,0,20,3
1746562327430,LIAB 1AX,A00,889389,El Cheddadi; Youniss,18,0,20,2
1746562328455,LIFR 1C,A00,889391,Van Moer; Vinciane G,8,0,20,12
1746562329484,LIFR 1CX,A00,889392,Van Moer; Vinciane G,7,0,20,13
1746562330509,LIFR 1D,A00,889393,Van Moer; Vinciane G,7,0,20,13
1746562331541,LIFR 1DX,A00,889394,Van Moer; Vinciane G,8,0,20,12
1746562332570,LIGN 7,A00,886923,Staff,24,0,50,26
1746562333595,LIGN 17,A00,886924,Kehler; Andrew Scott,125,0,150,25
1746562334620,LTAM 110,A00,889395,Staff,15,0,30,15
1746562335647,LTAM 110GS,A00,958010,Rodriguez; Bretton Sigfred,0,0,0,28
1746562336690,LTCH 101,A00,889397,Staff,23,0,25,2
1746562337720,LTCS 130,A00,889398,Staff,23,0,25,2
1746562338745,LTEA 138,A00,889399,Staff,24,0,40,16
1746562339769,LTEN 149,A00,889400,Wesling; Megan E.,0,3,25,25
1746562340798,LTEN 169,A00,889401,Staff,20,0,25,5
1746562341822,LTEN 180,A00,889402,Staff,10,0,15,5
1746562342847,LTEN 181,A00,889403,Staff,21,0,25,4
1746562343873,LTWL 100,A00,889404,Myerston Santana; Jacobo,2,0,25,23
1746562344901,LTWL 180GS,A00,889405,Staff,0,0,20,20
1746562345926,LTWL 181,A00,889406,Staff,16,0,25,9
1746562346954,LTWL 184,A00,889475,Mukherjee; Silpa,22,0,25,3
1746562347980,LTWR 102C,A00,889486,Staff,29,0,30,1
1746562349006,LTWR 115W,A00,889491,Staff,0,2,15,15
1746562350033,MAE 8,A01,886905,Staff,0,2,0,0
1746562351059,MAE 11,A00,886906,Bandaru; Prabhakar,0,7,50,50
1746562352084,MAE 20,A00,886907,Evdokimenko; Ekaterina,43,0,70,27
1746562353112,MAE 30B,A00,886909,Ghazinejad; Maziar,26,0,45,19
1746562354138,MAE 101B,A00,886910,Saintillan; David,29,0,45,16
1746562355166,MAE 105,A00,886911,Bandaru; Prabhakar,18,0,50,32
1746562356195,MAE 107,B00,958024,Staff,8,0,50,42
1746562357221,MAE 143B,A00,886913,Bewley; Thomas R,6,0,40,34
1746562358246,MAE 148,A01,886915,Silberman; Jack,0,3,14,14
1746562359272,MAE 160,A00,886916,Evdokimenko; Ekaterina,32,0,60,28
1746562360296,MATH 3C,A01,889681,Staff,0,2,30,30
1746562360296,MATH 3C,A02,960048,Staff,24,0,30,6
1746562361322,MATH 10A,A01,889760,Staff,26,0,30,4
1746562361322,MATH 10A,A02,889783,Staff,29,0,30,1
1746562362348,MATH 10B,A01,889785,Verstraete; Jacques Allan,2,0,35,33
1746562362348,MATH 10B,A02,889795,Verstraete; Jacques Allan,4,0,35,31
1746562362348,MATH 10B,B01,889797,Verstraete; Jacques Allan,3,0,35,32
1746562362348,MATH 10B,B02,889828,Verstraete; Jacques Allan,3,0,35,32
1746562363374,MATH 10C,A01,889849,Habib; Yousaf,8,0,30,22
1746562363374,MATH 10C,A02,889852,Habib; Yousaf,14,0,30,16
1746562363374,MATH 10C,A03,889853,Habib; Yousaf,22,0,30,8
1746562363374,MATH 10C,A04,889858,Habib; Yousaf,20,0,30,10
1746562363374,MATH 10C,B01,889861,Staff,1,0,30,29
1746562363374,MATH 10C,B02,889862,Staff,24,0,30,6
1746562363374,MATH 10C,B03,889863,Staff,27,0,30,3
1746562363374,MATH 10C,B04,889967,Staff,23,0,30,7
1746562364401,MATH 18,A01,889974,Staff,7,0,30,23
1746562364401,MATH 18,A02,889977,Staff,20,0,30,10
1746562364401,MATH 18,B01,889984,Hardiman; Liam,21,0,30,9
1746562364401,MATH 18,B02,889985,Hardiman; Liam,25,0,30,5
1746562365426,MATH 20A,A01,889990,Suk; Andrew Hoon,30,0,35,5
1746562366454,MATH 20B,A01,889993,Ohm; Ko Woon,22,0,30,8
1746562366454,MATH 20B,A02,889994,Ohm; Ko Woon,30,0,30,0
1746562366454,MATH 20B,B01,889996,Ohm; Ko Woon,21,0,30,9
1746562366454,MATH 20B,B02,889997,Ohm; Ko Woon,23,0,30,7
1746562367479,MATH 20C,A01,889999,Hammock; Frances H,17,0,30,13
1746562367479,MATH 20C,A02,890003,Hammock; Frances H,23,0,30,7
1746562367479,MATH 20C,B01,890006,Hammock; Frances H,3,0,30,27
1746562367479,MATH 20C,B02,890007,Hammock; Frances H,11,0,30,19
1746562368505,MATH 20D,A01,890011,Cheng; Hsiao-Bing,1,1,30,29
1746562368505,MATH 20D,A02,890012,Cheng; Hsiao-Bing,14,0,30,16
1746562368505,MATH 20D,B01,890016,Cheng; Hsiao-Bing,13,0,30,17
1746562368505,MATH 20D,B02,890017,Cheng; Hsiao-Bing,13,0,30,17
1746562369534,MATH 20E,A01,890026,Harel; Guershon,1,0,30,29
1746562369534,MATH 20E,A02,890029,Harel; Guershon,23,0,30,7
1746562369534,MATH 20E,B01,890033,Harel; Guershon,7,0,30,23
1746562369534,MATH 20E,B02,890101,Harel; Guershon,21,0,30,9
1746562370559,MATH 102,A01,890104,Staff,17,0,30,13
1746562370559,MATH 102,A02,890105,Staff,27,0,30,3
1746562371590,MATH 103B,A01,890116,Salehi Golsefidy; Alireza,3,0,30,27
1746562371590,MATH 103B,B01,890118,Staff,0,3,34,34
1746562372618,MATH 109,A01,890121,Aliabadi Sr.; Mohsen,1,0,30,29
1746562372618,MATH 109,B01,890124,Upadrashta; Pranav Kumar,18,0,30,12
1746562373648,MATH 120A,A01,890126,Eggers; John Dietrich,13,0,30,17
1746562374675,MATH 142B,A01,890128,Ioana; Adrian,19,0,30,11
1746562374675,MATH 142B,A02,890129,Ioana; Adrian,13,0,30,17
1746562375702,MATH 154,A01,890174,Staff,0,0,30,30
1746562375702,MATH 154,A02,890182,Staff,0,0,30,30
1746562376730,MATH 168A,A01,890197,Dumitriu; Ioana,21,0,35,14
1746562377756,MATH 170A,A01,890240,Nie; Jiawang,1,0,30,29
1746562377756,MATH 170A,A02,890241,Nie; Jiawang,11,0,30,19
1746562377756,MATH 170A,A03,890249,Nie; Jiawang,23,0,30,7
1746562378784,MATH 170B,A01,957891,Nag; Panchali,13,0,35,22
1746562380832,MATH 181A,A01,908025,Staff,0,4,35,35
1746562380832,MATH 181A,A02,960115,Staff,27,0,35,8
1746562381856,MATH 181B,A01,959874,Staff,25,0,30,5
1746562382882,MATH 193B,A01,890265,Staff,0,4,35,35
1746562383908,MGT 4,A01,890311,Anderson; John Charles,42,0,88,46
1746562384934,MGT 5,A00,907740,Staff,13,0,98,85
1746562385959,MGT 12,A00,890312,Lindenberger; Wade Douglas,67,0,98,31
1746562386985,MGT 16,A00,957883,Staff,78,0,98,20
1746562389038,MGT 45,A00,890314,Pecore; Joseph P.,46,0,98,52
1746562390065,MGT 71,A00,890315,Staff,0,11,98,98
1746562391093,MGT 100,A00,890316,Yavorsky; Daniel Ryan,44,0,98,54
1746562392117,MGT 103,A00,890317,Ehrich; Kristine R,73,0,98,25
1746562393146,MGT 105,A00,890356,Bates; Kenneth Walter,0,8,98,98
1746562394173,MGT 112,A00,890360,Ehrich; Kristine R,55,0,98,43
1746562395201,MGT 127R,A00,907732,Zhu; Kevin Xiaoguo,23,0,98,75
1746562396226,MGT 131B,A00,890361,Anderson; John Charles,60,0,98,38
1746562397254,MGT 137,A00,890362,Lindenberger; Wade Douglas,65,0,98,33
1746562398278,MGT 160,A00,890369,Johnson; Erik Barry,9,0,98,89
1746562400328,MGT 164,A00,890372,Zimmermann; Carsten,0,40,98,98
1746562401353,MGT 180,A00,890374,Bliss; Barbara Ann,12,0,98,86
1746562402377,MMW 15,A01,886414,Chang; Edmond Yi-Teh,0,12,28,28
1746562402377,MMW 15,A02,886415,Chang; Edmond Yi-Teh,0,8,28,28
1746562402377,MMW 15,A03,886416,Chang; Edmond Yi-Teh,0,8,28,28
1746562402377,MMW 15,A04,886417,Chang; Edmond Yi-Teh,0,8,28,28
1746562402377,MMW 15,B01,886419,Chang; Edmond Yi-Teh,0,7,28,28
1746562402377,MMW 15,B02,886420,Chang; Edmond Yi-Teh,0,8,28,28
1746562402377,MMW 15,B03,886421,Chang; Edmond Yi-Teh,0,7,28,28
1746562402377,MMW 15,B04,886422,Chang; Edmond Yi-Teh,0,8,28,28
1746562402377,MMW 15,C01,886424,Staff,0,9,28,28
1746562402377,MMW 15,C02,886425,Staff,0,8,28,28
1746562402377,MMW 15,C03,886426,Staff,0,8,28,28
1746562402377,MMW 15,C04,886427,Staff,0,8,28,28
1746562402377,MMW 15,C05,958038,Staff,0,8,28,28
1746562402377,MMW 15,C06,958039,Staff,0,8,28,28
1746562403404,MMW 15GS,A00,906910,Patterson; Patrick H.,4,0,28,24
1746562404433,MMW 122R,A01,886429,Rahimi; Babak,0,13,28,28
1746562404433,MMW 122R,A02,886430,Rahimi; Babak,0,12,28,28
1746562404433,MMW 122R,A03,958040,Rahimi; Babak,0,11,28,28
1746562405458,MUS 1A,A01,890937,Staff,2,0,25,23
1746562405458,MUS 1A,A02,891035,Staff,6,0,25,19
1746562405458,MUS 1A,C01,958912,Staff,24,0,25,1
1746562405458,MUS 1A,C02,958913,Staff,25,0,25,0
1746562407506,MUS 2AK,A00,957092,Ohnishi; Takae,15,0,15,0
1746562408532,MUS 4,A01,891044,Staff,2,0,25,23
1746562408532,MUS 4,A02,891045,Staff,23,0,25,2
1746562408532,MUS 4,B01,891048,Staff,17,0,25,8
1746562408532,MUS 4,B02,891050,Staff,25,0,25,0
1746562409557,MUS 5,A01,957506,Dubnov; Shlomo,0,0,25,25
1746562409557,MUS 5,A02,957622,Dubnov; Shlomo,13,0,25,12
1746562409557,MUS 5,A03,957623,Dubnov; Shlomo,20,0,25,5
1746562410583,MUS 6,A01,891053,Freitas Caetano; Marcelo,24,0,25,1
1746562410583,MUS 6,A02,891054,Freitas Caetano; Marcelo,23,0,25,2
1746562411607,MUS 7,A01,891081,Staff,0,0,25,25
1746562411607,MUS 7,A02,891082,Staff,4,0,25,21
1746562412632,MUS 8GS,A00,891118,Borgo; David Garcia,0,0,25,25
1746562413661,MUS 11,A01,891140,Staff,10,0,25,15
1746562413661,MUS 11,A02,891141,Staff,22,0,25,3
1746562414689,MUS 13,A01,891143,Staff,8,0,25,17
1746562414689,MUS 13,A02,891144,Staff,24,0,25,1
1746562415718,MUS 15,A01,891146,Staff,9,0,25,16
1746562415718,MUS 15,A02,891148,Staff,21,0,25,4
1746562415718,MUS 15,B01,891150,Staff,18,0,25,7
1746562415718,MUS 15,B02,891151,Staff,25,0,25,0
1746562416746,MUS 20,A01,891153,Staff,5,0,20,15
1746562416746,MUS 20,A02,891155,Staff,14,0,20,6
1746562417775,MUS 80,A00,891156,Staff,19,0,25,6
1746562417775,MUS 80,B00,891157,Staff,23,0,25,2
1746562418802,MUS 130,A00,891158,Ohnishi; Takae,35,0,35,0
1746562419827,MUS 150GS,A01,891160,Borgo; David Garcia,0,0,25,25
1746562420852,MUS 170,A01,891162,Freitas Caetano; Marcelo,20,0,25,5
1746562420852,MUS 170,A02,891164,Freitas Caetano; Marcelo,21,0,25,4
1746562421879,NANO 11,A00,886220,Vazquez Mena; Oscar,13,0,15,2
1746562422909,NANO 15,A01,886222,Drews; Aaron,4,0,7,3
1746562423934,NANO 104,A00,886224,Sirbuly; Donald,18,0,25,7
1746562424963,PH 40,A00,886528,Staff,23,0,40,17
1746562425987,PH 45,A01,886799,Staff,35,0,40,5
1746562427011,PH 110,A00,886802,Staff,0,7,40,40
1746562428041,PH 172,A00,906716,Staff,19,0,35,16
1746562429091,PH 191,A00,886803,Staff,6,0,40,34
1746562430116,PHIL 1,A00,889500,Staff,20,0,30,10
1746562431141,PHIL 10,A01,889549,Grush; Rick Scott,15,0,22,7
1746562431141,PHIL 10,A02,889551,Grush; Rick Scott,22,0,22,0
1746562432226,PHIL 28,A01,889559,Lamey; Andy M.,0,1,31,31
1746562432226,PHIL 28,A02,889561,Lamey; Andy M.,0,1,30,30
1746562432226,PHIL 28,A03,889572,Lamey; Andy M.,0,1,30,30
1746562433254,PHIL 35,A00,907839,Staff,13,0,15,2
1746562434279,PHIL 60,A00,889574,Staff,73,0,90,17
1746562435304,PHIL 101,A00,958004,Staff,12,0,15,3
1746562437355,PHIL 136,A00,889582,Fulkerson; Matthew Todd,26,0,45,19
1746562438380,PHIL 163,A01,889601,Staff,21,0,30,9
1746562438380,PHIL 163,B01,889606,Brandt; Reuven A,0,3,0,0
1746562439409,PHIL 164,A00,889610,Staff,16,0,30,14
1746562440433,PHIL 165,A00,889613,Staff,23,0,30,7
1746562441458,PHYS 1A,A00,886431,Staff,26,0,70,44
1746562442485,PHYS 1AL,001,886432,Tsai; Philbert S,0,2,30,30
1746562442485,PHYS 1AL,002,886436,Tsai; Philbert S,11,0,30,19
1746562443513,PHYS 1B,A00,886439,Staff,185,0,240,55
1746562444537,PHYS 1BL,001,886441,Tsai; Philbert S,0,4,30,30
1746562444537,PHYS 1BL,002,886444,Tsai; Philbert S,2,0,30,28
1746562445562,PHYS 1C,A00,896092,Arnold; Kam S,79,0,146,67
1746562446587,PHYS 1CL,001,886448,Tsai; Philbert S,0,0,30,30
1746562446587,PHYS 1CL,002,886449,Tsai; Philbert S,1,0,30,29
1746562446587,PHYS 1CL,003,886450,Tsai; Philbert S,16,0,30,14
1746562446587,PHYS 1CL,004,886451,Tsai; Philbert S,15,0,30,15
1746562447614,PHYS 2B,A01,886457,Staff,68,0,115,47
1746562448641,PHYS 2C,A01,886460,Shotwell; Brian,0,9,65,65
1746562449669,PHYS 2CL,A01,886467,Staff,0,4,28,28
1746562449669,PHYS 2CL,A02,886468,Staff,0,3,28,28
1746562450694,PHYS 2D,A01,886470,Staff,10,0,50,40
1746562451724,PHYS 4B,A01,886475,Grinstein; Benjamin,22,0,40,18
1746562452751,POLI 5,A00,891173,Desposato; Scott,7,0,25,18
1746562453777,POLI 5D,A01,891175,Staff,5,0,5,0
1746562453777,POLI 5D,B01,891178,Staff,5,0,5,0
1746562454802,POLI 11,A00,891179,Ferree; Karen E,2,0,35,33
1746562455830,POLI 12,A00,891180,Staff,16,0,30,14
1746562456856,POLI 27,A01,891182,Staff,12,0,75,63
1746562457880,POLI 30,A00,891183,Staff,8,0,50,42
1746562458908,POLI 100B,A00,891244,Staff,5,1,35,30
1746562459934,POLI 100I,A00,891247,Staff,7,0,30,23
1746562460961,POLI 104J,A00,891248,Nichter; Maysa,14,0,30,16
1746562461984,POLI 104U,A00,891250,Nichter; Maysa,2,0,30,28
1746562464034,POLI 110B,A00,891255,Wiens; David,20,0,25,5
1746562465065,POLI 112A,A00,891256,Wiens; David,6,0,25,19
1746562466090,POLI 114BR,A00,891261,Staff,19,0,30,11
1746562467113,POLI 117R,A00,891262,Forman; Fonna,0,6,50,50
1746562468137,POLI 118,A00,891264,Ingham; Sean,17,0,25,8
1746562469162,POLI 124A,A00,891265,Staff,18,0,20,2
1746562470187,POLI 125D,A00,891266,Nichter; Simeon C,2,0,25,23
1746562471213,POLI 126,A00,891268,Nichter; Simeon C,7,0,25,18
1746562472240,POLI 126AA,A00,891272,Staff,17,0,25,8
1746562473264,POLI 130AA,A00,891273,Staff,15,0,20,5
1746562474286,POLI 134AA,A00,891274,Staff,4,0,20,16
1746562476338,POLI 138,A00,891278,Staff,21,0,25,4
1746562477365,POLI 142K,A00,891280,Staff,11,0,25,14
1746562478390,POLI 142M,A00,891281,Gartzke; Erik,17,0,30,13
1746562479413,POLI 142P,A00,891284,Staff,20,0,30,10
1746562480439,POLI 143,A00,891285,Gartzke; Erik,12,0,30,18
1746562481465,POLI 153,A00,891286,Staff,19,0,20,1
1746562483515,POLI 175,A00,891290,Staff,15,0,20,5
1746562484539,PSYC 1,A00,890674,Steiner; Eric Tomas,0,11,45,45
1746562485563,PSYC 2,A00,890676,Albright; Thomas D,21,0,35,14
1746562486587,PSYC 3,A00,890679,Staff,17,0,20,3
1746562487613,PSYC 6,A00,959858,Staff,20,0,20,0
1746562488637,PSYC 60,A01,890684,Rickard; Timothy C.,0,5,45,45
1746562489666,PSYC 70,A01,890689,Geller; Emma Harlan,7,0,30,23
1746562490696,PSYC 71,A01,959860,Staff,21,0,25,4
1746562491721,PSYC 100,A00,890690,Lacefield; Katharine I,0,50,180,180
1746562492751,PSYC 102,A00,890695,Staff,18,0,40,22
1746562493780,PSYC 105,A00,890699,Geller; Emma Harlan,70,0,100,30
1746562494805,PSYC 106,A00,890701,Gorman; Michael R.,6,0,30,24
1746562495833,PSYC 108,A00,890704,Adrian; Julia Anna,0,28,50,50
1746562496861,PSYC 118,A01,890712,Staff,11,0,30,19
1746562497885,PSYC 124,A00,890716,Chapman; Eddie Nathaniel,25,0,60,35
1746562498910,PSYC 131,A00,890717,Anagnostaras; Stephan,0,7,80,80
1746562499936,PSYC 137,A00,890719,Winkielman; Piotr,0,11,30,30
1746562500964,PSYC 144,A00,890721,Adrian; Julia Anna,0,9,45,45
1746562501991,PSYC 162,A00,890805,Staff,1,0,75,74
1746562503018,PSYC 169,A00,890810,Staff,0,14,30,30
1746562504043,PSYC 172,A00,890814,Gorman; Michael R.,9,0,30,21
1746562505074,PSYC 181,A00,890818,Anagnostaras; Stephan,9,0,200,191
1746562506097,PSYC 184,A00,959861,Staff,168,0,175,7
1746562507126,PSYC 189,A00,890823,Staff,0,1,30,30
1746562508153,PSYC 191,A00,890884,Rickard; Timothy C.,0,11,35,35
1746562509178,PSYC 193,A00,890913,Staff,19,0,30,11
1746562509178,PSYC 193,B00,890914,Chapman; Eddie Nathaniel,24,0,30,6
1746562510204,PSYC 193L,A01,890918,Lowe; Angela Beth,20,0,30,10
1746562510204,PSYC 193L,B01,890921,Hurwitz; Ethan Scott,20,0,30,10
1746562510204,PSYC 193L,C01,890928,Staff,30,0,30,0
1746562511228,RELI 149,A00,886806,Rahimi; Babak,23,0,40,17
1746562512253,SE 9,A01,886814,Staff,7,0,20,13
1746562513277,SE 101B,A01,886816,Chadha; Mayank,4,0,35,31
1746562514306,SE 110B,A00,886818,Zhu; Qiang,4,0,75,71
1746562515334,SE 125,A01,886830,Staff,10,0,30,20
1746562516358,SE 130B,A01,886835,Staff,14,0,40,26
1746562517382,SE 131A,A01,886838,Krysl; Petr,34,0,55,21
1746562518407,SE 154,A00,886840,Staff,29,0,50,21
1746562519432,SE 164GS,A01,886849,Staff,6,0,20,14
1746562520463,SE 167GS,A01,886853,Staff,6,0,20,14
1746562521488,SIO 25,A01,890107,Staff,19,0,30,11
1746562522513,SIO 45,A00,890109,Cook; Geoffrey W,117,0,200,83
1746562523536,SIO 109R,A00,890110,Forman; Fonna,0,16,20,20
1746562524560,SIO 187,A01,890114,Kacev; David,15,0,40,25
1746562525589,SOCI 1,A01,890431,Thorpe; Charles Robert,15,0,30,15
1746562525589,SOCI 1,A02,890518,Thorpe; Charles Robert,30,0,30,0
1746562526616,SOCI 2,A01,957978,Staff,25,0,25,0
1746562526616,SOCI 2,A02,957979,Staff,23,0,25,2
1746562527645,SOCI 20,A01,890523,Calderon-Zaks; Michael Aar,23,0,30,7
1746562527645,SOCI 20,A02,890526,Calderon-Zaks; Michael Aar,29,0,30,1
1746562528670,SOCI 30,A01,890533,Pardo Guerra; Juan Pablo,37,0,40,3
1746562529697,SOCI 40,A01,890535,Staff,27,0,45,18
1746562530723,SOCI 104Q,A00,890559,Staff,18,0,30,12
1746562531747,SOCI 106,A00,890560,Arnal; Maud Marie Leonie,20,0,30,10
1746562532771,SOCI 110,A00,890567,Holkenbrink-Monk; Charlene,19,0,30,11
1746562533794,SOCI 112,A00,890568,Victoria Torres; Pablo,2,0,55,53
1746562534818,SOCI 115,A00,890597,Arnal; Maud Marie Leonie,28,0,45,17
1746562536869,SOCI 121,A00,890604,Pardo Guerra; Juan Pablo,38,0,45,7
1746562537894,SOCI 126,A01,890608,Staff,8,0,10,2
1746562538920,SOCI 127,A00,890609,Staff,18,0,30,12
1746562539946,SOCI 131,A00,890610,Thorpe; Charles Robert,37,0,45,8
1746562540970,SOCI 135,A00,890615,Payne; Christine Anna,13,0,45,32
1746562542000,SOCI 139,A00,890620,Staff,38,0,45,7
1746562543027,SOCI 148E,A00,890622,Calderon-Zaks; Michael Aar,36,0,45,9
1746562544051,SOCI 150,A00,890623,Kohler; Kristopher M.,31,0,45,14
1746562545078,SOCI 157,A00,890625,Jules-Rosette; Bennetta W.,18,0,20,2
1746562546104,SOCI 160,A00,890627,Payne; Christine Anna,21,0,45,24
1746562547130,SYN 1,A00,886855,Fish; Gwendolyn Anne,0,0,0,0
1746562547130,SYN 1,B00,906086,Fish; Gwendolyn Anne,0,1,0,2
1746562548155,SYN 2R,A00,886860,Staff,0,17,15,15
1746562548155,SYN 2R,B00,906106,Atkinson; Arthur Laird,0,16,15,15
1746562549181,SYN 100,A01,886866,Browne; Emily,0,28,20,20
1746562549181,SYN 100,B01,906128,Rock; Martin,0,5,20,20
1746562549181,SYN 100,C01,906140,Deavenport; James Cary,0,3,20,20
1746562549181,SYN 100,D01,907816,Deavenport; James Cary,0,5,20,20
1746562550209,TDAC 1,A00,890286,Walsh; Kim C.,8,0,20,12
1746562551235,TDAC 101,A00,890296,Basso; Beatrice,15,0,20,5
1746562552260,TDDE 131,A00,890297,Staff,47,0,50,3
1746562553290,TDDM 1,A00,890287,Weinberg; Sadie,25,0,30,5
1746562554315,TDGE 11,A00,890288,Fulton; Julia,137,0,200,63
1746562554315,TDGE 11,B00,890289,Castro; Robert Jess,184,0,200,16
1746562555340,TDGE 25,B00,957359,Walsh; Kim C.,3,0,20,17
1746562556366,TDGE 40,A01,890292,Power; Jade Yukana,27,0,30,3
1746562557393,TDGE 124,A00,890298,Havis; Allan,0,1,50,50
1746562558419,TDGE 131R,A00,890299,Burelle; Julie Sara Veronique,15,0,42,27
1746562559446,TDHT 101,A00,890300,Staff,10,0,20,10
1746562560472,TDHT 109,A01,890302,Anderson; Mysia Anyse,31,0,40,9
1746562561502,TDMV 1,A00,890293,Arcidiacono; Kristin,18,0,30,12
1746562562529,TDMV 2,A00,890294,Weinberg; Sadie,23,0,30,7
1746562563554,TDMV 3,A00,957878,Arcidiacono; Kristin,28,0,30,2
1746562565603,TDMV 138,A00,890304,Jun; Grace Shin Hae,25,0,40,15
1746562566632,TDMV 140,A00,890305,Corrales; Joseph Bernales,25,0,30,5
1746562567660,TDMV 142,A00,890307,Caligagan; Tony,32,0,40,8
1746562568687,TDMV 144,A00,890308,Camaya; Michelle Ann,25,0,30,5
1746562569713,TDPW 1,A00,890295,Stein; Deborah Isobel,3,0,20,17
1746562570743,USP 2,A01,890272,Lerner; Amy M,6,0,20,14
1746562571772,USP 3,A01,890274,Staff,12,0,30,18
1746562572797,USP 15,A01,890276,Sun; Feiyang,16,0,30,14
1746562573822,USP 25,A00,890277,Shenkman; Michael Thomas,19,0,25,6
1746562574853,USP 138,A00,890278,Staff,14,0,25,11
1746562575881,USP 143,A00,890279,Staff,22,0,70,48
1746562576910,USP 144,A00,890280,Chowdhury; Muhammed Zohir,16,0,30,14
1746562577936,USP 150,A00,890281,Boomhower; Matthew Charles,4,0,30,26
1746562578963,USP 151,A00,890282,Staff,16,0,20,4
1746562579988,USP 162,A00,890283,Andrews; Abigail Leslie,16,0,20,4
1746562581013,USP 168,A00,920477,Kwak; Nancy,0,0,5,5
1746562582041,USP 181,A00,890284,Staff,3,0,20,17
1746562583068,USP 191A,A00,890285,Staff,12,0,20,8
1746562584097,VIS 101,A00,886512,Staff,26,0,75,49
1746562585122,VIS 103,A00,886513,Cruz; Edwin Teddy,61,0,75,14
1746562586147,VIS 108,A00,886514,Staff,3,0,15,12
1746562587176,VIS 127P,A00,886515,Shen; Kuiyi,80,0,146,66
1746562588204,VIS 149,A00,886516,Yoldas; Pinar,0,0,15,15
1746562589233,VIS 164,A00,886526,Erdmann; Dean,19,0,22,3
1746562590259,VIS 194S,A00,886527,Staff,61,0,75,14
1746562591285,WCWP 10A,C00,886484,Martiniuk; Jill,12,0,15,3
1746562592311,WCWP 10B,A00,886490,Uriarte; Emma,0,0,15,15
1746562592311,WCWP 10B,B00,886491,Dhir; Simrita,10,0,15,5
1746562592311,WCWP 10B,C00,886492,Ornelas; Tricia,0,0,15,15
1746562593341,WCWP 100,A00,886494,Young; Mark T,0,6,15,15
1746562595491,AAS 10,A01,886199,Childs; Dennis R.,0,3,0,0
1746562596515,ANAR 104,A01,886940,Shtienberg; Gilad,27,0,30,3
1746562597540,ANAR 120,A00,886953,Staff,12,0,20,8
1746562598565,ANBI 148,A01,886955,Wilder; Linnea Lorene,30,0,40,10
1746562600616,ANSC 122,A00,886957,Staff,25,0,30,5
1746562601644,ANSC 150,A00,886958,Sloane; Julia Kathryn,2,0,15,13
1746562602692,ANSC 156,A00,886959,Jenkins; Janis A.,0,1,15,15
1746562603716,ANSC 180,A00,886960,Staff,11,0,17,6
1746562604743,ANSC 188,A00,886961,Jassal; Aftab,9,0,25,16
1746562605767,ANSC 190,A00,886962,Jassal; Aftab,14,0,25,11
1746562606794,ANSC 191,A00,886963,Staff,18,0,20,2
1746562607818,ANTH 3,A01,891689,Staff,17,0,20,3
1746562608843,ANTH 5,A00,886933,Semendeferi; Ekaterini,16,0,20,4
1746562609866,ANTH 10,A00,886934,Staff,0,12,30,30
1746562610891,ANTH 21,A01,886936,Staff,41,0,60,19
1746562611914,ANTH 23,A01,886938,Staff,92,0,100,8
1746562612938,ANTH 105,A00,886964,Stewart; Alexander B,84,0,100,16
1746562613964,ANTH 108,A00,886965,Pedersen; David,9,0,20,11
1746562614999,AWP 10,001,886147,Staff,0,0,0,0
1746562614999,AWP 10,002,886148,Staff,0,0,0,0
1746562614999,AWP 10,003,886149,Staff,0,0,0,0
1746562614999,AWP 10,004,886150,Staff,0,0,0,0
1746562614999,AWP 10,005,886151,Staff,0,0,0,0
1746562614999,AWP 10,006,886152,Staff,0,0,0,0
1746562614999,AWP 10,007,886153,Staff,0,0,0,0
1746562614999,AWP 10,008,886154,Staff,0,0,0,0
1746562614999,AWP 10,009,886155,Staff,0,0,0,0
1746562614999,AWP 10,010,886156,Staff,0,0,0,0
1746562614999,AWP 10,011,886158,Staff,0,0,0,0
1746562614999,AWP 10,012,886160,Staff,0,0,0,0
1746562614999,AWP 10,013,886161,Staff,0,0,0,0
1746562614999,AWP 10,014,886162,Staff,0,0,0,0
1746562614999,AWP 10,015,886163,Staff,0,0,0,0
1746562614999,AWP 10,016,886164,Staff,0,0,0,0
1746562614999,AWP 10,017,886165,Staff,0,0,0,0
1746562614999,AWP 10,018,886166,Staff,0,0,0,0
1746562614999,AWP 10,019,886168,Staff,0,0,0,0
1746562614999,AWP 10,020,886170,Staff,0,0,0,0
1746562614999,AWP 10,021,886172,Staff,0,0,0,0
1746562616037,AWP 10R,001,886173,Staff,0,1,0,0
1746562616037,AWP 10R,002,886174,Staff,0,1,0,0
1746562616037,AWP 10R,003,886175,Staff,0,0,0,0
1746562616037,AWP 10R,004,886176,Staff,0,0,0,0
1746562616037,AWP 10R,005,886177,Staff,0,0,0,0
1746562616037,AWP 10R,006,886178,Staff,0,0,0,0
1746562616037,AWP 10R,007,886179,Staff,0,0,0,0
1746562616037,AWP 10R,008,886181,Staff,0,0,0,0
1746562616037,AWP 10R,009,886182,Staff,0,0,0,0
1746562616037,AWP 10R,010,886183,Staff,0,0,0,0
1746562616037,AWP 10R,011,886184,Staff,0,0,0,0
1746562616037,AWP 10R,012,886185,Staff,0,0,0,0
1746562616037,AWP 10R,013,886186,Staff,0,0,0,0
1746562616037,AWP 10R,014,886187,Staff,0,0,0,0
1746562616037,AWP 10R,015,886188,Staff,0,0,0,0
1746562616037,AWP 10R,016,886189,Staff,0,0,0,0
1746562616037,AWP 10R,017,960532,Staff,0,0,0,0
1746562616037,AWP 10R,018,960533,Staff,0,0,0,0
1746562616037,AWP 10R,019,960534,Staff,0,0,0,0
1746562616037,AWP 10R,020,960538,Staff,0,0,0,0
1746562616037,AWP 10R,021,960540,Staff,0,0,0,0
1746562616037,AWP 10R,022,960541,Staff,0,0,0,0
1746562616037,AWP 10R,023,960542,Staff,0,0,0,0
1746562616037,AWP 10R,024,960544,Staff,0,0,0,0
1746562616037,AWP 10R,025,960545,Staff,0,0,0,0
1746562616037,AWP 10R,026,960548,Staff,0,0,0,0
1746562617066,AWP 102R,A00,886190,Staff,0,0,0,0
1746562617066,AWP 102R,B00,886191,Staff,0,0,0,0
1746562618091,BENG 100,A01,886193,Staff,17,0,30,13
1746562619118,BENG 122A,A01,886195,Hasty; Jeff M,13,0,30,17
1746562620149,BENG 166A,A00,886196,Sah; Robert Lie-Yuan,0,2,30,30
1746562621175,BENG 190,A00,958050,Khojah; Reem I,21,0,25,4
1746562622202,BIBC 102,A01,894320,Staff,0,0,46,46
1746562622202,BIBC 102,A02,894321,Staff,0,0,46,46
1746562622202,BIBC 102,A03,894344,Staff,7,0,46,39
1746562622202,BIBC 102,A04,894345,Staff,26,0,47,21
1746562623227,BICD 100R,A01,894365,Smith; Laurie,0,3,58,58
1746562623227,BICD 100R,A02,894366,Smith; Laurie,0,5,58,58
1746562623227,BICD 100R,A03,894367,Smith; Laurie,1,0,59,58
1746562623227,BICD 100R,A04,959869,Smith; Laurie,40,0,59,19
1746562624253,BICD 136,A01,894383,Gustafson-Brown; Cindy,14,0,50,36
1746562625279,BIEB 102,A01,894494,Butler; Shannon Rhey,51,0,130,79
1746562627328,BIEB 150,A01,894617,Wills; Christopher,3,0,20,17
1746562627328,BIEB 150,A02,894631,Wills; Christopher,3,0,20,17
1746562627328,BIEB 150,A03,894937,Wills; Christopher,3,0,20,17
1746562627328,BIEB 150,A04,894946,Wills; Christopher,5,0,20,15
1746562628354,BIEB 194,A00,906141,Kurle; Carolyn M.,6,0,20,14
1746562629379,BILD 1,A01,894154,Staff,3,0,19,16
1746562629379,BILD 1,A02,894155,Staff,14,0,19,5
1746562629379,BILD 1,A03,894160,Staff,13,0,19,6
1746562629379,BILD 1,A04,894161,Staff,15,0,18,3
1746562630402,BILD 2,A01,894168,Staff,0,0,50,50
1746562630402,BILD 2,A02,894169,Staff,0,0,50,50
1746562630402,BILD 2,A03,894179,Staff,0,0,50,50
1746562630402,BILD 2,A04,894203,Staff,26,0,50,24
1746562631428,BILD 3,A01,894213,Staff,22,0,31,9
1746562631428,BILD 3,A02,894214,Staff,26,0,31,5
1746562631428,BILD 3,A03,894235,Staff,28,0,31,3
1746562631428,BILD 3,A04,894236,Staff,28,0,32,4
1746562632453,BILD 4,A01,894253,Reuther; Keefe,5,0,24,19
1746562632453,BILD 4,A02,894258,Reuther; Keefe,16,0,24,8
1746562633479,BILD 5,A01,894276,Reuther; Keefe,35,0,50,15
1746562633479,BILD 5,A02,894277,Reuther; Keefe,45,0,50,5
1746562633479,BILD 5,A03,894290,Reuther; Keefe,44,0,50,6
1746562633479,BILD 5,A04,894291,Reuther; Keefe,48,0,50,2
1746562634506,BILD 24,A01,894297,Pirino; Giorgia,40,0,60,20
1746562635533,BIMM 100,B01,958915,Staff,71,0,100,29
1746562636561,BIMM 101,A01,895017,McDonnell; Lisa Marie,0,5,24,24
1746562636561,BIMM 101,A02,895018,McDonnell; Lisa Marie,0,5,24,24
1746562636561,BIMM 101,B01,895020,McDonnell; Lisa Marie,0,6,24,24
1746562636561,BIMM 101,B02,895021,McDonnell; Lisa Marie,0,4,24,24
1746562637586,BIMM 110,A01,895023,Staff,1,0,25,24
1746562637586,BIMM 110,A02,895024,Staff,9,0,25,16
1746562637586,BIMM 110,A03,895025,Staff,18,0,25,7
1746562637586,BIMM 110,A04,895031,Staff,20,0,25,5
1746562638611,BIMM 120,A01,895114,Gustafson-Brown; Cindy,14,0,28,14
1746562638611,BIMM 120,A02,895126,Gustafson-Brown; Cindy,21,0,27,6
1746562639639,BIPN 100,A01,895130,Yang; Mingyu,1,0,38,37
1746562639639,BIPN 100,A02,895131,Yang; Mingyu,32,0,38,6
1746562639639,BIPN 100,A03,895132,Yang; Mingyu,32,0,38,6
1746562639639,BIPN 100,A04,895133,Yang; Mingyu,27,0,36,9
1746562640669,BIPN 120,A01,895135,Cooke; James Edward,0,3,13,13
1746562640669,BIPN 120,A02,895136,Cooke; James Edward,0,1,13,13
1746562640669,BIPN 120,A03,895137,Cooke; James Edward,0,3,13,13
1746562640669,BIPN 120,A04,895156,Cooke; James Edward,0,2,11,11
1746562641698,BIPN 134,A01,895235,Cooke; James Edward,0,2,25,25
1746562641698,BIPN 134,A02,895237,Cooke; James Edward,0,0,25,25
1746562641698,BIPN 134,A03,895240,Cooke; James Edward,3,0,25,22
1746562641698,BIPN 134,A04,895270,Cooke; James Edward,20,0,25,5
1746562642725,BIPN 189,A00,892103,Staff,0,13,14,14
1746562644790,BISP 194,A00,958008,Staff,0,2,0,0
1746562645815,CAT 124,A01,922009,Staff,0,5,20,20
1746562646844,CAT 125R,A00,886390,Morales; Celeste Georgianna,0,2,20,20
1746562646844,CAT 125R,B00,886391,Irwin; Matthew Joseph,0,4,20,20
1746562646844,CAT 125R,C00,886392,Smith; Lauryn Alissa,0,2,20,20
1746562646844,CAT 125R,D00,886393,Vanderschuit; Maya Alysia,0,2,20,20
1746562646844,CAT 125R,E00,886394,Marchisotto; Jennifer Anne,0,3,20,20
1746562647868,CENG 15,A01,886218,Drews; Aaron,3,0,8,5
1746562648894,CENG 113,A00,886219,Opatkiewicz; Justin Paul,15,0,25,10
1746562649919,CGS 101,A00,887044,Staff,7,0,20,13
1746562650944,CGS 105,A01,887046,Staff,14,0,25,11
1746562651976,CGS 112,A00,887047,Cuong; Marisol,12,0,15,3
1746562653000,CGS 113,A00,887048,Staff,23,0,30,7
1746562654026,CGS 120,A00,887049,Staff,10,0,17,7
1746562655055,CHEM 6A,A01,886336,Lam; Tin Yiu,38,0,50,12
1746562655055,CHEM 6A,A02,886338,Lam; Tin Yiu,37,0,50,13
1746562656079,CHEM 6B,A01,886341,Hopkins; Patrycja Anna,16,0,50,34
1746562656079,CHEM 6B,A02,886343,Hopkins; Patrycja Anna,42,0,50,8
1746562657109,CHEM 6C,A01,886346,Albizati; Kim F.,0,2,50,50
1746562657109,CHEM 6C,A02,886348,Albizati; Kim F.,23,0,50,27
1746562658165,CHEM 40A,A01,886352,Klosterman; Jeremy K,65,0,100,35
1746562659192,CHEM 40B,A01,886356,Klosterman; Jeremy K,0,23,100,100
1746562660218,CHEM 41B,A01,886360,Theodorakis; Emmanuel,25,0,50,25
1746562660218,CHEM 41B,A02,886362,Theodorakis; Emmanuel,47,0,50,3
1746562661246,CHIN 165A,A00,886382,Xu; Li,18,0,20,2
1746562662269,CLAS 120,A00,886387,Myerston Santana; Jacobo,33,0,40,7
1746562663294,COGS 9,A01,886967,Shannon; Kyle Michael,42,0,60,18
1746562664320,COGS 11,A01,886969,Staff,10,0,30,20
1746562665355,COGS 14A,A01,886971,Staff,6,0,60,54
1746562666384,COGS 14B,A01,886973,Hoffman; Drew Ellen,4,0,60,56
1746562667408,COGS 18,A01,886975,Morgan; Eric,35,0,60,25
1746562668440,COGS 20,A01,886977,Staff,4,0,8,4
1746562668440,COGS 20,A02,886978,Staff,5,0,7,2
1746562669465,COGS 100,A01,907783,Staff,0,2,30,30
1746562670493,COGS 101B,A01,886980,Staff,0,3,48,48
1746562671523,COGS 101C,A01,886982,Delgado; Tania,0,5,44,44
1746562672552,COGS 102A,A01,886984,Johnson; Christine M.,4,0,30,26
1746562673576,COGS 118B,A01,886986,Staff,0,3,88,88
1746562674604,COGS 150,A01,886988,Bergen; Benjamin,22,0,50,28
1746562675628,COGS 153,A00,886989,Delgado; Tania,0,2,41,41
1746562676653,COGS 186,A01,886991,Staff,0,0,32,32
1746562677683,COGS 187A,A01,886993,Boyle; Mary E. T.,7,0,30,23
1746562678713,COGS 189,A00,886994,Staff,0,1,30,30
1746562679740,COMM 10,A01,886996,Staff,0,0,20,21
1746562679740,COMM 10,A02,886997,Staff,12,0,20,8
1746562679740,COMM 10,A03,959845,Staff,19,0,20,1
1746562680763,COMM 20,A01,886999,Leuning; Grant Maurstad,24,0,40,16
1746562682816,COMM 100A,A01,887002,Staff,0,0,20,25
1746562682816,COMM 100A,A02,887003,Staff,7,0,20,13
1746562683842,COMM 100B,A01,887005,Staff,0,8,20,24
1746562684871,COMM 106D,A00,887006,Staff,14,0,40,26
1746562685899,COMM 110G,A00,887007,Whitworth-Smith; Andrew C,12,0,40,28
1746562686922,COMM 111B,A00,887008,Staff,31,0,40,9
1746562687946,COMM 113T,A00,887009,Abuelhiga; Soraya Jill,28,0,40,12
1746562687946,COMM 113T,B00,906733,Staff,40,0,40,0
1746562688971,COMM 145,A00,887010,Staff,12,0,40,28
1746562689995,COMM 146,A00,887054,Staff,31,0,40,9
1746562691024,COMM 190,A00,887012,Staff,8,0,23,15
1746562692054,CSE 8A,A50,887015,Cao; Yingjun,57,0,85,28
1746562693080,CSE 11,A01,887017,Cao; Yingjun,12,0,70,58
1746562694106,CSE 20,A01,887019,Staff,30,0,50,20
1746562695131,CSE 21,A01,887021,Staff,78,0,100,22
1746562695131,CSE 21,B01,892583,Braun; Oliver,45,0,50,5
1746562696159,CSE 30,A01,887025,Eldon; John,143,0,200,57
1746562697183,CSE 100,A01,887027,Staff,26,0,50,24
1746562697183,CSE 100,A02,887028,Staff,42,0,50,8
1746562698211,CSE 101,A01,887030,Braun; Oliver,74,0,100,26
1746562698211,CSE 101,B01,887032,Jones; Miles E,0,3,50,50
1746562698211,CSE 101,B02,887033,Jones; Miles E,0,2,50,50
1746562699237,CSE 105,A01,908084,Jones; Miles E,32,0,50,18
1746562699237,CSE 105,A02,908087,Jones; Miles E,32,0,50,18
1746562700262,CSE 135,A01,887035,Powell; Thomas Allan,0,4,50,50
1746562701288,CSE 142,A01,887037,Staff,8,0,60,52
1746562702316,CSE 142L,A01,887039,Staff,34,0,60,26
1746562703342,CSE 151A,A01,887041,Solares; Edwin A,47,0,100,53
1746562704369,CSE 175,A01,887043,Kumar; Rakesh,30,0,30,0
1746562705419,CSS 1,A01,886389,Staff,1,1,40,39
1746562706444,DSC 30,A01,908097,Liao; Soohyun Nam,47,0,75,28
1746562707469,DSC 40A,A01,908099,Shannon; Kyle Michael,30,0,50,20
1746562708493,DSC 40B,A01,908112,Staff,16,0,50,34
1746562709521,DSC 80,A01,908116,Staff,19,0,60,41
1746562710545,DSC 197,001,956863,Eldridge; Justin Matthew,9999,0,9999,0
1746562711572,ECE 5,A01,886400,Morris; Karcher William,2,0,6,4
1746562711572,ECE 5,A02,886401,Morris; Karcher William,3,0,6,3
1746562712602,ECE 148,A01,886403,Silberman; Jack,0,14,14,14
1746562713629,ECON 1,A01,887265,Crane; Meredith Helen,12,0,70,58
1746562713629,ECON 1,B01,887268,Staff,43,0,50,7
1746562714657,ECON 2,A01,887273,Crane; Meredith Helen,55,0,70,15
1746562715686,ECON 3,A01,887279,Rondina; Giacomo,32,0,70,38
1746562716712,ECON 4,A01,887282,Anderson; John Charles,0,2,10,10
1746562717739,ECON 5,A01,887285,Staff,34,0,45,11
1746562717739,ECON 5,B01,887292,Staff,41,0,45,4
1746562718766,ECON 100A,A01,887337,Newhouse; Herbert S,54,0,70,16
1746562718766,ECON 100A,B01,887349,Staff,45,0,50,5
1746562719792,ECON 100B,A01,887361,Du; Songzi,29,0,70,41
1746562720818,ECON 100C,A01,887445,Newhouse; Herbert S,59,0,70,11
1746562721870,ECON 105,A00,887488,Vespa; Emanuel Ignacio,23,0,35,12
1746562722897,ECON 109,A01,887506,Shishkin; Denis,28,0,35,7
1746562723925,ECON 110A,A01,887568,Alon; Titan Michael,0,3,35,35
1746562723925,ECON 110A,B01,907601,Alon; Titan Michael,20,0,35,15
1746562724952,ECON 110B,A01,887598,Levkoff; Steven B.,0,24,70,70
1746562725976,ECON 112,A00,887599,Rondina; Giacomo,19,0,35,16
1746562727003,ECON 120A,A01,887603,Dai; Yinlin,35,0,70,35
1746562728029,ECON 120C,A01,887608,Sun; Yixiao,0,1,35,35
1746562728029,ECON 120C,B01,887614,Sun; Yixiao,0,0,35,35
1746562729057,ECON 138,A00,887621,Bharadwaj; Prashant,0,21,20,20
1746562730083,ECON 144,A00,958007,Squires; Dale E,13,0,35,22
1746562731108,ECON 171,A01,907666,Staff,18,0,35,17
1746562732136,ECON 175,A00,887626,Wu; Pak Yeung,23,0,35,12
1746562733162,ECON 190,A00,887640,Vespa; Emanuel Ignacio,23,0,35,12
1746562734189,EDS 25,A01,888197,Staff,0,0,0,0
1746562734189,EDS 25,A02,888209,Staff,0,0,0,0
1746562734189,EDS 25,A03,888210,Staff,0,0,0,0
1746562734189,EDS 25,A04,888212,Staff,0,0,0,0
1746562734189,EDS 25,A05,888213,Staff,0,0,0,0
1746562734189,EDS 25,A06,888214,Staff,0,0,0,0
1746562734189,EDS 25,A07,888235,Staff,0,2,0,0
1746562734189,EDS 25,A08,888236,Staff,0,0,0,0
1746562734189,EDS 25,A09,888240,Staff,0,0,0,0
1746562734189,EDS 25,A10,888244,Staff,0,0,0,0
1746562734189,EDS 25,B01,888273,Staff,0,0,0,0
1746562734189,EDS 25,B02,888285,Staff,0,0,0,0
1746562734189,EDS 25,B03,888423,Staff,0,0,0,1
1746562734189,EDS 25,B04,888432,Staff,0,0,0,0
1746562734189,EDS 25,B05,888433,Staff,0,0,0,0
1746562734189,EDS 25,B06,888467,Staff,0,0,0,0
1746562734189,EDS 25,B07,888468,Staff,0,0,0,0
1746562734189,EDS 25,B08,888479,Staff,0,0,0,0
1746562734189,EDS 25,B09,888484,Staff,0,0,0,0
1746562734189,EDS 25,B10,888487,Staff,0,0,0,0
1746562735215,EDS 38,A01,907700,Choi; Bailey Miyeon,30,0,30,0
1746562736240,EDS 112,A01,888601,Chapman; Thandeka K,13,0,40,27
1746562737267,EDS 115,A00,888697,Mendez; Kathrina Mendoza,10,0,30,20
1746562738294,EDS 116,A01,888893,Staff,35,0,40,5
1746562740348,EDS 124AR,A00,889133,Staff,29,0,50,21
1746562740348,EDS 124AR,B00,907471,Simon; Elizabeth A,37,0,50,13
1746562741375,EDS 124BR,A00,889134,Simon; Elizabeth A,44,0,100,56
1746562742399,EDS 125,A00,889135,Staff,25,0,30,5
1746562743426,EDS 126,A01,889138,Staff,36,0,40,4
1746562744450,EDS 164R,A01,889142,Wishard Guerra; Alison G.,33,0,50,17
1746562745477,ENG 30,A01,886396,Staff,0,0,0,0
1746562745477,ENG 30,B01,886398,Staff,0,0,0,0
1746562746503,ENVR 102,A00,906150,Montejo; Carolina,23,0,25,2
1746562747528,ETHN 103A,A00,887236,Man; Simeon S,0,3,0,0
1746562748566,ETHN 113,A00,887239,Staff,16,0,30,14
1746562749597,ETHN 116,A00,887240,Staff,16,0,25,9
1746562750623,ETHN 117,A00,887241,Choi; Esther Min,28,0,30,2
1746562751652,ETHN 118,A00,887243,Staff,24,0,30,6
1746562752682,ETHN 127,A00,887248,Cuong; Marisol,11,0,15,4
1746562753707,ETHN 139,A00,887250,Staff,7,0,10,3
1746562754733,ETHN 142,A00,887252,Staff,10,0,30,20
1746562755758,ETHN 161,A00,887253,Browne; Errol Tsekani,24,0,30,6
1746562756785,ETHN 163FR,A00,887255,Burelle; Julie Sara Veronique,0,0,5,5
1746562757810,GLBH 20,A00,889149,Elwardani; Nile Regina,8,0,42,34
1746562759862,GLBH 111,A01,889152,Burgos; Jose L.,17,0,17,0
1746562760888,GLBH 150,A00,889181,Sloane; Julia Kathryn,0,5,15,15
1746562762940,HDS 60,A01,886406,Warstadt; Melissa Fawn,73,0,80,7
1746562763966,HIAF 111,A00,889324,Gyamfi; Bright,25,0,32,7
1746562764991,HIEA 131,A00,889328,Staff,15,0,32,17
1746562766016,HIEA 144,A00,889333,Henry; Todd A.,26,0,32,6
1746562767041,HIEA 154,A00,889336,Henry; Todd A.,24,0,32,8
1746562768066,HIEU 106,A00,889339,Staff,22,0,32,10
1746562770121,HIEU 114,A00,889340,Staff,3,0,32,29
1746562771148,HIEU 135GS,A00,889342,Patterson; Patrick H.,0,0,1,24
1746562772175,HIEU 137,A00,889343,Edington; Claire Ellen,10,0,25,15
1746562773201,HIEU 148,A00,889345,Staff,14,0,32,18
1746562774225,HIEU 154,A00,889346,Biess; Frank Peter,21,0,32,11
1746562775253,HILA 102,A00,889351,Staff,12,0,32,20
1746562776276,HILD 2A,A01,889221,Lewandoski; Julia Mavis,1,10,32,31
1746562777302,HILD 7B,A01,889225,Man; Simeon S,0,12,32,32
1746562778328,HILD 7C,A01,889288,Alvarez; Luis A,0,14,32,32
1746562779353,HILD 30,A01,889323,Staff,0,5,32,32
1746562781405,HISC 119,A00,889383,Golan; Tal,20,0,32,12
1746562782431,HIUS 103,A00,889384,Man; Simeon S,0,0,32,32
1746562783458,HIUS 117,A00,919797,Kwak; Nancy,18,0,32,14
1746562784484,HIUS 142A,A00,919788,Staff,22,0,32,10
1746562786533,HIUS 149,A00,889386,Gyamfi; Bright,26,0,32,6
1746562787559,HIUS 155,A00,889387,Alvarez; Luis A,14,0,32,18
1746562788587,HUM 3,A01,886499,Caldwell; Michael Alan,19,0,50,31
1746562789612,HUM 3GS,A00,886500,Rodriguez; Bretton Sigfred,0,0,0,28
1746562790642,HUM 3R,A01,886502,Markman; Kristina,0,36,50,50
1746562791669,HUM 4,A01,886504,Crum; Matthew Stephen,24,0,50,26
1746562791669,HUM 4,B01,886506,West; Geoffrey Scott,17,0,50,33
1746562792693,HUM 4GS,A00,886507,Staff,0,0,0,19
1746562793721,HUM 5,A01,886509,Staff,32,0,50,18
1746562794747,HUM 5R,A01,886511,Zavodny; Tatiana Sophia,0,39,50,50
1746562795772,JAPN 180,A00,886407,Staff,17,0,40,23
1746562796798,LATI 50,A01,886409,Martin-Cabrera; Luis,4,0,22,18
1746562796798,LATI 50,A02,886410,Martin-Cabrera; Luis,19,0,22,3
1746562796798,LATI 50,A03,886411,Martin-Cabrera; Luis,21,0,22,1
1746562796798,LATI 50,A04,886412,Martin-Cabrera; Luis,9,0,22,13
1746562797822,LAWS 101,A00,907664,Staff,28,0,60,32
1746562798846,LIAB 1A,A00,889388,Saab; Dima,17,0,20,3
1746562799871,LIAB 1AX,A00,889389,El Cheddadi; Youniss,18,0,20,2
1746562800900,LIFR 1C,A00,889391,Van Moer; Vinciane G,8,0,20,12
1746562801929,LIFR 1CX,A00,889392,Van Moer; Vinciane G,7,0,20,13
1746562802958,LIFR 1D,A00,889393,Van Moer; Vinciane G,7,0,20,13
1746562803987,LIFR 1DX,A00,889394,Van Moer; Vinciane G,8,0,20,12
1746562805014,LIGN 7,A00,886923,Staff,24,0,50,26
1746562806042,LIGN 17,A00,886924,Kehler; Andrew Scott,125,0,150,25
1746562807068,LTAM 110,A00,889395,Staff,15,0,30,15
1746562808096,LTAM 110GS,A00,958010,Rodriguez; Bretton Sigfred,0,0,0,28
1746562809124,LTCH 101,A00,889397,Staff,23,0,25,2
1746562810152,LTCS 130,A00,889398,Staff,23,0,25,2
1746562811176,LTEA 138,A00,889399,Staff,24,0,40,16
1746562812202,LTEN 149,A00,889400,Wesling; Megan E.,0,3,25,25
1746562813229,LTEN 169,A00,889401,Staff,20,0,25,5
1746562814254,LTEN 180,A00,889402,Staff,10,0,15,5
1746562815281,LTEN 181,A00,889403,Staff,21,0,25,4
1746562816305,LTWL 100,A00,889404,Myerston Santana; Jacobo,2,0,25,23
1746562817329,LTWL 180GS,A00,889405,Staff,0,0,20,20
1746562818353,LTWL 181,A00,889406,Staff,16,0,25,9
1746562819382,LTWL 184,A00,889475,Mukherjee; Silpa,22,0,25,3
1746562820408,LTWR 102C,A00,889486,Staff,29,0,30,1
1746562821434,LTWR 115W,A00,889491,Staff,0,2,15,15
1746562822458,MAE 8,A01,886905,Staff,0,2,0,0
1746562823484,MAE 11,A00,886906,Bandaru; Prabhakar,0,7,50,50
1746562824509,MAE 20,A00,886907,Evdokimenko; Ekaterina,43,0,70,27
1746562825538,MAE 30B,A00,886909,Ghazinejad; Maziar,26,0,45,19
1746562826565,MAE 101B,A00,886910,Saintillan; David,29,0,45,16
1746562827591,MAE 105,A00,886911,Bandaru; Prabhakar,18,0,50,32
1746562828619,MAE 107,B00,958024,Staff,8,0,50,42
1746562829650,MAE 143B,A00,886913,Bewley; Thomas R,6,0,40,34
1746562830677,MAE 148,A01,886915,Silberman; Jack,0,3,14,14
1746562831702,MAE 160,A00,886916,Evdokimenko; Ekaterina,32,0,60,28
1746562832729,MATH 3C,A01,889681,Staff,0,2,30,30
1746562832729,MATH 3C,A02,960048,Staff,24,0,30,6
1746562833754,MATH 10A,A01,889760,Staff,26,0,30,4
1746562833754,MATH 10A,A02,889783,Staff,29,0,30,1
1746562834778,MATH 10B,A01,889785,Verstraete; Jacques Allan,2,0,35,33
1746562834778,MATH 10B,A02,889795,Verstraete; Jacques Allan,4,0,35,31
1746562834778,MATH 10B,B01,889797,Verstraete; Jacques Allan,3,0,35,32
1746562834778,MATH 10B,B02,889828,Verstraete; Jacques Allan,3,0,35,32
1746562835803,MATH 10C,A01,889849,Habib; Yousaf,8,0,30,22
1746562835803,MATH 10C,A02,889852,Habib; Yousaf,14,0,30,16
1746562835803,MATH 10C,A03,889853,Habib; Yousaf,22,0,30,8
1746562835803,MATH 10C,A04,889858,Habib; Yousaf,20,0,30,10
1746562835803,MATH 10C,B01,889861,Staff,1,0,30,29
1746562835803,MATH 10C,B02,889862,Staff,24,0,30,6
1746562835803,MATH 10C,B03,889863,Staff,27,0,30,3
1746562835803,MATH 10C,B04,889967,Staff,23,0,30,7
1746562836827,MATH 18,A01,889974,Staff,7,0,30,23
1746562836827,MATH 18,A02,889977,Staff,20,0,30,10
1746562836827,MATH 18,B01,889984,Hardiman; Liam,21,0,30,9
1746562836827,MATH 18,B02,889985,Hardiman; Liam,25,0,30,5
1746562837855,MATH 20A,A01,889990,Suk; Andrew Hoon,30,0,35,5
1746562838885,MATH 20B,A01,889993,Ohm; Ko Woon,22,0,30,8
1746562838885,MATH 20B,A02,889994,Ohm; Ko Woon,30,0,30,0
1746562838885,MATH 20B,B01,889996,Ohm; Ko Woon,21,0,30,9
1746562838885,MATH 20B,B02,889997,Ohm; Ko Woon,23,0,30,7
1746562839912,MATH 20C,A01,889999,Hammock; Frances H,17,0,30,13
1746562839912,MATH 20C,A02,890003,Hammock; Frances H,23,0,30,7
1746562839912,MATH 20C,B01,890006,Hammock; Frances H,3,0,30,27
1746562839912,MATH 20C,B02,890007,Hammock; Frances H,11,0,30,19
1746562840943,MATH 20D,A01,890011,Cheng; Hsiao-Bing,1,1,30,29
1746562840943,MATH 20D,A02,890012,Cheng; Hsiao-Bing,14,0,30,16
1746562840943,MATH 20D,B01,890016,Cheng; Hsiao-Bing,13,0,30,17
1746562840943,MATH 20D,B02,890017,Cheng; Hsiao-Bing,13,0,30,17
1746562841974,MATH 20E,A01,890026,Harel; Guershon,1,0,30,29
1746562841974,MATH 20E,A02,890029,Harel; Guershon,23,0,30,7
1746562841974,MATH 20E,B01,890033,Harel; Guershon,7,0,30,23
1746562841974,MATH 20E,B02,890101,Harel; Guershon,21,0,30,9
1746562843000,MATH 102,A01,890104,Staff,17,0,30,13
1746562843000,MATH 102,A02,890105,Staff,27,0,30,3
1746562844025,MATH 103B,A01,890116,Salehi Golsefidy; Alireza,3,0,30,27
1746562844025,MATH 103B,B01,890118,Staff,0,3,34,34
1746562845055,MATH 109,A01,890121,Aliabadi Sr.; Mohsen,1,0,30,29
1746562845055,MATH 109,B01,890124,Upadrashta; Pranav Kumar,18,0,30,12
1746562846085,MATH 120A,A01,890126,Eggers; John Dietrich,13,0,30,17
1746562847109,MATH 142B,A01,890128,Ioana; Adrian,19,0,30,11
1746562847109,MATH 142B,A02,890129,Ioana; Adrian,13,0,30,17
1746562848137,MATH 154,A01,890174,Staff,0,0,30,30
1746562848137,MATH 154,A02,890182,Staff,0,0,30,30
1746562849166,MATH 168A,A01,890197,Dumitriu; Ioana,21,0,35,14
1746562850192,MATH 170A,A01,890240,Nie; Jiawang,1,0,30,29
1746562850192,MATH 170A,A02,890241,Nie; Jiawang,11,0,30,19
1746562850192,MATH 170A,A03,890249,Nie; Jiawang,23,0,30,7
1746562851218,MATH 170B,A01,957891,Nag; Panchali,13,0,35,22
1746562853269,MATH 181A,A01,908025,Staff,0,4,35,35
1746562853269,MATH 181A,A02,960115,Staff,27,0,35,8
1746562854332,MATH 181B,A01,959874,Staff,25,0,30,5
1746562855356,MATH 193B,A01,890265,Staff,0,4,35,35
1746562856383,MGT 4,A01,890311,Anderson; John Charles,42,0,88,46
1746562857408,MGT 5,A00,907740,Staff,13,0,98,85
1746562858432,MGT 12,A00,890312,Lindenberger; Wade Douglas,67,0,98,31
1746562859459,MGT 16,A00,957883,Staff,78,0,98,20
1746562861508,MGT 45,A00,890314,Pecore; Joseph P.,46,0,98,52
1746562862534,MGT 71,A00,890315,Staff,0,11,98,98
1746562863558,MGT 100,A00,890316,Yavorsky; Daniel Ryan,44,0,98,54
1746562864585,MGT 103,A00,890317,Ehrich; Kristine R,73,0,98,25
1746562865613,MGT 105,A00,890356,Bates; Kenneth Walter,0,8,98,98
1746562866640,MGT 112,A00,890360,Ehrich; Kristine R,55,0,98,43
1746562867664,MGT 127R,A00,907732,Zhu; Kevin Xiaoguo,23,0,98,75
1746562868689,MGT 131B,A00,890361,Anderson; John Charles,60,0,98,38
1746562869714,MGT 137,A00,890362,Lindenberger; Wade Douglas,65,0,98,33
1746562870742,MGT 160,A00,890369,Johnson; Erik Barry,9,0,98,89
1746562872793,MGT 164,A00,890372,Zimmermann; Carsten,0,40,98,98
1746562873820,MGT 180,A00,890374,Bliss; Barbara Ann,12,0,98,86
1746562874847,MMW 15,A01,886414,Chang; Edmond Yi-Teh,0,12,28,28
1746562874847,MMW 15,A02,886415,Chang; Edmond Yi-Teh,0,8,28,28
1746562874847,MMW 15,A03,886416,Chang; Edmond Yi-Teh,0,8,28,28
1746562874847,MMW 15,A04,886417,Chang; Edmond Yi-Teh,0,8,28,28
1746562874847,MMW 15,B01,886419,Chang; Edmond Yi-Teh,0,7,28,28
1746562874847,MMW 15,B02,886420,Chang; Edmond Yi-Teh,0,8,28,28
1746562874847,MMW 15,B03,886421,Chang; Edmond Yi-Teh,0,7,28,28
1746562874847,MMW 15,B04,886422,Chang; Edmond Yi-Teh,0,8,28,28
1746562874847,MMW 15,C01,886424,Staff,0,9,28,28
1746562874847,MMW 15,C02,886425,Staff,0,8,28,28
1746562874847,MMW 15,C03,886426,Staff,0,8,28,28
1746562874847,MMW 15,C04,886427,Staff,0,8,28,28
1746562874847,MMW 15,C05,958038,Staff,0,8,28,28
1746562874847,MMW 15,C06,958039,Staff,0,8,28,28
1746562875875,MMW 15GS,A00,906910,Patterson; Patrick H.,4,0,28,24
1746562876903,MMW 122R,A01,886429,Rahimi; Babak,0,13,28,28
1746562876903,MMW 122R,A02,886430,Rahimi; Babak,0,12,28,28
1746562876903,MMW 122R,A03,958040,Rahimi; Babak,0,11,28,28
1746562877928,MUS 1A,A01,890937,Staff,2,0,25,23
1746562877928,MUS 1A,A02,891035,Staff,6,0,25,19
1746562877928,MUS 1A,C01,958912,Staff,24,0,25,1
1746562877928,MUS 1A,C02,958913,Staff,25,0,25,0
1746562879981,MUS 2AK,A00,957092,Ohnishi; Takae,15,0,15,0
1746562881005,MUS 4,A01,891044,Staff,2,0,25,23
1746562881005,MUS 4,A02,891045,Staff,23,0,25,2
1746562881005,MUS 4,B01,891048,Staff,17,0,25,8
1746562881005,MUS 4,B02,891050,Staff,25,0,25,0
1746562882030,MUS 5,A01,957506,Dubnov; Shlomo,0,0,25,25
1746562882030,MUS 5,A02,957622,Dubnov; Shlomo,13,0,25,12
1746562882030,MUS 5,A03,957623,Dubnov; Shlomo,20,0,25,5
1746562883054,MUS 6,A01,891053,Freitas Caetano; Marcelo,24,0,25,1
1746562883054,MUS 6,A02,891054,Freitas Caetano; Marcelo,23,0,25,2
1746562884082,MUS 7,A01,891081,Staff,0,0,25,25
1746562884082,MUS 7,A02,891082,Staff,4,0,25,21
1746562885106,MUS 8GS,A00,891118,Borgo; David Garcia,0,0,25,25
1746562886135,MUS 11,A01,891140,Staff,10,0,25,15
1746562886135,MUS 11,A02,891141,Staff,22,0,25,3
1746562887160,MUS 13,A01,891143,Staff,8,0,25,17
1746562887160,MUS 13,A02,891144,Staff,24,0,25,1
1746562888184,MUS 15,A01,891146,Staff,9,0,25,16
1746562888184,MUS 15,A02,891148,Staff,21,0,25,4
1746562888184,MUS 15,B01,891150,Staff,18,0,25,7
1746562888184,MUS 15,B02,891151,Staff,25,0,25,0
1746562889209,MUS 20,A01,891153,Staff,5,0,20,15
1746562889209,MUS 20,A02,891155,Staff,14,0,20,6
1746562890236,MUS 80,A00,891156,Staff,19,0,25,6
1746562890236,MUS 80,B00,891157,Staff,23,0,25,2
1746562891261,MUS 130,A00,891158,Ohnishi; Takae,35,0,35,0
1746562892286,MUS 150GS,A01,891160,Borgo; David Garcia,0,0,25,25
1746562893315,MUS 170,A01,891162,Freitas Caetano; Marcelo,20,0,25,5
1746562893315,MUS 170,A02,891164,Freitas Caetano; Marcelo,21,0,25,4
1746562894340,NANO 11,A00,886220,Vazquez Mena; Oscar,13,0,15,2
1746562895365,NANO 15,A01,886222,Drews; Aaron,4,0,7,3
1746562896390,NANO 104,A00,886224,Sirbuly; Donald,18,0,25,7
1746562897419,PH 40,A00,886528,Staff,23,0,40,17
1746562898443,PH 45,A01,886799,Staff,35,0,40,5
1746562899467,PH 110,A00,886802,Staff,0,7,40,40
1746562900492,PH 172,A00,906716,Staff,19,0,35,16
1746562901517,PH 191,A00,886803,Staff,6,0,40,34
1746562902541,PHIL 1,A00,889500,Staff,20,0,30,10
1746562903569,PHIL 10,A01,889549,Grush; Rick Scott,15,0,22,7
1746562903569,PHIL 10,A02,889551,Grush; Rick Scott,22,0,22,0
1746562904597,PHIL 28,A01,889559,Lamey; Andy M.,0,1,31,31
1746562904597,PHIL 28,A02,889561,Lamey; Andy M.,0,1,30,30
1746562904597,PHIL 28,A03,889572,Lamey; Andy M.,0,1,30,30
1746562905620,PHIL 35,A00,907839,Staff,13,0,15,2
1746562906649,PHIL 60,A00,889574,Staff,73,0,90,17
1746562907673,PHIL 101,A00,958004,Staff,12,0,15,3
1746562909721,PHIL 136,A00,889582,Fulkerson; Matthew Todd,26,0,45,19
1746562910750,PHIL 163,A01,889601,Staff,21,0,30,9
1746562910750,PHIL 163,B01,889606,Brandt; Reuven A,0,3,0,0
1746562911782,PHIL 164,A00,889610,Staff,16,0,30,14
1746562912806,PHIL 165,A00,889613,Staff,23,0,30,7
1746562913832,PHYS 1A,A00,886431,Staff,26,0,70,44
1746562914857,PHYS 1AL,001,886432,Tsai; Philbert S,0,2,30,30
1746562914857,PHYS 1AL,002,886436,Tsai; Philbert S,11,0,30,19
1746562915881,PHYS 1B,A00,886439,Staff,185,0,240,55
1746562916906,PHYS 1BL,001,886441,Tsai; Philbert S,0,4,30,30
1746562916906,PHYS 1BL,002,886444,Tsai; Philbert S,2,0,30,28
1746562917932,PHYS 1C,A00,896092,Arnold; Kam S,79,0,146,67
1746562918956,PHYS 1CL,001,886448,Tsai; Philbert S,0,0,30,30
1746562918956,PHYS 1CL,002,886449,Tsai; Philbert S,1,0,30,29
1746562918956,PHYS 1CL,003,886450,Tsai; Philbert S,16,0,30,14
1746562918956,PHYS 1CL,004,886451,Tsai; Philbert S,15,0,30,15
1746562919986,PHYS 2B,A01,886457,Staff,68,0,115,47
1746562921012,PHYS 2C,A01,886460,Shotwell; Brian,0,9,65,65
1746562922037,PHYS 2CL,A01,886467,Staff,0,4,28,28
1746562922037,PHYS 2CL,A02,886468,Staff,0,3,28,28
1746562923067,PHYS 2D,A01,886470,Staff,10,0,50,40
1746562924095,PHYS 4B,A01,886475,Grinstein; Benjamin,22,0,40,18
1746562925121,POLI 5,A00,891173,Desposato; Scott,7,0,25,18
1746562926148,POLI 5D,A01,891175,Staff,5,0,5,0
1746562926148,POLI 5D,B01,891178,Staff,5,0,5,0
1746562927176,POLI 11,A00,891179,Ferree; Karen E,2,0,35,33
1746562928202,POLI 12,A00,891180,Staff,16,0,30,14
1746562929231,POLI 27,A01,891182,Staff,12,0,75,63
1746562930260,POLI 30,A00,891183,Staff,8,0,50,42
1746562931287,POLI 100B,A00,891244,Staff,5,1,35,30
1746562932315,POLI 100I,A00,891247,Staff,7,0,30,23
1746562933340,POLI 104J,A00,891248,Nichter; Maysa,14,0,30,16
1746562934366,POLI 104U,A00,891250,Nichter; Maysa,2,0,30,28
1746562936420,POLI 110B,A00,891255,Wiens; David,20,0,25,5
1746562937449,POLI 112A,A00,891256,Wiens; David,6,0,25,19
1746562938477,POLI 114BR,A00,891261,Staff,19,0,30,11
1746562939506,POLI 117R,A00,891262,Forman; Fonna,0,6,50,50
1746562940536,POLI 118,A00,891264,Ingham; Sean,17,0,25,8
1746562941562,POLI 124A,A00,891265,Staff,18,0,20,2
1746562942590,POLI 125D,A00,891266,Nichter; Simeon C,2,0,25,23
1746562943615,POLI 126,A00,891268,Nichter; Simeon C,7,0,25,18
1746562944643,POLI 126AA,A00,891272,Staff,17,0,25,8
1746562945669,POLI 130AA,A00,891273,Staff,15,0,20,5
1746562946708,POLI 134AA,A00,891274,Staff,4,0,20,16
1746562948759,POLI 138,A00,891278,Staff,21,0,25,4
1746562949785,POLI 142K,A00,891280,Staff,11,0,25,14
1746562950813,POLI 142M,A00,891281,Gartzke; Erik,17,0,30,13
1746562951858,POLI 142P,A00,891284,Staff,20,0,30,10
1746562952885,POLI 143,A00,891285,Gartzke; Erik,12,0,30,18
1746562953911,POLI 153,A00,891286,Staff,19,0,20,1
1746562955965,POLI 175,A00,891290,Staff,15,0,20,5
1746562956994,PSYC 1,A00,890674,Steiner; Eric Tomas,0,11,45,45
1746562958057,PSYC 2,A00,890676,Albright; Thomas D,21,0,35,14
1746562959086,PSYC 3,A00,890679,Staff,17,0,20,3
1746562960112,PSYC 6,A00,959858,Staff,20,0,20,0
1746562961142,PSYC 60,A01,890684,Rickard; Timothy C.,0,5,45,45
1746562962172,PSYC 70,A01,890689,Geller; Emma Harlan,7,0,30,23
1746562963197,PSYC 71,A01,959860,Staff,21,0,25,4
1746562964220,PSYC 100,A00,890690,Lacefield; Katharine I,0,50,180,180
1746562965247,PSYC 102,A00,890695,Staff,18,0,40,22
1746562966273,PSYC 105,A00,890699,Geller; Emma Harlan,70,0,100,30
1746562967297,PSYC 106,A00,890701,Gorman; Michael R.,6,0,30,24
1746562968324,PSYC 108,A00,890704,Adrian; Julia Anna,0,28,50,50
1746562969349,PSYC 118,A01,890712,Staff,11,0,30,19
1746562970373,PSYC 124,A00,890716,Chapman; Eddie Nathaniel,25,0,60,35
1746562971401,PSYC 131,A00,890717,Anagnostaras; Stephan,0,7,80,80
1746562972426,PSYC 137,A00,890719,Winkielman; Piotr,0,11,30,30
1746562973454,PSYC 144,A00,890721,Adrian; Julia Anna,0,9,45,45
1746562974479,PSYC 162,A00,890805,Staff,1,0,75,74
1746562975504,PSYC 169,A00,890810,Staff,0,14,30,30
1746562976530,PSYC 172,A00,890814,Gorman; Michael R.,9,0,30,21
1746562977555,PSYC 181,A00,890818,Anagnostaras; Stephan,9,0,200,191
1746562978582,PSYC 184,A00,959861,Staff,168,0,175,7
1746562979609,PSYC 189,A00,890823,Staff,0,1,30,30
1746562980636,PSYC 191,A00,890884,Rickard; Timothy C.,0,11,35,35
1746562981660,PSYC 193,A00,890913,Staff,19,0,30,11
1746562981660,PSYC 193,B00,890914,Chapman; Eddie Nathaniel,24,0,30,6
1746562982685,PSYC 193L,A01,890918,Lowe; Angela Beth,20,0,30,10
1746562982685,PSYC 193L,B01,890921,Hurwitz; Ethan Scott,20,0,30,10
1746562982685,PSYC 193L,C01,890928,Staff,30,0,30,0
1746562983710,RELI 149,A00,886806,Rahimi; Babak,23,0,40,17
1746562984737,SE 9,A01,886814,Staff,7,0,20,13
1746562985763,SE 101B,A01,886816,Chadha; Mayank,4,0,35,31
1746562986788,SE 110B,A00,886818,Zhu; Qiang,4,0,75,71
1746562987814,SE 125,A01,886830,Staff,10,0,30,20
1746562988840,SE 130B,A01,886835,Staff,14,0,40,26
1746562989868,SE 131A,A01,886838,Krysl; Petr,34,0,55,21
1746562990896,SE 154,A00,886840,Staff,29,0,50,21
1746562991922,SE 164GS,A01,886849,Staff,6,0,20,14
1746562992946,SE 167GS,A01,886853,Staff,6,0,20,14
1746562993974,SIO 25,A01,890107,Staff,19,0,30,11
1746562995003,SIO 45,A00,890109,Cook; Geoffrey W,117,0,200,83
1746562996030,SIO 109R,A00,890110,Forman; Fonna,0,16,20,20
1746562997055,SIO 187,A01,890114,Kacev; David,15,0,40,25
1746562998081,SOCI 1,A01,890431,Thorpe; Charles Robert,15,0,30,15
1746562998081,SOCI 1,A02,890518,Thorpe; Charles Robert,30,0,30,0
1746562999108,SOCI 2,A01,957978,Staff,25,0,25,0
1746562999108,SOCI 2,A02,957979,Staff,23,0,25,2
1746563000133,SOCI 20,A01,890523,Calderon-Zaks; Michael Aar,23,0,30,7
1746563000133,SOCI 20,A02,890526,Calderon-Zaks; Michael Aar,29,0,30,1
1746563001162,SOCI 30,A01,890533,Pardo Guerra; Juan Pablo,37,0,40,3
1746563002192,SOCI 40,A01,890535,Staff,27,0,45,18
1746563003218,SOCI 104Q,A00,890559,Staff,18,0,30,12
1746563004242,SOCI 106,A00,890560,Arnal; Maud Marie Leonie,20,0,30,10
1746563005267,SOCI 110,A00,890567,Holkenbrink-Monk; Charlene,19,0,30,11
1746563006291,SOCI 112,A00,890568,Victoria Torres; Pablo,2,0,55,53
1746563007316,SOCI 115,A00,890597,Arnal; Maud Marie Leonie,28,0,45,17
1746563009367,SOCI 121,A00,890604,Pardo Guerra; Juan Pablo,38,0,45,7
1746563010393,SOCI 126,A01,890608,Staff,8,0,10,2
1746563011420,SOCI 127,A00,890609,Staff,18,0,30,12
1746563012447,SOCI 131,A00,890610,Thorpe; Charles Robert,37,0,45,8
1746563013475,SOCI 135,A00,890615,Payne; Christine Anna,13,0,45,32
1746563014499,SOCI 139,A00,890620,Staff,38,0,45,7
1746563015526,SOCI 148E,A00,890622,Calderon-Zaks; Michael Aar,36,0,45,9
1746563016556,SOCI 150,A00,890623,Kohler; Kristopher M.,31,0,45,14
1746563017586,SOCI 157,A00,890625,Jules-Rosette; Bennetta W.,18,0,20,2
1746563018611,SOCI 160,A00,890627,Payne; Christine Anna,21,0,45,24
1746563019638,SYN 1,A00,886855,Fish; Gwendolyn Anne,0,0,0,0
1746563019638,SYN 1,B00,906086,Fish; Gwendolyn Anne,0,1,0,2
1746563020669,SYN 2R,A00,886860,Staff,0,17,15,15
1746563020669,SYN 2R,B00,906106,Atkinson; Arthur Laird,0,16,15,15
1746563021695,SYN 100,A01,886866,Browne; Emily,0,28,20,20
1746563021695,SYN 100,B01,906128,Rock; Martin,0,5,20,20
1746563021695,SYN 100,C01,906140,Deavenport; James Cary,0,3,20,20
1746563021695,SYN 100,D01,907816,Deavenport; James Cary,0,5,20,20
1746563022722,TDAC 1,A00,890286,Walsh; Kim C.,8,0,20,12
1746563023751,TDAC 101,A00,890296,Basso; Beatrice,15,0,20,5
1746563024780,TDDE 131,A00,890297,Staff,47,0,50,3
1746563025805,TDDM 1,A00,890287,Weinberg; Sadie,25,0,30,5
1746563026845,TDGE 11,A00,890288,Fulton; Julia,137,0,200,63
1746563026845,TDGE 11,B00,890289,Castro; Robert Jess,184,0,200,16
1746563027870,TDGE 25,B00,957359,Walsh; Kim C.,3,0,20,17
1746563028895,TDGE 40,A01,890292,Power; Jade Yukana,27,0,30,3
1746563029920,TDGE 124,A00,890298,Havis; Allan,0,1,50,50
1746563030945,TDGE 131R,A00,890299,Burelle; Julie Sara Veronique,15,0,42,27
1746563031977,TDHT 101,A00,890300,Staff,10,0,20,10
1746563033001,TDHT 109,A01,890302,Anderson; Mysia Anyse,31,0,40,9
1746563034029,TDMV 1,A00,890293,Arcidiacono; Kristin,18,0,30,12
1746563035054,TDMV 2,A00,890294,Weinberg; Sadie,23,0,30,7
1746563036085,TDMV 3,A00,957878,Arcidiacono; Kristin,28,0,30,2
1746563038134,TDMV 138,A00,890304,Jun; Grace Shin Hae,25,0,40,15
1746563039158,TDMV 140,A00,890305,Corrales; Joseph Bernales,25,0,30,5
1746563040184,TDMV 142,A00,890307,Caligagan; Tony,32,0,40,8
1746563041207,TDMV 144,A00,890308,Camaya; Michelle Ann,25,0,30,5
1746563042237,TDPW 1,A00,890295,Stein; Deborah Isobel,3,0,20,17
1746563043264,USP 2,A01,890272,Lerner; Amy M,6,0,20,14
1746563044289,USP 3,A01,890274,Staff,12,0,30,18
1746563045315,USP 15,A01,890276,Sun; Feiyang,16,0,30,14
1746563046345,USP 25,A00,890277,Shenkman; Michael Thomas,19,0,25,6
1746563047371,USP 138,A00,890278,Staff,14,0,25,11
1746563048396,USP 143,A00,890279,Staff,22,0,70,48
1746563049421,USP 144,A00,890280,Chowdhury; Muhammed Zohir,16,0,30,14
1746563050446,USP 150,A00,890281,Boomhower; Matthew Charles,4,0,30,26
1746563051476,USP 151,A00,890282,Staff,16,0,20,4
1746563052501,USP 162,A00,890283,Andrews; Abigail Leslie,16,0,20,4
1746563053526,USP 168,A00,920477,Kwak; Nancy,0,0,5,5
1746563054551,USP 181,A00,890284,Staff,3,0,20,17
1746563055577,USP 191A,A00,890285,Staff,12,0,20,8
1746563056603,VIS 101,A00,886512,Staff,26,0,75,49
1746563057627,VIS 103,A00,886513,Cruz; Edwin Teddy,61,0,75,14
1746563058654,VIS 108,A00,886514,Staff,3,0,15,12
1746563059681,VIS 127P,A00,886515,Shen; Kuiyi,80,0,146,66
1746563060705,VIS 149,A00,886516,Yoldas; Pinar,0,0,15,15
1746563061785,VIS 164,A00,886526,Erdmann; Dean,19,0,22,3
1746563062811,VIS 194S,A00,886527,Staff,61,0,75,14
1746563063839,WCWP 10A,C00,886484,Martiniuk; Jill,12,0,15,3
1746563064870,WCWP 10B,A00,886490,Uriarte; Emma,0,0,15,15
1746563064870,WCWP 10B,B00,886491,Dhir; Simrita,10,0,15,5
1746563064870,WCWP 10B,C00,886492,Ornelas; Tricia,0,0,15,15
1746563065895,WCWP 100,A00,886494,Young; Mark T,0,6,15,15
1746563067990,AAS 10,A01,886199,Childs; Dennis R.,0,3,0,0
1746563069014,ANAR 104,A01,886940,Shtienberg; Gilad,27,0,30,3
1746563070038,ANAR 120,A00,886953,Staff,12,0,20,8
1746563071062,ANBI 148,A01,886955,Wilder; Linnea Lorene,30,0,40,10
1746563073112,ANSC 122,A00,886957,Staff,25,0,30,5
1746563074137,ANSC 150,A00,886958,Sloane; Julia Kathryn,2,0,15,13
1746563075166,ANSC 156,A00,886959,Jenkins; Janis A.,0,1,15,15
1746563076191,ANSC 180,A00,886960,Staff,11,0,17,6
1746563077217,ANSC 188,A00,886961,Jassal; Aftab,9,0,25,16
1746563078245,ANSC 190,A00,886962,Jassal; Aftab,14,0,25,11
1746563079270,ANSC 191,A00,886963,Staff,18,0,20,2
1746563080298,ANTH 3,A01,891689,Staff,17,0,20,3
1746563081325,ANTH 5,A00,886933,Semendeferi; Ekaterini,16,0,20,4
1746563082354,ANTH 10,A00,886934,Staff,0,12,30,30
1746563083378,ANTH 21,A01,886936,Staff,41,0,60,19
1746563084404,ANTH 23,A01,886938,Staff,92,0,100,8
1746563085428,ANTH 105,A00,886964,Stewart; Alexander B,84,0,100,16
1746563086455,ANTH 108,A00,886965,Pedersen; David,9,0,20,11
1746563087482,AWP 10,001,886147,Staff,0,0,0,0
1746563087482,AWP 10,002,886148,Staff,0,0,0,0
1746563087482,AWP 10,003,886149,Staff,0,0,0,0
1746563087482,AWP 10,004,886150,Staff,0,0,0,0
1746563087482,AWP 10,005,886151,Staff,0,0,0,0
1746563087482,AWP 10,006,886152,Staff,0,0,0,0
1746563087482,AWP 10,007,886153,Staff,0,0,0,0
1746563087482,AWP 10,008,886154,Staff,0,0,0,0
1746563087482,AWP 10,009,886155,Staff,0,0,0,0
1746563087482,AWP 10,010,886156,Staff,0,0,0,0
1746563087482,AWP 10,011,886158,Staff,0,0,0,0
1746563087482,AWP 10,012,886160,Staff,0,0,0,0
1746563087482,AWP 10,013,886161,Staff,0,0,0,0
1746563087482,AWP 10,014,886162,Staff,0,0,0,0
1746563087482,AWP 10,015,886163,Staff,0,0,0,0
1746563087482,AWP 10,016,886164,Staff,0,0,0,0
1746563087482,AWP 10,017,886165,Staff,0,0,0,0
1746563087482,AWP 10,018,886166,Staff,0,0,0,0
1746563087482,AWP 10,019,886168,Staff,0,0,0,0
1746563087482,AWP 10,020,886170,Staff,0,0,0,0
1746563087482,AWP 10,021,886172,Staff,0,0,0,0
1746563088507,AWP 10R,001,886173,Staff,0,1,0,0
1746563088507,AWP 10R,002,886174,Staff,0,1,0,0
1746563088507,AWP 10R,003,886175,Staff,0,0,0,0
1746563088507,AWP 10R,004,886176,Staff,0,0,0,0
1746563088507,AWP 10R,005,886177,Staff,0,0,0,0
1746563088507,AWP 10R,006,886178,Staff,0,0,0,0
1746563088507,AWP 10R,007,886179,Staff,0,0,0,0
1746563088507,AWP 10R,008,886181,Staff,0,0,0,0
1746563088507,AWP 10R,009,886182,Staff,0,0,0,0
1746563088507,AWP 10R,010,886183,Staff,0,0,0,0
1746563088507,AWP 10R,011,886184,Staff,0,0,0,0
1746563088507,AWP 10R,012,886185,Staff,0,0,0,0
1746563088507,AWP 10R,013,886186,Staff,0,0,0,0
1746563088507,AWP 10R,014,886187,Staff,0,0,0,0
1746563088507,AWP 10R,015,886188,Staff,0,0,0,0
1746563088507,AWP 10R,016,886189,Staff,0,0,0,0
1746563088507,AWP 10R,017,960532,Staff,0,0,0,0
1746563088507,AWP 10R,018,960533,Staff,0,0,0,0
1746563088507,AWP 10R,019,960534,Staff,0,0,0,0
1746563088507,AWP 10R,020,960538,Staff,0,0,0,0
1746563088507,AWP 10R,021,960540,Staff,0,0,0,0
1746563088507,AWP 10R,022,960541,Staff,0,0,0,0
1746563088507,AWP 10R,023,960542,Staff,0,0,0,0
1746563088507,AWP 10R,024,960544,Staff,0,0,0,0
1746563088507,AWP 10R,025,960545,Staff,0,0,0,0
1746563088507,AWP 10R,026,960548,Staff,0,0,0,0
1746563089532,AWP 102R,A00,886190,Staff,0,0,0,0
1746563089532,AWP 102R,B00,886191,Staff,0,0,0,0
1746563090561,BENG 100,A01,886193,Staff,17,0,30,13
1746563091590,BENG 122A,A01,886195,Hasty; Jeff M,13,0,30,17
1746563092615,BENG 166A,A00,886196,Sah; Robert Lie-Yuan,0,2,30,30
1746563093641,BENG 190,A00,958050,Khojah; Reem I,21,0,25,4
1746563094668,BIBC 102,A01,894320,Staff,0,0,46,46
1746563094668,BIBC 102,A02,894321,Staff,0,0,46,46
1746563094668,BIBC 102,A03,894344,Staff,7,0,46,39
1746563094668,BIBC 102,A04,894345,Staff,26,0,47,21
1746563095700,BICD 100R,A01,894365,Smith; Laurie,0,3,58,58
1746563095700,BICD 100R,A02,894366,Smith; Laurie,0,5,58,58
1746563095700,BICD 100R,A03,894367,Smith; Laurie,1,0,59,58
1746563095700,BICD 100R,A04,959869,Smith; Laurie,40,0,59,19
1746563096730,BICD 136,A01,894383,Gustafson-Brown; Cindy,14,0,50,36
1746563097754,BIEB 102,A01,894494,Butler; Shannon Rhey,51,0,130,79
1746563099809,BIEB 150,A01,894617,Wills; Christopher,3,0,20,17
1746563099809,BIEB 150,A02,894631,Wills; Christopher,3,0,20,17
1746563099809,BIEB 150,A03,894937,Wills; Christopher,3,0,20,17
1746563099809,BIEB 150,A04,894946,Wills; Christopher,5,0,20,15
1746563100837,BIEB 194,A00,906141,Kurle; Carolyn M.,6,0,20,14
1746563101873,BILD 1,A01,894154,Staff,3,0,19,16
1746563101873,BILD 1,A02,894155,Staff,14,0,19,5
1746563101873,BILD 1,A03,894160,Staff,13,0,19,6
1746563101873,BILD 1,A04,894161,Staff,15,0,18,3
1746563102898,BILD 2,A01,894168,Staff,0,0,50,50
1746563102898,BILD 2,A02,894169,Staff,0,0,50,50
1746563102898,BILD 2,A03,894179,Staff,0,0,50,50
1746563102898,BILD 2,A04,894203,Staff,26,0,50,24
1746563103927,BILD 3,A01,894213,Staff,22,0,31,9
1746563103927,BILD 3,A02,894214,Staff,26,0,31,5
1746563103927,BILD 3,A03,894235,Staff,28,0,31,3
1746563103927,BILD 3,A04,894236,Staff,28,0,32,4
1746563104953,BILD 4,A01,894253,Reuther; Keefe,5,0,24,19
1746563104953,BILD 4,A02,894258,Reuther; Keefe,16,0,24,8
1746563105982,BILD 5,A01,894276,Reuther; Keefe,35,0,50,15
1746563105982,BILD 5,A02,894277,Reuther; Keefe,45,0,50,5
1746563105982,BILD 5,A03,894290,Reuther; Keefe,44,0,50,6
1746563105982,BILD 5,A04,894291,Reuther; Keefe,48,0,50,2
1746563107009,BILD 24,A01,894297,Pirino; Giorgia,40,0,60,20
1746563108034,BIMM 100,B01,958915,Staff,71,0,100,29
1746563109062,BIMM 101,A01,895017,McDonnell; Lisa Marie,0,5,24,24
1746563109062,BIMM 101,A02,895018,McDonnell; Lisa Marie,0,5,24,24
1746563109062,BIMM 101,B01,895020,McDonnell; Lisa Marie,0,6,24,24
1746563109062,BIMM 101,B02,895021,McDonnell; Lisa Marie,0,4,24,24
1746563110092,BIMM 110,A01,895023,Staff,1,0,25,24
1746563110092,BIMM 110,A02,895024,Staff,9,0,25,16
1746563110092,BIMM 110,A03,895025,Staff,18,0,25,7
1746563110092,BIMM 110,A04,895031,Staff,20,0,25,5
1746563111118,BIMM 120,A01,895114,Gustafson-Brown; Cindy,14,0,28,14
1746563111118,BIMM 120,A02,895126,Gustafson-Brown; Cindy,21,0,27,6
1746563112144,BIPN 100,A01,895130,Yang; Mingyu,1,0,38,37
1746563112144,BIPN 100,A02,895131,Yang; Mingyu,32,0,38,6
1746563112144,BIPN 100,A03,895132,Yang; Mingyu,32,0,38,6
1746563112144,BIPN 100,A04,895133,Yang; Mingyu,27,0,36,9
1746563113169,BIPN 120,A01,895135,Cooke; James Edward,0,3,13,13
1746563113169,BIPN 120,A02,895136,Cooke; James Edward,0,1,13,13
1746563113169,BIPN 120,A03,895137,Cooke; James Edward,0,3,13,13
1746563113169,BIPN 120,A04,895156,Cooke; James Edward,0,2,11,11
1746563114199,BIPN 134,A01,895235,Cooke; James Edward,0,2,25,25
1746563114199,BIPN 134,A02,895237,Cooke; James Edward,0,0,25,25
1746563114199,BIPN 134,A03,895240,Cooke; James Edward,3,0,25,22
1746563114199,BIPN 134,A04,895270,Cooke; James Edward,20,0,25,5
1746563115222,BIPN 189,A00,892103,Staff,0,13,14,14
1746563117273,BISP 194,A00,958008,Staff,0,2,0,0
1746563118299,CAT 124,A01,922009,Staff,0,5,20,20
1746563119325,CAT 125R,A00,886390,Morales; Celeste Georgianna,0,2,20,20
1746563119325,CAT 125R,B00,886391,Irwin; Matthew Joseph,0,4,20,20
1746563119325,CAT 125R,C00,886392,Smith; Lauryn Alissa,0,2,20,20
1746563119325,CAT 125R,D00,886393,Vanderschuit; Maya Alysia,0,2,20,20
1746563119325,CAT 125R,E00,886394,Marchisotto; Jennifer Anne,0,3,20,20
1746563120353,CENG 15,A01,886218,Drews; Aaron,3,0,8,5
1746563121379,CENG 113,A00,886219,Opatkiewicz; Justin Paul,15,0,25,10
1746563122415,CGS 101,A00,887044,Staff,7,0,20,13
1746563123443,CGS 105,A01,887046,Staff,14,0,25,11
1746563124468,CGS 112,A00,887047,Cuong; Marisol,12,0,15,3
1746563125492,CGS 113,A00,887048,Staff,23,0,30,7
1746563126519,CGS 120,A00,887049,Staff,10,0,17,7
1746563127549,CHEM 6A,A01,886336,Lam; Tin Yiu,38,0,50,12
1746563127549,CHEM 6A,A02,886338,Lam; Tin Yiu,37,0,50,13
1746563128572,CHEM 6B,A01,886341,Hopkins; Patrycja Anna,16,0,50,34
1746563128572,CHEM 6B,A02,886343,Hopkins; Patrycja Anna,42,0,50,8
1746563129599,CHEM 6C,A01,886346,Albizati; Kim F.,0,2,50,50
1746563129599,CHEM 6C,A02,886348,Albizati; Kim F.,23,0,50,27
1746563130626,CHEM 40A,A01,886352,Klosterman; Jeremy K,65,0,100,35
1746563131655,CHEM 40B,A01,886356,Klosterman; Jeremy K,0,23,100,100
1746563132682,CHEM 41B,A01,886360,Theodorakis; Emmanuel,25,0,50,25
1746563132682,CHEM 41B,A02,886362,Theodorakis; Emmanuel,47,0,50,3
1746563133707,CHIN 165A,A00,886382,Xu; Li,18,0,20,2
1746563134733,CLAS 120,A00,886387,Myerston Santana; Jacobo,33,0,40,7
1746563135762,COGS 9,A01,886967,Shannon; Kyle Michael,42,0,60,18
1746563136786,COGS 11,A01,886969,Staff,10,0,30,20
1746563137811,COGS 14A,A01,886971,Staff,6,0,60,54
1746563138839,COGS 14B,A01,886973,Hoffman; Drew Ellen,4,0,60,56
1746563139867,COGS 18,A01,886975,Morgan; Eric,35,0,60,25
1746563140896,COGS 20,A01,886977,Staff,4,0,8,4
1746563140896,COGS 20,A02,886978,Staff,5,0,7,2
1746563141924,COGS 100,A01,907783,Staff,0,2,30,30
1746563142949,COGS 101B,A01,886980,Staff,0,3,48,48
1746563143978,COGS 101C,A01,886982,Delgado; Tania,0,5,44,44
1746563145005,COGS 102A,A01,886984,Johnson; Christine M.,4,0,30,26
1746563146029,COGS 118B,A01,886986,Staff,0,3,88,88
1746563147057,COGS 150,A01,886988,Bergen; Benjamin,22,0,50,28
1746563148082,COGS 153,A00,886989,Delgado; Tania,0,2,41,41
1746563149109,COGS 186,A01,886991,Staff,0,0,32,32
1746563150134,COGS 187A,A01,886993,Boyle; Mary E. T.,7,0,30,23
1746563151158,COGS 189,A00,886994,Staff,0,1,30,30
1746563152183,COMM 10,A01,886996,Staff,0,0,20,21
1746563152183,COMM 10,A02,886997,Staff,12,0,20,8
1746563152183,COMM 10,A03,959845,Staff,19,0,20,1
1746563153210,COMM 20,A01,886999,Leuning; Grant Maurstad,24,0,40,16
1746563155266,COMM 100A,A01,887002,Staff,0,0,20,25
1746563155266,COMM 100A,A02,887003,Staff,7,0,20,13
1746563156290,COMM 100B,A01,887005,Staff,0,8,20,24
1746563157315,COMM 106D,A00,887006,Staff,14,0,40,26
1746563158342,COMM 110G,A00,887007,Whitworth-Smith; Andrew C,12,0,40,28
1746563159367,COMM 111B,A00,887008,Staff,31,0,40,9
1746563160395,COMM 113T,A00,887009,Abuelhiga; Soraya Jill,28,0,40,12
1746563160395,COMM 113T,B00,906733,Staff,40,0,40,0
1746563161420,COMM 145,A00,887010,Staff,12,0,40,28
1746563162449,COMM 146,A00,887054,Staff,31,0,40,9
1746563163473,COMM 190,A00,887012,Staff,8,0,23,15
1746563164497,CSE 8A,A50,887015,Cao; Yingjun,57,0,85,28
1746563165560,CSE 11,A01,887017,Cao; Yingjun,12,0,70,58
1746563166590,CSE 20,A01,887019,Staff,30,0,50,20
1746563167615,CSE 21,A01,887021,Staff,78,0,100,22
1746563167615,CSE 21,B01,892583,Braun; Oliver,45,0,50,5
1746563168640,CSE 30,A01,887025,Eldon; John,143,0,200,57
1746563169664,CSE 100,A01,887027,Staff,26,0,50,24
1746563169664,CSE 100,A02,887028,Staff,42,0,50,8
1746563170695,CSE 101,A01,887030,Braun; Oliver,74,0,100,26
1746563170695,CSE 101,B01,887032,Jones; Miles E,0,3,50,50
1746563170695,CSE 101,B02,887033,Jones; Miles E,0,2,50,50
1746563171719,CSE 105,A01,908084,Jones; Miles E,32,0,50,18
1746563171719,CSE 105,A02,908087,Jones; Miles E,32,0,50,18
1746563172744,CSE 135,A01,887035,Powell; Thomas Allan,0,4,50,50
1746563173773,CSE 142,A01,887037,Staff,8,0,60,52
1746563174797,CSE 142L,A01,887039,Staff,34,0,60,26
1746563175828,CSE 151A,A01,887041,Solares; Edwin A,47,0,100,53
1746563176858,CSE 175,A01,887043,Kumar; Rakesh,30,0,30,0
1746563177885,CSS 1,A01,886389,Staff,1,1,40,39
1746563178912,DSC 30,A01,908097,Liao; Soohyun Nam,47,0,75,28
1746563179942,DSC 40A,A01,908099,Shannon; Kyle Michael,30,0,50,20
1746563180969,DSC 40B,A01,908112,Staff,16,0,50,34
1746563181994,DSC 80,A01,908116,Staff,19,0,60,41
1746563183023,DSC 197,001,956863,Eldridge; Justin Matthew,9999,0,9999,0
1746563184054,ECE 5,A01,886400,Morris; Karcher William,2,0,6,4
1746563184054,ECE 5,A02,886401,Morris; Karcher William,3,0,6,3
1746563185079,ECE 148,A01,886403,Silberman; Jack,0,14,14,14
1746563186106,ECON 1,A01,887265,Crane; Meredith Helen,12,0,70,58
1746563186106,ECON 1,B01,887268,Staff,43,0,50,7
1746563187136,ECON 2,A01,887273,Crane; Meredith Helen,55,0,70,15
1746563188166,ECON 3,A01,887279,Rondina; Giacomo,32,0,70,38
1746563189194,ECON 4,A01,887282,Anderson; John Charles,0,2,10,10
1746563190223,ECON 5,A01,887285,Staff,34,0,45,11
1746563190223,ECON 5,B01,887292,Staff,41,0,45,4
1746563191247,ECON 100A,A01,887337,Newhouse; Herbert S,54,0,70,16
1746563191247,ECON 100A,B01,887349,Staff,45,0,50,5
1746563192275,ECON 100B,A01,887361,Du; Songzi,29,0,70,41
1746563193300,ECON 100C,A01,887445,Newhouse; Herbert S,59,0,70,11
1746563194325,ECON 105,A00,887488,Vespa; Emanuel Ignacio,23,0,35,12
1746563195353,ECON 109,A01,887506,Shishkin; Denis,28,0,35,7
1746563196379,ECON 110A,A01,887568,Alon; Titan Michael,0,3,35,35
1746563196379,ECON 110A,B01,907601,Alon; Titan Michael,20,0,35,15
1746563197407,ECON 110B,A01,887598,Levkoff; Steven B.,0,24,70,70
1746563198433,ECON 112,A00,887599,Rondina; Giacomo,19,0,35,16
1746563199461,ECON 120A,A01,887603,Dai; Yinlin,35,0,70,35
1746563200489,ECON 120C,A01,887608,Sun; Yixiao,0,1,35,35
1746563200489,ECON 120C,B01,887614,Sun; Yixiao,0,0,35,35
1746563201516,ECON 138,A00,887621,Bharadwaj; Prashant,0,21,20,20
1746563202541,ECON 144,A00,958007,Squires; Dale E,13,0,35,22
1746563203568,ECON 171,A01,907666,Staff,18,0,35,17
1746563204597,ECON 175,A00,887626,Wu; Pak Yeung,23,0,35,12
1746563205624,ECON 190,A00,887640,Vespa; Emanuel Ignacio,23,0,35,12
1746563206651,EDS 25,A01,888197,Staff,0,0,0,0
1746563206651,EDS 25,A02,888209,Staff,0,0,0,0
1746563206651,EDS 25,A03,888210,Staff,0,0,0,0
1746563206651,EDS 25,A04,888212,Staff,0,0,0,0
1746563206651,EDS 25,A05,888213,Staff,0,0,0,0
1746563206651,EDS 25,A06,888214,Staff,0,0,0,0
1746563206651,EDS 25,A07,888235,Staff,0,2,0,0
1746563206651,EDS 25,A08,888236,Staff,0,0,0,0
1746563206651,EDS 25,A09,888240,Staff,0,0,0,0
1746563206651,EDS 25,A10,888244,Staff,0,0,0,0
1746563206651,EDS 25,B01,888273,Staff,0,0,0,0
1746563206651,EDS 25,B02,888285,Staff,0,0,0,0
1746563206651,EDS 25,B03,888423,Staff,0,0,0,1
1746563206651,EDS 25,B04,888432,Staff,0,0,0,0
1746563206651,EDS 25,B05,888433,Staff,0,0,0,0
1746563206651,EDS 25,B06,888467,Staff,0,0,0,0
1746563206651,EDS 25,B07,888468,Staff,0,0,0,0
1746563206651,EDS 25,B08,888479,Staff,0,0,0,0
1746563206651,EDS 25,B09,888484,Staff,0,0,0,0
1746563206651,EDS 25,B10,888487,Staff,0,0,0,0
1746563207679,EDS 38,A01,907700,Choi; Bailey Miyeon,30,0,30,0
1746563208704,EDS 112,A01,888601,Chapman; Thandeka K,13,0,40,27
1746563209734,EDS 115,A00,888697,Mendez; Kathrina Mendoza,10,0,30,20
1746563210759,EDS 116,A01,888893,Staff,35,0,40,5
1746563212807,EDS 124AR,A00,889133,Staff,29,0,50,21
1746563212807,EDS 124AR,B00,907471,Simon; Elizabeth A,37,0,50,13
1746563213834,EDS 124BR,A00,889134,Simon; Elizabeth A,44,0,100,56
1746563214858,EDS 125,A00,889135,Staff,25,0,30,5
1746563215885,EDS 126,A01,889138,Staff,36,0,40,4
1746563216910,EDS 164R,A01,889142,Wishard Guerra; Alison G.,33,0,50,17
1746563217937,ENG 30,A01,886396,Staff,0,0,0,0
1746563217937,ENG 30,B01,886398,Staff,0,0,0,0
1746563218966,ENVR 102,A00,906150,Montejo; Carolina,23,0,25,2
1746563219992,ETHN 103A,A00,887236,Man; Simeon S,0,3,0,0
1746563221019,ETHN 113,A00,887239,Staff,16,0,30,14
1746563222044,ETHN 116,A00,887240,Staff,16,0,25,9
1746563223072,ETHN 117,A00,887241,Choi; Esther Min,28,0,30,2
1746563224096,ETHN 118,A00,887243,Staff,24,0,30,6
1746563225123,ETHN 127,A00,887248,Cuong; Marisol,11,0,15,4
1746563226147,ETHN 139,A00,887250,Staff,7,0,10,3
1746563227172,ETHN 142,A00,887252,Staff,10,0,30,20
1746563228199,ETHN 161,A00,887253,Browne; Errol Tsekani,24,0,30,6
1746563229224,ETHN 163FR,A00,887255,Burelle; Julie Sara Veronique,0,0,5,5
1746563230248,GLBH 20,A00,889149,Elwardani; Nile Regina,8,0,42,34
1746563232301,GLBH 111,A01,889152,Burgos; Jose L.,17,0,17,0
1746563233326,GLBH 150,A00,889181,Sloane; Julia Kathryn,0,5,15,15
1746563235377,HDS 60,A01,886406,Warstadt; Melissa Fawn,73,0,80,7
1746563236400,HIAF 111,A00,889324,Gyamfi; Bright,25,0,32,7
1746563237425,HIEA 131,A00,889328,Staff,15,0,32,17
1746563238454,HIEA 144,A00,889333,Henry; Todd A.,26,0,32,6
1746563239480,HIEA 154,A00,889336,Henry; Todd A.,24,0,32,8
1746563240508,HIEU 106,A00,889339,Staff,22,0,32,10
1746563242562,HIEU 114,A00,889340,Staff,3,0,32,29
1746563243590,HIEU 135GS,A00,889342,Patterson; Patrick H.,0,0,1,24
1746563244619,HIEU 137,A00,889343,Edington; Claire Ellen,10,0,25,15
1746563245648,HIEU 148,A00,889345,Staff,14,0,32,18
1746563246674,HIEU 154,A00,889346,Biess; Frank Peter,21,0,32,11
1746563247699,HILA 102,A00,889351,Staff,12,0,32,20
1746563248725,HILD 2A,A01,889221,Lewandoski; Julia Mavis,1,10,32,31
1746563249749,HILD 7B,A01,889225,Man; Simeon S,0,12,32,32
1746563250782,HILD 7C,A01,889288,Alvarez; Luis A,0,14,32,32
1746563251807,HILD 30,A01,889323,Staff,0,5,32,32
1746563253861,HISC 119,A00,889383,Golan; Tal,20,0,32,12
1746563254884,HIUS 103,A00,889384,Man; Simeon S,0,0,32,32
1746563255910,HIUS 117,A00,919797,Kwak; Nancy,18,0,32,14
1746563256934,HIUS 142A,A00,919788,Staff,22,0,32,10
1746563258986,HIUS 149,A00,889386,Gyamfi; Bright,26,0,32,6
1746563260014,HIUS 155,A00,889387,Alvarez; Luis A,14,0,32,18
1746563261041,HUM 3,A01,886499,Caldwell; Michael Alan,19,0,50,31
1746563262067,HUM 3GS,A00,886500,Rodriguez; Bretton Sigfred,0,0,0,28
1746563263092,HUM 3R,A01,886502,Markman; Kristina,0,36,50,50
1746563264122,HUM 4,A01,886504,Crum; Matthew Stephen,24,0,50,26
1746563264122,HUM 4,B01,886506,West; Geoffrey Scott,17,0,50,33
1746563265163,HUM 4GS,A00,886507,Staff,0,0,0,19
1746563266189,HUM 5,A01,886509,Staff,32,0,50,18
1746563267215,HUM 5R,A01,886511,Zavodny; Tatiana Sophia,0,39,50,50
1746563268243,JAPN 180,A00,886407,Staff,17,0,40,23
1746563269311,LATI 50,A01,886409,Martin-Cabrera; Luis,4,0,22,18
1746563269311,LATI 50,A02,886410,Martin-Cabrera; Luis,19,0,22,3
1746563269311,LATI 50,A03,886411,Martin-Cabrera; Luis,21,0,22,1
1746563269311,LATI 50,A04,886412,Martin-Cabrera; Luis,9,0,22,13
1746563270338,LAWS 101,A00,907664,Staff,28,0,60,32
1746563271362,LIAB 1A,A00,889388,Saab; Dima,17,0,20,3
1746563272399,LIAB 1AX,A00,889389,El Cheddadi; Youniss,18,0,20,2
1746563273422,LIFR 1C,A00,889391,Van Moer; Vinciane G,8,0,20,12
1746563274448,LIFR 1CX,A00,889392,Van Moer; Vinciane G,7,0,20,13
1746563275473,LIFR 1D,A00,889393,Van Moer; Vinciane G,7,0,20,13
1746563276499,LIFR 1DX,A00,889394,Van Moer; Vinciane G,8,0,20,12
1746563277523,LIGN 7,A00,886923,Staff,24,0,50,26
1746563278547,LIGN 17,A00,886924,Kehler; Andrew Scott,125,0,150,25
1746563279572,LTAM 110,A00,889395,Staff,15,0,30,15
1746563280603,LTAM 110GS,A00,958010,Rodriguez; Bretton Sigfred,0,0,0,28
1746563281630,LTCH 101,A00,889397,Staff,23,0,25,2
1746563282655,LTCS 130,A00,889398,Staff,23,0,25,2
1746563283679,LTEA 138,A00,889399,Staff,24,0,40,16
1746563284703,LTEN 149,A00,889400,Wesling; Megan E.,0,3,25,25
1746563285729,LTEN 169,A00,889401,Staff,20,0,25,5
1746563286754,LTEN 180,A00,889402,Staff,10,0,15,5
1746563287778,LTEN 181,A00,889403,Staff,21,0,25,4
1746563288803,LTWL 100,A00,889404,Myerston Santana; Jacobo,2,0,25,23
1746563289829,LTWL 180GS,A00,889405,Staff,0,0,20,20
1746563290854,LTWL 181,A00,889406,Staff,16,0,25,9
1746563291878,LTWL 184,A00,889475,Mukherjee; Silpa,22,0,25,3
1746563292904,LTWR 102C,A00,889486,Staff,29,0,30,1
1746563293930,LTWR 115W,A00,889491,Staff,0,2,15,15
1746563294956,MAE 8,A01,886905,Staff,0,2,0,0
1746563295984,MAE 11,A00,886906,Bandaru; Prabhakar,0,7,50,50
1746563297008,MAE 20,A00,886907,Evdokimenko; Ekaterina,43,0,70,27
1746563298037,MAE 30B,A00,886909,Ghazinejad; Maziar,26,0,45,19
1746563299066,MAE 101B,A00,886910,Saintillan; David,29,0,45,16
1746563300092,MAE 105,A00,886911,Bandaru; Prabhakar,18,0,50,32
1746563301120,MAE 107,B00,958024,Staff,8,0,50,42
1746563302146,MAE 143B,A00,886913,Bewley; Thomas R,6,0,40,34
1746563303173,MAE 148,A01,886915,Silberman; Jack,0,3,14,14
1746563304203,MAE 160,A00,886916,Evdokimenko; Ekaterina,32,0,60,28
1746563305228,MATH 3C,A01,889681,Staff,0,2,30,30
1746563305228,MATH 3C,A02,960048,Staff,24,0,30,6
1746563306256,MATH 10A,A01,889760,Staff,26,0,30,4
1746563306256,MATH 10A,A02,889783,Staff,29,0,30,1
1746563307283,MATH 10B,A01,889785,Verstraete; Jacques Allan,2,0,35,33
1746563307283,MATH 10B,A02,889795,Verstraete; Jacques Allan,4,0,35,31
1746563307283,MATH 10B,B01,889797,Verstraete; Jacques Allan,3,0,35,32
1746563307283,MATH 10B,B02,889828,Verstraete; Jacques Allan,3,0,35,32
1746563308312,MATH 10C,A01,889849,Habib; Yousaf,8,0,30,22
1746563308312,MATH 10C,A02,889852,Habib; Yousaf,14,0,30,16
1746563308312,MATH 10C,A03,889853,Habib; Yousaf,22,0,30,8
1746563308312,MATH 10C,A04,889858,Habib; Yousaf,20,0,30,10
1746563308312,MATH 10C,B01,889861,Staff,1,0,30,29
1746563308312,MATH 10C,B02,889862,Staff,24,0,30,6
1746563308312,MATH 10C,B03,889863,Staff,27,0,30,3
1746563308312,MATH 10C,B04,889967,Staff,23,0,30,7
1746563309342,MATH 18,A01,889974,Staff,7,0,30,23
1746563309342,MATH 18,A02,889977,Staff,20,0,30,10
1746563309342,MATH 18,B01,889984,Hardiman; Liam,21,0,30,9
1746563309342,MATH 18,B02,889985,Hardiman; Liam,25,0,30,5
1746563310369,MATH 20A,A01,889990,Suk; Andrew Hoon,30,0,35,5
1746563311397,MATH 20B,A01,889993,Ohm; Ko Woon,22,0,30,8
1746563311397,MATH 20B,A02,889994,Ohm; Ko Woon,30,0,30,0
1746563311397,MATH 20B,B01,889996,Ohm; Ko Woon,21,0,30,9
1746563311397,MATH 20B,B02,889997,Ohm; Ko Woon,23,0,30,7
1746563312423,MATH 20C,A01,889999,Hammock; Frances H,17,0,30,13
1746563312423,MATH 20C,A02,890003,Hammock; Frances H,23,0,30,7
1746563312423,MATH 20C,B01,890006,Hammock; Frances H,3,0,30,27
1746563312423,MATH 20C,B02,890007,Hammock; Frances H,11,0,30,19
1746563313452,MATH 20D,A01,890011,Cheng; Hsiao-Bing,1,1,30,29
1746563313452,MATH 20D,A02,890012,Cheng; Hsiao-Bing,14,0,30,16
1746563313452,MATH 20D,B01,890016,Cheng; Hsiao-Bing,13,0,30,17
1746563313452,MATH 20D,B02,890017,Cheng; Hsiao-Bing,13,0,30,17
1746563314480,MATH 20E,A01,890026,Harel; Guershon,1,0,30,29
1746563314480,MATH 20E,A02,890029,Harel; Guershon,23,0,30,7
1746563314480,MATH 20E,B01,890033,Harel; Guershon,7,0,30,23
1746563314480,MATH 20E,B02,890101,Harel; Guershon,21,0,30,9
1746563315508,MATH 102,A01,890104,Staff,17,0,30,13
1746563315508,MATH 102,A02,890105,Staff,27,0,30,3
1746563316535,MATH 103B,A01,890116,Salehi Golsefidy; Alireza,3,0,30,27
1746563316535,MATH 103B,B01,890118,Staff,0,3,34,34
1746563317560,MATH 109,A01,890121,Aliabadi Sr.; Mohsen,1,0,30,29
1746563317560,MATH 109,B01,890124,Upadrashta; Pranav Kumar,18,0,30,12
1746563318586,MATH 120A,A01,890126,Eggers; John Dietrich,13,0,30,17
1746563319612,MATH 142B,A01,890128,Ioana; Adrian,19,0,30,11
1746563319612,MATH 142B,A02,890129,Ioana; Adrian,13,0,30,17
1746563320638,MATH 154,A01,890174,Staff,0,0,30,30
1746563320638,MATH 154,A02,890182,Staff,0,0,30,30
1746563321665,MATH 168A,A01,890197,Dumitriu; Ioana,21,0,35,14
1746563322691,MATH 170A,A01,890240,Nie; Jiawang,1,0,30,29
1746563322691,MATH 170A,A02,890241,Nie; Jiawang,11,0,30,19
1746563322691,MATH 170A,A03,890249,Nie; Jiawang,23,0,30,7
1746563323719,MATH 170B,A01,957891,Nag; Panchali,13,0,35,22
1746563325767,MATH 181A,A01,908025,Staff,0,4,35,35
1746563325767,MATH 181A,A02,960115,Staff,27,0,35,8
1746563326794,MATH 181B,A01,959874,Staff,25,0,30,5
1746563327819,MATH 193B,A01,890265,Staff,0,4,35,35
1746563328844,MGT 4,A01,890311,Anderson; John Charles,42,0,88,46
1746563329870,MGT 5,A00,907740,Staff,13,0,98,85
1746563330895,MGT 12,A00,890312,Lindenberger; Wade Douglas,67,0,98,31
1746563331922,MGT 16,A00,957883,Staff,78,0,98,20
1746563333972,MGT 45,A00,890314,Pecore; Joseph P.,46,0,98,52
1746563334998,MGT 71,A00,890315,Staff,0,11,98,98
1746563336026,MGT 100,A00,890316,Yavorsky; Daniel Ryan,44,0,98,54
1746563337052,MGT 103,A00,890317,Ehrich; Kristine R,73,0,98,25
1746563338077,MGT 105,A00,890356,Bates; Kenneth Walter,0,8,98,98
1746563339105,MGT 112,A00,890360,Ehrich; Kristine R,55,0,98,43
1746563340132,MGT 127R,A00,907732,Zhu; Kevin Xiaoguo,23,0,98,75
1746563341161,MGT 131B,A00,890361,Anderson; John Charles,60,0,98,38
1746563342187,MGT 137,A00,890362,Lindenberger; Wade Douglas,65,0,98,33
1746563343210,MGT 160,A00,890369,Johnson; Erik Barry,9,0,98,89
1746563345260,MGT 164,A00,890372,Zimmermann; Carsten,0,40,98,98
1746563346299,MGT 180,A00,890374,Bliss; Barbara Ann,12,0,98,86
1746563347328,MMW 15,A01,886414,Chang; Edmond Yi-Teh,0,12,28,28
1746563347328,MMW 15,A02,886415,Chang; Edmond Yi-Teh,0,8,28,28
1746563347328,MMW 15,A03,886416,Chang; Edmond Yi-Teh,0,8,28,28
1746563347328,MMW 15,A04,886417,Chang; Edmond Yi-Teh,0,8,28,28
1746563347328,MMW 15,B01,886419,Chang; Edmond Yi-Teh,0,7,28,28
1746563347328,MMW 15,B02,886420,Chang; Edmond Yi-Teh,0,8,28,28
1746563347328,MMW 15,B03,886421,Chang; Edmond Yi-Teh,0,7,28,28
1746563347328,MMW 15,B04,886422,Chang; Edmond Yi-Teh,0,8,28,28
1746563347328,MMW 15,C01,886424,Staff,0,9,28,28
1746563347328,MMW 15,C02,886425,Staff,0,8,28,28
1746563347328,MMW 15,C03,886426,Staff,0,8,28,28
1746563347328,MMW 15,C04,886427,Staff,0,8,28,28
1746563347328,MMW 15,C05,958038,Staff,0,8,28,28
1746563347328,MMW 15,C06,958039,Staff,0,8,28,28
1746563348355,MMW 15GS,A00,906910,Patterson; Patrick H.,4,0,28,24
1746563349382,MMW 122R,A01,886429,Rahimi; Babak,0,13,28,28
1746563349382,MMW 122R,A02,886430,Rahimi; Babak,0,12,28,28
1746563349382,MMW 122R,A03,958040,Rahimi; Babak,0,11,28,28
1746563350412,MUS 1A,A01,890937,Staff,2,0,25,23
1746563350412,MUS 1A,A02,891035,Staff,6,0,25,19
1746563350412,MUS 1A,C01,958912,Staff,24,0,25,1
1746563350412,MUS 1A,C02,958913,Staff,25,0,25,0
1746563352478,MUS 2AK,A00,957092,Ohnishi; Takae,15,0,15,0
1746563353502,MUS 4,A01,891044,Staff,2,0,25,23
1746563353502,MUS 4,A02,891045,Staff,23,0,25,2
1746563353502,MUS 4,B01,891048,Staff,17,0,25,8
1746563353502,MUS 4,B02,891050,Staff,25,0,25,0
1746563354529,MUS 5,A01,957506,Dubnov; Shlomo,0,0,25,25
1746563354529,MUS 5,A02,957622,Dubnov; Shlomo,13,0,25,12
1746563354529,MUS 5,A03,957623,Dubnov; Shlomo,20,0,25,5
1746563355552,MUS 6,A01,891053,Freitas Caetano; Marcelo,24,0,25,1
1746563355552,MUS 6,A02,891054,Freitas Caetano; Marcelo,23,0,25,2
1746563356578,MUS 7,A01,891081,Staff,0,0,25,25
1746563356578,MUS 7,A02,891082,Staff,4,0,25,21
1746563357605,MUS 8GS,A00,891118,Borgo; David Garcia,0,0,25,25
1746563358633,MUS 11,A01,891140,Staff,10,0,25,15
1746563358633,MUS 11,A02,891141,Staff,22,0,25,3
1746563359659,MUS 13,A01,891143,Staff,8,0,25,17
1746563359659,MUS 13,A02,891144,Staff,24,0,25,1
1746563360686,MUS 15,A01,891146,Staff,9,0,25,16
1746563360686,MUS 15,A02,891148,Staff,21,0,25,4
1746563360686,MUS 15,B01,891150,Staff,18,0,25,7
1746563360686,MUS 15,B02,891151,Staff,25,0,25,0
1746563361713,MUS 20,A01,891153,Staff,5,0,20,15
1746563361713,MUS 20,A02,891155,Staff,14,0,20,6
1746563362736,MUS 80,A00,891156,Staff,19,0,25,6
1746563362736,MUS 80,B00,891157,Staff,23,0,25,2
1746563363760,MUS 130,A00,891158,Ohnishi; Takae,35,0,35,0
1746563364784,MUS 150GS,A01,891160,Borgo; David Garcia,0,0,25,25
1746563365810,MUS 170,A01,891162,Freitas Caetano; Marcelo,20,0,25,5
1746563365810,MUS 170,A02,891164,Freitas Caetano; Marcelo,21,0,25,4
1746563366835,NANO 11,A00,886220,Vazquez Mena; Oscar,13,0,15,2
1746563367860,NANO 15,A01,886222,Drews; Aaron,4,0,7,3
1746563368884,NANO 104,A00,886224,Sirbuly; Donald,18,0,25,7
1746563369910,PH 40,A00,886528,Staff,23,0,40,17
1746563370941,PH 45,A01,886799,Staff,35,0,40,5
1746563371966,PH 110,A00,886802,Staff,0,7,40,40
1746563372991,PH 172,A00,906716,Staff,19,0,35,16
1746563374016,PH 191,A00,886803,Staff,6,0,40,34
1746563375043,PHIL 1,A00,889500,Staff,20,0,30,10
1746563376087,PHIL 10,A01,889549,Grush; Rick Scott,15,0,22,7
1746563376087,PHIL 10,A02,889551,Grush; Rick Scott,22,0,22,0
1746563377119,PHIL 28,A01,889559,Lamey; Andy M.,0,1,31,31
1746563377119,PHIL 28,A02,889561,Lamey; Andy M.,0,1,30,30
1746563377119,PHIL 28,A03,889572,Lamey; Andy M.,0,1,30,30
1746563378145,PHIL 35,A00,907839,Staff,13,0,15,2
1746563379171,PHIL 60,A00,889574,Staff,73,0,90,17
1746563380198,PHIL 101,A00,958004,Staff,12,0,15,3
1746563382254,PHIL 136,A00,889582,Fulkerson; Matthew Todd,26,0,45,19
1746563383302,PHIL 163,A01,889601,Staff,21,0,30,9
1746563383302,PHIL 163,B01,889606,Brandt; Reuven A,0,3,0,0
1746563384330,PHIL 164,A00,889610,Staff,16,0,30,14
1746563385358,PHIL 165,A00,889613,Staff,23,0,30,7
1746563386381,PHYS 1A,A00,886431,Staff,26,0,70,44
1746563387404,PHYS 1AL,001,886432,Tsai; Philbert S,0,2,30,30
1746563387404,PHYS 1AL,002,886436,Tsai; Philbert S,11,0,30,19
1746563388432,PHYS 1B,A00,886439,Staff,185,0,240,55
1746563389456,PHYS 1BL,001,886441,Tsai; Philbert S,0,4,30,30
1746563389456,PHYS 1BL,002,886444,Tsai; Philbert S,2,0,30,28
1746563390483,PHYS 1C,A00,896092,Arnold; Kam S,79,0,146,67
1746563391508,PHYS 1CL,001,886448,Tsai; Philbert S,0,0,30,30
1746563391508,PHYS 1CL,002,886449,Tsai; Philbert S,1,0,30,29
1746563391508,PHYS 1CL,003,886450,Tsai; Philbert S,16,0,30,14
1746563391508,PHYS 1CL,004,886451,Tsai; Philbert S,15,0,30,15
1746563392531,PHYS 2B,A01,886457,Staff,68,0,115,47
1746563393558,PHYS 2C,A01,886460,Shotwell; Brian,0,9,65,65
1746563394583,PHYS 2CL,A01,886467,Staff,0,4,28,28
1746563394583,PHYS 2CL,A02,886468,Staff,0,3,28,28
1746563395609,PHYS 2D,A01,886470,Staff,10,0,50,40
1746563396634,PHYS 4B,A01,886475,Grinstein; Benjamin,22,0,40,18
1746563397661,POLI 5,A00,891173,Desposato; Scott,7,0,25,18
1746563398701,POLI 5D,A01,891175,Staff,5,0,5,0
1746563398701,POLI 5D,B01,891178,Staff,5,0,5,0
1746563399727,POLI 11,A00,891179,Ferree; Karen E,2,0,35,33
1746563400751,POLI 12,A00,891180,Staff,16,0,30,14
1746563401779,POLI 27,A01,891182,Staff,12,0,75,63
1746563402808,POLI 30,A00,891183,Staff,8,0,50,42
1746563403834,POLI 100B,A00,891244,Staff,5,1,35,30
1746563404860,POLI 100I,A00,891247,Staff,7,0,30,23
1746563405886,POLI 104J,A00,891248,Nichter; Maysa,14,0,30,16
1746563406914,POLI 104U,A00,891250,Nichter; Maysa,2,0,30,28
1746563408965,POLI 110B,A00,891255,Wiens; David,20,0,25,5
1746563409992,POLI 112A,A00,891256,Wiens; David,6,0,25,19
1746563411018,POLI 114BR,A00,891261,Staff,19,0,30,11
1746563412043,POLI 117R,A00,891262,Forman; Fonna,0,6,50,50
1746563413068,POLI 118,A00,891264,Ingham; Sean,17,0,25,8
1746563414101,POLI 124A,A00,891265,Staff,18,0,20,2
1746563415125,POLI 125D,A00,891266,Nichter; Simeon C,2,0,25,23
1746563416150,POLI 126,A00,891268,Nichter; Simeon C,7,0,25,18
1746563417176,POLI 126AA,A00,891272,Staff,17,0,25,8
1746563418201,POLI 130AA,A00,891273,Staff,15,0,20,5
1746563419227,POLI 134AA,A00,891274,Staff,4,0,20,16
1746563421281,POLI 138,A00,891278,Staff,21,0,25,4
1746563422308,POLI 142K,A00,891280,Staff,11,0,25,14
1746563423337,POLI 142M,A00,891281,Gartzke; Erik,17,0,30,13
1746563424363,POLI 142P,A00,891284,Staff,20,0,30,10
1746563425388,POLI 143,A00,891285,Gartzke; Erik,12,0,30,18
1746563426414,POLI 153,A00,891286,Staff,19,0,20,1
1746563428465,POLI 175,A00,891290,Staff,15,0,20,5
1746563429492,PSYC 1,A00,890674,Steiner; Eric Tomas,0,11,45,45
1746563430520,PSYC 2,A00,890676,Albright; Thomas D,21,0,35,14
1746563431548,PSYC 3,A00,890679,Staff,17,0,20,3
1746563432574,PSYC 6,A00,959858,Staff,20,0,20,0
1746563433599,PSYC 60,A01,890684,Rickard; Timothy C.,0,5,45,45
1746563434627,PSYC 70,A01,890689,Geller; Emma Harlan,7,0,30,23
1746563435651,PSYC 71,A01,959860,Staff,21,0,25,4
1746563436676,PSYC 100,A00,890690,Lacefield; Katharine I,0,50,180,180
1746563437702,PSYC 102,A00,890695,Staff,18,0,40,22
1746563438728,PSYC 105,A00,890699,Geller; Emma Harlan,70,0,100,30
1746563439758,PSYC 106,A00,890701,Gorman; Michael R.,6,0,30,24
1746563440787,PSYC 108,A00,890704,Adrian; Julia Anna,0,28,50,50
1746563441811,PSYC 118,A01,890712,Staff,11,0,30,19
1746563442837,PSYC 124,A00,890716,Chapman; Eddie Nathaniel,25,0,60,35
1746563443865,PSYC 131,A00,890717,Anagnostaras; Stephan,0,7,80,80
1746563444890,PSYC 137,A00,890719,Winkielman; Piotr,0,11,30,30
1746563445917,PSYC 144,A00,890721,Adrian; Julia Anna,0,9,45,45
1746563446941,PSYC 162,A00,890805,Staff,1,0,75,74
1746563447967,PSYC 169,A00,890810,Staff,0,14,30,30
1746563448995,PSYC 172,A00,890814,Gorman; Michael R.,9,0,30,21
1746563450036,PSYC 181,A00,890818,Anagnostaras; Stephan,9,0,200,191
1746563451063,PSYC 184,A00,959861,Staff,168,0,175,7
1746563452088,PSYC 189,A00,890823,Staff,0,1,30,30
1746563453117,PSYC 191,A00,890884,Rickard; Timothy C.,0,11,35,35
1746563454141,PSYC 193,A00,890913,Staff,19,0,30,11
1746563454141,PSYC 193,B00,890914,Chapman; Eddie Nathaniel,24,0,30,6
1746563455167,PSYC 193L,A01,890918,Lowe; Angela Beth,20,0,30,10
1746563455167,PSYC 193L,B01,890921,Hurwitz; Ethan Scott,20,0,30,10
1746563455167,PSYC 193L,C01,890928,Staff,30,0,30,0
1746563456193,RELI 149,A00,886806,Rahimi; Babak,23,0,40,17
1746563457221,SE 9,A01,886814,Staff,7,0,20,13
1746563458245,SE 101B,A01,886816,Chadha; Mayank,4,0,35,31
1746563459271,SE 110B,A00,886818,Zhu; Qiang,4,0,75,71
1746563460297,SE 125,A01,886830,Staff,10,0,30,20
1746563461326,SE 130B,A01,886835,Staff,14,0,40,26
1746563462352,SE 131A,A01,886838,Krysl; Petr,34,0,55,21
1746563463379,SE 154,A00,886840,Staff,29,0,50,21
1746563464407,SE 164GS,A01,886849,Staff,6,0,20,14
1746563465434,SE 167GS,A01,886853,Staff,6,0,20,14
1746563466460,SIO 25,A01,890107,Staff,19,0,30,11
1746563467488,SIO 45,A00,890109,Cook; Geoffrey W,117,0,200,83
1746563468512,SIO 109R,A00,890110,Forman; Fonna,0,16,20,20
1746563469541,SIO 187,A01,890114,Kacev; David,15,0,40,25
1746563470566,SOCI 1,A01,890431,Thorpe; Charles Robert,15,0,30,15
1746563470566,SOCI 1,A02,890518,Thorpe; Charles Robert,30,0,30,0
1746563471595,SOCI 2,A01,957978,Staff,25,0,25,0
1746563471595,SOCI 2,A02,957979,Staff,23,0,25,2
1746563472621,SOCI 20,A01,890523,Calderon-Zaks; Michael Aar,23,0,30,7
1746563472621,SOCI 20,A02,890526,Calderon-Zaks; Michael Aar,29,0,30,1
1746563473650,SOCI 30,A01,890533,Pardo Guerra; Juan Pablo,37,0,40,3
1746563474674,SOCI 40,A01,890535,Staff,27,0,45,18
1746563475700,SOCI 104Q,A00,890559,Staff,18,0,30,12
1746563476728,SOCI 106,A00,890560,Arnal; Maud Marie Leonie,20,0,30,10
1746563477758,SOCI 110,A00,890567,Holkenbrink-Monk; Charlene,19,0,30,11
1746563478786,SOCI 112,A00,890568,Victoria Torres; Pablo,2,0,55,53
1746563479808,SOCI 115,A00,890597,Arnal; Maud Marie Leonie,28,0,45,17
1746563481861,SOCI 121,A00,890604,Pardo Guerra; Juan Pablo,38,0,45,7
1746563482890,SOCI 126,A01,890608,Staff,8,0,10,2
1746563483915,SOCI 127,A00,890609,Staff,18,0,30,12
1746563484941,SOCI 131,A00,890610,Thorpe; Charles Robert,37,0,45,8
1746563485969,SOCI 135,A00,890615,Payne; Christine Anna,13,0,45,32
1746563486998,SOCI 139,A00,890620,Staff,38,0,45,7
1746563488022,SOCI 148E,A00,890622,Calderon-Zaks; Michael Aar,36,0,45,9
1746563489047,SOCI 150,A00,890623,Kohler; Kristopher M.,31,0,45,14
1746563490075,SOCI 157,A00,890625,Jules-Rosette; Bennetta W.,18,0,20,2
1746563491100,SOCI 160,A00,890627,Payne; Christine Anna,21,0,45,24
1746563492130,SYN 1,A00,886855,Fish; Gwendolyn Anne,0,0,0,0
1746563492130,SYN 1,B00,906086,Fish; Gwendolyn Anne,0,2,0,2
1746563493154,SYN 2R,A00,886860,Staff,0,17,15,15
1746563493154,SYN 2R,B00,906106,Atkinson; Arthur Laird,0,16,15,15
1746563494181,SYN 100,A01,886866,Browne; Emily,0,28,20,20
1746563494181,SYN 100,B01,906128,Rock; Martin,0,5,20,20
1746563494181,SYN 100,C01,906140,Deavenport; James Cary,0,3,20,20
1746563494181,SYN 100,D01,907816,Deavenport; James Cary,0,5,20,20
1746563495211,TDAC 1,A00,890286,Walsh; Kim C.,8,0,20,12
1746563496240,TDAC 101,A00,890296,Basso; Beatrice,15,0,20,5
1746563497267,TDDE 131,A00,890297,Staff,47,0,50,3
1746563498295,TDDM 1,A00,890287,Weinberg; Sadie,25,0,30,5
1746563499322,TDGE 11,A00,890288,Fulton; Julia,137,0,200,63
1746563499322,TDGE 11,B00,890289,Castro; Robert Jess,184,0,200,16
1746563500350,TDGE 25,B00,957359,Walsh; Kim C.,3,0,20,17
1746563501378,TDGE 40,A01,890292,Power; Jade Yukana,27,0,30,3
1746563502416,TDGE 124,A00,890298,Havis; Allan,0,1,50,50
1746563503441,TDGE 131R,A00,890299,Burelle; Julie Sara Veronique,15,0,42,27
1746563504469,TDHT 101,A00,890300,Staff,10,0,20,10
1746563505495,TDHT 109,A01,890302,Anderson; Mysia Anyse,31,0,40,9
1746563506531,TDMV 1,A00,890293,Arcidiacono; Kristin,18,0,30,12
1746563507555,TDMV 2,A00,890294,Weinberg; Sadie,23,0,30,7
1746563508583,TDMV 3,A00,957878,Arcidiacono; Kristin,28,0,30,2
1746563510634,TDMV 138,A00,890304,Jun; Grace Shin Hae,25,0,40,15
1746563511658,TDMV 140,A00,890305,Corrales; Joseph Bernales,25,0,30,5
1746563512686,TDMV 142,A00,890307,Caligagan; Tony,32,0,40,8
1746563513713,TDMV 144,A00,890308,Camaya; Michelle Ann,25,0,30,5
1746563514739,TDPW 1,A00,890295,Stein; Deborah Isobel,3,0,20,17
1746563515768,USP 2,A01,890272,Lerner; Amy M,6,0,20,14
1746563516793,USP 3,A01,890274,Staff,12,0,30,18
1746563517822,USP 15,A01,890276,Sun; Feiyang,16,0,30,14
1746563518847,USP 25,A00,890277,Shenkman; Michael Thomas,19,0,25,6
1746563519876,USP 138,A00,890278,Staff,14,0,25,11
1746563520902,USP 143,A00,890279,Staff,22,0,70,48
1746563521927,USP 144,A00,890280,Chowdhury; Muhammed Zohir,16,0,30,14
1746563522952,USP 150,A00,890281,Boomhower; Matthew Charles,4,0,30,26
1746563523978,USP 151,A00,890282,Staff,16,0,20,4
1746563525005,USP 162,A00,890283,Andrews; Abigail Leslie,16,0,20,4
1746563526032,USP 168,A00,920477,Kwak; Nancy,0,0,5,5
1746563527058,USP 181,A00,890284,Staff,3,0,20,17
1746563528086,USP 191A,A00,890285,Staff,12,0,20,8
1746563529111,VIS 101,A00,886512,Staff,26,0,75,49
1746563530136,VIS 103,A00,886513,Cruz; Edwin Teddy,61,0,75,14
1746563531162,VIS 108,A00,886514,Staff,3,0,15,12
1746563532187,VIS 127P,A00,886515,Shen; Kuiyi,80,0,146,66
1746563533212,VIS 149,A00,886516,Yoldas; Pinar,0,0,15,15
1746563534241,VIS 164,A00,886526,Erdmann; Dean,19,0,22,3
1746563535267,VIS 194S,A00,886527,Staff,61,0,75,14
1746563536295,WCWP 10A,C00,886484,Martiniuk; Jill,12,0,15,3
1746563537322,WCWP 10B,A00,886490,Uriarte; Emma,0,0,15,15
1746563537322,WCWP 10B,B00,886491,Dhir; Simrita,10,0,15,5
1746563537322,WCWP 10B,C00,886492,Ornelas; Tricia,0,0,15,15
1746563538350,WCWP 100,A00,886494,Young; Mark T,0,6,15,15
1746563540453,AAS 10,A01,886199,Childs; Dennis R.,0,3,0,0
1746563541479,ANAR 104,A01,886940,Shtienberg; Gilad,27,0,30,3
1746563542504,ANAR 120,A00,886953,Staff,12,0,20,8
1746563543533,ANBI 148,A01,886955,Wilder; Linnea Lorene,30,0,40,10
1746563545584,ANSC 122,A00,886957,Staff,25,0,30,5
1746563546612,ANSC 150,A00,886958,Sloane; Julia Kathryn,2,0,15,13
1746563547638,ANSC 156,A00,886959,Jenkins; Janis A.,0,1,15,15
1746563548662,ANSC 180,A00,886960,Staff,11,0,17,6
1746563549691,ANSC 188,A00,886961,Jassal; Aftab,9,0,25,16
1746563550714,ANSC 190,A00,886962,Jassal; Aftab,14,0,25,11
1746563551741,ANSC 191,A00,886963,Staff,18,0,20,2
1746563552768,ANTH 3,A01,891689,Staff,17,0,20,3
1746563553794,ANTH 5,A00,886933,Semendeferi; Ekaterini,16,0,20,4
1746563554826,ANTH 10,A00,886934,Staff,0,12,30,30
1746563555850,ANTH 21,A01,886936,Staff,41,0,60,19
1746563556875,ANTH 23,A01,886938,Staff,92,0,100,8
1746563557901,ANTH 105,A00,886964,Stewart; Alexander B,84,0,100,16
1746563558930,ANTH 108,A00,886965,Pedersen; David,9,0,20,11
1746563559957,AWP 10,001,886147,Staff,0,0,0,0
1746563559957,AWP 10,002,886148,Staff,0,0,0,0
1746563559957,AWP 10,003,886149,Staff,0,0,0,0
1746563559957,AWP 10,004,886150,Staff,0,0,0,0
1746563559957,AWP 10,005,886151,Staff,0,0,0,0
1746563559957,AWP 10,006,886152,Staff,0,0,0,0
1746563559957,AWP 10,007,886153,Staff,0,0,0,0
1746563559957,AWP 10,008,886154,Staff,0,0,0,0
1746563559957,AWP 10,009,886155,Staff,0,0,0,0
1746563559957,AWP 10,010,886156,Staff,0,0,0,0
1746563559957,AWP 10,011,886158,Staff,0,0,0,0
1746563559957,AWP 10,012,886160,Staff,0,0,0,0
1746563559957,AWP 10,013,886161,Staff,0,0,0,0
1746563559957,AWP 10,014,886162,Staff,0,0,0,0
1746563559957,AWP 10,015,886163,Staff,0,0,0,0
1746563559957,AWP 10,016,886164,Staff,0,0,0,0
1746563559957,AWP 10,017,886165,Staff,0,0,0,0
1746563559957,AWP 10,018,886166,Staff,0,0,0,0
1746563559957,AWP 10,019,886168,Staff,0,0,0,0
1746563559957,AWP 10,020,886170,Staff,0,0,0,0
1746563559957,AWP 10,021,886172,Staff,0,0,0,0
1746563560992,AWP 10R,001,886173,Staff,0,1,0,0
1746563560992,AWP 10R,002,886174,Staff,0,1,0,0
1746563560992,AWP 10R,003,886175,Staff,0,0,0,0
1746563560992,AWP 10R,004,886176,Staff,0,0,0,0
1746563560992,AWP 10R,005,886177,Staff,0,0,0,0
1746563560992,AWP 10R,006,886178,Staff,0,0,0,0
1746563560992,AWP 10R,007,886179,Staff,0,0,0,0
1746563560992,AWP 10R,008,886181,Staff,0,0,0,0
1746563560992,AWP 10R,009,886182,Staff,0,0,0,0
1746563560992,AWP 10R,010,886183,Staff,0,0,0,0
1746563560992,AWP 10R,011,886184,Staff,0,0,0,0
1746563560992,AWP 10R,012,886185,Staff,0,0,0,0
1746563560992,AWP 10R,013,886186,Staff,0,0,0,0
1746563560992,AWP 10R,014,886187,Staff,0,0,0,0
1746563560992,AWP 10R,015,886188,Staff,0,0,0,0
1746563560992,AWP 10R,016,886189,Staff,0,0,0,0
1746563560992,AWP 10R,017,960532,Staff,0,0,0,0
1746563560992,AWP 10R,018,960533,Staff,0,0,0,0
1746563560992,AWP 10R,019,960534,Staff,0,0,0,0
1746563560992,AWP 10R,020,960538,Staff,0,0,0,0
1746563560992,AWP 10R,021,960540,Staff,0,0,0,0
1746563560992,AWP 10R,022,960541,Staff,0,0,0,0
1746563560992,AWP 10R,023,960542,Staff,0,0,0,0
1746563560992,AWP 10R,024,960544,Staff,0,0,0,0
1746563560992,AWP 10R,025,960545,Staff,0,0,0,0
1746563560992,AWP 10R,026,960548,Staff,0,0,0,0
1746563562018,AWP 102R,A00,886190,Staff,0,0,0,0
1746563562018,AWP 102R,B00,886191,Staff,0,0,0,0
1746563563044,BENG 100,A01,886193,Staff,17,0,30,13
1746563564071,BENG 122A,A01,886195,Hasty; Jeff M,13,0,30,17
1746563565099,BENG 166A,A00,886196,Sah; Robert Lie-Yuan,0,2,30,30
1746563566128,BENG 190,A00,958050,Khojah; Reem I,21,0,25,4
1746563567152,BIBC 102,A01,894320,Staff,0,0,46,46
1746563567152,BIBC 102,A02,894321,Staff,0,0,46,46
1746563567152,BIBC 102,A03,894344,Staff,7,0,46,39
1746563567152,BIBC 102,A04,894345,Staff,26,0,47,21
1746563568182,BICD 100R,A01,894365,Smith; Laurie,0,3,58,58
1746563568182,BICD 100R,A02,894366,Smith; Laurie,0,5,58,58
1746563568182,BICD 100R,A03,894367,Smith; Laurie,1,0,59,58
1746563568182,BICD 100R,A04,959869,Smith; Laurie,40,0,59,19
1746563569211,BICD 136,A01,894383,Gustafson-Brown; Cindy,14,0,50,36
1746563570240,BIEB 102,A01,894494,Butler; Shannon Rhey,51,0,130,79
1746563572301,BIEB 150,A01,894617,Wills; Christopher,3,0,20,17
1746563572301,BIEB 150,A02,894631,Wills; Christopher,3,0,20,17
1746563572301,BIEB 150,A03,894937,Wills; Christopher,3,0,20,17
1746563572301,BIEB 150,A04,894946,Wills; Christopher,5,0,20,15
1746563573328,BIEB 194,A00,906141,Kurle; Carolyn M.,6,0,20,14
1746563574356,BILD 1,A01,894154,Staff,3,0,19,16
1746563574356,BILD 1,A02,894155,Staff,14,0,19,5
1746563574356,BILD 1,A03,894160,Staff,13,0,19,6
1746563574356,BILD 1,A04,894161,Staff,15,0,18,3
1746563575386,BILD 2,A01,894168,Staff,0,0,50,50
1746563575386,BILD 2,A02,894169,Staff,0,0,50,50
1746563575386,BILD 2,A03,894179,Staff,0,0,50,50
1746563575386,BILD 2,A04,894203,Staff,25,0,50,25
1746563576411,BILD 3,A01,894213,Staff,22,0,31,9
1746563576411,BILD 3,A02,894214,Staff,26,0,31,5
1746563576411,BILD 3,A03,894235,Staff,28,0,31,3
1746563576411,BILD 3,A04,894236,Staff,28,0,32,4
1746563577435,BILD 4,A01,894253,Reuther; Keefe,5,0,24,19
1746563577435,BILD 4,A02,894258,Reuther; Keefe,16,0,24,8
1746563578460,BILD 5,A01,894276,Reuther; Keefe,35,0,50,15
1746563578460,BILD 5,A02,894277,Reuther; Keefe,45,0,50,5
1746563578460,BILD 5,A03,894290,Reuther; Keefe,44,0,50,6
1746563578460,BILD 5,A04,894291,Reuther; Keefe,48,0,50,2
1746563579486,BILD 24,A01,894297,Pirino; Giorgia,40,0,60,20
1746563580513,BIMM 100,B01,958915,Staff,71,0,100,29
1746563581538,BIMM 101,A01,895017,McDonnell; Lisa Marie,0,5,24,24
1746563581538,BIMM 101,A02,895018,McDonnell; Lisa Marie,0,5,24,24
1746563581538,BIMM 101,B01,895020,McDonnell; Lisa Marie,0,6,24,24
1746563581538,BIMM 101,B02,895021,McDonnell; Lisa Marie,0,4,24,24
1746563582564,BIMM 110,A01,895023,Staff,1,0,25,24
1746563582564,BIMM 110,A02,895024,Staff,9,0,25,16
1746563582564,BIMM 110,A03,895025,Staff,18,0,25,7
1746563582564,BIMM 110,A04,895031,Staff,20,0,25,5
1746563583594,BIMM 120,A01,895114,Gustafson-Brown; Cindy,14,0,28,14
1746563583594,BIMM 120,A02,895126,Gustafson-Brown; Cindy,21,0,27,6
1746563584623,BIPN 100,A01,895130,Yang; Mingyu,1,0,38,37
1746563584623,BIPN 100,A02,895131,Yang; Mingyu,32,0,38,6
1746563584623,BIPN 100,A03,895132,Yang; Mingyu,32,0,38,6
1746563584623,BIPN 100,A04,895133,Yang; Mingyu,27,0,36,9
1746563585647,BIPN 120,A01,895135,Cooke; James Edward,0,3,13,13
1746563585647,BIPN 120,A02,895136,Cooke; James Edward,0,1,13,13
1746563585647,BIPN 120,A03,895137,Cooke; James Edward,0,3,13,13
1746563585647,BIPN 120,A04,895156,Cooke; James Edward,0,2,11,11
1746563586675,BIPN 134,A01,895235,Cooke; James Edward,0,2,25,25
1746563586675,BIPN 134,A02,895237,Cooke; James Edward,0,0,25,25
1746563586675,BIPN 134,A03,895240,Cooke; James Edward,3,0,25,22
1746563586675,BIPN 134,A04,895270,Cooke; James Edward,20,0,25,5
1746563587702,BIPN 189,A00,892103,Staff,0,13,14,14
1746563589755,BISP 194,A00,958008,Staff,0,2,0,0
1746563590783,CAT 124,A01,922009,Staff,0,5,20,20
1746563591812,CAT 125R,A00,886390,Morales; Celeste Georgianna,0,2,20,20
1746563591812,CAT 125R,B00,886391,Irwin; Matthew Joseph,0,4,20,20
1746563591812,CAT 125R,C00,886392,Smith; Lauryn Alissa,0,2,20,20
1746563591812,CAT 125R,D00,886393,Vanderschuit; Maya Alysia,0,2,20,20
1746563591812,CAT 125R,E00,886394,Marchisotto; Jennifer Anne,0,3,20,20
1746563592838,CENG 15,A01,886218,Drews; Aaron,3,0,8,5
1746563593865,CENG 113,A00,886219,Opatkiewicz; Justin Paul,15,0,25,10
1746563594891,CGS 101,A00,887044,Staff,7,0,20,13
1746563595916,CGS 105,A01,887046,Staff,14,0,25,11
1746563596944,CGS 112,A00,887047,Cuong; Marisol,12,0,15,3
1746563597968,CGS 113,A00,887048,Staff,23,0,30,7
1746563598995,CGS 120,A00,887049,Staff,10,0,17,7
1746563600022,CHEM 6A,A01,886336,Lam; Tin Yiu,38,0,50,12
1746563600022,CHEM 6A,A02,886338,Lam; Tin Yiu,37,0,50,13
1746563601047,CHEM 6B,A01,886341,Hopkins; Patrycja Anna,16,0,50,34
1746563601047,CHEM 6B,A02,886343,Hopkins; Patrycja Anna,42,0,50,8
1746563602073,CHEM 6C,A01,886346,Albizati; Kim F.,0,2,50,50
1746563602073,CHEM 6C,A02,886348,Albizati; Kim F.,23,0,50,27
1746563603098,CHEM 40A,A01,886352,Klosterman; Jeremy K,65,0,100,35
1746563604127,CHEM 40B,A01,886356,Klosterman; Jeremy K,0,23,100,100
1746563605154,CHEM 41B,A01,886360,Theodorakis; Emmanuel,25,0,50,25
1746563605154,CHEM 41B,A02,886362,Theodorakis; Emmanuel,47,0,50,3
1746563606182,CHIN 165A,A00,886382,Xu; Li,18,0,20,2
1746563607209,CLAS 120,A00,886387,Myerston Santana; Jacobo,33,0,40,7
1746563608235,COGS 9,A01,886967,Shannon; Kyle Michael,42,0,60,18
1746563609261,COGS 11,A01,886969,Staff,10,0,30,20
1746563610289,COGS 14A,A01,886971,Staff,6,0,60,54
1746563611315,COGS 14B,A01,886973,Hoffman; Drew Ellen,4,0,60,56
1746563612343,COGS 18,A01,886975,Morgan; Eric,35,0,60,25
1746563613369,COGS 20,A01,886977,Staff,4,0,8,4
1746563613369,COGS 20,A02,886978,Staff,5,0,7,2
1746563614393,COGS 100,A01,907783,Staff,0,2,30,30
1746563615420,COGS 101B,A01,886980,Staff,0,3,48,48
1746563616446,COGS 101C,A01,886982,Delgado; Tania,0,5,44,44
1746563617471,COGS 102A,A01,886984,Johnson; Christine M.,4,0,30,26
1746563618495,COGS 118B,A01,886986,Staff,0,3,88,88
1746563619518,COGS 150,A01,886988,Bergen; Benjamin,22,0,50,28
1746563620546,COGS 153,A00,886989,Delgado; Tania,0,2,41,41
1746563621574,COGS 186,A01,886991,Staff,0,0,32,32
1746563622602,COGS 187A,A01,886993,Boyle; Mary E. T.,7,0,30,23
1746563623657,COGS 189,A00,886994,Staff,0,1,30,30
1746563624683,COMM 10,A01,886996,Staff,0,0,20,21
1746563624683,COMM 10,A02,886997,Staff,12,0,20,8
1746563624683,COMM 10,A03,959845,Staff,19,0,20,1
1746563625711,COMM 20,A01,886999,Leuning; Grant Maurstad,24,0,40,16
1746563627761,COMM 100A,A01,887002,Staff,0,0,20,25
1746563627761,COMM 100A,A02,887003,Staff,7,0,20,13
1746563628787,COMM 100B,A01,887005,Staff,0,8,20,24
1746563629816,COMM 106D,A00,887006,Staff,14,0,40,26
1746563630841,COMM 110G,A00,887007,Whitworth-Smith; Andrew C,12,0,40,28
1746563631866,COMM 111B,A00,887008,Staff,31,0,40,9
1746563632892,COMM 113T,A00,887009,Abuelhiga; Soraya Jill,28,0,40,12
1746563632892,COMM 113T,B00,906733,Staff,40,0,40,0
1746563633916,COMM 145,A00,887010,Staff,12,0,40,28
1746563634944,COMM 146,A00,887054,Staff,31,0,40,9
1746563635968,COMM 190,A00,887012,Staff,8,0,23,15
1746563636993,CSE 8A,A50,887015,Cao; Yingjun,57,0,85,28
1746563638020,CSE 11,A01,887017,Cao; Yingjun,12,0,70,58
1746563639054,CSE 20,A01,887019,Staff,30,0,50,20
1746563640084,CSE 21,A01,887021,Staff,78,0,100,22
1746563640084,CSE 21,B01,892583,Braun; Oliver,45,0,50,5
1746563641110,CSE 30,A01,887025,Eldon; John,143,0,200,57
1746563642137,CSE 100,A01,887027,Staff,26,0,50,24
1746563642137,CSE 100,A02,887028,Staff,42,0,50,8
1746563643161,CSE 101,A01,887030,Braun; Oliver,74,0,100,26
1746563643161,CSE 101,B01,887032,Jones; Miles E,0,3,50,50
1746563643161,CSE 101,B02,887033,Jones; Miles E,0,2,50,50
1746563644186,CSE 105,A01,908084,Jones; Miles E,32,0,50,18
1746563644186,CSE 105,A02,908087,Jones; Miles E,32,0,50,18
1746563645211,CSE 135,A01,887035,Powell; Thomas Allan,0,4,50,50
1746563646237,CSE 142,A01,887037,Staff,8,0,60,52
1746563647265,CSE 142L,A01,887039,Staff,34,0,60,26
1746563648293,CSE 151A,A01,887041,Solares; Edwin A,47,0,100,53
1746563649324,CSE 175,A01,887043,Kumar; Rakesh,30,0,30,0
1746563650353,CSS 1,A01,886389,Staff,1,1,40,39
1746563651379,DSC 30,A01,908097,Liao; Soohyun Nam,47,0,75,28
1746563652406,DSC 40A,A01,908099,Shannon; Kyle Michael,30,0,50,20
1746563653437,DSC 40B,A01,908112,Staff,16,0,50,34
1746563654462,DSC 80,A01,908116,Staff,19,0,60,41
1746563655489,DSC 197,001,956863,Eldridge; Justin Matthew,9999,0,9999,0
1746563656522,ECE 5,A01,886400,Morris; Karcher William,2,0,6,4
1746563656522,ECE 5,A02,886401,Morris; Karcher William,3,0,6,3
1746563657552,ECE 148,A01,886403,Silberman; Jack,0,14,14,14
1746563658579,ECON 1,A01,887265,Crane; Meredith Helen,12,0,70,58
1746563658579,ECON 1,B01,887268,Staff,43,0,50,7
1746563659605,ECON 2,A01,887273,Crane; Meredith Helen,55,0,70,15
1746563660629,ECON 3,A01,887279,Rondina; Giacomo,32,0,70,38
1746563661653,ECON 4,A01,887282,Anderson; John Charles,0,2,10,10
1746563662681,ECON 5,A01,887285,Staff,34,0,45,11
1746563662681,ECON 5,B01,887292,Staff,41,0,45,4
1746563663707,ECON 100A,A01,887337,Newhouse; Herbert S,54,0,70,16
1746563663707,ECON 100A,B01,887349,Staff,45,0,50,5
1746563664734,ECON 100B,A01,887361,Du; Songzi,29,0,70,41
1746563665764,ECON 100C,A01,887445,Newhouse; Herbert S,59,0,70,11
1746563666792,ECON 105,A00,887488,Vespa; Emanuel Ignacio,23,0,35,12
1746563667821,ECON 109,A01,887506,Shishkin; Denis,28,0,35,7
1746563668845,ECON 110A,A01,887568,Alon; Titan Michael,0,3,35,35
1746563668845,ECON 110A,B01,907601,Alon; Titan Michael,20,0,35,15
1746563669874,ECON 110B,A01,887598,Levkoff; Steven B.,0,24,70,70
1746563670896,ECON 112,A00,887599,Rondina; Giacomo,19,0,35,16
1746563671925,ECON 120A,A01,887603,Dai; Yinlin,35,0,70,35
1746563672951,ECON 120C,A01,887608,Sun; Yixiao,0,1,35,35
1746563672951,ECON 120C,B01,887614,Sun; Yixiao,0,0,35,35
1746563673975,ECON 138,A00,887621,Bharadwaj; Prashant,0,21,20,20
1746563675007,ECON 144,A00,958007,Squires; Dale E,13,0,35,22
1746563676033,ECON 171,A01,907666,Staff,18,0,35,17
1746563677059,ECON 175,A00,887626,Wu; Pak Yeung,23,0,35,12
1746563678088,ECON 190,A00,887640,Vespa; Emanuel Ignacio,23,0,35,12
1746563679116,EDS 25,A01,888197,Staff,0,0,0,0
1746563679116,EDS 25,A02,888209,Staff,0,0,0,0
1746563679116,EDS 25,A03,888210,Staff,0,0,0,0
1746563679116,EDS 25,A04,888212,Staff,0,0,0,0
1746563679116,EDS 25,A05,888213,Staff,0,0,0,0
1746563679116,EDS 25,A06,888214,Staff,0,0,0,0
1746563679116,EDS 25,A07,888235,Staff,0,2,0,0
1746563679116,EDS 25,A08,888236,Staff,0,0,0,0
1746563679116,EDS 25,A09,888240,Staff,0,0,0,0
1746563679116,EDS 25,A10,888244,Staff,0,0,0,0
1746563679116,EDS 25,B01,888273,Staff,0,0,0,0
1746563679116,EDS 25,B02,888285,Staff,0,0,0,0
1746563679116,EDS 25,B03,888423,Staff,0,0,0,1
1746563679116,EDS 25,B04,888432,Staff,0,0,0,0
1746563679116,EDS 25,B05,888433,Staff,0,0,0,0
1746563679116,EDS 25,B06,888467,Staff,0,0,0,0
1746563679116,EDS 25,B07,888468,Staff,0,0,0,0
1746563679116,EDS 25,B08,888479,Staff,0,0,0,0
1746563679116,EDS 25,B09,888484,Staff,0,0,0,0
1746563679116,EDS 25,B10,888487,Staff,0,0,0,0
1746563680146,EDS 38,A01,907700,Choi; Bailey Miyeon,30,0,30,0
1746563681170,EDS 112,A01,888601,Chapman; Thandeka K,13,0,40,27
1746563682195,EDS 115,A00,888697,Mendez; Kathrina Mendoza,10,0,30,20
1746563683224,EDS 116,A01,888893,Staff,35,0,40,5
1746563685281,EDS 124AR,A00,889133,Staff,29,0,50,21
1746563685281,EDS 124AR,B00,907471,Simon; Elizabeth A,37,0,50,13
1746563686307,EDS 124BR,A00,889134,Simon; Elizabeth A,44,0,100,56
1746563687335,EDS 125,A00,889135,Staff,25,0,30,5
1746563688364,EDS 126,A01,889138,Staff,36,0,40,4
1746563689387,EDS 164R,A01,889142,Wishard Guerra; Alison G.,33,0,50,17
1746563690411,ENG 30,A01,886396,Staff,0,0,0,0
1746563690411,ENG 30,B01,886398,Staff,0,0,0,0
1746563691436,ENVR 102,A00,906150,Montejo; Carolina,23,0,25,2
1746563692461,ETHN 103A,A00,887236,Man; Simeon S,0,3,0,0
1746563693487,ETHN 113,A00,887239,Staff,16,0,30,14
1746563694514,ETHN 116,A00,887240,Staff,16,0,25,9
1746563695539,ETHN 117,A00,887241,Choi; Esther Min,28,0,30,2
1746563696565,ETHN 118,A00,887243,Staff,24,0,30,6
1746563697593,ETHN 127,A00,887248,Cuong; Marisol,11,0,15,4
1746563698619,ETHN 139,A00,887250,Staff,7,0,10,3
1746563699645,ETHN 142,A00,887252,Staff,10,0,30,20
1746563700670,ETHN 161,A00,887253,Browne; Errol Tsekani,24,0,30,6
1746563701698,ETHN 163FR,A00,887255,Burelle; Julie Sara Veronique,0,0,5,5
1746563702722,GLBH 20,A00,889149,Elwardani; Nile Regina,8,0,42,34
1746563704774,GLBH 111,A01,889152,Burgos; Jose L.,17,0,17,0
1746563705799,GLBH 150,A00,889181,Sloane; Julia Kathryn,0,5,15,15
1746563707851,HDS 60,A01,886406,Warstadt; Melissa Fawn,73,0,80,7
1746563708878,HIAF 111,A00,889324,Gyamfi; Bright,25,0,32,7
1746563709902,HIEA 131,A00,889328,Staff,15,0,32,17
1746563710926,HIEA 144,A00,889333,Henry; Todd A.,26,0,32,6
1746563711955,HIEA 154,A00,889336,Henry; Todd A.,24,0,32,8
1746563712983,HIEU 106,A00,889339,Staff,22,0,32,10
1746563715034,HIEU 114,A00,889340,Staff,3,0,32,29
1746563716060,HIEU 135GS,A00,889342,Patterson; Patrick H.,0,0,1,24
1746563717087,HIEU 137,A00,889343,Edington; Claire Ellen,10,0,25,15
1746563718111,HIEU 148,A00,889345,Staff,14,0,32,18
1746563719137,HIEU 154,A00,889346,Biess; Frank Peter,21,0,32,11
1746563720163,HILA 102,A00,889351,Staff,12,0,32,20
1746563721191,HILD 2A,A01,889221,Lewandoski; Julia Mavis,1,10,32,31
1746563722216,HILD 7B,A01,889225,Man; Simeon S,0,12,32,32
1746563723240,HILD 7C,A01,889288,Alvarez; Luis A,0,14,32,32
1746563724265,HILD 30,A01,889323,Staff,0,5,32,32
1746563726318,HISC 119,A00,889383,Golan; Tal,20,0,32,12
1746563727382,HIUS 103,A00,889384,Man; Simeon S,0,0,32,32
1746563728408,HIUS 117,A00,919797,Kwak; Nancy,18,0,32,14
1746563729433,HIUS 142A,A00,919788,Staff,22,0,32,10
1746563731481,HIUS 149,A00,889386,Gyamfi; Bright,26,0,32,6
1746563732505,HIUS 155,A00,889387,Alvarez; Luis A,14,0,32,18
1746563733533,HUM 3,A01,886499,Caldwell; Michael Alan,19,0,50,31
1746563734557,HUM 3GS,A00,886500,Rodriguez; Bretton Sigfred,0,0,0,28
1746563735583,HUM 3R,A01,886502,Markman; Kristina,0,36,50,50
1746563736607,HUM 4,A01,886504,Crum; Matthew Stephen,24,0,50,26
1746563736607,HUM 4,B01,886506,West; Geoffrey Scott,17,0,50,33
1746563737632,HUM 4GS,A00,886507,Staff,0,0,0,19
1746563738658,HUM 5,A01,886509,Staff,32,0,50,18
1746563739686,HUM 5R,A01,886511,Zavodny; Tatiana Sophia,0,39,50,50
1746563740714,JAPN 180,A00,886407,Staff,17,0,40,23
1746563741742,LATI 50,A01,886409,Martin-Cabrera; Luis,4,0,22,18
1746563741742,LATI 50,A02,886410,Martin-Cabrera; Luis,19,0,22,3
1746563741742,LATI 50,A03,886411,Martin-Cabrera; Luis,21,0,22,1
1746563741742,LATI 50,A04,886412,Martin-Cabrera; Luis,9,0,22,13
1746563742767,LAWS 101,A00,907664,Staff,28,0,60,32
1746563743796,LIAB 1A,A00,889388,Saab; Dima,17,0,20,3
1746563744821,LIAB 1AX,A00,889389,El Cheddadi; Youniss,18,0,20,2
1746563745847,LIFR 1C,A00,889391,Van Moer; Vinciane G,8,0,20,12
1746563746872,LIFR 1CX,A00,889392,Van Moer; Vinciane G,7,0,20,13
1746563747897,LIFR 1D,A00,889393,Van Moer; Vinciane G,7,0,20,13
1746563748921,LIFR 1DX,A00,889394,Van Moer; Vinciane G,8,0,20,12
1746563749945,LIGN 7,A00,886923,Staff,24,0,50,26
1746563750970,LIGN 17,A00,886924,Kehler; Andrew Scott,125,0,150,25
1746563751997,LTAM 110,A00,889395,Staff,15,0,30,15
1746563753024,LTAM 110GS,A00,958010,Rodriguez; Bretton Sigfred,0,0,0,28
1746563754050,LTCH 101,A00,889397,Staff,23,0,25,2
1746563755078,LTCS 130,A00,889398,Staff,23,0,25,2
1746563756104,LTEA 138,A00,889399,Staff,24,0,40,16
1746563757134,LTEN 149,A00,889400,Wesling; Megan E.,0,3,25,25
1746563758161,LTEN 169,A00,889401,Staff,20,0,25,5
1746563759187,LTEN 180,A00,889402,Staff,10,0,15,5
1746563760216,LTEN 181,A00,889403,Staff,21,0,25,4
1746563761241,LTWL 100,A00,889404,Myerston Santana; Jacobo,2,0,25,23
1746563762295,LTWL 180GS,A00,889405,Staff,0,0,20,20
1746563763323,LTWL 181,A00,889406,Staff,16,0,25,9
1746563764346,LTWL 184,A00,889475,Mukherjee; Silpa,22,0,25,3
1746563765370,LTWR 102C,A00,889486,Staff,29,0,30,1
1746563766394,LTWR 115W,A00,889491,Staff,0,2,15,15
1746563767418,MAE 8,A01,886905,Staff,0,2,0,0
1746563768445,MAE 11,A00,886906,Bandaru; Prabhakar,0,7,50,50
1746563769470,MAE 20,A00,886907,Evdokimenko; Ekaterina,43,0,70,27
1746563770499,MAE 30B,A00,886909,Ghazinejad; Maziar,26,0,45,19
1746563771527,MAE 101B,A00,886910,Saintillan; David,29,0,45,16
1746563772552,MAE 105,A00,886911,Bandaru; Prabhakar,18,0,50,32
1746563773576,MAE 107,B00,958024,Staff,8,0,50,42
1746563774601,MAE 143B,A00,886913,Bewley; Thomas R,6,0,40,34
1746563775628,MAE 148,A01,886915,Silberman; Jack,0,3,14,14
1746563776656,MAE 160,A00,886916,Evdokimenko; Ekaterina,32,0,60,28
1746563777681,MATH 3C,A01,889681,Staff,0,2,30,30
1746563777681,MATH 3C,A02,960048,Staff,24,0,30,6
1746563778707,MATH 10A,A01,889760,Staff,26,0,30,4
1746563778707,MATH 10A,A02,889783,Staff,29,0,30,1
1746563779737,MATH 10B,A01,889785,Verstraete; Jacques Allan,2,0,35,33
1746563779737,MATH 10B,A02,889795,Verstraete; Jacques Allan,4,0,35,31
1746563779737,MATH 10B,B01,889797,Verstraete; Jacques Allan,3,0,35,32
1746563779737,MATH 10B,B02,889828,Verstraete; Jacques Allan,3,0,35,32
1746563780768,MATH 10C,A01,889849,Habib; Yousaf,8,0,30,22
1746563780768,MATH 10C,A02,889852,Habib; Yousaf,14,0,30,16
1746563780768,MATH 10C,A03,889853,Habib; Yousaf,22,0,30,8
1746563780768,MATH 10C,A04,889858,Habib; Yousaf,20,0,30,10
1746563780768,MATH 10C,B01,889861,Staff,1,0,30,29
1746563780768,MATH 10C,B02,889862,Staff,24,0,30,6
1746563780768,MATH 10C,B03,889863,Staff,27,0,30,3
1746563780768,MATH 10C,B04,889967,Staff,23,0,30,7
1746563781793,MATH 18,A01,889974,Staff,7,0,30,23
1746563781793,MATH 18,A02,889977,Staff,20,0,30,10
1746563781793,MATH 18,B01,889984,Hardiman; Liam,21,0,30,9
1746563781793,MATH 18,B02,889985,Hardiman; Liam,25,0,30,5
1746563782818,MATH 20A,A01,889990,Suk; Andrew Hoon,30,0,35,5
1746563783842,MATH 20B,A01,889993,Ohm; Ko Woon,22,0,30,8
1746563783842,MATH 20B,A02,889994,Ohm; Ko Woon,30,0,30,0
1746563783842,MATH 20B,B01,889996,Ohm; Ko Woon,21,0,30,9
1746563783842,MATH 20B,B02,889997,Ohm; Ko Woon,23,0,30,7
1746563784875,MATH 20C,A01,889999,Hammock; Frances H,17,0,30,13
1746563784875,MATH 20C,A02,890003,Hammock; Frances H,23,0,30,7
1746563784875,MATH 20C,B01,890006,Hammock; Frances H,3,0,30,27
1746563784875,MATH 20C,B02,890007,Hammock; Frances H,11,0,30,19
1746563785900,MATH 20D,A01,890011,Cheng; Hsiao-Bing,1,1,30,29
1746563785900,MATH 20D,A02,890012,Cheng; Hsiao-Bing,14,0,30,16
1746563785900,MATH 20D,B01,890016,Cheng; Hsiao-Bing,13,0,30,17
1746563785900,MATH 20D,B02,890017,Cheng; Hsiao-Bing,13,0,30,17
1746563786925,MATH 20E,A01,890026,Harel; Guershon,1,0,30,29
1746563786925,MATH 20E,A02,890029,Harel; Guershon,23,0,30,7
1746563786925,MATH 20E,B01,890033,Harel; Guershon,7,0,30,23
1746563786925,MATH 20E,B02,890101,Harel; Guershon,21,0,30,9
1746563787953,MATH 102,A01,890104,Staff,17,0,30,13
1746563787953,MATH 102,A02,890105,Staff,27,0,30,3
1746563788980,MATH 103B,A01,890116,Salehi Golsefidy; Alireza,3,0,30,27
1746563788980,MATH 103B,B01,890118,Staff,0,3,34,34
1746563790006,MATH 109,A01,890121,Aliabadi Sr.; Mohsen,1,0,30,29
1746563790006,MATH 109,B01,890124,Upadrashta; Pranav Kumar,18,0,30,12
1746563791033,MATH 120A,A01,890126,Eggers; John Dietrich,13,0,30,17
1746563792062,MATH 142B,A01,890128,Ioana; Adrian,19,0,30,11
1746563792062,MATH 142B,A02,890129,Ioana; Adrian,13,0,30,17
1746563793087,MATH 154,A01,890174,Staff,0,0,30,30
1746563793087,MATH 154,A02,890182,Staff,0,0,30,30
1746563794113,MATH 168A,A01,890197,Dumitriu; Ioana,21,0,35,14
1746563795139,MATH 170A,A01,890240,Nie; Jiawang,1,0,30,29
1746563795139,MATH 170A,A02,890241,Nie; Jiawang,11,0,30,19
1746563795139,MATH 170A,A03,890249,Nie; Jiawang,23,0,30,7
1746563796164,MATH 170B,A01,957891,Nag; Panchali,13,0,35,22
1746563798219,MATH 181A,A01,908025,Staff,0,4,35,35
1746563798219,MATH 181A,A02,960115,Staff,27,0,35,8
1746563799243,MATH 181B,A01,959874,Staff,25,0,30,5
1746563800271,MATH 193B,A01,890265,Staff,0,4,35,35
1746563801298,MGT 4,A01,890311,Anderson; John Charles,42,0,88,46
1746563802322,MGT 5,A00,907740,Staff,13,0,98,85
1746563803347,MGT 12,A00,890312,Lindenberger; Wade Douglas,67,0,98,31
1746563804371,MGT 16,A00,957883,Staff,78,0,98,20
1746563806422,MGT 45,A00,890314,Pecore; Joseph P.,46,0,98,52
1746563807451,MGT 71,A00,890315,Staff,0,11,98,98
1746563808476,MGT 100,A00,890316,Yavorsky; Daniel Ryan,44,0,98,54
1746563809502,MGT 103,A00,890317,Ehrich; Kristine R,73,0,98,25
1746563810531,MGT 105,A00,890356,Bates; Kenneth Walter,0,8,98,98
1746563811556,MGT 112,A00,890360,Ehrich; Kristine R,55,0,98,43
1746563812582,MGT 127R,A00,907732,Zhu; Kevin Xiaoguo,23,0,98,75
1746563813611,MGT 131B,A00,890361,Anderson; John Charles,60,0,98,38
1746563814637,MGT 137,A00,890362,Lindenberger; Wade Douglas,65,0,98,33
1746563815667,MGT 160,A00,890369,Johnson; Erik Barry,9,0,98,89
1746563817724,MGT 164,A00,890372,Zimmermann; Carsten,0,40,98,98
1746563818753,MGT 180,A00,890374,Bliss; Barbara Ann,12,0,98,86
1746563819785,MMW 15,A01,886414,Chang; Edmond Yi-Teh,0,12,28,28
1746563819785,MMW 15,A02,886415,Chang; Edmond Yi-Teh,0,8,28,28
1746563819785,MMW 15,A03,886416,Chang; Edmond Yi-Teh,0,8,28,28
1746563819785,MMW 15,A04,886417,Chang; Edmond Yi-Teh,0,8,28,28
1746563819785,MMW 15,B01,886419,Chang; Edmond Yi-Teh,0,7,28,28
1746563819785,MMW 15,B02,886420,Chang; Edmond Yi-Teh,0,8,28,28
1746563819785,MMW 15,B03,886421,Chang; Edmond Yi-Teh,0,7,28,28
1746563819785,MMW 15,B04,886422,Chang; Edmond Yi-Teh,0,8,28,28
1746563819785,MMW 15,C01,886424,Staff,0,9,28,28
1746563819785,MMW 15,C02,886425,Staff,0,8,28,28
1746563819785,MMW 15,C03,886426,Staff,0,8,28,28
1746563819785,MMW 15,C04,886427,Staff,0,8,28,28
1746563819785,MMW 15,C05,958038,Staff,0,8,28,28
1746563819785,MMW 15,C06,958039,Staff,0,8,28,28
1746563820810,MMW 15GS,A00,906910,Patterson; Patrick H.,4,0,28,24
1746563821837,MMW 122R,A01,886429,Rahimi; Babak,0,13,28,28
1746563821837,MMW 122R,A02,886430,Rahimi; Babak,0,12,28,28
1746563821837,MMW 122R,A03,958040,Rahimi; Babak,0,11,28,28
1746563822867,MUS 1A,A01,890937,Staff,2,0,25,23
1746563822867,MUS 1A,A02,891035,Staff,6,0,25,19
1746563822867,MUS 1A,C01,958912,Staff,24,0,25,1
1746563822867,MUS 1A,C02,958913,Staff,25,0,25,0
1746563824922,MUS 2AK,A00,957092,Ohnishi; Takae,15,0,15,0
1746563825949,MUS 4,A01,891044,Staff,2,0,25,23
1746563825949,MUS 4,A02,891045,Staff,23,0,25,2
1746563825949,MUS 4,B01,891048,Staff,17,0,25,8
1746563825949,MUS 4,B02,891050,Staff,25,0,25,0
1746563826974,MUS 5,A01,957506,Dubnov; Shlomo,0,0,25,25
1746563826974,MUS 5,A02,957622,Dubnov; Shlomo,13,0,25,12
1746563826974,MUS 5,A03,957623,Dubnov; Shlomo,20,0,25,5
1746563827999,MUS 6,A01,891053,Freitas Caetano; Marcelo,24,0,25,1
1746563827999,MUS 6,A02,891054,Freitas Caetano; Marcelo,23,0,25,2
1746563829025,MUS 7,A01,891081,Staff,0,0,25,25
1746563829025,MUS 7,A02,891082,Staff,4,0,25,21
1746563830050,MUS 8GS,A00,891118,Borgo; David Garcia,0,0,25,25
1746563831074,MUS 11,A01,891140,Staff,9,0,25,16
1746563831074,MUS 11,A02,891141,Staff,22,0,25,3
1746563832101,MUS 13,A01,891143,Staff,8,0,25,17
1746563832101,MUS 13,A02,891144,Staff,24,0,25,1
1746563833128,MUS 15,A01,891146,Staff,9,0,25,16
1746563833128,MUS 15,A02,891148,Staff,21,0,25,4
1746563833128,MUS 15,B01,891150,Staff,18,0,25,7
1746563833128,MUS 15,B02,891151,Staff,25,0,25,0
1746563834158,MUS 20,A01,891153,Staff,5,0,20,15
1746563834158,MUS 20,A02,891155,Staff,14,0,20,6
1746563835191,MUS 80,A00,891156,Staff,19,0,25,6
1746563835191,MUS 80,B00,891157,Staff,23,0,25,2
1746563836214,MUS 130,A00,891158,Ohnishi; Takae,35,0,35,0
1746563837239,MUS 150GS,A01,891160,Borgo; David Garcia,0,0,25,25
1746563838264,MUS 170,A01,891162,Freitas Caetano; Marcelo,20,0,25,5
1746563838264,MUS 170,A02,891164,Freitas Caetano; Marcelo,21,0,25,4
1746563839293,NANO 11,A00,886220,Vazquez Mena; Oscar,13,0,15,2
1746563840317,NANO 15,A01,886222,Drews; Aaron,4,0,7,3
1746563841342,NANO 104,A00,886224,Sirbuly; Donald,18,0,25,7
1746563842366,PH 40,A00,886528,Staff,23,0,40,17
1746563843392,PH 45,A01,886799,Staff,35,0,40,5
1746563844416,PH 110,A00,886802,Staff,0,7,40,40
1746563845462,PH 172,A00,906716,Staff,19,0,35,16
1746563846485,PH 191,A00,886803,Staff,6,0,40,34
1746563847509,PHIL 1,A00,889500,Staff,20,0,30,10
1746563848536,PHIL 10,A01,889549,Grush; Rick Scott,15,0,22,7
1746563848536,PHIL 10,A02,889551,Grush; Rick Scott,22,0,22,0
1746563849565,PHIL 28,A01,889559,Lamey; Andy M.,0,2,31,31
1746563849565,PHIL 28,A02,889561,Lamey; Andy M.,0,1,30,30
1746563849565,PHIL 28,A03,889572,Lamey; Andy M.,0,1,30,30
1746563850591,PHIL 35,A00,907839,Staff,13,0,15,2
1746563851615,PHIL 60,A00,889574,Staff,73,0,90,17
1746563852639,PHIL 101,A00,958004,Staff,12,0,15,3
1746563854688,PHIL 136,A00,889582,Fulkerson; Matthew Todd,26,0,45,19
1746563855712,PHIL 163,A01,889601,Staff,21,0,30,9
1746563855712,PHIL 163,B01,889606,Brandt; Reuven A,0,3,0,0
1746563856739,PHIL 164,A00,889610,Staff,16,0,30,14
1746563857765,PHIL 165,A00,889613,Staff,23,0,30,7
1746563858790,PHYS 1A,A00,886431,Staff,26,0,70,44
1746563859817,PHYS 1AL,001,886432,Tsai; Philbert S,0,2,30,30
1746563859817,PHYS 1AL,002,886436,Tsai; Philbert S,11,0,30,19
1746563860841,PHYS 1B,A00,886439,Staff,185,0,240,55
1746563861865,PHYS 1BL,001,886441,Tsai; Philbert S,0,4,30,30
1746563861865,PHYS 1BL,002,886444,Tsai; Philbert S,2,0,30,28
1746563862891,PHYS 1C,A00,896092,Arnold; Kam S,79,0,146,67
1746563863916,PHYS 1CL,001,886448,Tsai; Philbert S,0,0,30,30
1746563863916,PHYS 1CL,002,886449,Tsai; Philbert S,1,0,30,29
1746563863916,PHYS 1CL,003,886450,Tsai; Philbert S,16,0,30,14
1746563863916,PHYS 1CL,004,886451,Tsai; Philbert S,15,0,30,15
1746563864947,PHYS 2B,A01,886457,Staff,68,0,115,47
1746563865974,PHYS 2C,A01,886460,Shotwell; Brian,0,9,65,65
1746563866998,PHYS 2CL,A01,886467,Staff,0,4,28,28
1746563866998,PHYS 2CL,A02,886468,Staff,0,3,28,28
1746563868025,PHYS 2D,A01,886470,Staff,10,0,50,40
1746563869054,PHYS 4B,A01,886475,Grinstein; Benjamin,22,0,40,18
1746563870089,POLI 5,A00,891173,Desposato; Scott,7,0,25,18
1746563871121,POLI 5D,A01,891175,Staff,5,0,5,0
1746563871121,POLI 5D,B01,891178,Staff,5,0,5,0
1746563872146,POLI 11,A00,891179,Ferree; Karen E,2,0,35,33
1746563873174,POLI 12,A00,891180,Staff,16,0,30,14
1746563874204,POLI 27,A01,891182,Staff,12,0,75,63
1746563875231,POLI 30,A00,891183,Staff,8,0,50,42
1746563876256,POLI 100B,A00,891244,Staff,5,1,35,30
1746563877285,POLI 100I,A00,891247,Staff,7,0,30,23
1746563878308,POLI 104J,A00,891248,Nichter; Maysa,14,0,30,16
1746563879333,POLI 104U,A00,891250,Nichter; Maysa,2,0,30,28
1746563881384,POLI 110B,A00,891255,Wiens; David,20,0,25,5
1746563882423,POLI 112A,A00,891256,Wiens; David,6,0,25,19
1746563883449,POLI 114BR,A00,891261,Staff,19,0,30,11
1746563884475,POLI 117R,A00,891262,Forman; Fonna,0,6,50,50
1746563885500,POLI 118,A00,891264,Ingham; Sean,17,0,25,8
1746563886523,POLI 124A,A00,891265,Staff,18,0,20,2
1746563887551,POLI 125D,A00,891266,Nichter; Simeon C,2,0,25,23
1746563888577,POLI 126,A00,891268,Nichter; Simeon C,7,0,25,18
1746563889602,POLI 126AA,A00,891272,Staff,17,0,25,8
1746563890626,POLI 130AA,A00,891273,Staff,15,0,20,5
1746563891656,POLI 134AA,A00,891274,Staff,4,0,20,16
1746563893709,POLI 138,A00,891278,Staff,21,0,25,4
1746563894734,POLI 142K,A00,891280,Staff,11,0,25,14
1746563895765,POLI 142M,A00,891281,Gartzke; Erik,17,0,30,13
1746563896793,POLI 142P,A00,891284,Staff,20,0,30,10
1746563897817,POLI 143,A00,891285,Gartzke; Erik,12,0,30,18
1746563898844,POLI 153,A00,891286,Staff,19,0,20,1
1746563900898,POLI 175,A00,891290,Staff,15,0,20,5
1746563901925,PSYC 1,A00,890674,Steiner; Eric Tomas,0,11,45,45
1746563902951,PSYC 2,A00,890676,Albright; Thomas D,21,0,35,14
1746563903980,PSYC 3,A00,890679,Staff,17,0,20,3
1746563905038,PSYC 6,A00,959858,Staff,20,0,20,0
1746563906070,PSYC 60,A01,890684,Rickard; Timothy C.,0,5,45,45
1746563907098,PSYC 70,A01,890689,Geller; Emma Harlan,7,0,30,23
1746563908127,PSYC 71,A01,959860,Staff,21,0,25,4
1746563909150,PSYC 100,A00,890690,Lacefield; Katharine I,0,50,180,180
1746563910178,PSYC 102,A00,890695,Staff,18,0,40,22
1746563911202,PSYC 105,A00,890699,Geller; Emma Harlan,70,0,100,30
1746563912227,PSYC 106,A00,890701,Gorman; Michael R.,6,0,30,24
1746563913251,PSYC 108,A00,890704,Adrian; Julia Anna,0,28,50,50
1746563914275,PSYC 118,A01,890712,Staff,11,0,30,19
1746563915303,PSYC 124,A00,890716,Chapman; Eddie Nathaniel,25,0,60,35
1746563916327,PSYC 131,A00,890717,Anagnostaras; Stephan,0,7,80,80
1746563917351,PSYC 137,A00,890719,Winkielman; Piotr,0,11,30,30
1746563918378,PSYC 144,A00,890721,Adrian; Julia Anna,0,9,45,45
1746563919406,PSYC 162,A00,890805,Staff,1,0,75,74
1746563920430,PSYC 169,A00,890810,Staff,0,14,30,30
1746563921458,PSYC 172,A00,890814,Gorman; Michael R.,9,0,30,21
1746563922481,PSYC 181,A00,890818,Anagnostaras; Stephan,9,0,200,191
1746563923504,PSYC 184,A00,959861,Staff,168,0,175,7
1746563924529,PSYC 189,A00,890823,Staff,0,1,30,30
1746563925557,PSYC 191,A00,890884,Rickard; Timothy C.,0,11,35,35
1746563926586,PSYC 193,A00,890913,Staff,19,0,30,11
1746563926586,PSYC 193,B00,890914,Chapman; Eddie Nathaniel,24,0,30,6
1746563927612,PSYC 193L,A01,890918,Lowe; Angela Beth,20,0,30,10
1746563927612,PSYC 193L,B01,890921,Hurwitz; Ethan Scott,20,0,30,10
1746563927612,PSYC 193L,C01,890928,Staff,30,0,30,0
1746563928638,RELI 149,A00,886806,Rahimi; Babak,23,0,40,17
1746563929663,SE 9,A01,886814,Staff,7,0,20,13
1746563930691,SE 101B,A01,886816,Chadha; Mayank,4,0,35,31
1746563931721,SE 110B,A00,886818,Zhu; Qiang,4,0,75,71
1746563932748,SE 125,A01,886830,Staff,10,0,30,20
1746563933773,SE 130B,A01,886835,Staff,14,0,40,26
1746563934799,SE 131A,A01,886838,Krysl; Petr,34,0,55,21
1746563935829,SE 154,A00,886840,Staff,29,0,50,21
1746563936855,SE 164GS,A01,886849,Staff,6,0,20,14
1746563937880,SE 167GS,A01,886853,Staff,6,0,20,14
1746563938905,SIO 25,A01,890107,Staff,19,0,30,11
1746563939929,SIO 45,A00,890109,Cook; Geoffrey W,117,0,200,83
1746563940954,SIO 109R,A00,890110,Forman; Fonna,0,16,20,20
1746563941982,SIO 187,A01,890114,Kacev; David,15,0,40,25
1746563943008,SOCI 1,A01,890431,Thorpe; Charles Robert,15,0,30,15
1746563943008,SOCI 1,A02,890518,Thorpe; Charles Robert,30,0,30,0
1746563944054,SOCI 2,A01,957978,Staff,25,0,25,0
1746563944054,SOCI 2,A02,957979,Staff,23,0,25,2
1746563945081,SOCI 20,A01,890523,Calderon-Zaks; Michael Aar,23,0,30,7
1746563945081,SOCI 20,A02,890526,Calderon-Zaks; Michael Aar,29,0,30,1
1746563946109,SOCI 30,A01,890533,Pardo Guerra; Juan Pablo,37,0,40,3
1746563947133,SOCI 40,A01,890535,Staff,27,0,45,18
1746563948157,SOCI 104Q,A00,890559,Staff,18,0,30,12
1746563949183,SOCI 106,A00,890560,Arnal; Maud Marie Leonie,20,0,30,10
1746563950212,SOCI 110,A00,890567,Holkenbrink-Monk; Charlene,19,0,30,11
1746563951235,SOCI 112,A00,890568,Victoria Torres; Pablo,2,0,55,53
1746563952264,SOCI 115,A00,890597,Arnal; Maud Marie Leonie,28,0,45,17
1746563954312,SOCI 121,A00,890604,Pardo Guerra; Juan Pablo,38,0,45,7
1746563955336,SOCI 126,A01,890608,Staff,8,0,10,2
1746563956362,SOCI 127,A00,890609,Staff,18,0,30,12
1746563957386,SOCI 131,A00,890610,Thorpe; Charles Robert,37,0,45,8
1746563958413,SOCI 135,A00,890615,Payne; Christine Anna,13,0,45,32
1746563959438,SOCI 139,A00,890620,Staff,38,0,45,7
1746563960467,SOCI 148E,A00,890622,Calderon-Zaks; Michael Aar,36,0,45,9
1746563961494,SOCI 150,A00,890623,Kohler; Kristopher M.,31,0,45,14
1746563962517,SOCI 157,A00,890625,Jules-Rosette; Bennetta W.,18,0,20,2
1746563963541,SOCI 160,A00,890627,Payne; Christine Anna,21,0,45,24
1746563964565,SYN 1,A00,886855,Fish; Gwendolyn Anne,0,0,0,0
1746563964565,SYN 1,B00,906086,Fish; Gwendolyn Anne,0,2,0,2
1746563965592,SYN 2R,A00,886860,Staff,0,17,15,15
1746563965592,SYN 2R,B00,906106,Atkinson; Arthur Laird,0,16,15,15
1746563966622,SYN 100,A01,886866,Browne; Emily,0,28,20,20
1746563966622,SYN 100,B01,906128,Rock; Martin,0,5,20,20
1746563966622,SYN 100,C01,906140,Deavenport; James Cary,0,3,20,20
1746563966622,SYN 100,D01,907816,Deavenport; James Cary,0,5,20,20
1746563967649,TDAC 1,A00,890286,Walsh; Kim C.,8,0,20,12
1746563968673,TDAC 101,A00,890296,Basso; Beatrice,15,0,20,5
1746563969704,TDDE 131,A00,890297,Staff,47,0,50,3
1746563970728,TDDM 1,A00,890287,Weinberg; Sadie,25,0,30,5
1746563971760,TDGE 11,A00,890288,Fulton; Julia,137,0,200,63
1746563971760,TDGE 11,B00,890289,Castro; Robert Jess,184,0,200,16
1746563972784,TDGE 25,B00,957359,Walsh; Kim C.,3,0,20,17
1746563973813,TDGE 40,A01,890292,Power; Jade Yukana,27,0,30,3
1746563974839,TDGE 124,A00,890298,Havis; Allan,0,1,50,50
1746563975865,TDGE 131R,A00,890299,Burelle; Julie Sara Veronique,15,0,42,27
1746563976895,TDHT 101,A00,890300,Staff,10,0,20,10
1746563977918,TDHT 109,A01,890302,Anderson; Mysia Anyse,31,0,40,9
1746563978946,TDMV 1,A00,890293,Arcidiacono; Kristin,18,0,30,12
1746563979970,TDMV 2,A00,890294,Weinberg; Sadie,23,0,30,7
1746563981001,TDMV 3,A00,957878,Arcidiacono; Kristin,28,0,30,2
1746563983056,TDMV 138,A00,890304,Jun; Grace Shin Hae,25,0,40,15
1746563984084,TDMV 140,A00,890305,Corrales; Joseph Bernales,25,0,30,5
1746563985108,TDMV 142,A00,890307,Caligagan; Tony,32,0,40,8
1746563986133,TDMV 144,A00,890308,Camaya; Michelle Ann,25,0,30,5
1746563987162,TDPW 1,A00,890295,Stein; Deborah Isobel,3,0,20,17
1746563988189,USP 2,A01,890272,Lerner; Amy M,6,0,20,14
1746563989215,USP 3,A01,890274,Staff,12,0,30,18
1746563990244,USP 15,A01,890276,Sun; Feiyang,16,0,30,14
1746563991273,USP 25,A00,890277,Shenkman; Michael Thomas,19,0,25,6
1746563992299,USP 138,A00,890278,Staff,14,0,25,11
1746563993323,USP 143,A00,890279,Staff,22,0,70,48
1746563994348,USP 144,A00,890280,Chowdhury; Muhammed Zohir,16,0,30,14
1746563995373,USP 150,A00,890281,Boomhower; Matthew Charles,4,0,30,26
1746563996400,USP 151,A00,890282,Staff,16,0,20,4
1746563997429,USP 162,A00,890283,Andrews; Abigail Leslie,16,0,20,4
1746563998455,USP 168,A00,920477,Kwak; Nancy,0,0,5,5
1746563999481,USP 181,A00,890284,Staff,3,0,20,17
1746564000508,USP 191A,A00,890285,Staff,12,0,20,8
1746564001536,VIS 101,A00,886512,Staff,26,0,75,49
1746564002560,VIS 103,A00,886513,Cruz; Edwin Teddy,61,0,75,14
1746564003586,VIS 108,A00,886514,Staff,3,0,15,12
1746564004613,VIS 127P,A00,886515,Shen; Kuiyi,80,0,146,66
1746564005638,VIS 149,A00,886516,Yoldas; Pinar,0,0,15,15
1746564006667,VIS 164,A00,886526,Erdmann; Dean,19,0,22,3
1746564007693,VIS 194S,A00,886527,Staff,61,0,75,14
1746564008720,WCWP 10A,C00,886484,Martiniuk; Jill,12,0,15,3
1746564009746,WCWP 10B,A00,886490,Uriarte; Emma,0,0,15,15
1746564009746,WCWP 10B,B00,886491,Dhir; Simrita,10,0,15,5
1746564009746,WCWP 10B,C00,886492,Ornelas; Tricia,0,0,15,15
1746564010773,WCWP 100,A00,886494,Young; Mark T,0,6,15,15
1746564012901,AAS 10,A01,886199,Childs; Dennis R.,0,3,0,0
1746564013931,ANAR 104,A01,886940,Shtienberg; Gilad,27,0,30,3
1746564014963,ANAR 120,A00,886953,Staff,12,0,20,8
1746564015989,ANBI 148,A01,886955,Wilder; Linnea Lorene,30,0,40,10
1746564018042,ANSC 122,A00,886957,Staff,25,0,30,5
1746564019067,ANSC 150,A00,886958,Sloane; Julia Kathryn,2,0,15,13
1746564020098,ANSC 156,A00,886959,Jenkins; Janis A.,0,1,15,15
1746564021127,ANSC 180,A00,886960,Staff,11,0,17,6
1746564022151,ANSC 188,A00,886961,Jassal; Aftab,9,0,25,16
1746564023180,ANSC 190,A00,886962,Jassal; Aftab,14,0,25,11
1746564024204,ANSC 191,A00,886963,Staff,18,0,20,2
1746564025229,ANTH 3,A01,891689,Staff,17,0,20,3
1746564026258,ANTH 5,A00,886933,Semendeferi; Ekaterini,16,0,20,4
1746564027283,ANTH 10,A00,886934,Staff,0,12,30,30
1746564028313,ANTH 21,A01,886936,Staff,41,0,60,19
1746564029339,ANTH 23,A01,886938,Staff,92,0,100,8
1746564030364,ANTH 105,A00,886964,Stewart; Alexander B,84,0,100,16
1746564031388,ANTH 108,A00,886965,Pedersen; David,9,0,20,11
1746564032420,AWP 10,001,886147,Staff,0,0,0,0
1746564032420,AWP 10,002,886148,Staff,0,0,0,0
1746564032420,AWP 10,003,886149,Staff,0,0,0,0
1746564032420,AWP 10,004,886150,Staff,0,0,0,0
1746564032420,AWP 10,005,886151,Staff,0,0,0,0
1746564032420,AWP 10,006,886152,Staff,0,0,0,0
1746564032420,AWP 10,007,886153,Staff,0,0,0,0
1746564032420,AWP 10,008,886154,Staff,0,0,0,0
1746564032420,AWP 10,009,886155,Staff,0,0,0,0
1746564032420,AWP 10,010,886156,Staff,0,0,0,0
1746564032420,AWP 10,011,886158,Staff,0,0,0,0
1746564032420,AWP 10,012,886160,Staff,0,0,0,0
1746564032420,AWP 10,013,886161,Staff,0,0,0,0
1746564032420,AWP 10,014,886162,Staff,0,0,0,0
1746564032420,AWP 10,015,886163,Staff,0,0,0,0
1746564032420,AWP 10,016,886164,Staff,0,0,0,0
1746564032420,AWP 10,017,886165,Staff,0,0,0,0
1746564032420,AWP 10,018,886166,Staff,0,0,0,0
1746564032420,AWP 10,019,886168,Staff,0,0,0,0
1746564032420,AWP 10,020,886170,Staff,0,0,0,0
1746564032420,AWP 10,021,886172,Staff,0,0,0,0
1746564033454,AWP 10R,001,886173,Staff,0,1,0,0
1746564033454,AWP 10R,002,886174,Staff,0,1,0,0
1746564033454,AWP 10R,003,886175,Staff,0,0,0,0
1746564033454,AWP 10R,004,886176,Staff,0,0,0,0
1746564033454,AWP 10R,005,886177,Staff,0,0,0,0
1746564033454,AWP 10R,006,886178,Staff,0,0,0,0
1746564033454,AWP 10R,007,886179,Staff,0,0,0,0
1746564033454,AWP 10R,008,886181,Staff,0,0,0,0
1746564033454,AWP 10R,009,886182,Staff,0,0,0,0
1746564033454,AWP 10R,010,886183,Staff,0,0,0,0
1746564033454,AWP 10R,011,886184,Staff,0,0,0,0
1746564033454,AWP 10R,012,886185,Staff,0,0,0,0
1746564033454,AWP 10R,013,886186,Staff,0,0,0,0
1746564033454,AWP 10R,014,886187,Staff,0,0,0,0
1746564033454,AWP 10R,015,886188,Staff,0,0,0,0
1746564033454,AWP 10R,016,886189,Staff,0,0,0,0
1746564033454,AWP 10R,017,960532,Staff,0,0,0,0
1746564033454,AWP 10R,018,960533,Staff,0,0,0,0
1746564033454,AWP 10R,019,960534,Staff,0,0,0,0
1746564033454,AWP 10R,020,960538,Staff,0,0,0,0
1746564033454,AWP 10R,021,960540,Staff,0,0,0,0
1746564033454,AWP 10R,022,960541,Staff,0,0,0,0
1746564033454,AWP 10R,023,960542,Staff,0,0,0,0
1746564033454,AWP 10R,024,960544,Staff,0,0,0,0
1746564033454,AWP 10R,025,960545,Staff,0,0,0,0
1746564033454,AWP 10R,026,960548,Staff,0,0,0,0
1746564034479,AWP 102R,A00,886190,Staff,0,0,0,0
1746564034479,AWP 102R,B00,886191,Staff,0,0,0,0
1746564035503,BENG 100,A01,886193,Staff,17,0,30,13
1746564036529,BENG 122A,A01,886195,Hasty; Jeff M,13,0,30,17
1746564037558,BENG 166A,A00,886196,Sah; Robert Lie-Yuan,0,2,30,30
1746564038586,BENG 190,A00,958050,Khojah; Reem I,21,0,25,4
1746564039614,BIBC 102,A01,894320,Staff,0,0,46,46
1746564039614,BIBC 102,A02,894321,Staff,0,0,46,46
1746564039614,BIBC 102,A03,894344,Staff,7,0,46,39
1746564039614,BIBC 102,A04,894345,Staff,26,0,47,21
1746564040641,BICD 100R,A01,894365,Smith; Laurie,0,3,58,58
1746564040641,BICD 100R,A02,894366,Smith; Laurie,0,5,58,58
1746564040641,BICD 100R,A03,894367,Smith; Laurie,1,0,59,58
1746564040641,BICD 100R,A04,959869,Smith; Laurie,40,0,59,19
1746564041667,BICD 136,A01,894383,Gustafson-Brown; Cindy,14,0,50,36
1746564042693,BIEB 102,A01,894494,Butler; Shannon Rhey,51,0,130,79
1746564044752,BIEB 150,A01,894617,Wills; Christopher,3,0,20,17
1746564044752,BIEB 150,A02,894631,Wills; Christopher,3,0,20,17
1746564044752,BIEB 150,A03,894937,Wills; Christopher,3,0,20,17
1746564044752,BIEB 150,A04,894946,Wills; Christopher,5,0,20,15
1746564045777,BIEB 194,A00,906141,Kurle; Carolyn M.,6,0,20,14
1746564046804,BILD 1,A01,894154,Staff,3,0,19,16
1746564046804,BILD 1,A02,894155,Staff,14,0,19,5
1746564046804,BILD 1,A03,894160,Staff,13,0,19,6
1746564046804,BILD 1,A04,894161,Staff,15,0,18,3
1746564047828,BILD 2,A01,894168,Staff,0,0,50,50
1746564047828,BILD 2,A02,894169,Staff,0,0,50,50
1746564047828,BILD 2,A03,894179,Staff,0,0,50,50
1746564047828,BILD 2,A04,894203,Staff,25,0,50,25
1746564048853,BILD 3,A01,894213,Staff,22,0,31,9
1746564048853,BILD 3,A02,894214,Staff,26,0,31,5
1746564048853,BILD 3,A03,894235,Staff,28,0,31,3
1746564048853,BILD 3,A04,894236,Staff,28,0,32,4
1746564049878,BILD 4,A01,894253,Reuther; Keefe,5,0,24,19
1746564049878,BILD 4,A02,894258,Reuther; Keefe,16,0,24,8
1746564050906,BILD 5,A01,894276,Reuther; Keefe,35,0,50,15
1746564050906,BILD 5,A02,894277,Reuther; Keefe,45,0,50,5
1746564050906,BILD 5,A03,894290,Reuther; Keefe,44,0,50,6
1746564050906,BILD 5,A04,894291,Reuther; Keefe,48,0,50,2
1746564051930,BILD 24,A01,894297,Pirino; Giorgia,40,0,60,20
1746564052955,BIMM 100,B01,958915,Staff,71,0,100,29
1746564053979,BIMM 101,A01,895017,McDonnell; Lisa Marie,0,5,24,24
1746564053979,BIMM 101,A02,895018,McDonnell; Lisa Marie,0,5,24,24
1746564053979,BIMM 101,B01,895020,McDonnell; Lisa Marie,0,6,24,24
1746564053979,BIMM 101,B02,895021,McDonnell; Lisa Marie,0,4,24,24
1746564055009,BIMM 110,A01,895023,Staff,1,0,25,24
1746564055009,BIMM 110,A02,895024,Staff,9,0,25,16
1746564055009,BIMM 110,A03,895025,Staff,18,0,25,7
1746564055009,BIMM 110,A04,895031,Staff,20,0,25,5
1746564056037,BIMM 120,A01,895114,Gustafson-Brown; Cindy,14,0,28,14
1746564056037,BIMM 120,A02,895126,Gustafson-Brown; Cindy,21,0,27,6
1746564057063,BIPN 100,A01,895130,Yang; Mingyu,1,0,38,37
1746564057063,BIPN 100,A02,895131,Yang; Mingyu,32,0,38,6
1746564057063,BIPN 100,A03,895132,Yang; Mingyu,32,0,38,6
1746564057063,BIPN 100,A04,895133,Yang; Mingyu,27,0,36,9
1746564058092,BIPN 120,A01,895135,Cooke; James Edward,0,3,13,13
1746564058092,BIPN 120,A02,895136,Cooke; James Edward,0,1,13,13
1746564058092,BIPN 120,A03,895137,Cooke; James Edward,0,3,13,13
1746564058092,BIPN 120,A04,895156,Cooke; James Edward,0,2,11,11
1746564059117,BIPN 134,A01,895235,Cooke; James Edward,0,2,25,25
1746564059117,BIPN 134,A02,895237,Cooke; James Edward,0,0,25,25
1746564059117,BIPN 134,A03,895240,Cooke; James Edward,3,0,25,22
1746564059117,BIPN 134,A04,895270,Cooke; James Edward,20,0,25,5
1746564060142,BIPN 189,A00,892103,Staff,0,13,14,14
1746564062191,BISP 194,A00,958008,Staff,0,2,0,0
1746564063219,CAT 124,A01,922009,Staff,0,5,20,20
1746564064244,CAT 125R,A00,886390,Morales; Celeste Georgianna,0,2,20,20
1746564064244,CAT 125R,B00,886391,Irwin; Matthew Joseph,0,4,20,20
1746564064244,CAT 125R,C00,886392,Smith; Lauryn Alissa,0,2,20,20
1746564064244,CAT 125R,D00,886393,Vanderschuit; Maya Alysia,0,2,20,20
1746564064244,CAT 125R,E00,886394,Marchisotto; Jennifer Anne,0,3,20,20
1746564065271,CENG 15,A01,886218,Drews; Aaron,3,0,8,5
1746564066295,CENG 113,A00,886219,Opatkiewicz; Justin Paul,15,0,25,10
1746564067320,CGS 101,A00,887044,Staff,7,0,20,13
1746564068345,CGS 105,A01,887046,Staff,14,0,25,11
1746564069371,CGS 112,A00,887047,Cuong; Marisol,12,0,15,3
1746564070395,CGS 113,A00,887048,Staff,23,0,30,7
1746564071420,CGS 120,A00,887049,Staff,10,0,17,7
1746564072447,CHEM 6A,A01,886336,Lam; Tin Yiu,38,0,50,12
1746564072447,CHEM 6A,A02,886338,Lam; Tin Yiu,37,0,50,13
1746564073472,CHEM 6B,A01,886341,Hopkins; Patrycja Anna,16,0,50,34
1746564073472,CHEM 6B,A02,886343,Hopkins; Patrycja Anna,42,0,50,8
1746564074497,CHEM 6C,A01,886346,Albizati; Kim F.,0,2,50,50
1746564074497,CHEM 6C,A02,886348,Albizati; Kim F.,23,0,50,27
1746564075524,CHEM 40A,A01,886352,Klosterman; Jeremy K,65,0,100,35
1746564076551,CHEM 40B,A01,886356,Klosterman; Jeremy K,0,23,100,100
1746564077576,CHEM 41B,A01,886360,Theodorakis; Emmanuel,25,0,50,25
1746564077576,CHEM 41B,A02,886362,Theodorakis; Emmanuel,47,0,50,3
1746564078603,CHIN 165A,A00,886382,Xu; Li,18,0,20,2
1746564079630,CLAS 120,A00,886387,Myerston Santana; Jacobo,33,0,40,7
1746564080658,COGS 9,A01,886967,Shannon; Kyle Michael,42,0,60,18
1746564081683,COGS 11,A01,886969,Staff,10,0,30,20
1746564093533,COGS 14A,A01,886971,Staff,6,0,60,54
1746564094559,COGS 14B,A01,886973,Hoffman; Drew Ellen,4,0,60,56
1746564095584,COGS 18,A01,886975,Morgan; Eric,35,0,60,25
1746564096611,COGS 20,A01,886977,Staff,4,0,8,4
1746564096611,COGS 20,A02,886978,Staff,5,0,7,2
1746564097637,COGS 100,A01,907783,Staff,0,2,30,30
1746564098663,COGS 101B,A01,886980,Staff,0,3,48,48
1746564099688,COGS 101C,A01,886982,Delgado; Tania,0,5,44,44
1746564100721,COGS 102A,A01,886984,Johnson; Christine M.,4,0,30,26
1746564101745,COGS 118B,A01,886986,Staff,0,3,88,88
1746564102771,COGS 150,A01,886988,Bergen; Benjamin,22,0,50,28
1746564103796,COGS 153,A00,886989,Delgado; Tania,0,2,41,41
1746564104824,COGS 186,A01,886991,Staff,0,0,32,32
1746564105849,COGS 187A,A01,886993,Boyle; Mary E. T.,7,0,30,23
1746564106878,COGS 189,A00,886994,Staff,0,1,30,30
1746564107903,COMM 10,A01,886996,Staff,0,0,20,21
1746564107903,COMM 10,A02,886997,Staff,12,0,20,8
1746564107903,COMM 10,A03,959845,Staff,19,0,20,1
1746564108929,COMM 20,A01,886999,Leuning; Grant Maurstad,24,0,40,16
1746564110983,COMM 100A,A01,887002,Staff,0,0,20,25
1746564110983,COMM 100A,A02,887003,Staff,6,0,20,14
1746564112008,COMM 100B,A01,887005,Staff,0,8,20,24
1746564113034,COMM 106D,A00,887006,Staff,13,0,40,27
1746564114058,COMM 110G,A00,887007,Whitworth-Smith; Andrew C,12,0,40,28
1746564115082,COMM 111B,A00,887008,Staff,31,0,40,9
1746564116111,COMM 113T,A00,887009,Abuelhiga; Soraya Jill,28,0,40,12
1746564116111,COMM 113T,B00,906733,Staff,40,0,40,0
1746564117137,COMM 145,A00,887010,Staff,12,0,40,28
1746564118164,COMM 146,A00,887054,Staff,31,0,40,9
1746564119193,COMM 190,A00,887012,Staff,8,0,23,15
1746564120219,CSE 8A,A50,887015,Cao; Yingjun,57,0,85,28
1746564121249,CSE 11,A01,887017,Cao; Yingjun,12,0,70,58
1746564122276,CSE 20,A01,887019,Staff,30,0,50,20
1746564123301,CSE 21,A01,887021,Staff,78,0,100,22
1746564123301,CSE 21,B01,892583,Braun; Oliver,45,0,50,5
1746564124327,CSE 30,A01,887025,Eldon; John,143,0,200,57
1746564125351,CSE 100,A01,887027,Staff,26,0,50,24
1746564125351,CSE 100,A02,887028,Staff,42,0,50,8
1746564126381,CSE 101,A01,887030,Braun; Oliver,74,0,100,26
1746564126381,CSE 101,B01,887032,Jones; Miles E,0,3,50,50
1746564126381,CSE 101,B02,887033,Jones; Miles E,0,2,50,50
1746564127413,CSE 105,A01,908084,Jones; Miles E,32,0,50,18
1746564127413,CSE 105,A02,908087,Jones; Miles E,32,0,50,18
1746564128439,CSE 135,A01,887035,Powell; Thomas Allan,0,5,50,50
1746564129466,CSE 142,A01,887037,Staff,8,0,60,52
1746564130493,CSE 142L,A01,887039,Staff,34,0,60,26
1746564131522,CSE 151A,A01,887041,Solares; Edwin A,47,0,100,53
1746564132550,CSE 175,A01,887043,Kumar; Rakesh,30,0,30,0
1746564133576,CSS 1,A01,886389,Staff,1,1,40,39
1746564134600,DSC 30,A01,908097,Liao; Soohyun Nam,47,0,75,28
1746564135624,DSC 40A,A01,908099,Shannon; Kyle Michael,30,0,50,20
1746564136649,DSC 40B,A01,908112,Staff,15,0,50,35
1746564137677,DSC 80,A01,908116,Staff,19,0,60,41
1746564138704,DSC 197,001,956863,Eldridge; Justin Matthew,9999,0,9999,0
1746564139734,ECE 5,A01,886400,Morris; Karcher William,1,0,6,5
1746564139734,ECE 5,A02,886401,Morris; Karcher William,3,0,6,3
1746564140760,ECE 148,A01,886403,Silberman; Jack,0,14,14,14
1746564141787,ECON 1,A01,887265,Crane; Meredith Helen,12,0,70,58
1746564141787,ECON 1,B01,887268,Staff,43,0,50,7
1746564142812,ECON 2,A01,887273,Crane; Meredith Helen,55,0,70,15
1746564143843,ECON 3,A01,887279,Rondina; Giacomo,32,0,70,38
1746564144872,ECON 4,A01,887282,Anderson; John Charles,0,2,10,10
1746564145897,ECON 5,A01,887285,Staff,34,0,45,11
1746564145897,ECON 5,B01,887292,Staff,41,0,45,4
1746564146922,ECON 100A,A01,887337,Newhouse; Herbert S,54,0,70,16
1746564146922,ECON 100A,B01,887349,Staff,45,0,50,5
1746564147950,ECON 100B,A01,887361,Du; Songzi,29,0,70,41
1746564148979,ECON 100C,A01,887445,Newhouse; Herbert S,59,0,70,11
1746564150003,ECON 105,A00,887488,Vespa; Emanuel Ignacio,23,0,35,12
1746564151030,ECON 109,A01,887506,Shishkin; Denis,28,0,35,7
1746564152058,ECON 110A,A01,887568,Alon; Titan Michael,0,3,35,35
1746564152058,ECON 110A,B01,907601,Alon; Titan Michael,20,0,35,15
1746564153086,ECON 110B,A01,887598,Levkoff; Steven B.,0,24,70,70
1746564154115,ECON 112,A00,887599,Rondina; Giacomo,19,0,35,16
1746564155146,ECON 120A,A01,887603,Dai; Yinlin,35,0,70,35
1746564156172,ECON 120C,A01,887608,Sun; Yixiao,0,1,35,35
1746564156172,ECON 120C,B01,887614,Sun; Yixiao,0,0,35,35
1746564157200,ECON 138,A00,887621,Bharadwaj; Prashant,0,21,20,20
1746564158224,ECON 144,A00,958007,Squires; Dale E,13,0,35,22
1746564159253,ECON 171,A01,907666,Staff,18,0,35,17
1746564160279,ECON 175,A00,887626,Wu; Pak Yeung,23,0,35,12
1746564161304,ECON 190,A00,887640,Vespa; Emanuel Ignacio,23,0,35,12
1746564162337,EDS 25,A01,888197,Staff,0,0,0,0
1746564162337,EDS 25,A02,888209,Staff,0,0,0,0
1746564162337,EDS 25,A03,888210,Staff,0,0,0,0
1746564162337,EDS 25,A04,888212,Staff,0,0,0,0
1746564162337,EDS 25,A05,888213,Staff,0,0,0,0
1746564162337,EDS 25,A06,888214,Staff,0,0,0,0
1746564162337,EDS 25,A07,888235,Staff,0,2,0,0
1746564162337,EDS 25,A08,888236,Staff,0,0,0,0
1746564162337,EDS 25,A09,888240,Staff,0,0,0,0
1746564162337,EDS 25,A10,888244,Staff,0,0,0,0
1746564162337,EDS 25,B01,888273,Staff,0,0,0,0
1746564162337,EDS 25,B02,888285,Staff,0,0,0,0
1746564162337,EDS 25,B03,888423,Staff,0,0,0,1
1746564162337,EDS 25,B04,888432,Staff,0,0,0,0
1746564162337,EDS 25,B05,888433,Staff,0,0,0,0
1746564162337,EDS 25,B06,888467,Staff,0,0,0,0
1746564162337,EDS 25,B07,888468,Staff,0,0,0,0
1746564162337,EDS 25,B08,888479,Staff,0,0,0,0
1746564162337,EDS 25,B09,888484,Staff,0,0,0,0
1746564162337,EDS 25,B10,888487,Staff,0,0,0,0
1746564163361,EDS 38,A01,907700,Choi; Bailey Miyeon,30,0,30,0
1746564164388,EDS 112,A01,888601,Chapman; Thandeka K,13,0,40,27
1746564165412,EDS 115,A00,888697,Mendez; Kathrina Mendoza,10,0,30,20
1746564166437,EDS 116,A01,888893,Staff,35,0,40,5
1746564168489,EDS 124AR,A00,889133,Staff,29,0,50,21
1746564168489,EDS 124AR,B00,907471,Simon; Elizabeth A,37,0,50,13
1746564169516,EDS 124BR,A00,889134,Simon; Elizabeth A,44,0,100,56
1746564170546,EDS 125,A00,889135,Staff,25,0,30,5
1746564171573,EDS 126,A01,889138,Staff,36,0,40,4
1746564172600,EDS 164R,A01,889142,Wishard Guerra; Alison G.,33,0,50,17
1746564173624,ENG 30,A01,886396,Staff,0,0,0,0
1746564173624,ENG 30,B01,886398,Staff,0,0,0,0
1746564174650,ENVR 102,A00,906150,Montejo; Carolina,23,0,25,2
1746564175679,ETHN 103A,A00,887236,Man; Simeon S,0,3,0,0
1746564176705,ETHN 113,A00,887239,Staff,16,0,30,14
1746564177732,ETHN 116,A00,887240,Staff,16,0,25,9
1746564178758,ETHN 117,A00,887241,Choi; Esther Min,28,0,30,2
1746564179784,ETHN 118,A00,887243,Staff,24,0,30,6
1746564180810,ETHN 127,A00,887248,Cuong; Marisol,11,0,15,4
1746564181834,ETHN 139,A00,887250,Staff,7,0,10,3
1746564182864,ETHN 142,A00,887252,Staff,10,0,30,20
1746564183895,ETHN 161,A00,887253,Browne; Errol Tsekani,24,0,30,6
1746564184919,ETHN 163FR,A00,887255,Burelle; Julie Sara Veronique,0,0,5,5
1746564185944,GLBH 20,A00,889149,Elwardani; Nile Regina,8,0,42,34
1746564187997,GLBH 111,A01,889152,Burgos; Jose L.,17,0,17,0
1746564189027,GLBH 150,A00,889181,Sloane; Julia Kathryn,0,5,15,15
1746564191080,HDS 60,A01,886406,Warstadt; Melissa Fawn,73,0,80,7
1746564192104,HIAF 111,A00,889324,Gyamfi; Bright,25,0,32,7
1746564193128,HIEA 131,A00,889328,Staff,15,0,32,17
1746564194155,HIEA 144,A00,889333,Henry; Todd A.,26,0,32,6
1746564195183,HIEA 154,A00,889336,Henry; Todd A.,24,0,32,8
1746564196206,HIEU 106,A00,889339,Staff,22,0,32,10
1746564198254,HIEU 114,A00,889340,Staff,3,0,32,29
1746564199283,HIEU 135GS,A00,889342,Patterson; Patrick H.,0,0,1,24
1746564200307,HIEU 137,A00,889343,Edington; Claire Ellen,10,0,25,15
1746564201333,HIEU 148,A00,889345,Staff,14,0,32,18
1746564202359,HIEU 154,A00,889346,Biess; Frank Peter,21,0,32,11
1746564203384,HILA 102,A00,889351,Staff,12,0,32,20
1746564204408,HILD 2A,A01,889221,Lewandoski; Julia Mavis,1,10,32,31
1746564205435,HILD 7B,A01,889225,Man; Simeon S,0,12,32,32
1746564206464,HILD 7C,A01,889288,Alvarez; Luis A,0,14,32,32
1746564207488,HILD 30,A01,889323,Staff,0,5,32,32
1746564209540,HISC 119,A00,889383,Golan; Tal,20,0,32,12
1746564210566,HIUS 103,A00,889384,Man; Simeon S,0,0,32,32
1746564211590,HIUS 117,A00,919797,Kwak; Nancy,18,0,32,14
1746564212618,HIUS 142A,A00,919788,Staff,22,0,32,10
1746564214670,HIUS 149,A00,889386,Gyamfi; Bright,26,0,32,6
1746564215696,HIUS 155,A00,889387,Alvarez; Luis A,14,0,32,18
1746564216722,HUM 3,A01,886499,Caldwell; Michael Alan,19,0,50,31
1746564217746,HUM 3GS,A00,886500,Rodriguez; Bretton Sigfred,0,0,0,28
1746564218771,HUM 3R,A01,886502,Markman; Kristina,0,36,50,50
1746564219795,HUM 4,A01,886504,Crum; Matthew Stephen,24,0,50,26
1746564219795,HUM 4,B01,886506,West; Geoffrey Scott,17,0,50,33
1746564220824,HUM 4GS,A00,886507,Staff,0,0,0,19
1746564221848,HUM 5,A01,886509,Staff,32,0,50,18
1746564222878,HUM 5R,A01,886511,Zavodny; Tatiana Sophia,0,39,50,50
1746564223906,JAPN 180,A00,886407,Staff,17,0,40,23
1746564224937,LATI 50,A01,886409,Martin-Cabrera; Luis,4,0,22,18
1746564224937,LATI 50,A02,886410,Martin-Cabrera; Luis,19,0,22,3
1746564224937,LATI 50,A03,886411,Martin-Cabrera; Luis,21,0,22,1
1746564224937,LATI 50,A04,886412,Martin-Cabrera; Luis,9,0,22,13
1746564225963,LAWS 101,A00,907664,Staff,28,0,60,32
1746564226990,LIAB 1A,A00,889388,Saab; Dima,17,0,20,3
1746564228015,LIAB 1AX,A00,889389,El Cheddadi; Youniss,18,0,20,2
1746564229041,LIFR 1C,A00,889391,Van Moer; Vinciane G,8,0,20,12
1746564230068,LIFR 1CX,A00,889392,Van Moer; Vinciane G,7,0,20,13
1746564231096,LIFR 1D,A00,889393,Van Moer; Vinciane G,7,0,20,13
1746564232122,LIFR 1DX,A00,889394,Van Moer; Vinciane G,8,0,20,12
1746564233146,LIGN 7,A00,886923,Staff,24,0,50,26
1746564234171,LIGN 17,A00,886924,Kehler; Andrew Scott,125,0,150,25
1746564235196,LTAM 110,A00,889395,Staff,15,0,30,15
1746564236247,LTAM 110GS,A00,958010,Rodriguez; Bretton Sigfred,0,0,0,28
1746564237271,LTCH 101,A00,889397,Staff,23,0,25,2
1746564238296,LTCS 130,A00,889398,Staff,23,0,25,2
1746564239321,LTEA 138,A00,889399,Staff,24,0,40,16
1746564240347,LTEN 149,A00,889400,Wesling; Megan E.,0,3,25,25
1746564241372,LTEN 169,A00,889401,Staff,20,0,25,5
1746564242402,LTEN 180,A00,889402,Staff,10,0,15,5
1746564243427,LTEN 181,A00,889403,Staff,21,0,25,4
1746564244452,LTWL 100,A00,889404,Myerston Santana; Jacobo,2,0,25,23
1746564245476,LTWL 180GS,A00,889405,Staff,0,0,20,20
1746564246502,LTWL 181,A00,889406,Staff,16,0,25,9
1746564247527,LTWL 184,A00,889475,Mukherjee; Silpa,22,0,25,3
1746564248553,LTWR 102C,A00,889486,Staff,29,0,30,1
1746564249579,LTWR 115W,A00,889491,Staff,0,2,15,15
1746564250609,MAE 8,A01,886905,Staff,0,2,0,0
1746564251639,MAE 11,A00,886906,Bandaru; Prabhakar,0,7,50,50
1746564252669,MAE 20,A00,886907,Evdokimenko; Ekaterina,43,0,70,27
1746564253694,MAE 30B,A00,886909,Ghazinejad; Maziar,26,0,45,19
1746564254718,MAE 101B,A00,886910,Saintillan; David,29,0,45,16
1746564255747,MAE 105,A00,886911,Bandaru; Prabhakar,18,0,50,32
1746564256781,MAE 107,B00,958024,Staff,8,0,50,42
1746564257806,MAE 143B,A00,886913,Bewley; Thomas R,6,0,40,34
1746564258831,MAE 148,A01,886915,Silberman; Jack,0,3,14,14
1746564259855,MAE 160,A00,886916,Evdokimenko; Ekaterina,32,0,60,28
1746564260883,MATH 3C,A01,889681,Staff,0,2,30,30
1746564260883,MATH 3C,A02,960048,Staff,24,0,30,6
1746564261915,MATH 10A,A01,889760,Staff,26,0,30,4
1746564261915,MATH 10A,A02,889783,Staff,29,0,30,1
1746564262940,MATH 10B,A01,889785,Verstraete; Jacques Allan,2,0,35,33
1746564262940,MATH 10B,A02,889795,Verstraete; Jacques Allan,4,0,35,31
1746564262940,MATH 10B,B01,889797,Verstraete; Jacques Allan,3,0,35,32
1746564262940,MATH 10B,B02,889828,Verstraete; Jacques Allan,3,0,35,32
1746564263968,MATH 10C,A01,889849,Habib; Yousaf,8,0,30,22
1746564263968,MATH 10C,A02,889852,Habib; Yousaf,14,0,30,16
1746564263968,MATH 10C,A03,889853,Habib; Yousaf,22,0,30,8
1746564263968,MATH 10C,A04,889858,Habib; Yousaf,20,0,30,10
1746564263968,MATH 10C,B01,889861,Staff,1,0,30,29
1746564263968,MATH 10C,B02,889862,Staff,24,0,30,6
1746564263968,MATH 10C,B03,889863,Staff,27,0,30,3
1746564263968,MATH 10C,B04,889967,Staff,23,0,30,7
1746564264998,MATH 18,A01,889974,Staff,7,0,30,23
1746564264998,MATH 18,A02,889977,Staff,20,0,30,10
1746564264998,MATH 18,B01,889984,Hardiman; Liam,21,0,30,9
1746564264998,MATH 18,B02,889985,Hardiman; Liam,25,0,30,5
1746564266024,MATH 20A,A01,889990,Suk; Andrew Hoon,30,0,35,5
1746564267051,MATH 20B,A01,889993,Ohm; Ko Woon,22,0,30,8
1746564267051,MATH 20B,A02,889994,Ohm; Ko Woon,30,0,30,0
1746564267051,MATH 20B,B01,889996,Ohm; Ko Woon,21,0,30,9
1746564267051,MATH 20B,B02,889997,Ohm; Ko Woon,23,0,30,7
1746564268076,MATH 20C,A01,889999,Hammock; Frances H,17,0,30,13
1746564268076,MATH 20C,A02,890003,Hammock; Frances H,23,0,30,7
1746564268076,MATH 20C,B01,890006,Hammock; Frances H,3,0,30,27
1746564268076,MATH 20C,B02,890007,Hammock; Frances H,12,0,30,18
1746564269108,MATH 20D,A01,890011,Cheng; Hsiao-Bing,1,1,30,29
1746564269108,MATH 20D,A02,890012,Cheng; Hsiao-Bing,14,0,30,16
1746564269108,MATH 20D,B01,890016,Cheng; Hsiao-Bing,13,0,30,17
1746564269108,MATH 20D,B02,890017,Cheng; Hsiao-Bing,13,0,30,17
1746564270138,MATH 20E,A01,890026,Harel; Guershon,1,0,30,29
1746564270138,MATH 20E,A02,890029,Harel; Guershon,23,0,30,7
1746564270138,MATH 20E,B01,890033,Harel; Guershon,7,0,30,23
1746564270138,MATH 20E,B02,890101,Harel; Guershon,21,0,30,9
1746564271166,MATH 102,A01,890104,Staff,17,0,30,13
1746564271166,MATH 102,A02,890105,Staff,27,0,30,3
1746564272197,MATH 103B,A01,890116,Salehi Golsefidy; Alireza,3,0,30,27
1746564272197,MATH 103B,B01,890118,Staff,0,3,34,34
1746564273224,MATH 109,A01,890121,Aliabadi Sr.; Mohsen,1,0,30,29
1746564273224,MATH 109,B01,890124,Upadrashta; Pranav Kumar,18,0,30,12
1746564274247,MATH 120A,A01,890126,Eggers; John Dietrich,13,0,30,17
1746564275273,MATH 142B,A01,890128,Ioana; Adrian,19,0,30,11
1746564275273,MATH 142B,A02,890129,Ioana; Adrian,13,0,30,17
1746564276299,MATH 154,A01,890174,Staff,0,0,30,30
1746564276299,MATH 154,A02,890182,Staff,0,0,30,30
1746564277324,MATH 168A,A01,890197,Dumitriu; Ioana,21,0,35,14
1746564278355,MATH 170A,A01,890240,Nie; Jiawang,1,0,30,29
1746564278355,MATH 170A,A02,890241,Nie; Jiawang,11,0,30,19
1746564278355,MATH 170A,A03,890249,Nie; Jiawang,23,0,30,7
1746564279381,MATH 170B,A01,957891,Nag; Panchali,13,0,35,22
1746564281432,MATH 181A,A01,908025,Staff,0,4,35,35
1746564281432,MATH 181A,A02,960115,Staff,27,0,35,8
1746564282458,MATH 181B,A01,959874,Staff,25,0,30,5
1746564283486,MATH 193B,A01,890265,Staff,0,4,35,35
1746564284514,MGT 4,A01,890311,Anderson; John Charles,42,0,88,46
1746564285539,MGT 5,A00,907740,Staff,13,0,98,85
1746564286565,MGT 12,A00,890312,Lindenberger; Wade Douglas,67,0,98,31
1746564287594,MGT 16,A00,957883,Staff,78,0,98,20
1746564289647,MGT 45,A00,890314,Pecore; Joseph P.,46,0,98,52
1746564290672,MGT 71,A00,890315,Staff,0,11,98,98
1746564291698,MGT 100,A00,890316,Yavorsky; Daniel Ryan,44,0,98,54
1746564292726,MGT 103,A00,890317,Ehrich; Kristine R,73,0,98,25
1746564293752,MGT 105,A00,890356,Bates; Kenneth Walter,0,8,98,98
1746564294777,MGT 112,A00,890360,Ehrich; Kristine R,55,0,98,43
1746564295804,MGT 127R,A00,907732,Zhu; Kevin Xiaoguo,23,0,98,75
1746564296829,MGT 131B,A00,890361,Anderson; John Charles,60,0,98,38
1746564297856,MGT 137,A00,890362,Lindenberger; Wade Douglas,65,0,98,33
1746564298883,MGT 160,A00,890369,Johnson; Erik Barry,9,0,98,89
1746564300937,MGT 164,A00,890372,Zimmermann; Carsten,0,40,98,98
1746564301963,MGT 180,A00,890374,Bliss; Barbara Ann,12,0,98,86
1746564302997,MMW 15,A01,886414,Chang; Edmond Yi-Teh,0,12,28,28
1746564302997,MMW 15,A02,886415,Chang; Edmond Yi-Teh,0,8,28,28
1746564302997,MMW 15,A03,886416,Chang; Edmond Yi-Teh,0,8,28,28
1746564302997,MMW 15,A04,886417,Chang; Edmond Yi-Teh,0,8,28,28
1746564302997,MMW 15,B01,886419,Chang; Edmond Yi-Teh,0,7,28,28
1746564302997,MMW 15,B02,886420,Chang; Edmond Yi-Teh,0,8,28,28
1746564302997,MMW 15,B03,886421,Chang; Edmond Yi-Teh,0,7,28,28
1746564302997,MMW 15,B04,886422,Chang; Edmond Yi-Teh,0,8,28,28
1746564302997,MMW 15,C01,886424,Staff,0,9,28,28
1746564302997,MMW 15,C02,886425,Staff,0,8,28,28
1746564302997,MMW 15,C03,886426,Staff,0,8,28,28
1746564302997,MMW 15,C04,886427,Staff,0,8,28,28
1746564302997,MMW 15,C05,958038,Staff,0,8,28,28
1746564302997,MMW 15,C06,958039,Staff,1,8,28,27
1746564304025,MMW 15GS,A00,906910,Patterson; Patrick H.,4,0,28,24
1746564305051,MMW 122R,A01,886429,Rahimi; Babak,0,13,28,28
1746564305051,MMW 122R,A02,886430,Rahimi; Babak,0,12,28,28
1746564305051,MMW 122R,A03,958040,Rahimi; Babak,0,11,28,28
1746564306079,MUS 1A,A01,890937,Staff,2,0,25,23
1746564306079,MUS 1A,A02,891035,Staff,6,0,25,19
1746564306079,MUS 1A,C01,958912,Staff,24,0,25,1
1746564306079,MUS 1A,C02,958913,Staff,25,0,25,0
1746564308130,MUS 2AK,A00,957092,Ohnishi; Takae,15,0,15,0
1746564309155,MUS 4,A01,891044,Staff,2,0,25,23
1746564309155,MUS 4,A02,891045,Staff,23,0,25,2
1746564309155,MUS 4,B01,891048,Staff,17,0,25,8
1746564309155,MUS 4,B02,891050,Staff,25,0,25,0
1746564310180,MUS 5,A01,957506,Dubnov; Shlomo,0,0,25,25
1746564310180,MUS 5,A02,957622,Dubnov; Shlomo,13,0,25,12
1746564310180,MUS 5,A03,957623,Dubnov; Shlomo,20,0,25,5
1746564311207,MUS 6,A01,891053,Freitas Caetano; Marcelo,24,0,25,1
1746564311207,MUS 6,A02,891054,Freitas Caetano; Marcelo,23,0,25,2
1746564312234,MUS 7,A01,891081,Staff,0,0,25,25
1746564312234,MUS 7,A02,891082,Staff,4,0,25,21
1746564313257,MUS 8GS,A00,891118,Borgo; David Garcia,1,0,25,24
1746564314285,MUS 11,A01,891140,Staff,9,0,25,16
1746564314285,MUS 11,A02,891141,Staff,22,0,25,3
1746564315310,MUS 13,A01,891143,Staff,8,0,25,17
1746564315310,MUS 13,A02,891144,Staff,24,0,25,1
1746564316335,MUS 15,A01,891146,Staff,9,0,25,16
1746564316335,MUS 15,A02,891148,Staff,21,0,25,4
1746564316335,MUS 15,B01,891150,Staff,18,0,25,7
1746564316335,MUS 15,B02,891151,Staff,25,0,25,0
1746564317363,MUS 20,A01,891153,Staff,5,0,20,15
1746564317363,MUS 20,A02,891155,Staff,14,0,20,6
1746564318387,MUS 80,A00,891156,Staff,19,0,25,6
1746564318387,MUS 80,B00,891157,Staff,23,0,25,2
1746564319411,MUS 130,A00,891158,Ohnishi; Takae,35,0,35,0
1746564320436,MUS 150GS,A01,891160,Borgo; David Garcia,1,0,25,24
1746564321461,MUS 170,A01,891162,Freitas Caetano; Marcelo,20,0,25,5
1746564321461,MUS 170,A02,891164,Freitas Caetano; Marcelo,21,0,25,4
1746564322489,NANO 11,A00,886220,Vazquez Mena; Oscar,13,0,15,2
1746564323513,NANO 15,A01,886222,Drews; Aaron,4,0,7,3
1746564324541,NANO 104,A00,886224,Sirbuly; Donald,18,0,25,7
1746564325568,PH 40,A00,886528,Staff,23,0,40,17
1746564326594,PH 45,A01,886799,Staff,35,0,40,5
1746564327621,PH 110,A00,886802,Staff,0,7,40,40
1746564328646,PH 172,A00,906716,Staff,19,0,35,16
1746564329671,PH 191,A00,886803,Staff,6,0,40,34
1746564331116,PHIL 1,A00,889500,Staff,20,0,30,10
1746564332143,PHIL 10,A01,889549,Grush; Rick Scott,15,0,22,7
1746564332143,PHIL 10,A02,889551,Grush; Rick Scott,22,0,22,0
1746564333172,PHIL 28,A01,889559,Lamey; Andy M.,0,2,31,31
1746564333172,PHIL 28,A02,889561,Lamey; Andy M.,0,1,30,30
1746564333172,PHIL 28,A03,889572,Lamey; Andy M.,0,1,30,30
1746564334196,PHIL 35,A00,907839,Staff,13,0,15,2
1746564335224,PHIL 60,A00,889574,Staff,73,0,90,17
1746564336250,PHIL 101,A00,958004,Staff,12,0,15,3
1746564338309,PHIL 136,A00,889582,Fulkerson; Matthew Todd,26,0,45,19
1746564339351,PHIL 163,A01,889601,Staff,21,0,30,9
1746564339351,PHIL 163,B01,889606,Brandt; Reuven A,0,3,0,0
1746564340376,PHIL 164,A00,889610,Staff,16,0,30,14
1746564341405,PHIL 165,A00,889613,Staff,23,0,30,7
1746564342432,PHYS 1A,A00,886431,Staff,26,0,70,44
1746564343459,PHYS 1AL,001,886432,Tsai; Philbert S,0,2,30,30
1746564343459,PHYS 1AL,002,886436,Tsai; Philbert S,11,0,30,19
1746564344487,PHYS 1B,A00,886439,Staff,185,0,240,55
1746564345512,PHYS 1BL,001,886441,Tsai; Philbert S,0,4,30,30
1746564345512,PHYS 1BL,002,886444,Tsai; Philbert S,2,0,30,28
1746564346644,PHYS 1C,A00,896092,Arnold; Kam S,78,0,146,68
1746564347677,PHYS 1CL,001,886448,Tsai; Philbert S,0,0,30,30
1746564347677,PHYS 1CL,002,886449,Tsai; Philbert S,1,0,30,29
1746564347677,PHYS 1CL,003,886450,Tsai; Philbert S,16,0,30,14
1746564347677,PHYS 1CL,004,886451,Tsai; Philbert S,15,0,30,15
1746564348706,PHYS 2B,A01,886457,Staff,68,0,115,47
1746564349731,PHYS 2C,A01,886460,Shotwell; Brian,0,9,65,65
1746564350902,PHYS 2CL,A01,886467,Staff,0,4,28,28
1746564350902,PHYS 2CL,A02,886468,Staff,0,3,28,28
1746564352414,PHYS 2D,A01,886470,Staff,10,0,50,40
1746564353438,PHYS 4B,A01,886475,Grinstein; Benjamin,22,0,40,18
1746564359353,POLI 5,A00,891173,Desposato; Scott,7,0,25,18
1746564360384,POLI 5D,A01,891175,Staff,5,0,5,0
1746564360384,POLI 5D,B01,891178,Staff,5,0,5,0
1746564361409,POLI 11,A00,891179,Ferree; Karen E,2,0,35,33
1746564362913,POLI 12,A00,891180,Staff,16,0,30,14
1746564363958,POLI 27,A01,891182,Staff,12,0,75,63
1746564364982,POLI 30,A00,891183,Staff,8,0,50,42
1746564371791,POLI 100B,A00,891244,Staff,5,1,35,30
1746564372821,POLI 100I,A00,891247,Staff,7,0,30,23
1746564377779,POLI 104J,A00,891248,Nichter; Maysa,14,0,30,16
1746564383785,POLI 104U,A00,891250,Nichter; Maysa,2,0,30,28
1746564397586,POLI 110B,A00,891255,Wiens; David,20,0,25,5
1746564402397,POLI 112A,A00,891256,Wiens; David,6,0,25,19
1746564406746,POLI 114BR,A00,891261,Staff,19,0,30,11
1746564412522,POLI 117R,A00,891262,Forman; Fonna,0,6,50,50
1746564417853,POLI 118,A00,891264,Ingham; Sean,17,0,25,8
1746564422740,POLI 124A,A00,891265,Staff,18,0,20,2
1746564426652,POLI 125D,A00,891266,Nichter; Simeon C,2,0,25,23
1746564432577,POLI 126,A00,891268,Nichter; Simeon C,7,0,25,18
1746564437562,POLI 126AA,A00,891272,Staff,17,0,25,8
1746564442563,POLI 130AA,A00,891273,Staff,15,0,20,5
1746564449076,POLI 134AA,A00,891274,Staff,4,0,20,16
1746564456456,POLI 138,A00,891278,Staff,21,0,25,4
1746564462537,POLI 142K,A00,891280,Staff,10,0,25,15
1746564467851,POLI 142M,A00,891281,Gartzke; Erik,16,0,30,14
1746564468876,POLI 142P,A00,891284,Staff,20,0,30,10
1746564475137,POLI 143,A00,891285,Gartzke; Erik,12,0,30,18
1746564476164,POLI 153,A00,891286,Staff,19,0,20,1
1746564482067,POLI 175,A00,891290,Staff,15,0,20,5
1746564483092,PSYC 1,A00,890674,Steiner; Eric Tomas,0,11,45,45
1746564488036,PSYC 2,A00,890676,Albright; Thomas D,21,0,35,14
1746564489062,PSYC 3,A00,890679,Staff,17,0,20,3
1746564494129,PSYC 6,A00,959858,Staff,20,0,20,0
1746564495163,PSYC 60,A01,890684,Rickard; Timothy C.,0,5,45,45
1746564499731,PSYC 70,A01,890689,Geller; Emma Harlan,7,0,30,23
1746564500756,PSYC 71,A01,959860,Staff,21,0,25,4
1746564506047,PSYC 100,A00,890690,Lacefield; Katharine I,0,50,180,180
1746564507077,PSYC 102,A00,890695,Staff,18,0,40,22
1746564508102,PSYC 105,A00,890699,Geller; Emma Harlan,70,0,100,30
1746564512243,PSYC 106,A00,890701,Gorman; Michael R.,6,0,30,24
1746564513269,PSYC 108,A00,890704,Adrian; Julia Anna,0,28,50,50
1746564519074,PSYC 118,A01,890712,Staff,11,0,30,19
1746564520099,PSYC 124,A00,890716,Chapman; Eddie Nathaniel,25,0,60,35
1746564525231,PSYC 131,A00,890717,Anagnostaras; Stephan,0,7,80,80
1746564530944,PSYC 137,A00,890719,Winkielman; Piotr,0,11,30,30
1746564536787,PSYC 144,A00,890721,Adrian; Julia Anna,0,9,45,45
1746564537819,PSYC 162,A00,890805,Staff,1,0,75,74
1746564543539,PSYC 169,A00,890810,Staff,0,14,30,30
1746564548977,PSYC 172,A00,890814,Gorman; Michael R.,9,0,30,21
1746564554401,PSYC 181,A00,890818,Anagnostaras; Stephan,9,0,200,191
1746564555427,PSYC 184,A00,959861,Staff,168,0,175,7
1746564560142,PSYC 189,A00,890823,Staff,0,1,30,30
1746564565741,PSYC 191,A00,890884,Rickard; Timothy C.,0,11,35,35
1746564570446,PSYC 193,A00,890913,Staff,19,0,30,11
1746564570446,PSYC 193,B00,890914,Chapman; Eddie Nathaniel,24,0,30,6
1746564571471,PSYC 193L,A01,890918,Lowe; Angela Beth,20,0,30,10
1746564571471,PSYC 193L,B01,890921,Hurwitz; Ethan Scott,20,0,30,10
1746564571471,PSYC 193L,C01,890928,Staff,30,0,30,0
1746564575574,RELI 149,A00,886806,Rahimi; Babak,23,0,40,17
1746564580959,SE 9,A01,886814,Staff,7,0,20,13
1746564586492,SE 101B,A01,886816,Chadha; Mayank,4,0,35,31
1746564592474,SE 110B,A00,886818,Zhu; Qiang,4,0,75,71
1746564597103,SE 125,A01,886830,Staff,10,0,30,20
1746564601984,SE 130B,A01,886835,Staff,14,0,40,26
1746564608153,SE 131A,A01,886838,Krysl; Petr,34,0,55,21
1746564614189,SE 154,A00,886840,Staff,29,0,50,21
1746564619358,SE 164GS,A01,886849,Staff,6,0,20,14
1746564625067,SE 167GS,A01,886853,Staff,6,0,20,14
1746564629624,SIO 25,A01,890107,Staff,19,0,30,11
1746564634147,SIO 45,A00,890109,Cook; Geoffrey W,117,0,200,83
1746564639077,SIO 109R,A00,890110,Forman; Fonna,0,16,20,20
1746564643573,SIO 187,A01,890114,Kacev; David,15,0,40,25
1746564648448,SOCI 1,A01,890431,Thorpe; Charles Robert,15,0,30,15
1746564648448,SOCI 1,A02,890518,Thorpe; Charles Robert,30,0,30,0
1746564653165,SOCI 2,A01,957978,Staff,25,0,25,0
1746564653165,SOCI 2,A02,957979,Staff,23,0,25,2
1746564658165,SOCI 20,A01,890523,Calderon-Zaks; Michael Aar,23,0,30,7
1746564658165,SOCI 20,A02,890526,Calderon-Zaks; Michael Aar,29,0,30,1
1746564663326,SOCI 30,A01,890533,Pardo Guerra; Juan Pablo,37,0,40,3
1746564668984,SOCI 40,A01,890535,Staff,27,0,45,18
1746564674993,SOCI 104Q,A00,890559,Staff,18,0,30,12
1746564680232,SOCI 106,A00,890560,Arnal; Maud Marie Leonie,20,0,30,10
1746564685924,SOCI 110,A00,890567,Holkenbrink-Monk; Charlene,19,0,30,11
1746564691179,SOCI 112,A00,890568,Victoria Torres; Pablo,2,0,55,53
1746564696779,SOCI 115,A00,890597,Arnal; Maud Marie Leonie,28,0,45,17
1746564705713,SOCI 121,A00,890604,Pardo Guerra; Juan Pablo,38,0,45,7
1746564710856,SOCI 126,A01,890608,Staff,8,0,10,2
1746564717234,SOCI 127,A00,890609,Staff,18,0,30,12
1746564722329,SOCI 131,A00,890610,Thorpe; Charles Robert,37,0,45,8
1746564728276,SOCI 135,A00,890615,Payne; Christine Anna,13,0,45,32
1746564733764,SOCI 139,A00,890620,Staff,38,0,45,7
1746564738965,SOCI 148E,A00,890622,Calderon-Zaks; Michael Aar,36,0,45,9
1746564743897,SOCI 150,A00,890623,Kohler; Kristopher M.,31,0,45,14
1746564749515,SOCI 157,A00,890625,Jules-Rosette; Bennetta W.,18,0,20,2
1746564754030,SOCI 160,A00,890627,Payne; Christine Anna,21,0,45,24
1746564760350,SYN 1,A00,886855,Fish; Gwendolyn Anne,0,0,0,0
1746564760350,SYN 1,B00,906086,Fish; Gwendolyn Anne,0,2,0,2
1746564766813,SYN 2R,A00,886860,Staff,0,17,15,15
1746564766813,SYN 2R,B00,906106,Atkinson; Arthur Laird,0,16,15,15
1746564773496,SYN 100,A01,886866,Browne; Emily,0,28,20,20
1746564773496,SYN 100,B01,906128,Rock; Martin,0,5,20,20
1746564773496,SYN 100,C01,906140,Deavenport; James Cary,0,3,20,20
1746564773496,SYN 100,D01,907816,Deavenport; James Cary,0,5,20,20
1746564778555,TDAC 1,A00,890286,Walsh; Kim C.,8,0,20,12
1746564783250,TDAC 101,A00,890296,Basso; Beatrice,15,0,20,5
1746564789242,TDDE 131,A00,890297,Staff,47,0,50,3
1746564794355,TDDM 1,A00,890287,Weinberg; Sadie,25,0,30,5
1746564799681,TDGE 11,A00,890288,Fulton; Julia,137,0,200,63
1746564799681,TDGE 11,B00,890289,Castro; Robert Jess,184,0,200,16
1746564805428,TDGE 25,B00,957359,Walsh; Kim C.,4,0,20,16
1746564810450,TDGE 40,A01,890292,Power; Jade Yukana,27,0,30,3
1746564814138,TDGE 124,A00,890298,Havis; Allan,0,1,50,50
1746564819607,TDGE 131R,A00,890299,Burelle; Julie Sara Veronique,15,0,42,27
1746564825480,TDHT 101,A00,890300,Staff,10,0,20,10
1746564829853,TDHT 109,A01,890302,Anderson; Mysia Anyse,31,0,40,9
1746564835249,TDMV 1,A00,890293,Arcidiacono; Kristin,18,0,30,12
1746564840070,TDMV 2,A00,890294,Weinberg; Sadie,23,0,30,7
1746564846722,TDMV 3,A00,957878,Arcidiacono; Kristin,28,0,30,2
1746564855925,TDMV 138,A00,890304,Jun; Grace Shin Hae,25,0,40,15
1746564859688,TDMV 140,A00,890305,Corrales; Joseph Bernales,25,0,30,5
1746564864650,TDMV 142,A00,890307,Caligagan; Tony,32,0,40,8
1746564868466,TDMV 144,A00,890308,Camaya; Michelle Ann,25,0,30,5
1746564873524,TDPW 1,A00,890295,Stein; Deborah Isobel,3,0,20,17
1746564878412,USP 2,A01,890272,Lerner; Amy M,6,0,20,14
1746564884564,USP 3,A01,890274,Staff,12,0,30,18
1746564888294,USP 15,A01,890276,Sun; Feiyang,16,0,30,14
1746564893597,USP 25,A00,890277,Shenkman; Michael Thomas,19,0,25,6
1746564898835,USP 138,A00,890278,Staff,14,0,25,11
1746564903730,USP 143,A00,890279,Staff,22,0,70,48
1746564908017,USP 144,A00,890280,Chowdhury; Muhammed Zohir,16,0,30,14
1746564911771,USP 150,A00,890281,Boomhower; Matthew Charles,4,0,30,26
1746564917190,USP 151,A00,890282,Staff,16,0,20,4
1746564922560,USP 162,A00,890283,Andrews; Abigail Leslie,16,0,20,4
1746564926252,USP 168,A00,920477,Kwak; Nancy,0,0,5,5
1746564931152,USP 181,A00,890284,Staff,3,0,20,17
1746564934986,USP 191A,A00,890285,Staff,12,0,20,8
1746564940097,VIS 101,A00,886512,Staff,26,0,75,49
1746564944976,VIS 103,A00,886513,Cruz; Edwin Teddy,61,0,75,14
1746564948910,VIS 108,A00,886514,Staff,3,0,15,12
1746564952911,VIS 127P,A00,886515,Shen; Kuiyi,80,0,146,66
1746564956839,VIS 149,A00,886516,Yoldas; Pinar,0,0,15,15
1746564960834,VIS 164,A00,886526,Erdmann; Dean,19,0,22,3
1746564966042,VIS 194S,A00,886527,Staff,61,0,75,14
1746564971465,WCWP 10A,C00,886484,Martiniuk; Jill,12,0,15,3
1746564976651,WCWP 10B,A00,886490,Uriarte; Emma,0,0,15,15
1746564976651,WCWP 10B,B00,886491,Dhir; Simrita,10,0,15,5
1746564976651,WCWP 10B,C00,886492,Ornelas; Tricia,0,0,15,15
1746564981765,WCWP 100,A00,886494,Young; Mark T,0,6,15,15
1746564990919,AAS 10,A01,886199,Childs; Dennis R.,0,3,0,0
1746564996421,ANAR 104,A01,886940,Shtienberg; Gilad,27,0,30,3
1746565000801,ANAR 120,A00,886953,Staff,12,0,20,8
1746565005346,ANBI 148,A01,886955,Wilder; Linnea Lorene,30,0,40,10
1746565013733,ANSC 122,A00,886957,Staff,25,0,30,5
1746565017715,ANSC 150,A00,886958,Sloane; Julia Kathryn,2,0,15,13
1746565028468,ANSC 156,A00,886959,Jenkins; Janis A.,0,1,15,15
1746565034082,ANSC 180,A00,886960,Staff,11,0,17,6
1746565039648,ANSC 188,A00,886961,Jassal; Aftab,9,0,25,16
1746565045809,ANSC 190,A00,886962,Jassal; Aftab,14,0,25,11
1746565051584,ANSC 191,A00,886963,Staff,18,0,20,2
1746565057460,ANTH 3,A01,891689,Staff,17,0,20,3
1746565064592,ANTH 5,A00,886933,Semendeferi; Ekaterini,16,0,20,4
1746565069524,ANTH 10,A00,886934,Staff,0,12,30,30
1746565075962,ANTH 21,A01,886936,Staff,41,0,60,19
1746565081107,ANTH 23,A01,886938,Staff,92,0,100,8
1746565086211,ANTH 105,A00,886964,Stewart; Alexander B,84,0,100,16
1746565091935,ANTH 108,A00,886965,Pedersen; David,9,0,20,11
1746565096919,AWP 10,001,886147,Staff,0,0,0,0
1746565096919,AWP 10,002,886148,Staff,0,0,0,0
1746565096919,AWP 10,003,886149,Staff,0,0,0,0
1746565096919,AWP 10,004,886150,Staff,0,0,0,0
1746565096919,AWP 10,005,886151,Staff,0,0,0,0
1746565096919,AWP 10,006,886152,Staff,0,0,0,0
1746565096919,AWP 10,007,886153,Staff,0,0,0,0
1746565096919,AWP 10,008,886154,Staff,0,0,0,0
1746565096919,AWP 10,009,886155,Staff,0,0,0,0
1746565096919,AWP 10,010,886156,Staff,0,0,0,0
1746565096919,AWP 10,011,886158,Staff,0,0,0,0
1746565096919,AWP 10,012,886160,Staff,0,0,0,0
1746565096919,AWP 10,013,886161,Staff,0,0,0,0
1746565096919,AWP 10,014,886162,Staff,0,0,0,0
1746565096919,AWP 10,015,886163,Staff,0,0,0,0
1746565096919,AWP 10,016,886164,Staff,0,0,0,0
1746565096919,AWP 10,017,886165,Staff,0,0,0,0
1746565096919,AWP 10,018,886166,Staff,0,0,0,0
1746565096919,AWP 10,019,886168,Staff,0,0,0,0
1746565096919,AWP 10,020,886170,Staff,0,0,0,0
1746565096919,AWP 10,021,886172,Staff,0,0,0,0
1746565102008,AWP 10R,001,886173,Staff,0,1,0,0
1746565102008,AWP 10R,002,886174,Staff,0,1,0,0
1746565102008,AWP 10R,003,886175,Staff,0,0,0,0
1746565102008,AWP 10R,004,886176,Staff,0,0,0,0
1746565102008,AWP 10R,005,886177,Staff,0,0,0,0
1746565102008,AWP 10R,006,886178,Staff,0,0,0,0
1746565102008,AWP 10R,007,886179,Staff,0,0,0,0
1746565102008,AWP 10R,008,886181,Staff,0,0,0,0
1746565102008,AWP 10R,009,886182,Staff,0,0,0,0
1746565102008,AWP 10R,010,886183,Staff,0,0,0,0
1746565102008,AWP 10R,011,886184,Staff,0,0,0,0
1746565102008,AWP 10R,012,886185,Staff,0,0,0,0
1746565102008,AWP 10R,013,886186,Staff,0,0,0,0
1746565102008,AWP 10R,014,886187,Staff,0,0,0,0
1746565102008,AWP 10R,015,886188,Staff,0,0,0,0
1746565102008,AWP 10R,016,886189,Staff,0,0,0,0
1746565102008,AWP 10R,017,960532,Staff,0,0,0,0
1746565102008,AWP 10R,018,960533,Staff,0,0,0,0
1746565102008,AWP 10R,019,960534,Staff,0,0,0,0
1746565102008,AWP 10R,020,960538,Staff,0,0,0,0
1746565102008,AWP 10R,021,960540,Staff,0,0,0,0
1746565102008,AWP 10R,022,960541,Staff,0,0,0,0
1746565102008,AWP 10R,023,960542,Staff,0,0,0,0
1746565102008,AWP 10R,024,960544,Staff,0,0,0,0
1746565102008,AWP 10R,025,960545,Staff,0,0,0,0
1746565102008,AWP 10R,026,960548,Staff,0,0,0,0
1746565107271,AWP 102R,A00,886190,Staff,0,0,0,0
1746565107271,AWP 102R,B00,886191,Staff,0,0,0,0
1746565111275,BENG 100,A01,886193,Staff,17,0,30,13
1746565116039,BENG 122A,A01,886195,Hasty; Jeff M,13,0,30,17
1746565120873,BENG 166A,A00,886196,Sah; Robert Lie-Yuan,0,2,30,30
1746565124569,BENG 190,A00,958050,Khojah; Reem I,21,0,25,4
1746565128229,BIBC 102,A01,894320,Staff,0,0,46,46
1746565128229,BIBC 102,A02,894321,Staff,0,0,46,46
1746565128229,BIBC 102,A03,894344,Staff,7,0,46,39
1746565128229,BIBC 102,A04,894345,Staff,26,0,47,21
1746565133028,BICD 100R,A01,894365,Smith; Laurie,0,3,58,58
1746565133028,BICD 100R,A02,894366,Smith; Laurie,0,5,58,58
1746565133028,BICD 100R,A03,894367,Smith; Laurie,0,0,59,59
1746565133028,BICD 100R,A04,959869,Smith; Laurie,40,0,59,19
1746565137624,BICD 136,A01,894383,Gustafson-Brown; Cindy,14,0,50,36
1746565143870,BIEB 102,A01,894494,Butler; Shannon Rhey,51,0,130,79
1746565155317,BIEB 150,A01,894617,Wills; Christopher,3,0,20,17
1746565155317,BIEB 150,A02,894631,Wills; Christopher,3,0,20,17
1746565155317,BIEB 150,A03,894937,Wills; Christopher,3,0,20,17
1746565155317,BIEB 150,A04,894946,Wills; Christopher,5,0,20,15
1746565159984,BIEB 194,A00,906141,Kurle; Carolyn M.,6,0,20,14
1746565165210,BILD 1,A01,894154,Staff,3,0,19,16
1746565165210,BILD 1,A02,894155,Staff,14,0,19,5
1746565165210,BILD 1,A03,894160,Staff,13,0,19,6
1746565165210,BILD 1,A04,894161,Staff,15,0,18,3
1746565169905,BILD 2,A01,894168,Staff,0,0,50,50
1746565169905,BILD 2,A02,894169,Staff,0,0,50,50
1746565169905,BILD 2,A03,894179,Staff,0,0,50,50
1746565169905,BILD 2,A04,894203,Staff,25,0,50,25
1746565175107,BILD 3,A01,894213,Staff,22,0,31,9
1746565175107,BILD 3,A02,894214,Staff,26,0,31,5
1746565175107,BILD 3,A03,894235,Staff,28,0,31,3
1746565175107,BILD 3,A04,894236,Staff,28,0,32,4
1746565180001,BILD 4,A01,894253,Reuther; Keefe,6,0,24,18
1746565180001,BILD 4,A02,894258,Reuther; Keefe,16,0,24,8
1746565184835,BILD 5,A01,894276,Reuther; Keefe,35,0,50,15
1746565184835,BILD 5,A02,894277,Reuther; Keefe,45,0,50,5
1746565184835,BILD 5,A03,894290,Reuther; Keefe,44,0,50,6
1746565184835,BILD 5,A04,894291,Reuther; Keefe,48,0,50,2
1746565189729,BILD 24,A01,894297,Pirino; Giorgia,40,0,60,20
1746565195674,BIMM 100,B01,958915,Staff,71,0,100,29
1746565200432,BIMM 101,A01,895017,McDonnell; Lisa Marie,0,5,24,24
1746565200432,BIMM 101,A02,895018,McDonnell; Lisa Marie,0,5,24,24
1746565200432,BIMM 101,B01,895020,McDonnell; Lisa Marie,0,6,24,24
1746565200432,BIMM 101,B02,895021,McDonnell; Lisa Marie,0,4,24,24
1746565204628,BIMM 110,A01,895023,Staff,1,0,25,24
1746565204628,BIMM 110,A02,895024,Staff,9,0,25,16
1746565204628,BIMM 110,A03,895025,Staff,18,0,25,7
1746565204628,BIMM 110,A04,895031,Staff,20,0,25,5
1746565209873,BIMM 120,A01,895114,Gustafson-Brown; Cindy,14,0,28,14
1746565209873,BIMM 120,A02,895126,Gustafson-Brown; Cindy,21,0,27,6
1746565216093,BIPN 100,A01,895130,Yang; Mingyu,1,0,38,37
1746565216093,BIPN 100,A02,895131,Yang; Mingyu,32,0,38,6
1746565216093,BIPN 100,A03,895132,Yang; Mingyu,32,0,38,6
1746565216093,BIPN 100,A04,895133,Yang; Mingyu,27,0,36,9
1746565221216,BIPN 120,A01,895135,Cooke; James Edward,0,3,13,13
1746565221216,BIPN 120,A02,895136,Cooke; James Edward,0,1,13,13
1746565221216,BIPN 120,A03,895137,Cooke; James Edward,0,3,13,13
1746565221216,BIPN 120,A04,895156,Cooke; James Edward,0,2,11,11
1746565225699,BIPN 134,A01,895235,Cooke; James Edward,0,2,25,25
1746565225699,BIPN 134,A02,895237,Cooke; James Edward,0,0,25,25
1746565225699,BIPN 134,A03,895240,Cooke; James Edward,3,0,25,22
1746565225699,BIPN 134,A04,895270,Cooke; James Edward,20,0,25,5
1746565231195,BIPN 189,A00,892103,Staff,0,13,14,14
1746565241307,BISP 194,A00,958008,Staff,0,2,0,0
1746565246153,CAT 124,A01,922009,Staff,0,5,20,20
1746565252257,CAT 125R,A00,886390,Morales; Celeste Georgianna,0,2,20,20
1746565252257,CAT 125R,B00,886391,Irwin; Matthew Joseph,0,4,20,20
1746565252257,CAT 125R,C00,886392,Smith; Lauryn Alissa,0,2,20,20
1746565252257,CAT 125R,D00,886393,Vanderschuit; Maya Alysia,0,3,20,20
1746565252257,CAT 125R,E00,886394,Marchisotto; Jennifer Anne,0,3,20,20
1746565256012,CENG 15,A01,886218,Drews; Aaron,3,0,8,5
1746565261704,CENG 113,A00,886219,Opatkiewicz; Justin Paul,15,0,25,10
1746565265299,CGS 101,A00,887044,Staff,7,0,20,13
1746565270686,CGS 105,A01,887046,Staff,14,0,25,11
1746565275267,CGS 112,A00,887047,Cuong; Marisol,12,0,15,3
1746565280288,CGS 113,A00,887048,Staff,23,0,30,7
1746565285154,CGS 120,A00,887049,Staff,10,0,17,7
1746565290531,CHEM 6A,A01,886336,Lam; Tin Yiu,38,0,50,12
1746565290531,CHEM 6A,A02,886338,Lam; Tin Yiu,37,0,50,13
1746565296310,CHEM 6B,A01,886341,Hopkins; Patrycja Anna,16,0,50,34
1746565296310,CHEM 6B,A02,886343,Hopkins; Patrycja Anna,42,0,50,8
1746565301388,CHEM 6C,A01,886346,Albizati; Kim F.,0,2,50,50
1746565301388,CHEM 6C,A02,886348,Albizati; Kim F.,23,0,50,27
1746565307116,CHEM 40A,A01,886352,Klosterman; Jeremy K,65,0,100,35
1746565312125,CHEM 40B,A01,886356,Klosterman; Jeremy K,0,23,100,100
1746565316696,CHEM 41B,A01,886360,Theodorakis; Emmanuel,25,0,50,25
1746565316696,CHEM 41B,A02,886362,Theodorakis; Emmanuel,47,0,50,3
1746565322062,CHIN 165A,A00,886382,Xu; Li,18,0,20,2
1746565327417,CLAS 120,A00,886387,Myerston Santana; Jacobo,33,0,40,7
1746565332218,COGS 9,A01,886967,Shannon; Kyle Michael,42,0,60,18
1746565337138,COGS 11,A01,886969,Staff,10,0,30,20
1746565342448,COGS 14A,A01,886971,Staff,6,0,60,54
1746565347453,COGS 14B,A01,886973,Hoffman; Drew Ellen,4,0,60,56
1746565352235,COGS 18,A01,886975,Morgan; Eric,35,0,60,25
1746565357329,COGS 20,A01,886977,Staff,4,0,8,4
1746565357329,COGS 20,A02,886978,Staff,5,0,7,2
1746565362347,COGS 100,A01,907783,Staff,0,2,30,30
1746565366061,COGS 101B,A01,886980,Staff,0,3,48,48
1746565370687,COGS 101C,A01,886982,Delgado; Tania,0,5,44,44
1746565375695,COGS 102A,A01,886984,Johnson; Christine M.,4,0,30,26
1746565381172,COGS 118B,A01,886986,Staff,1,3,88,87
1746565384989,COGS 150,A01,886988,Bergen; Benjamin,22,0,50,28
1746565389822,COGS 153,A00,886989,Delgado; Tania,0,2,41,41
1746565395554,COGS 186,A01,886991,Staff,0,0,32,32
1746565400250,COGS 187A,A01,886993,Boyle; Mary E. T.,7,0,30,23
1746565405690,COGS 189,A00,886994,Staff,0,1,30,30
1746565410411,COMM 10,A01,886996,Staff,0,0,20,21
1746565410411,COMM 10,A02,886997,Staff,12,0,20,8
1746565410411,COMM 10,A03,959845,Staff,19,0,20,1
1746565416267,COMM 20,A01,886999,Leuning; Grant Maurstad,24,0,40,16
1746565427704,COMM 100A,A01,887002,Staff,0,0,20,25
1746565427704,COMM 100A,A02,887003,Staff,6,0,20,14
1746565434092,COMM 100B,A01,887005,Staff,0,8,20,24
1746565440059,COMM 106D,A00,887006,Staff,13,0,40,27
1746565445476,COMM 110G,A00,887007,Whitworth-Smith; Andrew C,12,0,40,28
1746565450291,COMM 111B,A00,887008,Staff,31,0,40,9
1746565455466,COMM 113T,A00,887009,Abuelhiga; Soraya Jill,28,0,40,12
1746565455466,COMM 113T,B00,906733,Staff,40,0,40,0
1746565460580,COMM 145,A00,887010,Staff,12,0,40,28
1746565465422,COMM 146,A00,887054,Staff,31,0,40,9
1746565470018,COMM 190,A00,887012,Staff,8,0,23,15
1746565474612,CSE 8A,A50,887015,Cao; Yingjun,57,0,85,28
1746565480192,CSE 11,A01,887017,Cao; Yingjun,12,0,70,58
1746565485053,CSE 20,A01,887019,Staff,30,0,50,20
1746565489830,CSE 21,A01,887021,Staff,78,0,100,22
1746565489830,CSE 21,B01,892583,Braun; Oliver,45,0,50,5
1746565495462,CSE 30,A01,887025,Eldon; John,143,0,200,57
1746565500743,CSE 100,A01,887027,Staff,26,0,50,24
1746565500743,CSE 100,A02,887028,Staff,42,0,50,8
1746565505716,CSE 101,A01,887030,Braun; Oliver,74,0,100,26
1746565505716,CSE 101,B01,887032,Jones; Miles E,0,3,50,50
1746565505716,CSE 101,B02,887033,Jones; Miles E,0,2,50,50
1746565510655,CSE 105,A01,908084,Jones; Miles E,32,0,50,18
1746565510655,CSE 105,A02,908087,Jones; Miles E,32,0,50,18
1746565515544,CSE 135,A01,887035,Powell; Thomas Allan,0,5,50,50
1746565520763,CSE 142,A01,887037,Staff,8,0,60,52
1746565525272,CSE 142L,A01,887039,Staff,34,0,60,26
1746565530082,CSE 151A,A01,887041,Solares; Edwin A,47,0,100,53
1746565534799,CSE 175,A01,887043,Kumar; Rakesh,30,0,30,0
1746565539425,CSS 1,A01,886389,Staff,1,1,40,39
1746565544405,DSC 30,A01,908097,Liao; Soohyun Nam,47,0,75,28
1746565547928,DSC 40A,A01,908099,Shannon; Kyle Michael,30,0,50,20
1746565553258,DSC 40B,A01,908112,Staff,15,0,50,35
1746565557040,DSC 80,A01,908116,Staff,19,0,60,41
1746565562180,DSC 197,001,956863,Eldridge; Justin Matthew,9999,0,9999,0
1746565567084,ECE 5,A01,886400,Morris; Karcher William,1,0,6,5
1746565567084,ECE 5,A02,886401,Morris; Karcher William,3,0,6,3
1746565577517,ECE 148,A01,886403,Silberman; Jack,0,14,14,14
1746565582427,ECON 1,A01,887265,Crane; Meredith Helen,12,0,70,58
1746565582427,ECON 1,B01,887268,Staff,43,0,50,7
1746565586072,ECON 2,A01,887273,Crane; Meredith Helen,55,0,70,15
1746565589623,ECON 3,A01,887279,Rondina; Giacomo,32,0,70,38
1746565594362,ECON 4,A01,887282,Anderson; John Charles,0,2,10,10
1746565599298,ECON 5,A01,887285,Staff,34,0,45,11
1746565599298,ECON 5,B01,887292,Staff,41,0,45,4
1746565603951,ECON 100A,A01,887337,Newhouse; Herbert S,54,0,70,16
1746565603951,ECON 100A,B01,887349,Staff,45,0,50,5
1746565609206,ECON 100B,A01,887361,Du; Songzi,29,0,70,41
1746565619057,ECON 100C,A01,887445,Newhouse; Herbert S,59,0,70,11
1746565624706,ECON 105,A00,887488,Vespa; Emanuel Ignacio,23,0,35,12
1746565629689,ECON 109,A01,887506,Shishkin; Denis,28,0,35,7
1746565634273,ECON 110A,A01,887568,Alon; Titan Michael,0,3,35,35
1746565634273,ECON 110A,B01,907601,Alon; Titan Michael,20,0,35,15
1746565639276,ECON 110B,A01,887598,Levkoff; Steven B.,0,24,70,70
1746565652344,ECON 112,A00,887599,Rondina; Giacomo,19,0,35,16
1746565659351,ECON 120A,A01,887603,Dai; Yinlin,35,0,70,35
1746565662856,ECON 120C,A01,887608,Sun; Yixiao,0,1,35,35
1746565662856,ECON 120C,B01,887614,Sun; Yixiao,0,0,35,35
1746565666560,ECON 138,A00,887621,Bharadwaj; Prashant,0,21,20,20
1746565676875,ECON 144,A00,958007,Squires; Dale E,13,0,35,22
1746565685752,ECON 171,A01,907666,Staff,18,0,35,17
1746565690329,ECON 175,A00,887626,Wu; Pak Yeung,23,0,35,12
1746565693942,ECON 190,A00,887640,Vespa; Emanuel Ignacio,23,0,35,12
1746565698858,EDS 25,A01,888197,Staff,0,0,0,0
1746565698858,EDS 25,A02,888209,Staff,0,0,0,0
1746565698858,EDS 25,A03,888210,Staff,0,0,0,0
1746565698858,EDS 25,A04,888212,Staff,0,0,0,0
1746565698858,EDS 25,A05,888213,Staff,0,0,0,0
1746565698858,EDS 25,A06,888214,Staff,0,0,0,0
1746565698858,EDS 25,A07,888235,Staff,0,2,0,0
1746565698858,EDS 25,A08,888236,Staff,0,0,0,0
1746565698858,EDS 25,A09,888240,Staff,0,0,0,0
1746565698858,EDS 25,A10,888244,Staff,0,0,0,0
1746565698858,EDS 25,B01,888273,Staff,0,0,0,0
1746565698858,EDS 25,B02,888285,Staff,0,0,0,0
1746565698858,EDS 25,B03,888423,Staff,0,0,0,1
1746565698858,EDS 25,B04,888432,Staff,0,0,0,0
1746565698858,EDS 25,B05,888433,Staff,0,0,0,0
1746565698858,EDS 25,B06,888467,Staff,0,0,0,0
1746565698858,EDS 25,B07,888468,Staff,0,0,0,0
1746565698858,EDS 25,B08,888479,Staff,0,0,0,0
1746565698858,EDS 25,B09,888484,Staff,0,0,0,0
1746565698858,EDS 25,B10,888487,Staff,0,0,0,0
1746565703583,EDS 38,A01,907700,Choi; Bailey Miyeon,30,0,30,0
1746565709010,EDS 112,A01,888601,Chapman; Thandeka K,12,0,40,28
1746565712616,EDS 115,A00,888697,Mendez; Kathrina Mendoza,10,0,30,20
1746565716267,EDS 116,A01,888893,Staff,35,0,40,5
1746565727207,EDS 124AR,A00,889133,Staff,29,0,50,21
1746565727207,EDS 124AR,B00,907471,Simon; Elizabeth A,37,0,50,13
1746565748263,EDS 124BR,A00,889134,Simon; Elizabeth A,44,0,100,56
1746565762619,EDS 125,A00,889135,Staff,25,0,30,5
