time,subj_course_id,sec_code,sec_id,prof,available,waitlist,total,enrolled_ct
1745135425572,AAS 10,A01,886199,Childs; Dennis R.,0,2,0,0
1745135426599,ANAR 104,A01,886940,Shtienberg; Gilad,27,0,30,3
1745135427624,ANAR 120,A00,886953,Staff,13,0,20,7
1745135428650,ANBI 148,A01,886955,Wilder; Linnea Lorene,32,0,40,8
1745135430706,ANSC 122,A00,886957,Staff,28,0,30,2
1745135431733,ANSC 150,A00,886958,Sloane; Julia Kathryn,6,0,15,9
1745135432760,ANSC 156,A00,886959,Jenkins; Janis A.,2,0,15,13
1745135433786,ANSC 180,A00,886960,Staff,12,0,17,5
1745135434812,ANSC 188,A00,886961,Jassal; Aftab,10,0,25,15
1745135435838,ANSC 190,A00,886962,Jassal; Aftab,14,0,25,11
1745135436863,ANSC 191,A00,886963,Staff,18,0,20,2
1745135437893,ANTH 3,A01,891689,Staff,19,0,20,1
1745135438923,ANTH 5,A00,886933,Semendeferi; Ekaterini,18,0,20,2
1745135440121,ANTH 10,A00,886934,Staff,0,8,30,30
1745135441148,ANTH 21,A01,886936,Staff,44,0,60,16
1745135442177,ANTH 23,A01,886938,Staff,94,0,100,6
1745135443203,ANTH 105,A00,886964,Stewart; Alexander B,94,0,100,6
1745135444229,ANTH 108,A00,886965,Pedersen; David,10,0,20,10
1745135445267,AWP 10,001,886147,Staff,0,0,0,0
1745135445267,AWP 10,002,886148,Staff,0,0,0,0
1745135445267,AWP 10,003,886149,Staff,0,0,0,0
1745135445267,AWP 10,004,886150,Staff,0,0,0,0
1745135445267,AWP 10,005,886151,Staff,0,0,0,0
1745135445267,AWP 10,006,886152,Staff,0,0,0,0
1745135445267,AWP 10,007,886153,Staff,0,0,0,0
1745135445267,AWP 10,008,886154,Staff,0,0,0,0
1745135445267,AWP 10,009,886155,Staff,0,0,0,0
1745135445267,AWP 10,010,886156,Staff,0,0,0,0
1745135445267,AWP 10,011,886158,Staff,0,0,0,0
1745135445267,AWP 10,012,886160,Staff,0,0,0,0
1745135445267,AWP 10,013,886161,Staff,0,0,0,0
1745135445267,AWP 10,014,886162,Staff,0,0,0,0
1745135445267,AWP 10,015,886163,Staff,0,0,0,0
1745135445267,AWP 10,016,886164,Staff,0,0,0,0
1745135445267,AWP 10,017,886165,Staff,0,0,0,0
1745135445267,AWP 10,018,886166,Staff,0,0,0,0
1745135445267,AWP 10,019,886168,Staff,0,0,0,0
1745135445267,AWP 10,020,886170,Staff,0,0,0,0
1745135445267,AWP 10,021,886172,Staff,0,0,0,0
1745135446297,AWP 10R,001,886173,Staff,0,0,0,0
1745135446297,AWP 10R,002,886174,Staff,0,1,0,0
1745135446297,AWP 10R,003,886175,Staff,0,0,0,0
1745135446297,AWP 10R,004,886176,Staff,0,0,0,0
1745135446297,AWP 10R,005,886177,Staff,0,0,0,0
1745135446297,AWP 10R,006,886178,Staff,0,0,0,0
1745135446297,AWP 10R,007,886179,Staff,0,0,0,0
1745135446297,AWP 10R,008,886181,Staff,0,0,0,0
1745135446297,AWP 10R,009,886182,Staff,0,0,0,0
1745135446297,AWP 10R,010,886183,Staff,0,0,0,0
1745135446297,AWP 10R,011,886184,Staff,0,0,0,0
1745135446297,AWP 10R,012,886185,Staff,0,0,0,0
1745135446297,AWP 10R,013,886186,Staff,0,0,0,0
1745135446297,AWP 10R,014,886187,Staff,0,0,0,0
1745135446297,AWP 10R,015,886188,Staff,0,0,0,0
1745135446297,AWP 10R,016,886189,Staff,0,0,0,0
1745135447327,AWP 102R,A00,886190,Staff,0,0,0,0
1745135447327,AWP 102R,B00,886191,Staff,0,0,0,0
1745135448355,BENG 100,A01,886193,Staff,19,0,30,11
1745135449379,BENG 122A,A01,886195,Hasty; Jeff M,20,0,30,10
1745135450409,BENG 166A,A00,886196,Sah; Robert Lie-Yuan,0,3,20,20
1745135451439,BIBC 102,A01,894320,Staff,0,2,46,46
1745135451439,BIBC 102,A02,894321,Staff,0,0,46,46
1745135451439,BIBC 102,A03,894344,Staff,21,0,46,25
1745135451439,BIBC 102,A04,894345,Staff,30,0,47,17
1745135452467,BICD 100R,A01,894365,Smith; Laurie,1,3,58,57
1745135452467,BICD 100R,A02,894366,Smith; Laurie,0,1,58,58
1745135452467,BICD 100R,A03,894367,Smith; Laurie,13,0,59,46
1745135453496,BICD 136,A01,894383,Gustafson-Brown; Cindy,16,0,50,34
1745135454529,BIEB 102,A01,894494,Butler; Shannon Rhey,67,0,130,63
1745135456591,BIEB 150,A01,894617,Wills; Christopher,0,3,13,13
1745135456591,BIEB 150,A02,894631,Wills; Christopher,0,3,13,13
1745135456591,BIEB 150,A03,894937,Wills; Christopher,0,3,13,13
1745135456591,BIEB 150,A04,894946,Wills; Christopher,0,1,11,11
1745135457619,BIEB 194,A00,906141,Kurle; Carolyn M.,14,0,20,6
1745135458648,BILD 1,A01,894154,Staff,8,0,19,11
1745135458648,BILD 1,A02,894155,Staff,15,0,19,4
1745135458648,BILD 1,A03,894160,Staff,18,0,19,1
1745135458648,BILD 1,A04,894161,Staff,16,0,18,2
1745135459674,BILD 2,A01,894168,Staff,0,0,50,50
1745135459674,BILD 2,A02,894169,Staff,0,0,50,50
1745135459674,BILD 2,A03,894179,Staff,27,0,50,23
1745135459674,BILD 2,A04,894203,Staff,42,0,50,8
1745135460705,BILD 3,A01,894213,Staff,24,0,31,7
1745135460705,BILD 3,A02,894214,Staff,28,0,31,3
1745135460705,BILD 3,A03,894235,Staff,30,0,31,1
1745135460705,BILD 3,A04,894236,Staff,29,0,32,3
1745135461732,BILD 4,A01,894253,Reuther; Keefe,12,0,24,12
1745135461732,BILD 4,A02,894258,Reuther; Keefe,19,0,24,5
1745135462762,BILD 5,A01,894276,Reuther; Keefe,40,0,50,10
1745135462762,BILD 5,A02,894277,Reuther; Keefe,48,0,50,2
1745135462762,BILD 5,A03,894290,Reuther; Keefe,47,0,50,3
1745135462762,BILD 5,A04,894291,Reuther; Keefe,50,0,50,0
1745135463791,BILD 24,A01,894297,Pirino; Giorgia,46,0,60,14
1745135464819,BIMM 100,A01,895012,Staff,0,14,0,1
1745135464819,BIMM 100,A02,895013,Staff,0,6,0,2
1745135464819,BIMM 100,A03,895014,Staff,0,7,0,0
1745135464819,BIMM 100,A04,895015,Staff,0,4,0,0
1745135465846,BIMM 101,A01,895017,McDonnell; Lisa Marie,0,2,24,24
1745135465846,BIMM 101,A02,895018,McDonnell; Lisa Marie,0,1,24,24
1745135465846,BIMM 101,B01,895020,McDonnell; Lisa Marie,0,3,24,24
1745135465846,BIMM 101,B02,895021,McDonnell; Lisa Marie,0,2,24,24
1745135466875,BIMM 110,A01,895023,Staff,7,0,25,18
1745135466875,BIMM 110,A02,895024,Staff,11,0,25,14
1745135466875,BIMM 110,A03,895025,Staff,22,0,25,3
1745135466875,BIMM 110,A04,895031,Staff,21,0,25,4
1745135467908,BIMM 120,A01,895114,Gustafson-Brown; Cindy,8,0,28,20
1745135467908,BIMM 120,A02,895126,Gustafson-Brown; Cindy,19,0,27,8
1745135468934,BIPN 100,A01,895130,Yang; Mingyu,13,0,38,25
1745135468934,BIPN 100,A02,895131,Yang; Mingyu,33,0,38,5
1745135468934,BIPN 100,A03,895132,Yang; Mingyu,33,0,38,5
1745135468934,BIPN 100,A04,895133,Yang; Mingyu,30,0,36,6
1745135469961,BIPN 120,A01,895135,Cooke; James Edward,0,3,13,13
1745135469961,BIPN 120,A02,895136,Cooke; James Edward,0,1,13,13
1745135469961,BIPN 120,A03,895137,Cooke; James Edward,0,0,13,13
1745135469961,BIPN 120,A04,895156,Cooke; James Edward,4,0,11,7
1745135470987,BIPN 134,A01,895235,Cooke; James Edward,0,3,25,25
1745135470987,BIPN 134,A02,895237,Cooke; James Edward,0,0,25,25
1745135470987,BIPN 134,A03,895240,Cooke; James Edward,13,0,25,12
1745135470987,BIPN 134,A04,895270,Cooke; James Edward,24,0,25,1
1745135472017,BIPN 189,A00,892103,Staff,0,20,9,9
1745135474070,CAT 124,A01,922009,Staff,0,1,20,20
1745135475101,CAT 125R,A00,886390,Morales; Celeste Georgianna,4,0,20,16
1745135475101,CAT 125R,B00,886391,Irwin; Matthew Joseph,0,1,20,20
1745135475101,CAT 125R,C00,886392,Smith; Lauryn Alissa,11,0,20,9
1745135475101,CAT 125R,D00,886393,Vanderschuit; Maya Alysia,6,0,20,14
1745135475101,CAT 125R,E00,886394,Marchisotto; Jennifer Anne,0,2,20,20
1745135476129,CENG 15,A01,886218,Drews; Aaron,1,0,5,4
1745135477156,CENG 113,A00,886219,Opatkiewicz; Justin Paul,16,0,25,9
1745135478184,CGS 101,A00,887044,Staff,13,0,20,7
1745135479213,CGS 105,A01,887046,Staff,16,0,25,9
1745135480245,CGS 112,A00,887047,Cuong; Marisol,12,0,15,3
1745135481270,CGS 113,A00,887048,Staff,24,0,30,6
1745135482296,CGS 120,A00,887049,Staff,12,0,17,5
1745135483329,CHEM 6A,A01,886336,Lam; Tin Yiu,44,0,50,6
1745135483329,CHEM 6A,A02,886338,Lam; Tin Yiu,43,0,50,7
1745135484362,CHEM 6B,A01,886341,Hopkins; Patrycja Anna,21,0,50,29
1745135484362,CHEM 6B,A02,886343,Hopkins; Patrycja Anna,46,0,50,4
1745135485387,CHEM 6C,A01,886346,Albizati; Kim F.,0,1,50,50
1745135485387,CHEM 6C,A02,886348,Albizati; Kim F.,38,0,50,12
1745135486418,CHEM 40A,A01,886352,Klosterman; Jeremy K,70,0,100,30
1745135487446,CHEM 40B,A01,886356,Klosterman; Jeremy K,0,4,100,100
1745135488473,CHEM 41B,A01,886360,Theodorakis; Emmanuel,30,0,50,20
1745135488473,CHEM 41B,A02,886362,Theodorakis; Emmanuel,46,0,50,4
1745135489502,CHIN 165A,A00,886382,Xu; Li,19,0,20,1
1745135490530,CLAS 120,A00,886387,Myerston Santana; Jacobo,36,0,40,4
1745135491560,COGS 9,A01,886967,Shannon; Kyle Michael,49,0,60,11
1745135492586,COGS 11,A01,886969,Staff,18,0,30,12
1745135493613,COGS 14A,A01,886971,Staff,26,0,60,34
1745135494640,COGS 14B,A01,886973,Hoffman; Drew Ellen,18,0,60,42
1745135495671,COGS 18,A01,886975,Morgan; Eric,41,0,60,19
1745135496697,COGS 20,A01,886977,Staff,6,0,8,2
1745135496697,COGS 20,A02,886978,Staff,6,0,7,1
1745135497723,COGS 100,A01,907783,Staff,6,0,30,24
1745135498755,COGS 101B,A01,886980,Staff,0,10,30,30
1745135499782,COGS 101C,A01,886982,Delgado; Tania,0,6,30,30
1745135500815,COGS 102A,A01,886984,Johnson; Christine M.,13,0,30,17
1745135501842,COGS 118B,A01,886986,Staff,0,25,60,60
1745135502872,COGS 150,A01,886988,Bergen; Benjamin,16,0,30,14
1745135503901,COGS 153,A00,886989,Delgado; Tania,0,6,30,30
1745135504927,COGS 186,A01,886991,Staff,3,0,30,27
1745135505954,COGS 187A,A01,886993,Boyle; Mary E. T.,12,0,30,18
1745135506985,COGS 189,A00,886994,Staff,13,0,30,17
1745135508009,COMM 10,A01,886996,Staff,11,0,25,14
1745135508009,COMM 10,A02,886997,Staff,21,0,25,4
1745135509040,COMM 20,A01,886999,Leuning; Grant Maurstad,33,0,40,7
1745135511091,COMM 100A,A01,887002,Staff,0,0,25,25
1745135511091,COMM 100A,A02,887003,Staff,20,0,25,5
1745135512118,COMM 100B,A01,887005,Staff,0,1,25,25
1745135513145,COMM 106D,A00,887006,Staff,22,0,40,18
1745135514170,COMM 110G,A00,887007,Whitworth-Smith; Andrew C,17,0,40,23
1745135515200,COMM 111B,A00,887008,Staff,31,0,40,9
1745135516225,COMM 113T,A00,887009,Abuelhiga; Soraya Jill,30,0,40,10
1745135516225,COMM 113T,B00,906733,Staff,40,0,40,0
1745135517250,COMM 145,A00,887010,Staff,21,0,40,19
1745135518280,COMM 146,A00,887054,Staff,31,0,40,9
1745135519307,COMM 190,A00,887012,Staff,9,0,23,14
1745135520334,CSE 8A,A50,887015,Cao; Yingjun,68,0,85,17
1745135522441,CSE 11,A01,887017,Cao; Yingjun,35,0,70,35
1745135523472,CSE 20,A01,887019,Staff,35,0,50,15
1745135524510,CSE 21,A01,887021,Braun; Oliver,81,0,100,19
1745135524510,CSE 21,B01,892583,Staff,48,0,50,2
1745135525542,CSE 30,A01,887025,Eldon; John,161,0,200,39
1745135526567,CSE 100,A01,887027,Staff,28,0,50,22
1745135526567,CSE 100,A02,887028,Staff,43,0,50,7
1745135527595,CSE 101,A01,887030,Braun; Oliver,79,0,100,21
1745135527595,CSE 101,B01,887032,Jones; Miles E,0,1,50,50
1745135527595,CSE 101,B02,887033,Jones; Miles E,13,0,50,37
1745135528624,CSE 105,A01,908084,Jones; Miles E,36,0,50,14
1745135528624,CSE 105,A02,908087,Jones; Miles E,38,0,50,12
1745135529652,CSE 135,A01,887035,Powell; Thomas Allan,8,0,50,42
1745135530681,CSE 142,A01,887037,Staff,22,0,60,38
1745135531706,CSE 142L,A01,887039,Staff,42,0,60,18
1745135532732,CSE 151A,A01,887041,Solares; Edwin A,60,0,100,40
1745135533759,CSE 175,A01,887043,Kumar; Rakesh,30,0,30,0
1745135534784,CSS 1,A01,886389,Staff,12,0,40,28
1745135535810,DSC 30,A01,908097,Liao; Soohyun Nam,54,0,75,21
1745135536836,DSC 40A,A01,908099,Shannon; Kyle Michael,37,0,50,13
1745135537863,DSC 40B,A01,908112,Staff,28,0,50,22
1745135538894,DSC 80,A01,908116,Staff,32,0,60,28
1745135539938,DSC 197,001,956863,Eldridge; Justin Matthew,9999,0,9999,0
1745135540963,ECE 5,A01,886400,Morris; Karcher William,3,0,6,3
1745135540963,ECE 5,A02,886401,Morris; Karcher William,5,0,6,1
1745135541989,ECE 148,A01,886403,Silberman; Jack,0,8,14,14
1745135543023,ECON 1,A01,887265,Crane; Meredith Helen,25,0,70,45
1745135543023,ECON 1,B01,887268,Staff,44,0,50,6
1745135544049,ECON 2,A01,887273,Crane; Meredith Helen,61,0,70,9
1745135545081,ECON 3,A01,887279,Rondina; Giacomo,44,0,70,26
1745135546106,ECON 4,A01,887282,Anderson; John Charles,0,1,10,10
1745135547136,ECON 5,A01,887285,Staff,39,0,45,6
1745135547136,ECON 5,B01,887292,Staff,43,0,45,2
1745135548168,ECON 100A,A01,887337,Newhouse; Herbert S,58,0,70,12
1745135548168,ECON 100A,B01,887349,Staff,45,0,50,5
1745135549194,ECON 100B,A01,887361,Du; Songzi,42,0,70,28
1745135550224,ECON 100C,A01,887445,Newhouse; Herbert S,61,0,70,9
1745135551249,ECON 105,A00,887488,Vespa; Emanuel Ignacio,24,0,35,11
1745135552274,ECON 109,A01,887506,Staff,29,0,35,6
1745135553303,ECON 110A,A01,887568,Alon; Titan Michael,1,0,35,34
1745135553303,ECON 110A,B01,907601,Alon; Titan Michael,27,0,35,8
1745135554330,ECON 110B,A01,887598,Levkoff; Steven B.,0,7,70,70
1745135555356,ECON 112,A00,887599,Rondina; Giacomo,20,0,35,15
1745135556388,ECON 120A,A01,887603,Dai; Yinlin,46,0,70,24
1745135557415,ECON 120C,A01,887608,Sun; Yixiao,0,0,35,35
1745135557415,ECON 120C,B01,887614,Sun; Yixiao,13,0,35,22
1745135558442,ECON 138,A00,887621,Bharadwaj; Prashant,0,18,20,20
1745135559468,ECON 171,A01,907666,Staff,27,0,35,8
1745135560501,ECON 175,A00,887626,Wu; Pak Yeung,27,0,35,8
1745135561529,ECON 190,A00,887640,Vespa; Emanuel Ignacio,26,0,35,9
1745135562560,EDS 25,A01,888197,Staff,0,0,0,0
1745135562560,EDS 25,A02,888209,Staff,0,0,0,0
1745135562560,EDS 25,A03,888210,Staff,0,0,0,0
1745135562560,EDS 25,A04,888212,Staff,0,0,0,0
1745135562560,EDS 25,A05,888213,Staff,0,0,0,0
1745135562560,EDS 25,A06,888214,Staff,0,0,0,0
1745135562560,EDS 25,A07,888235,Staff,0,0,0,0
1745135562560,EDS 25,A08,888236,Staff,0,0,0,0
1745135562560,EDS 25,A09,888240,Staff,0,0,0,0
1745135562560,EDS 25,A10,888244,Staff,0,0,0,0
1745135562560,EDS 25,B01,888273,Staff,0,0,0,0
1745135562560,EDS 25,B02,888285,Staff,0,0,0,0
1745135562560,EDS 25,B03,888423,Staff,29,0,30,1
1745135562560,EDS 25,B04,888432,Staff,0,0,0,0
1745135562560,EDS 25,B05,888433,Staff,0,0,0,0
1745135562560,EDS 25,B06,888467,Staff,0,0,0,0
1745135562560,EDS 25,B07,888468,Staff,0,0,0,0
1745135562560,EDS 25,B08,888479,Staff,0,0,0,0
1745135562560,EDS 25,B09,888484,Staff,0,0,0,0
1745135562560,EDS 25,B10,888487,Staff,0,0,0,0
1745135563587,EDS 38,A01,907700,Choi; Bailey Miyeon,30,0,30,0
1745135564615,EDS 112,A01,888601,Chapman; Thandeka K,23,0,40,17
1745135565653,EDS 115,A00,888697,Mendez; Kathrina Mendoza,17,0,30,13
1745135566684,EDS 116,A01,888893,Staff,38,0,40,2
1745135568735,EDS 124AR,A00,889133,Staff,33,0,50,17
1745135568735,EDS 124AR,B00,907471,Simon; Elizabeth A,42,0,50,8
1745135569759,EDS 124BR,A00,889134,Staff,57,0,100,43
1745135570786,EDS 125,A00,889135,Staff,26,0,30,4
1745135571812,EDS 126,A01,889138,Staff,37,0,40,3
1745135572839,EDS 164R,A01,889142,Wishard Guerra; Alison G.,38,0,50,12
1745135573864,ENG 30,A01,886396,Staff,0,0,0,0
1745135573864,ENG 30,B01,886398,Staff,0,0,0,0
1745135574890,ENVR 102,A00,906150,Montejo; Carolina,23,0,25,2
1745135575916,ETHN 103A,A00,887236,Man; Simeon S,0,5,0,0
1745135576942,ETHN 113,A00,887239,Staff,20,0,30,10
1745135577968,ETHN 116,A00,887240,Staff,20,0,25,5
1745135579023,ETHN 117,A00,887241,Choi; Esther Min,27,0,30,3
1745135580049,ETHN 118,A00,887243,Staff,24,0,30,6
1745135581076,ETHN 127,A00,887248,Cuong; Marisol,12,0,15,3
1745135582107,ETHN 139,A00,887250,Staff,8,0,10,2
1745135583132,ETHN 142,A00,887252,Staff,18,0,30,12
1745135584158,ETHN 161,A00,887253,Browne; Errol Tsekani,28,0,30,2
1745135585188,ETHN 163FR,A00,887255,Burelle; Julie Sara Veronique,4,0,5,1
1745135586221,GLBH 20,A00,889149,Elwardani; Nile Regina,15,0,42,27
1745135588276,GLBH 111,A01,889152,Burgos; Jose L.,17,0,17,0
1745135589303,GLBH 150,A00,889181,Sloane; Julia Kathryn,0,1,15,15
1745135591361,HDS 60,A01,886406,Warstadt; Melissa Fawn,76,0,80,4
1745135592389,HIAF 111,A00,889324,Gyamfi; Bright,0,4,0,0
1745135593416,HIEA 131,A00,889328,Staff,14,0,32,18
1745135594446,HIEA 144,A00,889333,Henry; Todd A.,29,0,32,3
1745135595475,HIEA 154,A00,889336,Henry; Todd A.,28,0,32,4
1745135596498,HIEU 106,A00,889339,Staff,28,0,32,4
1745135598552,HIEU 114,A00,889340,Staff,18,0,32,14
1745135599580,HIEU 135GS,A00,889342,Patterson; Patrick H.,0,0,1,22
1745135600605,HIEU 137,A00,889343,Edington; Claire Ellen,12,0,25,13
1745135601633,HIEU 148,A00,889345,Staff,16,0,32,16
1745135602661,HIEU 154,A00,889346,Biess; Frank Peter,24,0,32,8
1745135603689,HILA 102,A00,889351,Staff,13,0,32,19
1745135604716,HILD 2A,A01,889221,Lewandoski; Julia Mavis,0,5,32,32
1745135605744,HILD 7B,A01,889225,Man; Simeon S,0,7,32,32
1745135606776,HILD 7C,A01,889288,Alvarez; Luis A,0,7,32,32
1745135607801,HILD 30,A01,889323,Staff,0,1,32,32
1745135609860,HISC 119,A00,889383,Golan; Tal,22,0,32,10
1745135610893,HIUS 103,A00,889384,Man; Simeon S,10,0,32,22
1745135611947,HIUS 117,A00,919797,Kwak; Nancy,23,0,32,9
1745135612972,HIUS 142A,A00,919788,Staff,24,0,32,8
1745135615025,HIUS 149,A00,889386,Gyamfi; Bright,0,1,0,0
1745135616052,HIUS 155,A00,889387,Alvarez; Luis A,19,0,32,13
1745135617079,HUM 3,A01,886499,Caldwell; Michael Alan,24,0,50,26
1745135618110,HUM 3GS,A00,886500,Rodriguez; Bretton Sigfred,0,0,0,26
1745135619135,HUM 3R,A01,886502,Markman; Kristina,0,32,50,50
1745135620169,HUM 4,A01,886504,Crum; Matthew Stephen,28,0,50,22
1745135620169,HUM 4,B01,886506,West; Geoffrey Scott,25,0,50,25
1745135621197,HUM 4GS,A00,886507,Staff,0,0,0,13
1745135622226,HUM 5,A01,886509,Staff,35,0,50,15
1745135623251,HUM 5R,A01,886511,Zavodny; Tatiana Sophia,0,32,50,50
1745135624276,JAPN 180,A00,886407,Staff,25,0,40,15
1745135625308,LATI 50,A01,886409,Martin-Cabrera; Luis,9,0,22,13
1745135625308,LATI 50,A02,886410,Martin-Cabrera; Luis,21,0,22,1
1745135625308,LATI 50,A03,886411,Martin-Cabrera; Luis,22,0,22,0
1745135625308,LATI 50,A04,886412,Martin-Cabrera; Luis,16,0,22,6
1745135626338,LAWS 101,A00,907664,Staff,36,0,60,24
1745135627364,LIAB 1A,A00,889388,Saab; Dima,19,0,20,1
1745135628390,LIAB 1AX,A00,889389,El Cheddadi; Youniss,19,0,20,1
1745135629417,LIFR 1C,A00,889391,Van Moer; Vinciane G,9,0,20,11
1745135630443,LIFR 1CX,A00,889392,Van Moer; Vinciane G,8,0,20,12
1745135631470,LIFR 1D,A00,889393,Van Moer; Vinciane G,11,0,20,9
1745135632496,LIFR 1DX,A00,889394,Van Moer; Vinciane G,11,0,20,9
1745135633522,LIGN 7,A00,886923,Staff,30,0,50,20
1745135634554,LIGN 17,A00,886924,Kehler; Andrew Scott,133,0,150,17
1745135635585,LTAM 110,A00,889395,Staff,17,0,30,13
1745135636612,LTCH 101,A00,889397,Staff,22,0,25,3
1745135637639,LTCS 130,A00,889398,Staff,23,0,25,2
1745135638670,LTEA 138,A00,889399,Staff,25,0,40,15
1745135639700,LTEN 149,A00,889400,Wesling; Megan E.,6,0,25,19
1745135640728,LTEN 169,A00,889401,Staff,24,0,25,1
1745135641755,LTEN 180,A00,889402,Staff,12,0,15,3
1745135642865,LTEN 181,A00,889403,Staff,23,0,25,2
1745135643894,LTWL 100,A00,889404,Myerston Santana; Jacobo,8,0,25,17
1745135644922,LTWL 180GS,A00,889405,Staff,6,0,20,14
1745135645950,LTWL 181,A00,889406,Staff,19,0,25,6
1745135646982,LTWL 184,A00,889475,Mukherjee; Silpa,21,0,25,4
1745135648016,LTWR 102C,A00,889486,Staff,29,0,30,1
1745135649041,LTWR 115W,A00,889491,Staff,3,0,15,12
1745135650067,MAE 8,A01,886905,Staff,0,2,0,0
1745135651094,MAE 11,A00,886906,Bandaru; Prabhakar,0,0,50,50
1745135652122,MAE 20,A00,886907,Evdokimenko; Ekaterina,50,0,70,20
1745135653150,MAE 30B,A00,886909,Ghazinejad; Maziar,28,0,45,17
1745135654178,MAE 101B,A00,886910,Saintillan; David,36,0,45,9
1745135655208,MAE 105,A00,886911,Bandaru; Prabhakar,26,0,50,24
1745135656235,MAE 107,A00,886912,Staff,22,0,60,38
1745135657260,MAE 143B,A00,886913,Bewley; Thomas R,14,0,40,26
1745135658295,MAE 148,A01,886915,Silberman; Jack,5,0,14,9
1745135659320,MAE 160,A00,886916,Evdokimenko; Ekaterina,41,0,60,19
1745135660346,MATH 3C,A01,889681,Staff,2,0,30,28
1745135661372,MATH 10A,A01,889760,Staff,28,0,30,2
1745135661372,MATH 10A,A02,889783,Staff,30,0,30,0
1745135662400,MATH 10B,A01,889785,Verstraete; Jacques Allan,0,2,30,30
1745135662400,MATH 10B,A02,889795,Verstraete; Jacques Allan,0,2,30,30
1745135662400,MATH 10B,B01,889797,Verstraete; Jacques Allan,1,0,30,29
1745135662400,MATH 10B,B02,889828,Verstraete; Jacques Allan,23,0,30,7
1745135663430,MATH 10C,A01,889849,Habib; Yousaf,18,0,30,12
1745135663430,MATH 10C,A02,889852,Habib; Yousaf,20,0,30,10
1745135663430,MATH 10C,A03,889853,Habib; Yousaf,25,0,30,5
1745135663430,MATH 10C,A04,889858,Habib; Yousaf,21,0,30,9
1745135663430,MATH 10C,B01,889861,Staff,12,0,30,18
1745135663430,MATH 10C,B02,889862,Staff,26,0,30,4
1745135663430,MATH 10C,B03,889863,Staff,28,0,30,2
1745135663430,MATH 10C,B04,889967,Staff,25,0,30,5
1745135664458,MATH 18,A01,889974,Staff,15,0,30,15
1745135664458,MATH 18,A02,889977,Staff,25,0,30,5
1745135664458,MATH 18,B01,889984,Hardiman; Liam,26,0,30,4
1745135664458,MATH 18,B02,889985,Hardiman; Liam,28,0,30,2
1745135665489,MATH 20A,A01,889990,Suk; Andrew Hoon,31,0,35,4
1745135666518,MATH 20B,A01,889993,Ohm; Ko Woon,21,0,30,9
1745135666518,MATH 20B,A02,889994,Ohm; Ko Woon,30,0,30,0
1745135666518,MATH 20B,B01,889996,Ohm; Ko Woon,25,0,30,5
1745135666518,MATH 20B,B02,889997,Ohm; Ko Woon,24,0,30,6
1745135667547,MATH 20C,A01,889999,Hammock; Frances H,22,0,30,8
1745135667547,MATH 20C,A02,890003,Hammock; Frances H,23,0,30,7
1745135667547,MATH 20C,B01,890006,Hammock; Frances H,11,0,30,19
1745135667547,MATH 20C,B02,890007,Hammock; Frances H,18,0,30,12
1745135668576,MATH 20D,A01,890011,Cheng; Hsiao-Bing,6,0,30,24
1745135668576,MATH 20D,A02,890012,Cheng; Hsiao-Bing,27,0,30,3
1745135668576,MATH 20D,B01,890016,Cheng; Hsiao-Bing,19,0,30,11
1745135668576,MATH 20D,B02,890017,Cheng; Hsiao-Bing,15,0,30,15
1745135669605,MATH 20E,A01,890026,Harel; Guershon,10,0,30,20
1745135669605,MATH 20E,A02,890029,Harel; Guershon,24,0,30,6
1745135669605,MATH 20E,B01,890033,Harel; Guershon,14,0,30,16
1745135669605,MATH 20E,B02,890101,Harel; Guershon,27,0,30,3
1745135670631,MATH 102,A01,890104,Staff,20,0,30,10
1745135670631,MATH 102,A02,890105,Staff,30,0,30,0
1745135671656,MATH 103B,A01,890116,Salehi Golsefidy; Alireza,8,0,30,22
1745135671656,MATH 103B,B01,890118,Staff,0,4,30,30
1745135672684,MATH 109,A01,890121,Aliabadi Sr.; Mohsen,6,0,30,24
1745135672684,MATH 109,B01,890124,Upadrashta; Pranav Kumar,23,0,30,7
1745135673712,MATH 120A,A01,890126,Eggers; John Dietrich,15,0,30,15
1745135674740,MATH 142B,A01,890128,Ioana; Adrian,17,0,30,13
1745135674740,MATH 142B,A02,890129,Ioana; Adrian,15,0,30,15
1745135675767,MATH 154,A01,890174,Staff,0,1,30,30
1745135675767,MATH 154,A02,890182,Staff,15,0,30,15
1745135676796,MATH 168A,A01,890197,Dumitriu; Ioana,22,0,35,13
1745135677824,MATH 170A,A01,890240,Nie; Jiawang,6,0,30,24
1745135677824,MATH 170A,A02,890241,Nie; Jiawang,18,0,30,12
1745135677824,MATH 170A,A03,890249,Nie; Jiawang,23,0,30,7
1745135678852,MATH 170B,A01,957891,Nag; Panchali,25,0,35,10
1745135680909,MATH 181A,A01,908025,Staff,0,8,35,35
1745135681939,MATH 193B,A01,890265,Staff,3,0,35,32
1745135682971,MGT 4,A01,890311,Anderson; John Charles,57,0,88,31
1745135683996,MGT 5,A00,907740,Staff,41,0,98,57
1745135685053,MGT 12,A00,890312,Lindenberger; Wade Douglas,70,0,98,28
1745135686083,MGT 16,A00,957883,Staff,84,0,98,14
1745135688139,MGT 45,A00,890314,Pecore; Joseph P.,57,0,98,41
1745135689166,MGT 71,A00,890315,Staff,6,0,98,92
1745135690194,MGT 100,A00,890316,Yavorsky; Daniel Ryan,59,0,98,39
1745135691219,MGT 103,A00,890317,Ehrich; Kristine R,77,0,98,21
1745135692247,MGT 105,A00,890356,Bates; Kenneth Walter,19,0,98,79
1745135693276,MGT 112,A00,890360,Ehrich; Kristine R,65,0,98,33
1745135694306,MGT 127R,A00,907732,Zhu; Kevin Xiaoguo,32,0,98,66
1745135695337,MGT 131B,A00,890361,Anderson; John Charles,75,0,98,23
1745135696365,MGT 137,A00,890362,Lindenberger; Wade Douglas,68,0,98,30
1745135697396,MGT 160,A00,890369,Johnson; Erik Barry,37,0,98,61
1745135699457,MGT 164,A00,890372,Zimmermann; Carsten,0,28,98,98
1745135700483,MGT 180,A00,890374,Bliss; Barbara Ann,32,0,98,66
1745135701516,MMW 15,A01,886414,Chang; Edmond Yi-Teh,0,10,28,28
1745135701516,MMW 15,A02,886415,Chang; Edmond Yi-Teh,0,10,28,28
1745135701516,MMW 15,A03,886416,Chang; Edmond Yi-Teh,0,8,28,28
1745135701516,MMW 15,A04,886417,Chang; Edmond Yi-Teh,0,8,28,28
1745135701516,MMW 15,B01,886419,Chang; Edmond Yi-Teh,0,8,28,28
1745135701516,MMW 15,B02,886420,Chang; Edmond Yi-Teh,0,9,28,28
1745135701516,MMW 15,B03,886421,Chang; Edmond Yi-Teh,0,9,28,28
1745135701516,MMW 15,B04,886422,Chang; Edmond Yi-Teh,0,9,28,28
1745135701516,MMW 15,C01,886424,Staff,0,10,28,28
1745135701516,MMW 15,C02,886425,Staff,0,10,28,28
1745135701516,MMW 15,C03,886426,Staff,0,9,28,28
1745135701516,MMW 15,C04,886427,Staff,0,9,28,28
1745135702543,MMW 15GS,A00,906910,Patterson; Patrick H.,5,0,28,23
1745135703572,MMW 122R,A01,886429,Rahimi; Babak,0,23,28,28
1745135703572,MMW 122R,A02,886430,Rahimi; Babak,0,23,28,28
1745135704601,MUS 1A,A01,890937,Staff,8,0,25,17
1745135704601,MUS 1A,A02,891035,Staff,15,0,25,10
1745135704601,MUS 1A,B00,907849,Staff,48,0,50,2
1745135704601,MUS 1A,B01,907850,Staff,25,0,25,0
1745135704601,MUS 1A,B02,907851,Staff,25,0,25,0
1745135706661,MUS 2AK,A00,957092,Ohnishi; Takae,15,0,15,0
1745135707691,MUS 4,A01,891044,Staff,6,0,25,19
1745135707691,MUS 4,A02,891045,Staff,24,0,25,1
1745135707691,MUS 4,B01,891048,Staff,20,0,25,5
1745135707691,MUS 4,B02,891050,Staff,25,0,25,0
1745135708720,MUS 5,A01,957506,Dubnov; Shlomo,4,0,25,21
1745135708720,MUS 5,A02,957622,Dubnov; Shlomo,21,0,25,4
1745135708720,MUS 5,A03,957623,Dubnov; Shlomo,23,0,25,2
1745135709747,MUS 6,A01,891053,Freitas Caetano; Marcelo,23,0,25,2
1745135709747,MUS 6,A02,891054,Freitas Caetano; Marcelo,23,0,25,2
1745135710778,MUS 7,A01,891081,Staff,0,0,25,25
1745135710778,MUS 7,A02,891082,Staff,15,0,25,10
1745135711807,MUS 8GS,A00,891118,Borgo; David Garcia,5,0,25,20
1745135712837,MUS 11,A01,891140,Staff,12,0,25,13
1745135712837,MUS 11,A02,891141,Staff,24,0,25,1
1745135713867,MUS 13,A01,891143,Staff,10,0,25,15
1745135713867,MUS 13,A02,891144,Staff,25,0,25,0
1745135714896,MUS 15,A01,891146,Staff,7,0,25,18
1745135714896,MUS 15,A02,891148,Staff,22,0,25,3
1745135714896,MUS 15,B01,891150,Staff,18,0,25,7
1745135714896,MUS 15,B02,891151,Staff,25,0,25,0
1745135715922,MUS 20,A01,891153,Staff,9,0,20,11
1745135715922,MUS 20,A02,891155,Staff,16,0,20,4
1745135716952,MUS 80,A00,891156,Staff,19,0,25,6
1745135716952,MUS 80,B00,891157,Staff,25,0,25,0
1745135717978,MUS 130,A00,891158,Ohnishi; Takae,35,0,35,0
1745135719003,MUS 150GS,A01,891160,Borgo; David Garcia,5,0,25,20
1745135720031,MUS 170,A01,891162,Freitas Caetano; Marcelo,21,0,25,4
1745135720031,MUS 170,A02,891164,Freitas Caetano; Marcelo,22,0,25,3
1745135721064,NANO 11,A00,886220,Vazquez Mena; Oscar,12,0,15,3
1745135722091,NANO 15,A01,886222,Drews; Aaron,9,0,10,1
1745135723118,NANO 104,A00,886224,Sirbuly; Donald,18,0,25,7
1745135724141,PH 40,A00,886528,Staff,29,0,40,11
1745135725168,PH 45,A01,886799,Staff,36,0,40,4
1745135726194,PH 110,A00,886802,Staff,7,0,40,33
1745135727223,PH 172,A00,906716,Staff,20,0,35,15
1745135728250,PH 191,A00,886803,Staff,23,0,40,17
1745135729279,PHIL 1,A00,889500,Staff,22,0,30,8
1745135730308,PHIL 10,A01,889549,Grush; Rick Scott,17,0,22,5
1745135730308,PHIL 10,A02,889551,Grush; Rick Scott,20,0,22,2
1745135731336,PHIL 28,A01,889559,Lamey; Andy M.,0,4,25,25
1745135731336,PHIL 28,A02,889561,Lamey; Andy M.,0,0,25,25
1745135731336,PHIL 28,A03,889572,Lamey; Andy M.,7,0,25,18
1745135732362,PHIL 35,A00,907839,Staff,32,0,33,1
1745135733406,PHIL 60,A00,889574,Staff,79,0,90,11
1745135734431,PHIL 105,A00,889579,Staff,0,1,0,0
1745135735459,PHIL 136,A00,889582,Fulkerson; Matthew Todd,27,0,45,18
1745135736489,PHIL 163,A01,889601,Staff,24,0,30,6
1745135736489,PHIL 163,B01,889606,Brandt; Reuven A,0,2,0,0
1745135737516,PHIL 164,A00,889610,Staff,20,0,30,10
1745135738543,PHIL 165,A00,889613,Staff,26,0,30,4
1745135739569,PHYS 1A,A00,886431,Staff,38,0,70,32
1745135740599,PHYS 1AL,001,886432,Tsai; Philbert S,0,0,30,30
1745135740599,PHYS 1AL,002,886436,Tsai; Philbert S,19,0,30,11
1745135741624,PHYS 1B,A00,886439,Staff,192,0,240,48
1745135742653,PHYS 1BL,001,886441,Tsai; Philbert S,0,1,30,30
1745135742653,PHYS 1BL,002,886444,Tsai; Philbert S,14,0,30,16
1745135743680,PHYS 1C,A00,896092,Arnold; Kam S,87,0,146,59
1745135744708,PHYS 1CL,001,886448,Tsai; Philbert S,0,4,30,30
1745135744708,PHYS 1CL,002,886449,Tsai; Philbert S,6,0,30,24
1745135744708,PHYS 1CL,003,886450,Tsai; Philbert S,22,0,30,8
1745135744708,PHYS 1CL,004,886451,Tsai; Philbert S,16,0,30,14
1745135745736,PHYS 2B,A01,886457,Staff,86,0,115,29
1745135746765,PHYS 2C,A01,886460,Shotwell; Brian,0,0,65,65
1745135747790,PHYS 2CL,A01,886467,Staff,0,3,28,28
1745135747790,PHYS 2CL,A02,886468,Staff,5,0,28,23
1745135748820,PHYS 2D,A01,886470,Staff,17,0,50,33
1745135749851,PHYS 4B,A01,886475,Grinstein; Benjamin,88,0,100,12
1745135750877,POLI 5,A00,891173,Desposato; Scott,17,0,25,8
1745135751907,POLI 5D,A01,891175,Staff,5,0,5,0
1745135751907,POLI 5D,B01,891178,Staff,5,0,5,0
1745135752933,POLI 11,A00,891179,Ferree; Karen E,3,0,25,22
1745135753963,POLI 12,A00,891180,Staff,21,0,30,9
1745135754988,POLI 27,A01,891182,Staff,29,0,75,46
1745135756015,POLI 30,A00,891183,Staff,0,3,30,30
1745135757066,POLI 100B,A00,891244,Staff,0,8,20,20
1745135758091,POLI 100I,A00,891247,Staff,19,0,30,11
1745135759121,POLI 104J,A00,891248,Nichter; Maysa,18,0,30,12
1745135760145,POLI 104U,A00,891250,Nichter; Maysa,9,0,30,21
1745135761173,POLI 108,A00,891253,Staff,0,0,0,4
1745135762202,POLI 110B,A00,891255,Wiens; David,22,0,25,3
1745135763227,POLI 112A,A00,891256,Wiens; David,15,0,25,10
1745135764254,POLI 114BR,A00,891261,Staff,22,0,30,8
1745135765279,POLI 117R,A00,891262,Forman; Fonna,12,0,50,38
1745135766303,POLI 118,A00,891264,Ingham; Sean,22,0,25,3
1745135767332,POLI 124A,A00,891265,Staff,19,0,20,1
1745135768357,POLI 125D,A00,891266,Nichter; Simeon C,9,0,25,16
1745135769383,POLI 126,A00,891268,Nichter; Simeon C,11,0,25,14
1745135770409,POLI 126AA,A00,891272,Staff,19,0,25,6
1745135771433,POLI 130AA,A00,891273,Staff,17,0,20,3
1745135772459,POLI 134AA,A00,891274,Staff,12,0,20,8
1745135774510,POLI 138,A00,891278,Staff,22,0,25,3
1745135775535,POLI 142K,A00,891280,Staff,17,0,25,8
1745135776563,POLI 142M,A00,891281,Gartzke; Erik,22,0,30,8
1745135777589,POLI 142P,A00,891284,Staff,21,0,30,9
1745135778634,POLI 143,A00,891285,Gartzke; Erik,17,0,30,13
1745135779661,POLI 153,A00,891286,Staff,20,0,20,0
1745135780687,POLI 170A,A00,891288,Staff,19,0,25,6
1745135781716,POLI 175,A00,891290,Staff,18,0,20,2
1745135782742,PSYC 1,A00,890674,Steiner; Eric Tomas,0,4,45,45
1745135783767,PSYC 2,A00,890676,Albright; Thomas D,25,0,35,10
1745135784794,PSYC 3,A00,890679,Staff,18,0,20,2
1745135785819,PSYC 60,A01,890684,Rickard; Timothy C.,7,0,45,38
1745135786846,PSYC 70,A01,890689,Geller; Emma Harlan,14,0,30,16
1745135787871,PSYC 100,A00,890690,Lacefield; Katharine I,0,43,180,180
1745135788895,PSYC 102,A00,890695,Staff,26,0,40,14
1745135789921,PSYC 105,A00,890699,Geller; Emma Harlan,78,0,100,22
1745135790948,PSYC 106,A00,890701,Gorman; Michael R.,15,0,30,15
1745135791975,PSYC 108,A00,890704,Adrian; Julia Anna,0,23,50,50
1745135792999,PSYC 118,A01,890712,Staff,18,0,30,12
1745135794026,PSYC 124,A00,890716,Chapman; Eddie Nathaniel,36,0,60,24
1745135795054,PSYC 131,A00,890717,Anagnostaras; Stephan,6,0,80,74
1745135796083,PSYC 137,A00,890719,Winkielman; Piotr,0,2,30,30
1745135797107,PSYC 144,A00,890721,Adrian; Julia Anna,0,3,45,45
1745135798134,PSYC 162,A00,890805,Staff,21,0,75,54
1745135799163,PSYC 169,A00,890810,Staff,0,15,30,30
1745135800192,PSYC 172,A00,890814,Gorman; Michael R.,14,0,30,16
1745135801218,PSYC 181,A00,890818,Anagnostaras; Stephan,63,0,200,137
1745135802244,PSYC 189,A00,890823,Staff,11,0,30,19
1745135803269,PSYC 191,A00,890884,Rickard; Timothy C.,0,11,35,35
1745135804299,PSYC 193,A00,890913,Staff,22,0,30,8
1745135804299,PSYC 193,B00,890914,Chapman; Eddie Nathaniel,25,0,30,5
1745135805330,PSYC 193L,A01,890918,Lowe; Angela Beth,29,0,30,1
1745135805330,PSYC 193L,B01,890921,Hurwitz; Ethan Scott,28,0,30,2
1745135805330,PSYC 193L,C01,890928,Staff,30,0,30,0
1745135806356,RELI 149,A00,886806,Rahimi; Babak,23,0,40,17
1745135807383,SE 9,A01,886814,Staff,13,0,20,7
1745135808412,SE 101B,A01,886816,Chadha; Mayank,8,0,30,22
1745135809439,SE 110B,A00,886818,Zhu; Qiang,0,16,45,45
1745135810466,SE 125,A01,886830,Staff,10,0,30,20
1745135811493,SE 130B,A01,886835,Staff,19,0,40,21
1745135812521,SE 131A,A01,886838,Krysl; Petr,37,0,55,18
1745135813549,SE 154,A00,886840,Staff,35,0,50,15
1745135814575,SE 164GS,A01,886849,Staff,13,0,20,7
1745135815604,SE 167GS,A01,886853,Staff,13,0,20,7
1745135816630,SIO 25,A01,890107,Staff,23,0,30,7
1745135817656,SIO 45,A00,890109,Cook; Geoffrey W,137,0,200,63
1745135818685,SIO 109R,A00,890110,Forman; Fonna,0,11,20,20
1745135819713,SIO 187,A01,890114,Kacev; David,21,0,40,19
1745135820742,SOCI 1,A01,890431,Thorpe; Charles Robert,21,0,30,9
1745135820742,SOCI 1,A02,890518,Thorpe; Charles Robert,30,0,30,0
1745135821771,SOCI 2,A01,957978,Staff,0,0,0,0
1745135821771,SOCI 2,A02,957979,Staff,0,3,0,0
1745135822798,SOCI 20,A01,890523,Calderon-Zaks; Michael Aar,24,0,30,6
1745135822798,SOCI 20,A02,890526,Calderon-Zaks; Michael Aar,29,0,30,1
1745135823825,SOCI 30,A01,890533,Pardo Guerra; Juan Pablo,37,0,40,3
1745135824852,SOCI 40,A01,890535,Staff,32,0,45,13
1745135825879,SOCI 104Q,A00,890559,Staff,20,0,30,10
1745135826905,SOCI 106,A00,890560,Arnal; Maud Marie Leonie,22,0,30,8
1745135827931,SOCI 110,A00,890567,Holkenbrink-Monk; Charlene,22,0,30,8
1745135828957,SOCI 112,A00,890568,Victoria Torres; Pablo,0,0,45,45
1745135829985,SOCI 115,A00,890597,Arnal; Maud Marie Leonie,33,0,45,12
1745135832048,SOCI 121,A00,890604,Pardo Guerra; Juan Pablo,40,0,45,5
1745135833076,SOCI 126,A01,890608,Staff,8,0,10,2
1745135834104,SOCI 127,A00,890609,Staff,23,0,30,7
1745135835129,SOCI 131,A00,890610,Thorpe; Charles Robert,38,0,45,7
1745135836159,SOCI 135,A00,890615,Payne; Christine Anna,20,0,45,25
1745135837187,SOCI 139,A00,890620,Staff,43,0,45,2
1745135838213,SOCI 148E,A00,890622,Calderon-Zaks; Michael Aar,39,0,45,6
1745135839239,SOCI 150,A00,890623,Kohler; Kristopher M.,36,0,45,9
1745135840264,SOCI 157,A00,890625,Jules-Rosette; Bennetta W.,18,0,20,2
1745135841292,SOCI 160,A00,890627,Payne; Christine Anna,26,0,45,19
1745135842323,SYN 1,A00,886855,Fish; Gwendolyn Anne,0,0,0,0
1745135842323,SYN 1,B00,906086,Fish; Gwendolyn Anne,0,0,0,2
1745135843348,SYN 2R,A00,886860,Staff,0,15,15,15
1745135843348,SYN 2R,B00,906106,Atkinson; Arthur Laird,0,14,15,15
1745135844375,SYN 100,A01,886866,Browne; Emily,0,29,20,20
1745135844375,SYN 100,B01,906128,Rock; Martin,0,4,20,20
1745135844375,SYN 100,C01,906140,Deavenport; James Cary,0,2,20,20
1745135844375,SYN 100,D01,907816,Deavenport; James Cary,0,3,20,20
1745135845407,TDAC 1,A00,890286,Walsh; Kim C.,11,0,20,9
1745135846437,TDAC 101,A00,890296,Basso; Beatrice,18,0,20,2
1745135847465,TDDE 131,A00,890297,Staff,47,0,50,3
1745135848495,TDDM 1,A00,890287,Weinberg; Sadie,26,0,30,4
1745135849523,TDGE 11,A00,890288,Fulton; Julia,155,0,200,45
1745135849523,TDGE 11,B00,890289,Castro; Robert Jess,188,0,200,12
1745135850553,TDGE 25,B00,957359,Walsh; Kim C.,9,0,20,11
1745135851582,TDGE 40,A01,890292,Power; Jade Yukana,28,0,30,2
1745135852609,TDGE 124,A00,890298,Havis; Allan,12,0,50,38
1745135853642,TDGE 131R,A00,890299,Burelle; Julie Sara Veronique,20,0,42,22
1745135854669,TDHT 101,A00,890300,Staff,12,0,20,8
1745135855698,TDHT 109,A01,890302,Anderson; Mysia Anyse,31,0,40,9
1745135856727,TDMV 1,A00,890293,Arcidiacono; Kristin,20,0,30,10
1745135857755,TDMV 2,A00,890294,Weinberg; Sadie,26,0,30,4
1745135858782,TDMV 3,A00,957878,Arcidiacono; Kristin,27,0,30,3
1745135860840,TDMV 138,A00,890304,Jun; Grace Shin Hae,25,0,40,15
1745135861865,TDMV 140,A00,890305,Corrales; Joseph Bernales,28,0,30,2
1745135862891,TDMV 142,A00,890307,Caligagan; Tony,30,0,40,10
1745135863918,TDMV 144,A00,890308,Camaya; Michelle Ann,26,0,30,4
1745135864950,TDPW 1,A00,890295,Stein; Deborah Isobel,5,0,20,15
1745135865983,USP 2,A01,890272,Lerner; Amy M,8,0,20,12
1745135867010,USP 3,A01,890274,Staff,21,0,30,9
1745135868037,USP 15,A01,890276,Sun; Feiyang,21,0,30,9
1745135869064,USP 25,A00,890277,Shenkman; Michael Thomas,21,0,25,4
1745135870091,USP 138,A00,890278,Staff,15,0,25,10
1745135871117,USP 143,A00,890279,Staff,30,0,70,40
1745135872143,USP 144,A00,890280,Chowdhury; Muhammed Zohir,19,0,30,11
1745135873171,USP 150,A00,890281,Boomhower; Matthew Charles,19,0,30,11
1745135874200,USP 151,A00,890282,Staff,17,0,20,3
1745135875226,USP 162,A00,890283,Andrews; Abigail Leslie,17,0,20,3
1745135876253,USP 168,A00,920477,Kwak; Nancy,2,0,5,3
1745135877283,USP 181,A00,890284,Staff,11,0,20,9
1745135878309,USP 191A,A00,890285,Staff,15,0,20,5
1745135879337,VIS 101,A00,886512,Staff,37,0,75,38
1745135880369,VIS 103,A00,886513,Cruz; Edwin Teddy,65,0,75,10
1745135881397,VIS 108,A00,886514,Staff,7,0,15,8
1745135882423,VIS 127P,A00,886515,Shen; Kuiyi,92,0,146,54
1745135883451,VIS 149,A00,886516,Yoldas; Pinar,1,0,15,14
1745135884477,VIS 164,A00,886526,Erdmann; Dean,21,0,22,1
1745135885504,VIS 194S,A00,886527,Staff,61,0,75,14
1745135886537,WCWP 10A,C00,886484,Staff,13,0,15,2
1745135887563,WCWP 10B,A00,886490,Staff,5,0,15,10
1745135887563,WCWP 10B,B00,886491,Staff,0,1,0,0
1745135887563,WCWP 10B,C00,886492,Staff,10,0,15,5
1745135888594,WCWP 100,A00,886494,Staff,0,2,15,15
1745135890973,AAS 10,A01,886199,Childs; Dennis R.,0,2,0,0
1745135892003,ANAR 104,A01,886940,Shtienberg; Gilad,27,0,30,3
1745135893032,ANAR 120,A00,886953,Staff,13,0,20,7
1745135894057,ANBI 148,A01,886955,Wilder; Linnea Lorene,32,0,40,8
1745135896113,ANSC 122,A00,886957,Staff,28,0,30,2
1745135897141,ANSC 150,A00,886958,Sloane; Julia Kathryn,6,0,15,9
1745135898172,ANSC 156,A00,886959,Jenkins; Janis A.,2,0,15,13
1745135899199,ANSC 180,A00,886960,Staff,12,0,17,5
1745135900225,ANSC 188,A00,886961,Jassal; Aftab,10,0,25,15
1745135901249,ANSC 190,A00,886962,Jassal; Aftab,14,0,25,11
1745135902277,ANSC 191,A00,886963,Staff,18,0,20,2
1745135903304,ANTH 3,A01,891689,Staff,19,0,20,1
1745135904335,ANTH 5,A00,886933,Semendeferi; Ekaterini,18,0,20,2
1745135905366,ANTH 10,A00,886934,Staff,0,8,30,30
1745135906392,ANTH 21,A01,886936,Staff,44,0,60,16
1745135907421,ANTH 23,A01,886938,Staff,94,0,100,6
1745135908448,ANTH 105,A00,886964,Stewart; Alexander B,94,0,100,6
1745135909476,ANTH 108,A00,886965,Pedersen; David,10,0,20,10
1745135910506,AWP 10,001,886147,Staff,0,0,0,0
1745135910506,AWP 10,002,886148,Staff,0,0,0,0
1745135910506,AWP 10,003,886149,Staff,0,0,0,0
1745135910506,AWP 10,004,886150,Staff,0,0,0,0
1745135910506,AWP 10,005,886151,Staff,0,0,0,0
1745135910506,AWP 10,006,886152,Staff,0,0,0,0
1745135910506,AWP 10,007,886153,Staff,0,0,0,0
1745135910506,AWP 10,008,886154,Staff,0,0,0,0
1745135910506,AWP 10,009,886155,Staff,0,0,0,0
1745135910506,AWP 10,010,886156,Staff,0,0,0,0
1745135910506,AWP 10,011,886158,Staff,0,0,0,0
1745135910506,AWP 10,012,886160,Staff,0,0,0,0
1745135910506,AWP 10,013,886161,Staff,0,0,0,0
1745135910506,AWP 10,014,886162,Staff,0,0,0,0
1745135910506,AWP 10,015,886163,Staff,0,0,0,0
1745135910506,AWP 10,016,886164,Staff,0,0,0,0
1745135910506,AWP 10,017,886165,Staff,0,0,0,0
1745135910506,AWP 10,018,886166,Staff,0,0,0,0
1745135910506,AWP 10,019,886168,Staff,0,0,0,0
1745135910506,AWP 10,020,886170,Staff,0,0,0,0
1745135910506,AWP 10,021,886172,Staff,0,0,0,0
1745135911569,AWP 10R,001,886173,Staff,0,0,0,0
1745135911569,AWP 10R,002,886174,Staff,0,1,0,0
1745135911569,AWP 10R,003,886175,Staff,0,0,0,0
1745135911569,AWP 10R,004,886176,Staff,0,0,0,0
1745135911569,AWP 10R,005,886177,Staff,0,0,0,0
1745135911569,AWP 10R,006,886178,Staff,0,0,0,0
1745135911569,AWP 10R,007,886179,Staff,0,0,0,0
1745135911569,AWP 10R,008,886181,Staff,0,0,0,0
1745135911569,AWP 10R,009,886182,Staff,0,0,0,0
1745135911569,AWP 10R,010,886183,Staff,0,0,0,0
1745135911569,AWP 10R,011,886184,Staff,0,0,0,0
1745135911569,AWP 10R,012,886185,Staff,0,0,0,0
1745135911569,AWP 10R,013,886186,Staff,0,0,0,0
1745135911569,AWP 10R,014,886187,Staff,0,0,0,0
1745135911569,AWP 10R,015,886188,Staff,0,0,0,0
1745135911569,AWP 10R,016,886189,Staff,0,0,0,0
1745135912595,AWP 102R,A00,886190,Staff,0,0,0,0
1745135912595,AWP 102R,B00,886191,Staff,0,0,0,0
1745135913625,BENG 100,A01,886193,Staff,19,0,30,11
1745135914653,BENG 122A,A01,886195,Hasty; Jeff M,20,0,30,10
1745135915678,BENG 166A,A00,886196,Sah; Robert Lie-Yuan,0,3,20,20
1745135916705,BIBC 102,A01,894320,Staff,0,2,46,46
1745135916705,BIBC 102,A02,894321,Staff,0,0,46,46
1745135916705,BIBC 102,A03,894344,Staff,21,0,46,25
1745135916705,BIBC 102,A04,894345,Staff,30,0,47,17
1745135917733,BICD 100R,A01,894365,Smith; Laurie,1,3,58,57
1745135917733,BICD 100R,A02,894366,Smith; Laurie,0,1,58,58
1745135917733,BICD 100R,A03,894367,Smith; Laurie,13,0,59,46
1745135918762,BICD 136,A01,894383,Gustafson-Brown; Cindy,16,0,50,34
1745135919791,BIEB 102,A01,894494,Butler; Shannon Rhey,67,0,130,63
1745135921849,BIEB 150,A01,894617,Wills; Christopher,0,3,13,13
1745135921849,BIEB 150,A02,894631,Wills; Christopher,0,3,13,13
1745135921849,BIEB 150,A03,894937,Wills; Christopher,0,3,13,13
1745135921849,BIEB 150,A04,894946,Wills; Christopher,0,1,11,11
1745135922878,BIEB 194,A00,906141,Kurle; Carolyn M.,14,0,20,6
1745135923905,BILD 1,A01,894154,Staff,8,0,19,11
1745135923905,BILD 1,A02,894155,Staff,15,0,19,4
1745135923905,BILD 1,A03,894160,Staff,18,0,19,1
1745135923905,BILD 1,A04,894161,Staff,16,0,18,2
1745135924934,BILD 2,A01,894168,Staff,0,0,50,50
1745135924934,BILD 2,A02,894169,Staff,0,0,50,50
1745135924934,BILD 2,A03,894179,Staff,27,0,50,23
1745135924934,BILD 2,A04,894203,Staff,42,0,50,8
1745135925961,BILD 3,A01,894213,Staff,24,0,31,7
1745135925961,BILD 3,A02,894214,Staff,28,0,31,3
1745135925961,BILD 3,A03,894235,Staff,30,0,31,1
1745135925961,BILD 3,A04,894236,Staff,29,0,32,3
1745135926991,BILD 4,A01,894253,Reuther; Keefe,12,0,24,12
1745135926991,BILD 4,A02,894258,Reuther; Keefe,19,0,24,5
1745135928019,BILD 5,A01,894276,Reuther; Keefe,40,0,50,10
1745135928019,BILD 5,A02,894277,Reuther; Keefe,48,0,50,2
1745135928019,BILD 5,A03,894290,Reuther; Keefe,47,0,50,3
1745135928019,BILD 5,A04,894291,Reuther; Keefe,50,0,50,0
1745135929049,BILD 24,A01,894297,Pirino; Giorgia,46,0,60,14
1745135930078,BIMM 100,A01,895012,Staff,0,14,0,1
1745135930078,BIMM 100,A02,895013,Staff,0,6,0,2
1745135930078,BIMM 100,A03,895014,Staff,0,7,0,0
1745135930078,BIMM 100,A04,895015,Staff,0,4,0,0
1745135931104,BIMM 101,A01,895017,McDonnell; Lisa Marie,0,2,24,24
1745135931104,BIMM 101,A02,895018,McDonnell; Lisa Marie,0,1,24,24
1745135931104,BIMM 101,B01,895020,McDonnell; Lisa Marie,0,3,24,24
1745135931104,BIMM 101,B02,895021,McDonnell; Lisa Marie,0,2,24,24
1745135932131,BIMM 110,A01,895023,Staff,7,0,25,18
1745135932131,BIMM 110,A02,895024,Staff,11,0,25,14
1745135932131,BIMM 110,A03,895025,Staff,22,0,25,3
1745135932131,BIMM 110,A04,895031,Staff,21,0,25,4
1745135933159,BIMM 120,A01,895114,Gustafson-Brown; Cindy,8,0,28,20
1745135933159,BIMM 120,A02,895126,Gustafson-Brown; Cindy,19,0,27,8
1745135934192,BIPN 100,A01,895130,Yang; Mingyu,13,0,38,25
1745135934192,BIPN 100,A02,895131,Yang; Mingyu,33,0,38,5
1745135934192,BIPN 100,A03,895132,Yang; Mingyu,33,0,38,5
1745135934192,BIPN 100,A04,895133,Yang; Mingyu,30,0,36,6
1745135935223,BIPN 120,A01,895135,Cooke; James Edward,0,3,13,13
1745135935223,BIPN 120,A02,895136,Cooke; James Edward,0,1,13,13
1745135935223,BIPN 120,A03,895137,Cooke; James Edward,0,0,13,13
1745135935223,BIPN 120,A04,895156,Cooke; James Edward,4,0,11,7
1745135936251,BIPN 134,A01,895235,Cooke; James Edward,0,3,25,25
1745135936251,BIPN 134,A02,895237,Cooke; James Edward,0,0,25,25
1745135936251,BIPN 134,A03,895240,Cooke; James Edward,13,0,25,12
1745135936251,BIPN 134,A04,895270,Cooke; James Edward,24,0,25,1
1745135937276,BIPN 189,A00,892103,Staff,0,20,9,9
1745135939330,CAT 124,A01,922009,Staff,0,1,20,20
1745135940410,CAT 125R,A00,886390,Morales; Celeste Georgianna,4,0,20,16
1745135940410,CAT 125R,B00,886391,Irwin; Matthew Joseph,0,1,20,20
1745135940410,CAT 125R,C00,886392,Smith; Lauryn Alissa,11,0,20,9
1745135940410,CAT 125R,D00,886393,Vanderschuit; Maya Alysia,6,0,20,14
1745135940410,CAT 125R,E00,886394,Marchisotto; Jennifer Anne,0,2,20,20
1745135941442,CENG 15,A01,886218,Drews; Aaron,1,0,5,4
1745135942469,CENG 113,A00,886219,Opatkiewicz; Justin Paul,16,0,25,9
1745135943499,CGS 101,A00,887044,Staff,13,0,20,7
1745135944529,CGS 105,A01,887046,Staff,16,0,25,9
1745135945556,CGS 112,A00,887047,Cuong; Marisol,12,0,15,3
1745135946589,CGS 113,A00,887048,Staff,24,0,30,6
1745135947615,CGS 120,A00,887049,Staff,12,0,17,5
1745135948649,CHEM 6A,A01,886336,Lam; Tin Yiu,44,0,50,6
1745135948649,CHEM 6A,A02,886338,Lam; Tin Yiu,43,0,50,7
1745135949675,CHEM 6B,A01,886341,Hopkins; Patrycja Anna,21,0,50,29
1745135949675,CHEM 6B,A02,886343,Hopkins; Patrycja Anna,46,0,50,4
1745135950704,CHEM 6C,A01,886346,Albizati; Kim F.,0,1,50,50
1745135950704,CHEM 6C,A02,886348,Albizati; Kim F.,38,0,50,12
1745135951731,CHEM 40A,A01,886352,Klosterman; Jeremy K,70,0,100,30
1745135952761,CHEM 40B,A01,886356,Klosterman; Jeremy K,0,4,100,100
1745135953789,CHEM 41B,A01,886360,Theodorakis; Emmanuel,30,0,50,20
1745135953789,CHEM 41B,A02,886362,Theodorakis; Emmanuel,46,0,50,4
1745135954819,CHIN 165A,A00,886382,Xu; Li,19,0,20,1
1745135955848,CLAS 120,A00,886387,Myerston Santana; Jacobo,36,0,40,4
1745135956880,COGS 9,A01,886967,Shannon; Kyle Michael,49,0,60,11
1745135957907,COGS 11,A01,886969,Staff,18,0,30,12
1745135958934,COGS 14A,A01,886971,Staff,26,0,60,34
1745135959964,COGS 14B,A01,886973,Hoffman; Drew Ellen,18,0,60,42
1745135960988,COGS 18,A01,886975,Morgan; Eric,41,0,60,19
1745135962019,COGS 20,A01,886977,Staff,6,0,8,2
1745135962019,COGS 20,A02,886978,Staff,6,0,7,1
1745135963046,COGS 100,A01,907783,Staff,6,0,30,24
1745135964073,COGS 101B,A01,886980,Staff,0,10,30,30
1745135965106,COGS 101C,A01,886982,Delgado; Tania,0,6,30,30
1745135966136,COGS 102A,A01,886984,Johnson; Christine M.,13,0,30,17
1745135967164,COGS 118B,A01,886986,Staff,0,25,60,60
1745135968191,COGS 150,A01,886988,Bergen; Benjamin,16,0,30,14
1745135969217,COGS 153,A00,886989,Delgado; Tania,0,6,30,30
1745135970244,COGS 186,A01,886991,Staff,3,0,30,27
1745135971269,COGS 187A,A01,886993,Boyle; Mary E. T.,12,0,30,18
1745135972299,COGS 189,A00,886994,Staff,13,0,30,17
1745135973323,COMM 10,A01,886996,Staff,11,0,25,14
1745135973323,COMM 10,A02,886997,Staff,21,0,25,4
1745135974349,COMM 20,A01,886999,Leuning; Grant Maurstad,33,0,40,7
1745135976402,COMM 100A,A01,887002,Staff,0,0,25,25
1745135976402,COMM 100A,A02,887003,Staff,20,0,25,5
1745135977428,COMM 100B,A01,887005,Staff,0,1,25,25
1745135978457,COMM 106D,A00,887006,Staff,22,0,40,18
1745135979485,COMM 110G,A00,887007,Whitworth-Smith; Andrew C,17,0,40,23
1745135980513,COMM 111B,A00,887008,Staff,31,0,40,9
1745135981539,COMM 113T,A00,887009,Abuelhiga; Soraya Jill,30,0,40,10
1745135981539,COMM 113T,B00,906733,Staff,40,0,40,0
1745135982566,COMM 145,A00,887010,Staff,21,0,40,19
1745135983591,COMM 146,A00,887054,Staff,31,0,40,9
1745135984617,COMM 190,A00,887012,Staff,9,0,23,14
1745135985645,CSE 8A,A50,887015,Cao; Yingjun,68,0,85,17
1745135986672,CSE 11,A01,887017,Cao; Yingjun,35,0,70,35
1745135987702,CSE 20,A01,887019,Staff,35,0,50,15
1745135988733,CSE 21,A01,887021,Braun; Oliver,81,0,100,19
1745135988733,CSE 21,B01,892583,Staff,48,0,50,2
1745135989760,CSE 30,A01,887025,Eldon; John,161,0,200,39
1745135990787,CSE 100,A01,887027,Staff,28,0,50,22
1745135990787,CSE 100,A02,887028,Staff,43,0,50,7
1745135991815,CSE 101,A01,887030,Braun; Oliver,79,0,100,21
1745135991815,CSE 101,B01,887032,Jones; Miles E,0,1,50,50
1745135991815,CSE 101,B02,887033,Jones; Miles E,13,0,50,37
1745135992845,CSE 105,A01,908084,Jones; Miles E,36,0,50,14
1745135992845,CSE 105,A02,908087,Jones; Miles E,38,0,50,12
1745135993872,CSE 135,A01,887035,Powell; Thomas Allan,8,0,50,42
1745135994901,CSE 142,A01,887037,Staff,22,0,60,38
1745135995928,CSE 142L,A01,887039,Staff,42,0,60,18
1745135996955,CSE 151A,A01,887041,Solares; Edwin A,60,0,100,40
1745135997982,CSE 175,A01,887043,Kumar; Rakesh,30,0,30,0
1745135999010,CSS 1,A01,886389,Staff,12,0,40,28
1745136000050,DSC 30,A01,908097,Liao; Soohyun Nam,54,0,75,21
1745136001076,DSC 40A,A01,908099,Shannon; Kyle Michael,37,0,50,13
1745136002101,DSC 40B,A01,908112,Staff,28,0,50,22
1745136003126,DSC 80,A01,908116,Staff,32,0,60,28
1745136004155,DSC 197,001,956863,Eldridge; Justin Matthew,9999,0,9999,0
1745136005183,ECE 5,A01,886400,Morris; Karcher William,3,0,6,3
1745136005183,ECE 5,A02,886401,Morris; Karcher William,5,0,6,1
1745136006208,ECE 148,A01,886403,Silberman; Jack,0,8,14,14
1745136007235,ECON 1,A01,887265,Crane; Meredith Helen,25,0,70,45
1745136007235,ECON 1,B01,887268,Staff,44,0,50,6
1745136008260,ECON 2,A01,887273,Crane; Meredith Helen,61,0,70,9
1745136009289,ECON 3,A01,887279,Rondina; Giacomo,44,0,70,26
1745136010320,ECON 4,A01,887282,Anderson; John Charles,0,1,10,10
1745136011350,ECON 5,A01,887285,Staff,39,0,45,6
1745136011350,ECON 5,B01,887292,Staff,43,0,45,2
1745136012399,ECON 100A,A01,887337,Newhouse; Herbert S,58,0,70,12
1745136012399,ECON 100A,B01,887349,Staff,45,0,50,5
1745136013425,ECON 100B,A01,887361,Du; Songzi,42,0,70,28
1745136014452,ECON 100C,A01,887445,Newhouse; Herbert S,61,0,70,9
1745136015479,ECON 105,A00,887488,Vespa; Emanuel Ignacio,24,0,35,11
1745136016506,ECON 109,A01,887506,Staff,29,0,35,6
1745136017536,ECON 110A,A01,887568,Alon; Titan Michael,1,0,35,34
1745136017536,ECON 110A,B01,907601,Alon; Titan Michael,27,0,35,8
1745136018563,ECON 110B,A01,887598,Levkoff; Steven B.,0,7,70,70
1745136019592,ECON 112,A00,887599,Rondina; Giacomo,20,0,35,15
1745136020623,ECON 120A,A01,887603,Dai; Yinlin,46,0,70,24
1745136021656,ECON 120C,A01,887608,Sun; Yixiao,0,0,35,35
1745136021656,ECON 120C,B01,887614,Sun; Yixiao,13,0,35,22
1745136022684,ECON 138,A00,887621,Bharadwaj; Prashant,0,18,20,20
1745136023714,ECON 171,A01,907666,Staff,27,0,35,8
1745136024744,ECON 175,A00,887626,Wu; Pak Yeung,27,0,35,8
1745136025773,ECON 190,A00,887640,Vespa; Emanuel Ignacio,26,0,35,9
1745136026804,EDS 25,A01,888197,Staff,0,0,0,0
1745136026804,EDS 25,A02,888209,Staff,0,0,0,0
1745136026804,EDS 25,A03,888210,Staff,0,0,0,0
1745136026804,EDS 25,A04,888212,Staff,0,0,0,0
1745136026804,EDS 25,A05,888213,Staff,0,0,0,0
1745136026804,EDS 25,A06,888214,Staff,0,0,0,0
1745136026804,EDS 25,A07,888235,Staff,0,0,0,0
1745136026804,EDS 25,A08,888236,Staff,0,0,0,0
1745136026804,EDS 25,A09,888240,Staff,0,0,0,0
1745136026804,EDS 25,A10,888244,Staff,0,0,0,0
1745136026804,EDS 25,B01,888273,Staff,0,0,0,0
1745136026804,EDS 25,B02,888285,Staff,0,0,0,0
1745136026804,EDS 25,B03,888423,Staff,29,0,30,1
1745136026804,EDS 25,B04,888432,Staff,0,0,0,0
1745136026804,EDS 25,B05,888433,Staff,0,0,0,0
1745136026804,EDS 25,B06,888467,Staff,0,0,0,0
1745136026804,EDS 25,B07,888468,Staff,0,0,0,0
1745136026804,EDS 25,B08,888479,Staff,0,0,0,0
1745136026804,EDS 25,B09,888484,Staff,0,0,0,0
1745136026804,EDS 25,B10,888487,Staff,0,0,0,0
1745136027831,EDS 38,A01,907700,Choi; Bailey Miyeon,30,0,30,0
1745136028859,EDS 112,A01,888601,Chapman; Thandeka K,23,0,40,17
1745136029883,EDS 115,A00,888697,Mendez; Kathrina Mendoza,17,0,30,13
1745136030913,EDS 116,A01,888893,Staff,38,0,40,2
1745136032962,EDS 124AR,A00,889133,Staff,33,0,50,17
1745136032962,EDS 124AR,B00,907471,Simon; Elizabeth A,42,0,50,8
1745136033989,EDS 124BR,A00,889134,Staff,57,0,100,43
1745136035015,EDS 125,A00,889135,Staff,26,0,30,4
1745136036042,EDS 126,A01,889138,Staff,37,0,40,3
1745136037067,EDS 164R,A01,889142,Wishard Guerra; Alison G.,38,0,50,12
1745136038095,ENG 30,A01,886396,Staff,0,0,0,0
1745136038095,ENG 30,B01,886398,Staff,0,0,0,0
1745136039124,ENVR 102,A00,906150,Montejo; Carolina,23,0,25,2
1745136040151,ETHN 103A,A00,887236,Man; Simeon S,0,5,0,0
1745136041181,ETHN 113,A00,887239,Staff,20,0,30,10
1745136042210,ETHN 116,A00,887240,Staff,20,0,25,5
1745136043240,ETHN 117,A00,887241,Choi; Esther Min,27,0,30,3
1745136044307,ETHN 118,A00,887243,Staff,24,0,30,6
1745136045335,ETHN 127,A00,887248,Cuong; Marisol,12,0,15,3
1745136046364,ETHN 139,A00,887250,Staff,8,0,10,2
1745136047389,ETHN 142,A00,887252,Staff,18,0,30,12
1745136048418,ETHN 161,A00,887253,Browne; Errol Tsekani,28,0,30,2
1745136049446,ETHN 163FR,A00,887255,Burelle; Julie Sara Veronique,4,0,5,1
1745136050470,GLBH 20,A00,889149,Elwardani; Nile Regina,15,0,42,27
1745136052525,GLBH 111,A01,889152,Burgos; Jose L.,17,0,17,0
1745136053550,GLBH 150,A00,889181,Sloane; Julia Kathryn,0,1,15,15
1745136055606,HDS 60,A01,886406,Warstadt; Melissa Fawn,76,0,80,4
1745136056632,HIAF 111,A00,889324,Gyamfi; Bright,0,4,0,0
1745136057659,HIEA 131,A00,889328,Staff,14,0,32,18
1745136058690,HIEA 144,A00,889333,Henry; Todd A.,29,0,32,3
1745136059716,HIEA 154,A00,889336,Henry; Todd A.,28,0,32,4
1745136060742,HIEU 106,A00,889339,Staff,28,0,32,4
1745136062794,HIEU 114,A00,889340,Staff,18,0,32,14
1745136063823,HIEU 135GS,A00,889342,Patterson; Patrick H.,0,0,1,22
1745136064849,HIEU 137,A00,889343,Edington; Claire Ellen,12,0,25,13
1745136065874,HIEU 148,A00,889345,Staff,16,0,32,16
1745136066901,HIEU 154,A00,889346,Biess; Frank Peter,24,0,32,8
1745136067929,HILA 102,A00,889351,Staff,13,0,32,19
1745136068953,HILD 2A,A01,889221,Lewandoski; Julia Mavis,0,5,32,32
1745136069983,HILD 7B,A01,889225,Man; Simeon S,0,7,32,32
1745136071009,HILD 7C,A01,889288,Alvarez; Luis A,0,7,32,32
1745136072033,HILD 30,A01,889323,Staff,0,1,32,32
1745136074087,HISC 119,A00,889383,Golan; Tal,22,0,32,10
1745136075110,HIUS 103,A00,889384,Man; Simeon S,10,0,32,22
1745136076136,HIUS 117,A00,919797,Kwak; Nancy,23,0,32,9
1745136077162,HIUS 142A,A00,919788,Staff,24,0,32,8
1745136079215,HIUS 149,A00,889386,Gyamfi; Bright,0,1,0,0
1745136080242,HIUS 155,A00,889387,Alvarez; Luis A,19,0,32,13
1745136081273,HUM 3,A01,886499,Caldwell; Michael Alan,24,0,50,26
1745136082300,HUM 3GS,A00,886500,Rodriguez; Bretton Sigfred,0,0,0,26
1745136083328,HUM 3R,A01,886502,Markman; Kristina,0,32,50,50
1745136084359,HUM 4,A01,886504,Crum; Matthew Stephen,28,0,50,22
1745136084359,HUM 4,B01,886506,West; Geoffrey Scott,25,0,50,25
1745136085387,HUM 4GS,A00,886507,Staff,0,0,0,13
1745136086418,HUM 5,A01,886509,Staff,35,0,50,15
1745136087446,HUM 5R,A01,886511,Zavodny; Tatiana Sophia,0,32,50,50
1745136088473,JAPN 180,A00,886407,Staff,25,0,40,15
1745136089500,LATI 50,A01,886409,Martin-Cabrera; Luis,8,0,22,14
1745136089500,LATI 50,A02,886410,Martin-Cabrera; Luis,21,0,22,1
1745136089500,LATI 50,A03,886411,Martin-Cabrera; Luis,22,0,22,0
1745136089500,LATI 50,A04,886412,Martin-Cabrera; Luis,16,0,22,6
1745136090527,LAWS 101,A00,907664,Staff,36,0,60,24
1745136091556,LIAB 1A,A00,889388,Saab; Dima,19,0,20,1
1745136092582,LIAB 1AX,A00,889389,El Cheddadi; Youniss,19,0,20,1
1745136093609,LIFR 1C,A00,889391,Van Moer; Vinciane G,9,0,20,11
1745136094638,LIFR 1CX,A00,889392,Van Moer; Vinciane G,8,0,20,12
1745136095665,LIFR 1D,A00,889393,Van Moer; Vinciane G,11,0,20,9
1745136096694,LIFR 1DX,A00,889394,Van Moer; Vinciane G,11,0,20,9
1745136097723,LIGN 7,A00,886923,Staff,30,0,50,20
1745136098750,LIGN 17,A00,886924,Kehler; Andrew Scott,133,0,150,17
1745136099775,LTAM 110,A00,889395,Staff,17,0,30,13
1745136100801,LTCH 101,A00,889397,Staff,22,0,25,3
1745136101828,LTCS 130,A00,889398,Staff,23,0,25,2
1745136102854,LTEA 138,A00,889399,Staff,25,0,40,15
1745136103881,LTEN 149,A00,889400,Wesling; Megan E.,6,0,25,19
1745136104907,LTEN 169,A00,889401,Staff,24,0,25,1
1745136105937,LTEN 180,A00,889402,Staff,12,0,15,3
1745136106963,LTEN 181,A00,889403,Staff,23,0,25,2
1745136107986,LTWL 100,A00,889404,Myerston Santana; Jacobo,8,0,25,17
1745136109015,LTWL 180GS,A00,889405,Staff,6,0,20,14
1745136110041,LTWL 181,A00,889406,Staff,19,0,25,6
1745136111069,LTWL 184,A00,889475,Mukherjee; Silpa,21,0,25,4
1745136112095,LTWR 102C,A00,889486,Staff,29,0,30,1
1745136113123,LTWR 115W,A00,889491,Staff,3,0,15,12
1745136114152,MAE 8,A01,886905,Staff,0,2,0,0
1745136115181,MAE 11,A00,886906,Bandaru; Prabhakar,0,0,50,50
1745136116209,MAE 20,A00,886907,Evdokimenko; Ekaterina,50,0,70,20
1745136117235,MAE 30B,A00,886909,Ghazinejad; Maziar,28,0,45,17
1745136118262,MAE 101B,A00,886910,Saintillan; David,36,0,45,9
1745136119289,MAE 105,A00,886911,Bandaru; Prabhakar,26,0,50,24
1745136120318,MAE 107,A00,886912,Staff,22,0,60,38
1745136121346,MAE 143B,A00,886913,Bewley; Thomas R,14,0,40,26
1745136122387,MAE 148,A01,886915,Silberman; Jack,5,0,14,9
1745136123412,MAE 160,A00,886916,Evdokimenko; Ekaterina,41,0,60,19
1745136124441,MATH 3C,A01,889681,Staff,2,0,30,28
1745136125470,MATH 10A,A01,889760,Staff,28,0,30,2
1745136125470,MATH 10A,A02,889783,Staff,30,0,30,0
1745136126500,MATH 10B,A01,889785,Verstraete; Jacques Allan,0,2,30,30
1745136126500,MATH 10B,A02,889795,Verstraete; Jacques Allan,0,2,30,30
1745136126500,MATH 10B,B01,889797,Verstraete; Jacques Allan,1,0,30,29
1745136126500,MATH 10B,B02,889828,Verstraete; Jacques Allan,23,0,30,7
1745136127530,MATH 10C,A01,889849,Habib; Yousaf,18,0,30,12
1745136127530,MATH 10C,A02,889852,Habib; Yousaf,20,0,30,10
1745136127530,MATH 10C,A03,889853,Habib; Yousaf,25,0,30,5
1745136127530,MATH 10C,A04,889858,Habib; Yousaf,21,0,30,9
1745136127530,MATH 10C,B01,889861,Staff,12,0,30,18
1745136127530,MATH 10C,B02,889862,Staff,26,0,30,4
1745136127530,MATH 10C,B03,889863,Staff,28,0,30,2
1745136127530,MATH 10C,B04,889967,Staff,25,0,30,5
1745136128557,MATH 18,A01,889974,Staff,15,0,30,15
1745136128557,MATH 18,A02,889977,Staff,25,0,30,5
1745136128557,MATH 18,B01,889984,Hardiman; Liam,26,0,30,4
1745136128557,MATH 18,B02,889985,Hardiman; Liam,28,0,30,2
1745136129588,MATH 20A,A01,889990,Suk; Andrew Hoon,31,0,35,4
1745136130619,MATH 20B,A01,889993,Ohm; Ko Woon,21,0,30,9
1745136130619,MATH 20B,A02,889994,Ohm; Ko Woon,30,0,30,0
1745136130619,MATH 20B,B01,889996,Ohm; Ko Woon,25,0,30,5
1745136130619,MATH 20B,B02,889997,Ohm; Ko Woon,24,0,30,6
1745136131652,MATH 20C,A01,889999,Hammock; Frances H,22,0,30,8
1745136131652,MATH 20C,A02,890003,Hammock; Frances H,23,0,30,7
1745136131652,MATH 20C,B01,890006,Hammock; Frances H,11,0,30,19
1745136131652,MATH 20C,B02,890007,Hammock; Frances H,18,0,30,12
1745136132684,MATH 20D,A01,890011,Cheng; Hsiao-Bing,6,0,30,24
1745136132684,MATH 20D,A02,890012,Cheng; Hsiao-Bing,27,0,30,3
1745136132684,MATH 20D,B01,890016,Cheng; Hsiao-Bing,19,0,30,11
1745136132684,MATH 20D,B02,890017,Cheng; Hsiao-Bing,15,0,30,15
1745136133711,MATH 20E,A01,890026,Harel; Guershon,10,0,30,20
1745136133711,MATH 20E,A02,890029,Harel; Guershon,24,0,30,6
1745136133711,MATH 20E,B01,890033,Harel; Guershon,14,0,30,16
1745136133711,MATH 20E,B02,890101,Harel; Guershon,27,0,30,3
1745136134741,MATH 102,A01,890104,Staff,20,0,30,10
1745136134741,MATH 102,A02,890105,Staff,30,0,30,0
1745136135767,MATH 103B,A01,890116,Salehi Golsefidy; Alireza,8,0,30,22
1745136135767,MATH 103B,B01,890118,Staff,0,4,30,30
1745136136798,MATH 109,A01,890121,Aliabadi Sr.; Mohsen,6,0,30,24
1745136136798,MATH 109,B01,890124,Upadrashta; Pranav Kumar,23,0,30,7
1745136137824,MATH 120A,A01,890126,Eggers; John Dietrich,15,0,30,15
1745136138847,MATH 142B,A01,890128,Ioana; Adrian,17,0,30,13
1745136138847,MATH 142B,A02,890129,Ioana; Adrian,15,0,30,15
1745136139879,MATH 154,A01,890174,Staff,0,1,30,30
1745136139879,MATH 154,A02,890182,Staff,15,0,30,15
1745136140905,MATH 168A,A01,890197,Dumitriu; Ioana,22,0,35,13
1745136141930,MATH 170A,A01,890240,Nie; Jiawang,6,0,30,24
1745136141930,MATH 170A,A02,890241,Nie; Jiawang,18,0,30,12
1745136141930,MATH 170A,A03,890249,Nie; Jiawang,23,0,30,7
1745136142957,MATH 170B,A01,957891,Nag; Panchali,25,0,35,10
1745136145008,MATH 181A,A01,908025,Staff,0,8,35,35
1745136146035,MATH 193B,A01,890265,Staff,3,0,35,32
1745136147060,MGT 4,A01,890311,Anderson; John Charles,57,0,88,31
1745136148086,MGT 5,A00,907740,Staff,41,0,98,57
1745136149112,MGT 12,A00,890312,Lindenberger; Wade Douglas,70,0,98,28
1745136150138,MGT 16,A00,957883,Staff,84,0,98,14
1745136152189,MGT 45,A00,890314,Pecore; Joseph P.,57,0,98,41
1745136153214,MGT 71,A00,890315,Staff,6,0,98,92
1745136154242,MGT 100,A00,890316,Yavorsky; Daniel Ryan,59,0,98,39
1745136155267,MGT 103,A00,890317,Ehrich; Kristine R,77,0,98,21
1745136156296,MGT 105,A00,890356,Bates; Kenneth Walter,19,0,98,79
1745136157322,MGT 112,A00,890360,Ehrich; Kristine R,65,0,98,33
1745136158350,MGT 127R,A00,907732,Zhu; Kevin Xiaoguo,32,0,98,66
1745136159376,MGT 131B,A00,890361,Anderson; John Charles,75,0,98,23
1745136160403,MGT 137,A00,890362,Lindenberger; Wade Douglas,68,0,98,30
1745136161428,MGT 160,A00,890369,Johnson; Erik Barry,37,0,98,61
1745136163479,MGT 164,A00,890372,Zimmermann; Carsten,0,28,98,98
1745136164509,MGT 180,A00,890374,Bliss; Barbara Ann,32,0,98,66
1745136165536,MMW 15,A01,886414,Chang; Edmond Yi-Teh,0,10,28,28
1745136165536,MMW 15,A02,886415,Chang; Edmond Yi-Teh,0,10,28,28
1745136165536,MMW 15,A03,886416,Chang; Edmond Yi-Teh,0,8,28,28
1745136165536,MMW 15,A04,886417,Chang; Edmond Yi-Teh,0,8,28,28
1745136165536,MMW 15,B01,886419,Chang; Edmond Yi-Teh,0,8,28,28
1745136165536,MMW 15,B02,886420,Chang; Edmond Yi-Teh,0,9,28,28
1745136165536,MMW 15,B03,886421,Chang; Edmond Yi-Teh,0,9,28,28
1745136165536,MMW 15,B04,886422,Chang; Edmond Yi-Teh,0,9,28,28
1745136165536,MMW 15,C01,886424,Staff,0,10,28,28
1745136165536,MMW 15,C02,886425,Staff,0,10,28,28
1745136165536,MMW 15,C03,886426,Staff,0,9,28,28
1745136165536,MMW 15,C04,886427,Staff,0,9,28,28
1745136166561,MMW 15GS,A00,906910,Patterson; Patrick H.,5,0,28,23
1745136167586,MMW 122R,A01,886429,Rahimi; Babak,0,23,28,28
1745136167586,MMW 122R,A02,886430,Rahimi; Babak,0,23,28,28
1745136168612,MUS 1A,A01,890937,Staff,8,0,25,17
1745136168612,MUS 1A,A02,891035,Staff,15,0,25,10
1745136168612,MUS 1A,B00,907849,Staff,48,0,50,2
1745136168612,MUS 1A,B01,907850,Staff,25,0,25,0
1745136168612,MUS 1A,B02,907851,Staff,25,0,25,0
1745136170665,MUS 2AK,A00,957092,Ohnishi; Takae,15,0,15,0
1745136171692,MUS 4,A01,891044,Staff,6,0,25,19
1745136171692,MUS 4,A02,891045,Staff,24,0,25,1
1745136171692,MUS 4,B01,891048,Staff,20,0,25,5
1745136171692,MUS 4,B02,891050,Staff,25,0,25,0
1745136172725,MUS 5,A01,957506,Dubnov; Shlomo,4,0,25,21
1745136172725,MUS 5,A02,957622,Dubnov; Shlomo,21,0,25,4
1745136172725,MUS 5,A03,957623,Dubnov; Shlomo,23,0,25,2
1745136173751,MUS 6,A01,891053,Freitas Caetano; Marcelo,23,0,25,2
1745136173751,MUS 6,A02,891054,Freitas Caetano; Marcelo,23,0,25,2
1745136174777,MUS 7,A01,891081,Staff,0,0,25,25
1745136174777,MUS 7,A02,891082,Staff,15,0,25,10
1745136175805,MUS 8GS,A00,891118,Borgo; David Garcia,5,0,25,20
1745136176836,MUS 11,A01,891140,Staff,12,0,25,13
1745136176836,MUS 11,A02,891141,Staff,24,0,25,1
1745136177867,MUS 13,A01,891143,Staff,10,0,25,15
1745136177867,MUS 13,A02,891144,Staff,25,0,25,0
1745136178894,MUS 15,A01,891146,Staff,7,0,25,18
1745136178894,MUS 15,A02,891148,Staff,22,0,25,3
1745136178894,MUS 15,B01,891150,Staff,18,0,25,7
1745136178894,MUS 15,B02,891151,Staff,25,0,25,0
1745136179917,MUS 20,A01,891153,Staff,9,0,20,11
1745136179917,MUS 20,A02,891155,Staff,16,0,20,4
1745136180943,MUS 80,A00,891156,Staff,19,0,25,6
1745136180943,MUS 80,B00,891157,Staff,25,0,25,0
1745136181968,MUS 130,A00,891158,Ohnishi; Takae,35,0,35,0
1745136182995,MUS 150GS,A01,891160,Borgo; David Garcia,5,0,25,20
1745136184023,MUS 170,A01,891162,Freitas Caetano; Marcelo,21,0,25,4
1745136184023,MUS 170,A02,891164,Freitas Caetano; Marcelo,22,0,25,3
1745136185060,NANO 11,A00,886220,Vazquez Mena; Oscar,12,0,15,3
1745136186087,NANO 15,A01,886222,Drews; Aaron,9,0,10,1
1745136187115,NANO 104,A00,886224,Sirbuly; Donald,18,0,25,7
1745136188144,PH 40,A00,886528,Staff,29,0,40,11
1745136189170,PH 45,A01,886799,Staff,36,0,40,4
1745136190193,PH 110,A00,886802,Staff,7,0,40,33
1745136191218,PH 172,A00,906716,Staff,20,0,35,15
1745136192243,PH 191,A00,886803,Staff,23,0,40,17
1745136193274,PHIL 1,A00,889500,Staff,22,0,30,8
1745136194307,PHIL 10,A01,889549,Grush; Rick Scott,17,0,22,5
1745136194307,PHIL 10,A02,889551,Grush; Rick Scott,20,0,22,2
1745136195339,PHIL 28,A01,889559,Lamey; Andy M.,0,4,25,25
1745136195339,PHIL 28,A02,889561,Lamey; Andy M.,0,0,25,25
1745136195339,PHIL 28,A03,889572,Lamey; Andy M.,7,0,25,18
1745136196369,PHIL 35,A00,907839,Staff,32,0,33,1
1745136197396,PHIL 60,A00,889574,Staff,79,0,90,11
1745136198425,PHIL 105,A00,889579,Staff,0,1,0,0
1745136199452,PHIL 136,A00,889582,Fulkerson; Matthew Todd,27,0,45,18
1745136200479,PHIL 163,A01,889601,Staff,24,0,30,6
1745136200479,PHIL 163,B01,889606,Brandt; Reuven A,0,2,0,0
1745136201504,PHIL 164,A00,889610,Staff,20,0,30,10
1745136202529,PHIL 165,A00,889613,Staff,26,0,30,4
1745136203556,PHYS 1A,A00,886431,Staff,38,0,70,32
1745136204582,PHYS 1AL,001,886432,Tsai; Philbert S,0,0,30,30
1745136204582,PHYS 1AL,002,886436,Tsai; Philbert S,19,0,30,11
1745136205613,PHYS 1B,A00,886439,Staff,192,0,240,48
1745136206640,PHYS 1BL,001,886441,Tsai; Philbert S,0,1,30,30
1745136206640,PHYS 1BL,002,886444,Tsai; Philbert S,14,0,30,16
1745136207666,PHYS 1C,A00,896092,Arnold; Kam S,87,0,146,59
1745136208692,PHYS 1CL,001,886448,Tsai; Philbert S,0,4,30,30
1745136208692,PHYS 1CL,002,886449,Tsai; Philbert S,6,0,30,24
1745136208692,PHYS 1CL,003,886450,Tsai; Philbert S,22,0,30,8
1745136208692,PHYS 1CL,004,886451,Tsai; Philbert S,16,0,30,14
1745136209716,PHYS 2B,A01,886457,Staff,86,0,115,29
1745136210745,PHYS 2C,A01,886460,Shotwell; Brian,0,0,65,65
1745136211771,PHYS 2CL,A01,886467,Staff,0,3,28,28
1745136211771,PHYS 2CL,A02,886468,Staff,5,0,28,23
1745136212795,PHYS 2D,A01,886470,Staff,17,0,50,33
1745136213825,PHYS 4B,A01,886475,Grinstein; Benjamin,88,0,100,12
1745136214851,POLI 5,A00,891173,Desposato; Scott,17,0,25,8
1745136215897,POLI 5D,A01,891175,Staff,5,0,5,0
1745136215897,POLI 5D,B01,891178,Staff,5,0,5,0
1745136216925,POLI 11,A00,891179,Ferree; Karen E,3,0,25,22
1745136217955,POLI 12,A00,891180,Staff,21,0,30,9
1745136218982,POLI 27,A01,891182,Staff,29,0,75,46
1745136220013,POLI 30,A00,891183,Staff,0,3,30,30
1745136221082,POLI 100B,A00,891244,Staff,0,8,20,20
1745136222108,POLI 100I,A00,891247,Staff,19,0,30,11
1745136223135,POLI 104J,A00,891248,Nichter; Maysa,18,0,30,12
1745136224164,POLI 104U,A00,891250,Nichter; Maysa,9,0,30,21
1745136225192,POLI 108,A00,891253,Staff,0,0,0,4
1745136226222,POLI 110B,A00,891255,Wiens; David,22,0,25,3
1745136227251,POLI 112A,A00,891256,Wiens; David,15,0,25,10
1745136228279,POLI 114BR,A00,891261,Staff,22,0,30,8
1745136229305,POLI 117R,A00,891262,Forman; Fonna,12,0,50,38
1745136230332,POLI 118,A00,891264,Ingham; Sean,22,0,25,3
1745136231360,POLI 124A,A00,891265,Staff,19,0,20,1
1745136232387,POLI 125D,A00,891266,Nichter; Simeon C,9,0,25,16
1745136233415,POLI 126,A00,891268,Nichter; Simeon C,11,0,25,14
1745136234439,POLI 126AA,A00,891272,Staff,19,0,25,6
1745136235464,POLI 130AA,A00,891273,Staff,17,0,20,3
1745136236493,POLI 134AA,A00,891274,Staff,12,0,20,8
1745136238549,POLI 138,A00,891278,Staff,22,0,25,3
1745136239579,POLI 142K,A00,891280,Staff,17,0,25,8
1745136240608,POLI 142M,A00,891281,Gartzke; Erik,22,0,30,8
1745136241633,POLI 142P,A00,891284,Staff,21,0,30,9
1745136242660,POLI 143,A00,891285,Gartzke; Erik,17,0,30,13
1745136243689,POLI 153,A00,891286,Staff,20,0,20,0
1745136244714,POLI 170A,A00,891288,Staff,19,0,25,6
1745136245740,POLI 175,A00,891290,Staff,18,0,20,2
1745136246766,PSYC 1,A00,890674,Steiner; Eric Tomas,0,4,45,45
1745136247797,PSYC 2,A00,890676,Albright; Thomas D,25,0,35,10
1745136248829,PSYC 3,A00,890679,Staff,18,0,20,2
1745136249860,PSYC 60,A01,890684,Rickard; Timothy C.,7,0,45,38
1745136250889,PSYC 70,A01,890689,Geller; Emma Harlan,14,0,30,16
1745136251918,PSYC 100,A00,890690,Lacefield; Katharine I,0,43,180,180
1745136252944,PSYC 102,A00,890695,Staff,26,0,40,14
1745136253971,PSYC 105,A00,890699,Geller; Emma Harlan,78,0,100,22
1745136254997,PSYC 106,A00,890701,Gorman; Michael R.,15,0,30,15
1745136256027,PSYC 108,A00,890704,Adrian; Julia Anna,0,23,50,50
1745136257053,PSYC 118,A01,890712,Staff,18,0,30,12
1745136258079,PSYC 124,A00,890716,Chapman; Eddie Nathaniel,36,0,60,24
1745136259103,PSYC 131,A00,890717,Anagnostaras; Stephan,6,0,80,74
1745136260128,PSYC 137,A00,890719,Winkielman; Piotr,0,2,30,30
1745136261156,PSYC 144,A00,890721,Adrian; Julia Anna,0,3,45,45
1745136262182,PSYC 162,A00,890805,Staff,21,0,75,54
1745136263207,PSYC 169,A00,890810,Staff,0,15,30,30
1745136264233,PSYC 172,A00,890814,Gorman; Michael R.,14,0,30,16
1745136265262,PSYC 181,A00,890818,Anagnostaras; Stephan,63,0,200,137
1745136266288,PSYC 189,A00,890823,Staff,11,0,30,19
1745136267313,PSYC 191,A00,890884,Rickard; Timothy C.,0,11,35,35
1745136268338,PSYC 193,A00,890913,Staff,22,0,30,8
1745136268338,PSYC 193,B00,890914,Chapman; Eddie Nathaniel,25,0,30,5
1745136269368,PSYC 193L,A01,890918,Lowe; Angela Beth,29,0,30,1
1745136269368,PSYC 193L,B01,890921,Hurwitz; Ethan Scott,28,0,30,2
1745136269368,PSYC 193L,C01,890928,Staff,30,0,30,0
1745136270398,RELI 149,A00,886806,Rahimi; Babak,23,0,40,17
1745136271426,SE 9,A01,886814,Staff,13,0,20,7
1745136272455,SE 101B,A01,886816,Chadha; Mayank,8,0,30,22
1745136273485,SE 110B,A00,886818,Zhu; Qiang,0,16,45,45
1745136274513,SE 125,A01,886830,Staff,10,0,30,20
1745136275538,SE 130B,A01,886835,Staff,19,0,40,21
1745136276565,SE 131A,A01,886838,Krysl; Petr,37,0,55,18
1745136277593,SE 154,A00,886840,Staff,35,0,50,15
1745136278621,SE 164GS,A01,886849,Staff,13,0,20,7
1745136279649,SE 167GS,A01,886853,Staff,13,0,20,7
1745136280676,SIO 25,A01,890107,Staff,23,0,30,7
1745136281704,SIO 45,A00,890109,Cook; Geoffrey W,137,0,200,63
1745136282728,SIO 109R,A00,890110,Forman; Fonna,0,11,20,20
1745136283756,SIO 187,A01,890114,Kacev; David,21,0,40,19
1745136284782,SOCI 1,A01,890431,Thorpe; Charles Robert,21,0,30,9
1745136284782,SOCI 1,A02,890518,Thorpe; Charles Robert,30,0,30,0
1745136285810,SOCI 2,A01,957978,Staff,0,0,0,0
1745136285810,SOCI 2,A02,957979,Staff,0,3,0,0
1745136286840,SOCI 20,A01,890523,Calderon-Zaks; Michael Aar,24,0,30,6
1745136286840,SOCI 20,A02,890526,Calderon-Zaks; Michael Aar,29,0,30,1
1745136287870,SOCI 30,A01,890533,Pardo Guerra; Juan Pablo,37,0,40,3
1745136288897,SOCI 40,A01,890535,Staff,32,0,45,13
1745136289923,SOCI 104Q,A00,890559,Staff,20,0,30,10
1745136290951,SOCI 106,A00,890560,Arnal; Maud Marie Leonie,22,0,30,8
1745136291977,SOCI 110,A00,890567,Holkenbrink-Monk; Charlene,22,0,30,8
1745136293005,SOCI 112,A00,890568,Victoria Torres; Pablo,0,0,45,45
1745136294034,SOCI 115,A00,890597,Arnal; Maud Marie Leonie,33,0,45,12
1745136296091,SOCI 121,A00,890604,Pardo Guerra; Juan Pablo,40,0,45,5
1745136297117,SOCI 126,A01,890608,Staff,8,0,10,2
1745136298143,SOCI 127,A00,890609,Staff,23,0,30,7
1745136299173,SOCI 131,A00,890610,Thorpe; Charles Robert,38,0,45,7
1745136300199,SOCI 135,A00,890615,Payne; Christine Anna,20,0,45,25
1745136301227,SOCI 139,A00,890620,Staff,43,0,45,2
1745136302256,SOCI 148E,A00,890622,Calderon-Zaks; Michael Aar,39,0,45,6
1745136303281,SOCI 150,A00,890623,Kohler; Kristopher M.,36,0,45,9
1745136304308,SOCI 157,A00,890625,Jules-Rosette; Bennetta W.,18,0,20,2
1745136305334,SOCI 160,A00,890627,Payne; Christine Anna,26,0,45,19
1745136306363,SYN 1,A00,886855,Fish; Gwendolyn Anne,0,0,0,0
1745136306363,SYN 1,B00,906086,Fish; Gwendolyn Anne,0,0,0,2
1745136307391,SYN 2R,A00,886860,Staff,0,15,15,15
1745136307391,SYN 2R,B00,906106,Atkinson; Arthur Laird,0,14,15,15
1745136308421,SYN 100,A01,886866,Browne; Emily,0,29,20,20
1745136308421,SYN 100,B01,906128,Rock; Martin,0,4,20,20
1745136308421,SYN 100,C01,906140,Deavenport; James Cary,0,2,20,20
1745136308421,SYN 100,D01,907816,Deavenport; James Cary,0,3,20,20
1745136309448,TDAC 1,A00,890286,Walsh; Kim C.,11,0,20,9
1745136310477,TDAC 101,A00,890296,Basso; Beatrice,18,0,20,2
1745136311507,TDDE 131,A00,890297,Staff,47,0,50,3
1745136312533,TDDM 1,A00,890287,Weinberg; Sadie,26,0,30,4
1745136313559,TDGE 11,A00,890288,Fulton; Julia,155,0,200,45
1745136313559,TDGE 11,B00,890289,Castro; Robert Jess,188,0,200,12
1745136314585,TDGE 25,B00,957359,Walsh; Kim C.,9,0,20,11
1745136315614,TDGE 40,A01,890292,Power; Jade Yukana,28,0,30,2
1745136316641,TDGE 124,A00,890298,Havis; Allan,12,0,50,38
1745136317670,TDGE 131R,A00,890299,Burelle; Julie Sara Veronique,20,0,42,22
1745136318695,TDHT 101,A00,890300,Staff,12,0,20,8
1745136319720,TDHT 109,A01,890302,Anderson; Mysia Anyse,31,0,40,9
1745136320748,TDMV 1,A00,890293,Arcidiacono; Kristin,20,0,30,10
1745136321777,TDMV 2,A00,890294,Weinberg; Sadie,26,0,30,4
1745136322818,TDMV 3,A00,957878,Arcidiacono; Kristin,27,0,30,3
1745136324871,TDMV 138,A00,890304,Jun; Grace Shin Hae,25,0,40,15
1745136325900,TDMV 140,A00,890305,Corrales; Joseph Bernales,28,0,30,2
1745136326928,TDMV 142,A00,890307,Caligagan; Tony,30,0,40,10
1745136327954,TDMV 144,A00,890308,Camaya; Michelle Ann,26,0,30,4
1745136328981,TDPW 1,A00,890295,Stein; Deborah Isobel,5,0,20,15
1745136330006,USP 2,A01,890272,Lerner; Amy M,8,0,20,12
1745136331036,USP 3,A01,890274,Staff,21,0,30,9
1745136332062,USP 15,A01,890276,Sun; Feiyang,21,0,30,9
1745136333086,USP 25,A00,890277,Shenkman; Michael Thomas,21,0,25,4
1745136334116,USP 138,A00,890278,Staff,15,0,25,10
1745136335142,USP 143,A00,890279,Staff,30,0,70,40
1745136336171,USP 144,A00,890280,Chowdhury; Muhammed Zohir,19,0,30,11
1745136337196,USP 150,A00,890281,Boomhower; Matthew Charles,19,0,30,11
1745136338224,USP 151,A00,890282,Staff,17,0,20,3
1745136339252,USP 162,A00,890283,Andrews; Abigail Leslie,17,0,20,3
1745136340277,USP 168,A00,920477,Kwak; Nancy,2,0,5,3
1745136341306,USP 181,A00,890284,Staff,11,0,20,9
1745136342332,USP 191A,A00,890285,Staff,15,0,20,5
1745136343358,VIS 101,A00,886512,Staff,37,0,75,38
1745136344390,VIS 103,A00,886513,Cruz; Edwin Teddy,65,0,75,10
1745136345415,VIS 108,A00,886514,Staff,7,0,15,8
1745136346444,VIS 127P,A00,886515,Shen; Kuiyi,92,0,146,54
1745136347471,VIS 149,A00,886516,Yoldas; Pinar,1,0,15,14
1745136348501,VIS 164,A00,886526,Erdmann; Dean,21,0,22,1
1745136349531,VIS 194S,A00,886527,Staff,61,0,75,14
1745136350561,WCWP 10A,C00,886484,Staff,13,0,15,2
1745136351586,WCWP 10B,A00,886490,Staff,5,0,15,10
1745136351586,WCWP 10B,B00,886491,Staff,0,1,0,0
1745136351586,WCWP 10B,C00,886492,Staff,10,0,15,5
1745136352613,WCWP 100,A00,886494,Staff,0,2,15,15
1745136354772,AAS 10,A01,886199,Childs; Dennis R.,0,2,0,0
1745136355801,ANAR 104,A01,886940,Shtienberg; Gilad,27,0,30,3
1745136356826,ANAR 120,A00,886953,Staff,13,0,20,7
1745136357852,ANBI 148,A01,886955,Wilder; Linnea Lorene,32,0,40,8
1745136359906,ANSC 122,A00,886957,Staff,28,0,30,2
1745136360931,ANSC 150,A00,886958,Sloane; Julia Kathryn,6,0,15,9
1745136361958,ANSC 156,A00,886959,Jenkins; Janis A.,2,0,15,13
1745136362982,ANSC 180,A00,886960,Staff,12,0,17,5
1745136364011,ANSC 188,A00,886961,Jassal; Aftab,10,0,25,15
1745136365039,ANSC 190,A00,886962,Jassal; Aftab,14,0,25,11
1745136366068,ANSC 191,A00,886963,Staff,18,0,20,2
1745136367100,ANTH 3,A01,891689,Staff,19,0,20,1
1745136368131,ANTH 5,A00,886933,Semendeferi; Ekaterini,18,0,20,2
1745136369155,ANTH 10,A00,886934,Staff,0,8,30,30
1745136370181,ANTH 21,A01,886936,Staff,44,0,60,16
1745136371207,ANTH 23,A01,886938,Staff,94,0,100,6
1745136372235,ANTH 105,A00,886964,Stewart; Alexander B,94,0,100,6
1745136373262,ANTH 108,A00,886965,Pedersen; David,10,0,20,10
1745136374295,AWP 10,001,886147,Staff,0,0,0,0
1745136374295,AWP 10,002,886148,Staff,0,0,0,0
1745136374295,AWP 10,003,886149,Staff,0,0,0,0
1745136374295,AWP 10,004,886150,Staff,0,0,0,0
1745136374295,AWP 10,005,886151,Staff,0,0,0,0
1745136374295,AWP 10,006,886152,Staff,0,0,0,0
1745136374295,AWP 10,007,886153,Staff,0,0,0,0
1745136374295,AWP 10,008,886154,Staff,0,0,0,0
1745136374295,AWP 10,009,886155,Staff,0,0,0,0
1745136374295,AWP 10,010,886156,Staff,0,0,0,0
1745136374295,AWP 10,011,886158,Staff,0,0,0,0
1745136374295,AWP 10,012,886160,Staff,0,0,0,0
1745136374295,AWP 10,013,886161,Staff,0,0,0,0
1745136374295,AWP 10,014,886162,Staff,0,0,0,0
1745136374295,AWP 10,015,886163,Staff,0,0,0,0
1745136374295,AWP 10,016,886164,Staff,0,0,0,0
1745136374295,AWP 10,017,886165,Staff,0,0,0,0
1745136374295,AWP 10,018,886166,Staff,0,0,0,0
1745136374295,AWP 10,019,886168,Staff,0,0,0,0
1745136374295,AWP 10,020,886170,Staff,0,0,0,0
1745136374295,AWP 10,021,886172,Staff,0,0,0,0
1745136375324,AWP 10R,001,886173,Staff,0,0,0,0
1745136375324,AWP 10R,002,886174,Staff,0,1,0,0
1745136375324,AWP 10R,003,886175,Staff,0,0,0,0
1745136375324,AWP 10R,004,886176,Staff,0,0,0,0
1745136375324,AWP 10R,005,886177,Staff,0,0,0,0
1745136375324,AWP 10R,006,886178,Staff,0,0,0,0
1745136375324,AWP 10R,007,886179,Staff,0,0,0,0
1745136375324,AWP 10R,008,886181,Staff,0,0,0,0
1745136375324,AWP 10R,009,886182,Staff,0,0,0,0
1745136375324,AWP 10R,010,886183,Staff,0,0,0,0
1745136375324,AWP 10R,011,886184,Staff,0,0,0,0
1745136375324,AWP 10R,012,886185,Staff,0,0,0,0
1745136375324,AWP 10R,013,886186,Staff,0,0,0,0
1745136375324,AWP 10R,014,886187,Staff,0,0,0,0
1745136375324,AWP 10R,015,886188,Staff,0,0,0,0
1745136375324,AWP 10R,016,886189,Staff,0,0,0,0
1745136376353,AWP 102R,A00,886190,Staff,0,0,0,0
1745136376353,AWP 102R,B00,886191,Staff,0,0,0,0
1745136377382,BENG 100,A01,886193,Staff,19,0,30,11
1745136378407,BENG 122A,A01,886195,Hasty; Jeff M,20,0,30,10
1745136379436,BENG 166A,A00,886196,Sah; Robert Lie-Yuan,0,3,20,20
1745136380462,BIBC 102,A01,894320,Staff,0,2,46,46
1745136380462,BIBC 102,A02,894321,Staff,0,0,46,46
1745136380462,BIBC 102,A03,894344,Staff,21,0,46,25
1745136380462,BIBC 102,A04,894345,Staff,30,0,47,17
1745136381490,BICD 100R,A01,894365,Smith; Laurie,1,3,58,57
1745136381490,BICD 100R,A02,894366,Smith; Laurie,0,1,58,58
1745136381490,BICD 100R,A03,894367,Smith; Laurie,13,0,59,46
1745136382517,BICD 136,A01,894383,Gustafson-Brown; Cindy,16,0,50,34
1745136383549,BIEB 102,A01,894494,Butler; Shannon Rhey,67,0,130,63
1745136385613,BIEB 150,A01,894617,Wills; Christopher,0,3,13,13
1745136385613,BIEB 150,A02,894631,Wills; Christopher,0,3,13,13
1745136385613,BIEB 150,A03,894937,Wills; Christopher,0,3,13,13
1745136385613,BIEB 150,A04,894946,Wills; Christopher,0,1,11,11
1745136386642,BIEB 194,A00,906141,Kurle; Carolyn M.,14,0,20,6
1745136387672,BILD 1,A01,894154,Staff,8,0,19,11
1745136387672,BILD 1,A02,894155,Staff,15,0,19,4
1745136387672,BILD 1,A03,894160,Staff,18,0,19,1
1745136387672,BILD 1,A04,894161,Staff,16,0,18,2
1745136388702,BILD 2,A01,894168,Staff,0,0,50,50
1745136388702,BILD 2,A02,894169,Staff,0,0,50,50
1745136388702,BILD 2,A03,894179,Staff,27,0,50,23
1745136388702,BILD 2,A04,894203,Staff,42,0,50,8
1745136389729,BILD 3,A01,894213,Staff,24,0,31,7
1745136389729,BILD 3,A02,894214,Staff,28,0,31,3
1745136389729,BILD 3,A03,894235,Staff,30,0,31,1
1745136389729,BILD 3,A04,894236,Staff,29,0,32,3
1745136390760,BILD 4,A01,894253,Reuther; Keefe,12,0,24,12
1745136390760,BILD 4,A02,894258,Reuther; Keefe,19,0,24,5
1745136391789,BILD 5,A01,894276,Reuther; Keefe,40,0,50,10
1745136391789,BILD 5,A02,894277,Reuther; Keefe,48,0,50,2
1745136391789,BILD 5,A03,894290,Reuther; Keefe,47,0,50,3
1745136391789,BILD 5,A04,894291,Reuther; Keefe,50,0,50,0
1745136392819,BILD 24,A01,894297,Pirino; Giorgia,46,0,60,14
1745136393844,BIMM 100,A01,895012,Staff,0,14,0,1
1745136393844,BIMM 100,A02,895013,Staff,0,6,0,2
1745136393844,BIMM 100,A03,895014,Staff,0,7,0,0
1745136393844,BIMM 100,A04,895015,Staff,0,4,0,0
1745136394876,BIMM 101,A01,895017,McDonnell; Lisa Marie,0,2,24,24
1745136394876,BIMM 101,A02,895018,McDonnell; Lisa Marie,0,1,24,24
1745136394876,BIMM 101,B01,895020,McDonnell; Lisa Marie,0,3,24,24
1745136394876,BIMM 101,B02,895021,McDonnell; Lisa Marie,0,2,24,24
1745136395901,BIMM 110,A01,895023,Staff,7,0,25,18
1745136395901,BIMM 110,A02,895024,Staff,11,0,25,14
1745136395901,BIMM 110,A03,895025,Staff,22,0,25,3
1745136395901,BIMM 110,A04,895031,Staff,21,0,25,4
1745136396970,BIMM 120,A01,895114,Gustafson-Brown; Cindy,8,0,28,20
1745136396970,BIMM 120,A02,895126,Gustafson-Brown; Cindy,19,0,27,8
1745136397996,BIPN 100,A01,895130,Yang; Mingyu,13,0,38,25
1745136397996,BIPN 100,A02,895131,Yang; Mingyu,33,0,38,5
1745136397996,BIPN 100,A03,895132,Yang; Mingyu,33,0,38,5
1745136397996,BIPN 100,A04,895133,Yang; Mingyu,30,0,36,6
1745136399025,BIPN 120,A01,895135,Cooke; James Edward,0,3,13,13
1745136399025,BIPN 120,A02,895136,Cooke; James Edward,0,1,13,13
1745136399025,BIPN 120,A03,895137,Cooke; James Edward,0,0,13,13
1745136399025,BIPN 120,A04,895156,Cooke; James Edward,4,0,11,7
1745136400051,BIPN 134,A01,895235,Cooke; James Edward,0,3,25,25
1745136400051,BIPN 134,A02,895237,Cooke; James Edward,0,0,25,25
1745136400051,BIPN 134,A03,895240,Cooke; James Edward,13,0,25,12
1745136400051,BIPN 134,A04,895270,Cooke; James Edward,24,0,25,1
1745136401079,BIPN 189,A00,892103,Staff,0,20,9,9
1745136403131,CAT 124,A01,922009,Staff,0,1,20,20
1745136404164,CAT 125R,A00,886390,Morales; Celeste Georgianna,4,0,20,16
1745136404164,CAT 125R,B00,886391,Irwin; Matthew Joseph,0,1,20,20
1745136404164,CAT 125R,C00,886392,Smith; Lauryn Alissa,11,0,20,9
1745136404164,CAT 125R,D00,886393,Vanderschuit; Maya Alysia,6,0,20,14
1745136404164,CAT 125R,E00,886394,Marchisotto; Jennifer Anne,0,2,20,20
1745136405193,CENG 15,A01,886218,Drews; Aaron,1,0,5,4
1745136406220,CENG 113,A00,886219,Opatkiewicz; Justin Paul,16,0,25,9
1745136407248,CGS 101,A00,887044,Staff,13,0,20,7
1745136408272,CGS 105,A01,887046,Staff,16,0,25,9
1745136409297,CGS 112,A00,887047,Cuong; Marisol,12,0,15,3
1745136410322,CGS 113,A00,887048,Staff,24,0,30,6
1745136411348,CGS 120,A00,887049,Staff,12,0,17,5
1745136412390,CHEM 6A,A01,886336,Lam; Tin Yiu,44,0,50,6
1745136412390,CHEM 6A,A02,886338,Lam; Tin Yiu,43,0,50,7
1745136413417,CHEM 6B,A01,886341,Hopkins; Patrycja Anna,21,0,50,29
1745136413417,CHEM 6B,A02,886343,Hopkins; Patrycja Anna,46,0,50,4
1745136414444,CHEM 6C,A01,886346,Albizati; Kim F.,0,1,50,50
1745136414444,CHEM 6C,A02,886348,Albizati; Kim F.,38,0,50,12
1745136415470,CHEM 40A,A01,886352,Klosterman; Jeremy K,70,0,100,30
1745136416502,CHEM 40B,A01,886356,Klosterman; Jeremy K,0,4,100,100
1745136417529,CHEM 41B,A01,886360,Theodorakis; Emmanuel,30,0,50,20
1745136417529,CHEM 41B,A02,886362,Theodorakis; Emmanuel,46,0,50,4
1745136418555,CHIN 165A,A00,886382,Xu; Li,19,0,20,1
1745136419582,CLAS 120,A00,886387,Myerston Santana; Jacobo,36,0,40,4
1745136420610,COGS 9,A01,886967,Shannon; Kyle Michael,49,0,60,11
1745136421636,COGS 11,A01,886969,Staff,18,0,30,12
1745136422661,COGS 14A,A01,886971,Staff,26,0,60,34
1745136423687,COGS 14B,A01,886973,Hoffman; Drew Ellen,18,0,60,42
1745136424714,COGS 18,A01,886975,Morgan; Eric,41,0,60,19
1745136425745,COGS 20,A01,886977,Staff,6,0,8,2
1745136425745,COGS 20,A02,886978,Staff,6,0,7,1
1745136426771,COGS 100,A01,907783,Staff,6,0,30,24
1745136427801,COGS 101B,A01,886980,Staff,0,10,30,30
1745136428827,COGS 101C,A01,886982,Delgado; Tania,0,6,30,30
1745136429857,COGS 102A,A01,886984,Johnson; Christine M.,13,0,30,17
1745136430886,COGS 118B,A01,886986,Staff,0,25,60,60
1745136431913,COGS 150,A01,886988,Bergen; Benjamin,16,0,30,14
1745136432939,COGS 153,A00,886989,Delgado; Tania,0,6,30,30
1745136433965,COGS 186,A01,886991,Staff,3,0,30,27
1745136434994,COGS 187A,A01,886993,Boyle; Mary E. T.,12,0,30,18
1745136436021,COGS 189,A00,886994,Staff,13,0,30,17
1745136437050,COMM 10,A01,886996,Staff,11,0,25,14
1745136437050,COMM 10,A02,886997,Staff,21,0,25,4
1745136438079,COMM 20,A01,886999,Leuning; Grant Maurstad,33,0,40,7
1745136440133,COMM 100A,A01,887002,Staff,0,0,25,25
1745136440133,COMM 100A,A02,887003,Staff,20,0,25,5
1745136441157,COMM 100B,A01,887005,Staff,0,1,25,25
1745136442184,COMM 106D,A00,887006,Staff,22,0,40,18
1745136443213,COMM 110G,A00,887007,Whitworth-Smith; Andrew C,17,0,40,23
1745136444237,COMM 111B,A00,887008,Staff,31,0,40,9
1745136445268,COMM 113T,A00,887009,Abuelhiga; Soraya Jill,30,0,40,10
1745136445268,COMM 113T,B00,906733,Staff,40,0,40,0
1745136446293,COMM 145,A00,887010,Staff,21,0,40,19
1745136447320,COMM 146,A00,887054,Staff,31,0,40,9
1745136448344,COMM 190,A00,887012,Staff,9,0,23,14
1745136449371,CSE 8A,A50,887015,Cao; Yingjun,68,0,85,17
1745136450401,CSE 11,A01,887017,Cao; Yingjun,35,0,70,35
1745136451426,CSE 20,A01,887019,Staff,35,0,50,15
1745136452455,CSE 21,A01,887021,Braun; Oliver,81,0,100,19
1745136452455,CSE 21,B01,892583,Staff,48,0,50,2
1745136453483,CSE 30,A01,887025,Eldon; John,161,0,200,39
1745136454511,CSE 100,A01,887027,Staff,28,0,50,22
1745136454511,CSE 100,A02,887028,Staff,43,0,50,7
1745136455536,CSE 101,A01,887030,Braun; Oliver,79,0,100,21
1745136455536,CSE 101,B01,887032,Jones; Miles E,0,1,50,50
1745136455536,CSE 101,B02,887033,Jones; Miles E,13,0,50,37
1745136456562,CSE 105,A01,908084,Jones; Miles E,36,0,50,14
1745136456562,CSE 105,A02,908087,Jones; Miles E,38,0,50,12
1745136457591,CSE 135,A01,887035,Powell; Thomas Allan,8,0,50,42
1745136458620,CSE 142,A01,887037,Staff,22,0,60,38
1745136459646,CSE 142L,A01,887039,Staff,42,0,60,18
1745136460671,CSE 151A,A01,887041,Solares; Edwin A,60,0,100,40
1745136461700,CSE 175,A01,887043,Kumar; Rakesh,30,0,30,0
1745136462725,CSS 1,A01,886389,Staff,12,0,40,28
1745136463749,DSC 30,A01,908097,Liao; Soohyun Nam,54,0,75,21
1745136464774,DSC 40A,A01,908099,Shannon; Kyle Michael,37,0,50,13
1745136465800,DSC 40B,A01,908112,Staff,28,0,50,22
1745136466826,DSC 80,A01,908116,Staff,32,0,60,28
1745136467887,DSC 197,001,956863,Eldridge; Justin Matthew,9999,0,9999,0
1745136468946,ECE 5,A01,886400,Morris; Karcher William,3,0,6,3
1745136468946,ECE 5,A02,886401,Morris; Karcher William,5,0,6,1
1745136469975,ECE 148,A01,886403,Silberman; Jack,0,8,14,14
1745136471001,ECON 1,A01,887265,Crane; Meredith Helen,25,0,70,45
1745136471001,ECON 1,B01,887268,Staff,44,0,50,6
1745136472027,ECON 2,A01,887273,Crane; Meredith Helen,61,0,70,9
1745136473054,ECON 3,A01,887279,Rondina; Giacomo,44,0,70,26
1745136474080,ECON 4,A01,887282,Anderson; John Charles,0,1,10,10
1745136475105,ECON 5,A01,887285,Staff,39,0,45,6
1745136475105,ECON 5,B01,887292,Staff,43,0,45,2
1745136476131,ECON 100A,A01,887337,Newhouse; Herbert S,58,0,70,12
1745136476131,ECON 100A,B01,887349,Staff,45,0,50,5
1745136477160,ECON 100B,A01,887361,Du; Songzi,42,0,70,28
1745136478183,ECON 100C,A01,887445,Newhouse; Herbert S,61,0,70,9
1745136479209,ECON 105,A00,887488,Vespa; Emanuel Ignacio,24,0,35,11
1745136480235,ECON 109,A01,887506,Staff,29,0,35,6
1745136481265,ECON 110A,A01,887568,Alon; Titan Michael,1,0,35,34
1745136481265,ECON 110A,B01,907601,Alon; Titan Michael,27,0,35,8
1745136482296,ECON 110B,A01,887598,Levkoff; Steven B.,0,7,70,70
1745136483325,ECON 112,A00,887599,Rondina; Giacomo,20,0,35,15
1745136484350,ECON 120A,A01,887603,Dai; Yinlin,46,0,70,24
1745136485380,ECON 120C,A01,887608,Sun; Yixiao,0,0,35,35
1745136485380,ECON 120C,B01,887614,Sun; Yixiao,13,0,35,22
1745136486410,ECON 138,A00,887621,Bharadwaj; Prashant,0,18,20,20
1745136487436,ECON 171,A01,907666,Staff,27,0,35,8
1745136488462,ECON 175,A00,887626,Wu; Pak Yeung,27,0,35,8
1745136489487,ECON 190,A00,887640,Vespa; Emanuel Ignacio,26,0,35,9
1745136490522,EDS 25,A01,888197,Staff,0,0,0,0
1745136490522,EDS 25,A02,888209,Staff,0,0,0,0
1745136490522,EDS 25,A03,888210,Staff,0,0,0,0
1745136490522,EDS 25,A04,888212,Staff,0,0,0,0
1745136490522,EDS 25,A05,888213,Staff,0,0,0,0
1745136490522,EDS 25,A06,888214,Staff,0,0,0,0
1745136490522,EDS 25,A07,888235,Staff,0,0,0,0
1745136490522,EDS 25,A08,888236,Staff,0,0,0,0
1745136490522,EDS 25,A09,888240,Staff,0,0,0,0
1745136490522,EDS 25,A10,888244,Staff,0,0,0,0
1745136490522,EDS 25,B01,888273,Staff,0,0,0,0
1745136490522,EDS 25,B02,888285,Staff,0,0,0,0
1745136490522,EDS 25,B03,888423,Staff,29,0,30,1
1745136490522,EDS 25,B04,888432,Staff,0,0,0,0
1745136490522,EDS 25,B05,888433,Staff,0,0,0,0
1745136490522,EDS 25,B06,888467,Staff,0,0,0,0
1745136490522,EDS 25,B07,888468,Staff,0,0,0,0
1745136490522,EDS 25,B08,888479,Staff,0,0,0,0
1745136490522,EDS 25,B09,888484,Staff,0,0,0,0
1745136490522,EDS 25,B10,888487,Staff,0,0,0,0
1745136491551,EDS 38,A01,907700,Choi; Bailey Miyeon,30,0,30,0
1745136492579,EDS 112,A01,888601,Chapman; Thandeka K,23,0,40,17
1745136493609,EDS 115,A00,888697,Mendez; Kathrina Mendoza,17,0,30,13
1745136494635,EDS 116,A01,888893,Staff,38,0,40,2
1745136496685,EDS 124AR,A00,889133,Staff,33,0,50,17
1745136496685,EDS 124AR,B00,907471,Simon; Elizabeth A,42,0,50,8
1745136497712,EDS 124BR,A00,889134,Staff,57,0,100,43
1745136498739,EDS 125,A00,889135,Staff,26,0,30,4
1745136499764,EDS 126,A01,889138,Staff,37,0,40,3
1745136500827,EDS 164R,A01,889142,Wishard Guerra; Alison G.,38,0,50,12
1745136501856,ENG 30,A01,886396,Staff,0,0,0,0
1745136501856,ENG 30,B01,886398,Staff,0,0,0,0
1745136502885,ENVR 102,A00,906150,Montejo; Carolina,23,0,25,2
1745136503909,ETHN 103A,A00,887236,Man; Simeon S,0,5,0,0
1745136504934,ETHN 113,A00,887239,Staff,20,0,30,10
1745136505963,ETHN 116,A00,887240,Staff,20,0,25,5
1745136506990,ETHN 117,A00,887241,Choi; Esther Min,27,0,30,3
1745136508015,ETHN 118,A00,887243,Staff,24,0,30,6
1745136509042,ETHN 127,A00,887248,Cuong; Marisol,12,0,15,3
1745136510068,ETHN 139,A00,887250,Staff,8,0,10,2
1745136511095,ETHN 142,A00,887252,Staff,18,0,30,12
1745136512124,ETHN 161,A00,887253,Browne; Errol Tsekani,28,0,30,2
1745136513151,ETHN 163FR,A00,887255,Burelle; Julie Sara Veronique,4,0,5,1
1745136514177,GLBH 20,A00,889149,Elwardani; Nile Regina,15,0,42,27
1745136516230,GLBH 111,A01,889152,Burgos; Jose L.,17,0,17,0
1745136517255,GLBH 150,A00,889181,Sloane; Julia Kathryn,0,1,15,15
1745136519310,HDS 60,A01,886406,Warstadt; Melissa Fawn,76,0,80,4
1745136520333,HIAF 111,A00,889324,Gyamfi; Bright,0,4,0,0
1745136521359,HIEA 131,A00,889328,Staff,14,0,32,18
1745136522395,HIEA 144,A00,889333,Henry; Todd A.,29,0,32,3
1745136523423,HIEA 154,A00,889336,Henry; Todd A.,28,0,32,4
1745136524450,HIEU 106,A00,889339,Staff,28,0,32,4
1745136526503,HIEU 114,A00,889340,Staff,18,0,32,14
1745136527531,HIEU 135GS,A00,889342,Patterson; Patrick H.,0,0,1,22
1745136528560,HIEU 137,A00,889343,Edington; Claire Ellen,12,0,25,13
1745136529586,HIEU 148,A00,889345,Staff,16,0,32,16
1745136530613,HIEU 154,A00,889346,Biess; Frank Peter,24,0,32,8
1745136531639,HILA 102,A00,889351,Staff,13,0,32,19
1745136532665,HILD 2A,A01,889221,Lewandoski; Julia Mavis,0,5,32,32
1745136533690,HILD 7B,A01,889225,Man; Simeon S,0,7,32,32
1745136534714,HILD 7C,A01,889288,Alvarez; Luis A,0,7,32,32
1745136535740,HILD 30,A01,889323,Staff,0,1,32,32
1745136537797,HISC 119,A00,889383,Golan; Tal,22,0,32,10
1745136538820,HIUS 103,A00,889384,Man; Simeon S,10,0,32,22
1745136539852,HIUS 117,A00,919797,Kwak; Nancy,23,0,32,9
1745136540876,HIUS 142A,A00,919788,Staff,24,0,32,8
1745136542929,HIUS 149,A00,889386,Gyamfi; Bright,0,1,0,0
1745136543953,HIUS 155,A00,889387,Alvarez; Luis A,19,0,32,13
1745136544982,HUM 3,A01,886499,Caldwell; Michael Alan,24,0,50,26
1745136546008,HUM 3GS,A00,886500,Rodriguez; Bretton Sigfred,0,0,0,26
1745136547034,HUM 3R,A01,886502,Markman; Kristina,0,32,50,50
1745136548065,HUM 4,A01,886504,Crum; Matthew Stephen,28,0,50,22
1745136548065,HUM 4,B01,886506,West; Geoffrey Scott,25,0,50,25
1745136549089,HUM 4GS,A00,886507,Staff,0,0,0,13
1745136550115,HUM 5,A01,886509,Staff,35,0,50,15
1745136551145,HUM 5R,A01,886511,Zavodny; Tatiana Sophia,0,32,50,50
1745136552173,JAPN 180,A00,886407,Staff,25,0,40,15
1745136553200,LATI 50,A01,886409,Martin-Cabrera; Luis,9,0,22,13
1745136553200,LATI 50,A02,886410,Martin-Cabrera; Luis,20,0,22,2
1745136553200,LATI 50,A03,886411,Martin-Cabrera; Luis,22,0,22,0
1745136553200,LATI 50,A04,886412,Martin-Cabrera; Luis,15,0,22,7
1745136554226,LAWS 101,A00,907664,Staff,36,0,60,24
1745136555250,LIAB 1A,A00,889388,Saab; Dima,19,0,20,1
1745136556275,LIAB 1AX,A00,889389,El Cheddadi; Youniss,19,0,20,1
1745136557304,LIFR 1C,A00,889391,Van Moer; Vinciane G,9,0,20,11
1745136558333,LIFR 1CX,A00,889392,Van Moer; Vinciane G,8,0,20,12
1745136559359,LIFR 1D,A00,889393,Van Moer; Vinciane G,11,0,20,9
1745136560386,LIFR 1DX,A00,889394,Van Moer; Vinciane G,11,0,20,9
1745136561414,LIGN 7,A00,886923,Staff,30,0,50,20
1745136562440,LIGN 17,A00,886924,Kehler; Andrew Scott,133,0,150,17
1745136563466,LTAM 110,A00,889395,Staff,17,0,30,13
1745136564492,LTCH 101,A00,889397,Staff,22,0,25,3
1745136565519,LTCS 130,A00,889398,Staff,23,0,25,2
1745136566548,LTEA 138,A00,889399,Staff,25,0,40,15
1745136567585,LTEN 149,A00,889400,Wesling; Megan E.,6,0,25,19
1745136568611,LTEN 169,A00,889401,Staff,24,0,25,1
1745136569636,LTEN 180,A00,889402,Staff,12,0,15,3
1745136570664,LTEN 181,A00,889403,Staff,23,0,25,2
1745136571691,LTWL 100,A00,889404,Myerston Santana; Jacobo,8,0,25,17
1745136572717,LTWL 180GS,A00,889405,Staff,6,0,20,14
1745136573745,LTWL 181,A00,889406,Staff,19,0,25,6
1745136574774,LTWL 184,A00,889475,Mukherjee; Silpa,21,0,25,4
1745136575802,LTWR 102C,A00,889486,Staff,29,0,30,1
1745136576828,LTWR 115W,A00,889491,Staff,3,0,15,12
1745136577855,MAE 8,A01,886905,Staff,0,2,0,0
1745136578880,MAE 11,A00,886906,Bandaru; Prabhakar,0,0,50,50
1745136579906,MAE 20,A00,886907,Evdokimenko; Ekaterina,50,0,70,20
1745136580930,MAE 30B,A00,886909,Ghazinejad; Maziar,28,0,45,17
1745136581959,MAE 101B,A00,886910,Saintillan; David,36,0,45,9
1745136582989,MAE 105,A00,886911,Bandaru; Prabhakar,26,0,50,24
1745136584018,MAE 107,A00,886912,Staff,22,0,60,38
1745136585043,MAE 143B,A00,886913,Bewley; Thomas R,14,0,40,26
1745136586132,MAE 148,A01,886915,Silberman; Jack,5,0,14,9
1745136587161,MAE 160,A00,886916,Evdokimenko; Ekaterina,41,0,60,19
1745136588187,MATH 3C,A01,889681,Staff,2,0,30,28
1745136589216,MATH 10A,A01,889760,Staff,28,0,30,2
1745136589216,MATH 10A,A02,889783,Staff,30,0,30,0
1745136590246,MATH 10B,A01,889785,Verstraete; Jacques Allan,0,2,30,30
1745136590246,MATH 10B,A02,889795,Verstraete; Jacques Allan,0,2,30,30
1745136590246,MATH 10B,B01,889797,Verstraete; Jacques Allan,1,0,30,29
1745136590246,MATH 10B,B02,889828,Verstraete; Jacques Allan,23,0,30,7
1745136591272,MATH 10C,A01,889849,Habib; Yousaf,18,0,30,12
1745136591272,MATH 10C,A02,889852,Habib; Yousaf,20,0,30,10
1745136591272,MATH 10C,A03,889853,Habib; Yousaf,25,0,30,5
1745136591272,MATH 10C,A04,889858,Habib; Yousaf,21,0,30,9
1745136591272,MATH 10C,B01,889861,Staff,12,0,30,18
1745136591272,MATH 10C,B02,889862,Staff,26,0,30,4
1745136591272,MATH 10C,B03,889863,Staff,28,0,30,2
1745136591272,MATH 10C,B04,889967,Staff,25,0,30,5
1745136592302,MATH 18,A01,889974,Staff,15,0,30,15
1745136592302,MATH 18,A02,889977,Staff,25,0,30,5
1745136592302,MATH 18,B01,889984,Hardiman; Liam,26,0,30,4
1745136592302,MATH 18,B02,889985,Hardiman; Liam,28,0,30,2
1745136593330,MATH 20A,A01,889990,Suk; Andrew Hoon,31,0,35,4
1745136594357,MATH 20B,A01,889993,Ohm; Ko Woon,21,0,30,9
1745136594357,MATH 20B,A02,889994,Ohm; Ko Woon,30,0,30,0
1745136594357,MATH 20B,B01,889996,Ohm; Ko Woon,25,0,30,5
1745136594357,MATH 20B,B02,889997,Ohm; Ko Woon,24,0,30,6
1745136595383,MATH 20C,A01,889999,Hammock; Frances H,22,0,30,8
1745136595383,MATH 20C,A02,890003,Hammock; Frances H,23,0,30,7
1745136595383,MATH 20C,B01,890006,Hammock; Frances H,11,0,30,19
1745136595383,MATH 20C,B02,890007,Hammock; Frances H,18,0,30,12
1745136596412,MATH 20D,A01,890011,Cheng; Hsiao-Bing,6,0,30,24
1745136596412,MATH 20D,A02,890012,Cheng; Hsiao-Bing,27,0,30,3
1745136596412,MATH 20D,B01,890016,Cheng; Hsiao-Bing,19,0,30,11
1745136596412,MATH 20D,B02,890017,Cheng; Hsiao-Bing,15,0,30,15
1745136597444,MATH 20E,A01,890026,Harel; Guershon,10,0,30,20
1745136597444,MATH 20E,A02,890029,Harel; Guershon,24,0,30,6
1745136597444,MATH 20E,B01,890033,Harel; Guershon,14,0,30,16
1745136597444,MATH 20E,B02,890101,Harel; Guershon,27,0,30,3
1745136598471,MATH 102,A01,890104,Staff,20,0,30,10
1745136598471,MATH 102,A02,890105,Staff,30,0,30,0
1745136599498,MATH 103B,A01,890116,Salehi Golsefidy; Alireza,8,0,30,22
1745136599498,MATH 103B,B01,890118,Staff,0,4,30,30
1745136600528,MATH 109,A01,890121,Aliabadi Sr.; Mohsen,6,0,30,24
1745136600528,MATH 109,B01,890124,Upadrashta; Pranav Kumar,23,0,30,7
1745136601554,MATH 120A,A01,890126,Eggers; John Dietrich,15,0,30,15
1745136602587,MATH 142B,A01,890128,Ioana; Adrian,17,0,30,13
1745136602587,MATH 142B,A02,890129,Ioana; Adrian,15,0,30,15
1745136603612,MATH 154,A01,890174,Staff,0,1,30,30
1745136603612,MATH 154,A02,890182,Staff,15,0,30,15
1745136604638,MATH 168A,A01,890197,Dumitriu; Ioana,22,0,35,13
1745136605664,MATH 170A,A01,890240,Nie; Jiawang,6,0,30,24
1745136605664,MATH 170A,A02,890241,Nie; Jiawang,18,0,30,12
1745136605664,MATH 170A,A03,890249,Nie; Jiawang,23,0,30,7
1745136606695,MATH 170B,A01,957891,Nag; Panchali,25,0,35,10
1745136608750,MATH 181A,A01,908025,Staff,0,8,35,35
1745136609773,MATH 193B,A01,890265,Staff,3,0,35,32
1745136610802,MGT 4,A01,890311,Anderson; John Charles,57,0,88,31
1745136611827,MGT 5,A00,907740,Staff,41,0,98,57
1745136612853,MGT 12,A00,890312,Lindenberger; Wade Douglas,70,0,98,28
1745136613879,MGT 16,A00,957883,Staff,84,0,98,14
1745136615930,MGT 45,A00,890314,Pecore; Joseph P.,57,0,98,41
1745136616953,MGT 71,A00,890315,Staff,6,0,98,92
1745136617979,MGT 100,A00,890316,Yavorsky; Daniel Ryan,59,0,98,39
1745136619004,MGT 103,A00,890317,Ehrich; Kristine R,77,0,98,21
1745136620031,MGT 105,A00,890356,Bates; Kenneth Walter,19,0,98,79
1745136621059,MGT 112,A00,890360,Ehrich; Kristine R,65,0,98,33
1745136622087,MGT 127R,A00,907732,Zhu; Kevin Xiaoguo,32,0,98,66
1745136623113,MGT 131B,A00,890361,Anderson; John Charles,75,0,98,23
1745136624142,MGT 137,A00,890362,Lindenberger; Wade Douglas,68,0,98,30
1745136625172,MGT 160,A00,890369,Johnson; Erik Barry,37,0,98,61
1745136627224,MGT 164,A00,890372,Zimmermann; Carsten,0,28,98,98
1745136628252,MGT 180,A00,890374,Bliss; Barbara Ann,32,0,98,66
1745136629278,MMW 15,A01,886414,Chang; Edmond Yi-Teh,0,10,28,28
1745136629278,MMW 15,A02,886415,Chang; Edmond Yi-Teh,0,10,28,28
1745136629278,MMW 15,A03,886416,Chang; Edmond Yi-Teh,0,8,28,28
1745136629278,MMW 15,A04,886417,Chang; Edmond Yi-Teh,0,8,28,28
1745136629278,MMW 15,B01,886419,Chang; Edmond Yi-Teh,0,8,28,28
1745136629278,MMW 15,B02,886420,Chang; Edmond Yi-Teh,0,9,28,28
1745136629278,MMW 15,B03,886421,Chang; Edmond Yi-Teh,0,9,28,28
1745136629278,MMW 15,B04,886422,Chang; Edmond Yi-Teh,0,9,28,28
1745136629278,MMW 15,C01,886424,Staff,0,10,28,28
1745136629278,MMW 15,C02,886425,Staff,0,10,28,28
1745136629278,MMW 15,C03,886426,Staff,0,9,28,28
1745136629278,MMW 15,C04,886427,Staff,0,9,28,28
1745136630304,MMW 15GS,A00,906910,Patterson; Patrick H.,5,0,28,23
1745136631331,MMW 122R,A01,886429,Rahimi; Babak,0,23,28,28
1745136631331,MMW 122R,A02,886430,Rahimi; Babak,0,23,28,28
1745136632358,MUS 1A,A01,890937,Staff,8,0,25,17
1745136632358,MUS 1A,A02,891035,Staff,15,0,25,10
1745136632358,MUS 1A,B00,907849,Staff,48,0,50,2
1745136632358,MUS 1A,B01,907850,Staff,25,0,25,0
1745136632358,MUS 1A,B02,907851,Staff,25,0,25,0
1745136634410,MUS 2AK,A00,957092,Ohnishi; Takae,15,0,15,0
1745136635435,MUS 4,A01,891044,Staff,6,0,25,19
1745136635435,MUS 4,A02,891045,Staff,24,0,25,1
1745136635435,MUS 4,B01,891048,Staff,20,0,25,5
1745136635435,MUS 4,B02,891050,Staff,25,0,25,0
1745136636463,MUS 5,A01,957506,Dubnov; Shlomo,4,0,25,21
1745136636463,MUS 5,A02,957622,Dubnov; Shlomo,21,0,25,4
1745136636463,MUS 5,A03,957623,Dubnov; Shlomo,23,0,25,2
1745136637489,MUS 6,A01,891053,Freitas Caetano; Marcelo,23,0,25,2
1745136637489,MUS 6,A02,891054,Freitas Caetano; Marcelo,23,0,25,2
1745136638520,MUS 7,A01,891081,Staff,0,0,25,25
1745136638520,MUS 7,A02,891082,Staff,15,0,25,10
1745136639606,MUS 8GS,A00,891118,Borgo; David Garcia,5,0,25,20
1745136640631,MUS 11,A01,891140,Staff,12,0,25,13
1745136640631,MUS 11,A02,891141,Staff,24,0,25,1
1745136641658,MUS 13,A01,891143,Staff,10,0,25,15
1745136641658,MUS 13,A02,891144,Staff,25,0,25,0
1745136642684,MUS 15,A01,891146,Staff,7,0,25,18
1745136642684,MUS 15,A02,891148,Staff,22,0,25,3
1745136642684,MUS 15,B01,891150,Staff,18,0,25,7
1745136642684,MUS 15,B02,891151,Staff,25,0,25,0
1745136643710,MUS 20,A01,891153,Staff,9,0,20,11
1745136643710,MUS 20,A02,891155,Staff,16,0,20,4
1745136644737,MUS 80,A00,891156,Staff,19,0,25,6
1745136644737,MUS 80,B00,891157,Staff,25,0,25,0
1745136645763,MUS 130,A00,891158,Ohnishi; Takae,35,0,35,0
1745136646789,MUS 150GS,A01,891160,Borgo; David Garcia,5,0,25,20
1745136647815,MUS 170,A01,891162,Freitas Caetano; Marcelo,21,0,25,4
1745136647815,MUS 170,A02,891164,Freitas Caetano; Marcelo,22,0,25,3
1745136648842,NANO 11,A00,886220,Vazquez Mena; Oscar,12,0,15,3
1745136649873,NANO 15,A01,886222,Drews; Aaron,9,0,10,1
1745136650900,NANO 104,A00,886224,Sirbuly; Donald,18,0,25,7
1745136651927,PH 40,A00,886528,Staff,29,0,40,11
1745136652952,PH 45,A01,886799,Staff,36,0,40,4
1745136653976,PH 110,A00,886802,Staff,7,0,40,33
1745136655000,PH 172,A00,906716,Staff,20,0,35,15
1745136656027,PH 191,A00,886803,Staff,23,0,40,17
1745136657054,PHIL 1,A00,889500,Staff,22,0,30,8
1745136658081,PHIL 10,A01,889549,Grush; Rick Scott,17,0,22,5
1745136658081,PHIL 10,A02,889551,Grush; Rick Scott,20,0,22,2
1745136659158,PHIL 28,A01,889559,Lamey; Andy M.,0,4,25,25
1745136659158,PHIL 28,A02,889561,Lamey; Andy M.,0,0,25,25
1745136659158,PHIL 28,A03,889572,Lamey; Andy M.,7,0,25,18
1745136660185,PHIL 35,A00,907839,Staff,32,0,33,1
1745136661213,PHIL 60,A00,889574,Staff,79,0,90,11
1745136662240,PHIL 105,A00,889579,Staff,0,1,0,0
1745136663264,PHIL 136,A00,889582,Fulkerson; Matthew Todd,27,0,45,18
1745136664291,PHIL 163,A01,889601,Staff,24,0,30,6
1745136664291,PHIL 163,B01,889606,Brandt; Reuven A,0,2,0,0
1745136665319,PHIL 164,A00,889610,Staff,20,0,30,10
1745136666345,PHIL 165,A00,889613,Staff,26,0,30,4
1745136667373,PHYS 1A,A00,886431,Staff,38,0,70,32
1745136668405,PHYS 1AL,001,886432,Tsai; Philbert S,0,0,30,30
1745136668405,PHYS 1AL,002,886436,Tsai; Philbert S,19,0,30,11
1745136669429,PHYS 1B,A00,886439,Staff,192,0,240,48
1745136670456,PHYS 1BL,001,886441,Tsai; Philbert S,0,1,30,30
1745136670456,PHYS 1BL,002,886444,Tsai; Philbert S,14,0,30,16
1745136671485,PHYS 1C,A00,896092,Arnold; Kam S,87,0,146,59
1745136672512,PHYS 1CL,001,886448,Tsai; Philbert S,0,4,30,30
1745136672512,PHYS 1CL,002,886449,Tsai; Philbert S,6,0,30,24
1745136672512,PHYS 1CL,003,886450,Tsai; Philbert S,22,0,30,8
1745136672512,PHYS 1CL,004,886451,Tsai; Philbert S,16,0,30,14
1745136673542,PHYS 2B,A01,886457,Staff,86,0,115,29
1745136674572,PHYS 2C,A01,886460,Shotwell; Brian,0,0,65,65
1745136675601,PHYS 2CL,A01,886467,Staff,0,3,28,28
1745136675601,PHYS 2CL,A02,886468,Staff,5,0,28,23
1745136676628,PHYS 2D,A01,886470,Staff,17,0,50,33
1745136677657,PHYS 4B,A01,886475,Grinstein; Benjamin,88,0,100,12
1745136678681,POLI 5,A00,891173,Desposato; Scott,17,0,25,8
1745136679712,POLI 5D,A01,891175,Staff,5,0,5,0
1745136679712,POLI 5D,B01,891178,Staff,5,0,5,0
1745136680741,POLI 11,A00,891179,Ferree; Karen E,3,0,25,22
1745136681765,POLI 12,A00,891180,Staff,21,0,30,9
1745136682793,POLI 27,A01,891182,Staff,29,0,75,46
1745136683818,POLI 30,A00,891183,Staff,0,3,30,30
1745136684845,POLI 100B,A00,891244,Staff,0,8,20,20
1745136685869,POLI 100I,A00,891247,Staff,19,0,30,11
1745136686894,POLI 104J,A00,891248,Nichter; Maysa,18,0,30,12
1745136687921,POLI 104U,A00,891250,Nichter; Maysa,9,0,30,21
1745136688947,POLI 108,A00,891253,Staff,0,0,0,4
1745136689974,POLI 110B,A00,891255,Wiens; David,22,0,25,3
1745136691002,POLI 112A,A00,891256,Wiens; David,15,0,25,10
1745136692031,POLI 114BR,A00,891261,Staff,22,0,30,8
1745136693057,POLI 117R,A00,891262,Forman; Fonna,12,0,50,38
1745136694084,POLI 118,A00,891264,Ingham; Sean,22,0,25,3
1745136695108,POLI 124A,A00,891265,Staff,19,0,20,1
1745136696135,POLI 125D,A00,891266,Nichter; Simeon C,9,0,25,16
1745136697163,POLI 126,A00,891268,Nichter; Simeon C,11,0,25,14
1745136698188,POLI 126AA,A00,891272,Staff,19,0,25,6
1745136699214,POLI 130AA,A00,891273,Staff,17,0,20,3
1745136700237,POLI 134AA,A00,891274,Staff,12,0,20,8
1745136702290,POLI 138,A00,891278,Staff,22,0,25,3
1745136703317,POLI 142K,A00,891280,Staff,17,0,25,8
1745136704342,POLI 142M,A00,891281,Gartzke; Erik,22,0,30,8
1745136705369,POLI 142P,A00,891284,Staff,21,0,30,9
1745136706395,POLI 143,A00,891285,Gartzke; Erik,17,0,30,13
1745136707422,POLI 153,A00,891286,Staff,20,0,20,0
1745136708447,POLI 170A,A00,891288,Staff,19,0,25,6
1745136709473,POLI 175,A00,891290,Staff,18,0,20,2
1745136710502,PSYC 1,A00,890674,Steiner; Eric Tomas,0,4,45,45
1745136711531,PSYC 2,A00,890676,Albright; Thomas D,25,0,35,10
1745136712560,PSYC 3,A00,890679,Staff,18,0,20,2
1745136713589,PSYC 60,A01,890684,Rickard; Timothy C.,7,0,45,38
1745136714620,PSYC 70,A01,890689,Geller; Emma Harlan,14,0,30,16
1745136715648,PSYC 100,A00,890690,Lacefield; Katharine I,0,43,180,180
1745136716674,PSYC 102,A00,890695,Staff,26,0,40,14
1745136717702,PSYC 105,A00,890699,Geller; Emma Harlan,78,0,100,22
1745136718731,PSYC 106,A00,890701,Gorman; Michael R.,15,0,30,15
1745136719760,PSYC 108,A00,890704,Adrian; Julia Anna,0,23,50,50
1745136720787,PSYC 118,A01,890712,Staff,18,0,30,12
1745136721813,PSYC 124,A00,890716,Chapman; Eddie Nathaniel,36,0,60,24
1745136722840,PSYC 131,A00,890717,Anagnostaras; Stephan,6,0,80,74
1745136723868,PSYC 137,A00,890719,Winkielman; Piotr,0,2,30,30
1745136724898,PSYC 144,A00,890721,Adrian; Julia Anna,0,3,45,45
1745136725928,PSYC 162,A00,890805,Staff,21,0,75,54
1745136726956,PSYC 169,A00,890810,Staff,0,15,30,30
1745136727983,PSYC 172,A00,890814,Gorman; Michael R.,14,0,30,16
1745136729012,PSYC 181,A00,890818,Anagnostaras; Stephan,63,0,200,137
1745136730039,PSYC 189,A00,890823,Staff,11,0,30,19
1745136731066,PSYC 191,A00,890884,Rickard; Timothy C.,0,11,35,35
1745136732089,PSYC 193,A00,890913,Staff,22,0,30,8
1745136732089,PSYC 193,B00,890914,Chapman; Eddie Nathaniel,25,0,30,5
1745136733120,PSYC 193L,A01,890918,Lowe; Angela Beth,29,0,30,1
1745136733120,PSYC 193L,B01,890921,Hurwitz; Ethan Scott,28,0,30,2
1745136733120,PSYC 193L,C01,890928,Staff,30,0,30,0
1745136734145,RELI 149,A00,886806,Rahimi; Babak,23,0,40,17
1745136735174,SE 9,A01,886814,Staff,13,0,20,7
1745136736201,SE 101B,A01,886816,Chadha; Mayank,8,0,30,22
1745136737230,SE 110B,A00,886818,Zhu; Qiang,0,16,45,45
1745136738258,SE 125,A01,886830,Staff,10,0,30,20
1745136739288,SE 130B,A01,886835,Staff,19,0,40,21
1745136740315,SE 131A,A01,886838,Krysl; Petr,37,0,55,18
1745136741343,SE 154,A00,886840,Staff,35,0,50,15
1745136742379,SE 164GS,A01,886849,Staff,13,0,20,7
1745136743408,SE 167GS,A01,886853,Staff,13,0,20,7
1745136744437,SIO 25,A01,890107,Staff,23,0,30,7
1745136745466,SIO 45,A00,890109,Cook; Geoffrey W,137,0,200,63
1745136746495,SIO 109R,A00,890110,Forman; Fonna,0,11,20,20
1745136747521,SIO 187,A01,890114,Kacev; David,21,0,40,19
1745136748550,SOCI 1,A01,890431,Thorpe; Charles Robert,21,0,30,9
1745136748550,SOCI 1,A02,890518,Thorpe; Charles Robert,30,0,30,0
1745136749579,SOCI 2,A01,957978,Staff,0,0,0,0
1745136749579,SOCI 2,A02,957979,Staff,0,3,0,0
1745136750606,SOCI 20,A01,890523,Calderon-Zaks; Michael Aar,24,0,30,6
1745136750606,SOCI 20,A02,890526,Calderon-Zaks; Michael Aar,29,0,30,1
1745136751637,SOCI 30,A01,890533,Pardo Guerra; Juan Pablo,37,0,40,3
1745136752666,SOCI 40,A01,890535,Staff,32,0,45,13
1745136753694,SOCI 104Q,A00,890559,Staff,20,0,30,10
1745136754724,SOCI 106,A00,890560,Arnal; Maud Marie Leonie,22,0,30,8
1745136755755,SOCI 110,A00,890567,Holkenbrink-Monk; Charlene,22,0,30,8
1745136756780,SOCI 112,A00,890568,Victoria Torres; Pablo,0,0,45,45
1745136757809,SOCI 115,A00,890597,Arnal; Maud Marie Leonie,33,0,45,12
1745136759867,SOCI 121,A00,890604,Pardo Guerra; Juan Pablo,40,0,45,5
1745136760893,SOCI 126,A01,890608,Staff,8,0,10,2
1745136761922,SOCI 127,A00,890609,Staff,23,0,30,7
1745136762948,SOCI 131,A00,890610,Thorpe; Charles Robert,38,0,45,7
1745136763976,SOCI 135,A00,890615,Payne; Christine Anna,20,0,45,25
1745136765003,SOCI 139,A00,890620,Staff,43,0,45,2
1745136766029,SOCI 148E,A00,890622,Calderon-Zaks; Michael Aar,39,0,45,6
1745136767059,SOCI 150,A00,890623,Kohler; Kristopher M.,36,0,45,9
1745136768082,SOCI 157,A00,890625,Jules-Rosette; Bennetta W.,18,0,20,2
1745136769109,SOCI 160,A00,890627,Payne; Christine Anna,26,0,45,19
1745136770136,SYN 1,A00,886855,Fish; Gwendolyn Anne,0,0,0,0
1745136770136,SYN 1,B00,906086,Fish; Gwendolyn Anne,0,0,0,2
1745136771162,SYN 2R,A00,886860,Staff,0,15,15,15
1745136771162,SYN 2R,B00,906106,Atkinson; Arthur Laird,0,14,15,15
1745136772191,SYN 100,A01,886866,Browne; Emily,0,29,20,20
1745136772191,SYN 100,B01,906128,Rock; Martin,0,4,20,20
1745136772191,SYN 100,C01,906140,Deavenport; James Cary,0,2,20,20
1745136772191,SYN 100,D01,907816,Deavenport; James Cary,0,3,20,20
1745136773216,TDAC 1,A00,890286,Walsh; Kim C.,11,0,20,9
1745136774242,TDAC 101,A00,890296,Basso; Beatrice,18,0,20,2
1745136775267,TDDE 131,A00,890297,Staff,47,0,50,3
1745136776293,TDDM 1,A00,890287,Weinberg; Sadie,26,0,30,4
1745136777323,TDGE 11,A00,890288,Fulton; Julia,155,0,200,45
1745136777323,TDGE 11,B00,890289,Castro; Robert Jess,188,0,200,12
1745136778349,TDGE 25,B00,957359,Walsh; Kim C.,9,0,20,11
1745136779376,TDGE 40,A01,890292,Power; Jade Yukana,28,0,30,2
1745136780401,TDGE 124,A00,890298,Havis; Allan,12,0,50,38
1745136781428,TDGE 131R,A00,890299,Burelle; Julie Sara Veronique,20,0,42,22
1745136782453,TDHT 101,A00,890300,Staff,12,0,20,8
1745136783477,TDHT 109,A01,890302,Anderson; Mysia Anyse,31,0,40,9
1745136784507,TDMV 1,A00,890293,Arcidiacono; Kristin,20,0,30,10
1745136785534,TDMV 2,A00,890294,Weinberg; Sadie,26,0,30,4
1745136786562,TDMV 3,A00,957878,Arcidiacono; Kristin,27,0,30,3
1745136788614,TDMV 138,A00,890304,Jun; Grace Shin Hae,25,0,40,15
1745136789639,TDMV 140,A00,890305,Corrales; Joseph Bernales,28,0,30,2
1745136790669,TDMV 142,A00,890307,Caligagan; Tony,30,0,40,10
1745136791697,TDMV 144,A00,890308,Camaya; Michelle Ann,26,0,30,4
1745136792722,TDPW 1,A00,890295,Stein; Deborah Isobel,5,0,20,15
1745136793749,USP 2,A01,890272,Lerner; Amy M,8,0,20,12
1745136794775,USP 3,A01,890274,Staff,21,0,30,9
1745136795803,USP 15,A01,890276,Sun; Feiyang,21,0,30,9
1745136796828,USP 25,A00,890277,Shenkman; Michael Thomas,21,0,25,4
1745136797854,USP 138,A00,890278,Staff,15,0,25,10
1745136798879,USP 143,A00,890279,Staff,30,0,70,40
1745136799906,USP 144,A00,890280,Chowdhury; Muhammed Zohir,19,0,30,11
1745136800935,USP 150,A00,890281,Boomhower; Matthew Charles,19,0,30,11
1745136801962,USP 151,A00,890282,Staff,17,0,20,3
1745136802986,USP 162,A00,890283,Andrews; Abigail Leslie,17,0,20,3
1745136804012,USP 168,A00,920477,Kwak; Nancy,2,0,5,3
1745136805041,USP 181,A00,890284,Staff,11,0,20,9
1745136806068,USP 191A,A00,890285,Staff,15,0,20,5
1745136807091,VIS 101,A00,886512,Staff,37,0,75,38
1745136808119,VIS 103,A00,886513,Cruz; Edwin Teddy,65,0,75,10
1745136809145,VIS 108,A00,886514,Staff,7,0,15,8
1745136810169,VIS 127P,A00,886515,Shen; Kuiyi,92,0,146,54
1745136811198,VIS 149,A00,886516,Yoldas; Pinar,1,0,15,14
1745136812226,VIS 164,A00,886526,Erdmann; Dean,21,0,22,1
1745136813254,VIS 194S,A00,886527,Staff,61,0,75,14
1745136814283,WCWP 10A,C00,886484,Staff,13,0,15,2
1745136815312,WCWP 10B,A00,886490,Staff,5,0,15,10
1745136815312,WCWP 10B,B00,886491,Staff,0,1,0,0
1745136815312,WCWP 10B,C00,886492,Staff,10,0,15,5
1745136816337,WCWP 100,A00,886494,Staff,0,2,15,15
1745136818512,AAS 10,A01,886199,Childs; Dennis R.,0,2,0,0
1745136819539,ANAR 104,A01,886940,Shtienberg; Gilad,27,0,30,3
1745136820566,ANAR 120,A00,886953,Staff,13,0,20,7
1745136821592,ANBI 148,A01,886955,Wilder; Linnea Lorene,32,0,40,8
1745136823642,ANSC 122,A00,886957,Staff,28,0,30,2
1745136824668,ANSC 150,A00,886958,Sloane; Julia Kathryn,6,0,15,9
1745136825692,ANSC 156,A00,886959,Jenkins; Janis A.,2,0,15,13
1745136826717,ANSC 180,A00,886960,Staff,12,0,17,5
1745136827743,ANSC 188,A00,886961,Jassal; Aftab,10,0,25,15
1745136828771,ANSC 190,A00,886962,Jassal; Aftab,14,0,25,11
1745136829799,ANSC 191,A00,886963,Staff,18,0,20,2
1745136830825,ANTH 3,A01,891689,Staff,19,0,20,1
1745136831852,ANTH 5,A00,886933,Semendeferi; Ekaterini,18,0,20,2
1745136832880,ANTH 10,A00,886934,Staff,0,8,30,30
1745136833905,ANTH 21,A01,886936,Staff,44,0,60,16
1745136834935,ANTH 23,A01,886938,Staff,94,0,100,6
1745136835964,ANTH 105,A00,886964,Stewart; Alexander B,94,0,100,6
1745136836989,ANTH 108,A00,886965,Pedersen; David,10,0,20,10
1745136838020,AWP 10,001,886147,Staff,0,0,0,0
1745136838020,AWP 10,002,886148,Staff,0,0,0,0
1745136838020,AWP 10,003,886149,Staff,0,0,0,0
1745136838020,AWP 10,004,886150,Staff,0,0,0,0
1745136838020,AWP 10,005,886151,Staff,0,0,0,0
1745136838020,AWP 10,006,886152,Staff,0,0,0,0
1745136838020,AWP 10,007,886153,Staff,0,0,0,0
1745136838020,AWP 10,008,886154,Staff,0,0,0,0
1745136838020,AWP 10,009,886155,Staff,0,0,0,0
1745136838020,AWP 10,010,886156,Staff,0,0,0,0
1745136838020,AWP 10,011,886158,Staff,0,0,0,0
1745136838020,AWP 10,012,886160,Staff,0,0,0,0
1745136838020,AWP 10,013,886161,Staff,0,0,0,0
1745136838020,AWP 10,014,886162,Staff,0,0,0,0
1745136838020,AWP 10,015,886163,Staff,0,0,0,0
1745136838020,AWP 10,016,886164,Staff,0,0,0,0
1745136838020,AWP 10,017,886165,Staff,0,0,0,0
1745136838020,AWP 10,018,886166,Staff,0,0,0,0
1745136838020,AWP 10,019,886168,Staff,0,0,0,0
1745136838020,AWP 10,020,886170,Staff,0,0,0,0
1745136838020,AWP 10,021,886172,Staff,0,0,0,0
1745136839051,AWP 10R,001,886173,Staff,0,0,0,0
1745136839051,AWP 10R,002,886174,Staff,0,1,0,0
1745136839051,AWP 10R,003,886175,Staff,0,0,0,0
1745136839051,AWP 10R,004,886176,Staff,0,0,0,0
1745136839051,AWP 10R,005,886177,Staff,0,0,0,0
1745136839051,AWP 10R,006,886178,Staff,0,0,0,0
1745136839051,AWP 10R,007,886179,Staff,0,0,0,0
1745136839051,AWP 10R,008,886181,Staff,0,0,0,0
1745136839051,AWP 10R,009,886182,Staff,0,0,0,0
1745136839051,AWP 10R,010,886183,Staff,0,0,0,0
1745136839051,AWP 10R,011,886184,Staff,0,0,0,0
1745136839051,AWP 10R,012,886185,Staff,0,0,0,0
1745136839051,AWP 10R,013,886186,Staff,0,0,0,0
1745136839051,AWP 10R,014,886187,Staff,0,0,0,0
1745136839051,AWP 10R,015,886188,Staff,0,0,0,0
1745136839051,AWP 10R,016,886189,Staff,0,0,0,0
1745136840080,AWP 102R,A00,886190,Staff,0,0,0,0
1745136840080,AWP 102R,B00,886191,Staff,0,0,0,0
1745136841109,BENG 100,A01,886193,Staff,19,0,30,11
1745136842134,BENG 122A,A01,886195,Hasty; Jeff M,20,0,30,10
1745136843158,BENG 166A,A00,886196,Sah; Robert Lie-Yuan,0,3,20,20
1745136844183,BIBC 102,A01,894320,Staff,0,2,46,46
1745136844183,BIBC 102,A02,894321,Staff,0,0,46,46
1745136844183,BIBC 102,A03,894344,Staff,21,0,46,25
1745136844183,BIBC 102,A04,894345,Staff,30,0,47,17
1745136845208,BICD 100R,A01,894365,Smith; Laurie,1,3,58,57
1745136845208,BICD 100R,A02,894366,Smith; Laurie,0,1,58,58
1745136845208,BICD 100R,A03,894367,Smith; Laurie,13,0,59,46
1745136846232,BICD 136,A01,894383,Gustafson-Brown; Cindy,16,0,50,34
1745136847263,BIEB 102,A01,894494,Butler; Shannon Rhey,67,0,130,63
1745136849320,BIEB 150,A01,894617,Wills; Christopher,0,3,13,13
1745136849320,BIEB 150,A02,894631,Wills; Christopher,0,3,13,13
1745136849320,BIEB 150,A03,894937,Wills; Christopher,0,3,13,13
1745136849320,BIEB 150,A04,894946,Wills; Christopher,0,1,11,11
1745136850385,BIEB 194,A00,906141,Kurle; Carolyn M.,14,0,20,6
1745136851412,BILD 1,A01,894154,Staff,8,0,19,11
1745136851412,BILD 1,A02,894155,Staff,15,0,19,4
1745136851412,BILD 1,A03,894160,Staff,18,0,19,1
1745136851412,BILD 1,A04,894161,Staff,16,0,18,2
1745136852441,BILD 2,A01,894168,Staff,0,0,50,50
1745136852441,BILD 2,A02,894169,Staff,0,0,50,50
1745136852441,BILD 2,A03,894179,Staff,27,0,50,23
1745136852441,BILD 2,A04,894203,Staff,42,0,50,8
1745136853469,BILD 3,A01,894213,Staff,24,0,31,7
1745136853469,BILD 3,A02,894214,Staff,28,0,31,3
1745136853469,BILD 3,A03,894235,Staff,30,0,31,1
1745136853469,BILD 3,A04,894236,Staff,29,0,32,3
1745136854494,BILD 4,A01,894253,Reuther; Keefe,12,0,24,12
1745136854494,BILD 4,A02,894258,Reuther; Keefe,19,0,24,5
1745136855526,BILD 5,A01,894276,Reuther; Keefe,40,0,50,10
1745136855526,BILD 5,A02,894277,Reuther; Keefe,48,0,50,2
1745136855526,BILD 5,A03,894290,Reuther; Keefe,47,0,50,3
1745136855526,BILD 5,A04,894291,Reuther; Keefe,50,0,50,0
1745136856550,BILD 24,A01,894297,Pirino; Giorgia,46,0,60,14
1745136857576,BIMM 100,A01,895012,Staff,0,14,0,1
1745136857576,BIMM 100,A02,895013,Staff,0,6,0,2
1745136857576,BIMM 100,A03,895014,Staff,0,7,0,0
1745136857576,BIMM 100,A04,895015,Staff,0,4,0,0
1745136858604,BIMM 101,A01,895017,McDonnell; Lisa Marie,0,2,24,24
1745136858604,BIMM 101,A02,895018,McDonnell; Lisa Marie,0,1,24,24
1745136858604,BIMM 101,B01,895020,McDonnell; Lisa Marie,0,3,24,24
1745136858604,BIMM 101,B02,895021,McDonnell; Lisa Marie,0,2,24,24
1745136859631,BIMM 110,A01,895023,Staff,7,0,25,18
1745136859631,BIMM 110,A02,895024,Staff,11,0,25,14
1745136859631,BIMM 110,A03,895025,Staff,22,0,25,3
1745136859631,BIMM 110,A04,895031,Staff,21,0,25,4
1745136860657,BIMM 120,A01,895114,Gustafson-Brown; Cindy,8,0,28,20
1745136860657,BIMM 120,A02,895126,Gustafson-Brown; Cindy,19,0,27,8
1745136861684,BIPN 100,A01,895130,Yang; Mingyu,13,0,38,25
1745136861684,BIPN 100,A02,895131,Yang; Mingyu,33,0,38,5
1745136861684,BIPN 100,A03,895132,Yang; Mingyu,33,0,38,5
1745136861684,BIPN 100,A04,895133,Yang; Mingyu,30,0,36,6
1745136862711,BIPN 120,A01,895135,Cooke; James Edward,0,3,13,13
1745136862711,BIPN 120,A02,895136,Cooke; James Edward,0,1,13,13
1745136862711,BIPN 120,A03,895137,Cooke; James Edward,0,0,13,13
1745136862711,BIPN 120,A04,895156,Cooke; James Edward,4,0,11,7
1745136863738,BIPN 134,A01,895235,Cooke; James Edward,0,3,25,25
1745136863738,BIPN 134,A02,895237,Cooke; James Edward,0,0,25,25
1745136863738,BIPN 134,A03,895240,Cooke; James Edward,13,0,25,12
1745136863738,BIPN 134,A04,895270,Cooke; James Edward,24,0,25,1
1745136864763,BIPN 189,A00,892103,Staff,0,20,9,9
1745136866817,CAT 124,A01,922009,Staff,0,1,20,20
1745136867844,CAT 125R,A00,886390,Morales; Celeste Georgianna,4,0,20,16
1745136867844,CAT 125R,B00,886391,Irwin; Matthew Joseph,0,1,20,20
1745136867844,CAT 125R,C00,886392,Smith; Lauryn Alissa,11,0,20,9
1745136867844,CAT 125R,D00,886393,Vanderschuit; Maya Alysia,6,0,20,14
1745136867844,CAT 125R,E00,886394,Marchisotto; Jennifer Anne,0,2,20,20
1745136868869,CENG 15,A01,886218,Drews; Aaron,1,0,5,4
1745136869898,CENG 113,A00,886219,Opatkiewicz; Justin Paul,16,0,25,9
1745136870923,CGS 101,A00,887044,Staff,13,0,20,7
1745136871951,CGS 105,A01,887046,Staff,16,0,25,9
1745136872975,CGS 112,A00,887047,Cuong; Marisol,12,0,15,3
1745136874000,CGS 113,A00,887048,Staff,24,0,30,6
1745136875026,CGS 120,A00,887049,Staff,12,0,17,5
1745136876051,CHEM 6A,A01,886336,Lam; Tin Yiu,44,0,50,6
1745136876051,CHEM 6A,A02,886338,Lam; Tin Yiu,43,0,50,7
1745136877077,CHEM 6B,A01,886341,Hopkins; Patrycja Anna,21,0,50,29
1745136877077,CHEM 6B,A02,886343,Hopkins; Patrycja Anna,46,0,50,4
1745136878106,CHEM 6C,A01,886346,Albizati; Kim F.,0,1,50,50
1745136878106,CHEM 6C,A02,886348,Albizati; Kim F.,38,0,50,12
1745136879130,CHEM 40A,A01,886352,Klosterman; Jeremy K,70,0,100,30
1745136880159,CHEM 40B,A01,886356,Klosterman; Jeremy K,0,4,100,100
1745136881185,CHEM 41B,A01,886360,Theodorakis; Emmanuel,30,0,50,20
1745136881185,CHEM 41B,A02,886362,Theodorakis; Emmanuel,46,0,50,4
1745136882209,CHIN 165A,A00,886382,Xu; Li,19,0,20,1
1745136883237,CLAS 120,A00,886387,Myerston Santana; Jacobo,36,0,40,4
1745136884263,COGS 9,A01,886967,Shannon; Kyle Michael,49,0,60,11
1745136885288,COGS 11,A01,886969,Staff,18,0,30,12
1745136886314,COGS 14A,A01,886971,Staff,26,0,60,34
1745136887339,COGS 14B,A01,886973,Hoffman; Drew Ellen,18,0,60,42
1745136888366,COGS 18,A01,886975,Morgan; Eric,41,0,60,19
1745136889396,COGS 20,A01,886977,Staff,6,0,8,2
1745136889396,COGS 20,A02,886978,Staff,6,0,7,1
1745136890420,COGS 100,A01,907783,Staff,6,0,30,24
1745136891446,COGS 101B,A01,886980,Staff,0,10,30,30
1745136892473,COGS 101C,A01,886982,Delgado; Tania,0,6,30,30
1745136893498,COGS 102A,A01,886984,Johnson; Christine M.,13,0,30,17
1745136894526,COGS 118B,A01,886986,Staff,0,25,60,60
1745136895556,COGS 150,A01,886988,Bergen; Benjamin,16,0,30,14
1745136896583,COGS 153,A00,886989,Delgado; Tania,0,6,30,30
1745136897611,COGS 186,A01,886991,Staff,3,0,30,27
1745136898637,COGS 187A,A01,886993,Boyle; Mary E. T.,12,0,30,18
1745136899663,COGS 189,A00,886994,Staff,13,0,30,17
1745136900690,COMM 10,A01,886996,Staff,11,0,25,14
1745136900690,COMM 10,A02,886997,Staff,21,0,25,4
1745136901720,COMM 20,A01,886999,Leuning; Grant Maurstad,33,0,40,7
1745136903772,COMM 100A,A01,887002,Staff,0,0,25,25
1745136903772,COMM 100A,A02,887003,Staff,20,0,25,5
1745136904803,COMM 100B,A01,887005,Staff,0,1,25,25
1745136905830,COMM 106D,A00,887006,Staff,22,0,40,18
1745136906859,COMM 110G,A00,887007,Whitworth-Smith; Andrew C,17,0,40,23
1745136907889,COMM 111B,A00,887008,Staff,31,0,40,9
1745136908939,COMM 113T,A00,887009,Abuelhiga; Soraya Jill,30,0,40,10
1745136908939,COMM 113T,B00,906733,Staff,40,0,40,0
1745136909968,COMM 145,A00,887010,Staff,21,0,40,19
1745136910995,COMM 146,A00,887054,Staff,31,0,40,9
1745136912020,COMM 190,A00,887012,Staff,9,0,23,14
1745136913047,CSE 8A,A50,887015,Cao; Yingjun,68,0,85,17
1745136914073,CSE 11,A01,887017,Cao; Yingjun,35,0,70,35
1745136915099,CSE 20,A01,887019,Staff,35,0,50,15
1745136916128,CSE 21,A01,887021,Braun; Oliver,81,0,100,19
1745136916128,CSE 21,B01,892583,Staff,48,0,50,2
1745136917155,CSE 30,A01,887025,Eldon; John,161,0,200,39
1745136918184,CSE 100,A01,887027,Staff,28,0,50,22
1745136918184,CSE 100,A02,887028,Staff,43,0,50,7
1745136919212,CSE 101,A01,887030,Braun; Oliver,79,0,100,21
1745136919212,CSE 101,B01,887032,Jones; Miles E,0,1,50,50
1745136919212,CSE 101,B02,887033,Jones; Miles E,13,0,50,37
1745136920266,CSE 105,A01,908084,Jones; Miles E,36,0,50,14
1745136920266,CSE 105,A02,908087,Jones; Miles E,38,0,50,12
1745136921293,CSE 135,A01,887035,Powell; Thomas Allan,8,0,50,42
1745136922318,CSE 142,A01,887037,Staff,22,0,60,38
1745136923344,CSE 142L,A01,887039,Staff,42,0,60,18
1745136924374,CSE 151A,A01,887041,Solares; Edwin A,60,0,100,40
1745136925400,CSE 175,A01,887043,Kumar; Rakesh,30,0,30,0
1745136926430,CSS 1,A01,886389,Staff,12,0,40,28
1745136927459,DSC 30,A01,908097,Liao; Soohyun Nam,54,0,75,21
1745136928488,DSC 40A,A01,908099,Shannon; Kyle Michael,37,0,50,13
1745136929515,DSC 40B,A01,908112,Staff,28,0,50,22
1745136930544,DSC 80,A01,908116,Staff,32,0,60,28
1745136931570,DSC 197,001,956863,Eldridge; Justin Matthew,9999,0,9999,0
1745136932597,ECE 5,A01,886400,Morris; Karcher William,3,0,6,3
1745136932597,ECE 5,A02,886401,Morris; Karcher William,5,0,6,1
1745136933628,ECE 148,A01,886403,Silberman; Jack,0,8,14,14
1745136934654,ECON 1,A01,887265,Crane; Meredith Helen,25,0,70,45
1745136934654,ECON 1,B01,887268,Staff,44,0,50,6
1745136935683,ECON 2,A01,887273,Crane; Meredith Helen,61,0,70,9
1745136936710,ECON 3,A01,887279,Rondina; Giacomo,44,0,70,26
1745136937739,ECON 4,A01,887282,Anderson; John Charles,0,1,10,10
1745136938772,ECON 5,A01,887285,Staff,39,0,45,6
1745136938772,ECON 5,B01,887292,Staff,43,0,45,2
1745136939801,ECON 100A,A01,887337,Newhouse; Herbert S,58,0,70,12
1745136939801,ECON 100A,B01,887349,Staff,45,0,50,5
1745136940830,ECON 100B,A01,887361,Du; Songzi,42,0,70,28
1745136941857,ECON 100C,A01,887445,Newhouse; Herbert S,61,0,70,9
1745136942882,ECON 105,A00,887488,Vespa; Emanuel Ignacio,24,0,35,11
1745136943908,ECON 109,A01,887506,Staff,29,0,35,6
1745136944936,ECON 110A,A01,887568,Alon; Titan Michael,1,0,35,34
1745136944936,ECON 110A,B01,907601,Alon; Titan Michael,27,0,35,8
1745136945962,ECON 110B,A01,887598,Levkoff; Steven B.,0,7,70,70
1745136946988,ECON 112,A00,887599,Rondina; Giacomo,20,0,35,15
1745136948017,ECON 120A,A01,887603,Dai; Yinlin,46,0,70,24
1745136949042,ECON 120C,A01,887608,Sun; Yixiao,0,0,35,35
1745136949042,ECON 120C,B01,887614,Sun; Yixiao,13,0,35,22
1745136950071,ECON 138,A00,887621,Bharadwaj; Prashant,0,18,20,20
1745136951097,ECON 171,A01,907666,Staff,27,0,35,8
1745136952125,ECON 175,A00,887626,Wu; Pak Yeung,27,0,35,8
1745136953154,ECON 190,A00,887640,Vespa; Emanuel Ignacio,26,0,35,9
1745136954191,EDS 25,A01,888197,Staff,0,0,0,0
1745136954191,EDS 25,A02,888209,Staff,0,0,0,0
1745136954191,EDS 25,A03,888210,Staff,0,0,0,0
1745136954191,EDS 25,A04,888212,Staff,0,0,0,0
1745136954191,EDS 25,A05,888213,Staff,0,0,0,0
1745136954191,EDS 25,A06,888214,Staff,0,0,0,0
1745136954191,EDS 25,A07,888235,Staff,0,0,0,0
1745136954191,EDS 25,A08,888236,Staff,0,0,0,0
1745136954191,EDS 25,A09,888240,Staff,0,0,0,0
1745136954191,EDS 25,A10,888244,Staff,0,0,0,0
1745136954191,EDS 25,B01,888273,Staff,0,0,0,0
1745136954191,EDS 25,B02,888285,Staff,0,0,0,0
1745136954191,EDS 25,B03,888423,Staff,29,0,30,1
1745136954191,EDS 25,B04,888432,Staff,0,0,0,0
1745136954191,EDS 25,B05,888433,Staff,0,0,0,0
1745136954191,EDS 25,B06,888467,Staff,0,0,0,0
1745136954191,EDS 25,B07,888468,Staff,0,0,0,0
1745136954191,EDS 25,B08,888479,Staff,0,0,0,0
1745136954191,EDS 25,B09,888484,Staff,0,0,0,0
1745136954191,EDS 25,B10,888487,Staff,0,0,0,0
1745136955217,EDS 38,A01,907700,Choi; Bailey Miyeon,30,0,30,0
1745136956242,EDS 112,A01,888601,Chapman; Thandeka K,23,0,40,17
1745136957267,EDS 115,A00,888697,Mendez; Kathrina Mendoza,17,0,30,13
1745136958294,EDS 116,A01,888893,Staff,38,0,40,2
1745136960349,EDS 124AR,A00,889133,Staff,33,0,50,17
1745136960349,EDS 124AR,B00,907471,Simon; Elizabeth A,42,0,50,8
1745136961375,EDS 124BR,A00,889134,Staff,57,0,100,43
1745136962405,EDS 125,A00,889135,Staff,26,0,30,4
1745136963434,EDS 126,A01,889138,Staff,37,0,40,3
1745136964459,EDS 164R,A01,889142,Wishard Guerra; Alison G.,38,0,50,12
1745136965485,ENG 30,A01,886396,Staff,0,0,0,0
1745136965485,ENG 30,B01,886398,Staff,0,0,0,0
1745136966509,ENVR 102,A00,906150,Montejo; Carolina,23,0,25,2
1745136967533,ETHN 103A,A00,887236,Man; Simeon S,0,5,0,0
1745136968557,ETHN 113,A00,887239,Staff,20,0,30,10
1745136969582,ETHN 116,A00,887240,Staff,20,0,25,5
1745136970606,ETHN 117,A00,887241,Choi; Esther Min,27,0,30,3
1745136971635,ETHN 118,A00,887243,Staff,24,0,30,6
1745136972659,ETHN 127,A00,887248,Cuong; Marisol,12,0,15,3
1745136973686,ETHN 139,A00,887250,Staff,8,0,10,2
1745136974714,ETHN 142,A00,887252,Staff,18,0,30,12
1745136975743,ETHN 161,A00,887253,Browne; Errol Tsekani,28,0,30,2
1745136976772,ETHN 163FR,A00,887255,Burelle; Julie Sara Veronique,4,0,5,1
1745136977799,GLBH 20,A00,889149,Elwardani; Nile Regina,15,0,42,27
1745136979868,GLBH 111,A01,889152,Burgos; Jose L.,17,0,17,0
1745136980894,GLBH 150,A00,889181,Sloane; Julia Kathryn,0,1,15,15
1745136982951,HDS 60,A01,886406,Warstadt; Melissa Fawn,76,0,80,4
1745136983974,HIAF 111,A00,889324,Gyamfi; Bright,0,4,0,0
1745136985006,HIEA 131,A00,889328,Staff,14,0,32,18
1745136986030,HIEA 144,A00,889333,Henry; Todd A.,29,0,32,3
1745136987057,HIEA 154,A00,889336,Henry; Todd A.,28,0,32,4
1745136988081,HIEU 106,A00,889339,Staff,28,0,32,4
1745136990147,HIEU 114,A00,889340,Staff,18,0,32,14
1745136991173,HIEU 135GS,A00,889342,Patterson; Patrick H.,0,0,1,22
1745136992198,HIEU 137,A00,889343,Edington; Claire Ellen,12,0,25,13
1745136993224,HIEU 148,A00,889345,Staff,16,0,32,16
1745136994251,HIEU 154,A00,889346,Biess; Frank Peter,24,0,32,8
1745136995276,HILA 102,A00,889351,Staff,13,0,32,19
1745136996301,HILD 2A,A01,889221,Lewandoski; Julia Mavis,0,5,32,32
1745136997325,HILD 7B,A01,889225,Man; Simeon S,0,7,32,32
1745136998353,HILD 7C,A01,889288,Alvarez; Luis A,0,7,32,32
1745136999377,HILD 30,A01,889323,Staff,0,1,32,32
1745137001430,HISC 119,A00,889383,Golan; Tal,22,0,32,10
1745137002455,HIUS 103,A00,889384,Man; Simeon S,10,0,32,22
1745137003479,HIUS 117,A00,919797,Kwak; Nancy,23,0,32,9
1745137004502,HIUS 142A,A00,919788,Staff,24,0,32,8
1745137006550,HIUS 149,A00,889386,Gyamfi; Bright,0,1,0,0
1745137007576,HIUS 155,A00,889387,Alvarez; Luis A,19,0,32,13
1745137008601,HUM 3,A01,886499,Caldwell; Michael Alan,24,0,50,26
1745137009627,HUM 3GS,A00,886500,Rodriguez; Bretton Sigfred,0,0,0,26
1745137010655,HUM 3R,A01,886502,Markman; Kristina,0,32,50,50
1745137011683,HUM 4,A01,886504,Crum; Matthew Stephen,28,0,50,22
1745137011683,HUM 4,B01,886506,West; Geoffrey Scott,25,0,50,25
1745137012709,HUM 4GS,A00,886507,Staff,0,0,0,13
1745137013738,HUM 5,A01,886509,Staff,35,0,50,15
1745137014764,HUM 5R,A01,886511,Zavodny; Tatiana Sophia,0,32,50,50
1745137015791,JAPN 180,A00,886407,Staff,25,0,40,15
1745137016817,LATI 50,A01,886409,Martin-Cabrera; Luis,9,0,22,13
1745137016817,LATI 50,A02,886410,Martin-Cabrera; Luis,20,0,22,2
1745137016817,LATI 50,A03,886411,Martin-Cabrera; Luis,22,0,22,0
1745137016817,LATI 50,A04,886412,Martin-Cabrera; Luis,15,0,22,7
1745137017845,LAWS 101,A00,907664,Staff,36,0,60,24
1745137018873,LIAB 1A,A00,889388,Saab; Dima,19,0,20,1
1745137019898,LIAB 1AX,A00,889389,El Cheddadi; Youniss,19,0,20,1
1745137020927,LIFR 1C,A00,889391,Van Moer; Vinciane G,9,0,20,11
1745137021955,LIFR 1CX,A00,889392,Van Moer; Vinciane G,8,0,20,12
1745137022979,LIFR 1D,A00,889393,Van Moer; Vinciane G,11,0,20,9
1745137024006,LIFR 1DX,A00,889394,Van Moer; Vinciane G,11,0,20,9
1745137025033,LIGN 7,A00,886923,Staff,30,0,50,20
1745137026060,LIGN 17,A00,886924,Kehler; Andrew Scott,133,0,150,17
1745137027087,LTAM 110,A00,889395,Staff,17,0,30,13
1745137028116,LTCH 101,A00,889397,Staff,22,0,25,3
1745137029139,LTCS 130,A00,889398,Staff,23,0,25,2
1745137030165,LTEA 138,A00,889399,Staff,25,0,40,15
1745137031195,LTEN 149,A00,889400,Wesling; Megan E.,6,0,25,19
1745137032220,LTEN 169,A00,889401,Staff,24,0,25,1
1745137033249,LTEN 180,A00,889402,Staff,12,0,15,3
1745137034279,LTEN 181,A00,889403,Staff,23,0,25,2
1745137035305,LTWL 100,A00,889404,Myerston Santana; Jacobo,8,0,25,17
1745137036335,LTWL 180GS,A00,889405,Staff,6,0,20,14
1745137037361,LTWL 181,A00,889406,Staff,19,0,25,6
1745137038388,LTWL 184,A00,889475,Mukherjee; Silpa,21,0,25,4
1745137039416,LTWR 102C,A00,889486,Staff,29,0,30,1
1745137040445,LTWR 115W,A00,889491,Staff,3,0,15,12
1745137041470,MAE 8,A01,886905,Staff,0,2,0,0
1745137042496,MAE 11,A00,886906,Bandaru; Prabhakar,0,0,50,50
1745137043523,MAE 20,A00,886907,Evdokimenko; Ekaterina,50,0,70,20
1745137044550,MAE 30B,A00,886909,Ghazinejad; Maziar,28,0,45,17
1745137045579,MAE 101B,A00,886910,Saintillan; David,36,0,45,9
1745137046608,MAE 105,A00,886911,Bandaru; Prabhakar,26,0,50,24
1745137047638,MAE 107,A00,886912,Staff,22,0,60,38
1745137048663,MAE 143B,A00,886913,Bewley; Thomas R,14,0,40,26
1745137049693,MAE 148,A01,886915,Silberman; Jack,5,0,14,9
1745137050744,MAE 160,A00,886916,Evdokimenko; Ekaterina,41,0,60,19
1745137051770,MATH 3C,A01,889681,Staff,2,0,30,28
1745137052795,MATH 10A,A01,889760,Staff,28,0,30,2
1745137052795,MATH 10A,A02,889783,Staff,30,0,30,0
1745137053819,MATH 10B,A01,889785,Verstraete; Jacques Allan,0,2,30,30
1745137053819,MATH 10B,A02,889795,Verstraete; Jacques Allan,0,2,30,30
1745137053819,MATH 10B,B01,889797,Verstraete; Jacques Allan,1,0,30,29
1745137053819,MATH 10B,B02,889828,Verstraete; Jacques Allan,23,0,30,7
1745137054846,MATH 10C,A01,889849,Habib; Yousaf,18,0,30,12
1745137054846,MATH 10C,A02,889852,Habib; Yousaf,20,0,30,10
1745137054846,MATH 10C,A03,889853,Habib; Yousaf,25,0,30,5
1745137054846,MATH 10C,A04,889858,Habib; Yousaf,21,0,30,9
1745137054846,MATH 10C,B01,889861,Staff,12,0,30,18
1745137054846,MATH 10C,B02,889862,Staff,26,0,30,4
1745137054846,MATH 10C,B03,889863,Staff,28,0,30,2
1745137054846,MATH 10C,B04,889967,Staff,25,0,30,5
1745137055899,MATH 18,A01,889974,Staff,15,0,30,15
1745137055899,MATH 18,A02,889977,Staff,25,0,30,5
1745137055899,MATH 18,B01,889984,Hardiman; Liam,26,0,30,4
1745137055899,MATH 18,B02,889985,Hardiman; Liam,28,0,30,2
1745137056924,MATH 20A,A01,889990,Suk; Andrew Hoon,31,0,35,4
1745137057954,MATH 20B,A01,889993,Ohm; Ko Woon,21,0,30,9
1745137057954,MATH 20B,A02,889994,Ohm; Ko Woon,30,0,30,0
1745137057954,MATH 20B,B01,889996,Ohm; Ko Woon,25,0,30,5
1745137057954,MATH 20B,B02,889997,Ohm; Ko Woon,24,0,30,6
1745137058981,MATH 20C,A01,889999,Hammock; Frances H,22,0,30,8
1745137058981,MATH 20C,A02,890003,Hammock; Frances H,23,0,30,7
1745137058981,MATH 20C,B01,890006,Hammock; Frances H,11,0,30,19
1745137058981,MATH 20C,B02,890007,Hammock; Frances H,18,0,30,12
1745137060016,MATH 20D,A01,890011,Cheng; Hsiao-Bing,6,0,30,24
1745137060016,MATH 20D,A02,890012,Cheng; Hsiao-Bing,27,0,30,3
1745137060016,MATH 20D,B01,890016,Cheng; Hsiao-Bing,19,0,30,11
1745137060016,MATH 20D,B02,890017,Cheng; Hsiao-Bing,15,0,30,15
1745137061041,MATH 20E,A01,890026,Harel; Guershon,10,0,30,20
1745137061041,MATH 20E,A02,890029,Harel; Guershon,24,0,30,6
1745137061041,MATH 20E,B01,890033,Harel; Guershon,14,0,30,16
1745137061041,MATH 20E,B02,890101,Harel; Guershon,27,0,30,3
1745137062066,MATH 102,A01,890104,Staff,20,0,30,10
1745137062066,MATH 102,A02,890105,Staff,30,0,30,0
1745137063092,MATH 103B,A01,890116,Salehi Golsefidy; Alireza,8,0,30,22
1745137063092,MATH 103B,B01,890118,Staff,0,4,30,30
1745137064123,MATH 109,A01,890121,Aliabadi Sr.; Mohsen,6,0,30,24
1745137064123,MATH 109,B01,890124,Upadrashta; Pranav Kumar,23,0,30,7
1745137065147,MATH 120A,A01,890126,Eggers; John Dietrich,15,0,30,15
1745137066172,MATH 142B,A01,890128,Ioana; Adrian,17,0,30,13
1745137066172,MATH 142B,A02,890129,Ioana; Adrian,15,0,30,15
1745137067202,MATH 154,A01,890174,Staff,0,1,30,30
1745137067202,MATH 154,A02,890182,Staff,15,0,30,15
1745137068230,MATH 168A,A01,890197,Dumitriu; Ioana,22,0,35,13
1745137069257,MATH 170A,A01,890240,Nie; Jiawang,6,0,30,24
1745137069257,MATH 170A,A02,890241,Nie; Jiawang,18,0,30,12
1745137069257,MATH 170A,A03,890249,Nie; Jiawang,23,0,30,7
1745137070282,MATH 170B,A01,957891,Nag; Panchali,25,0,35,10
1745137072336,MATH 181A,A01,908025,Staff,0,8,35,35
1745137073361,MATH 193B,A01,890265,Staff,3,0,35,32
1745137074386,MGT 4,A01,890311,Anderson; John Charles,57,0,88,31
1745137075416,MGT 5,A00,907740,Staff,41,0,98,57
1745137076441,MGT 12,A00,890312,Lindenberger; Wade Douglas,70,0,98,28
1745137077467,MGT 16,A00,957883,Staff,84,0,98,14
1745137079521,MGT 45,A00,890314,Pecore; Joseph P.,57,0,98,41
1745137080550,MGT 71,A00,890315,Staff,6,0,98,92
1745137081577,MGT 100,A00,890316,Yavorsky; Daniel Ryan,59,0,98,39
1745137082601,MGT 103,A00,890317,Ehrich; Kristine R,77,0,98,21
1745137083627,MGT 105,A00,890356,Bates; Kenneth Walter,19,0,98,79
1745137084654,MGT 112,A00,890360,Ehrich; Kristine R,65,0,98,33
1745137085679,MGT 127R,A00,907732,Zhu; Kevin Xiaoguo,32,0,98,66
1745137086708,MGT 131B,A00,890361,Anderson; John Charles,75,0,98,23
1745137087733,MGT 137,A00,890362,Lindenberger; Wade Douglas,68,0,98,30
1745137088758,MGT 160,A00,890369,Johnson; Erik Barry,37,0,98,61
1745137090812,MGT 164,A00,890372,Zimmermann; Carsten,0,28,98,98
1745137091885,MGT 180,A00,890374,Bliss; Barbara Ann,32,0,98,66
1745137092910,MMW 15,A01,886414,Chang; Edmond Yi-Teh,0,10,28,28
1745137092910,MMW 15,A02,886415,Chang; Edmond Yi-Teh,0,10,28,28
1745137092910,MMW 15,A03,886416,Chang; Edmond Yi-Teh,0,8,28,28
1745137092910,MMW 15,A04,886417,Chang; Edmond Yi-Teh,0,8,28,28
1745137092910,MMW 15,B01,886419,Chang; Edmond Yi-Teh,0,8,28,28
1745137092910,MMW 15,B02,886420,Chang; Edmond Yi-Teh,0,9,28,28
1745137092910,MMW 15,B03,886421,Chang; Edmond Yi-Teh,0,9,28,28
1745137092910,MMW 15,B04,886422,Chang; Edmond Yi-Teh,0,9,28,28
1745137092910,MMW 15,C01,886424,Staff,0,10,28,28
1745137092910,MMW 15,C02,886425,Staff,0,10,28,28
1745137092910,MMW 15,C03,886426,Staff,0,9,28,28
1745137092910,MMW 15,C04,886427,Staff,0,9,28,28
1745137093937,MMW 15GS,A00,906910,Patterson; Patrick H.,5,0,28,23
1745137094962,MMW 122R,A01,886429,Rahimi; Babak,0,23,28,28
1745137094962,MMW 122R,A02,886430,Rahimi; Babak,0,23,28,28
1745137095991,MUS 1A,A01,890937,Staff,8,0,25,17
1745137095991,MUS 1A,A02,891035,Staff,15,0,25,10
1745137095991,MUS 1A,B00,907849,Staff,48,0,50,2
1745137095991,MUS 1A,B01,907850,Staff,25,0,25,0
1745137095991,MUS 1A,B02,907851,Staff,25,0,25,0
1745137098041,MUS 2AK,A00,957092,Ohnishi; Takae,15,0,15,0
1745137099065,MUS 4,A01,891044,Staff,6,0,25,19
1745137099065,MUS 4,A02,891045,Staff,24,0,25,1
1745137099065,MUS 4,B01,891048,Staff,20,0,25,5
1745137099065,MUS 4,B02,891050,Staff,25,0,25,0
1745137100090,MUS 5,A01,957506,Dubnov; Shlomo,4,0,25,21
1745137100090,MUS 5,A02,957622,Dubnov; Shlomo,21,0,25,4
1745137100090,MUS 5,A03,957623,Dubnov; Shlomo,23,0,25,2
1745137101118,MUS 6,A01,891053,Freitas Caetano; Marcelo,23,0,25,2
1745137101118,MUS 6,A02,891054,Freitas Caetano; Marcelo,23,0,25,2
1745137102146,MUS 7,A01,891081,Staff,0,0,25,25
1745137102146,MUS 7,A02,891082,Staff,15,0,25,10
1745137103171,MUS 8GS,A00,891118,Borgo; David Garcia,5,0,25,20
1745137104196,MUS 11,A01,891140,Staff,12,0,25,13
1745137104196,MUS 11,A02,891141,Staff,24,0,25,1
1745137105224,MUS 13,A01,891143,Staff,10,0,25,15
1745137105224,MUS 13,A02,891144,Staff,25,0,25,0
1745137106254,MUS 15,A01,891146,Staff,7,0,25,18
1745137106254,MUS 15,A02,891148,Staff,22,0,25,3
1745137106254,MUS 15,B01,891150,Staff,18,0,25,7
1745137106254,MUS 15,B02,891151,Staff,25,0,25,0
1745137107279,MUS 20,A01,891153,Staff,9,0,20,11
1745137107279,MUS 20,A02,891155,Staff,16,0,20,4
1745137108305,MUS 80,A00,891156,Staff,19,0,25,6
1745137108305,MUS 80,B00,891157,Staff,25,0,25,0
1745137109330,MUS 130,A00,891158,Ohnishi; Takae,35,0,35,0
1745137110355,MUS 150GS,A01,891160,Borgo; David Garcia,5,0,25,20
1745137111384,MUS 170,A01,891162,Freitas Caetano; Marcelo,21,0,25,4
1745137111384,MUS 170,A02,891164,Freitas Caetano; Marcelo,22,0,25,3
1745137112412,NANO 11,A00,886220,Vazquez Mena; Oscar,12,0,15,3
1745137113443,NANO 15,A01,886222,Drews; Aaron,9,0,10,1
1745137114469,NANO 104,A00,886224,Sirbuly; Donald,18,0,25,7
1745137115494,PH 40,A00,886528,Staff,29,0,40,11
1745137116519,PH 45,A01,886799,Staff,36,0,40,4
1745137117546,PH 110,A00,886802,Staff,7,0,40,33
1745137118574,PH 172,A00,906716,Staff,20,0,35,15
1745137119598,PH 191,A00,886803,Staff,23,0,40,17
1745137120623,PHIL 1,A00,889500,Staff,22,0,30,8
1745137121653,PHIL 10,A01,889549,Grush; Rick Scott,17,0,22,5
1745137121653,PHIL 10,A02,889551,Grush; Rick Scott,20,0,22,2
1745137122679,PHIL 28,A01,889559,Lamey; Andy M.,0,4,25,25
1745137122679,PHIL 28,A02,889561,Lamey; Andy M.,0,0,25,25
1745137122679,PHIL 28,A03,889572,Lamey; Andy M.,7,0,25,18
1745137123708,PHIL 35,A00,907839,Staff,32,0,33,1
1745137124735,PHIL 60,A00,889574,Staff,79,0,90,11
1745137125763,PHIL 105,A00,889579,Staff,0,1,0,0
1745137126787,PHIL 136,A00,889582,Fulkerson; Matthew Todd,27,0,45,18
1745137127816,PHIL 163,A01,889601,Staff,24,0,30,6
1745137127816,PHIL 163,B01,889606,Brandt; Reuven A,0,2,0,0
1745137128840,PHIL 164,A00,889610,Staff,20,0,30,10
1745137129866,PHIL 165,A00,889613,Staff,26,0,30,4
1745137130891,PHYS 1A,A00,886431,Staff,38,0,70,32
1745137131916,PHYS 1AL,001,886432,Tsai; Philbert S,0,0,30,30
1745137131916,PHYS 1AL,002,886436,Tsai; Philbert S,19,0,30,11
1745137132944,PHYS 1B,A00,886439,Staff,192,0,240,48
1745137133972,PHYS 1BL,001,886441,Tsai; Philbert S,0,1,30,30
1745137133972,PHYS 1BL,002,886444,Tsai; Philbert S,14,0,30,16
1745137134997,PHYS 1C,A00,896092,Arnold; Kam S,87,0,146,59
1745137136039,PHYS 1CL,001,886448,Tsai; Philbert S,0,4,30,30
1745137136039,PHYS 1CL,002,886449,Tsai; Philbert S,6,0,30,24
1745137136039,PHYS 1CL,003,886450,Tsai; Philbert S,22,0,30,8
1745137136039,PHYS 1CL,004,886451,Tsai; Philbert S,16,0,30,14
1745137137064,PHYS 2B,A01,886457,Staff,86,0,115,29
1745137138095,PHYS 2C,A01,886460,Shotwell; Brian,0,0,65,65
1745137139119,PHYS 2CL,A01,886467,Staff,0,3,28,28
1745137139119,PHYS 2CL,A02,886468,Staff,5,0,28,23
1745137140148,PHYS 2D,A01,886470,Staff,17,0,50,33
1745137141177,PHYS 4B,A01,886475,Grinstein; Benjamin,88,0,100,12
1745137142206,POLI 5,A00,891173,Desposato; Scott,17,0,25,8
1745137143232,POLI 5D,A01,891175,Staff,5,0,5,0
1745137143232,POLI 5D,B01,891178,Staff,5,0,5,0
1745137144256,POLI 11,A00,891179,Ferree; Karen E,3,0,25,22
1745137145282,POLI 12,A00,891180,Staff,21,0,30,9
1745137146306,POLI 27,A01,891182,Staff,29,0,75,46
1745137147330,POLI 30,A00,891183,Staff,0,3,30,30
1745137148355,POLI 100B,A00,891244,Staff,0,8,20,20
1745137149378,POLI 100I,A00,891247,Staff,19,0,30,11
1745137150404,POLI 104J,A00,891248,Nichter; Maysa,18,0,30,12
1745137151430,POLI 104U,A00,891250,Nichter; Maysa,9,0,30,21
1745137152455,POLI 108,A00,891253,Staff,0,0,0,4
1745137153482,POLI 110B,A00,891255,Wiens; David,22,0,25,3
1745137154506,POLI 112A,A00,891256,Wiens; David,15,0,25,10
1745137155531,POLI 114BR,A00,891261,Staff,22,0,30,8
1745137156557,POLI 117R,A00,891262,Forman; Fonna,12,0,50,38
1745137157585,POLI 118,A00,891264,Ingham; Sean,22,0,25,3
1745137158613,POLI 124A,A00,891265,Staff,19,0,20,1
1745137159643,POLI 125D,A00,891266,Nichter; Simeon C,9,0,25,16
1745137160669,POLI 126,A00,891268,Nichter; Simeon C,11,0,25,14
1745137161699,POLI 126AA,A00,891272,Staff,19,0,25,6
1745137162726,POLI 130AA,A00,891273,Staff,17,0,20,3
1745137163754,POLI 134AA,A00,891274,Staff,12,0,20,8
1745137165807,POLI 138,A00,891278,Staff,22,0,25,3
1745137166836,POLI 142K,A00,891280,Staff,17,0,25,8
1745137167864,POLI 142M,A00,891281,Gartzke; Erik,22,0,30,8
1745137168889,POLI 142P,A00,891284,Staff,21,0,30,9
1745137169915,POLI 143,A00,891285,Gartzke; Erik,17,0,30,13
1745137170944,POLI 153,A00,891286,Staff,20,0,20,0
1745137171968,POLI 170A,A00,891288,Staff,19,0,25,6
1745137172992,POLI 175,A00,891290,Staff,18,0,20,2
1745137174019,PSYC 1,A00,890674,Steiner; Eric Tomas,0,4,45,45
1745137175051,PSYC 2,A00,890676,Albright; Thomas D,25,0,35,10
1745137176078,PSYC 3,A00,890679,Staff,18,0,20,2
1745137177104,PSYC 60,A01,890684,Rickard; Timothy C.,7,0,45,38
1745137178134,PSYC 70,A01,890689,Geller; Emma Harlan,14,0,30,16
1745137179160,PSYC 100,A00,890690,Lacefield; Katharine I,0,43,180,180
1745137180189,PSYC 102,A00,890695,Staff,26,0,40,14
1745137181217,PSYC 105,A00,890699,Geller; Emma Harlan,78,0,100,22
1745137182246,PSYC 106,A00,890701,Gorman; Michael R.,15,0,30,15
1745137183270,PSYC 108,A00,890704,Adrian; Julia Anna,0,23,50,50
1745137184296,PSYC 118,A01,890712,Staff,18,0,30,12
1745137185321,PSYC 124,A00,890716,Chapman; Eddie Nathaniel,36,0,60,24
1745137186349,PSYC 131,A00,890717,Anagnostaras; Stephan,6,0,80,74
1745137187375,PSYC 137,A00,890719,Winkielman; Piotr,0,2,30,30
1745137188400,PSYC 144,A00,890721,Adrian; Julia Anna,0,3,45,45
1745137189426,PSYC 162,A00,890805,Staff,21,0,75,54
1745137190455,PSYC 169,A00,890810,Staff,0,15,30,30
1745137191481,PSYC 172,A00,890814,Gorman; Michael R.,14,0,30,16
1745137192505,PSYC 181,A00,890818,Anagnostaras; Stephan,63,0,200,137
1745137193530,PSYC 189,A00,890823,Staff,11,0,30,19
1745137194557,PSYC 191,A00,890884,Rickard; Timothy C.,0,11,35,35
1745137195582,PSYC 193,A00,890913,Staff,22,0,30,8
1745137195582,PSYC 193,B00,890914,Chapman; Eddie Nathaniel,25,0,30,5
1745137196611,PSYC 193L,A01,890918,Lowe; Angela Beth,29,0,30,1
1745137196611,PSYC 193L,B01,890921,Hurwitz; Ethan Scott,28,0,30,2
1745137196611,PSYC 193L,C01,890928,Staff,30,0,30,0
1745137197638,RELI 149,A00,886806,Rahimi; Babak,23,0,40,17
1745137198664,SE 9,A01,886814,Staff,13,0,20,7
1745137199690,SE 101B,A01,886816,Chadha; Mayank,8,0,30,22
1745137200719,SE 110B,A00,886818,Zhu; Qiang,0,16,45,45
1745137201753,SE 125,A01,886830,Staff,10,0,30,20
1745137202780,SE 130B,A01,886835,Staff,19,0,40,21
1745137203807,SE 131A,A01,886838,Krysl; Petr,37,0,55,18
1745137204834,SE 154,A00,886840,Staff,35,0,50,15
1745137205859,SE 164GS,A01,886849,Staff,13,0,20,7
1745137206886,SE 167GS,A01,886853,Staff,13,0,20,7
1745137207913,SIO 25,A01,890107,Staff,23,0,30,7
1745137208941,SIO 45,A00,890109,Cook; Geoffrey W,137,0,200,63
1745137209965,SIO 109R,A00,890110,Forman; Fonna,0,11,20,20
1745137210994,SIO 187,A01,890114,Kacev; David,21,0,40,19
1745137212019,SOCI 1,A01,890431,Thorpe; Charles Robert,21,0,30,9
1745137212019,SOCI 1,A02,890518,Thorpe; Charles Robert,30,0,30,0
1745137213084,SOCI 2,A01,957978,Staff,0,0,0,0
1745137213084,SOCI 2,A02,957979,Staff,0,3,0,0
1745137214112,SOCI 20,A01,890523,Calderon-Zaks; Michael Aar,24,0,30,6
1745137214112,SOCI 20,A02,890526,Calderon-Zaks; Michael Aar,29,0,30,1
1745137215141,SOCI 30,A01,890533,Pardo Guerra; Juan Pablo,37,0,40,3
1745137216171,SOCI 40,A01,890535,Staff,32,0,45,13
1745137217198,SOCI 104Q,A00,890559,Staff,20,0,30,10
1745137218224,SOCI 106,A00,890560,Arnal; Maud Marie Leonie,22,0,30,8
1745137219249,SOCI 110,A00,890567,Holkenbrink-Monk; Charlene,22,0,30,8
1745137220276,SOCI 112,A00,890568,Victoria Torres; Pablo,0,0,45,45
1745137221305,SOCI 115,A00,890597,Arnal; Maud Marie Leonie,33,0,45,12
1745137223358,SOCI 121,A00,890604,Pardo Guerra; Juan Pablo,40,0,45,5
1745137224388,SOCI 126,A01,890608,Staff,8,0,10,2
1745137225417,SOCI 127,A00,890609,Staff,23,0,30,7
1745137226444,SOCI 131,A00,890610,Thorpe; Charles Robert,38,0,45,7
1745137227473,SOCI 135,A00,890615,Payne; Christine Anna,20,0,45,25
1745137228498,SOCI 139,A00,890620,Staff,43,0,45,2
1745137229527,SOCI 148E,A00,890622,Calderon-Zaks; Michael Aar,39,0,45,6
1745137230553,SOCI 150,A00,890623,Kohler; Kristopher M.,36,0,45,9
1745137231578,SOCI 157,A00,890625,Jules-Rosette; Bennetta W.,18,0,20,2
1745137232604,SOCI 160,A00,890627,Payne; Christine Anna,26,0,45,19
1745137233631,SYN 1,A00,886855,Fish; Gwendolyn Anne,0,0,0,0
1745137233631,SYN 1,B00,906086,Fish; Gwendolyn Anne,0,0,0,2
1745137234659,SYN 2R,A00,886860,Staff,0,15,15,15
1745137234659,SYN 2R,B00,906106,Atkinson; Arthur Laird,0,14,15,15
1745137235691,SYN 100,A01,886866,Browne; Emily,0,29,20,20
1745137235691,SYN 100,B01,906128,Rock; Martin,0,4,20,20
1745137235691,SYN 100,C01,906140,Deavenport; James Cary,0,2,20,20
1745137235691,SYN 100,D01,907816,Deavenport; James Cary,0,3,20,20
1745137236718,TDAC 1,A00,890286,Walsh; Kim C.,11,0,20,9
1745137237747,TDAC 101,A00,890296,Basso; Beatrice,18,0,20,2
1745137238772,TDDE 131,A00,890297,Staff,47,0,50,3
1745137239800,TDDM 1,A00,890287,Weinberg; Sadie,26,0,30,4
1745137240827,TDGE 11,A00,890288,Fulton; Julia,155,0,200,45
1745137240827,TDGE 11,B00,890289,Castro; Robert Jess,188,0,200,12
1745137241852,TDGE 25,B00,957359,Walsh; Kim C.,9,0,20,11
1745137242878,TDGE 40,A01,890292,Power; Jade Yukana,28,0,30,2
1745137243907,TDGE 124,A00,890298,Havis; Allan,12,0,50,38
1745137244932,TDGE 131R,A00,890299,Burelle; Julie Sara Veronique,20,0,42,22
1745137245958,TDHT 101,A00,890300,Staff,12,0,20,8
1745137246984,TDHT 109,A01,890302,Anderson; Mysia Anyse,31,0,40,9
1745137248011,TDMV 1,A00,890293,Arcidiacono; Kristin,20,0,30,10
1745137249041,TDMV 2,A00,890294,Weinberg; Sadie,26,0,30,4
1745137250068,TDMV 3,A00,957878,Arcidiacono; Kristin,27,0,30,3
1745137252122,TDMV 138,A00,890304,Jun; Grace Shin Hae,25,0,40,15
1745137253150,TDMV 140,A00,890305,Corrales; Joseph Bernales,28,0,30,2
1745137254176,TDMV 142,A00,890307,Caligagan; Tony,30,0,40,10
1745137255201,TDMV 144,A00,890308,Camaya; Michelle Ann,26,0,30,4
1745137256227,TDPW 1,A00,890295,Stein; Deborah Isobel,5,0,20,15
1745137257253,USP 2,A01,890272,Lerner; Amy M,8,0,20,12
1745137258281,USP 3,A01,890274,Staff,21,0,30,9
1745137259307,USP 15,A01,890276,Sun; Feiyang,21,0,30,9
1745137260335,USP 25,A00,890277,Shenkman; Michael Thomas,21,0,25,4
1745137261361,USP 138,A00,890278,Staff,15,0,25,10
1745137262387,USP 143,A00,890279,Staff,30,0,70,40
1745137263415,USP 144,A00,890280,Chowdhury; Muhammed Zohir,19,0,30,11
1745137264439,USP 150,A00,890281,Boomhower; Matthew Charles,19,0,30,11
1745137265466,USP 151,A00,890282,Staff,17,0,20,3
1745137266492,USP 162,A00,890283,Andrews; Abigail Leslie,17,0,20,3
1745137267519,USP 168,A00,920477,Kwak; Nancy,2,0,5,3
1745137268545,USP 181,A00,890284,Staff,11,0,20,9
1745137269569,USP 191A,A00,890285,Staff,15,0,20,5
1745137270598,VIS 101,A00,886512,Staff,37,0,75,38
1745137271624,VIS 103,A00,886513,Cruz; Edwin Teddy,65,0,75,10
1745137272650,VIS 108,A00,886514,Staff,7,0,15,8
1745137273677,VIS 127P,A00,886515,Shen; Kuiyi,92,0,146,54
1745137274706,VIS 149,A00,886516,Yoldas; Pinar,1,0,15,14
1745137275733,VIS 164,A00,886526,Erdmann; Dean,21,0,22,1
1745137276757,VIS 194S,A00,886527,Staff,61,0,75,14
1745137277787,WCWP 10A,C00,886484,Staff,13,0,15,2
1745137278812,WCWP 10B,A00,886490,Staff,5,0,15,10
1745137278812,WCWP 10B,B00,886491,Staff,0,1,0,0
1745137278812,WCWP 10B,C00,886492,Staff,10,0,15,5
1745137279839,WCWP 100,A00,886494,Staff,0,2,15,15
1745137282000,AAS 10,A01,886199,Childs; Dennis R.,0,2,0,0
1745137283029,ANAR 104,A01,886940,Shtienberg; Gilad,27,0,30,3
1745137284054,ANAR 120,A00,886953,Staff,13,0,20,7
1745137285079,ANBI 148,A01,886955,Wilder; Linnea Lorene,32,0,40,8
1745137287135,ANSC 122,A00,886957,Staff,28,0,30,2
1745137288162,ANSC 150,A00,886958,Sloane; Julia Kathryn,6,0,15,9
1745137289185,ANSC 156,A00,886959,Jenkins; Janis A.,2,0,15,13
1745137290213,ANSC 180,A00,886960,Staff,12,0,17,5
1745137291241,ANSC 188,A00,886961,Jassal; Aftab,10,0,25,15
1745137292266,ANSC 190,A00,886962,Jassal; Aftab,14,0,25,11
1745137293290,ANSC 191,A00,886963,Staff,18,0,20,2
1745137294318,ANTH 3,A01,891689,Staff,19,0,20,1
1745137295347,ANTH 5,A00,886933,Semendeferi; Ekaterini,18,0,20,2
1745137296373,ANTH 10,A00,886934,Staff,0,8,30,30
1745137297400,ANTH 21,A01,886936,Staff,44,0,60,16
1745137298427,ANTH 23,A01,886938,Staff,94,0,100,6
1745137299454,ANTH 105,A00,886964,Stewart; Alexander B,94,0,100,6
1745137300480,ANTH 108,A00,886965,Pedersen; David,10,0,20,10
1745137301509,AWP 10,001,886147,Staff,0,0,0,0
1745137301509,AWP 10,002,886148,Staff,0,0,0,0
1745137301509,AWP 10,003,886149,Staff,0,0,0,0
1745137301509,AWP 10,004,886150,Staff,0,0,0,0
1745137301509,AWP 10,005,886151,Staff,0,0,0,0
1745137301509,AWP 10,006,886152,Staff,0,0,0,0
1745137301509,AWP 10,007,886153,Staff,0,0,0,0
1745137301509,AWP 10,008,886154,Staff,0,0,0,0
1745137301509,AWP 10,009,886155,Staff,0,0,0,0
1745137301509,AWP 10,010,886156,Staff,0,0,0,0
1745137301509,AWP 10,011,886158,Staff,0,0,0,0
1745137301509,AWP 10,012,886160,Staff,0,0,0,0
1745137301509,AWP 10,013,886161,Staff,0,0,0,0
1745137301509,AWP 10,014,886162,Staff,0,0,0,0
1745137301509,AWP 10,015,886163,Staff,0,0,0,0
1745137301509,AWP 10,016,886164,Staff,0,0,0,0
1745137301509,AWP 10,017,886165,Staff,0,0,0,0
1745137301509,AWP 10,018,886166,Staff,0,0,0,0
1745137301509,AWP 10,019,886168,Staff,0,0,0,0
1745137301509,AWP 10,020,886170,Staff,0,0,0,0
1745137301509,AWP 10,021,886172,Staff,0,0,0,0
1745137302536,AWP 10R,001,886173,Staff,0,0,0,0
1745137302536,AWP 10R,002,886174,Staff,0,1,0,0
1745137302536,AWP 10R,003,886175,Staff,0,0,0,0
1745137302536,AWP 10R,004,886176,Staff,0,0,0,0
1745137302536,AWP 10R,005,886177,Staff,0,0,0,0
1745137302536,AWP 10R,006,886178,Staff,0,0,0,0
1745137302536,AWP 10R,007,886179,Staff,0,0,0,0
1745137302536,AWP 10R,008,886181,Staff,0,0,0,0
1745137302536,AWP 10R,009,886182,Staff,0,0,0,0
1745137302536,AWP 10R,010,886183,Staff,0,0,0,0
1745137302536,AWP 10R,011,886184,Staff,0,0,0,0
1745137302536,AWP 10R,012,886185,Staff,0,0,0,0
1745137302536,AWP 10R,013,886186,Staff,0,0,0,0
1745137302536,AWP 10R,014,886187,Staff,0,0,0,0
1745137302536,AWP 10R,015,886188,Staff,0,0,0,0
1745137302536,AWP 10R,016,886189,Staff,0,0,0,0
1745137303561,AWP 102R,A00,886190,Staff,0,0,0,0
1745137303561,AWP 102R,B00,886191,Staff,0,0,0,0
1745137304588,BENG 100,A01,886193,Staff,19,0,30,11
1745137305617,BENG 122A,A01,886195,Hasty; Jeff M,20,0,30,10
1745137306646,BENG 166A,A00,886196,Sah; Robert Lie-Yuan,0,3,20,20
1745137307671,BIBC 102,A01,894320,Staff,0,2,46,46
1745137307671,BIBC 102,A02,894321,Staff,0,0,46,46
1745137307671,BIBC 102,A03,894344,Staff,21,0,46,25
1745137307671,BIBC 102,A04,894345,Staff,30,0,47,17
1745137308697,BICD 100R,A01,894365,Smith; Laurie,1,3,58,57
1745137308697,BICD 100R,A02,894366,Smith; Laurie,0,1,58,58
1745137308697,BICD 100R,A03,894367,Smith; Laurie,13,0,59,46
1745137309728,BICD 136,A01,894383,Gustafson-Brown; Cindy,16,0,50,34
1745137310754,BIEB 102,A01,894494,Butler; Shannon Rhey,67,0,130,63
1745137312811,BIEB 150,A01,894617,Wills; Christopher,0,3,13,13
1745137312811,BIEB 150,A02,894631,Wills; Christopher,0,3,13,13
1745137312811,BIEB 150,A03,894937,Wills; Christopher,0,3,13,13
1745137312811,BIEB 150,A04,894946,Wills; Christopher,0,1,11,11
1745137313840,BIEB 194,A00,906141,Kurle; Carolyn M.,14,0,20,6
1745137314867,BILD 1,A01,894154,Staff,8,0,19,11
1745137314867,BILD 1,A02,894155,Staff,15,0,19,4
1745137314867,BILD 1,A03,894160,Staff,18,0,19,1
1745137314867,BILD 1,A04,894161,Staff,16,0,18,2
1745137315893,BILD 2,A01,894168,Staff,0,0,50,50
1745137315893,BILD 2,A02,894169,Staff,0,0,50,50
1745137315893,BILD 2,A03,894179,Staff,27,0,50,23
1745137315893,BILD 2,A04,894203,Staff,42,0,50,8
1745137316960,BILD 3,A01,894213,Staff,24,0,31,7
1745137316960,BILD 3,A02,894214,Staff,28,0,31,3
1745137316960,BILD 3,A03,894235,Staff,30,0,31,1
1745137316960,BILD 3,A04,894236,Staff,29,0,32,3
1745137317987,BILD 4,A01,894253,Reuther; Keefe,12,0,24,12
1745137317987,BILD 4,A02,894258,Reuther; Keefe,19,0,24,5
1745137319011,BILD 5,A01,894276,Reuther; Keefe,40,0,50,10
1745137319011,BILD 5,A02,894277,Reuther; Keefe,48,0,50,2
1745137319011,BILD 5,A03,894290,Reuther; Keefe,47,0,50,3
1745137319011,BILD 5,A04,894291,Reuther; Keefe,50,0,50,0
1745137320037,BILD 24,A01,894297,Pirino; Giorgia,46,0,60,14
1745137321067,BIMM 100,A01,895012,Staff,0,14,0,1
1745137321067,BIMM 100,A02,895013,Staff,0,6,0,2
1745137321067,BIMM 100,A03,895014,Staff,0,7,0,0
1745137321067,BIMM 100,A04,895015,Staff,0,4,0,0
1745137322095,BIMM 101,A01,895017,McDonnell; Lisa Marie,0,2,24,24
1745137322095,BIMM 101,A02,895018,McDonnell; Lisa Marie,0,1,24,24
1745137322095,BIMM 101,B01,895020,McDonnell; Lisa Marie,0,3,24,24
1745137322095,BIMM 101,B02,895021,McDonnell; Lisa Marie,0,2,24,24
1745137323121,BIMM 110,A01,895023,Staff,7,0,25,18
1745137323121,BIMM 110,A02,895024,Staff,11,0,25,14
1745137323121,BIMM 110,A03,895025,Staff,22,0,25,3
1745137323121,BIMM 110,A04,895031,Staff,21,0,25,4
1745137324147,BIMM 120,A01,895114,Gustafson-Brown; Cindy,8,0,28,20
1745137324147,BIMM 120,A02,895126,Gustafson-Brown; Cindy,19,0,27,8
1745137325173,BIPN 100,A01,895130,Yang; Mingyu,13,0,38,25
1745137325173,BIPN 100,A02,895131,Yang; Mingyu,33,0,38,5
1745137325173,BIPN 100,A03,895132,Yang; Mingyu,33,0,38,5
1745137325173,BIPN 100,A04,895133,Yang; Mingyu,30,0,36,6
1745137326198,BIPN 120,A01,895135,Cooke; James Edward,0,3,13,13
1745137326198,BIPN 120,A02,895136,Cooke; James Edward,0,1,13,13
1745137326198,BIPN 120,A03,895137,Cooke; James Edward,0,0,13,13
1745137326198,BIPN 120,A04,895156,Cooke; James Edward,4,0,11,7
1745137327227,BIPN 134,A01,895235,Cooke; James Edward,0,3,25,25
1745137327227,BIPN 134,A02,895237,Cooke; James Edward,0,0,25,25
1745137327227,BIPN 134,A03,895240,Cooke; James Edward,13,0,25,12
1745137327227,BIPN 134,A04,895270,Cooke; James Edward,24,0,25,1
1745137328252,BIPN 189,A00,892103,Staff,0,20,9,9
1745137330304,CAT 124,A01,922009,Staff,0,1,20,20
1745137331336,CAT 125R,A00,886390,Morales; Celeste Georgianna,4,0,20,16
1745137331336,CAT 125R,B00,886391,Irwin; Matthew Joseph,0,1,20,20
1745137331336,CAT 125R,C00,886392,Smith; Lauryn Alissa,11,0,20,9
1745137331336,CAT 125R,D00,886393,Vanderschuit; Maya Alysia,6,0,20,14
1745137331336,CAT 125R,E00,886394,Marchisotto; Jennifer Anne,0,2,20,20
1745137332363,CENG 15,A01,886218,Drews; Aaron,1,0,5,4
1745137333390,CENG 113,A00,886219,Opatkiewicz; Justin Paul,16,0,25,9
1745137334417,CGS 101,A00,887044,Staff,13,0,20,7
1745137335441,CGS 105,A01,887046,Staff,16,0,25,9
1745137336468,CGS 112,A00,887047,Cuong; Marisol,12,0,15,3
1745137337494,CGS 113,A00,887048,Staff,24,0,30,6
1745137338521,CGS 120,A00,887049,Staff,12,0,17,5
1745137339549,CHEM 6A,A01,886336,Lam; Tin Yiu,44,0,50,6
1745137339549,CHEM 6A,A02,886338,Lam; Tin Yiu,43,0,50,7
1745137340574,CHEM 6B,A01,886341,Hopkins; Patrycja Anna,21,0,50,29
1745137340574,CHEM 6B,A02,886343,Hopkins; Patrycja Anna,46,0,50,4
1745137341602,CHEM 6C,A01,886346,Albizati; Kim F.,0,1,50,50
1745137341602,CHEM 6C,A02,886348,Albizati; Kim F.,38,0,50,12
1745137342628,CHEM 40A,A01,886352,Klosterman; Jeremy K,70,0,100,30
1745137343654,CHEM 40B,A01,886356,Klosterman; Jeremy K,0,4,100,100
1745137344684,CHEM 41B,A01,886360,Theodorakis; Emmanuel,30,0,50,20
1745137344684,CHEM 41B,A02,886362,Theodorakis; Emmanuel,46,0,50,4
1745137345710,CHIN 165A,A00,886382,Xu; Li,19,0,20,1
1745137346738,CLAS 120,A00,886387,Myerston Santana; Jacobo,36,0,40,4
1745137347764,COGS 9,A01,886967,Shannon; Kyle Michael,49,0,60,11
1745137348790,COGS 11,A01,886969,Staff,18,0,30,12
1745137349816,COGS 14A,A01,886971,Staff,26,0,60,34
1745137350840,COGS 14B,A01,886973,Hoffman; Drew Ellen,18,0,60,42
1745137351869,COGS 18,A01,886975,Morgan; Eric,41,0,60,19
1745137352895,COGS 20,A01,886977,Staff,6,0,8,2
1745137352895,COGS 20,A02,886978,Staff,6,0,7,1
1745137353922,COGS 100,A01,907783,Staff,6,0,30,24
1745137354948,COGS 101B,A01,886980,Staff,0,10,30,30
1745137355975,COGS 101C,A01,886982,Delgado; Tania,0,6,30,30
1745137357001,COGS 102A,A01,886984,Johnson; Christine M.,13,0,30,17
1745137358026,COGS 118B,A01,886986,Staff,0,25,60,60
1745137359053,COGS 150,A01,886988,Bergen; Benjamin,16,0,30,14
1745137360078,COGS 153,A00,886989,Delgado; Tania,0,6,30,30
1745137361104,COGS 186,A01,886991,Staff,3,0,30,27
1745137362129,COGS 187A,A01,886993,Boyle; Mary E. T.,12,0,30,18
1745137363154,COGS 189,A00,886994,Staff,13,0,30,17
1745137364180,COMM 10,A01,886996,Staff,11,0,25,14
1745137364180,COMM 10,A02,886997,Staff,21,0,25,4
1745137365209,COMM 20,A01,886999,Leuning; Grant Maurstad,33,0,40,7
1745137367260,COMM 100A,A01,887002,Staff,0,0,25,25
1745137367260,COMM 100A,A02,887003,Staff,20,0,25,5
1745137368285,COMM 100B,A01,887005,Staff,0,1,25,25
1745137369310,COMM 106D,A00,887006,Staff,22,0,40,18
1745137370333,COMM 110G,A00,887007,Whitworth-Smith; Andrew C,17,0,40,23
1745137371361,COMM 111B,A00,887008,Staff,31,0,40,9
1745137372396,COMM 113T,A00,887009,Abuelhiga; Soraya Jill,30,0,40,10
1745137372396,COMM 113T,B00,906733,Staff,40,0,40,0
1745137373422,COMM 145,A00,887010,Staff,21,0,40,19
1745137374448,COMM 146,A00,887054,Staff,31,0,40,9
1745137375475,COMM 190,A00,887012,Staff,9,0,23,14
1745137376499,CSE 8A,A50,887015,Cao; Yingjun,68,0,85,17
1745137377529,CSE 11,A01,887017,Cao; Yingjun,35,0,70,35
1745137378557,CSE 20,A01,887019,Staff,35,0,50,15
1745137379583,CSE 21,A01,887021,Braun; Oliver,81,0,100,19
1745137379583,CSE 21,B01,892583,Staff,48,0,50,2
1745137380612,CSE 30,A01,887025,Eldon; John,161,0,200,39
1745137381640,CSE 100,A01,887027,Staff,28,0,50,22
1745137381640,CSE 100,A02,887028,Staff,43,0,50,7
1745137382666,CSE 101,A01,887030,Braun; Oliver,79,0,100,21
1745137382666,CSE 101,B01,887032,Jones; Miles E,0,1,50,50
1745137382666,CSE 101,B02,887033,Jones; Miles E,13,0,50,37
1745137383692,CSE 105,A01,908084,Jones; Miles E,36,0,50,14
1745137383692,CSE 105,A02,908087,Jones; Miles E,38,0,50,12
1745137384720,CSE 135,A01,887035,Powell; Thomas Allan,8,0,50,42
1745137385749,CSE 142,A01,887037,Staff,22,0,60,38
1745137386775,CSE 142L,A01,887039,Staff,42,0,60,18
1745137387804,CSE 151A,A01,887041,Solares; Edwin A,60,0,100,40
1745137388829,CSE 175,A01,887043,Kumar; Rakesh,30,0,30,0
1745137389857,CSS 1,A01,886389,Staff,12,0,40,28
1745137390883,DSC 30,A01,908097,Liao; Soohyun Nam,54,0,75,21
1745137391910,DSC 40A,A01,908099,Shannon; Kyle Michael,37,0,50,13
1745137392935,DSC 40B,A01,908112,Staff,28,0,50,22
1745137393963,DSC 80,A01,908116,Staff,32,0,60,28
1745137394988,DSC 197,001,956863,Eldridge; Justin Matthew,9999,0,9999,0
1745137396016,ECE 5,A01,886400,Morris; Karcher William,3,0,6,3
1745137396016,ECE 5,A02,886401,Morris; Karcher William,5,0,6,1
1745137397042,ECE 148,A01,886403,Silberman; Jack,0,8,14,14
1745137398067,ECON 1,A01,887265,Crane; Meredith Helen,25,0,70,45
1745137398067,ECON 1,B01,887268,Staff,44,0,50,6
1745137399096,ECON 2,A01,887273,Crane; Meredith Helen,61,0,70,9
1745137400127,ECON 3,A01,887279,Rondina; Giacomo,44,0,70,26
1745137401153,ECON 4,A01,887282,Anderson; John Charles,0,1,10,10
1745137402180,ECON 5,A01,887285,Staff,39,0,45,6
1745137402180,ECON 5,B01,887292,Staff,43,0,45,2
1745137403210,ECON 100A,A01,887337,Newhouse; Herbert S,58,0,70,12
1745137403210,ECON 100A,B01,887349,Staff,45,0,50,5
1745137404237,ECON 100B,A01,887361,Du; Songzi,42,0,70,28
1745137405263,ECON 100C,A01,887445,Newhouse; Herbert S,61,0,70,9
1745137406288,ECON 105,A00,887488,Vespa; Emanuel Ignacio,24,0,35,11
1745137407313,ECON 109,A01,887506,Staff,29,0,35,6
1745137408343,ECON 110A,A01,887568,Alon; Titan Michael,1,0,35,34
1745137408343,ECON 110A,B01,907601,Alon; Titan Michael,27,0,35,8
1745137409372,ECON 110B,A01,887598,Levkoff; Steven B.,0,7,70,70
1745137410399,ECON 112,A00,887599,Rondina; Giacomo,20,0,35,15
1745137411427,ECON 120A,A01,887603,Dai; Yinlin,46,0,70,24
1745137412457,ECON 120C,A01,887608,Sun; Yixiao,0,0,35,35
1745137412457,ECON 120C,B01,887614,Sun; Yixiao,13,0,35,22
1745137413487,ECON 138,A00,887621,Bharadwaj; Prashant,0,18,20,20
1745137414513,ECON 171,A01,907666,Staff,27,0,35,8
1745137415540,ECON 175,A00,887626,Wu; Pak Yeung,27,0,35,8
1745137416565,ECON 190,A00,887640,Vespa; Emanuel Ignacio,26,0,35,9
1745137417599,EDS 25,A01,888197,Staff,0,0,0,0
1745137417599,EDS 25,A02,888209,Staff,0,0,0,0
1745137417599,EDS 25,A03,888210,Staff,0,0,0,0
1745137417599,EDS 25,A04,888212,Staff,0,0,0,0
1745137417599,EDS 25,A05,888213,Staff,0,0,0,0
1745137417599,EDS 25,A06,888214,Staff,0,0,0,0
1745137417599,EDS 25,A07,888235,Staff,0,0,0,0
1745137417599,EDS 25,A08,888236,Staff,0,0,0,0
1745137417599,EDS 25,A09,888240,Staff,0,0,0,0
1745137417599,EDS 25,A10,888244,Staff,0,0,0,0
1745137417599,EDS 25,B01,888273,Staff,0,0,0,0
1745137417599,EDS 25,B02,888285,Staff,0,0,0,0
1745137417599,EDS 25,B03,888423,Staff,29,0,30,1
1745137417599,EDS 25,B04,888432,Staff,0,0,0,0
1745137417599,EDS 25,B05,888433,Staff,0,0,0,0
1745137417599,EDS 25,B06,888467,Staff,0,0,0,0
1745137417599,EDS 25,B07,888468,Staff,0,0,0,0
1745137417599,EDS 25,B08,888479,Staff,0,0,0,0
1745137417599,EDS 25,B09,888484,Staff,0,0,0,0
1745137417599,EDS 25,B10,888487,Staff,0,0,0,0
1745137418624,EDS 38,A01,907700,Choi; Bailey Miyeon,30,0,30,0
1745137419651,EDS 112,A01,888601,Chapman; Thandeka K,23,0,40,17
1745137420676,EDS 115,A00,888697,Mendez; Kathrina Mendoza,17,0,30,13
1745137421701,EDS 116,A01,888893,Staff,38,0,40,2
1745137423752,EDS 124AR,A00,889133,Staff,33,0,50,17
1745137423752,EDS 124AR,B00,907471,Simon; Elizabeth A,42,0,50,8
1745137424779,EDS 124BR,A00,889134,Staff,57,0,100,43
1745137425805,EDS 125,A00,889135,Staff,26,0,30,4
1745137426830,EDS 126,A01,889138,Staff,37,0,40,3
1745137427858,EDS 164R,A01,889142,Wishard Guerra; Alison G.,38,0,50,12
1745137428883,ENG 30,A01,886396,Staff,0,0,0,0
1745137428883,ENG 30,B01,886398,Staff,0,0,0,0
1745137429909,ENVR 102,A00,906150,Montejo; Carolina,23,0,25,2
1745137430933,ETHN 103A,A00,887236,Man; Simeon S,0,5,0,0
1745137431961,ETHN 113,A00,887239,Staff,20,0,30,10
1745137432986,ETHN 116,A00,887240,Staff,20,0,25,5
1745137434011,ETHN 117,A00,887241,Choi; Esther Min,27,0,30,3
1745137435040,ETHN 118,A00,887243,Staff,24,0,30,6
1745137436067,ETHN 127,A00,887248,Cuong; Marisol,12,0,15,3
1745137437095,ETHN 139,A00,887250,Staff,8,0,10,2
1745137438122,ETHN 142,A00,887252,Staff,18,0,30,12
1745137439150,ETHN 161,A00,887253,Browne; Errol Tsekani,28,0,30,2
1745137440177,ETHN 163FR,A00,887255,Burelle; Julie Sara Veronique,4,0,5,1
1745137441205,GLBH 20,A00,889149,Elwardani; Nile Regina,15,0,42,27
1745137443257,GLBH 111,A01,889152,Burgos; Jose L.,17,0,17,0
1745137444282,GLBH 150,A00,889181,Sloane; Julia Kathryn,0,1,15,15
1745137446336,HDS 60,A01,886406,Warstadt; Melissa Fawn,76,0,80,4
1745137447362,HIAF 111,A00,889324,Gyamfi; Bright,0,4,0,0
1745137448390,HIEA 131,A00,889328,Staff,14,0,32,18
1745137449415,HIEA 144,A00,889333,Henry; Todd A.,29,0,32,3
1745137450444,HIEA 154,A00,889336,Henry; Todd A.,28,0,32,4
1745137451468,HIEU 106,A00,889339,Staff,28,0,32,4
1745137453519,HIEU 114,A00,889340,Staff,18,0,32,14
1745137454547,HIEU 135GS,A00,889342,Patterson; Patrick H.,0,0,1,22
1745137455574,HIEU 137,A00,889343,Edington; Claire Ellen,12,0,25,13
1745137456603,HIEU 148,A00,889345,Staff,16,0,32,16
1745137457631,HIEU 154,A00,889346,Biess; Frank Peter,24,0,32,8
1745137458657,HILA 102,A00,889351,Staff,13,0,32,19
1745137459681,HILD 2A,A01,889221,Lewandoski; Julia Mavis,0,5,32,32
1745137460708,HILD 7B,A01,889225,Man; Simeon S,0,7,32,32
1745137461732,HILD 7C,A01,889288,Alvarez; Luis A,0,7,32,32
1745137462758,HILD 30,A01,889323,Staff,0,1,32,32
1745137464812,HISC 119,A00,889383,Golan; Tal,22,0,32,10
1745137465837,HIUS 103,A00,889384,Man; Simeon S,10,0,32,22
1745137466865,HIUS 117,A00,919797,Kwak; Nancy,23,0,32,9
1745137467893,HIUS 142A,A00,919788,Staff,24,0,32,8
1745137469943,HIUS 149,A00,889386,Gyamfi; Bright,0,1,0,0
1745137470968,HIUS 155,A00,889387,Alvarez; Luis A,19,0,32,13
1745137471993,HUM 3,A01,886499,Caldwell; Michael Alan,24,0,50,26
1745137473017,HUM 3GS,A00,886500,Rodriguez; Bretton Sigfred,0,0,0,26
1745137474046,HUM 3R,A01,886502,Markman; Kristina,0,32,50,50
1745137475076,HUM 4,A01,886504,Crum; Matthew Stephen,28,0,50,22
1745137475076,HUM 4,B01,886506,West; Geoffrey Scott,25,0,50,25
1745137476102,HUM 4GS,A00,886507,Staff,0,0,0,13
1745137477130,HUM 5,A01,886509,Staff,35,0,50,15
1745137478159,HUM 5R,A01,886511,Zavodny; Tatiana Sophia,0,32,50,50
1745137479186,JAPN 180,A00,886407,Staff,25,0,40,15
1745137480211,LATI 50,A01,886409,Martin-Cabrera; Luis,9,0,22,13
1745137480211,LATI 50,A02,886410,Martin-Cabrera; Luis,20,0,22,2
1745137480211,LATI 50,A03,886411,Martin-Cabrera; Luis,22,0,22,0
1745137480211,LATI 50,A04,886412,Martin-Cabrera; Luis,15,0,22,7
1745137481240,LAWS 101,A00,907664,Staff,36,0,60,24
1745137482267,LIAB 1A,A00,889388,Saab; Dima,19,0,20,1
1745137483294,LIAB 1AX,A00,889389,El Cheddadi; Youniss,19,0,20,1
1745137484324,LIFR 1C,A00,889391,Van Moer; Vinciane G,9,0,20,11
1745137485350,LIFR 1CX,A00,889392,Van Moer; Vinciane G,8,0,20,12
1745137486379,LIFR 1D,A00,889393,Van Moer; Vinciane G,11,0,20,9
1745137487405,LIFR 1DX,A00,889394,Van Moer; Vinciane G,11,0,20,9
1745137488433,LIGN 7,A00,886923,Staff,30,0,50,20
1745137489462,LIGN 17,A00,886924,Kehler; Andrew Scott,133,0,150,17
1745137490486,LTAM 110,A00,889395,Staff,17,0,30,13
1745137491514,LTCH 101,A00,889397,Staff,22,0,25,3
1745137492541,LTCS 130,A00,889398,Staff,23,0,25,2
1745137493566,LTEA 138,A00,889399,Staff,25,0,40,15
1745137494593,LTEN 149,A00,889400,Wesling; Megan E.,6,0,25,19
1745137495621,LTEN 169,A00,889401,Staff,24,0,25,1
1745137496647,LTEN 180,A00,889402,Staff,12,0,15,3
1745137497672,LTEN 181,A00,889403,Staff,23,0,25,2
1745137498701,LTWL 100,A00,889404,Myerston Santana; Jacobo,8,0,25,17
1745137499728,LTWL 180GS,A00,889405,Staff,6,0,20,14
1745137500754,LTWL 181,A00,889406,Staff,19,0,25,6
1745137501780,LTWL 184,A00,889475,Mukherjee; Silpa,21,0,25,4
1745137502809,LTWR 102C,A00,889486,Staff,29,0,30,1
1745137503838,LTWR 115W,A00,889491,Staff,3,0,15,12
1745137504863,MAE 8,A01,886905,Staff,0,2,0,0
1745137505892,MAE 11,A00,886906,Bandaru; Prabhakar,0,0,50,50
1745137506918,MAE 20,A00,886907,Evdokimenko; Ekaterina,50,0,70,20
1745137507944,MAE 30B,A00,886909,Ghazinejad; Maziar,28,0,45,17
1745137508969,MAE 101B,A00,886910,Saintillan; David,36,0,45,9
1745137509997,MAE 105,A00,886911,Bandaru; Prabhakar,26,0,50,24
1745137511022,MAE 107,A00,886912,Staff,22,0,60,38
1745137512052,MAE 143B,A00,886913,Bewley; Thomas R,14,0,40,26
1745137513080,MAE 148,A01,886915,Silberman; Jack,5,0,14,9
1745137514109,MAE 160,A00,886916,Evdokimenko; Ekaterina,41,0,60,19
1745137515136,MATH 3C,A01,889681,Staff,2,0,30,28
1745137516161,MATH 10A,A01,889760,Staff,28,0,30,2
1745137516161,MATH 10A,A02,889783,Staff,30,0,30,0
1745137517187,MATH 10B,A01,889785,Verstraete; Jacques Allan,0,2,30,30
1745137517187,MATH 10B,A02,889795,Verstraete; Jacques Allan,0,2,30,30
1745137517187,MATH 10B,B01,889797,Verstraete; Jacques Allan,1,0,30,29
1745137517187,MATH 10B,B02,889828,Verstraete; Jacques Allan,23,0,30,7
1745137518217,MATH 10C,A01,889849,Habib; Yousaf,18,0,30,12
1745137518217,MATH 10C,A02,889852,Habib; Yousaf,20,0,30,10
1745137518217,MATH 10C,A03,889853,Habib; Yousaf,25,0,30,5
1745137518217,MATH 10C,A04,889858,Habib; Yousaf,21,0,30,9
1745137518217,MATH 10C,B01,889861,Staff,12,0,30,18
1745137518217,MATH 10C,B02,889862,Staff,26,0,30,4
1745137518217,MATH 10C,B03,889863,Staff,28,0,30,2
1745137518217,MATH 10C,B04,889967,Staff,25,0,30,5
1745137519246,MATH 18,A01,889974,Staff,15,0,30,15
1745137519246,MATH 18,A02,889977,Staff,25,0,30,5
1745137519246,MATH 18,B01,889984,Hardiman; Liam,26,0,30,4
1745137519246,MATH 18,B02,889985,Hardiman; Liam,28,0,30,2
1745137520271,MATH 20A,A01,889990,Suk; Andrew Hoon,31,0,35,4
1745137521298,MATH 20B,A01,889993,Ohm; Ko Woon,21,0,30,9
1745137521298,MATH 20B,A02,889994,Ohm; Ko Woon,30,0,30,0
1745137521298,MATH 20B,B01,889996,Ohm; Ko Woon,25,0,30,5
1745137521298,MATH 20B,B02,889997,Ohm; Ko Woon,24,0,30,6
1745137522330,MATH 20C,A01,889999,Hammock; Frances H,22,0,30,8
1745137522330,MATH 20C,A02,890003,Hammock; Frances H,23,0,30,7
1745137522330,MATH 20C,B01,890006,Hammock; Frances H,11,0,30,19
1745137522330,MATH 20C,B02,890007,Hammock; Frances H,18,0,30,12
1745137523361,MATH 20D,A01,890011,Cheng; Hsiao-Bing,6,0,30,24
1745137523361,MATH 20D,A02,890012,Cheng; Hsiao-Bing,27,0,30,3
1745137523361,MATH 20D,B01,890016,Cheng; Hsiao-Bing,19,0,30,11
1745137523361,MATH 20D,B02,890017,Cheng; Hsiao-Bing,15,0,30,15
1745137524391,MATH 20E,A01,890026,Harel; Guershon,10,0,30,20
1745137524391,MATH 20E,A02,890029,Harel; Guershon,24,0,30,6
1745137524391,MATH 20E,B01,890033,Harel; Guershon,14,0,30,16
1745137524391,MATH 20E,B02,890101,Harel; Guershon,27,0,30,3
1745137525418,MATH 102,A01,890104,Staff,20,0,30,10
1745137525418,MATH 102,A02,890105,Staff,30,0,30,0
1745137526445,MATH 103B,A01,890116,Salehi Golsefidy; Alireza,8,0,30,22
1745137526445,MATH 103B,B01,890118,Staff,0,4,30,30
1745137527471,MATH 109,A01,890121,Aliabadi Sr.; Mohsen,6,0,30,24
1745137527471,MATH 109,B01,890124,Upadrashta; Pranav Kumar,23,0,30,7
1745137528501,MATH 120A,A01,890126,Eggers; John Dietrich,15,0,30,15
1745137529527,MATH 142B,A01,890128,Ioana; Adrian,17,0,30,13
1745137529527,MATH 142B,A02,890129,Ioana; Adrian,15,0,30,15
1745137530554,MATH 154,A01,890174,Staff,0,1,30,30
1745137530554,MATH 154,A02,890182,Staff,15,0,30,15
1745137531585,MATH 168A,A01,890197,Dumitriu; Ioana,22,0,35,13
1745137532611,MATH 170A,A01,890240,Nie; Jiawang,6,0,30,24
1745137532611,MATH 170A,A02,890241,Nie; Jiawang,18,0,30,12
1745137532611,MATH 170A,A03,890249,Nie; Jiawang,23,0,30,7
1745137533636,MATH 170B,A01,957891,Nag; Panchali,25,0,35,10
1745137535690,MATH 181A,A01,908025,Staff,0,8,35,35
1745137536718,MATH 193B,A01,890265,Staff,3,0,35,32
1745137537745,MGT 4,A01,890311,Anderson; John Charles,57,0,88,31
1745137538771,MGT 5,A00,907740,Staff,41,0,98,57
1745137539796,MGT 12,A00,890312,Lindenberger; Wade Douglas,70,0,98,28
1745137540822,MGT 16,A00,957883,Staff,84,0,98,14
1745137542877,MGT 45,A00,890314,Pecore; Joseph P.,57,0,98,41
1745137543903,MGT 71,A00,890315,Staff,6,0,98,92
1745137544927,MGT 100,A00,890316,Yavorsky; Daniel Ryan,59,0,98,39
1745137545954,MGT 103,A00,890317,Ehrich; Kristine R,77,0,98,21
1745137546981,MGT 105,A00,890356,Bates; Kenneth Walter,19,0,98,79
1745137548007,MGT 112,A00,890360,Ehrich; Kristine R,65,0,98,33
1745137549033,MGT 127R,A00,907732,Zhu; Kevin Xiaoguo,32,0,98,66
1745137550062,MGT 131B,A00,890361,Anderson; John Charles,75,0,98,23
1745137551089,MGT 137,A00,890362,Lindenberger; Wade Douglas,68,0,98,30
1745137552114,MGT 160,A00,890369,Johnson; Erik Barry,37,0,98,61
1745137554170,MGT 164,A00,890372,Zimmermann; Carsten,0,28,98,98
1745137555195,MGT 180,A00,890374,Bliss; Barbara Ann,32,0,98,66
1745137556221,MMW 15,A01,886414,Chang; Edmond Yi-Teh,0,10,28,28
1745137556221,MMW 15,A02,886415,Chang; Edmond Yi-Teh,0,10,28,28
1745137556221,MMW 15,A03,886416,Chang; Edmond Yi-Teh,0,8,28,28
1745137556221,MMW 15,A04,886417,Chang; Edmond Yi-Teh,0,8,28,28
1745137556221,MMW 15,B01,886419,Chang; Edmond Yi-Teh,0,8,28,28
1745137556221,MMW 15,B02,886420,Chang; Edmond Yi-Teh,0,9,28,28
1745137556221,MMW 15,B03,886421,Chang; Edmond Yi-Teh,0,9,28,28
1745137556221,MMW 15,B04,886422,Chang; Edmond Yi-Teh,0,9,28,28
1745137556221,MMW 15,C01,886424,Staff,0,10,28,28
1745137556221,MMW 15,C02,886425,Staff,0,10,28,28
1745137556221,MMW 15,C03,886426,Staff,0,9,28,28
1745137556221,MMW 15,C04,886427,Staff,0,9,28,28
1745137557245,MMW 15GS,A00,906910,Patterson; Patrick H.,5,0,28,23
1745137558271,MMW 122R,A01,886429,Rahimi; Babak,0,23,28,28
1745137558271,MMW 122R,A02,886430,Rahimi; Babak,0,23,28,28
1745137559299,MUS 1A,A01,890937,Staff,8,0,25,17
1745137559299,MUS 1A,A02,891035,Staff,15,0,25,10
1745137559299,MUS 1A,B00,907849,Staff,48,0,50,2
1745137559299,MUS 1A,B01,907850,Staff,25,0,25,0
1745137559299,MUS 1A,B02,907851,Staff,25,0,25,0
1745137561356,MUS 2AK,A00,957092,Ohnishi; Takae,15,0,15,0
1745137562390,MUS 4,A01,891044,Staff,6,0,25,19
1745137562390,MUS 4,A02,891045,Staff,24,0,25,1
1745137562390,MUS 4,B01,891048,Staff,20,0,25,5
1745137562390,MUS 4,B02,891050,Staff,25,0,25,0
1745137563415,MUS 5,A01,957506,Dubnov; Shlomo,4,0,25,21
1745137563415,MUS 5,A02,957622,Dubnov; Shlomo,21,0,25,4
1745137563415,MUS 5,A03,957623,Dubnov; Shlomo,23,0,25,2
1745137564441,MUS 6,A01,891053,Freitas Caetano; Marcelo,23,0,25,2
1745137564441,MUS 6,A02,891054,Freitas Caetano; Marcelo,23,0,25,2
1745137565468,MUS 7,A01,891081,Staff,0,0,25,25
1745137565468,MUS 7,A02,891082,Staff,15,0,25,10
1745137566493,MUS 8GS,A00,891118,Borgo; David Garcia,5,0,25,20
1745137567522,MUS 11,A01,891140,Staff,12,0,25,13
1745137567522,MUS 11,A02,891141,Staff,24,0,25,1
1745137568548,MUS 13,A01,891143,Staff,10,0,25,15
1745137568548,MUS 13,A02,891144,Staff,25,0,25,0
1745137569574,MUS 15,A01,891146,Staff,7,0,25,18
1745137569574,MUS 15,A02,891148,Staff,22,0,25,3
1745137569574,MUS 15,B01,891150,Staff,18,0,25,7
1745137569574,MUS 15,B02,891151,Staff,25,0,25,0
1745137570604,MUS 20,A01,891153,Staff,9,0,20,11
1745137570604,MUS 20,A02,891155,Staff,16,0,20,4
1745137571630,MUS 80,A00,891156,Staff,19,0,25,6
1745137571630,MUS 80,B00,891157,Staff,25,0,25,0
1745137572656,MUS 130,A00,891158,Ohnishi; Takae,35,0,35,0
1745137573683,MUS 150GS,A01,891160,Borgo; David Garcia,5,0,25,20
1745137574710,MUS 170,A01,891162,Freitas Caetano; Marcelo,21,0,25,4
1745137574710,MUS 170,A02,891164,Freitas Caetano; Marcelo,22,0,25,3
1745137575736,NANO 11,A00,886220,Vazquez Mena; Oscar,12,0,15,3
1745137576762,NANO 15,A01,886222,Drews; Aaron,9,0,10,1
1745137577790,NANO 104,A00,886224,Sirbuly; Donald,18,0,25,7
1745137578817,PH 40,A00,886528,Staff,29,0,40,11
1745137579845,PH 45,A01,886799,Staff,36,0,40,4
1745137580873,PH 110,A00,886802,Staff,7,0,40,33
1745137581900,PH 172,A00,906716,Staff,20,0,35,15
1745137582929,PH 191,A00,886803,Staff,23,0,40,17
1745137583957,PHIL 1,A00,889500,Staff,22,0,30,8
1745137584983,PHIL 10,A01,889549,Grush; Rick Scott,17,0,22,5
1745137584983,PHIL 10,A02,889551,Grush; Rick Scott,20,0,22,2
1745137586010,PHIL 28,A01,889559,Lamey; Andy M.,0,4,25,25
1745137586010,PHIL 28,A02,889561,Lamey; Andy M.,0,0,25,25
1745137586010,PHIL 28,A03,889572,Lamey; Andy M.,7,0,25,18
1745137587037,PHIL 35,A00,907839,Staff,32,0,33,1
1745137588061,PHIL 60,A00,889574,Staff,79,0,90,11
1745137589086,PHIL 105,A00,889579,Staff,0,1,0,0
1745137590113,PHIL 136,A00,889582,Fulkerson; Matthew Todd,27,0,45,18
1745137591140,PHIL 163,A01,889601,Staff,24,0,30,6
1745137591140,PHIL 163,B01,889606,Brandt; Reuven A,0,2,0,0
1745137592164,PHIL 164,A00,889610,Staff,20,0,30,10
1745137593190,PHIL 165,A00,889613,Staff,26,0,30,4
1745137594217,PHYS 1A,A00,886431,Staff,38,0,70,32
1745137595242,PHYS 1AL,001,886432,Tsai; Philbert S,0,0,30,30
1745137595242,PHYS 1AL,002,886436,Tsai; Philbert S,19,0,30,11
1745137596268,PHYS 1B,A00,886439,Staff,192,0,240,48
1745137597296,PHYS 1BL,001,886441,Tsai; Philbert S,0,1,30,30
1745137597296,PHYS 1BL,002,886444,Tsai; Philbert S,14,0,30,16
1745137598325,PHYS 1C,A00,896092,Arnold; Kam S,87,0,146,59
1745137599352,PHYS 1CL,001,886448,Tsai; Philbert S,0,4,30,30
1745137599352,PHYS 1CL,002,886449,Tsai; Philbert S,6,0,30,24
1745137599352,PHYS 1CL,003,886450,Tsai; Philbert S,22,0,30,8
1745137599352,PHYS 1CL,004,886451,Tsai; Philbert S,16,0,30,14
1745137600380,PHYS 2B,A01,886457,Staff,86,0,115,29
1745137601404,PHYS 2C,A01,886460,Shotwell; Brian,0,0,65,65
1745137602430,PHYS 2CL,A01,886467,Staff,0,3,28,28
1745137602430,PHYS 2CL,A02,886468,Staff,5,0,28,23
1745137603456,PHYS 2D,A01,886470,Staff,17,0,50,33
1745137604482,PHYS 4B,A01,886475,Grinstein; Benjamin,88,0,100,12
1745137605508,POLI 5,A00,891173,Desposato; Scott,17,0,25,8
1745137606534,POLI 5D,A01,891175,Staff,5,0,5,0
1745137606534,POLI 5D,B01,891178,Staff,5,0,5,0
1745137607562,POLI 11,A00,891179,Ferree; Karen E,3,0,25,22
1745137608587,POLI 12,A00,891180,Staff,21,0,30,9
1745137609629,POLI 27,A01,891182,Staff,29,0,75,46
1745137610656,POLI 30,A00,891183,Staff,0,3,30,30
1745137611682,POLI 100B,A00,891244,Staff,0,8,20,20
1745137612708,POLI 100I,A00,891247,Staff,19,0,30,11
1745137613736,POLI 104J,A00,891248,Nichter; Maysa,18,0,30,12
1745137614765,POLI 104U,A00,891250,Nichter; Maysa,9,0,30,21
1745137615789,POLI 108,A00,891253,Staff,0,0,0,4
1745137616818,POLI 110B,A00,891255,Wiens; David,22,0,25,3
1745137617844,POLI 112A,A00,891256,Wiens; David,15,0,25,10
1745137618873,POLI 114BR,A00,891261,Staff,22,0,30,8
1745137619898,POLI 117R,A00,891262,Forman; Fonna,12,0,50,38
1745137620922,POLI 118,A00,891264,Ingham; Sean,22,0,25,3
1745137621947,POLI 124A,A00,891265,Staff,19,0,20,1
1745137622974,POLI 125D,A00,891266,Nichter; Simeon C,9,0,25,16
1745137624001,POLI 126,A00,891268,Nichter; Simeon C,11,0,25,14
1745137625026,POLI 126AA,A00,891272,Staff,19,0,25,6
1745137626052,POLI 130AA,A00,891273,Staff,17,0,20,3
1745137627079,POLI 134AA,A00,891274,Staff,12,0,20,8
1745137629130,POLI 138,A00,891278,Staff,22,0,25,3
1745137630155,POLI 142K,A00,891280,Staff,17,0,25,8
1745137631182,POLI 142M,A00,891281,Gartzke; Erik,22,0,30,8
1745137632209,POLI 142P,A00,891284,Staff,21,0,30,9
1745137633234,POLI 143,A00,891285,Gartzke; Erik,17,0,30,13
1745137634258,POLI 153,A00,891286,Staff,20,0,20,0
1745137635285,POLI 170A,A00,891288,Staff,19,0,25,6
1745137636314,POLI 175,A00,891290,Staff,18,0,20,2
1745137637338,PSYC 1,A00,890674,Steiner; Eric Tomas,0,4,45,45
1745137638365,PSYC 2,A00,890676,Albright; Thomas D,25,0,35,10
1745137639391,PSYC 3,A00,890679,Staff,18,0,20,2
1745137640419,PSYC 60,A01,890684,Rickard; Timothy C.,7,0,45,38
1745137641445,PSYC 70,A01,890689,Geller; Emma Harlan,14,0,30,16
1745137642475,PSYC 100,A00,890690,Lacefield; Katharine I,0,43,180,180
1745137643500,PSYC 102,A00,890695,Staff,26,0,40,14
1745137644529,PSYC 105,A00,890699,Geller; Emma Harlan,78,0,100,22
1745137645556,PSYC 106,A00,890701,Gorman; Michael R.,15,0,30,15
1745137646581,PSYC 108,A00,890704,Adrian; Julia Anna,0,23,50,50
1745137647606,PSYC 118,A01,890712,Staff,18,0,30,12
1745137648631,PSYC 124,A00,890716,Chapman; Eddie Nathaniel,36,0,60,24
1745137649660,PSYC 131,A00,890717,Anagnostaras; Stephan,6,0,80,74
1745137650685,PSYC 137,A00,890719,Winkielman; Piotr,0,2,30,30
1745137651712,PSYC 144,A00,890721,Adrian; Julia Anna,0,3,45,45
1745137652736,PSYC 162,A00,890805,Staff,21,0,75,54
1745137653763,PSYC 169,A00,890810,Staff,0,15,30,30
1745137654791,PSYC 172,A00,890814,Gorman; Michael R.,14,0,30,16
1745137655816,PSYC 181,A00,890818,Anagnostaras; Stephan,63,0,200,137
1745137656843,PSYC 189,A00,890823,Staff,11,0,30,19
1745137657869,PSYC 191,A00,890884,Rickard; Timothy C.,0,11,35,35
1745137658898,PSYC 193,A00,890913,Staff,22,0,30,8
1745137658898,PSYC 193,B00,890914,Chapman; Eddie Nathaniel,25,0,30,5
1745137659928,PSYC 193L,A01,890918,Lowe; Angela Beth,29,0,30,1
1745137659928,PSYC 193L,B01,890921,Hurwitz; Ethan Scott,28,0,30,2
1745137659928,PSYC 193L,C01,890928,Staff,30,0,30,0
1745137660954,RELI 149,A00,886806,Rahimi; Babak,23,0,40,17
1745137661981,SE 9,A01,886814,Staff,13,0,20,7
1745137663006,SE 101B,A01,886816,Chadha; Mayank,8,0,30,22
1745137664031,SE 110B,A00,886818,Zhu; Qiang,0,16,45,45
1745137665057,SE 125,A01,886830,Staff,10,0,30,20
1745137666084,SE 130B,A01,886835,Staff,19,0,40,21
1745137667113,SE 131A,A01,886838,Krysl; Petr,37,0,55,18
1745137668136,SE 154,A00,886840,Staff,35,0,50,15
1745137669162,SE 164GS,A01,886849,Staff,13,0,20,7
1745137670187,SE 167GS,A01,886853,Staff,13,0,20,7
1745137671215,SIO 25,A01,890107,Staff,23,0,30,7
1745137672240,SIO 45,A00,890109,Cook; Geoffrey W,137,0,200,63
1745137673266,SIO 109R,A00,890110,Forman; Fonna,0,11,20,20
1745137674295,SIO 187,A01,890114,Kacev; David,21,0,40,19
1745137675322,SOCI 1,A01,890431,Thorpe; Charles Robert,21,0,30,9
1745137675322,SOCI 1,A02,890518,Thorpe; Charles Robert,30,0,30,0
1745137676351,SOCI 2,A01,957978,Staff,0,0,0,0
1745137676351,SOCI 2,A02,957979,Staff,0,3,0,0
1745137677377,SOCI 20,A01,890523,Calderon-Zaks; Michael Aar,24,0,30,6
1745137677377,SOCI 20,A02,890526,Calderon-Zaks; Michael Aar,29,0,30,1
1745137678406,SOCI 30,A01,890533,Pardo Guerra; Juan Pablo,37,0,40,3
1745137679430,SOCI 40,A01,890535,Staff,32,0,45,13
1745137680456,SOCI 104Q,A00,890559,Staff,20,0,30,10
1745137681483,SOCI 106,A00,890560,Arnal; Maud Marie Leonie,22,0,30,8
1745137682506,SOCI 110,A00,890567,Holkenbrink-Monk; Charlene,22,0,30,8
1745137683534,SOCI 112,A00,890568,Victoria Torres; Pablo,0,0,45,45
1745137684562,SOCI 115,A00,890597,Arnal; Maud Marie Leonie,33,0,45,12
1745137686613,SOCI 121,A00,890604,Pardo Guerra; Juan Pablo,40,0,45,5
1745137687641,SOCI 126,A01,890608,Staff,8,0,10,2
1745137688667,SOCI 127,A00,890609,Staff,23,0,30,7
1745137689694,SOCI 131,A00,890610,Thorpe; Charles Robert,38,0,45,7
1745137690719,SOCI 135,A00,890615,Payne; Christine Anna,20,0,45,25
1745137691746,SOCI 139,A00,890620,Staff,43,0,45,2
1745137692772,SOCI 148E,A00,890622,Calderon-Zaks; Michael Aar,39,0,45,6
1745137693798,SOCI 150,A00,890623,Kohler; Kristopher M.,36,0,45,9
1745137694823,SOCI 157,A00,890625,Jules-Rosette; Bennetta W.,18,0,20,2
1745137695849,SOCI 160,A00,890627,Payne; Christine Anna,26,0,45,19
1745137696875,SYN 1,A00,886855,Fish; Gwendolyn Anne,0,0,0,0
1745137696875,SYN 1,B00,906086,Fish; Gwendolyn Anne,0,0,0,2
1745137697904,SYN 2R,A00,886860,Staff,0,15,15,15
1745137697904,SYN 2R,B00,906106,Atkinson; Arthur Laird,0,14,15,15
1745137698936,SYN 100,A01,886866,Browne; Emily,0,29,20,20
1745137698936,SYN 100,B01,906128,Rock; Martin,0,4,20,20
1745137698936,SYN 100,C01,906140,Deavenport; James Cary,0,2,20,20
1745137698936,SYN 100,D01,907816,Deavenport; James Cary,0,3,20,20
1745137699961,TDAC 1,A00,890286,Walsh; Kim C.,11,0,20,9
1745137700986,TDAC 101,A00,890296,Basso; Beatrice,18,0,20,2
1745137702015,TDDE 131,A00,890297,Staff,47,0,50,3
1745137703042,TDDM 1,A00,890287,Weinberg; Sadie,26,0,30,4
1745137704069,TDGE 11,A00,890288,Fulton; Julia,155,0,200,45
1745137704069,TDGE 11,B00,890289,Castro; Robert Jess,188,0,200,12
1745137705097,TDGE 25,B00,957359,Walsh; Kim C.,9,0,20,11
1745137706128,TDGE 40,A01,890292,Power; Jade Yukana,28,0,30,2
1745137707153,TDGE 124,A00,890298,Havis; Allan,12,0,50,38
1745137708178,TDGE 131R,A00,890299,Burelle; Julie Sara Veronique,20,0,42,22
1745137709207,TDHT 101,A00,890300,Staff,12,0,20,8
1745137710232,TDHT 109,A01,890302,Anderson; Mysia Anyse,31,0,40,9
1745137711258,TDMV 1,A00,890293,Arcidiacono; Kristin,20,0,30,10
1745137712284,TDMV 2,A00,890294,Weinberg; Sadie,26,0,30,4
1745137713311,TDMV 3,A00,957878,Arcidiacono; Kristin,27,0,30,3
1745137715363,TDMV 138,A00,890304,Jun; Grace Shin Hae,25,0,40,15
1745137716392,TDMV 140,A00,890305,Corrales; Joseph Bernales,28,0,30,2
1745137717418,TDMV 142,A00,890307,Caligagan; Tony,30,0,40,10
1745137718444,TDMV 144,A00,890308,Camaya; Michelle Ann,26,0,30,4
1745137719468,TDPW 1,A00,890295,Stein; Deborah Isobel,5,0,20,15
1745137720493,USP 2,A01,890272,Lerner; Amy M,8,0,20,12
1745137721517,USP 3,A01,890274,Staff,21,0,30,9
1745137722543,USP 15,A01,890276,Sun; Feiyang,21,0,30,9
1745137723571,USP 25,A00,890277,Shenkman; Michael Thomas,21,0,25,4
1745137724597,USP 138,A00,890278,Staff,15,0,25,10
1745137725622,USP 143,A00,890279,Staff,30,0,70,40
1745137726650,USP 144,A00,890280,Chowdhury; Muhammed Zohir,19,0,30,11
1745137727675,USP 150,A00,890281,Boomhower; Matthew Charles,19,0,30,11
1745137728700,USP 151,A00,890282,Staff,17,0,20,3
1745137729725,USP 162,A00,890283,Andrews; Abigail Leslie,17,0,20,3
1745137730751,USP 168,A00,920477,Kwak; Nancy,2,0,5,3
1745137731776,USP 181,A00,890284,Staff,11,0,20,9
1745137732801,USP 191A,A00,890285,Staff,15,0,20,5
1745137733830,VIS 101,A00,886512,Staff,37,0,75,38
1745137734859,VIS 103,A00,886513,Cruz; Edwin Teddy,65,0,75,10
1745137735882,VIS 108,A00,886514,Staff,7,0,15,8
1745137736906,VIS 127P,A00,886515,Shen; Kuiyi,92,0,146,54
1745137737934,VIS 149,A00,886516,Yoldas; Pinar,1,0,15,14
1745137738960,VIS 164,A00,886526,Erdmann; Dean,21,0,22,1
1745137739988,VIS 194S,A00,886527,Staff,61,0,75,14
1745137741013,WCWP 10A,C00,886484,Staff,13,0,15,2
1745137742043,WCWP 10B,A00,886490,Staff,5,0,15,10
1745137742043,WCWP 10B,B00,886491,Staff,0,1,0,0
1745137742043,WCWP 10B,C00,886492,Staff,10,0,15,5
1745137743068,WCWP 100,A00,886494,Staff,0,2,15,15
1745137745157,AAS 10,A01,886199,Childs; Dennis R.,0,2,0,0
1745137746186,ANAR 104,A01,886940,Shtienberg; Gilad,27,0,30,3
1745137747212,ANAR 120,A00,886953,Staff,13,0,20,7
1745137748241,ANBI 148,A01,886955,Wilder; Linnea Lorene,32,0,40,8
1745137750298,ANSC 122,A00,886957,Staff,28,0,30,2
1745137751329,ANSC 150,A00,886958,Sloane; Julia Kathryn,6,0,15,9
1745137752355,ANSC 156,A00,886959,Jenkins; Janis A.,2,0,15,13
1745137753385,ANSC 180,A00,886960,Staff,12,0,17,5
1745137754413,ANSC 188,A00,886961,Jassal; Aftab,10,0,25,15
1745137755442,ANSC 190,A00,886962,Jassal; Aftab,14,0,25,11
1745137756467,ANSC 191,A00,886963,Staff,18,0,20,2
1745137757492,ANTH 3,A01,891689,Staff,19,0,20,1
1745137758522,ANTH 5,A00,886933,Semendeferi; Ekaterini,18,0,20,2
1745137759551,ANTH 10,A00,886934,Staff,0,8,30,30
1745137760577,ANTH 21,A01,886936,Staff,44,0,60,16
1745137761613,ANTH 23,A01,886938,Staff,94,0,100,6
1745137762642,ANTH 105,A00,886964,Stewart; Alexander B,94,0,100,6
1745137763668,ANTH 108,A00,886965,Pedersen; David,10,0,20,10
1745137764702,AWP 10,001,886147,Staff,0,0,0,0
1745137764702,AWP 10,002,886148,Staff,0,0,0,0
1745137764702,AWP 10,003,886149,Staff,0,0,0,0
1745137764702,AWP 10,004,886150,Staff,0,0,0,0
1745137764702,AWP 10,005,886151,Staff,0,0,0,0
1745137764702,AWP 10,006,886152,Staff,0,0,0,0
1745137764702,AWP 10,007,886153,Staff,0,0,0,0
1745137764702,AWP 10,008,886154,Staff,0,0,0,0
1745137764702,AWP 10,009,886155,Staff,0,0,0,0
1745137764702,AWP 10,010,886156,Staff,0,0,0,0
1745137764702,AWP 10,011,886158,Staff,0,0,0,0
1745137764702,AWP 10,012,886160,Staff,0,0,0,0
1745137764702,AWP 10,013,886161,Staff,0,0,0,0
1745137764702,AWP 10,014,886162,Staff,0,0,0,0
1745137764702,AWP 10,015,886163,Staff,0,0,0,0
1745137764702,AWP 10,016,886164,Staff,0,0,0,0
1745137764702,AWP 10,017,886165,Staff,0,0,0,0
1745137764702,AWP 10,018,886166,Staff,0,0,0,0
1745137764702,AWP 10,019,886168,Staff,0,0,0,0
1745137764702,AWP 10,020,886170,Staff,0,0,0,0
1745137764702,AWP 10,021,886172,Staff,0,0,0,0
1745137765729,AWP 10R,001,886173,Staff,0,0,0,0
1745137765729,AWP 10R,002,886174,Staff,0,1,0,0
1745137765729,AWP 10R,003,886175,Staff,0,0,0,0
1745137765729,AWP 10R,004,886176,Staff,0,0,0,0
1745137765729,AWP 10R,005,886177,Staff,0,0,0,0
1745137765729,AWP 10R,006,886178,Staff,0,0,0,0
1745137765729,AWP 10R,007,886179,Staff,0,0,0,0
1745137765729,AWP 10R,008,886181,Staff,0,0,0,0
1745137765729,AWP 10R,009,886182,Staff,0,0,0,0
1745137765729,AWP 10R,010,886183,Staff,0,0,0,0
1745137765729,AWP 10R,011,886184,Staff,0,0,0,0
1745137765729,AWP 10R,012,886185,Staff,0,0,0,0
1745137765729,AWP 10R,013,886186,Staff,0,0,0,0
1745137765729,AWP 10R,014,886187,Staff,0,0,0,0
1745137765729,AWP 10R,015,886188,Staff,0,0,0,0
1745137765729,AWP 10R,016,886189,Staff,0,0,0,0
1745137766759,AWP 102R,A00,886190,Staff,0,0,0,0
1745137766759,AWP 102R,B00,886191,Staff,0,0,0,0
1745137767784,BENG 100,A01,886193,Staff,19,0,30,11
1745137768811,BENG 122A,A01,886195,Hasty; Jeff M,20,0,30,10
1745137769841,BENG 166A,A00,886196,Sah; Robert Lie-Yuan,0,3,20,20
1745137770872,BIBC 102,A01,894320,Staff,0,2,46,46
1745137770872,BIBC 102,A02,894321,Staff,0,0,46,46
1745137770872,BIBC 102,A03,894344,Staff,21,0,46,25
1745137770872,BIBC 102,A04,894345,Staff,30,0,47,17
1745137771899,BICD 100R,A01,894365,Smith; Laurie,1,3,58,57
1745137771899,BICD 100R,A02,894366,Smith; Laurie,0,1,58,58
1745137771899,BICD 100R,A03,894367,Smith; Laurie,13,0,59,46
1745137772925,BICD 136,A01,894383,Gustafson-Brown; Cindy,16,0,50,34
1745137773979,BIEB 102,A01,894494,Butler; Shannon Rhey,67,0,130,63
1745137776033,BIEB 150,A01,894617,Wills; Christopher,0,3,13,13
1745137776033,BIEB 150,A02,894631,Wills; Christopher,0,3,13,13
1745137776033,BIEB 150,A03,894937,Wills; Christopher,0,3,13,13
1745137776033,BIEB 150,A04,894946,Wills; Christopher,0,1,11,11
1745137777058,BIEB 194,A00,906141,Kurle; Carolyn M.,14,0,20,6
1745137778087,BILD 1,A01,894154,Staff,8,0,19,11
1745137778087,BILD 1,A02,894155,Staff,15,0,19,4
1745137778087,BILD 1,A03,894160,Staff,18,0,19,1
1745137778087,BILD 1,A04,894161,Staff,16,0,18,2
1745137779115,BILD 2,A01,894168,Staff,0,0,50,50
1745137779115,BILD 2,A02,894169,Staff,0,0,50,50
1745137779115,BILD 2,A03,894179,Staff,27,0,50,23
1745137779115,BILD 2,A04,894203,Staff,42,0,50,8
1745137780148,BILD 3,A01,894213,Staff,24,0,31,7
1745137780148,BILD 3,A02,894214,Staff,28,0,31,3
1745137780148,BILD 3,A03,894235,Staff,30,0,31,1
1745137780148,BILD 3,A04,894236,Staff,29,0,32,3
1745137781174,BILD 4,A01,894253,Reuther; Keefe,12,0,24,12
1745137781174,BILD 4,A02,894258,Reuther; Keefe,19,0,24,5
1745137782201,BILD 5,A01,894276,Reuther; Keefe,40,0,50,10
1745137782201,BILD 5,A02,894277,Reuther; Keefe,48,0,50,2
1745137782201,BILD 5,A03,894290,Reuther; Keefe,47,0,50,3
1745137782201,BILD 5,A04,894291,Reuther; Keefe,50,0,50,0
1745137783228,BILD 24,A01,894297,Pirino; Giorgia,46,0,60,14
1745137784256,BIMM 100,A01,895012,Staff,0,14,0,1
1745137784256,BIMM 100,A02,895013,Staff,0,6,0,2
1745137784256,BIMM 100,A03,895014,Staff,0,7,0,0
1745137784256,BIMM 100,A04,895015,Staff,0,4,0,0
1745137785283,BIMM 101,A01,895017,McDonnell; Lisa Marie,0,2,24,24
1745137785283,BIMM 101,A02,895018,McDonnell; Lisa Marie,0,1,24,24
1745137785283,BIMM 101,B01,895020,McDonnell; Lisa Marie,0,3,24,24
1745137785283,BIMM 101,B02,895021,McDonnell; Lisa Marie,0,2,24,24
1745137786313,BIMM 110,A01,895023,Staff,7,0,25,18
1745137786313,BIMM 110,A02,895024,Staff,11,0,25,14
1745137786313,BIMM 110,A03,895025,Staff,22,0,25,3
1745137786313,BIMM 110,A04,895031,Staff,21,0,25,4
1745137787343,BIMM 120,A01,895114,Gustafson-Brown; Cindy,8,0,28,20
1745137787343,BIMM 120,A02,895126,Gustafson-Brown; Cindy,19,0,27,8
1745137788372,BIPN 100,A01,895130,Yang; Mingyu,13,0,38,25
1745137788372,BIPN 100,A02,895131,Yang; Mingyu,33,0,38,5
1745137788372,BIPN 100,A03,895132,Yang; Mingyu,33,0,38,5
1745137788372,BIPN 100,A04,895133,Yang; Mingyu,30,0,36,6
1745137789399,BIPN 120,A01,895135,Cooke; James Edward,0,3,13,13
1745137789399,BIPN 120,A02,895136,Cooke; James Edward,0,1,13,13
1745137789399,BIPN 120,A03,895137,Cooke; James Edward,0,0,13,13
1745137789399,BIPN 120,A04,895156,Cooke; James Edward,4,0,11,7
1745137790427,BIPN 134,A01,895235,Cooke; James Edward,0,3,25,25
1745137790427,BIPN 134,A02,895237,Cooke; James Edward,0,0,25,25
1745137790427,BIPN 134,A03,895240,Cooke; James Edward,13,0,25,12
1745137790427,BIPN 134,A04,895270,Cooke; James Edward,24,0,25,1
1745137791451,BIPN 189,A00,892103,Staff,0,20,9,9
1745137793510,CAT 124,A01,922009,Staff,0,1,20,20
1745137794538,CAT 125R,A00,886390,Morales; Celeste Georgianna,4,0,20,16
1745137794538,CAT 125R,B00,886391,Irwin; Matthew Joseph,0,1,20,20
1745137794538,CAT 125R,C00,886392,Smith; Lauryn Alissa,11,0,20,9
1745137794538,CAT 125R,D00,886393,Vanderschuit; Maya Alysia,6,0,20,14
1745137794538,CAT 125R,E00,886394,Marchisotto; Jennifer Anne,0,2,20,20
1745137795562,CENG 15,A01,886218,Drews; Aaron,1,0,5,4
1745137796589,CENG 113,A00,886219,Opatkiewicz; Justin Paul,16,0,25,9
1745137797616,CGS 101,A00,887044,Staff,13,0,20,7
1745137798642,CGS 105,A01,887046,Staff,16,0,25,9
1745137799671,CGS 112,A00,887047,Cuong; Marisol,12,0,15,3
1745137800698,CGS 113,A00,887048,Staff,24,0,30,6
1745137801726,CGS 120,A00,887049,Staff,12,0,17,5
1745137802755,CHEM 6A,A01,886336,Lam; Tin Yiu,44,0,50,6
1745137802755,CHEM 6A,A02,886338,Lam; Tin Yiu,43,0,50,7
1745137803787,CHEM 6B,A01,886341,Hopkins; Patrycja Anna,21,0,50,29
1745137803787,CHEM 6B,A02,886343,Hopkins; Patrycja Anna,46,0,50,4
1745137804816,CHEM 6C,A01,886346,Albizati; Kim F.,0,1,50,50
1745137804816,CHEM 6C,A02,886348,Albizati; Kim F.,38,0,50,12
1745137805846,CHEM 40A,A01,886352,Klosterman; Jeremy K,70,0,100,30
1745137806873,CHEM 40B,A01,886356,Klosterman; Jeremy K,0,4,100,100
1745137807898,CHEM 41B,A01,886360,Theodorakis; Emmanuel,30,0,50,20
1745137807898,CHEM 41B,A02,886362,Theodorakis; Emmanuel,46,0,50,4
1745137808928,CHIN 165A,A00,886382,Xu; Li,19,0,20,1
1745137809954,CLAS 120,A00,886387,Myerston Santana; Jacobo,36,0,40,4
1745137810981,COGS 9,A01,886967,Shannon; Kyle Michael,49,0,60,11
1745137812007,COGS 11,A01,886969,Staff,18,0,30,12
1745137813037,COGS 14A,A01,886971,Staff,26,0,60,34
1745137814066,COGS 14B,A01,886973,Hoffman; Drew Ellen,18,0,60,42
1745137815090,COGS 18,A01,886975,Morgan; Eric,41,0,60,19
1745137816116,COGS 20,A01,886977,Staff,6,0,8,2
1745137816116,COGS 20,A02,886978,Staff,6,0,7,1
1745137817143,COGS 100,A01,907783,Staff,6,0,30,24
1745137818173,COGS 101B,A01,886980,Staff,0,10,30,30
1745137819204,COGS 101C,A01,886982,Delgado; Tania,0,6,30,30
1745137820230,COGS 102A,A01,886984,Johnson; Christine M.,13,0,30,17
1745137821260,COGS 118B,A01,886986,Staff,0,25,60,60
1745137822290,COGS 150,A01,886988,Bergen; Benjamin,16,0,30,14
1745137823315,COGS 153,A00,886989,Delgado; Tania,0,6,30,30
1745137824340,COGS 186,A01,886991,Staff,3,0,30,27
1745137825371,COGS 187A,A01,886993,Boyle; Mary E. T.,12,0,30,18
1745137826397,COGS 189,A00,886994,Staff,13,0,30,17
1745137827423,COMM 10,A01,886996,Staff,11,0,25,14
1745137827423,COMM 10,A02,886997,Staff,21,0,25,4
1745137828453,COMM 20,A01,886999,Leuning; Grant Maurstad,33,0,40,7
1745137830508,COMM 100A,A01,887002,Staff,0,0,25,25
1745137830508,COMM 100A,A02,887003,Staff,20,0,25,5
1745137831536,COMM 100B,A01,887005,Staff,0,1,25,25
1745137832564,COMM 106D,A00,887006,Staff,22,0,40,18
1745137833592,COMM 110G,A00,887007,Whitworth-Smith; Andrew C,17,0,40,23
1745137834622,COMM 111B,A00,887008,Staff,31,0,40,9
1745137835652,COMM 113T,A00,887009,Abuelhiga; Soraya Jill,30,0,40,10
1745137835652,COMM 113T,B00,906733,Staff,40,0,40,0
1745137836683,COMM 145,A00,887010,Staff,21,0,40,19
1745137837709,COMM 146,A00,887054,Staff,31,0,40,9
1745137838735,COMM 190,A00,887012,Staff,9,0,23,14
1745137839785,CSE 8A,A50,887015,Cao; Yingjun,68,0,85,17
1745137840821,CSE 11,A01,887017,Cao; Yingjun,35,0,70,35
1745137841852,CSE 20,A01,887019,Staff,35,0,50,15
1745137842886,CSE 21,A01,887021,Braun; Oliver,81,0,100,19
1745137842886,CSE 21,B01,892583,Staff,48,0,50,2
1745137843919,CSE 30,A01,887025,Eldon; John,161,0,200,39
1745137844948,CSE 100,A01,887027,Staff,28,0,50,22
1745137844948,CSE 100,A02,887028,Staff,43,0,50,7
1745137845976,CSE 101,A01,887030,Braun; Oliver,79,0,100,21
1745137845976,CSE 101,B01,887032,Jones; Miles E,0,1,50,50
1745137845976,CSE 101,B02,887033,Jones; Miles E,13,0,50,37
1745137847002,CSE 105,A01,908084,Jones; Miles E,36,0,50,14
1745137847002,CSE 105,A02,908087,Jones; Miles E,38,0,50,12
1745137848026,CSE 135,A01,887035,Powell; Thomas Allan,8,0,50,42
1745137849055,CSE 142,A01,887037,Staff,22,0,60,38
1745137850081,CSE 142L,A01,887039,Staff,42,0,60,18
1745137851109,CSE 151A,A01,887041,Solares; Edwin A,60,0,100,40
1745137852137,CSE 175,A01,887043,Kumar; Rakesh,30,0,30,0
1745137853162,CSS 1,A01,886389,Staff,12,0,40,28
1745137854188,DSC 30,A01,908097,Liao; Soohyun Nam,54,0,75,21
1745137855216,DSC 40A,A01,908099,Shannon; Kyle Michael,37,0,50,13
1745137856242,DSC 40B,A01,908112,Staff,28,0,50,22
1745137857267,DSC 80,A01,908116,Staff,32,0,60,28
1745137858293,DSC 197,001,956863,Eldridge; Justin Matthew,9999,0,9999,0
1745137859333,ECE 5,A01,886400,Morris; Karcher William,3,0,6,3
1745137859333,ECE 5,A02,886401,Morris; Karcher William,5,0,6,1
1745137860359,ECE 148,A01,886403,Silberman; Jack,0,8,14,14
1745137861393,ECON 1,A01,887265,Crane; Meredith Helen,25,0,70,45
1745137861393,ECON 1,B01,887268,Staff,44,0,50,6
1745137862425,ECON 2,A01,887273,Crane; Meredith Helen,61,0,70,9
1745137863454,ECON 3,A01,887279,Rondina; Giacomo,44,0,70,26
1745137864486,ECON 4,A01,887282,Anderson; John Charles,0,1,10,10
1745137865517,ECON 5,A01,887285,Staff,39,0,45,6
1745137865517,ECON 5,B01,887292,Staff,43,0,45,2
1745137866541,ECON 100A,A01,887337,Newhouse; Herbert S,58,0,70,12
1745137866541,ECON 100A,B01,887349,Staff,45,0,50,5
1745137867568,ECON 100B,A01,887361,Du; Songzi,42,0,70,28
1745137868599,ECON 100C,A01,887445,Newhouse; Herbert S,61,0,70,9
1745137869630,ECON 105,A00,887488,Vespa; Emanuel Ignacio,24,0,35,11
1745137870661,ECON 109,A01,887506,Staff,29,0,35,6
1745137871687,ECON 110A,A01,887568,Alon; Titan Michael,1,0,35,34
1745137871687,ECON 110A,B01,907601,Alon; Titan Michael,27,0,35,8
1745137872716,ECON 110B,A01,887598,Levkoff; Steven B.,0,7,70,70
1745137873746,ECON 112,A00,887599,Rondina; Giacomo,20,0,35,15
1745137874782,ECON 120A,A01,887603,Dai; Yinlin,46,0,70,24
1745137875808,ECON 120C,A01,887608,Sun; Yixiao,0,0,35,35
1745137875808,ECON 120C,B01,887614,Sun; Yixiao,13,0,35,22
1745137876838,ECON 138,A00,887621,Bharadwaj; Prashant,0,18,20,20
1745137877864,ECON 171,A01,907666,Staff,27,0,35,8
1745137878892,ECON 175,A00,887626,Wu; Pak Yeung,27,0,35,8
1745137879916,ECON 190,A00,887640,Vespa; Emanuel Ignacio,26,0,35,9
1745137880955,EDS 25,A01,888197,Staff,0,0,0,0
1745137880955,EDS 25,A02,888209,Staff,0,0,0,0
1745137880955,EDS 25,A03,888210,Staff,0,0,0,0
1745137880955,EDS 25,A04,888212,Staff,0,0,0,0
1745137880955,EDS 25,A05,888213,Staff,0,0,0,0
1745137880955,EDS 25,A06,888214,Staff,0,0,0,0
1745137880955,EDS 25,A07,888235,Staff,0,0,0,0
1745137880955,EDS 25,A08,888236,Staff,0,0,0,0
1745137880955,EDS 25,A09,888240,Staff,0,0,0,0
1745137880955,EDS 25,A10,888244,Staff,0,0,0,0
1745137880955,EDS 25,B01,888273,Staff,0,0,0,0
1745137880955,EDS 25,B02,888285,Staff,0,0,0,0
1745137880955,EDS 25,B03,888423,Staff,29,0,30,1
1745137880955,EDS 25,B04,888432,Staff,0,0,0,0
1745137880955,EDS 25,B05,888433,Staff,0,0,0,0
1745137880955,EDS 25,B06,888467,Staff,0,0,0,0
1745137880955,EDS 25,B07,888468,Staff,0,0,0,0
1745137880955,EDS 25,B08,888479,Staff,0,0,0,0
1745137880955,EDS 25,B09,888484,Staff,0,0,0,0
1745137880955,EDS 25,B10,888487,Staff,0,0,0,0
1745137881982,EDS 38,A01,907700,Choi; Bailey Miyeon,30,0,30,0
1745137883007,EDS 112,A01,888601,Chapman; Thandeka K,23,0,40,17
1745137884043,EDS 115,A00,888697,Mendez; Kathrina Mendoza,17,0,30,13
1745137885074,EDS 116,A01,888893,Staff,38,0,40,2
1745137887128,EDS 124AR,A00,889133,Staff,33,0,50,17
1745137887128,EDS 124AR,B00,907471,Simon; Elizabeth A,42,0,50,8
1745137888154,EDS 124BR,A00,889134,Staff,57,0,100,43
1745137889178,EDS 125,A00,889135,Staff,26,0,30,4
1745137890203,EDS 126,A01,889138,Staff,37,0,40,3
1745137891229,EDS 164R,A01,889142,Wishard Guerra; Alison G.,38,0,50,12
1745137892259,ENG 30,A01,886396,Staff,0,0,0,0
1745137892259,ENG 30,B01,886398,Staff,0,0,0,0
1745137893285,ENVR 102,A00,906150,Montejo; Carolina,23,0,25,2
1745137894312,ETHN 103A,A00,887236,Man; Simeon S,0,5,0,0
1745137895341,ETHN 113,A00,887239,Staff,20,0,30,10
1745137896367,ETHN 116,A00,887240,Staff,20,0,25,5
1745137897392,ETHN 117,A00,887241,Choi; Esther Min,27,0,30,3
1745137898418,ETHN 118,A00,887243,Staff,24,0,30,6
1745137899450,ETHN 127,A00,887248,Cuong; Marisol,12,0,15,3
1745137900478,ETHN 139,A00,887250,Staff,8,0,10,2
1745137901506,ETHN 142,A00,887252,Staff,18,0,30,12
1745137902538,ETHN 161,A00,887253,Browne; Errol Tsekani,28,0,30,2
1745137903563,ETHN 163FR,A00,887255,Burelle; Julie Sara Veronique,4,0,5,1
1745137904590,GLBH 20,A00,889149,Elwardani; Nile Regina,15,0,42,27
1745137906644,GLBH 111,A01,889152,Burgos; Jose L.,17,0,17,0
1745137907670,GLBH 150,A00,889181,Sloane; Julia Kathryn,0,1,15,15
1745137909722,HDS 60,A01,886406,Warstadt; Melissa Fawn,76,0,80,4
1745137910747,HIAF 111,A00,889324,Gyamfi; Bright,0,4,0,0
1745137911773,HIEA 131,A00,889328,Staff,14,0,32,18
1745137912800,HIEA 144,A00,889333,Henry; Todd A.,29,0,32,3
1745137913832,HIEA 154,A00,889336,Henry; Todd A.,28,0,32,4
1745137914865,HIEU 106,A00,889339,Staff,28,0,32,4
1745137916916,HIEU 114,A00,889340,Staff,18,0,32,14
1745137917942,HIEU 135GS,A00,889342,Patterson; Patrick H.,0,0,1,22
1745137918969,HIEU 137,A00,889343,Edington; Claire Ellen,12,0,25,13
1745137919994,HIEU 148,A00,889345,Staff,16,0,32,16
1745137921023,HIEU 154,A00,889346,Biess; Frank Peter,24,0,32,8
1745137922050,HILA 102,A00,889351,Staff,13,0,32,19
1745137923073,HILD 2A,A01,889221,Lewandoski; Julia Mavis,0,5,32,32
1745137924100,HILD 7B,A01,889225,Man; Simeon S,0,7,32,32
1745137925126,HILD 7C,A01,889288,Alvarez; Luis A,0,7,32,32
1745137926154,HILD 30,A01,889323,Staff,0,1,32,32
1745137928208,HISC 119,A00,889383,Golan; Tal,22,0,32,10
1745137929232,HIUS 103,A00,889384,Man; Simeon S,10,0,32,22
1745137930261,HIUS 117,A00,919797,Kwak; Nancy,23,0,32,9
1745137931288,HIUS 142A,A00,919788,Staff,24,0,32,8
1745137933340,HIUS 149,A00,889386,Gyamfi; Bright,0,1,0,0
1745137934367,HIUS 155,A00,889387,Alvarez; Luis A,19,0,32,13
1745137935397,HUM 3,A01,886499,Caldwell; Michael Alan,24,0,50,26
1745137936424,HUM 3GS,A00,886500,Rodriguez; Bretton Sigfred,0,0,0,26
1745137937454,HUM 3R,A01,886502,Markman; Kristina,0,32,50,50
1745137938486,HUM 4,A01,886504,Crum; Matthew Stephen,28,0,50,22
1745137938486,HUM 4,B01,886506,West; Geoffrey Scott,25,0,50,25
1745137939512,HUM 4GS,A00,886507,Staff,0,0,0,13
1745137940539,HUM 5,A01,886509,Staff,35,0,50,15
1745137941569,HUM 5R,A01,886511,Zavodny; Tatiana Sophia,0,32,50,50
1745137942595,JAPN 180,A00,886407,Staff,25,0,40,15
1745137943628,LATI 50,A01,886409,Martin-Cabrera; Luis,9,0,22,13
1745137943628,LATI 50,A02,886410,Martin-Cabrera; Luis,20,0,22,2
1745137943628,LATI 50,A03,886411,Martin-Cabrera; Luis,22,0,22,0
1745137943628,LATI 50,A04,886412,Martin-Cabrera; Luis,15,0,22,7
1745137944653,LAWS 101,A00,907664,Staff,36,0,60,24
1745137945679,LIAB 1A,A00,889388,Saab; Dima,19,0,20,1
1745137946709,LIAB 1AX,A00,889389,El Cheddadi; Youniss,19,0,20,1
1745137947736,LIFR 1C,A00,889391,Van Moer; Vinciane G,9,0,20,11
1745137948764,LIFR 1CX,A00,889392,Van Moer; Vinciane G,8,0,20,12
1745137949791,LIFR 1D,A00,889393,Van Moer; Vinciane G,11,0,20,9
1745137950822,LIFR 1DX,A00,889394,Van Moer; Vinciane G,11,0,20,9
1745137951849,LIGN 7,A00,886923,Staff,30,0,50,20
1745137952873,LIGN 17,A00,886924,Kehler; Andrew Scott,133,0,150,17
1745137953902,LTAM 110,A00,889395,Staff,17,0,30,13
1745137954929,LTCH 101,A00,889397,Staff,22,0,25,3
1745137955956,LTCS 130,A00,889398,Staff,23,0,25,2
1745137956983,LTEA 138,A00,889399,Staff,25,0,40,15
1745137958016,LTEN 149,A00,889400,Wesling; Megan E.,6,0,25,19
1745137959040,LTEN 169,A00,889401,Staff,24,0,25,1
1745137960066,LTEN 180,A00,889402,Staff,12,0,15,3
1745137961114,LTEN 181,A00,889403,Staff,23,0,25,2
1745137962137,LTWL 100,A00,889404,Myerston Santana; Jacobo,8,0,25,17
1745137963162,LTWL 180GS,A00,889405,Staff,6,0,20,14
1745137964190,LTWL 181,A00,889406,Staff,19,0,25,6
1745137965215,LTWL 184,A00,889475,Mukherjee; Silpa,21,0,25,4
1745137966242,LTWR 102C,A00,889486,Staff,29,0,30,1
1745137967272,LTWR 115W,A00,889491,Staff,3,0,15,12
1745137968302,MAE 8,A01,886905,Staff,0,2,0,0
1745137969328,MAE 11,A00,886906,Bandaru; Prabhakar,0,0,50,50
1745137970358,MAE 20,A00,886907,Evdokimenko; Ekaterina,50,0,70,20
1745137971390,MAE 30B,A00,886909,Ghazinejad; Maziar,28,0,45,17
1745137972415,MAE 101B,A00,886910,Saintillan; David,36,0,45,9
1745137973442,MAE 105,A00,886911,Bandaru; Prabhakar,26,0,50,24
1745137974471,MAE 107,A00,886912,Staff,22,0,60,38
1745137975500,MAE 143B,A00,886913,Bewley; Thomas R,14,0,40,26
1745137976526,MAE 148,A01,886915,Silberman; Jack,5,0,14,9
1745137977555,MAE 160,A00,886916,Evdokimenko; Ekaterina,41,0,60,19
1745137978581,MATH 3C,A01,889681,Staff,2,0,30,28
1745137979605,MATH 10A,A01,889760,Staff,28,0,30,2
1745137979605,MATH 10A,A02,889783,Staff,30,0,30,0
1745137980637,MATH 10B,A01,889785,Verstraete; Jacques Allan,0,2,30,30
1745137980637,MATH 10B,A02,889795,Verstraete; Jacques Allan,0,2,30,30
1745137980637,MATH 10B,B01,889797,Verstraete; Jacques Allan,1,0,30,29
1745137980637,MATH 10B,B02,889828,Verstraete; Jacques Allan,23,0,30,7
1745137981670,MATH 10C,A01,889849,Habib; Yousaf,18,0,30,12
1745137981670,MATH 10C,A02,889852,Habib; Yousaf,20,0,30,10
1745137981670,MATH 10C,A03,889853,Habib; Yousaf,25,0,30,5
1745137981670,MATH 10C,A04,889858,Habib; Yousaf,21,0,30,9
1745137981670,MATH 10C,B01,889861,Staff,12,0,30,18
1745137981670,MATH 10C,B02,889862,Staff,26,0,30,4
1745137981670,MATH 10C,B03,889863,Staff,28,0,30,2
1745137981670,MATH 10C,B04,889967,Staff,25,0,30,5
1745137982701,MATH 18,A01,889974,Staff,15,0,30,15
1745137982701,MATH 18,A02,889977,Staff,25,0,30,5
1745137982701,MATH 18,B01,889984,Hardiman; Liam,26,0,30,4
1745137982701,MATH 18,B02,889985,Hardiman; Liam,28,0,30,2
1745137983732,MATH 20A,A01,889990,Suk; Andrew Hoon,31,0,35,4
1745137984759,MATH 20B,A01,889993,Ohm; Ko Woon,21,0,30,9
1745137984759,MATH 20B,A02,889994,Ohm; Ko Woon,30,0,30,0
1745137984759,MATH 20B,B01,889996,Ohm; Ko Woon,25,0,30,5
1745137984759,MATH 20B,B02,889997,Ohm; Ko Woon,24,0,30,6
1745137985785,MATH 20C,A01,889999,Hammock; Frances H,22,0,30,8
1745137985785,MATH 20C,A02,890003,Hammock; Frances H,23,0,30,7
1745137985785,MATH 20C,B01,890006,Hammock; Frances H,11,0,30,19
1745137985785,MATH 20C,B02,890007,Hammock; Frances H,18,0,30,12
1745137986813,MATH 20D,A01,890011,Cheng; Hsiao-Bing,6,0,30,24
1745137986813,MATH 20D,A02,890012,Cheng; Hsiao-Bing,27,0,30,3
1745137986813,MATH 20D,B01,890016,Cheng; Hsiao-Bing,19,0,30,11
1745137986813,MATH 20D,B02,890017,Cheng; Hsiao-Bing,15,0,30,15
1745137987839,MATH 20E,A01,890026,Harel; Guershon,10,0,30,20
1745137987839,MATH 20E,A02,890029,Harel; Guershon,24,0,30,6
1745137987839,MATH 20E,B01,890033,Harel; Guershon,14,0,30,16
1745137987839,MATH 20E,B02,890101,Harel; Guershon,27,0,30,3
1745137988865,MATH 102,A01,890104,Staff,20,0,30,10
1745137988865,MATH 102,A02,890105,Staff,30,0,30,0
1745137989896,MATH 103B,A01,890116,Salehi Golsefidy; Alireza,8,0,30,22
1745137989896,MATH 103B,B01,890118,Staff,0,4,30,30
1745137990927,MATH 109,A01,890121,Aliabadi Sr.; Mohsen,6,0,30,24
1745137990927,MATH 109,B01,890124,Upadrashta; Pranav Kumar,23,0,30,7
1745137991955,MATH 120A,A01,890126,Eggers; John Dietrich,15,0,30,15
1745137992985,MATH 142B,A01,890128,Ioana; Adrian,17,0,30,13
1745137992985,MATH 142B,A02,890129,Ioana; Adrian,15,0,30,15
1745137994016,MATH 154,A01,890174,Staff,0,1,30,30
1745137994016,MATH 154,A02,890182,Staff,15,0,30,15
1745137995053,MATH 168A,A01,890197,Dumitriu; Ioana,22,0,35,13
1745137996084,MATH 170A,A01,890240,Nie; Jiawang,6,0,30,24
1745137996084,MATH 170A,A02,890241,Nie; Jiawang,18,0,30,12
1745137996084,MATH 170A,A03,890249,Nie; Jiawang,23,0,30,7
1745137997108,MATH 170B,A01,957891,Nag; Panchali,25,0,35,10
1745137999166,MATH 181A,A01,908025,Staff,0,8,35,35
1745138000191,MATH 193B,A01,890265,Staff,3,0,35,32
1745138001215,MGT 4,A01,890311,Anderson; John Charles,57,0,88,31
1745138002242,MGT 5,A00,907740,Staff,41,0,98,57
1745138003268,MGT 12,A00,890312,Lindenberger; Wade Douglas,70,0,98,28
1745138004291,MGT 16,A00,957883,Staff,84,0,98,14
1745138006347,MGT 45,A00,890314,Pecore; Joseph P.,57,0,98,41
1745138007371,MGT 71,A00,890315,Staff,6,0,98,92
1745138008395,MGT 100,A00,890316,Yavorsky; Daniel Ryan,59,0,98,39
1745138009426,MGT 103,A00,890317,Ehrich; Kristine R,77,0,98,21
1745138010451,MGT 105,A00,890356,Bates; Kenneth Walter,19,0,98,79
1745138011478,MGT 112,A00,890360,Ehrich; Kristine R,65,0,98,33
1745138012507,MGT 127R,A00,907732,Zhu; Kevin Xiaoguo,32,0,98,66
1745138013533,MGT 131B,A00,890361,Anderson; John Charles,75,0,98,23
1745138014562,MGT 137,A00,890362,Lindenberger; Wade Douglas,68,0,98,30
1745138015591,MGT 160,A00,890369,Johnson; Erik Barry,37,0,98,61
1745138017647,MGT 164,A00,890372,Zimmermann; Carsten,0,28,98,98
1745138018674,MGT 180,A00,890374,Bliss; Barbara Ann,32,0,98,66
1745138019708,MMW 15,A01,886414,Chang; Edmond Yi-Teh,0,10,28,28
1745138019708,MMW 15,A02,886415,Chang; Edmond Yi-Teh,0,10,28,28
1745138019708,MMW 15,A03,886416,Chang; Edmond Yi-Teh,0,8,28,28
1745138019708,MMW 15,A04,886417,Chang; Edmond Yi-Teh,0,8,28,28
1745138019708,MMW 15,B01,886419,Chang; Edmond Yi-Teh,0,8,28,28
1745138019708,MMW 15,B02,886420,Chang; Edmond Yi-Teh,0,9,28,28
1745138019708,MMW 15,B03,886421,Chang; Edmond Yi-Teh,0,9,28,28
1745138019708,MMW 15,B04,886422,Chang; Edmond Yi-Teh,0,9,28,28
1745138019708,MMW 15,C01,886424,Staff,0,10,28,28
1745138019708,MMW 15,C02,886425,Staff,0,10,28,28
1745138019708,MMW 15,C03,886426,Staff,0,9,28,28
1745138019708,MMW 15,C04,886427,Staff,0,9,28,28
1745138020736,MMW 15GS,A00,906910,Patterson; Patrick H.,5,0,28,23
1745138021761,MMW 122R,A01,886429,Rahimi; Babak,0,23,28,28
1745138021761,MMW 122R,A02,886430,Rahimi; Babak,0,23,28,28
1745138022788,MUS 1A,A01,890937,Staff,8,0,25,17
1745138022788,MUS 1A,A02,891035,Staff,15,0,25,10
1745138022788,MUS 1A,B00,907849,Staff,48,0,50,2
1745138022788,MUS 1A,B01,907850,Staff,25,0,25,0
1745138022788,MUS 1A,B02,907851,Staff,25,0,25,0
1745138024855,MUS 2AK,A00,957092,Ohnishi; Takae,15,0,15,0
1745138025880,MUS 4,A01,891044,Staff,6,0,25,19
1745138025880,MUS 4,A02,891045,Staff,24,0,25,1
1745138025880,MUS 4,B01,891048,Staff,20,0,25,5
1745138025880,MUS 4,B02,891050,Staff,25,0,25,0
1745138026908,MUS 5,A01,957506,Dubnov; Shlomo,4,0,25,21
1745138026908,MUS 5,A02,957622,Dubnov; Shlomo,21,0,25,4
1745138026908,MUS 5,A03,957623,Dubnov; Shlomo,23,0,25,2
1745138027931,MUS 6,A01,891053,Freitas Caetano; Marcelo,23,0,25,2
1745138027931,MUS 6,A02,891054,Freitas Caetano; Marcelo,23,0,25,2
1745138028957,MUS 7,A01,891081,Staff,0,0,25,25
1745138028957,MUS 7,A02,891082,Staff,15,0,25,10
1745138029985,MUS 8GS,A00,891118,Borgo; David Garcia,5,0,25,20
1745138031018,MUS 11,A01,891140,Staff,12,0,25,13
1745138031018,MUS 11,A02,891141,Staff,24,0,25,1
1745138032044,MUS 13,A01,891143,Staff,10,0,25,15
1745138032044,MUS 13,A02,891144,Staff,25,0,25,0
1745138033070,MUS 15,A01,891146,Staff,7,0,25,18
1745138033070,MUS 15,A02,891148,Staff,22,0,25,3
1745138033070,MUS 15,B01,891150,Staff,18,0,25,7
1745138033070,MUS 15,B02,891151,Staff,25,0,25,0
1745138034097,MUS 20,A01,891153,Staff,9,0,20,11
1745138034097,MUS 20,A02,891155,Staff,16,0,20,4
1745138035127,MUS 80,A00,891156,Staff,19,0,25,6
1745138035127,MUS 80,B00,891157,Staff,25,0,25,0
1745138036155,MUS 130,A00,891158,Ohnishi; Takae,35,0,35,0
1745138037179,MUS 150GS,A01,891160,Borgo; David Garcia,5,0,25,20
1745138038204,MUS 170,A01,891162,Freitas Caetano; Marcelo,21,0,25,4
1745138038204,MUS 170,A02,891164,Freitas Caetano; Marcelo,22,0,25,3
1745138039233,NANO 11,A00,886220,Vazquez Mena; Oscar,12,0,15,3
1745138040260,NANO 15,A01,886222,Drews; Aaron,9,0,10,1
1745138041286,NANO 104,A00,886224,Sirbuly; Donald,18,0,25,7
1745138042311,PH 40,A00,886528,Staff,29,0,40,11
1745138043337,PH 45,A01,886799,Staff,36,0,40,4
1745138044364,PH 110,A00,886802,Staff,7,0,40,33
1745138045392,PH 172,A00,906716,Staff,20,0,35,15
1745138046422,PH 191,A00,886803,Staff,23,0,40,17
1745138047449,PHIL 1,A00,889500,Staff,22,0,30,8
1745138048476,PHIL 10,A01,889549,Grush; Rick Scott,17,0,22,5
1745138048476,PHIL 10,A02,889551,Grush; Rick Scott,20,0,22,2
1745138049503,PHIL 28,A01,889559,Lamey; Andy M.,0,4,25,25
1745138049503,PHIL 28,A02,889561,Lamey; Andy M.,0,0,25,25
1745138049503,PHIL 28,A03,889572,Lamey; Andy M.,7,0,25,18
1745138050530,PHIL 35,A00,907839,Staff,32,0,33,1
1745138051560,PHIL 60,A00,889574,Staff,79,0,90,11
1745138052590,PHIL 105,A00,889579,Staff,0,1,0,0
1745138053616,PHIL 136,A00,889582,Fulkerson; Matthew Todd,27,0,45,18
1745138054644,PHIL 163,A01,889601,Staff,24,0,30,6
1745138054644,PHIL 163,B01,889606,Brandt; Reuven A,0,2,0,0
1745138055670,PHIL 164,A00,889610,Staff,20,0,30,10
1745138056695,PHIL 165,A00,889613,Staff,26,0,30,4
1745138057726,PHYS 1A,A00,886431,Staff,38,0,70,32
1745138058755,PHYS 1AL,001,886432,Tsai; Philbert S,0,0,30,30
1745138058755,PHYS 1AL,002,886436,Tsai; Philbert S,19,0,30,11
1745138059782,PHYS 1B,A00,886439,Staff,192,0,240,48
1745138060811,PHYS 1BL,001,886441,Tsai; Philbert S,0,1,30,30
1745138060811,PHYS 1BL,002,886444,Tsai; Philbert S,14,0,30,16
1745138061838,PHYS 1C,A00,896092,Arnold; Kam S,87,0,146,59
1745138062868,PHYS 1CL,001,886448,Tsai; Philbert S,0,4,30,30
1745138062868,PHYS 1CL,002,886449,Tsai; Philbert S,6,0,30,24
1745138062868,PHYS 1CL,003,886450,Tsai; Philbert S,22,0,30,8
1745138062868,PHYS 1CL,004,886451,Tsai; Philbert S,16,0,30,14
1745138063894,PHYS 2B,A01,886457,Staff,86,0,115,29
1745138064924,PHYS 2C,A01,886460,Shotwell; Brian,0,0,65,65
1745138065953,PHYS 2CL,A01,886467,Staff,0,3,28,28
1745138065953,PHYS 2CL,A02,886468,Staff,5,0,28,23
1745138066978,PHYS 2D,A01,886470,Staff,17,0,50,33
1745138068007,PHYS 4B,A01,886475,Grinstein; Benjamin,88,0,100,12
1745138069034,POLI 5,A00,891173,Desposato; Scott,17,0,25,8
1745138070060,POLI 5D,A01,891175,Staff,5,0,5,0
1745138070060,POLI 5D,B01,891178,Staff,5,0,5,0
1745138071085,POLI 11,A00,891179,Ferree; Karen E,3,0,25,22
1745138072114,POLI 12,A00,891180,Staff,21,0,30,9
1745138073138,POLI 27,A01,891182,Staff,29,0,75,46
1745138074166,POLI 30,A00,891183,Staff,0,3,30,30
1745138075189,POLI 100B,A00,891244,Staff,0,8,20,20
1745138076217,POLI 100I,A00,891247,Staff,19,0,30,11
1745138077247,POLI 104J,A00,891248,Nichter; Maysa,18,0,30,12
1745138078276,POLI 104U,A00,891250,Nichter; Maysa,9,0,30,21
1745138079303,POLI 108,A00,891253,Staff,0,0,0,4
1745138080326,POLI 110B,A00,891255,Wiens; David,22,0,25,3
1745138081351,POLI 112A,A00,891256,Wiens; David,15,0,25,10
1745138082387,POLI 114BR,A00,891261,Staff,22,0,30,8
1745138083415,POLI 117R,A00,891262,Forman; Fonna,12,0,50,38
1745138084446,POLI 118,A00,891264,Ingham; Sean,22,0,25,3
1745138085472,POLI 124A,A00,891265,Staff,19,0,20,1
1745138086500,POLI 125D,A00,891266,Nichter; Simeon C,9,0,25,16
1745138087530,POLI 126,A00,891268,Nichter; Simeon C,11,0,25,14
1745138088557,POLI 126AA,A00,891272,Staff,19,0,25,6
1745138089585,POLI 130AA,A00,891273,Staff,17,0,20,3
1745138090613,POLI 134AA,A00,891274,Staff,12,0,20,8
1745138092667,POLI 138,A00,891278,Staff,22,0,25,3
1745138093692,POLI 142K,A00,891280,Staff,17,0,25,8
1745138094722,POLI 142M,A00,891281,Gartzke; Erik,22,0,30,8
1745138095747,POLI 142P,A00,891284,Staff,21,0,30,9
1745138096773,POLI 143,A00,891285,Gartzke; Erik,17,0,30,13
1745138097804,POLI 153,A00,891286,Staff,20,0,20,0
1745138098835,POLI 170A,A00,891288,Staff,19,0,25,6
1745138099862,POLI 175,A00,891290,Staff,18,0,20,2
1745138100890,PSYC 1,A00,890674,Steiner; Eric Tomas,0,4,45,45
1745138101918,PSYC 2,A00,890676,Albright; Thomas D,25,0,35,10
1745138102949,PSYC 3,A00,890679,Staff,18,0,20,2
1745138103977,PSYC 60,A01,890684,Rickard; Timothy C.,7,0,45,38
1745138105009,PSYC 70,A01,890689,Geller; Emma Harlan,14,0,30,16
1745138106039,PSYC 100,A00,890690,Lacefield; Katharine I,0,43,180,180
1745138107067,PSYC 102,A00,890695,Staff,26,0,40,14
1745138108092,PSYC 105,A00,890699,Geller; Emma Harlan,78,0,100,22
1745138109117,PSYC 106,A00,890701,Gorman; Michael R.,15,0,30,15
1745138110142,PSYC 108,A00,890704,Adrian; Julia Anna,0,23,50,50
1745138111167,PSYC 118,A01,890712,Staff,18,0,30,12
1745138112197,PSYC 124,A00,890716,Chapman; Eddie Nathaniel,36,0,60,24
1745138113223,PSYC 131,A00,890717,Anagnostaras; Stephan,6,0,80,74
1745138114250,PSYC 137,A00,890719,Winkielman; Piotr,0,2,30,30
1745138115278,PSYC 144,A00,890721,Adrian; Julia Anna,0,3,45,45
1745138116309,PSYC 162,A00,890805,Staff,21,0,75,54
1745138117338,PSYC 169,A00,890810,Staff,0,15,30,30
1745138118368,PSYC 172,A00,890814,Gorman; Michael R.,14,0,30,16
1745138119400,PSYC 181,A00,890818,Anagnostaras; Stephan,63,0,200,137
1745138120429,PSYC 189,A00,890823,Staff,11,0,30,19
1745138121456,PSYC 191,A00,890884,Rickard; Timothy C.,0,11,35,35
1745138122488,PSYC 193,A00,890913,Staff,22,0,30,8
1745138122488,PSYC 193,B00,890914,Chapman; Eddie Nathaniel,25,0,30,5
1745138123516,PSYC 193L,A01,890918,Lowe; Angela Beth,29,0,30,1
1745138123516,PSYC 193L,B01,890921,Hurwitz; Ethan Scott,28,0,30,2
1745138123516,PSYC 193L,C01,890928,Staff,30,0,30,0
1745138124545,RELI 149,A00,886806,Rahimi; Babak,23,0,40,17
1745138125572,SE 9,A01,886814,Staff,13,0,20,7
1745138126599,SE 101B,A01,886816,Chadha; Mayank,8,0,30,22
1745138127629,SE 110B,A00,886818,Zhu; Qiang,0,16,45,45
1745138128657,SE 125,A01,886830,Staff,10,0,30,20
1745138129683,SE 130B,A01,886835,Staff,19,0,40,21
1745138130713,SE 131A,A01,886838,Krysl; Petr,37,0,55,18
1745138131739,SE 154,A00,886840,Staff,35,0,50,15
1745138132769,SE 164GS,A01,886849,Staff,13,0,20,7
1745138133798,SE 167GS,A01,886853,Staff,13,0,20,7
1745138134829,SIO 25,A01,890107,Staff,23,0,30,7
1745138135857,SIO 45,A00,890109,Cook; Geoffrey W,137,0,200,63
1745138136884,SIO 109R,A00,890110,Forman; Fonna,0,11,20,20
1745138137915,SIO 187,A01,890114,Kacev; David,21,0,40,19
1745138138945,SOCI 1,A01,890431,Thorpe; Charles Robert,21,0,30,9
1745138138945,SOCI 1,A02,890518,Thorpe; Charles Robert,30,0,30,0
1745138139977,SOCI 2,A01,957978,Staff,0,0,0,0
1745138139977,SOCI 2,A02,957979,Staff,0,3,0,0
1745138141007,SOCI 20,A01,890523,Calderon-Zaks; Michael Aar,24,0,30,6
1745138141007,SOCI 20,A02,890526,Calderon-Zaks; Michael Aar,29,0,30,1
1745138142033,SOCI 30,A01,890533,Pardo Guerra; Juan Pablo,37,0,40,3
1745138143064,SOCI 40,A01,890535,Staff,32,0,45,13
1745138144090,SOCI 104Q,A00,890559,Staff,20,0,30,10
1745138145119,SOCI 106,A00,890560,Arnal; Maud Marie Leonie,22,0,30,8
1745138146148,SOCI 110,A00,890567,Holkenbrink-Monk; Charlene,22,0,30,8
1745138147175,SOCI 112,A00,890568,Victoria Torres; Pablo,0,0,45,45
1745138148203,SOCI 115,A00,890597,Arnal; Maud Marie Leonie,33,0,45,12
1745138150253,SOCI 121,A00,890604,Pardo Guerra; Juan Pablo,40,0,45,5
1745138151280,SOCI 126,A01,890608,Staff,8,0,10,2
1745138152306,SOCI 127,A00,890609,Staff,23,0,30,7
1745138153336,SOCI 131,A00,890610,Thorpe; Charles Robert,38,0,45,7
1745138154362,SOCI 135,A00,890615,Payne; Christine Anna,20,0,45,25
1745138155389,SOCI 139,A00,890620,Staff,43,0,45,2
1745138156415,SOCI 148E,A00,890622,Calderon-Zaks; Michael Aar,39,0,45,6
1745138157444,SOCI 150,A00,890623,Kohler; Kristopher M.,36,0,45,9
1745138158469,SOCI 157,A00,890625,Jules-Rosette; Bennetta W.,18,0,20,2
1745138159497,SOCI 160,A00,890627,Payne; Christine Anna,26,0,45,19
1745138160524,SYN 1,A00,886855,Fish; Gwendolyn Anne,0,0,0,0
1745138160524,SYN 1,B00,906086,Fish; Gwendolyn Anne,0,0,0,2
1745138161555,SYN 2R,A00,886860,Staff,0,15,15,15
1745138161555,SYN 2R,B00,906106,Atkinson; Arthur Laird,0,14,15,15
1745138162582,SYN 100,A01,886866,Browne; Emily,0,29,20,20
1745138162582,SYN 100,B01,906128,Rock; Martin,0,4,20,20
1745138162582,SYN 100,C01,906140,Deavenport; James Cary,0,2,20,20
1745138162582,SYN 100,D01,907816,Deavenport; James Cary,0,3,20,20
1745138163610,TDAC 1,A00,890286,Walsh; Kim C.,11,0,20,9
1745138164637,TDAC 101,A00,890296,Basso; Beatrice,18,0,20,2
1745138165668,TDDE 131,A00,890297,Staff,47,0,50,3
1745138166697,TDDM 1,A00,890287,Weinberg; Sadie,26,0,30,4
1745138167725,TDGE 11,A00,890288,Fulton; Julia,155,0,200,45
1745138167725,TDGE 11,B00,890289,Castro; Robert Jess,188,0,200,12
1745138168753,TDGE 25,B00,957359,Walsh; Kim C.,9,0,20,11
1745138169783,TDGE 40,A01,890292,Power; Jade Yukana,28,0,30,2
1745138170807,TDGE 124,A00,890298,Havis; Allan,12,0,50,38
1745138171832,TDGE 131R,A00,890299,Burelle; Julie Sara Veronique,20,0,42,22
1745138172861,TDHT 101,A00,890300,Staff,12,0,20,8
1745138173889,TDHT 109,A01,890302,Anderson; Mysia Anyse,31,0,40,9
1745138174915,TDMV 1,A00,890293,Arcidiacono; Kristin,20,0,30,10
1745138175944,TDMV 2,A00,890294,Weinberg; Sadie,26,0,30,4
1745138176969,TDMV 3,A00,957878,Arcidiacono; Kristin,27,0,30,3
1745138179022,TDMV 138,A00,890304,Jun; Grace Shin Hae,25,0,40,15
1745138180056,TDMV 140,A00,890305,Corrales; Joseph Bernales,28,0,30,2
1745138181082,TDMV 142,A00,890307,Caligagan; Tony,30,0,40,10
1745138182107,TDMV 144,A00,890308,Camaya; Michelle Ann,26,0,30,4
1745138183138,TDPW 1,A00,890295,Stein; Deborah Isobel,5,0,20,15
1745138184163,USP 2,A01,890272,Lerner; Amy M,8,0,20,12
1745138185191,USP 3,A01,890274,Staff,21,0,30,9
1745138186217,USP 15,A01,890276,Sun; Feiyang,21,0,30,9
1745138187246,USP 25,A00,890277,Shenkman; Michael Thomas,21,0,25,4
1745138188272,USP 138,A00,890278,Staff,15,0,25,10
1745138189301,USP 143,A00,890279,Staff,30,0,70,40
1745138190329,USP 144,A00,890280,Chowdhury; Muhammed Zohir,19,0,30,11
1745138191357,USP 150,A00,890281,Boomhower; Matthew Charles,19,0,30,11
1745138192397,USP 151,A00,890282,Staff,17,0,20,3
1745138193426,USP 162,A00,890283,Andrews; Abigail Leslie,17,0,20,3
1745138194454,USP 168,A00,920477,Kwak; Nancy,2,0,5,3
1745138195491,USP 181,A00,890284,Staff,11,0,20,9
1745138196518,USP 191A,A00,890285,Staff,15,0,20,5
1745138206306,VIS 101,A00,886512,Staff,37,0,75,38
1745138207333,VIS 103,A00,886513,Cruz; Edwin Teddy,65,0,75,10
1745138208359,VIS 108,A00,886514,Staff,7,0,15,8
1745138209400,VIS 127P,A00,886515,Shen; Kuiyi,92,0,146,54
1745138210431,VIS 149,A00,886516,Yoldas; Pinar,1,0,15,14
1745138211506,VIS 164,A00,886526,Erdmann; Dean,21,0,22,1
1745138212543,VIS 194S,A00,886527,Staff,61,0,75,14
1745138213570,WCWP 10A,C00,886484,Staff,13,0,15,2
1745138214597,WCWP 10B,A00,886490,Staff,5,0,15,10
1745138214597,WCWP 10B,B00,886491,Staff,0,1,0,0
1745138214597,WCWP 10B,C00,886492,Staff,10,0,15,5
1745138215629,WCWP 100,A00,886494,Staff,0,2,15,15
1745138217886,AAS 10,A01,886199,Childs; Dennis R.,0,2,0,0
1745138218912,ANAR 104,A01,886940,Shtienberg; Gilad,27,0,30,3
1745138219947,ANAR 120,A00,886953,Staff,13,0,20,7
1745138220973,ANBI 148,A01,886955,Wilder; Linnea Lorene,32,0,40,8
1745138223036,ANSC 122,A00,886957,Staff,28,0,30,2
1745138224062,ANSC 150,A00,886958,Sloane; Julia Kathryn,6,0,15,9
1745138225098,ANSC 156,A00,886959,Jenkins; Janis A.,2,0,15,13
1745138226123,ANSC 180,A00,886960,Staff,12,0,17,5
1745138227161,ANSC 188,A00,886961,Jassal; Aftab,10,0,25,15
1745138228185,ANSC 190,A00,886962,Jassal; Aftab,14,0,25,11
1745138229218,ANSC 191,A00,886963,Staff,18,0,20,2
1745138230251,ANTH 3,A01,891689,Staff,19,0,20,1
1745138231278,ANTH 5,A00,886933,Semendeferi; Ekaterini,18,0,20,2
1745138232303,ANTH 10,A00,886934,Staff,0,8,30,30
1745138233337,ANTH 21,A01,886936,Staff,44,0,60,16
1745138234365,ANTH 23,A01,886938,Staff,94,0,100,6
1745138235392,ANTH 105,A00,886964,Stewart; Alexander B,94,0,100,6
1745138236423,ANTH 108,A00,886965,Pedersen; David,10,0,20,10
1745138237453,AWP 10,001,886147,Staff,0,0,0,0
1745138237453,AWP 10,002,886148,Staff,0,0,0,0
1745138237453,AWP 10,003,886149,Staff,0,0,0,0
1745138237453,AWP 10,004,886150,Staff,0,0,0,0
1745138237453,AWP 10,005,886151,Staff,0,0,0,0
1745138237453,AWP 10,006,886152,Staff,0,0,0,0
1745138237453,AWP 10,007,886153,Staff,0,0,0,0
1745138237453,AWP 10,008,886154,Staff,0,0,0,0
1745138237453,AWP 10,009,886155,Staff,0,0,0,0
1745138237453,AWP 10,010,886156,Staff,0,0,0,0
1745138237453,AWP 10,011,886158,Staff,0,0,0,0
1745138237453,AWP 10,012,886160,Staff,0,0,0,0
1745138237453,AWP 10,013,886161,Staff,0,0,0,0
1745138237453,AWP 10,014,886162,Staff,0,0,0,0
1745138237453,AWP 10,015,886163,Staff,0,0,0,0
1745138237453,AWP 10,016,886164,Staff,0,0,0,0
1745138237453,AWP 10,017,886165,Staff,0,0,0,0
1745138237453,AWP 10,018,886166,Staff,0,0,0,0
1745138237453,AWP 10,019,886168,Staff,0,0,0,0
1745138237453,AWP 10,020,886170,Staff,0,0,0,0
1745138237453,AWP 10,021,886172,Staff,0,0,0,0
1745138238480,AWP 10R,001,886173,Staff,0,0,0,0
1745138238480,AWP 10R,002,886174,Staff,0,1,0,0
1745138238480,AWP 10R,003,886175,Staff,0,0,0,0
1745138238480,AWP 10R,004,886176,Staff,0,0,0,0
1745138238480,AWP 10R,005,886177,Staff,0,0,0,0
1745138238480,AWP 10R,006,886178,Staff,0,0,0,0
1745138238480,AWP 10R,007,886179,Staff,0,0,0,0
1745138238480,AWP 10R,008,886181,Staff,0,0,0,0
1745138238480,AWP 10R,009,886182,Staff,0,0,0,0
1745138238480,AWP 10R,010,886183,Staff,0,0,0,0
1745138238480,AWP 10R,011,886184,Staff,0,0,0,0
1745138238480,AWP 10R,012,886185,Staff,0,0,0,0
1745138238480,AWP 10R,013,886186,Staff,0,0,0,0
1745138238480,AWP 10R,014,886187,Staff,0,0,0,0
1745138238480,AWP 10R,015,886188,Staff,0,0,0,0
1745138238480,AWP 10R,016,886189,Staff,0,0,0,0
1745138239512,AWP 102R,A00,886190,Staff,0,0,0,0
1745138239512,AWP 102R,B00,886191,Staff,0,0,0,0
1745138240539,BENG 100,A01,886193,Staff,19,0,30,11
1745138241565,BENG 122A,A01,886195,Hasty; Jeff M,20,0,30,10
1745138242592,BENG 166A,A00,886196,Sah; Robert Lie-Yuan,0,3,20,20
1745138243618,BIBC 102,A01,894320,Staff,0,2,46,46
1745138243618,BIBC 102,A02,894321,Staff,0,0,46,46
1745138243618,BIBC 102,A03,894344,Staff,21,0,46,25
1745138243618,BIBC 102,A04,894345,Staff,30,0,47,17
1745138244647,BICD 100R,A01,894365,Smith; Laurie,1,3,58,57
1745138244647,BICD 100R,A02,894366,Smith; Laurie,0,1,58,58
1745138244647,BICD 100R,A03,894367,Smith; Laurie,13,0,59,46
1745138245673,BICD 136,A01,894383,Gustafson-Brown; Cindy,16,0,50,34
1745138246701,BIEB 102,A01,894494,Butler; Shannon Rhey,67,0,130,63
1745138248795,BIEB 150,A01,894617,Wills; Christopher,0,3,13,13
1745138248795,BIEB 150,A02,894631,Wills; Christopher,0,3,13,13
1745138248795,BIEB 150,A03,894937,Wills; Christopher,0,3,13,13
1745138248795,BIEB 150,A04,894946,Wills; Christopher,0,1,11,11
1745138249859,BIEB 194,A00,906141,Kurle; Carolyn M.,14,0,20,6
1745138250887,BILD 1,A01,894154,Staff,8,0,19,11
1745138250887,BILD 1,A02,894155,Staff,15,0,19,4
1745138250887,BILD 1,A03,894160,Staff,18,0,19,1
1745138250887,BILD 1,A04,894161,Staff,16,0,18,2
1745138251930,BILD 2,A01,894168,Staff,0,0,50,50
1745138251930,BILD 2,A02,894169,Staff,0,0,50,50
1745138251930,BILD 2,A03,894179,Staff,27,0,50,23
1745138251930,BILD 2,A04,894203,Staff,42,0,50,8
1745138252959,BILD 3,A01,894213,Staff,24,0,31,7
1745138252959,BILD 3,A02,894214,Staff,28,0,31,3
1745138252959,BILD 3,A03,894235,Staff,30,0,31,1
1745138252959,BILD 3,A04,894236,Staff,29,0,32,3
1745138254164,BILD 4,A01,894253,Reuther; Keefe,12,0,24,12
1745138254164,BILD 4,A02,894258,Reuther; Keefe,19,0,24,5
1745138255191,BILD 5,A01,894276,Reuther; Keefe,40,0,50,10
1745138255191,BILD 5,A02,894277,Reuther; Keefe,48,0,50,2
1745138255191,BILD 5,A03,894290,Reuther; Keefe,47,0,50,3
1745138255191,BILD 5,A04,894291,Reuther; Keefe,50,0,50,0
1745138256217,BILD 24,A01,894297,Pirino; Giorgia,46,0,60,14
1745138257243,BIMM 100,A01,895012,Staff,0,14,0,1
1745138257243,BIMM 100,A02,895013,Staff,0,6,0,2
1745138257243,BIMM 100,A03,895014,Staff,0,7,0,0
1745138257243,BIMM 100,A04,895015,Staff,0,4,0,0
1745138258270,BIMM 101,A01,895017,McDonnell; Lisa Marie,0,2,24,24
1745138258270,BIMM 101,A02,895018,McDonnell; Lisa Marie,0,1,24,24
1745138258270,BIMM 101,B01,895020,McDonnell; Lisa Marie,0,3,24,24
1745138258270,BIMM 101,B02,895021,McDonnell; Lisa Marie,0,2,24,24
1745138259351,BIMM 110,A01,895023,Staff,7,0,25,18
1745138259351,BIMM 110,A02,895024,Staff,11,0,25,14
1745138259351,BIMM 110,A03,895025,Staff,22,0,25,3
1745138259351,BIMM 110,A04,895031,Staff,21,0,25,4
1745138260405,BIMM 120,A01,895114,Gustafson-Brown; Cindy,8,0,28,20
1745138260405,BIMM 120,A02,895126,Gustafson-Brown; Cindy,19,0,27,8
1745138261432,BIPN 100,A01,895130,Yang; Mingyu,13,0,38,25
1745138261432,BIPN 100,A02,895131,Yang; Mingyu,33,0,38,5
1745138261432,BIPN 100,A03,895132,Yang; Mingyu,33,0,38,5
1745138261432,BIPN 100,A04,895133,Yang; Mingyu,30,0,36,6
1745138262460,BIPN 120,A01,895135,Cooke; James Edward,0,3,13,13
1745138262460,BIPN 120,A02,895136,Cooke; James Edward,0,1,13,13
1745138262460,BIPN 120,A03,895137,Cooke; James Edward,0,0,13,13
1745138262460,BIPN 120,A04,895156,Cooke; James Edward,4,0,11,7
1745138263489,BIPN 134,A01,895235,Cooke; James Edward,0,3,25,25
1745138263489,BIPN 134,A02,895237,Cooke; James Edward,0,0,25,25
1745138263489,BIPN 134,A03,895240,Cooke; James Edward,13,0,25,12
1745138263489,BIPN 134,A04,895270,Cooke; James Edward,24,0,25,1
1745138264515,BIPN 189,A00,892103,Staff,0,20,9,9
1745138266599,CAT 124,A01,922009,Staff,0,1,20,20
1745138267631,CAT 125R,A00,886390,Morales; Celeste Georgianna,4,0,20,16
1745138267631,CAT 125R,B00,886391,Irwin; Matthew Joseph,0,1,20,20
1745138267631,CAT 125R,C00,886392,Smith; Lauryn Alissa,11,0,20,9
1745138267631,CAT 125R,D00,886393,Vanderschuit; Maya Alysia,6,0,20,14
1745138267631,CAT 125R,E00,886394,Marchisotto; Jennifer Anne,0,2,20,20
1745138268659,CENG 15,A01,886218,Drews; Aaron,1,0,5,4
1745138269705,CENG 113,A00,886219,Opatkiewicz; Justin Paul,16,0,25,9
1745138270732,CGS 101,A00,887044,Staff,13,0,20,7
1745138271757,CGS 105,A01,887046,Staff,16,0,25,9
1745138272783,CGS 112,A00,887047,Cuong; Marisol,12,0,15,3
1745138273807,CGS 113,A00,887048,Staff,24,0,30,6
1745138274838,CGS 120,A00,887049,Staff,12,0,17,5
1745138275865,CHEM 6A,A01,886336,Lam; Tin Yiu,44,0,50,6
1745138275865,CHEM 6A,A02,886338,Lam; Tin Yiu,43,0,50,7
1745138276893,CHEM 6B,A01,886341,Hopkins; Patrycja Anna,21,0,50,29
1745138276893,CHEM 6B,A02,886343,Hopkins; Patrycja Anna,46,0,50,4
1745138277925,CHEM 6C,A01,886346,Albizati; Kim F.,0,1,50,50
1745138277925,CHEM 6C,A02,886348,Albizati; Kim F.,38,0,50,12
1745138278957,CHEM 40A,A01,886352,Klosterman; Jeremy K,70,0,100,30
1745138279983,CHEM 40B,A01,886356,Klosterman; Jeremy K,0,4,100,100
1745138281010,CHEM 41B,A01,886360,Theodorakis; Emmanuel,30,0,50,20
1745138281010,CHEM 41B,A02,886362,Theodorakis; Emmanuel,46,0,50,4
1745138282043,CHIN 165A,A00,886382,Xu; Li,19,0,20,1
1745138283069,CLAS 120,A00,886387,Myerston Santana; Jacobo,36,0,40,4
1745138284104,COGS 9,A01,886967,Shannon; Kyle Michael,49,0,60,11
1745138285128,COGS 11,A01,886969,Staff,18,0,30,12
1745138286153,COGS 14A,A01,886971,Staff,26,0,60,34
1745138287183,COGS 14B,A01,886973,Hoffman; Drew Ellen,18,0,60,42
1745138288209,COGS 18,A01,886975,Morgan; Eric,41,0,60,19
1745138289240,COGS 20,A01,886977,Staff,6,0,8,2
1745138289240,COGS 20,A02,886978,Staff,6,0,7,1
1745138290269,COGS 100,A01,907783,Staff,6,0,30,24
1745138291296,COGS 101B,A01,886980,Staff,0,10,30,30
1745138292326,COGS 101C,A01,886982,Delgado; Tania,0,6,30,30
1745138293355,COGS 102A,A01,886984,Johnson; Christine M.,13,0,30,17
1745138294382,COGS 118B,A01,886986,Staff,0,25,60,60
1745138295409,COGS 150,A01,886988,Bergen; Benjamin,16,0,30,14
1745138296435,COGS 153,A00,886989,Delgado; Tania,0,6,30,30
1745138297465,COGS 186,A01,886991,Staff,3,0,30,27
1745138298492,COGS 187A,A01,886993,Boyle; Mary E. T.,12,0,30,18
1745138299522,COGS 189,A00,886994,Staff,13,0,30,17
1745138300548,COMM 10,A01,886996,Staff,11,0,25,14
1745138300548,COMM 10,A02,886997,Staff,21,0,25,4
1745138301574,COMM 20,A01,886999,Leuning; Grant Maurstad,33,0,40,7
1745138303630,COMM 100A,A01,887002,Staff,0,0,25,25
1745138303630,COMM 100A,A02,887003,Staff,20,0,25,5
1745138304672,COMM 100B,A01,887005,Staff,0,1,25,25
1745138305700,COMM 106D,A00,887006,Staff,22,0,40,18
1745138306730,COMM 110G,A00,887007,Whitworth-Smith; Andrew C,17,0,40,23
1745138307756,COMM 111B,A00,887008,Staff,31,0,40,9
1745138308789,COMM 113T,A00,887009,Abuelhiga; Soraya Jill,30,0,40,10
1745138308789,COMM 113T,B00,906733,Staff,40,0,40,0
1745138309817,COMM 145,A00,887010,Staff,21,0,40,19
1745138310844,COMM 146,A00,887054,Staff,31,0,40,9
1745138311869,COMM 190,A00,887012,Staff,9,0,23,14
1745138312895,CSE 8A,A50,887015,Cao; Yingjun,68,0,85,17
1745138313926,CSE 11,A01,887017,Cao; Yingjun,35,0,70,35
1745138314958,CSE 20,A01,887019,Staff,35,0,50,15
1745138315987,CSE 21,A01,887021,Braun; Oliver,81,0,100,19
1745138315987,CSE 21,B01,892583,Staff,48,0,50,2
1745138317016,CSE 30,A01,887025,Eldon; John,161,0,200,39
1745138318041,CSE 100,A01,887027,Staff,28,0,50,22
1745138318041,CSE 100,A02,887028,Staff,43,0,50,7
1745138319073,CSE 101,A01,887030,Braun; Oliver,79,0,100,21
1745138319073,CSE 101,B01,887032,Jones; Miles E,0,1,50,50
1745138319073,CSE 101,B02,887033,Jones; Miles E,13,0,50,37
1745138320098,CSE 105,A01,908084,Jones; Miles E,36,0,50,14
1745138320098,CSE 105,A02,908087,Jones; Miles E,38,0,50,12
1745138321131,CSE 135,A01,887035,Powell; Thomas Allan,8,0,50,42
1745138322156,CSE 142,A01,887037,Staff,22,0,60,38
1745138323182,CSE 142L,A01,887039,Staff,42,0,60,18
1745138324213,CSE 151A,A01,887041,Solares; Edwin A,60,0,100,40
1745138325245,CSE 175,A01,887043,Kumar; Rakesh,30,0,30,0
1745138326270,CSS 1,A01,886389,Staff,12,0,40,28
1745138327297,DSC 30,A01,908097,Liao; Soohyun Nam,54,0,75,21
1745138328323,DSC 40A,A01,908099,Shannon; Kyle Michael,37,0,50,13
1745138329352,DSC 40B,A01,908112,Staff,28,0,50,22
1745138330378,DSC 80,A01,908116,Staff,32,0,60,28
1745138331406,DSC 197,001,956863,Eldridge; Justin Matthew,9999,0,9999,0
1745138332437,ECE 5,A01,886400,Morris; Karcher William,3,0,6,3
1745138332437,ECE 5,A02,886401,Morris; Karcher William,5,0,6,1
1745138333466,ECE 148,A01,886403,Silberman; Jack,0,8,14,14
1745138334499,ECON 1,A01,887265,Crane; Meredith Helen,25,0,70,45
1745138334499,ECON 1,B01,887268,Staff,44,0,50,6
1745138335532,ECON 2,A01,887273,Crane; Meredith Helen,61,0,70,9
1745138336567,ECON 3,A01,887279,Rondina; Giacomo,44,0,70,26
1745138337599,ECON 4,A01,887282,Anderson; John Charles,0,1,10,10
1745138338634,ECON 5,A01,887285,Staff,39,0,45,6
1745138338634,ECON 5,B01,887292,Staff,43,0,45,2
1745138339664,ECON 100A,A01,887337,Newhouse; Herbert S,58,0,70,12
1745138339664,ECON 100A,B01,887349,Staff,45,0,50,5
1745138340698,ECON 100B,A01,887361,Du; Songzi,42,0,70,28
1745138341727,ECON 100C,A01,887445,Newhouse; Herbert S,61,0,70,9
1745138342759,ECON 105,A00,887488,Vespa; Emanuel Ignacio,24,0,35,11
1745138343790,ECON 109,A01,887506,Staff,29,0,35,6
1745138344819,ECON 110A,A01,887568,Alon; Titan Michael,1,0,35,34
1745138344819,ECON 110A,B01,907601,Alon; Titan Michael,27,0,35,8
1745138345851,ECON 110B,A01,887598,Levkoff; Steven B.,0,7,70,70
1745138346876,ECON 112,A00,887599,Rondina; Giacomo,20,0,35,15
1745138347905,ECON 120A,A01,887603,Dai; Yinlin,46,0,70,24
1745138348934,ECON 120C,A01,887608,Sun; Yixiao,0,0,35,35
1745138348934,ECON 120C,B01,887614,Sun; Yixiao,13,0,35,22
1745138349961,ECON 138,A00,887621,Bharadwaj; Prashant,0,18,20,20
1745138350990,ECON 171,A01,907666,Staff,27,0,35,8
1745138352024,ECON 175,A00,887626,Wu; Pak Yeung,27,0,35,8
1745138353049,ECON 190,A00,887640,Vespa; Emanuel Ignacio,26,0,35,9
1745138354085,EDS 25,A01,888197,Staff,0,0,0,0
1745138354085,EDS 25,A02,888209,Staff,0,0,0,0
1745138354085,EDS 25,A03,888210,Staff,0,0,0,0
1745138354085,EDS 25,A04,888212,Staff,0,0,0,0
1745138354085,EDS 25,A05,888213,Staff,0,0,0,0
1745138354085,EDS 25,A06,888214,Staff,0,0,0,0
1745138354085,EDS 25,A07,888235,Staff,0,0,0,0
1745138354085,EDS 25,A08,888236,Staff,0,0,0,0
1745138354085,EDS 25,A09,888240,Staff,0,0,0,0
1745138354085,EDS 25,A10,888244,Staff,0,0,0,0
1745138354085,EDS 25,B01,888273,Staff,0,0,0,0
1745138354085,EDS 25,B02,888285,Staff,0,0,0,0
1745138354085,EDS 25,B03,888423,Staff,29,0,30,1
1745138354085,EDS 25,B04,888432,Staff,0,0,0,0
1745138354085,EDS 25,B05,888433,Staff,0,0,0,0
1745138354085,EDS 25,B06,888467,Staff,0,0,0,0
1745138354085,EDS 25,B07,888468,Staff,0,0,0,0
1745138354085,EDS 25,B08,888479,Staff,0,0,0,0
1745138354085,EDS 25,B09,888484,Staff,0,0,0,0
1745138354085,EDS 25,B10,888487,Staff,0,0,0,0
1745138355116,EDS 38,A01,907700,Choi; Bailey Miyeon,30,0,30,0
1745138356148,EDS 112,A01,888601,Chapman; Thandeka K,23,0,40,17
1745138357175,EDS 115,A00,888697,Mendez; Kathrina Mendoza,17,0,30,13
1745138358415,EDS 116,A01,888893,Staff,38,0,40,2
1745138360471,EDS 124AR,A00,889133,Staff,33,0,50,17
1745138360471,EDS 124AR,B00,907471,Simon; Elizabeth A,42,0,50,8
1745138361511,EDS 124BR,A00,889134,Staff,57,0,100,43
1745138363562,EDS 125,A00,889135,Staff,26,0,30,4
1745138367337,EDS 126,A01,889138,Staff,37,0,40,3
1745138368369,EDS 164R,A01,889142,Wishard Guerra; Alison G.,38,0,50,12
1745138369397,ENG 30,A01,886396,Staff,0,0,0,0
1745138369397,ENG 30,B01,886398,Staff,0,0,0,0
1745138370464,ENVR 102,A00,906150,Montejo; Carolina,23,0,25,2
1745138371492,ETHN 103A,A00,887236,Man; Simeon S,0,5,0,0
1745138372530,ETHN 113,A00,887239,Staff,20,0,30,10
1745138373574,ETHN 116,A00,887240,Staff,20,0,25,5
1745138374602,ETHN 117,A00,887241,Choi; Esther Min,27,0,30,3
1745138375650,ETHN 118,A00,887243,Staff,24,0,30,6
1745138376679,ETHN 127,A00,887248,Cuong; Marisol,12,0,15,3
1745138377712,ETHN 139,A00,887250,Staff,8,0,10,2
1745138378736,ETHN 142,A00,887252,Staff,18,0,30,12
1745138379769,ETHN 161,A00,887253,Browne; Errol Tsekani,28,0,30,2
1745138380795,ETHN 163FR,A00,887255,Burelle; Julie Sara Veronique,4,0,5,1
1745138381821,GLBH 20,A00,889149,Elwardani; Nile Regina,15,0,42,27
1745138383895,GLBH 111,A01,889152,Burgos; Jose L.,17,0,17,0
1745138384920,GLBH 150,A00,889181,Sloane; Julia Kathryn,0,1,15,15
1745138386985,HDS 60,A01,886406,Warstadt; Melissa Fawn,76,0,80,4
1745138388010,HIAF 111,A00,889324,Gyamfi; Bright,0,4,0,0
1745138389035,HIEA 131,A00,889328,Staff,14,0,32,18
1745138390062,HIEA 144,A00,889333,Henry; Todd A.,29,0,32,3
1745138391088,HIEA 154,A00,889336,Henry; Todd A.,28,0,32,4
1745138392115,HIEU 106,A00,889339,Staff,28,0,32,4
1745138394170,HIEU 114,A00,889340,Staff,18,0,32,14
1745138395197,HIEU 135GS,A00,889342,Patterson; Patrick H.,0,0,1,22
1745138396222,HIEU 137,A00,889343,Edington; Claire Ellen,12,0,25,13
1745138397248,HIEU 148,A00,889345,Staff,16,0,32,16
1745138398274,HIEU 154,A00,889346,Biess; Frank Peter,24,0,32,8
1745138399306,HILA 102,A00,889351,Staff,13,0,32,19
1745138400349,HILD 2A,A01,889221,Lewandoski; Julia Mavis,0,5,32,32
1745138401377,HILD 7B,A01,889225,Man; Simeon S,0,7,32,32
1745138402425,HILD 7C,A01,889288,Alvarez; Luis A,0,8,32,32
1745138403464,HILD 30,A01,889323,Staff,0,1,32,32
1745138405527,HISC 119,A00,889383,Golan; Tal,22,0,32,10
1745138406569,HIUS 103,A00,889384,Man; Simeon S,10,0,32,22
1745138407613,HIUS 117,A00,919797,Kwak; Nancy,23,0,32,9
1745138408640,HIUS 142A,A00,919788,Staff,24,0,32,8
1745138410718,HIUS 149,A00,889386,Gyamfi; Bright,0,1,0,0
1745138411756,HIUS 155,A00,889387,Alvarez; Luis A,19,0,32,13
1745138412797,HUM 3,A01,886499,Caldwell; Michael Alan,24,0,50,26
1745138413832,HUM 3GS,A00,886500,Rodriguez; Bretton Sigfred,0,0,0,26
1745138414870,HUM 3R,A01,886502,Markman; Kristina,0,32,50,50
1745138415906,HUM 4,A01,886504,Crum; Matthew Stephen,28,0,50,22
1745138415906,HUM 4,B01,886506,West; Geoffrey Scott,25,0,50,25
1745138416935,HUM 4GS,A00,886507,Staff,0,0,0,13
1745138417963,HUM 5,A01,886509,Staff,35,0,50,15
1745138418994,HUM 5R,A01,886511,Zavodny; Tatiana Sophia,0,32,50,50
1745138420038,JAPN 180,A00,886407,Staff,25,0,40,15
1745138421076,LATI 50,A01,886409,Martin-Cabrera; Luis,9,0,22,13
1745138421076,LATI 50,A02,886410,Martin-Cabrera; Luis,20,0,22,2
1745138421076,LATI 50,A03,886411,Martin-Cabrera; Luis,22,0,22,0
1745138421076,LATI 50,A04,886412,Martin-Cabrera; Luis,15,0,22,7
1745138422104,LAWS 101,A00,907664,Staff,36,0,60,24
1745138423144,LIAB 1A,A00,889388,Saab; Dima,19,0,20,1
1745138424170,LIAB 1AX,A00,889389,El Cheddadi; Youniss,19,0,20,1
1745138425207,LIFR 1C,A00,889391,Van Moer; Vinciane G,9,0,20,11
1745138426232,LIFR 1CX,A00,889392,Van Moer; Vinciane G,8,0,20,12
1745138427258,LIFR 1D,A00,889393,Van Moer; Vinciane G,11,0,20,9
1745138428285,LIFR 1DX,A00,889394,Van Moer; Vinciane G,11,0,20,9
1745138432162,LIGN 7,A00,886923,Staff,30,0,50,20
1745138433188,LIGN 17,A00,886924,Kehler; Andrew Scott,133,0,150,17
1745138437465,LTAM 110,A00,889395,Staff,17,0,30,13
1745138438491,LTCH 101,A00,889397,Staff,22,0,25,3
1745138439520,LTCS 130,A00,889398,Staff,23,0,25,2
1745138440549,LTEA 138,A00,889399,Staff,25,0,40,15
1745138441575,LTEN 149,A00,889400,Wesling; Megan E.,6,0,25,19
1745138442601,LTEN 169,A00,889401,Staff,24,0,25,1
1745138443629,LTEN 180,A00,889402,Staff,12,0,15,3
1745138444666,LTEN 181,A00,889403,Staff,23,0,25,2
1745138445693,LTWL 100,A00,889404,Myerston Santana; Jacobo,8,0,25,17
1745138446725,LTWL 180GS,A00,889405,Staff,6,0,20,14
1745138447753,LTWL 181,A00,889406,Staff,19,0,25,6
1745138448780,LTWL 184,A00,889475,Mukherjee; Silpa,21,0,25,4
1745138449818,LTWR 102C,A00,889486,Staff,29,0,30,1
1745138450844,LTWR 115W,A00,889491,Staff,3,0,15,12
1745138451870,MAE 8,A01,886905,Staff,0,2,0,0
1745138452897,MAE 11,A00,886906,Bandaru; Prabhakar,0,0,50,50
1745138453925,MAE 20,A00,886907,Evdokimenko; Ekaterina,50,0,70,20
1745138454972,MAE 30B,A00,886909,Ghazinejad; Maziar,28,0,45,17
1745138456001,MAE 101B,A00,886910,Saintillan; David,36,0,45,9
1745138457027,MAE 105,A00,886911,Bandaru; Prabhakar,26,0,50,24
1745138458066,MAE 107,A00,886912,Staff,22,0,60,38
1745138459092,MAE 143B,A00,886913,Bewley; Thomas R,14,0,40,26
1745138460119,MAE 148,A01,886915,Silberman; Jack,5,0,14,9
1745138461156,MAE 160,A00,886916,Evdokimenko; Ekaterina,41,0,60,19
1745138462185,MATH 3C,A01,889681,Staff,2,0,30,28
1745138463213,MATH 10A,A01,889760,Staff,28,0,30,2
1745138463213,MATH 10A,A02,889783,Staff,30,0,30,0
1745138464266,MATH 10B,A01,889785,Verstraete; Jacques Allan,0,2,30,30
1745138464266,MATH 10B,A02,889795,Verstraete; Jacques Allan,0,2,30,30
1745138464266,MATH 10B,B01,889797,Verstraete; Jacques Allan,1,0,30,29
1745138464266,MATH 10B,B02,889828,Verstraete; Jacques Allan,23,0,30,7
1745138465298,MATH 10C,A01,889849,Habib; Yousaf,18,0,30,12
1745138465298,MATH 10C,A02,889852,Habib; Yousaf,20,0,30,10
1745138465298,MATH 10C,A03,889853,Habib; Yousaf,25,0,30,5
1745138465298,MATH 10C,A04,889858,Habib; Yousaf,21,0,30,9
1745138465298,MATH 10C,B01,889861,Staff,12,0,30,18
1745138465298,MATH 10C,B02,889862,Staff,26,0,30,4
1745138465298,MATH 10C,B03,889863,Staff,28,0,30,2
1745138465298,MATH 10C,B04,889967,Staff,25,0,30,5
1745138466326,MATH 18,A01,889974,Staff,15,0,30,15
1745138466326,MATH 18,A02,889977,Staff,25,0,30,5
1745138466326,MATH 18,B01,889984,Hardiman; Liam,26,0,30,4
1745138466326,MATH 18,B02,889985,Hardiman; Liam,28,0,30,2
1745138467368,MATH 20A,A01,889990,Suk; Andrew Hoon,31,0,35,4
1745138468397,MATH 20B,A01,889993,Ohm; Ko Woon,21,0,30,9
1745138468397,MATH 20B,A02,889994,Ohm; Ko Woon,30,0,30,0
1745138468397,MATH 20B,B01,889996,Ohm; Ko Woon,25,0,30,5
1745138468397,MATH 20B,B02,889997,Ohm; Ko Woon,24,0,30,6
1745138469439,MATH 20C,A01,889999,Hammock; Frances H,22,0,30,8
1745138469439,MATH 20C,A02,890003,Hammock; Frances H,23,0,30,7
1745138469439,MATH 20C,B01,890006,Hammock; Frances H,11,0,30,19
1745138469439,MATH 20C,B02,890007,Hammock; Frances H,18,0,30,12
1745138470490,MATH 20D,A01,890011,Cheng; Hsiao-Bing,6,0,30,24
1745138470490,MATH 20D,A02,890012,Cheng; Hsiao-Bing,27,0,30,3
1745138470490,MATH 20D,B01,890016,Cheng; Hsiao-Bing,19,0,30,11
1745138470490,MATH 20D,B02,890017,Cheng; Hsiao-Bing,15,0,30,15
1745138471540,MATH 20E,A01,890026,Harel; Guershon,10,0,30,20
1745138471540,MATH 20E,A02,890029,Harel; Guershon,24,0,30,6
1745138471540,MATH 20E,B01,890033,Harel; Guershon,14,0,30,16
1745138471540,MATH 20E,B02,890101,Harel; Guershon,27,0,30,3
1745138472568,MATH 102,A01,890104,Staff,20,0,30,10
1745138472568,MATH 102,A02,890105,Staff,30,0,30,0
1745138473596,MATH 103B,A01,890116,Salehi Golsefidy; Alireza,8,0,30,22
1745138473596,MATH 103B,B01,890118,Staff,0,4,30,30
1745138474626,MATH 109,A01,890121,Aliabadi Sr.; Mohsen,6,0,30,24
1745138474626,MATH 109,B01,890124,Upadrashta; Pranav Kumar,23,0,30,7
1745138475654,MATH 120A,A01,890126,Eggers; John Dietrich,15,0,30,15
1745138476692,MATH 142B,A01,890128,Ioana; Adrian,17,0,30,13
1745138476692,MATH 142B,A02,890129,Ioana; Adrian,15,0,30,15
1745138477718,MATH 154,A01,890174,Staff,0,1,30,30
1745138477718,MATH 154,A02,890182,Staff,15,0,30,15
1745138478745,MATH 168A,A01,890197,Dumitriu; Ioana,22,0,35,13
1745138479793,MATH 170A,A01,890240,Nie; Jiawang,6,0,30,24
1745138479793,MATH 170A,A02,890241,Nie; Jiawang,18,0,30,12
1745138479793,MATH 170A,A03,890249,Nie; Jiawang,23,0,30,7
1745138480837,MATH 170B,A01,957891,Nag; Panchali,25,0,35,10
1745138482890,MATH 181A,A01,908025,Staff,0,8,35,35
1745138483927,MATH 193B,A01,890265,Staff,3,0,35,32
1745138484970,MGT 4,A01,890311,Anderson; John Charles,57,0,88,31
1745138486008,MGT 5,A00,907740,Staff,41,0,98,57
1745138487034,MGT 12,A00,890312,Lindenberger; Wade Douglas,70,0,98,28
1745138488061,MGT 16,A00,957883,Staff,84,0,98,14
1745138492803,MGT 45,A00,890314,Pecore; Joseph P.,57,0,98,41
1745138493827,MGT 71,A00,890315,Staff,6,0,98,92
1745138495089,MGT 100,A00,890316,Yavorsky; Daniel Ryan,59,0,98,39
1745138496464,MGT 103,A00,890317,Ehrich; Kristine R,77,0,98,21
1745138497563,MGT 105,A00,890356,Bates; Kenneth Walter,19,0,98,79
1745138498596,MGT 112,A00,890360,Ehrich; Kristine R,65,0,98,33
1745138499622,MGT 127R,A00,907732,Zhu; Kevin Xiaoguo,32,0,98,66
1745138500656,MGT 131B,A00,890361,Anderson; John Charles,75,0,98,23
1745138501690,MGT 137,A00,890362,Lindenberger; Wade Douglas,68,0,98,30
1745138502732,MGT 160,A00,890369,Johnson; Erik Barry,37,0,98,61
1745138504784,MGT 164,A00,890372,Zimmermann; Carsten,0,28,98,98
1745138505809,MGT 180,A00,890374,Bliss; Barbara Ann,32,0,98,66
1745138506853,MMW 15,A01,886414,Chang; Edmond Yi-Teh,0,10,28,28
1745138506853,MMW 15,A02,886415,Chang; Edmond Yi-Teh,0,10,28,28
1745138506853,MMW 15,A03,886416,Chang; Edmond Yi-Teh,0,8,28,28
1745138506853,MMW 15,A04,886417,Chang; Edmond Yi-Teh,0,8,28,28
1745138506853,MMW 15,B01,886419,Chang; Edmond Yi-Teh,0,8,28,28
1745138506853,MMW 15,B02,886420,Chang; Edmond Yi-Teh,0,9,28,28
1745138506853,MMW 15,B03,886421,Chang; Edmond Yi-Teh,0,9,28,28
1745138506853,MMW 15,B04,886422,Chang; Edmond Yi-Teh,0,9,28,28
1745138506853,MMW 15,C01,886424,Staff,0,10,28,28
1745138506853,MMW 15,C02,886425,Staff,0,10,28,28
1745138506853,MMW 15,C03,886426,Staff,0,9,28,28
1745138506853,MMW 15,C04,886427,Staff,0,9,28,28
1745138507900,MMW 15GS,A00,906910,Patterson; Patrick H.,5,0,28,23
1745138508928,MMW 122R,A01,886429,Rahimi; Babak,0,23,28,28
1745138508928,MMW 122R,A02,886430,Rahimi; Babak,0,23,28,28
1745138509958,MUS 1A,A01,890937,Staff,8,0,25,17
1745138509958,MUS 1A,A02,891035,Staff,15,0,25,10
1745138509958,MUS 1A,B00,907849,Staff,48,0,50,2
1745138509958,MUS 1A,B01,907850,Staff,25,0,25,0
1745138509958,MUS 1A,B02,907851,Staff,25,0,25,0
1745138512030,MUS 2AK,A00,957092,Ohnishi; Takae,15,0,15,0
1745138513069,MUS 4,A01,891044,Staff,6,0,25,19
1745138513069,MUS 4,A02,891045,Staff,24,0,25,1
1745138513069,MUS 4,B01,891048,Staff,20,0,25,5
1745138513069,MUS 4,B02,891050,Staff,25,0,25,0
1745138514120,MUS 5,A01,957506,Dubnov; Shlomo,4,0,25,21
1745138514120,MUS 5,A02,957622,Dubnov; Shlomo,21,0,25,4
1745138514120,MUS 5,A03,957623,Dubnov; Shlomo,23,0,25,2
1745138515148,MUS 6,A01,891053,Freitas Caetano; Marcelo,23,0,25,2
1745138515148,MUS 6,A02,891054,Freitas Caetano; Marcelo,23,0,25,2
1745138516182,MUS 7,A01,891081,Staff,0,0,25,25
1745138516182,MUS 7,A02,891082,Staff,15,0,25,10
1745138517209,MUS 8GS,A00,891118,Borgo; David Garcia,5,0,25,20
1745138518243,MUS 11,A01,891140,Staff,12,0,25,13
1745138518243,MUS 11,A02,891141,Staff,24,0,25,1
1745138519277,MUS 13,A01,891143,Staff,10,0,25,15
1745138519277,MUS 13,A02,891144,Staff,25,0,25,0
1745138520315,MUS 15,A01,891146,Staff,7,0,25,18
1745138520315,MUS 15,A02,891148,Staff,22,0,25,3
1745138520315,MUS 15,B01,891150,Staff,18,0,25,7
1745138520315,MUS 15,B02,891151,Staff,25,0,25,0
1745138521343,MUS 20,A01,891153,Staff,9,0,20,11
1745138521343,MUS 20,A02,891155,Staff,16,0,20,4
1745138522388,MUS 80,A00,891156,Staff,19,0,25,6
1745138522388,MUS 80,B00,891157,Staff,25,0,25,0
1745138523423,MUS 130,A00,891158,Ohnishi; Takae,35,0,35,0
1745138524457,MUS 150GS,A01,891160,Borgo; David Garcia,5,0,25,20
1745138525483,MUS 170,A01,891162,Freitas Caetano; Marcelo,21,0,25,4
1745138525483,MUS 170,A02,891164,Freitas Caetano; Marcelo,22,0,25,3
1745138526533,NANO 11,A00,886220,Vazquez Mena; Oscar,12,0,15,3
1745138527560,NANO 15,A01,886222,Drews; Aaron,9,0,10,1
1745138528594,NANO 104,A00,886224,Sirbuly; Donald,18,0,25,7
1745138529619,PH 40,A00,886528,Staff,29,0,40,11
1745138530647,PH 45,A01,886799,Staff,36,0,40,4
1745138531672,PH 110,A00,886802,Staff,7,0,40,33
1745138532709,PH 172,A00,906716,Staff,20,0,35,15
1745138533734,PH 191,A00,886803,Staff,23,0,40,17
1745138534778,PHIL 1,A00,889500,Staff,22,0,30,8
1745138535834,PHIL 10,A01,889549,Grush; Rick Scott,17,0,22,5
1745138535834,PHIL 10,A02,889551,Grush; Rick Scott,20,0,22,2
1745138536884,PHIL 28,A01,889559,Lamey; Andy M.,0,4,25,25
1745138536884,PHIL 28,A02,889561,Lamey; Andy M.,0,0,25,25
1745138536884,PHIL 28,A03,889572,Lamey; Andy M.,7,0,25,18
1745138537910,PHIL 35,A00,907839,Staff,32,0,33,1
1745138538944,PHIL 60,A00,889574,Staff,79,0,90,11
1745138539971,PHIL 105,A00,889579,Staff,0,1,0,0
1745138541011,PHIL 136,A00,889582,Fulkerson; Matthew Todd,27,0,45,18
1745138542039,PHIL 163,A01,889601,Staff,24,0,30,6
1745138542039,PHIL 163,B01,889606,Brandt; Reuven A,0,2,0,0
1745138543073,PHIL 164,A00,889610,Staff,20,0,30,10
1745138544096,PHIL 165,A00,889613,Staff,26,0,30,4
1745138545123,PHYS 1A,A00,886431,Staff,38,0,70,32
1745138546166,PHYS 1AL,001,886432,Tsai; Philbert S,0,0,30,30
1745138546166,PHYS 1AL,002,886436,Tsai; Philbert S,19,0,30,11
1745138547192,PHYS 1B,A00,886439,Staff,192,0,240,48
1745138548217,PHYS 1BL,001,886441,Tsai; Philbert S,0,1,30,30
1745138548217,PHYS 1BL,002,886444,Tsai; Philbert S,14,0,30,16
1745138549268,PHYS 1C,A00,896092,Arnold; Kam S,87,0,146,59
1745138550295,PHYS 1CL,001,886448,Tsai; Philbert S,0,4,30,30
1745138550295,PHYS 1CL,002,886449,Tsai; Philbert S,6,0,30,24
1745138550295,PHYS 1CL,003,886450,Tsai; Philbert S,22,0,30,8
1745138550295,PHYS 1CL,004,886451,Tsai; Philbert S,16,0,30,14
1745138551323,PHYS 2B,A01,886457,Staff,86,0,115,29
1745138552349,PHYS 2C,A01,886460,Shotwell; Brian,0,0,65,65
1745138553387,PHYS 2CL,A01,886467,Staff,0,3,28,28
1745138553387,PHYS 2CL,A02,886468,Staff,5,0,28,23
1745138554420,PHYS 2D,A01,886470,Staff,17,0,50,33
1745138555446,PHYS 4B,A01,886475,Grinstein; Benjamin,88,0,100,12
1745138556474,POLI 5,A00,891173,Desposato; Scott,17,0,25,8
1745138557508,POLI 5D,A01,891175,Staff,5,0,5,0
1745138557508,POLI 5D,B01,891178,Staff,5,0,5,0
1745138558536,POLI 11,A00,891179,Ferree; Karen E,3,0,25,22
1745138559562,POLI 12,A00,891180,Staff,21,0,30,9
1745138560594,POLI 27,A01,891182,Staff,29,0,75,46
1745138561629,POLI 30,A00,891183,Staff,0,3,30,30
1745138562654,POLI 100B,A00,891244,Staff,0,8,20,20
1745138563688,POLI 100I,A00,891247,Staff,19,0,30,11
1745138564712,POLI 104J,A00,891248,Nichter; Maysa,18,0,30,12
1745138565746,POLI 104U,A00,891250,Nichter; Maysa,9,0,30,21
1745138566771,POLI 108,A00,891253,Staff,0,0,0,4
1745138567798,POLI 110B,A00,891255,Wiens; David,22,0,25,3
1745138568823,POLI 112A,A00,891256,Wiens; David,15,0,25,10
1745138569850,POLI 114BR,A00,891261,Staff,22,0,30,8
1745138570877,POLI 117R,A00,891262,Forman; Fonna,12,0,50,38
1745138571916,POLI 118,A00,891264,Ingham; Sean,22,0,25,3
1745138572941,POLI 124A,A00,891265,Staff,19,0,20,1
1745138573968,POLI 125D,A00,891266,Nichter; Simeon C,9,0,25,16
1745138575013,POLI 126,A00,891268,Nichter; Simeon C,11,0,25,14
1745138576045,POLI 126AA,A00,891272,Staff,19,0,25,6
1745138577083,POLI 130AA,A00,891273,Staff,17,0,20,3
1745138578111,POLI 134AA,A00,891274,Staff,12,0,20,8
1745138580172,POLI 138,A00,891278,Staff,22,0,25,3
1745138581197,POLI 142K,A00,891280,Staff,17,0,25,8
1745138582224,POLI 142M,A00,891281,Gartzke; Erik,22,0,30,8
1745138583258,POLI 142P,A00,891284,Staff,21,0,30,9
1745138584285,POLI 143,A00,891285,Gartzke; Erik,17,0,30,13
1745138585310,POLI 153,A00,891286,Staff,20,0,20,0
1745138586352,POLI 170A,A00,891288,Staff,19,0,25,6
1745138587379,POLI 175,A00,891290,Staff,18,0,20,2
1745138588407,PSYC 1,A00,890674,Steiner; Eric Tomas,0,4,45,45
1745138592682,PSYC 2,A00,890676,Albright; Thomas D,25,0,35,10
1745138593709,PSYC 3,A00,890679,Staff,18,0,20,2
1745138594822,PSYC 60,A01,890684,Rickard; Timothy C.,7,0,45,38
1745138597586,PSYC 70,A01,890689,Geller; Emma Harlan,14,0,30,16
1745138598625,PSYC 100,A00,890690,Lacefield; Katharine I,0,43,180,180
1745138599649,PSYC 102,A00,890695,Staff,26,0,40,14
1745138600675,PSYC 105,A00,890699,Geller; Emma Harlan,78,0,100,22
1745138601712,PSYC 106,A00,890701,Gorman; Michael R.,15,0,30,15
1745138602739,PSYC 108,A00,890704,Adrian; Julia Anna,0,23,50,50
1745138603772,PSYC 118,A01,890712,Staff,18,0,30,12
1745138604799,PSYC 124,A00,890716,Chapman; Eddie Nathaniel,36,0,60,24
1745138605835,PSYC 131,A00,890717,Anagnostaras; Stephan,6,0,80,74
1745138606860,PSYC 137,A00,890719,Winkielman; Piotr,0,2,30,30
1745138607888,PSYC 144,A00,890721,Adrian; Julia Anna,0,3,45,45
1745138608914,PSYC 162,A00,890805,Staff,21,0,75,54
1745138609938,PSYC 169,A00,890810,Staff,0,15,30,30
1745138610974,PSYC 172,A00,890814,Gorman; Michael R.,14,0,30,16
1745138612000,PSYC 181,A00,890818,Anagnostaras; Stephan,63,0,200,137
1745138613027,PSYC 189,A00,890823,Staff,11,0,30,19
1745138614053,PSYC 191,A00,890884,Rickard; Timothy C.,0,11,35,35
1745138615078,PSYC 193,A00,890913,Staff,22,0,30,8
1745138615078,PSYC 193,B00,890914,Chapman; Eddie Nathaniel,25,0,30,5
1745138616118,PSYC 193L,A01,890918,Lowe; Angela Beth,29,0,30,1
1745138616118,PSYC 193L,B01,890921,Hurwitz; Ethan Scott,28,0,30,2
1745138616118,PSYC 193L,C01,890928,Staff,30,0,30,0
1745138617144,RELI 149,A00,886806,Rahimi; Babak,23,0,40,17
1745138618178,SE 9,A01,886814,Staff,13,0,20,7
1745138619205,SE 101B,A01,886816,Chadha; Mayank,8,0,30,22
1745138620233,SE 110B,A00,886818,Zhu; Qiang,0,16,45,45
1745138621258,SE 125,A01,886830,Staff,10,0,30,20
1745138622291,SE 130B,A01,886835,Staff,19,0,40,21
1745138623331,SE 131A,A01,886838,Krysl; Petr,37,0,55,18
1745138624356,SE 154,A00,886840,Staff,35,0,50,15
1745138625381,SE 164GS,A01,886849,Staff,13,0,20,7
1745138626408,SE 167GS,A01,886853,Staff,13,0,20,7
1745138627446,SIO 25,A01,890107,Staff,23,0,30,7
1745138628476,SIO 45,A00,890109,Cook; Geoffrey W,137,0,200,63
1745138629502,SIO 109R,A00,890110,Forman; Fonna,0,11,20,20
1745138630537,SIO 187,A01,890114,Kacev; David,21,0,40,19
1745138631564,SOCI 1,A01,890431,Thorpe; Charles Robert,21,0,30,9
1745138631564,SOCI 1,A02,890518,Thorpe; Charles Robert,30,0,30,0
1745138632597,SOCI 2,A01,957978,Staff,0,0,0,0
1745138632597,SOCI 2,A02,957979,Staff,0,3,0,0
1745138633623,SOCI 20,A01,890523,Calderon-Zaks; Michael Aar,24,0,30,6
1745138633623,SOCI 20,A02,890526,Calderon-Zaks; Michael Aar,29,0,30,1
1745138634650,SOCI 30,A01,890533,Pardo Guerra; Juan Pablo,37,0,40,3
1745138635677,SOCI 40,A01,890535,Staff,32,0,45,13
1745138636704,SOCI 104Q,A00,890559,Staff,20,0,30,10
1745138637737,SOCI 106,A00,890560,Arnal; Maud Marie Leonie,22,0,30,8
1745138638764,SOCI 110,A00,890567,Holkenbrink-Monk; Charlene,22,0,30,8
1745138639795,SOCI 112,A00,890568,Victoria Torres; Pablo,0,0,45,45
1745138640821,SOCI 115,A00,890597,Arnal; Maud Marie Leonie,33,0,45,12
1745138642886,SOCI 121,A00,890604,Pardo Guerra; Juan Pablo,40,0,45,5
1745138643912,SOCI 126,A01,890608,Staff,8,0,10,2
1745138644939,SOCI 127,A00,890609,Staff,23,0,30,7
1745138645966,SOCI 131,A00,890610,Thorpe; Charles Robert,38,0,45,7
1745138646994,SOCI 135,A00,890615,Payne; Christine Anna,20,0,45,25
1745138648021,SOCI 139,A00,890620,Staff,43,0,45,2
1745138649047,SOCI 148E,A00,890622,Calderon-Zaks; Michael Aar,39,0,45,6
1745138650074,SOCI 150,A00,890623,Kohler; Kristopher M.,36,0,45,9
1745138651108,SOCI 157,A00,890625,Jules-Rosette; Bennetta W.,18,0,20,2
1745138652134,SOCI 160,A00,890627,Payne; Christine Anna,26,0,45,19
1745138653160,SYN 1,A00,886855,Fish; Gwendolyn Anne,0,0,0,0
1745138653160,SYN 1,B00,906086,Fish; Gwendolyn Anne,0,0,0,2
1745138654187,SYN 2R,A00,886860,Staff,0,15,15,15
1745138654187,SYN 2R,B00,906106,Atkinson; Arthur Laird,0,14,15,15
1745138655221,SYN 100,A01,886866,Browne; Emily,0,29,20,20
1745138655221,SYN 100,B01,906128,Rock; Martin,0,4,20,20
1745138655221,SYN 100,C01,906140,Deavenport; James Cary,0,2,20,20
1745138655221,SYN 100,D01,907816,Deavenport; James Cary,0,3,20,20
1745138656258,TDAC 1,A00,890286,Walsh; Kim C.,11,0,20,9
1745138657282,TDAC 101,A00,890296,Basso; Beatrice,18,0,20,2
1745138658312,TDDE 131,A00,890297,Staff,47,0,50,3
1745138659337,TDDM 1,A00,890287,Weinberg; Sadie,26,0,30,4
1745138660364,TDGE 11,A00,890288,Fulton; Julia,155,0,200,45
1745138660364,TDGE 11,B00,890289,Castro; Robert Jess,188,0,200,12
1745138661398,TDGE 25,B00,957359,Walsh; Kim C.,9,0,20,11
1745138662427,TDGE 40,A01,890292,Power; Jade Yukana,28,0,30,2
1745138663459,TDGE 124,A00,890298,Havis; Allan,12,0,50,38
1745138664485,TDGE 131R,A00,890299,Burelle; Julie Sara Veronique,20,0,42,22
1745138665509,TDHT 101,A00,890300,Staff,12,0,20,8
1745138666543,TDHT 109,A01,890302,Anderson; Mysia Anyse,31,0,40,9
1745138667568,TDMV 1,A00,890293,Arcidiacono; Kristin,20,0,30,10
1745138668595,TDMV 2,A00,890294,Weinberg; Sadie,26,0,30,4
1745138669624,TDMV 3,A00,957878,Arcidiacono; Kristin,27,0,30,3
1745138671674,TDMV 138,A00,890304,Jun; Grace Shin Hae,25,0,40,15
1745138672700,TDMV 140,A00,890305,Corrales; Joseph Bernales,28,0,30,2
1745138673731,TDMV 142,A00,890307,Caligagan; Tony,30,0,40,10
1745138674764,TDMV 144,A00,890308,Camaya; Michelle Ann,26,0,30,4
1745138675789,TDPW 1,A00,890295,Stein; Deborah Isobel,5,0,20,15
1745138676817,USP 2,A01,890272,Lerner; Amy M,8,0,20,12
1745138677844,USP 3,A01,890274,Staff,21,0,30,9
1745138678875,USP 15,A01,890276,Sun; Feiyang,21,0,30,9
1745138679901,USP 25,A00,890277,Shenkman; Michael Thomas,21,0,25,4
1745138680928,USP 138,A00,890278,Staff,15,0,25,10
1745138681970,USP 143,A00,890279,Staff,30,0,70,40
1745138682998,USP 144,A00,890280,Chowdhury; Muhammed Zohir,19,0,30,11
1745138684027,USP 150,A00,890281,Boomhower; Matthew Charles,19,0,30,11
1745138685055,USP 151,A00,890282,Staff,17,0,20,3
1745138686080,USP 162,A00,890283,Andrews; Abigail Leslie,17,0,20,3
1745138687107,USP 168,A00,920477,Kwak; Nancy,2,0,5,3
1745138688137,USP 181,A00,890284,Staff,11,0,20,9
1745138689166,USP 191A,A00,890285,Staff,15,0,20,5
1745138690194,VIS 101,A00,886512,Staff,37,0,75,38
1745138691224,VIS 103,A00,886513,Cruz; Edwin Teddy,65,0,75,10
1745138692250,VIS 108,A00,886514,Staff,7,0,15,8
1745138693278,VIS 127P,A00,886515,Shen; Kuiyi,92,0,146,54
1745138694309,VIS 149,A00,886516,Yoldas; Pinar,1,0,15,14
1745138695339,VIS 164,A00,886526,Erdmann; Dean,21,0,22,1
1745138696366,VIS 194S,A00,886527,Staff,61,0,75,14
1745138697392,WCWP 10A,C00,886484,Staff,13,0,15,2
1745138698451,WCWP 10B,A00,886490,Staff,5,0,15,10
1745138698451,WCWP 10B,B00,886491,Staff,0,1,0,0
1745138698451,WCWP 10B,C00,886492,Staff,10,0,15,5
1745138699481,WCWP 100,A00,886494,Staff,0,2,15,15
1745138701604,AAS 10,A01,886199,Childs; Dennis R.,0,2,0,0
1745138702634,ANAR 104,A01,886940,Shtienberg; Gilad,27,0,30,3
1745138703664,ANAR 120,A00,886953,Staff,13,0,20,7
1745138704692,ANBI 148,A01,886955,Wilder; Linnea Lorene,32,0,40,8
1745138706745,ANSC 122,A00,886957,Staff,28,0,30,2
1745138707772,ANSC 150,A00,886958,Sloane; Julia Kathryn,6,0,15,9
1745138708803,ANSC 156,A00,886959,Jenkins; Janis A.,2,0,15,13
1745138709828,ANSC 180,A00,886960,Staff,12,0,17,5
1745138710861,ANSC 188,A00,886961,Jassal; Aftab,10,0,25,15
1745138711887,ANSC 190,A00,886962,Jassal; Aftab,14,0,25,11
1745138712917,ANSC 191,A00,886963,Staff,18,0,20,2
1745138713949,ANTH 3,A01,891689,Staff,19,0,20,1
1745138714975,ANTH 5,A00,886933,Semendeferi; Ekaterini,18,0,20,2
1745138716005,ANTH 10,A00,886934,Staff,0,8,30,30
1745138717032,ANTH 21,A01,886936,Staff,44,0,60,16
1745138718056,ANTH 23,A01,886938,Staff,94,0,100,6
1745138719085,ANTH 105,A00,886964,Stewart; Alexander B,94,0,100,6
1745138720114,ANTH 108,A00,886965,Pedersen; David,10,0,20,10
1745138721152,AWP 10,001,886147,Staff,0,0,0,0
1745138721152,AWP 10,002,886148,Staff,0,0,0,0
1745138721152,AWP 10,003,886149,Staff,0,0,0,0
1745138721152,AWP 10,004,886150,Staff,0,0,0,0
1745138721152,AWP 10,005,886151,Staff,0,0,0,0
1745138721152,AWP 10,006,886152,Staff,0,0,0,0
1745138721152,AWP 10,007,886153,Staff,0,0,0,0
1745138721152,AWP 10,008,886154,Staff,0,0,0,0
1745138721152,AWP 10,009,886155,Staff,0,0,0,0
1745138721152,AWP 10,010,886156,Staff,0,0,0,0
1745138721152,AWP 10,011,886158,Staff,0,0,0,0
1745138721152,AWP 10,012,886160,Staff,0,0,0,0
1745138721152,AWP 10,013,886161,Staff,0,0,0,0
1745138721152,AWP 10,014,886162,Staff,0,0,0,0
1745138721152,AWP 10,015,886163,Staff,0,0,0,0
1745138721152,AWP 10,016,886164,Staff,0,0,0,0
1745138721152,AWP 10,017,886165,Staff,0,0,0,0
1745138721152,AWP 10,018,886166,Staff,0,0,0,0
1745138721152,AWP 10,019,886168,Staff,0,0,0,0
1745138721152,AWP 10,020,886170,Staff,0,0,0,0
1745138721152,AWP 10,021,886172,Staff,0,0,0,0
1745138722188,AWP 10R,001,886173,Staff,0,0,0,0
1745138722188,AWP 10R,002,886174,Staff,0,1,0,0
1745138722188,AWP 10R,003,886175,Staff,0,0,0,0
1745138722188,AWP 10R,004,886176,Staff,0,0,0,0
1745138722188,AWP 10R,005,886177,Staff,0,0,0,0
1745138722188,AWP 10R,006,886178,Staff,0,0,0,0
1745138722188,AWP 10R,007,886179,Staff,0,0,0,0
1745138722188,AWP 10R,008,886181,Staff,0,0,0,0
1745138722188,AWP 10R,009,886182,Staff,0,0,0,0
1745138722188,AWP 10R,010,886183,Staff,0,0,0,0
1745138722188,AWP 10R,011,886184,Staff,0,0,0,0
1745138722188,AWP 10R,012,886185,Staff,0,0,0,0
1745138722188,AWP 10R,013,886186,Staff,0,0,0,0
1745138722188,AWP 10R,014,886187,Staff,0,0,0,0
1745138722188,AWP 10R,015,886188,Staff,0,0,0,0
1745138722188,AWP 10R,016,886189,Staff,0,0,0,0
1745138723215,AWP 102R,A00,886190,Staff,0,0,0,0
1745138723215,AWP 102R,B00,886191,Staff,0,0,0,0
1745138724246,BENG 100,A01,886193,Staff,19,0,30,11
1745138725276,BENG 122A,A01,886195,Hasty; Jeff M,20,0,30,10
1745138726302,BENG 166A,A00,886196,Sah; Robert Lie-Yuan,0,3,20,20
1745138727330,BIBC 102,A01,894320,Staff,0,2,46,46
1745138727330,BIBC 102,A02,894321,Staff,0,0,46,46
1745138727330,BIBC 102,A03,894344,Staff,21,0,46,25
1745138727330,BIBC 102,A04,894345,Staff,30,0,47,17
1745138728366,BICD 100R,A01,894365,Smith; Laurie,1,3,58,57
1745138728366,BICD 100R,A02,894366,Smith; Laurie,0,1,58,58
1745138728366,BICD 100R,A03,894367,Smith; Laurie,13,0,59,46
1745138729401,BICD 136,A01,894383,Gustafson-Brown; Cindy,16,0,50,34
1745138730439,BIEB 102,A01,894494,Butler; Shannon Rhey,67,0,130,63
1745138732502,BIEB 150,A01,894617,Wills; Christopher,0,3,13,13
1745138732502,BIEB 150,A02,894631,Wills; Christopher,0,3,13,13
1745138732502,BIEB 150,A03,894937,Wills; Christopher,0,3,13,13
1745138732502,BIEB 150,A04,894946,Wills; Christopher,0,1,11,11
1745138733530,BIEB 194,A00,906141,Kurle; Carolyn M.,14,0,20,6
1745138734559,BILD 1,A01,894154,Staff,8,0,19,11
1745138734559,BILD 1,A02,894155,Staff,15,0,19,4
1745138734559,BILD 1,A03,894160,Staff,18,0,19,1
1745138734559,BILD 1,A04,894161,Staff,16,0,18,2
1745138735585,BILD 2,A01,894168,Staff,0,0,50,50
1745138735585,BILD 2,A02,894169,Staff,0,0,50,50
1745138735585,BILD 2,A03,894179,Staff,27,0,50,23
1745138735585,BILD 2,A04,894203,Staff,42,0,50,8
1745138736612,BILD 3,A01,894213,Staff,24,0,31,7
1745138736612,BILD 3,A02,894214,Staff,28,0,31,3
1745138736612,BILD 3,A03,894235,Staff,30,0,31,1
1745138736612,BILD 3,A04,894236,Staff,29,0,32,3
1745138737640,BILD 4,A01,894253,Reuther; Keefe,12,0,24,12
1745138737640,BILD 4,A02,894258,Reuther; Keefe,19,0,24,5
1745138738682,BILD 5,A01,894276,Reuther; Keefe,40,0,50,10
1745138738682,BILD 5,A02,894277,Reuther; Keefe,48,0,50,2
1745138738682,BILD 5,A03,894290,Reuther; Keefe,47,0,50,3
1745138738682,BILD 5,A04,894291,Reuther; Keefe,50,0,50,0
1745138739711,BILD 24,A01,894297,Pirino; Giorgia,46,0,60,14
1745138740739,BIMM 100,A01,895012,Staff,0,14,0,1
1745138740739,BIMM 100,A02,895013,Staff,0,6,0,2
1745138740739,BIMM 100,A03,895014,Staff,0,7,0,0
1745138740739,BIMM 100,A04,895015,Staff,0,4,0,0
1745138741767,BIMM 101,A01,895017,McDonnell; Lisa Marie,0,2,24,24
1745138741767,BIMM 101,A02,895018,McDonnell; Lisa Marie,0,1,24,24
1745138741767,BIMM 101,B01,895020,McDonnell; Lisa Marie,0,3,24,24
1745138741767,BIMM 101,B02,895021,McDonnell; Lisa Marie,0,2,24,24
1745138742795,BIMM 110,A01,895023,Staff,7,0,25,18
1745138742795,BIMM 110,A02,895024,Staff,11,0,25,14
1745138742795,BIMM 110,A03,895025,Staff,22,0,25,3
1745138742795,BIMM 110,A04,895031,Staff,21,0,25,4
1745138743848,BIMM 120,A01,895114,Gustafson-Brown; Cindy,8,0,28,20
1745138743848,BIMM 120,A02,895126,Gustafson-Brown; Cindy,19,0,27,8
1745138744877,BIPN 100,A01,895130,Yang; Mingyu,13,0,38,25
1745138744877,BIPN 100,A02,895131,Yang; Mingyu,33,0,38,5
1745138744877,BIPN 100,A03,895132,Yang; Mingyu,33,0,38,5
1745138744877,BIPN 100,A04,895133,Yang; Mingyu,30,0,36,6
1745138745904,BIPN 120,A01,895135,Cooke; James Edward,0,3,13,13
1745138745904,BIPN 120,A02,895136,Cooke; James Edward,0,1,13,13
1745138745904,BIPN 120,A03,895137,Cooke; James Edward,0,0,13,13
1745138745904,BIPN 120,A04,895156,Cooke; James Edward,4,0,11,7
1745138746933,BIPN 134,A01,895235,Cooke; James Edward,0,3,25,25
1745138746933,BIPN 134,A02,895237,Cooke; James Edward,0,0,25,25
1745138746933,BIPN 134,A03,895240,Cooke; James Edward,13,0,25,12
1745138746933,BIPN 134,A04,895270,Cooke; James Edward,24,0,25,1
1745138747959,BIPN 189,A00,892103,Staff,0,20,9,9
1745138755987,CAT 124,A01,922009,Staff,0,1,20,20
1745138757832,CAT 125R,A00,886390,Morales; Celeste Georgianna,4,0,20,16
1745138757832,CAT 125R,B00,886391,Irwin; Matthew Joseph,0,1,20,20
1745138757832,CAT 125R,C00,886392,Smith; Lauryn Alissa,11,0,20,9
1745138757832,CAT 125R,D00,886393,Vanderschuit; Maya Alysia,6,0,20,14
1745138757832,CAT 125R,E00,886394,Marchisotto; Jennifer Anne,0,2,20,20
1745138758885,CENG 15,A01,886218,Drews; Aaron,1,0,5,4
1745138759935,CENG 113,A00,886219,Opatkiewicz; Justin Paul,16,0,25,9
1745138760963,CGS 101,A00,887044,Staff,13,0,20,7
1745138761990,CGS 105,A01,887046,Staff,16,0,25,9
1745138763037,CGS 112,A00,887047,Cuong; Marisol,12,0,15,3
1745138764063,CGS 113,A00,887048,Staff,24,0,30,6
1745138765090,CGS 120,A00,887049,Staff,12,0,17,5
1745138766118,CHEM 6A,A01,886336,Lam; Tin Yiu,44,0,50,6
1745138766118,CHEM 6A,A02,886338,Lam; Tin Yiu,43,0,50,7
1745138767146,CHEM 6B,A01,886341,Hopkins; Patrycja Anna,21,0,50,29
1745138767146,CHEM 6B,A02,886343,Hopkins; Patrycja Anna,46,0,50,4
1745138768175,CHEM 6C,A01,886346,Albizati; Kim F.,0,1,50,50
1745138768175,CHEM 6C,A02,886348,Albizati; Kim F.,38,0,50,12
1745138769203,CHEM 40A,A01,886352,Klosterman; Jeremy K,70,0,100,30
1745138770228,CHEM 40B,A01,886356,Klosterman; Jeremy K,0,4,100,100
1745138771255,CHEM 41B,A01,886360,Theodorakis; Emmanuel,30,0,50,20
1745138771255,CHEM 41B,A02,886362,Theodorakis; Emmanuel,46,0,50,4
1745138772282,CHIN 165A,A00,886382,Xu; Li,19,0,20,1
1745138773326,CLAS 120,A00,886387,Myerston Santana; Jacobo,36,0,40,4
1745138774355,COGS 9,A01,886967,Shannon; Kyle Michael,49,0,60,11
1745138775395,COGS 11,A01,886969,Staff,18,0,30,12
1745138776429,COGS 14A,A01,886971,Staff,26,0,60,34
1745138777472,COGS 14B,A01,886973,Hoffman; Drew Ellen,18,0,60,42
1745138778497,COGS 18,A01,886975,Morgan; Eric,41,0,60,19
1745138779531,COGS 20,A01,886977,Staff,6,0,8,2
1745138779531,COGS 20,A02,886978,Staff,6,0,7,1
1745138780559,COGS 100,A01,907783,Staff,6,0,30,24
1745138781585,COGS 101B,A01,886980,Staff,0,10,30,30
1745138782613,COGS 101C,A01,886982,Delgado; Tania,0,6,30,30
1745138783639,COGS 102A,A01,886984,Johnson; Christine M.,13,0,30,17
1745138784678,COGS 118B,A01,886986,Staff,0,25,60,60
1745138785706,COGS 150,A01,886988,Bergen; Benjamin,16,0,30,14
1745138786746,COGS 153,A00,886989,Delgado; Tania,0,6,30,30
1745138797821,COGS 186,A01,886991,Staff,3,0,30,27
1745138798848,COGS 187A,A01,886993,Boyle; Mary E. T.,12,0,30,18
1745138799874,COGS 189,A00,886994,Staff,13,0,30,17
1745138800912,COMM 10,A01,886996,Staff,11,0,25,14
1745138800912,COMM 10,A02,886997,Staff,21,0,25,4
1745138801957,COMM 20,A01,886999,Leuning; Grant Maurstad,33,0,40,7
1745138804016,COMM 100A,A01,887002,Staff,0,0,25,25
1745138804016,COMM 100A,A02,887003,Staff,20,0,25,5
1745138805043,COMM 100B,A01,887005,Staff,0,1,25,25
1745138806079,COMM 106D,A00,887006,Staff,22,0,40,18
1745138807107,COMM 110G,A00,887007,Whitworth-Smith; Andrew C,17,0,40,23
1745138808138,COMM 111B,A00,887008,Staff,31,0,40,9
1745138809179,COMM 113T,A00,887009,Abuelhiga; Soraya Jill,30,0,40,10
1745138809179,COMM 113T,B00,906733,Staff,40,0,40,0
1745138810205,COMM 145,A00,887010,Staff,21,0,40,19
1745138811231,COMM 146,A00,887054,Staff,31,0,40,9
1745138812256,COMM 190,A00,887012,Staff,9,0,23,14
1745138813310,CSE 8A,A50,887015,Cao; Yingjun,68,0,85,17
1745138814340,CSE 11,A01,887017,Cao; Yingjun,35,0,70,35
1745138815381,CSE 20,A01,887019,Staff,35,0,50,15
1745138816411,CSE 21,A01,887021,Braun; Oliver,81,0,100,19
1745138816411,CSE 21,B01,892583,Staff,48,0,50,2
1745138817439,CSE 30,A01,887025,Eldon; John,161,0,200,39
1745138818467,CSE 100,A01,887027,Staff,28,0,50,22
1745138818467,CSE 100,A02,887028,Staff,43,0,50,7
1745138819494,CSE 101,A01,887030,Braun; Oliver,79,0,100,21
1745138819494,CSE 101,B01,887032,Jones; Miles E,0,1,50,50
1745138819494,CSE 101,B02,887033,Jones; Miles E,13,0,50,37
1745138820522,CSE 105,A01,908084,Jones; Miles E,36,0,50,14
1745138820522,CSE 105,A02,908087,Jones; Miles E,38,0,50,12
1745138821550,CSE 135,A01,887035,Powell; Thomas Allan,8,0,50,42
1745138822587,CSE 142,A01,887037,Staff,22,0,60,38
1745138823619,CSE 142L,A01,887039,Staff,42,0,60,18
1745138824647,CSE 151A,A01,887041,Solares; Edwin A,60,0,100,40
1745138825676,CSE 175,A01,887043,Kumar; Rakesh,30,0,30,0
1745138826713,CSS 1,A01,886389,Staff,12,0,40,28
1745138827757,DSC 30,A01,908097,Liao; Soohyun Nam,54,0,75,21
1745138828798,DSC 40A,A01,908099,Shannon; Kyle Michael,37,0,50,13
1745138829835,DSC 40B,A01,908112,Staff,28,0,50,22
1745138830862,DSC 80,A01,908116,Staff,32,0,60,28
1745138831889,DSC 197,001,956863,Eldridge; Justin Matthew,9999,0,9999,0
1745138832918,ECE 5,A01,886400,Morris; Karcher William,3,0,6,3
1745138832918,ECE 5,A02,886401,Morris; Karcher William,5,0,6,1
1745138833945,ECE 148,A01,886403,Silberman; Jack,0,8,14,14
1745138834971,ECON 1,A01,887265,Crane; Meredith Helen,25,0,70,45
1745138834971,ECON 1,B01,887268,Staff,44,0,50,6
1745138835998,ECON 2,A01,887273,Crane; Meredith Helen,61,0,70,9
1745138837026,ECON 3,A01,887279,Rondina; Giacomo,44,0,70,26
1745138838054,ECON 4,A01,887282,Anderson; John Charles,0,1,10,10
1745138847843,ECON 5,A01,887285,Staff,39,0,45,6
1745138847843,ECON 5,B01,887292,Staff,43,0,45,2
1745138848874,ECON 100A,A01,887337,Newhouse; Herbert S,58,0,70,12
1745138848874,ECON 100A,B01,887349,Staff,45,0,50,5
1745138849909,ECON 100B,A01,887361,Du; Songzi,42,0,70,28
1745138850935,ECON 100C,A01,887445,Newhouse; Herbert S,61,0,70,9
1745138851963,ECON 105,A00,887488,Vespa; Emanuel Ignacio,24,0,35,11
1745138852988,ECON 109,A01,887506,Staff,29,0,35,6
1745138854043,ECON 110A,A01,887568,Alon; Titan Michael,1,0,35,34
1745138854043,ECON 110A,B01,907601,Alon; Titan Michael,27,0,35,8
1745138855091,ECON 110B,A01,887598,Levkoff; Steven B.,0,7,70,70
1745138856115,ECON 112,A00,887599,Rondina; Giacomo,20,0,35,15
1745138857145,ECON 120A,A01,887603,Dai; Yinlin,46,0,70,24
1745138858193,ECON 120C,A01,887608,Sun; Yixiao,0,0,35,35
1745138858193,ECON 120C,B01,887614,Sun; Yixiao,13,0,35,22
1745138859220,ECON 138,A00,887621,Bharadwaj; Prashant,0,18,20,20
1745138860259,ECON 171,A01,907666,Staff,27,0,35,8
1745138861305,ECON 175,A00,887626,Wu; Pak Yeung,27,0,35,8
1745138862340,ECON 190,A00,887640,Vespa; Emanuel Ignacio,26,0,35,9
1745138863373,EDS 25,A01,888197,Staff,0,0,0,0
1745138863373,EDS 25,A02,888209,Staff,0,0,0,0
1745138863373,EDS 25,A03,888210,Staff,0,0,0,0
1745138863373,EDS 25,A04,888212,Staff,0,0,0,0
1745138863373,EDS 25,A05,888213,Staff,0,0,0,0
1745138863373,EDS 25,A06,888214,Staff,0,0,0,0
1745138863373,EDS 25,A07,888235,Staff,0,0,0,0
1745138863373,EDS 25,A08,888236,Staff,0,0,0,0
1745138863373,EDS 25,A09,888240,Staff,0,0,0,0
1745138863373,EDS 25,A10,888244,Staff,0,0,0,0
1745138863373,EDS 25,B01,888273,Staff,0,0,0,0
1745138863373,EDS 25,B02,888285,Staff,0,0,0,0
1745138863373,EDS 25,B03,888423,Staff,29,0,30,1
1745138863373,EDS 25,B04,888432,Staff,0,0,0,0
1745138863373,EDS 25,B05,888433,Staff,0,0,0,0
1745138863373,EDS 25,B06,888467,Staff,0,0,0,0
1745138863373,EDS 25,B07,888468,Staff,0,0,0,0
1745138863373,EDS 25,B08,888479,Staff,0,0,0,0
1745138863373,EDS 25,B09,888484,Staff,0,0,0,0
1745138863373,EDS 25,B10,888487,Staff,0,0,0,0
1745138864403,EDS 38,A01,907700,Choi; Bailey Miyeon,30,0,30,0
1745138865430,EDS 112,A01,888601,Chapman; Thandeka K,23,0,40,17
1745138866468,EDS 115,A00,888697,Mendez; Kathrina Mendoza,17,0,30,13
1745138867507,EDS 116,A01,888893,Staff,38,0,40,2
1745138869572,EDS 124AR,A00,889133,Staff,33,0,50,17
1745138869572,EDS 124AR,B00,907471,Simon; Elizabeth A,42,0,50,8
1745138870597,EDS 124BR,A00,889134,Staff,57,0,100,43
1745138871631,EDS 125,A00,889135,Staff,26,0,30,4
1745138872667,EDS 126,A01,889138,Staff,37,0,40,3
1745138873693,EDS 164R,A01,889142,Wishard Guerra; Alison G.,38,0,50,12
1745138874721,ENG 30,A01,886396,Staff,0,0,0,0
1745138874721,ENG 30,B01,886398,Staff,0,0,0,0
1745138876305,ENVR 102,A00,906150,Montejo; Carolina,23,0,25,2
1745138877336,ETHN 103A,A00,887236,Man; Simeon S,0,5,0,0
1745138878362,ETHN 113,A00,887239,Staff,20,0,30,10
1745138879387,ETHN 116,A00,887240,Staff,20,0,25,5
1745138880431,ETHN 117,A00,887241,Choi; Esther Min,27,0,30,3
1745138881467,ETHN 118,A00,887243,Staff,24,0,30,6
1745138882495,ETHN 127,A00,887248,Cuong; Marisol,12,0,15,3
1745138883533,ETHN 139,A00,887250,Staff,8,0,10,2
1745138884567,ETHN 142,A00,887252,Staff,18,0,30,12
1745138885595,ETHN 161,A00,887253,Browne; Errol Tsekani,28,0,30,2
1745138886641,ETHN 163FR,A00,887255,Burelle; Julie Sara Veronique,4,0,5,1
1745138887699,GLBH 20,A00,889149,Elwardani; Nile Regina,15,0,42,27
1745138889754,GLBH 111,A01,889152,Burgos; Jose L.,17,0,17,0
1745138890782,GLBH 150,A00,889181,Sloane; Julia Kathryn,0,1,15,15
1745138892836,HDS 60,A01,886406,Warstadt; Melissa Fawn,76,0,80,4
1745138893865,HIAF 111,A00,889324,Gyamfi; Bright,0,4,0,0
1745138894900,HIEA 131,A00,889328,Staff,14,0,32,18
1745138895926,HIEA 144,A00,889333,Henry; Todd A.,29,0,32,3
1745138896954,HIEA 154,A00,889336,Henry; Todd A.,28,0,32,4
1745138897980,HIEU 106,A00,889339,Staff,28,0,32,4
1745138900245,HIEU 114,A00,889340,Staff,18,0,32,14
1745138901281,HIEU 135GS,A00,889342,Patterson; Patrick H.,0,0,1,22
1745138902308,HIEU 137,A00,889343,Edington; Claire Ellen,12,0,25,13
1745138903338,HIEU 148,A00,889345,Staff,16,0,32,16
1745138904364,HIEU 154,A00,889346,Biess; Frank Peter,24,0,32,8
1745138905394,HILA 102,A00,889351,Staff,13,0,32,19
1745138906421,HILD 2A,A01,889221,Lewandoski; Julia Mavis,0,5,32,32
1745138907447,HILD 7B,A01,889225,Man; Simeon S,0,7,32,32
1745138908481,HILD 7C,A01,889288,Alvarez; Luis A,0,8,32,32
1745138909509,HILD 30,A01,889323,Staff,0,1,32,32
1745138911568,HISC 119,A00,889383,Golan; Tal,22,0,32,10
1745138912598,HIUS 103,A00,889384,Man; Simeon S,10,0,32,22
1745138913628,HIUS 117,A00,919797,Kwak; Nancy,23,0,32,9
1745138914674,HIUS 142A,A00,919788,Staff,24,0,32,8
1745138916729,HIUS 149,A00,889386,Gyamfi; Bright,0,1,0,0
1745138917759,HIUS 155,A00,889387,Alvarez; Luis A,19,0,32,13
1745138918808,HUM 3,A01,886499,Caldwell; Michael Alan,24,0,50,26
1745138919838,HUM 3GS,A00,886500,Rodriguez; Bretton Sigfred,0,0,0,26
1745138920865,HUM 3R,A01,886502,Markman; Kristina,0,32,50,50
1745138921893,HUM 4,A01,886504,Crum; Matthew Stephen,28,0,50,22
1745138921893,HUM 4,B01,886506,West; Geoffrey Scott,25,0,50,25
1745138922922,HUM 4GS,A00,886507,Staff,0,0,0,13
1745138923953,HUM 5,A01,886509,Staff,35,0,50,15
1745138924984,HUM 5R,A01,886511,Zavodny; Tatiana Sophia,0,32,50,50
1745138926010,JAPN 180,A00,886407,Staff,25,0,40,15
1745138927043,LATI 50,A01,886409,Martin-Cabrera; Luis,9,0,22,13
1745138927043,LATI 50,A02,886410,Martin-Cabrera; Luis,20,0,22,2
1745138927043,LATI 50,A03,886411,Martin-Cabrera; Luis,22,0,22,0
1745138927043,LATI 50,A04,886412,Martin-Cabrera; Luis,15,0,22,7
1745138928068,LAWS 101,A00,907664,Staff,36,0,60,24
1745138929094,LIAB 1A,A00,889388,Saab; Dima,19,0,20,1
1745138930123,LIAB 1AX,A00,889389,El Cheddadi; Youniss,19,0,20,1
1745138931149,LIFR 1C,A00,889391,Van Moer; Vinciane G,9,0,20,11
1745138932189,LIFR 1CX,A00,889392,Van Moer; Vinciane G,8,0,20,12
1745138933225,LIFR 1D,A00,889393,Van Moer; Vinciane G,11,0,20,9
1745138934252,LIFR 1DX,A00,889394,Van Moer; Vinciane G,11,0,20,9
1745138935295,LIGN 7,A00,886923,Staff,30,0,50,20
1745138936322,LIGN 17,A00,886924,Kehler; Andrew Scott,133,0,150,17
1745138937358,LTAM 110,A00,889395,Staff,17,0,30,13
1745138938394,LTCH 101,A00,889397,Staff,22,0,25,3
1745138939430,LTCS 130,A00,889398,Staff,23,0,25,2
1745138940456,LTEA 138,A00,889399,Staff,25,0,40,15
1745138941483,LTEN 149,A00,889400,Wesling; Megan E.,6,0,25,19
1745138942509,LTEN 169,A00,889401,Staff,24,0,25,1
1745138943535,LTEN 180,A00,889402,Staff,12,0,15,3
1745138944568,LTEN 181,A00,889403,Staff,23,0,25,2
1745138945596,LTWL 100,A00,889404,Myerston Santana; Jacobo,8,0,25,17
1745138946631,LTWL 180GS,A00,889405,Staff,6,0,20,14
1745138947656,LTWL 181,A00,889406,Staff,19,0,25,6
1745138957931,LTWL 184,A00,889475,Mukherjee; Silpa,21,0,25,4
1745138958957,LTWR 102C,A00,889486,Staff,29,0,30,1
1745138959996,LTWR 115W,A00,889491,Staff,3,0,15,12
1745138961021,MAE 8,A01,886905,Staff,0,2,0,0
1745138962067,MAE 11,A00,886906,Bandaru; Prabhakar,0,0,50,50
1745138963095,MAE 20,A00,886907,Evdokimenko; Ekaterina,50,0,70,20
1745138964121,MAE 30B,A00,886909,Ghazinejad; Maziar,28,0,45,17
1745138965149,MAE 101B,A00,886910,Saintillan; David,36,0,45,9
1745138966175,MAE 105,A00,886911,Bandaru; Prabhakar,26,0,50,24
1745138967199,MAE 107,A00,886912,Staff,22,0,60,38
1745138968225,MAE 143B,A00,886913,Bewley; Thomas R,14,0,40,26
1745138969252,MAE 148,A01,886915,Silberman; Jack,5,0,14,9
1745138970277,MAE 160,A00,886916,Evdokimenko; Ekaterina,41,0,60,19
1745138971305,MATH 3C,A01,889681,Staff,2,0,30,28
1745138972332,MATH 10A,A01,889760,Staff,28,0,30,2
1745138972332,MATH 10A,A02,889783,Staff,30,0,30,0
1745138973363,MATH 10B,A01,889785,Verstraete; Jacques Allan,0,2,30,30
1745138973363,MATH 10B,A02,889795,Verstraete; Jacques Allan,0,2,30,30
1745138973363,MATH 10B,B01,889797,Verstraete; Jacques Allan,1,0,30,29
1745138973363,MATH 10B,B02,889828,Verstraete; Jacques Allan,23,0,30,7
1745138974394,MATH 10C,A01,889849,Habib; Yousaf,18,0,30,12
1745138974394,MATH 10C,A02,889852,Habib; Yousaf,20,0,30,10
1745138974394,MATH 10C,A03,889853,Habib; Yousaf,25,0,30,5
1745138974394,MATH 10C,A04,889858,Habib; Yousaf,21,0,30,9
1745138974394,MATH 10C,B01,889861,Staff,12,0,30,18
1745138974394,MATH 10C,B02,889862,Staff,26,0,30,4
1745138974394,MATH 10C,B03,889863,Staff,28,0,30,2
1745138974394,MATH 10C,B04,889967,Staff,25,0,30,5
1745138975438,MATH 18,A01,889974,Staff,15,0,30,15
1745138975438,MATH 18,A02,889977,Staff,25,0,30,5
1745138975438,MATH 18,B01,889984,Hardiman; Liam,26,0,30,4
1745138975438,MATH 18,B02,889985,Hardiman; Liam,28,0,30,2
1745138976479,MATH 20A,A01,889990,Suk; Andrew Hoon,31,0,35,4
1745138977505,MATH 20B,A01,889993,Ohm; Ko Woon,21,0,30,9
1745138977505,MATH 20B,A02,889994,Ohm; Ko Woon,30,0,30,0
1745138977505,MATH 20B,B01,889996,Ohm; Ko Woon,25,0,30,5
1745138977505,MATH 20B,B02,889997,Ohm; Ko Woon,24,0,30,6
1745138978534,MATH 20C,A01,889999,Hammock; Frances H,22,0,30,8
1745138978534,MATH 20C,A02,890003,Hammock; Frances H,23,0,30,7
1745138978534,MATH 20C,B01,890006,Hammock; Frances H,11,0,30,19
1745138978534,MATH 20C,B02,890007,Hammock; Frances H,18,0,30,12
1745138979577,MATH 20D,A01,890011,Cheng; Hsiao-Bing,6,0,30,24
1745138979577,MATH 20D,A02,890012,Cheng; Hsiao-Bing,27,0,30,3
1745138979577,MATH 20D,B01,890016,Cheng; Hsiao-Bing,19,0,30,11
1745138979577,MATH 20D,B02,890017,Cheng; Hsiao-Bing,15,0,30,15
1745138980624,MATH 20E,A01,890026,Harel; Guershon,10,0,30,20
1745138980624,MATH 20E,A02,890029,Harel; Guershon,24,0,30,6
1745138980624,MATH 20E,B01,890033,Harel; Guershon,14,0,30,16
1745138980624,MATH 20E,B02,890101,Harel; Guershon,27,0,30,3
1745138981652,MATH 102,A01,890104,Staff,20,0,30,10
1745138981652,MATH 102,A02,890105,Staff,30,0,30,0
1745138982693,MATH 103B,A01,890116,Salehi Golsefidy; Alireza,8,0,30,22
1745138982693,MATH 103B,B01,890118,Staff,0,4,30,30
1745138983722,MATH 109,A01,890121,Aliabadi Sr.; Mohsen,6,0,30,24
1745138983722,MATH 109,B01,890124,Upadrashta; Pranav Kumar,23,0,30,7
1745138984761,MATH 120A,A01,890126,Eggers; John Dietrich,15,0,30,15
1745138985787,MATH 142B,A01,890128,Ioana; Adrian,17,0,30,13
1745138985787,MATH 142B,A02,890129,Ioana; Adrian,15,0,30,15
1745138986823,MATH 154,A01,890174,Staff,0,1,30,30
1745138986823,MATH 154,A02,890182,Staff,15,0,30,15
1745138987850,MATH 168A,A01,890197,Dumitriu; Ioana,22,0,35,13
1745138988878,MATH 170A,A01,890240,Nie; Jiawang,6,0,30,24
1745138988878,MATH 170A,A02,890241,Nie; Jiawang,18,0,30,12
1745138988878,MATH 170A,A03,890249,Nie; Jiawang,23,0,30,7
1745138989918,MATH 170B,A01,957891,Nag; Panchali,25,0,35,10
1745138991977,MATH 181A,A01,908025,Staff,0,8,35,35
1745138993003,MATH 193B,A01,890265,Staff,3,0,35,32
1745138994029,MGT 4,A01,890311,Anderson; John Charles,57,0,88,31
1745138995085,MGT 5,A00,907740,Staff,41,0,98,57
1745138996111,MGT 12,A00,890312,Lindenberger; Wade Douglas,70,0,98,28
1745138997145,MGT 16,A00,957883,Staff,84,0,98,14
1745139007969,MGT 45,A00,890314,Pecore; Joseph P.,57,0,98,41
1745139009003,MGT 71,A00,890315,Staff,6,0,98,92
1745139010031,MGT 100,A00,890316,Yavorsky; Daniel Ryan,59,0,98,39
1745139011073,MGT 103,A00,890317,Ehrich; Kristine R,77,0,98,21
1745139012099,MGT 105,A00,890356,Bates; Kenneth Walter,19,0,98,79
1745139013128,MGT 112,A00,890360,Ehrich; Kristine R,65,0,98,33
1745139014157,MGT 127R,A00,907732,Zhu; Kevin Xiaoguo,32,0,98,66
1745139015186,MGT 131B,A00,890361,Anderson; John Charles,75,0,98,23
1745139016225,MGT 137,A00,890362,Lindenberger; Wade Douglas,68,0,98,30
1745139017254,MGT 160,A00,890369,Johnson; Erik Barry,37,0,98,61
1745139019307,MGT 164,A00,890372,Zimmermann; Carsten,0,28,98,98
1745139020346,MGT 180,A00,890374,Bliss; Barbara Ann,32,0,98,66
1745139021376,MMW 15,A01,886414,Chang; Edmond Yi-Teh,0,10,28,28
1745139021376,MMW 15,A02,886415,Chang; Edmond Yi-Teh,0,10,28,28
1745139021376,MMW 15,A03,886416,Chang; Edmond Yi-Teh,0,8,28,28
1745139021376,MMW 15,A04,886417,Chang; Edmond Yi-Teh,0,8,28,28
1745139021376,MMW 15,B01,886419,Chang; Edmond Yi-Teh,0,8,28,28
1745139021376,MMW 15,B02,886420,Chang; Edmond Yi-Teh,0,9,28,28
1745139021376,MMW 15,B03,886421,Chang; Edmond Yi-Teh,0,9,28,28
1745139021376,MMW 15,B04,886422,Chang; Edmond Yi-Teh,0,9,28,28
1745139021376,MMW 15,C01,886424,Staff,0,10,28,28
1745139021376,MMW 15,C02,886425,Staff,0,10,28,28
1745139021376,MMW 15,C03,886426,Staff,0,9,28,28
1745139021376,MMW 15,C04,886427,Staff,0,9,28,28
1745139022403,MMW 15GS,A00,906910,Patterson; Patrick H.,5,0,28,23
1745139023440,MMW 122R,A01,886429,Rahimi; Babak,0,23,28,28
1745139023440,MMW 122R,A02,886430,Rahimi; Babak,0,23,28,28
1745139024470,MUS 1A,A01,890937,Staff,8,0,25,17
1745139024470,MUS 1A,A02,891035,Staff,15,0,25,10
1745139024470,MUS 1A,B00,907849,Staff,48,0,50,2
1745139024470,MUS 1A,B01,907850,Staff,25,0,25,0
1745139024470,MUS 1A,B02,907851,Staff,25,0,25,0
1745139026531,MUS 2AK,A00,957092,Ohnishi; Takae,15,0,15,0
1745139027559,MUS 4,A01,891044,Staff,6,0,25,19
1745139027559,MUS 4,A02,891045,Staff,24,0,25,1
1745139027559,MUS 4,B01,891048,Staff,20,0,25,5
1745139027559,MUS 4,B02,891050,Staff,25,0,25,0
1745139028591,MUS 5,A01,957506,Dubnov; Shlomo,4,0,25,21
1745139028591,MUS 5,A02,957622,Dubnov; Shlomo,21,0,25,4
1745139028591,MUS 5,A03,957623,Dubnov; Shlomo,23,0,25,2
1745139029619,MUS 6,A01,891053,Freitas Caetano; Marcelo,23,0,25,2
1745139029619,MUS 6,A02,891054,Freitas Caetano; Marcelo,23,0,25,2
1745139030646,MUS 7,A01,891081,Staff,0,0,25,25
1745139030646,MUS 7,A02,891082,Staff,15,0,25,10
1745139031673,MUS 8GS,A00,891118,Borgo; David Garcia,5,0,25,20
1745139032699,MUS 11,A01,891140,Staff,12,0,25,13
1745139032699,MUS 11,A02,891141,Staff,24,0,25,1
1745139033727,MUS 13,A01,891143,Staff,10,0,25,15
1745139033727,MUS 13,A02,891144,Staff,25,0,25,0
1745139034755,MUS 15,A01,891146,Staff,7,0,25,18
1745139034755,MUS 15,A02,891148,Staff,22,0,25,3
1745139034755,MUS 15,B01,891150,Staff,18,0,25,7
1745139034755,MUS 15,B02,891151,Staff,25,0,25,0
1745139035790,MUS 20,A01,891153,Staff,9,0,20,11
1745139035790,MUS 20,A02,891155,Staff,16,0,20,4
1745139036826,MUS 80,A00,891156,Staff,19,0,25,6
1745139036826,MUS 80,B00,891157,Staff,25,0,25,0
1745139037852,MUS 130,A00,891158,Ohnishi; Takae,35,0,35,0
1745139038880,MUS 150GS,A01,891160,Borgo; David Garcia,5,0,25,20
1745139039920,MUS 170,A01,891162,Freitas Caetano; Marcelo,21,0,25,4
1745139039920,MUS 170,A02,891164,Freitas Caetano; Marcelo,22,0,25,3
1745139040963,NANO 11,A00,886220,Vazquez Mena; Oscar,12,0,15,3
1745139041988,NANO 15,A01,886222,Drews; Aaron,9,0,10,1
1745139043016,NANO 104,A00,886224,Sirbuly; Donald,18,0,25,7
1745139044046,PH 40,A00,886528,Staff,29,0,40,11
1745139045079,PH 45,A01,886799,Staff,36,0,40,4
1745139046106,PH 110,A00,886802,Staff,7,0,40,33
1745139047132,PH 172,A00,906716,Staff,20,0,35,15
1745139048160,PH 191,A00,886803,Staff,23,0,40,17
1745139049198,PHIL 1,A00,889500,Staff,22,0,30,8
1745139050226,PHIL 10,A01,889549,Grush; Rick Scott,17,0,22,5
1745139050226,PHIL 10,A02,889551,Grush; Rick Scott,20,0,22,2
1745139051265,PHIL 28,A01,889559,Lamey; Andy M.,0,4,25,25
1745139051265,PHIL 28,A02,889561,Lamey; Andy M.,0,0,25,25
1745139051265,PHIL 28,A03,889572,Lamey; Andy M.,7,0,25,18
1745139052304,PHIL 35,A00,907839,Staff,32,0,33,1
1745139053336,PHIL 60,A00,889574,Staff,79,0,90,11
1745139054363,PHIL 105,A00,889579,Staff,0,1,0,0
1745139055389,PHIL 136,A00,889582,Fulkerson; Matthew Todd,27,0,45,18
1745139056418,PHIL 163,A01,889601,Staff,24,0,30,6
1745139056418,PHIL 163,B01,889606,Brandt; Reuven A,0,2,0,0
1745139057449,PHIL 164,A00,889610,Staff,20,0,30,10
1745139058476,PHIL 165,A00,889613,Staff,26,0,30,4
1745139059504,PHYS 1A,A00,886431,Staff,38,0,70,32
1745139060531,PHYS 1AL,001,886432,Tsai; Philbert S,0,0,30,30
1745139060531,PHYS 1AL,002,886436,Tsai; Philbert S,19,0,30,11
1745139061558,PHYS 1B,A00,886439,Staff,192,0,240,48
1745139062585,PHYS 1BL,001,886441,Tsai; Philbert S,0,1,30,30
1745139062585,PHYS 1BL,002,886444,Tsai; Philbert S,14,0,30,16
1745139063612,PHYS 1C,A00,896092,Arnold; Kam S,87,0,146,59
1745139064712,PHYS 1CL,001,886448,Tsai; Philbert S,0,4,30,30
1745139064712,PHYS 1CL,002,886449,Tsai; Philbert S,6,0,30,24
1745139064712,PHYS 1CL,003,886450,Tsai; Philbert S,22,0,30,8
1745139064712,PHYS 1CL,004,886451,Tsai; Philbert S,16,0,30,14
1745139065750,PHYS 2B,A01,886457,Staff,86,0,115,29
1745139066776,PHYS 2C,A01,886460,Shotwell; Brian,0,0,65,65
1745139067805,PHYS 2CL,A01,886467,Staff,0,3,28,28
1745139067805,PHYS 2CL,A02,886468,Staff,5,0,28,23
1745139068834,PHYS 2D,A01,886470,Staff,17,0,50,33
1745139069869,PHYS 4B,A01,886475,Grinstein; Benjamin,88,0,100,12
1745139070898,POLI 5,A00,891173,Desposato; Scott,17,0,25,8
1745139071923,POLI 5D,A01,891175,Staff,5,0,5,0
1745139071923,POLI 5D,B01,891178,Staff,5,0,5,0
1745139072960,POLI 11,A00,891179,Ferree; Karen E,3,0,25,22
1745139073994,POLI 12,A00,891180,Staff,21,0,30,9
1745139075021,POLI 27,A01,891182,Staff,29,0,75,46
1745139076048,POLI 30,A00,891183,Staff,0,3,30,30
1745139077076,POLI 100B,A00,891244,Staff,0,8,20,20
1745139088004,POLI 100I,A00,891247,Staff,19,0,30,11
1745139089030,POLI 104J,A00,891248,Nichter; Maysa,18,0,30,12
1745139090069,POLI 104U,A00,891250,Nichter; Maysa,9,0,30,21
1745139091095,POLI 108,A00,891253,Staff,0,0,0,4
1745139092128,POLI 110B,A00,891255,Wiens; David,22,0,25,3
1745139093168,POLI 112A,A00,891256,Wiens; David,15,0,25,10
1745139094195,POLI 114BR,A00,891261,Staff,22,0,30,8
1745139095221,POLI 117R,A00,891262,Forman; Fonna,12,0,50,38
1745139096248,POLI 118,A00,891264,Ingham; Sean,22,0,25,3
1745139097286,POLI 124A,A00,891265,Staff,19,0,20,1
1745139098314,POLI 125D,A00,891266,Nichter; Simeon C,9,0,25,16
1745139099348,POLI 126,A00,891268,Nichter; Simeon C,11,0,25,14
1745139100373,POLI 126AA,A00,891272,Staff,19,0,25,6
1745139101399,POLI 130AA,A00,891273,Staff,17,0,20,3
1745139102425,POLI 134AA,A00,891274,Staff,12,0,20,8
1745139104482,POLI 138,A00,891278,Staff,22,0,25,3
1745139105511,POLI 142K,A00,891280,Staff,17,0,25,8
1745139106538,POLI 142M,A00,891281,Gartzke; Erik,22,0,30,8
1745139107602,POLI 142P,A00,891284,Staff,21,0,30,9
1745139108639,POLI 143,A00,891285,Gartzke; Erik,17,0,30,13
1745139109674,POLI 153,A00,891286,Staff,20,0,20,0
1745139110705,POLI 170A,A00,891288,Staff,19,0,25,6
1745139111730,POLI 175,A00,891290,Staff,18,0,20,2
1745139112757,PSYC 1,A00,890674,Steiner; Eric Tomas,0,4,45,45
1745139113795,PSYC 2,A00,890676,Albright; Thomas D,25,0,35,10
1745139114829,PSYC 3,A00,890679,Staff,18,0,20,2
1745139115905,PSYC 60,A01,890684,Rickard; Timothy C.,7,0,45,38
1745139116936,PSYC 70,A01,890689,Geller; Emma Harlan,14,0,30,16
1745139117971,PSYC 100,A00,890690,Lacefield; Katharine I,0,43,180,180
1745139119208,PSYC 102,A00,890695,Staff,25,0,40,15
1745139120236,PSYC 105,A00,890699,Geller; Emma Harlan,78,0,100,22
1745139121272,PSYC 106,A00,890701,Gorman; Michael R.,15,0,30,15
1745139122308,PSYC 108,A00,890704,Adrian; Julia Anna,0,23,50,50
1745139123341,PSYC 118,A01,890712,Staff,18,0,30,12
1745139124367,PSYC 124,A00,890716,Chapman; Eddie Nathaniel,36,0,60,24
1745139125403,PSYC 131,A00,890717,Anagnostaras; Stephan,6,0,80,74
1745139126431,PSYC 137,A00,890719,Winkielman; Piotr,0,2,30,30
1745139127457,PSYC 144,A00,890721,Adrian; Julia Anna,0,3,45,45
1745139128492,PSYC 162,A00,890805,Staff,21,0,75,54
1745139129517,PSYC 169,A00,890810,Staff,0,15,30,30
1745139130544,PSYC 172,A00,890814,Gorman; Michael R.,14,0,30,16
1745139131570,PSYC 181,A00,890818,Anagnostaras; Stephan,63,0,200,137
1745139132601,PSYC 189,A00,890823,Staff,11,0,30,19
1745139133627,PSYC 191,A00,890884,Rickard; Timothy C.,0,11,35,35
1745139134654,PSYC 193,A00,890913,Staff,22,0,30,8
1745139134654,PSYC 193,B00,890914,Chapman; Eddie Nathaniel,25,0,30,5
1745139135682,PSYC 193L,A01,890918,Lowe; Angela Beth,29,0,30,1
1745139135682,PSYC 193L,B01,890921,Hurwitz; Ethan Scott,28,0,30,2
1745139135682,PSYC 193L,C01,890928,Staff,30,0,30,0
1745139136707,RELI 149,A00,886806,Rahimi; Babak,23,0,40,17
1745139137734,SE 9,A01,886814,Staff,13,0,20,7
1745139138771,SE 101B,A01,886816,Chadha; Mayank,8,0,30,22
1745139139817,SE 110B,A00,886818,Zhu; Qiang,0,16,45,45
1745139140844,SE 125,A01,886830,Staff,10,0,30,20
1745139141884,SE 130B,A01,886835,Staff,19,0,40,21
1745139142911,SE 131A,A01,886838,Krysl; Petr,37,0,55,18
1745139143949,SE 154,A00,886840,Staff,35,0,50,15
1745139144984,SE 164GS,A01,886849,Staff,13,0,20,7
1745139146015,SE 167GS,A01,886853,Staff,13,0,20,7
1745139147049,SIO 25,A01,890107,Staff,23,0,30,7
1745139148075,SIO 45,A00,890109,Cook; Geoffrey W,137,0,200,63
1745139149111,SIO 109R,A00,890110,Forman; Fonna,0,11,20,20
1745139150136,SIO 187,A01,890114,Kacev; David,21,0,40,19
1745139151164,SOCI 1,A01,890431,Thorpe; Charles Robert,21,0,30,9
1745139151164,SOCI 1,A02,890518,Thorpe; Charles Robert,30,0,30,0
1745139152189,SOCI 2,A01,957978,Staff,0,0,0,0
1745139152189,SOCI 2,A02,957979,Staff,0,3,0,0
1745139153227,SOCI 20,A01,890523,Calderon-Zaks; Michael Aar,24,0,30,6
1745139153227,SOCI 20,A02,890526,Calderon-Zaks; Michael Aar,29,0,30,1
1745139154255,SOCI 30,A01,890533,Pardo Guerra; Juan Pablo,37,0,40,3
1745139155292,SOCI 40,A01,890535,Staff,32,0,45,13
1745139156328,SOCI 104Q,A00,890559,Staff,20,0,30,10
1745139157370,SOCI 106,A00,890560,Arnal; Maud Marie Leonie,22,0,30,8
1745139158416,SOCI 110,A00,890567,Holkenbrink-Monk; Charlene,22,0,30,8
1745139159441,SOCI 112,A00,890568,Victoria Torres; Pablo,0,0,45,45
1745139160467,SOCI 115,A00,890597,Arnal; Maud Marie Leonie,33,0,45,12
1745139162532,SOCI 121,A00,890604,Pardo Guerra; Juan Pablo,40,0,45,5
1745139163559,SOCI 126,A01,890608,Staff,8,0,10,2
1745139164584,SOCI 127,A00,890609,Staff,23,0,30,7
1745139165609,SOCI 131,A00,890610,Thorpe; Charles Robert,38,0,45,7
1745139166637,SOCI 135,A00,890615,Payne; Christine Anna,20,0,45,25
1745139167669,SOCI 139,A00,890620,Staff,43,0,45,2
1745139168735,SOCI 148E,A00,890622,Calderon-Zaks; Michael Aar,39,0,45,6
1745139178078,SOCI 150,A00,890623,Kohler; Kristopher M.,36,0,45,9
1745139179113,SOCI 157,A00,890625,Jules-Rosette; Bennetta W.,18,0,20,2
1745139180162,SOCI 160,A00,890627,Payne; Christine Anna,26,0,45,19
1745139181201,SYN 1,A00,886855,Fish; Gwendolyn Anne,0,0,0,0
1745139181201,SYN 1,B00,906086,Fish; Gwendolyn Anne,0,0,0,2
1745139182248,SYN 2R,A00,886860,Staff,0,15,15,15
1745139182248,SYN 2R,B00,906106,Atkinson; Arthur Laird,0,14,15,15
1745139183309,SYN 100,A01,886866,Browne; Emily,0,29,20,20
1745139183309,SYN 100,B01,906128,Rock; Martin,0,4,20,20
1745139183309,SYN 100,C01,906140,Deavenport; James Cary,0,2,20,20
1745139183309,SYN 100,D01,907816,Deavenport; James Cary,0,3,20,20
1745139184336,TDAC 1,A00,890286,Walsh; Kim C.,11,0,20,9
1745139185362,TDAC 101,A00,890296,Basso; Beatrice,18,0,20,2
1745139186388,TDDE 131,A00,890297,Staff,47,0,50,3
1745139187413,TDDM 1,A00,890287,Weinberg; Sadie,26,0,30,4
1745139188439,TDGE 11,A00,890288,Fulton; Julia,155,0,200,45
1745139188439,TDGE 11,B00,890289,Castro; Robert Jess,188,0,200,12
1745139189465,TDGE 25,B00,957359,Walsh; Kim C.,9,0,20,11
1745139190491,TDGE 40,A01,890292,Power; Jade Yukana,28,0,30,2
1745139191536,TDGE 124,A00,890298,Havis; Allan,12,0,50,38
1745139192566,TDGE 131R,A00,890299,Burelle; Julie Sara Veronique,20,0,42,22
1745139193593,TDHT 101,A00,890300,Staff,12,0,20,8
1745139194618,TDHT 109,A01,890302,Anderson; Mysia Anyse,31,0,40,9
1745139195654,TDMV 1,A00,890293,Arcidiacono; Kristin,20,0,30,10
1745139196678,TDMV 2,A00,890294,Weinberg; Sadie,26,0,30,4
1745139197705,TDMV 3,A00,957878,Arcidiacono; Kristin,27,0,30,3
1745139199766,TDMV 138,A00,890304,Jun; Grace Shin Hae,25,0,40,15
1745139200798,TDMV 140,A00,890305,Corrales; Joseph Bernales,28,0,30,2
1745139201822,TDMV 142,A00,890307,Caligagan; Tony,30,0,40,10
1745139202849,TDMV 144,A00,890308,Camaya; Michelle Ann,26,0,30,4
1745139203873,TDPW 1,A00,890295,Stein; Deborah Isobel,5,0,20,15
1745139204899,USP 2,A01,890272,Lerner; Amy M,8,0,20,12
1745139205927,USP 3,A01,890274,Staff,21,0,30,9
1745139206952,USP 15,A01,890276,Sun; Feiyang,21,0,30,9
1745139207983,USP 25,A00,890277,Shenkman; Michael Thomas,21,0,25,4
1745139209015,USP 138,A00,890278,Staff,15,0,25,10
1745139210055,USP 143,A00,890279,Staff,30,0,70,40
1745139211082,USP 144,A00,890280,Chowdhury; Muhammed Zohir,19,0,30,11
1745139212115,USP 150,A00,890281,Boomhower; Matthew Charles,19,0,30,11
1745139213146,USP 151,A00,890282,Staff,17,0,20,3
1745139214180,USP 162,A00,890283,Andrews; Abigail Leslie,17,0,20,3
1745139215206,USP 168,A00,920477,Kwak; Nancy,2,0,5,3
1745139216232,USP 181,A00,890284,Staff,11,0,20,9
1745139217267,USP 191A,A00,890285,Staff,15,0,20,5
1745139218294,VIS 101,A00,886512,Staff,37,0,75,38
1745139219320,VIS 103,A00,886513,Cruz; Edwin Teddy,65,0,75,10
1745139220346,VIS 108,A00,886514,Staff,7,0,15,8
1745139221389,VIS 127P,A00,886515,Shen; Kuiyi,92,0,146,54
1745139222414,VIS 149,A00,886516,Yoldas; Pinar,1,0,15,14
1745139223440,VIS 164,A00,886526,Erdmann; Dean,21,0,22,1
1745139224475,VIS 194S,A00,886527,Staff,61,0,75,14
1745139225501,WCWP 10A,C00,886484,Staff,13,0,15,2
1745139226557,WCWP 10B,A00,886490,Staff,5,0,15,10
1745139226557,WCWP 10B,B00,886491,Staff,0,1,0,0
1745139226557,WCWP 10B,C00,886492,Staff,10,0,15,5
1745139227583,WCWP 100,A00,886494,Staff,0,2,15,15
1745139229839,AAS 10,A01,886199,Childs; Dennis R.,0,2,0,0
1745139230878,ANAR 104,A01,886940,Shtienberg; Gilad,27,0,30,3
1745139231914,ANAR 120,A00,886953,Staff,13,0,20,7
1745139232956,ANBI 148,A01,886955,Wilder; Linnea Lorene,32,0,40,8
1745139235008,ANSC 122,A00,886957,Staff,28,0,30,2
1745139236034,ANSC 150,A00,886958,Sloane; Julia Kathryn,6,0,15,9
1745139237067,ANSC 156,A00,886959,Jenkins; Janis A.,2,0,15,13
1745139238094,ANSC 180,A00,886960,Staff,12,0,17,5
1745139239129,ANSC 188,A00,886961,Jassal; Aftab,10,0,25,15
1745139240155,ANSC 190,A00,886962,Jassal; Aftab,14,0,25,11
1745139241182,ANSC 191,A00,886963,Staff,18,0,20,2
1745139242250,ANTH 3,A01,891689,Staff,19,0,20,1
1745139243288,ANTH 5,A00,886933,Semendeferi; Ekaterini,18,0,20,2
1745139244322,ANTH 10,A00,886934,Staff,0,8,30,30
1745139245350,ANTH 21,A01,886936,Staff,44,0,60,16
1745139246391,ANTH 23,A01,886938,Staff,94,0,100,6
1745139247430,ANTH 105,A00,886964,Stewart; Alexander B,94,0,100,6
1745139252465,ANTH 108,A00,886965,Pedersen; David,10,0,20,10
1745139253495,AWP 10,001,886147,Staff,0,0,0,0
1745139253495,AWP 10,002,886148,Staff,0,0,0,0
1745139253495,AWP 10,003,886149,Staff,0,0,0,0
1745139253495,AWP 10,004,886150,Staff,0,0,0,0
1745139253495,AWP 10,005,886151,Staff,0,0,0,0
1745139253495,AWP 10,006,886152,Staff,0,0,0,0
1745139253495,AWP 10,007,886153,Staff,0,0,0,0
1745139253495,AWP 10,008,886154,Staff,0,0,0,0
1745139253495,AWP 10,009,886155,Staff,0,0,0,0
1745139253495,AWP 10,010,886156,Staff,0,0,0,0
1745139253495,AWP 10,011,886158,Staff,0,0,0,0
1745139253495,AWP 10,012,886160,Staff,0,0,0,0
1745139253495,AWP 10,013,886161,Staff,0,0,0,0
1745139253495,AWP 10,014,886162,Staff,0,0,0,0
1745139253495,AWP 10,015,886163,Staff,0,0,0,0
1745139253495,AWP 10,016,886164,Staff,0,0,0,0
1745139253495,AWP 10,017,886165,Staff,0,0,0,0
1745139253495,AWP 10,018,886166,Staff,0,0,0,0
1745139253495,AWP 10,019,886168,Staff,0,0,0,0
1745139253495,AWP 10,020,886170,Staff,0,0,0,0
1745139253495,AWP 10,021,886172,Staff,0,0,0,0
1745139254521,AWP 10R,001,886173,Staff,0,0,0,0
1745139254521,AWP 10R,002,886174,Staff,0,1,0,0
1745139254521,AWP 10R,003,886175,Staff,0,0,0,0
1745139254521,AWP 10R,004,886176,Staff,0,0,0,0
1745139254521,AWP 10R,005,886177,Staff,0,0,0,0
1745139254521,AWP 10R,006,886178,Staff,0,0,0,0
1745139254521,AWP 10R,007,886179,Staff,0,0,0,0
1745139254521,AWP 10R,008,886181,Staff,0,0,0,0
1745139254521,AWP 10R,009,886182,Staff,0,0,0,0
1745139254521,AWP 10R,010,886183,Staff,0,0,0,0
1745139254521,AWP 10R,011,886184,Staff,0,0,0,0
1745139254521,AWP 10R,012,886185,Staff,0,0,0,0
1745139254521,AWP 10R,013,886186,Staff,0,0,0,0
1745139254521,AWP 10R,014,886187,Staff,0,0,0,0
1745139254521,AWP 10R,015,886188,Staff,0,0,0,0
1745139254521,AWP 10R,016,886189,Staff,0,0,0,0
1745139255548,AWP 102R,A00,886190,Staff,0,0,0,0
1745139255548,AWP 102R,B00,886191,Staff,0,0,0,0
1745139256574,BENG 100,A01,886193,Staff,19,0,30,11
1745139258173,BENG 122A,A01,886195,Hasty; Jeff M,20,0,30,10
1745139259218,BENG 166A,A00,886196,Sah; Robert Lie-Yuan,0,3,20,20
1745139260242,BIBC 102,A01,894320,Staff,0,2,46,46
1745139260242,BIBC 102,A02,894321,Staff,0,0,46,46
1745139260242,BIBC 102,A03,894344,Staff,21,0,46,25
1745139260242,BIBC 102,A04,894345,Staff,30,0,47,17
1745139261269,BICD 100R,A01,894365,Smith; Laurie,1,3,58,57
1745139261269,BICD 100R,A02,894366,Smith; Laurie,0,1,58,58
1745139261269,BICD 100R,A03,894367,Smith; Laurie,13,0,59,46
1745139262299,BICD 136,A01,894383,Gustafson-Brown; Cindy,16,0,50,34
1745139263350,BIEB 102,A01,894494,Butler; Shannon Rhey,67,0,130,63
1745139265402,BIEB 150,A01,894617,Wills; Christopher,0,3,13,13
1745139265402,BIEB 150,A02,894631,Wills; Christopher,0,3,13,13
1745139265402,BIEB 150,A03,894937,Wills; Christopher,0,3,13,13
1745139265402,BIEB 150,A04,894946,Wills; Christopher,0,1,11,11
1745139266428,BIEB 194,A00,906141,Kurle; Carolyn M.,14,0,20,6
1745139267454,BILD 1,A01,894154,Staff,8,0,19,11
1745139267454,BILD 1,A02,894155,Staff,15,0,19,4
1745139267454,BILD 1,A03,894160,Staff,18,0,19,1
1745139267454,BILD 1,A04,894161,Staff,16,0,18,2
1745139268480,BILD 2,A01,894168,Staff,0,0,50,50
1745139268480,BILD 2,A02,894169,Staff,0,0,50,50
1745139268480,BILD 2,A03,894179,Staff,27,0,50,23
1745139268480,BILD 2,A04,894203,Staff,42,0,50,8
1745139269509,BILD 3,A01,894213,Staff,24,0,31,7
1745139269509,BILD 3,A02,894214,Staff,28,0,31,3
1745139269509,BILD 3,A03,894235,Staff,30,0,31,1
1745139269509,BILD 3,A04,894236,Staff,29,0,32,3
1745139270557,BILD 4,A01,894253,Reuther; Keefe,12,0,24,12
1745139270557,BILD 4,A02,894258,Reuther; Keefe,19,0,24,5
1745139271585,BILD 5,A01,894276,Reuther; Keefe,40,0,50,10
1745139271585,BILD 5,A02,894277,Reuther; Keefe,48,0,50,2
1745139271585,BILD 5,A03,894290,Reuther; Keefe,47,0,50,3
1745139271585,BILD 5,A04,894291,Reuther; Keefe,50,0,50,0
1745139272611,BILD 24,A01,894297,Pirino; Giorgia,46,0,60,14
1745139273651,BIMM 100,A01,895012,Staff,0,14,0,1
1745139273651,BIMM 100,A02,895013,Staff,0,6,0,2
1745139273651,BIMM 100,A03,895014,Staff,0,7,0,0
1745139273651,BIMM 100,A04,895015,Staff,0,4,0,0
1745139274678,BIMM 101,A01,895017,McDonnell; Lisa Marie,0,2,24,24
1745139274678,BIMM 101,A02,895018,McDonnell; Lisa Marie,0,1,24,24
1745139274678,BIMM 101,B01,895020,McDonnell; Lisa Marie,0,3,24,24
1745139274678,BIMM 101,B02,895021,McDonnell; Lisa Marie,0,2,24,24
1745139275713,BIMM 110,A01,895023,Staff,7,0,25,18
1745139275713,BIMM 110,A02,895024,Staff,11,0,25,14
1745139275713,BIMM 110,A03,895025,Staff,22,0,25,3
1745139275713,BIMM 110,A04,895031,Staff,21,0,25,4
1745139276739,BIMM 120,A01,895114,Gustafson-Brown; Cindy,8,0,28,20
1745139276739,BIMM 120,A02,895126,Gustafson-Brown; Cindy,19,0,27,8
1745139277766,BIPN 100,A01,895130,Yang; Mingyu,13,0,38,25
1745139277766,BIPN 100,A02,895131,Yang; Mingyu,33,0,38,5
1745139277766,BIPN 100,A03,895132,Yang; Mingyu,33,0,38,5
1745139277766,BIPN 100,A04,895133,Yang; Mingyu,30,0,36,6
1745139278793,BIPN 120,A01,895135,Cooke; James Edward,0,3,13,13
1745139278793,BIPN 120,A02,895136,Cooke; James Edward,0,1,13,13
1745139278793,BIPN 120,A03,895137,Cooke; James Edward,0,0,13,13
1745139278793,BIPN 120,A04,895156,Cooke; James Edward,4,0,11,7
1745139279856,BIPN 134,A01,895235,Cooke; James Edward,0,3,25,25
1745139279856,BIPN 134,A02,895237,Cooke; James Edward,0,0,25,25
1745139279856,BIPN 134,A03,895240,Cooke; James Edward,13,0,25,12
1745139279856,BIPN 134,A04,895270,Cooke; James Edward,24,0,25,1
1745139280904,BIPN 189,A00,892103,Staff,0,20,9,9
1745139282958,CAT 124,A01,922009,Staff,0,1,20,20
1745139284055,CAT 125R,A00,886390,Morales; Celeste Georgianna,4,0,20,16
1745139284055,CAT 125R,B00,886391,Irwin; Matthew Joseph,0,1,20,20
1745139284055,CAT 125R,C00,886392,Smith; Lauryn Alissa,11,0,20,9
1745139284055,CAT 125R,D00,886393,Vanderschuit; Maya Alysia,6,0,20,14
1745139284055,CAT 125R,E00,886394,Marchisotto; Jennifer Anne,0,2,20,20
1745139285082,CENG 15,A01,886218,Drews; Aaron,1,0,5,4
1745139286116,CENG 113,A00,886219,Opatkiewicz; Justin Paul,16,0,25,9
1745139287143,CGS 101,A00,887044,Staff,13,0,20,7
1745139288210,CGS 105,A01,887046,Staff,16,0,25,9
1745139289235,CGS 112,A00,887047,Cuong; Marisol,12,0,15,3
1745139290276,CGS 113,A00,887048,Staff,24,0,30,6
1745139291303,CGS 120,A00,887049,Staff,12,0,17,5
1745139292331,CHEM 6A,A01,886336,Lam; Tin Yiu,44,0,50,6
1745139292331,CHEM 6A,A02,886338,Lam; Tin Yiu,43,0,50,7
1745139293358,CHEM 6B,A01,886341,Hopkins; Patrycja Anna,21,0,50,29
1745139293358,CHEM 6B,A02,886343,Hopkins; Patrycja Anna,46,0,50,4
1745139294385,CHEM 6C,A01,886346,Albizati; Kim F.,0,1,50,50
1745139294385,CHEM 6C,A02,886348,Albizati; Kim F.,38,0,50,12
1745139295414,CHEM 40A,A01,886352,Klosterman; Jeremy K,70,0,100,30
1745139296439,CHEM 40B,A01,886356,Klosterman; Jeremy K,0,4,100,100
1745139297484,CHEM 41B,A01,886360,Theodorakis; Emmanuel,30,0,50,20
1745139297484,CHEM 41B,A02,886362,Theodorakis; Emmanuel,46,0,50,4
1745139298511,CHIN 165A,A00,886382,Xu; Li,19,0,20,1
1745139299536,CLAS 120,A00,886387,Myerston Santana; Jacobo,36,0,40,4
1745139300574,COGS 9,A01,886967,Shannon; Kyle Michael,49,0,60,11
1745139301612,COGS 11,A01,886969,Staff,18,0,30,12
1745139302653,COGS 14A,A01,886971,Staff,26,0,60,34
1745139303682,COGS 14B,A01,886973,Hoffman; Drew Ellen,18,0,60,42
1745139304710,COGS 18,A01,886975,Morgan; Eric,41,0,60,19
1745139305737,COGS 20,A01,886977,Staff,6,0,8,2
1745139305737,COGS 20,A02,886978,Staff,6,0,7,1
1745139306769,COGS 100,A01,907783,Staff,6,0,30,24
1745139307804,COGS 101B,A01,886980,Staff,0,10,30,30
1745139308832,COGS 101C,A01,886982,Delgado; Tania,0,6,30,30
1745139309869,COGS 102A,A01,886984,Johnson; Christine M.,13,0,30,17
1745139310898,COGS 118B,A01,886986,Staff,0,25,60,60
1745139311938,COGS 150,A01,886988,Bergen; Benjamin,16,0,30,14
1745139312965,COGS 153,A00,886989,Delgado; Tania,0,6,30,30
1745139314000,COGS 186,A01,886991,Staff,3,0,30,27
1745139315026,COGS 187A,A01,886993,Boyle; Mary E. T.,12,0,30,18
1745139316053,COGS 189,A00,886994,Staff,13,0,30,17
1745139317082,COMM 10,A01,886996,Staff,11,0,25,14
1745139317082,COMM 10,A02,886997,Staff,21,0,25,4
1745139318128,COMM 20,A01,886999,Leuning; Grant Maurstad,33,0,40,7
1745139320197,COMM 100A,A01,887002,Staff,0,0,25,25
1745139320197,COMM 100A,A02,887003,Staff,20,0,25,5
1745139321223,COMM 100B,A01,887005,Staff,0,1,25,25
1745139322260,COMM 106D,A00,887006,Staff,22,0,40,18
1745139323305,COMM 110G,A00,887007,Whitworth-Smith; Andrew C,17,0,40,23
1745139324333,COMM 111B,A00,887008,Staff,31,0,40,9
1745139325359,COMM 113T,A00,887009,Abuelhiga; Soraya Jill,30,0,40,10
1745139325359,COMM 113T,B00,906733,Staff,40,0,40,0
1745139326383,COMM 145,A00,887010,Staff,21,0,40,19
1745139327422,COMM 146,A00,887054,Staff,31,0,40,9
1745139328449,COMM 190,A00,887012,Staff,9,0,23,14
1745139334645,CSE 8A,A50,887015,Cao; Yingjun,68,0,85,17
1745139335673,CSE 11,A01,887017,Cao; Yingjun,35,0,70,35
1745139336702,CSE 20,A01,887019,Staff,35,0,50,15
1745139337730,CSE 21,A01,887021,Braun; Oliver,81,0,100,19
1745139337730,CSE 21,B01,892583,Staff,48,0,50,2
1745139338769,CSE 30,A01,887025,Eldon; John,161,0,200,39
1745139339796,CSE 100,A01,887027,Staff,28,0,50,22
1745139339796,CSE 100,A02,887028,Staff,43,0,50,7
1745139340841,CSE 101,A01,887030,Braun; Oliver,79,0,100,21
1745139340841,CSE 101,B01,887032,Jones; Miles E,0,1,50,50
1745139340841,CSE 101,B02,887033,Jones; Miles E,13,0,50,37
1745139341868,CSE 105,A01,908084,Jones; Miles E,36,0,50,14
1745139341868,CSE 105,A02,908087,Jones; Miles E,38,0,50,12
1745139342910,CSE 135,A01,887035,Powell; Thomas Allan,8,0,50,42
1745139343937,CSE 142,A01,887037,Staff,22,0,60,38
1745139344964,CSE 142L,A01,887039,Staff,42,0,60,18
1745139345991,CSE 151A,A01,887041,Solares; Edwin A,60,0,100,40
1745139347028,CSE 175,A01,887043,Kumar; Rakesh,30,0,30,0
1745139348061,CSS 1,A01,886389,Staff,12,0,40,28
1745139349087,DSC 30,A01,908097,Liao; Soohyun Nam,54,0,75,21
1745139350115,DSC 40A,A01,908099,Shannon; Kyle Michael,37,0,50,13
1745139351141,DSC 40B,A01,908112,Staff,28,0,50,22
1745139352176,DSC 80,A01,908116,Staff,32,0,60,28
1745139353203,DSC 197,001,956863,Eldridge; Justin Matthew,9999,0,9999,0
1745139354245,ECE 5,A01,886400,Morris; Karcher William,3,0,6,3
1745139354245,ECE 5,A02,886401,Morris; Karcher William,5,0,6,1
1745139355288,ECE 148,A01,886403,Silberman; Jack,0,8,14,14
1745139356317,ECON 1,A01,887265,Crane; Meredith Helen,25,0,70,45
1745139356317,ECON 1,B01,887268,Staff,44,0,50,6
1745139357345,ECON 2,A01,887273,Crane; Meredith Helen,61,0,70,9
1745139358371,ECON 3,A01,887279,Rondina; Giacomo,44,0,70,26
1745139359414,ECON 4,A01,887282,Anderson; John Charles,0,1,10,10
1745139360456,ECON 5,A01,887285,Staff,39,0,45,6
1745139360456,ECON 5,B01,887292,Staff,43,0,45,2
1745139361484,ECON 100A,A01,887337,Newhouse; Herbert S,58,0,70,12
1745139361484,ECON 100A,B01,887349,Staff,45,0,50,5
1745139362511,ECON 100B,A01,887361,Du; Songzi,42,0,70,28
1745139363554,ECON 100C,A01,887445,Newhouse; Herbert S,61,0,70,9
1745139364582,ECON 105,A00,887488,Vespa; Emanuel Ignacio,24,0,35,11
1745139365607,ECON 109,A01,887506,Staff,29,0,35,6
1745139366667,ECON 110A,A01,887568,Alon; Titan Michael,1,0,35,34
1745139366667,ECON 110A,B01,907601,Alon; Titan Michael,27,0,35,8
1745139367694,ECON 110B,A01,887598,Levkoff; Steven B.,0,7,70,70
1745139368719,ECON 112,A00,887599,Rondina; Giacomo,20,0,35,15
1745139369758,ECON 120A,A01,887603,Dai; Yinlin,46,0,70,24
1745139370787,ECON 120C,A01,887608,Sun; Yixiao,0,0,35,35
1745139370787,ECON 120C,B01,887614,Sun; Yixiao,13,0,35,22
1745139371812,ECON 138,A00,887621,Bharadwaj; Prashant,0,18,20,20
1745139372852,ECON 171,A01,907666,Staff,27,0,35,8
1745139373879,ECON 175,A00,887626,Wu; Pak Yeung,27,0,35,8
1745139374906,ECON 190,A00,887640,Vespa; Emanuel Ignacio,26,0,35,9
1745139375937,EDS 25,A01,888197,Staff,0,0,0,0
1745139375937,EDS 25,A02,888209,Staff,0,0,0,0
1745139375937,EDS 25,A03,888210,Staff,0,0,0,0
1745139375937,EDS 25,A04,888212,Staff,0,0,0,0
1745139375937,EDS 25,A05,888213,Staff,0,0,0,0
1745139375937,EDS 25,A06,888214,Staff,0,0,0,0
1745139375937,EDS 25,A07,888235,Staff,0,0,0,0
1745139375937,EDS 25,A08,888236,Staff,0,0,0,0
1745139375937,EDS 25,A09,888240,Staff,0,0,0,0
1745139375937,EDS 25,A10,888244,Staff,0,0,0,0
1745139375937,EDS 25,B01,888273,Staff,0,0,0,0
1745139375937,EDS 25,B02,888285,Staff,0,0,0,0
1745139375937,EDS 25,B03,888423,Staff,29,0,30,1
1745139375937,EDS 25,B04,888432,Staff,0,0,0,0
1745139375937,EDS 25,B05,888433,Staff,0,0,0,0
1745139375937,EDS 25,B06,888467,Staff,0,0,0,0
1745139375937,EDS 25,B07,888468,Staff,0,0,0,0
1745139375937,EDS 25,B08,888479,Staff,0,0,0,0
1745139375937,EDS 25,B09,888484,Staff,0,0,0,0
1745139375937,EDS 25,B10,888487,Staff,0,0,0,0
1745139376964,EDS 38,A01,907700,Choi; Bailey Miyeon,30,0,30,0
1745139377991,EDS 112,A01,888601,Chapman; Thandeka K,23,0,40,17
1745139379031,EDS 115,A00,888697,Mendez; Kathrina Mendoza,17,0,30,13
1745139380058,EDS 116,A01,888893,Staff,38,0,40,2
1745139382121,EDS 124AR,A00,889133,Staff,33,0,50,17
1745139382121,EDS 124AR,B00,907471,Simon; Elizabeth A,42,0,50,8
1745139383154,EDS 124BR,A00,889134,Staff,57,0,100,43
1745139384183,EDS 125,A00,889135,Staff,26,0,30,4
1745139385228,EDS 126,A01,889138,Staff,37,0,40,3
1745139386262,EDS 164R,A01,889142,Wishard Guerra; Alison G.,38,0,50,12
1745139387322,ENG 30,A01,886396,Staff,0,0,0,0
1745139387322,ENG 30,B01,886398,Staff,0,0,0,0
1745139388349,ENVR 102,A00,906150,Montejo; Carolina,23,0,25,2
1745139389392,ETHN 103A,A00,887236,Man; Simeon S,0,5,0,0
1745139390430,ETHN 113,A00,887239,Staff,20,0,30,10
1745139391465,ETHN 116,A00,887240,Staff,20,0,25,5
1745139392500,ETHN 117,A00,887241,Choi; Esther Min,27,0,30,3
1745139393527,ETHN 118,A00,887243,Staff,24,0,30,6
1745139394554,ETHN 127,A00,887248,Cuong; Marisol,12,0,15,3
1745139395580,ETHN 139,A00,887250,Staff,8,0,10,2
1745139396605,ETHN 142,A00,887252,Staff,18,0,30,12
1745139397630,ETHN 161,A00,887253,Browne; Errol Tsekani,28,0,30,2
1745139398657,ETHN 163FR,A00,887255,Burelle; Julie Sara Veronique,4,0,5,1
1745139399695,GLBH 20,A00,889149,Elwardani; Nile Regina,15,0,42,27
1745139401759,GLBH 111,A01,889152,Burgos; Jose L.,17,0,17,0
1745139402786,GLBH 150,A00,889181,Sloane; Julia Kathryn,0,1,15,15
1745139404848,HDS 60,A01,886406,Warstadt; Melissa Fawn,76,0,80,4
1745139405876,HIAF 111,A00,889324,Gyamfi; Bright,0,4,0,0
1745139406902,HIEA 131,A00,889328,Staff,14,0,32,18
1745139407929,HIEA 144,A00,889333,Henry; Todd A.,29,0,32,3
1745139408957,HIEA 154,A00,889336,Henry; Todd A.,28,0,32,4
1745139409985,HIEU 106,A00,889339,Staff,28,0,32,4
1745139412041,HIEU 114,A00,889340,Staff,18,0,32,14
1745139413069,HIEU 135GS,A00,889342,Patterson; Patrick H.,0,0,1,22
1745139414094,HIEU 137,A00,889343,Edington; Claire Ellen,12,0,25,13
1745139415122,HIEU 148,A00,889345,Staff,16,0,32,16
1745139416152,HIEU 154,A00,889346,Biess; Frank Peter,24,0,32,8
1745139417178,HILA 102,A00,889351,Staff,13,0,32,19
1745139418205,HILD 2A,A01,889221,Lewandoski; Julia Mavis,0,5,32,32
1745139419232,HILD 7B,A01,889225,Man; Simeon S,0,7,32,32
1745139420260,HILD 7C,A01,889288,Alvarez; Luis A,0,8,32,32
1745139421287,HILD 30,A01,889323,Staff,0,1,32,32
1745139423348,HISC 119,A00,889383,Golan; Tal,22,0,32,10
1745139424374,HIUS 103,A00,889384,Man; Simeon S,10,0,32,22
1745139425406,HIUS 117,A00,919797,Kwak; Nancy,23,0,32,9
1745139426434,HIUS 142A,A00,919788,Staff,24,0,32,8
1745139428488,HIUS 149,A00,889386,Gyamfi; Bright,0,1,0,0
1745139429518,HIUS 155,A00,889387,Alvarez; Luis A,19,0,32,13
1745139430551,HUM 3,A01,886499,Caldwell; Michael Alan,24,0,50,26
1745139431578,HUM 3GS,A00,886500,Rodriguez; Bretton Sigfred,0,0,0,26
1745139432606,HUM 3R,A01,886502,Markman; Kristina,0,32,50,50
1745139433636,HUM 4,A01,886504,Crum; Matthew Stephen,28,0,50,22
1745139433636,HUM 4,B01,886506,West; Geoffrey Scott,25,0,50,25
1745139434660,HUM 4GS,A00,886507,Staff,0,0,0,13
1745139435686,HUM 5,A01,886509,Staff,35,0,50,15
1745139436716,HUM 5R,A01,886511,Zavodny; Tatiana Sophia,0,32,50,50
1745139437743,JAPN 180,A00,886407,Staff,25,0,40,15
1745139438772,LATI 50,A01,886409,Martin-Cabrera; Luis,9,0,22,13
1745139438772,LATI 50,A02,886410,Martin-Cabrera; Luis,20,0,22,2
1745139438772,LATI 50,A03,886411,Martin-Cabrera; Luis,22,0,22,0
1745139438772,LATI 50,A04,886412,Martin-Cabrera; Luis,15,0,22,7
1745139439800,LAWS 101,A00,907664,Staff,36,0,60,24
1745139440827,LIAB 1A,A00,889388,Saab; Dima,19,0,20,1
1745139441861,LIAB 1AX,A00,889389,El Cheddadi; Youniss,19,0,20,1
1745139442894,LIFR 1C,A00,889391,Van Moer; Vinciane G,9,0,20,11
1745139443924,LIFR 1CX,A00,889392,Van Moer; Vinciane G,8,0,20,12
1745139444950,LIFR 1D,A00,889393,Van Moer; Vinciane G,11,0,20,9
1745139445980,LIFR 1DX,A00,889394,Van Moer; Vinciane G,11,0,20,9
1745139447007,LIGN 7,A00,886923,Staff,30,0,50,20
1745139448035,LIGN 17,A00,886924,Kehler; Andrew Scott,133,0,150,17
1745139449063,LTAM 110,A00,889395,Staff,17,0,30,13
1745139450091,LTCH 101,A00,889397,Staff,22,0,25,3
1745139451120,LTCS 130,A00,889398,Staff,23,0,25,2
1745139452149,LTEA 138,A00,889399,Staff,25,0,40,15
1745139453174,LTEN 149,A00,889400,Wesling; Megan E.,6,0,25,19
1745139454199,LTEN 169,A00,889401,Staff,24,0,25,1
1745139455225,LTEN 180,A00,889402,Staff,12,0,15,3
1745139456251,LTEN 181,A00,889403,Staff,23,0,25,2
1745139457278,LTWL 100,A00,889404,Myerston Santana; Jacobo,8,0,25,17
1745139458306,LTWL 180GS,A00,889405,Staff,6,0,20,14
1745139459335,LTWL 181,A00,889406,Staff,19,0,25,6
1745139460363,LTWL 184,A00,889475,Mukherjee; Silpa,21,0,25,4
1745139461390,LTWR 102C,A00,889486,Staff,29,0,30,1
1745139462415,LTWR 115W,A00,889491,Staff,3,0,15,12
1745139463442,MAE 8,A01,886905,Staff,0,2,0,0
1745139464475,MAE 11,A00,886906,Bandaru; Prabhakar,0,0,50,50
1745139465507,MAE 20,A00,886907,Evdokimenko; Ekaterina,50,0,70,20
1745139466534,MAE 30B,A00,886909,Ghazinejad; Maziar,28,0,45,17
1745139467562,MAE 101B,A00,886910,Saintillan; David,36,0,45,9
1745139468589,MAE 105,A00,886911,Bandaru; Prabhakar,26,0,50,24
1745139469618,MAE 107,A00,886912,Staff,22,0,60,38
1745139470645,MAE 143B,A00,886913,Bewley; Thomas R,14,0,40,26
1745139471672,MAE 148,A01,886915,Silberman; Jack,5,0,14,9
1745139472703,MAE 160,A00,886916,Evdokimenko; Ekaterina,41,0,60,19
1745139473734,MATH 3C,A01,889681,Staff,2,0,30,28
1745139474766,MATH 10A,A01,889760,Staff,28,0,30,2
1745139474766,MATH 10A,A02,889783,Staff,30,0,30,0
1745139475799,MATH 10B,A01,889785,Verstraete; Jacques Allan,0,2,30,30
1745139475799,MATH 10B,A02,889795,Verstraete; Jacques Allan,0,2,30,30
1745139475799,MATH 10B,B01,889797,Verstraete; Jacques Allan,1,0,30,29
1745139475799,MATH 10B,B02,889828,Verstraete; Jacques Allan,23,0,30,7
1745139476837,MATH 10C,A01,889849,Habib; Yousaf,18,0,30,12
1745139476837,MATH 10C,A02,889852,Habib; Yousaf,20,0,30,10
1745139476837,MATH 10C,A03,889853,Habib; Yousaf,25,0,30,5
1745139476837,MATH 10C,A04,889858,Habib; Yousaf,21,0,30,9
1745139476837,MATH 10C,B01,889861,Staff,12,0,30,18
1745139476837,MATH 10C,B02,889862,Staff,26,0,30,4
1745139476837,MATH 10C,B03,889863,Staff,28,0,30,2
1745139476837,MATH 10C,B04,889967,Staff,25,0,30,5
1745139477867,MATH 18,A01,889974,Staff,15,0,30,15
1745139477867,MATH 18,A02,889977,Staff,25,0,30,5
1745139477867,MATH 18,B01,889984,Hardiman; Liam,26,0,30,4
1745139477867,MATH 18,B02,889985,Hardiman; Liam,28,0,30,2
1745139478895,MATH 20A,A01,889990,Suk; Andrew Hoon,31,0,35,4
1745139479922,MATH 20B,A01,889993,Ohm; Ko Woon,21,0,30,9
1745139479922,MATH 20B,A02,889994,Ohm; Ko Woon,30,0,30,0
1745139479922,MATH 20B,B01,889996,Ohm; Ko Woon,25,0,30,5
1745139479922,MATH 20B,B02,889997,Ohm; Ko Woon,24,0,30,6
1745139480951,MATH 20C,A01,889999,Hammock; Frances H,22,0,30,8
1745139480951,MATH 20C,A02,890003,Hammock; Frances H,23,0,30,7
1745139480951,MATH 20C,B01,890006,Hammock; Frances H,11,0,30,19
1745139480951,MATH 20C,B02,890007,Hammock; Frances H,18,0,30,12
1745139481987,MATH 20D,A01,890011,Cheng; Hsiao-Bing,6,0,30,24
1745139481987,MATH 20D,A02,890012,Cheng; Hsiao-Bing,27,0,30,3
1745139481987,MATH 20D,B01,890016,Cheng; Hsiao-Bing,19,0,30,11
1745139481987,MATH 20D,B02,890017,Cheng; Hsiao-Bing,15,0,30,15
1745139483021,MATH 20E,A01,890026,Harel; Guershon,10,0,30,20
1745139483021,MATH 20E,A02,890029,Harel; Guershon,24,0,30,6
1745139483021,MATH 20E,B01,890033,Harel; Guershon,14,0,30,16
1745139483021,MATH 20E,B02,890101,Harel; Guershon,27,0,30,3
1745139484050,MATH 102,A01,890104,Staff,20,0,30,10
1745139484050,MATH 102,A02,890105,Staff,30,0,30,0
1745139485084,MATH 103B,A01,890116,Salehi Golsefidy; Alireza,8,0,30,22
1745139485084,MATH 103B,B01,890118,Staff,0,4,30,30
1745139486120,MATH 109,A01,890121,Aliabadi Sr.; Mohsen,6,0,30,24
1745139486120,MATH 109,B01,890124,Upadrashta; Pranav Kumar,23,0,30,7
1745139487150,MATH 120A,A01,890126,Eggers; John Dietrich,15,0,30,15
1745139488182,MATH 142B,A01,890128,Ioana; Adrian,17,0,30,13
1745139488182,MATH 142B,A02,890129,Ioana; Adrian,15,0,30,15
1745139489216,MATH 154,A01,890174,Staff,0,1,30,30
1745139489216,MATH 154,A02,890182,Staff,15,0,30,15
1745139490248,MATH 168A,A01,890197,Dumitriu; Ioana,22,0,35,13
1745139491280,MATH 170A,A01,890240,Nie; Jiawang,6,0,30,24
1745139491280,MATH 170A,A02,890241,Nie; Jiawang,18,0,30,12
1745139491280,MATH 170A,A03,890249,Nie; Jiawang,23,0,30,7
1745139492307,MATH 170B,A01,957891,Nag; Panchali,25,0,35,10
1745139494359,MATH 181A,A01,908025,Staff,0,8,35,35
1745139495390,MATH 193B,A01,890265,Staff,3,0,35,32
1745139496417,MGT 4,A01,890311,Anderson; John Charles,57,0,88,31
1745139497444,MGT 5,A00,907740,Staff,41,0,98,57
1745139498476,MGT 12,A00,890312,Lindenberger; Wade Douglas,70,0,98,28
1745139499506,MGT 16,A00,957883,Staff,84,0,98,14
1745139501561,MGT 45,A00,890314,Pecore; Joseph P.,57,0,98,41
1745139502592,MGT 71,A00,890315,Staff,6,0,98,92
1745139503620,MGT 100,A00,890316,Yavorsky; Daniel Ryan,59,0,98,39
1745139504650,MGT 103,A00,890317,Ehrich; Kristine R,77,0,98,21
1745139505678,MGT 105,A00,890356,Bates; Kenneth Walter,19,0,98,79
1745139506707,MGT 112,A00,890360,Ehrich; Kristine R,65,0,98,33
1745139507734,MGT 127R,A00,907732,Zhu; Kevin Xiaoguo,32,0,98,66
1745139508759,MGT 131B,A00,890361,Anderson; John Charles,75,0,98,23
1745139509790,MGT 137,A00,890362,Lindenberger; Wade Douglas,68,0,98,30
1745139510818,MGT 160,A00,890369,Johnson; Erik Barry,37,0,98,61
1745139512871,MGT 164,A00,890372,Zimmermann; Carsten,0,28,98,98
1745139513898,MGT 180,A00,890374,Bliss; Barbara Ann,32,0,98,66
1745139514926,MMW 15,A01,886414,Chang; Edmond Yi-Teh,0,10,28,28
1745139514926,MMW 15,A02,886415,Chang; Edmond Yi-Teh,0,10,28,28
1745139514926,MMW 15,A03,886416,Chang; Edmond Yi-Teh,0,8,28,28
1745139514926,MMW 15,A04,886417,Chang; Edmond Yi-Teh,0,8,28,28
1745139514926,MMW 15,B01,886419,Chang; Edmond Yi-Teh,0,8,28,28
1745139514926,MMW 15,B02,886420,Chang; Edmond Yi-Teh,0,9,28,28
1745139514926,MMW 15,B03,886421,Chang; Edmond Yi-Teh,0,9,28,28
1745139514926,MMW 15,B04,886422,Chang; Edmond Yi-Teh,0,9,28,28
1745139514926,MMW 15,C01,886424,Staff,0,10,28,28
1745139514926,MMW 15,C02,886425,Staff,0,10,28,28
1745139514926,MMW 15,C03,886426,Staff,0,9,28,28
1745139514926,MMW 15,C04,886427,Staff,0,9,28,28
1745139515953,MMW 15GS,A00,906910,Patterson; Patrick H.,5,0,28,23
1745139516984,MMW 122R,A01,886429,Rahimi; Babak,0,23,28,28
1745139516984,MMW 122R,A02,886430,Rahimi; Babak,0,23,28,28
1745139518023,MUS 1A,A01,890937,Staff,8,0,25,17
1745139518023,MUS 1A,A02,891035,Staff,15,0,25,10
1745139518023,MUS 1A,B00,907849,Staff,48,0,50,2
1745139518023,MUS 1A,B01,907850,Staff,25,0,25,0
1745139518023,MUS 1A,B02,907851,Staff,25,0,25,0
1745139520078,MUS 2AK,A00,957092,Ohnishi; Takae,15,0,15,0
1745139521106,MUS 4,A01,891044,Staff,6,0,25,19
1745139521106,MUS 4,A02,891045,Staff,24,0,25,1
1745139521106,MUS 4,B01,891048,Staff,20,0,25,5
1745139521106,MUS 4,B02,891050,Staff,25,0,25,0
1745139522142,MUS 5,A01,957506,Dubnov; Shlomo,4,0,25,21
1745139522142,MUS 5,A02,957622,Dubnov; Shlomo,21,0,25,4
1745139522142,MUS 5,A03,957623,Dubnov; Shlomo,23,0,25,2
1745139523175,MUS 6,A01,891053,Freitas Caetano; Marcelo,23,0,25,2
1745139523175,MUS 6,A02,891054,Freitas Caetano; Marcelo,23,0,25,2
1745139524204,MUS 7,A01,891081,Staff,0,0,25,25
1745139524204,MUS 7,A02,891082,Staff,15,0,25,10
1745139525240,MUS 8GS,A00,891118,Borgo; David Garcia,5,0,25,20
1745139526271,MUS 11,A01,891140,Staff,12,0,25,13
1745139526271,MUS 11,A02,891141,Staff,24,0,25,1
1745139527299,MUS 13,A01,891143,Staff,10,0,25,15
1745139527299,MUS 13,A02,891144,Staff,25,0,25,0
1745139528338,MUS 15,A01,891146,Staff,7,0,25,18
1745139528338,MUS 15,A02,891148,Staff,22,0,25,3
1745139528338,MUS 15,B01,891150,Staff,18,0,25,7
1745139528338,MUS 15,B02,891151,Staff,25,0,25,0
1745139529365,MUS 20,A01,891153,Staff,9,0,20,11
1745139529365,MUS 20,A02,891155,Staff,16,0,20,4
1745139530396,MUS 80,A00,891156,Staff,19,0,25,6
1745139530396,MUS 80,B00,891157,Staff,25,0,25,0
1745139531424,MUS 130,A00,891158,Ohnishi; Takae,35,0,35,0
1745139532506,MUS 150GS,A01,891160,Borgo; David Garcia,5,0,25,20
1745139533532,MUS 170,A01,891162,Freitas Caetano; Marcelo,21,0,25,4
1745139533532,MUS 170,A02,891164,Freitas Caetano; Marcelo,22,0,25,3
1745139534562,NANO 11,A00,886220,Vazquez Mena; Oscar,12,0,15,3
1745139535597,NANO 15,A01,886222,Drews; Aaron,9,0,10,1
1745139536625,NANO 104,A00,886224,Sirbuly; Donald,18,0,25,7
1745139537651,PH 40,A00,886528,Staff,29,0,40,11
1745139538684,PH 45,A01,886799,Staff,36,0,40,4
1745139539710,PH 110,A00,886802,Staff,7,0,40,33
1745139540740,PH 172,A00,906716,Staff,20,0,35,15
1745139541771,PH 191,A00,886803,Staff,23,0,40,17
1745139542798,PHIL 1,A00,889500,Staff,22,0,30,8
1745139543826,PHIL 10,A01,889549,Grush; Rick Scott,17,0,22,5
1745139543826,PHIL 10,A02,889551,Grush; Rick Scott,20,0,22,2
1745139544862,PHIL 28,A01,889559,Lamey; Andy M.,0,4,25,25
1745139544862,PHIL 28,A02,889561,Lamey; Andy M.,0,0,25,25
1745139544862,PHIL 28,A03,889572,Lamey; Andy M.,7,0,25,18
1745139545889,PHIL 35,A00,907839,Staff,32,0,33,1
1745139546919,PHIL 60,A00,889574,Staff,79,0,90,11
1745139547946,PHIL 105,A00,889579,Staff,0,1,0,0
1745139548972,PHIL 136,A00,889582,Fulkerson; Matthew Todd,27,0,45,18
1745139550001,PHIL 163,A01,889601,Staff,24,0,30,6
1745139550001,PHIL 163,B01,889606,Brandt; Reuven A,0,2,0,0
1745139551026,PHIL 164,A00,889610,Staff,20,0,30,10
1745139552052,PHIL 165,A00,889613,Staff,26,0,30,4
1745139553082,PHYS 1A,A00,886431,Staff,38,0,70,32
1745139554110,PHYS 1AL,001,886432,Tsai; Philbert S,0,0,30,30
1745139554110,PHYS 1AL,002,886436,Tsai; Philbert S,19,0,30,11
1745139555139,PHYS 1B,A00,886439,Staff,192,0,240,48
1745139556169,PHYS 1BL,001,886441,Tsai; Philbert S,0,1,30,30
1745139556169,PHYS 1BL,002,886444,Tsai; Philbert S,14,0,30,16
1745139557197,PHYS 1C,A00,896092,Arnold; Kam S,87,0,146,59
1745139558229,PHYS 1CL,001,886448,Tsai; Philbert S,0,4,30,30
1745139558229,PHYS 1CL,002,886449,Tsai; Philbert S,6,0,30,24
1745139558229,PHYS 1CL,003,886450,Tsai; Philbert S,22,0,30,8
1745139558229,PHYS 1CL,004,886451,Tsai; Philbert S,16,0,30,14
1745139559259,PHYS 2B,A01,886457,Staff,86,0,115,29
1745139560288,PHYS 2C,A01,886460,Shotwell; Brian,0,0,65,65
1745139561315,PHYS 2CL,A01,886467,Staff,0,3,28,28
1745139561315,PHYS 2CL,A02,886468,Staff,5,0,28,23
1745139562343,PHYS 2D,A01,886470,Staff,17,0,50,33
1745139563374,PHYS 4B,A01,886475,Grinstein; Benjamin,88,0,100,12
1745139564402,POLI 5,A00,891173,Desposato; Scott,17,0,25,8
1745139565433,POLI 5D,A01,891175,Staff,5,0,5,0
1745139565433,POLI 5D,B01,891178,Staff,5,0,5,0
1745139566460,POLI 11,A00,891179,Ferree; Karen E,3,0,25,22
1745139567488,POLI 12,A00,891180,Staff,21,0,30,9
1745139568518,POLI 27,A01,891182,Staff,29,0,75,46
1745139569547,POLI 30,A00,891183,Staff,0,3,30,30
1745139570575,POLI 100B,A00,891244,Staff,0,8,20,20
1745139571603,POLI 100I,A00,891247,Staff,19,0,30,11
1745139572631,POLI 104J,A00,891248,Nichter; Maysa,18,0,30,12
1745139573657,POLI 104U,A00,891250,Nichter; Maysa,9,0,30,21
1745139574684,POLI 108,A00,891253,Staff,0,0,0,4
1745139575715,POLI 110B,A00,891255,Wiens; David,22,0,25,3
1745139576742,POLI 112A,A00,891256,Wiens; David,15,0,25,10
1745139577768,POLI 114BR,A00,891261,Staff,22,0,30,8
1745139578795,POLI 117R,A00,891262,Forman; Fonna,12,0,50,38
1745139579823,POLI 118,A00,891264,Ingham; Sean,22,0,25,3
1745139580850,POLI 124A,A00,891265,Staff,19,0,20,1
1745139581882,POLI 125D,A00,891266,Nichter; Simeon C,9,0,25,16
1745139582909,POLI 126,A00,891268,Nichter; Simeon C,11,0,25,14
1745139583938,POLI 126AA,A00,891272,Staff,19,0,25,6
1745139584965,POLI 130AA,A00,891273,Staff,17,0,20,3
1745139585991,POLI 134AA,A00,891274,Staff,12,0,20,8
1745139588048,POLI 138,A00,891278,Staff,22,0,25,3
1745139589078,POLI 142K,A00,891280,Staff,17,0,25,8
1745139590105,POLI 142M,A00,891281,Gartzke; Erik,22,0,30,8
1745139591131,POLI 142P,A00,891284,Staff,21,0,30,9
1745139592157,POLI 143,A00,891285,Gartzke; Erik,17,0,30,13
1745139593185,POLI 153,A00,891286,Staff,20,0,20,0
1745139594216,POLI 170A,A00,891288,Staff,19,0,25,6
1745139595246,POLI 175,A00,891290,Staff,18,0,20,2
1745139596276,PSYC 1,A00,890674,Steiner; Eric Tomas,0,4,45,45
1745139597302,PSYC 2,A00,890676,Albright; Thomas D,25,0,35,10
1745139598330,PSYC 3,A00,890679,Staff,18,0,20,2
1745139599356,PSYC 60,A01,890684,Rickard; Timothy C.,7,0,45,38
1745139600380,PSYC 70,A01,890689,Geller; Emma Harlan,14,0,30,16
1745139601413,PSYC 100,A00,890690,Lacefield; Katharine I,0,43,180,180
1745139602441,PSYC 102,A00,890695,Staff,25,0,40,15
1745139603470,PSYC 105,A00,890699,Geller; Emma Harlan,78,0,100,22
1745139604497,PSYC 106,A00,890701,Gorman; Michael R.,15,0,30,15
1745139605535,PSYC 108,A00,890704,Adrian; Julia Anna,0,23,50,50
1745139606565,PSYC 118,A01,890712,Staff,18,0,30,12
1745139607592,PSYC 124,A00,890716,Chapman; Eddie Nathaniel,36,0,60,24
1745139608624,PSYC 131,A00,890717,Anagnostaras; Stephan,6,0,80,74
1745139609654,PSYC 137,A00,890719,Winkielman; Piotr,0,2,30,30
1745139610679,PSYC 144,A00,890721,Adrian; Julia Anna,0,3,45,45
1745139611706,PSYC 162,A00,890805,Staff,21,0,75,54
1745139612737,PSYC 169,A00,890810,Staff,0,15,30,30
1745139613769,PSYC 172,A00,890814,Gorman; Michael R.,14,0,30,16
1745139614797,PSYC 181,A00,890818,Anagnostaras; Stephan,63,0,200,137
1745139615823,PSYC 189,A00,890823,Staff,11,0,30,19
1745139616851,PSYC 191,A00,890884,Rickard; Timothy C.,0,11,35,35
1745139617879,PSYC 193,A00,890913,Staff,22,0,30,8
1745139617879,PSYC 193,B00,890914,Chapman; Eddie Nathaniel,25,0,30,5
1745139618915,PSYC 193L,A01,890918,Lowe; Angela Beth,29,0,30,1
1745139618915,PSYC 193L,B01,890921,Hurwitz; Ethan Scott,28,0,30,2
1745139618915,PSYC 193L,C01,890928,Staff,30,0,30,0
1745139619949,RELI 149,A00,886806,Rahimi; Babak,23,0,40,17
1745139620975,SE 9,A01,886814,Staff,13,0,20,7
1745139622001,SE 101B,A01,886816,Chadha; Mayank,8,0,30,22
1745139623030,SE 110B,A00,886818,Zhu; Qiang,0,16,45,45
1745139624055,SE 125,A01,886830,Staff,10,0,30,20
1745139625083,SE 130B,A01,886835,Staff,19,0,40,21
1745139626114,SE 131A,A01,886838,Krysl; Petr,37,0,55,18
1745139627141,SE 154,A00,886840,Staff,35,0,50,15
1745139628168,SE 164GS,A01,886849,Staff,13,0,20,7
1745139629197,SE 167GS,A01,886853,Staff,13,0,20,7
1745139630224,SIO 25,A01,890107,Staff,23,0,30,7
1745139631253,SIO 45,A00,890109,Cook; Geoffrey W,137,0,200,63
1745139632286,SIO 109R,A00,890110,Forman; Fonna,0,11,20,20
1745139633312,SIO 187,A01,890114,Kacev; David,21,0,40,19
1745139634343,SOCI 1,A01,890431,Thorpe; Charles Robert,21,0,30,9
1745139634343,SOCI 1,A02,890518,Thorpe; Charles Robert,30,0,30,0
1745139635371,SOCI 2,A01,957978,Staff,0,0,0,0
1745139635371,SOCI 2,A02,957979,Staff,0,3,0,0
1745139636439,SOCI 20,A01,890523,Calderon-Zaks; Michael Aar,24,0,30,6
1745139636439,SOCI 20,A02,890526,Calderon-Zaks; Michael Aar,29,0,30,1
1745139637465,SOCI 30,A01,890533,Pardo Guerra; Juan Pablo,37,0,40,3
1745139638492,SOCI 40,A01,890535,Staff,32,0,45,13
1745139639518,SOCI 104Q,A00,890559,Staff,20,0,30,10
1745139640545,SOCI 106,A00,890560,Arnal; Maud Marie Leonie,22,0,30,8
1745139641573,SOCI 110,A00,890567,Holkenbrink-Monk; Charlene,22,0,30,8
1745139642606,SOCI 112,A00,890568,Victoria Torres; Pablo,0,0,45,45
1745139643635,SOCI 115,A00,890597,Arnal; Maud Marie Leonie,33,0,45,12
1745139645696,SOCI 121,A00,890604,Pardo Guerra; Juan Pablo,40,0,45,5
1745139646723,SOCI 126,A01,890608,Staff,8,0,10,2
1745139647749,SOCI 127,A00,890609,Staff,23,0,30,7
1745139648776,SOCI 131,A00,890610,Thorpe; Charles Robert,38,0,45,7
1745139649804,SOCI 135,A00,890615,Payne; Christine Anna,20,0,45,25
1745139650830,SOCI 139,A00,890620,Staff,43,0,45,2
1745139651857,SOCI 148E,A00,890622,Calderon-Zaks; Michael Aar,39,0,45,6
1745139652885,SOCI 150,A00,890623,Kohler; Kristopher M.,36,0,45,9
1745139653911,SOCI 157,A00,890625,Jules-Rosette; Bennetta W.,18,0,20,2
1745139654938,SOCI 160,A00,890627,Payne; Christine Anna,26,0,45,19
1745139655973,SYN 1,A00,886855,Fish; Gwendolyn Anne,0,0,0,0
1745139655973,SYN 1,B00,906086,Fish; Gwendolyn Anne,0,0,0,2
1745139657005,SYN 2R,A00,886860,Staff,0,15,15,15
1745139657005,SYN 2R,B00,906106,Atkinson; Arthur Laird,0,14,15,15
1745139658037,SYN 100,A01,886866,Browne; Emily,0,29,20,20
1745139658037,SYN 100,B01,906128,Rock; Martin,0,4,20,20
1745139658037,SYN 100,C01,906140,Deavenport; James Cary,0,2,20,20
1745139658037,SYN 100,D01,907816,Deavenport; James Cary,0,3,20,20
1745139659065,TDAC 1,A00,890286,Walsh; Kim C.,11,0,20,9
1745139660090,TDAC 101,A00,890296,Basso; Beatrice,18,0,20,2
1745139661116,TDDE 131,A00,890297,Staff,47,0,50,3
1745139662146,TDDM 1,A00,890287,Weinberg; Sadie,26,0,30,4
1745139663173,TDGE 11,A00,890288,Fulton; Julia,155,0,200,45
1745139663173,TDGE 11,B00,890289,Castro; Robert Jess,188,0,200,12
1745139664201,TDGE 25,B00,957359,Walsh; Kim C.,9,0,20,11
1745139665228,TDGE 40,A01,890292,Power; Jade Yukana,28,0,30,2
1745139666256,TDGE 124,A00,890298,Havis; Allan,12,0,50,38
1745139667287,TDGE 131R,A00,890299,Burelle; Julie Sara Veronique,20,0,42,22
1745139668315,TDHT 101,A00,890300,Staff,12,0,20,8
1745139669343,TDHT 109,A01,890302,Anderson; Mysia Anyse,31,0,40,9
1745139670367,TDMV 1,A00,890293,Arcidiacono; Kristin,20,0,30,10
1745139671393,TDMV 2,A00,890294,Weinberg; Sadie,26,0,30,4
1745139672603,TDMV 3,A00,957878,Arcidiacono; Kristin,27,0,30,3
1745139674665,TDMV 138,A00,890304,Jun; Grace Shin Hae,25,0,40,15
1745139675700,TDMV 140,A00,890305,Corrales; Joseph Bernales,28,0,30,2
1745139676732,TDMV 142,A00,890307,Caligagan; Tony,30,0,40,10
1745139677759,TDMV 144,A00,890308,Camaya; Michelle Ann,26,0,30,4
1745139678790,TDPW 1,A00,890295,Stein; Deborah Isobel,5,0,20,15
1745139679818,USP 2,A01,890272,Lerner; Amy M,8,0,20,12
1745139680846,USP 3,A01,890274,Staff,21,0,30,9
1745139681873,USP 15,A01,890276,Sun; Feiyang,21,0,30,9
1745139682901,USP 25,A00,890277,Shenkman; Michael Thomas,21,0,25,4
1745139683926,USP 138,A00,890278,Staff,15,0,25,10
1745139684953,USP 143,A00,890279,Staff,30,0,70,40
1745139685986,USP 144,A00,890280,Chowdhury; Muhammed Zohir,19,0,30,11
1745139687016,USP 150,A00,890281,Boomhower; Matthew Charles,19,0,30,11
1745139688043,USP 151,A00,890282,Staff,17,0,20,3
1745139689069,USP 162,A00,890283,Andrews; Abigail Leslie,17,0,20,3
1745139690096,USP 168,A00,920477,Kwak; Nancy,2,0,5,3
1745139691126,USP 181,A00,890284,Staff,11,0,20,9
1745139692151,USP 191A,A00,890285,Staff,15,0,20,5
1745139693181,VIS 101,A00,886512,Staff,37,0,75,38
1745139694207,VIS 103,A00,886513,Cruz; Edwin Teddy,65,0,75,10
1745139695235,VIS 108,A00,886514,Staff,7,0,15,8
1745139696263,VIS 127P,A00,886515,Shen; Kuiyi,92,0,146,54
1745139697309,VIS 149,A00,886516,Yoldas; Pinar,1,0,15,14
1745139698343,VIS 164,A00,886526,Erdmann; Dean,21,0,22,1
1745139699372,VIS 194S,A00,886527,Staff,61,0,75,14
1745139700400,WCWP 10A,C00,886484,Staff,13,0,15,2
1745139701428,WCWP 10B,A00,886490,Staff,5,0,15,10
1745139701428,WCWP 10B,B00,886491,Staff,0,1,0,0
1745139701428,WCWP 10B,C00,886492,Staff,10,0,15,5
1745139702455,WCWP 100,A00,886494,Staff,0,2,15,15
1745139704579,AAS 10,A01,886199,Childs; Dennis R.,0,2,0,0
1745139705614,ANAR 104,A01,886940,Shtienberg; Gilad,27,0,30,3
1745139706642,ANAR 120,A00,886953,Staff,13,0,20,7
1745139707669,ANBI 148,A01,886955,Wilder; Linnea Lorene,32,0,40,8
1745139709724,ANSC 122,A00,886957,Staff,28,0,30,2
1745139710752,ANSC 150,A00,886958,Sloane; Julia Kathryn,6,0,15,9
1745139711779,ANSC 156,A00,886959,Jenkins; Janis A.,2,0,15,13
1745139712808,ANSC 180,A00,886960,Staff,12,0,17,5
1745139713839,ANSC 188,A00,886961,Jassal; Aftab,10,0,25,15
1745139714869,ANSC 190,A00,886962,Jassal; Aftab,14,0,25,11
1745139715895,ANSC 191,A00,886963,Staff,18,0,20,2
1745139716921,ANTH 3,A01,891689,Staff,19,0,20,1
1745139717949,ANTH 5,A00,886933,Semendeferi; Ekaterini,18,0,20,2
1745139718978,ANTH 10,A00,886934,Staff,0,9,30,30
1745139720008,ANTH 21,A01,886936,Staff,44,0,60,16
1745139721038,ANTH 23,A01,886938,Staff,94,0,100,6
1745139722064,ANTH 105,A00,886964,Stewart; Alexander B,94,0,100,6
1745139723090,ANTH 108,A00,886965,Pedersen; David,10,0,20,10
1745139724125,AWP 10,001,886147,Staff,0,0,0,0
1745139724125,AWP 10,002,886148,Staff,0,0,0,0
1745139724125,AWP 10,003,886149,Staff,0,0,0,0
1745139724125,AWP 10,004,886150,Staff,0,0,0,0
1745139724125,AWP 10,005,886151,Staff,0,0,0,0
1745139724125,AWP 10,006,886152,Staff,0,0,0,0
1745139724125,AWP 10,007,886153,Staff,0,0,0,0
1745139724125,AWP 10,008,886154,Staff,0,0,0,0
1745139724125,AWP 10,009,886155,Staff,0,0,0,0
1745139724125,AWP 10,010,886156,Staff,0,0,0,0
1745139724125,AWP 10,011,886158,Staff,0,0,0,0
1745139724125,AWP 10,012,886160,Staff,0,0,0,0
1745139724125,AWP 10,013,886161,Staff,0,0,0,0
1745139724125,AWP 10,014,886162,Staff,0,0,0,0
1745139724125,AWP 10,015,886163,Staff,0,0,0,0
1745139724125,AWP 10,016,886164,Staff,0,0,0,0
1745139724125,AWP 10,017,886165,Staff,0,0,0,0
1745139724125,AWP 10,018,886166,Staff,0,0,0,0
1745139724125,AWP 10,019,886168,Staff,0,0,0,0
1745139724125,AWP 10,020,886170,Staff,0,0,0,0
1745139724125,AWP 10,021,886172,Staff,0,0,0,0
1745139725155,AWP 10R,001,886173,Staff,0,0,0,0
1745139725155,AWP 10R,002,886174,Staff,0,1,0,0
1745139725155,AWP 10R,003,886175,Staff,0,0,0,0
1745139725155,AWP 10R,004,886176,Staff,0,0,0,0
1745139725155,AWP 10R,005,886177,Staff,0,0,0,0
1745139725155,AWP 10R,006,886178,Staff,0,0,0,0
1745139725155,AWP 10R,007,886179,Staff,0,0,0,0
1745139725155,AWP 10R,008,886181,Staff,0,0,0,0
1745139725155,AWP 10R,009,886182,Staff,0,0,0,0
1745139725155,AWP 10R,010,886183,Staff,0,0,0,0
1745139725155,AWP 10R,011,886184,Staff,0,0,0,0
1745139725155,AWP 10R,012,886185,Staff,0,0,0,0
1745139725155,AWP 10R,013,886186,Staff,0,0,0,0
1745139725155,AWP 10R,014,886187,Staff,0,0,0,0
1745139725155,AWP 10R,015,886188,Staff,0,0,0,0
1745139725155,AWP 10R,016,886189,Staff,0,0,0,0
1745139726185,AWP 102R,A00,886190,Staff,0,0,0,0
1745139726185,AWP 102R,B00,886191,Staff,0,0,0,0
1745139727212,BENG 100,A01,886193,Staff,19,0,30,11
1745139728244,BENG 122A,A01,886195,Hasty; Jeff M,20,0,30,10
1745139729270,BENG 166A,A00,886196,Sah; Robert Lie-Yuan,0,3,20,20
1745139730301,BIBC 102,A01,894320,Staff,0,2,46,46
1745139730301,BIBC 102,A02,894321,Staff,0,0,46,46
1745139730301,BIBC 102,A03,894344,Staff,21,0,46,25
1745139730301,BIBC 102,A04,894345,Staff,30,0,47,17
1745139731328,BICD 100R,A01,894365,Smith; Laurie,1,3,58,57
1745139731328,BICD 100R,A02,894366,Smith; Laurie,0,1,58,58
1745139731328,BICD 100R,A03,894367,Smith; Laurie,13,0,59,46
1745139732353,BICD 136,A01,894383,Gustafson-Brown; Cindy,16,0,50,34
1745139733388,BIEB 102,A01,894494,Butler; Shannon Rhey,67,0,130,63
1745139735456,BIEB 150,A01,894617,Wills; Christopher,0,3,13,13
1745139735456,BIEB 150,A02,894631,Wills; Christopher,0,3,13,13
1745139735456,BIEB 150,A03,894937,Wills; Christopher,0,3,13,13
1745139735456,BIEB 150,A04,894946,Wills; Christopher,0,1,11,11
1745139736486,BIEB 194,A00,906141,Kurle; Carolyn M.,14,0,20,6
1745139737514,BILD 1,A01,894154,Staff,8,0,19,11
1745139737514,BILD 1,A02,894155,Staff,15,0,19,4
1745139737514,BILD 1,A03,894160,Staff,18,0,19,1
1745139737514,BILD 1,A04,894161,Staff,16,0,18,2
1745139738545,BILD 2,A01,894168,Staff,0,0,50,50
1745139738545,BILD 2,A02,894169,Staff,0,0,50,50
1745139738545,BILD 2,A03,894179,Staff,27,0,50,23
1745139738545,BILD 2,A04,894203,Staff,42,0,50,8
1745139739576,BILD 3,A01,894213,Staff,24,0,31,7
1745139739576,BILD 3,A02,894214,Staff,28,0,31,3
1745139739576,BILD 3,A03,894235,Staff,30,0,31,1
1745139739576,BILD 3,A04,894236,Staff,29,0,32,3
1745139740608,BILD 4,A01,894253,Reuther; Keefe,12,0,24,12
1745139740608,BILD 4,A02,894258,Reuther; Keefe,19,0,24,5
1745139741634,BILD 5,A01,894276,Reuther; Keefe,40,0,50,10
1745139741634,BILD 5,A02,894277,Reuther; Keefe,48,0,50,2
1745139741634,BILD 5,A03,894290,Reuther; Keefe,47,0,50,3
1745139741634,BILD 5,A04,894291,Reuther; Keefe,50,0,50,0
1745139742666,BILD 24,A01,894297,Pirino; Giorgia,46,0,60,14
1745139743694,BIMM 100,A01,895012,Staff,0,14,0,1
1745139743694,BIMM 100,A02,895013,Staff,0,6,0,2
1745139743694,BIMM 100,A03,895014,Staff,0,7,0,0
1745139743694,BIMM 100,A04,895015,Staff,0,4,0,0
1745139744722,BIMM 101,A01,895017,McDonnell; Lisa Marie,0,2,24,24
1745139744722,BIMM 101,A02,895018,McDonnell; Lisa Marie,0,1,24,24
1745139744722,BIMM 101,B01,895020,McDonnell; Lisa Marie,0,3,24,24
1745139744722,BIMM 101,B02,895021,McDonnell; Lisa Marie,0,2,24,24
1745139745752,BIMM 110,A01,895023,Staff,7,0,25,18
1745139745752,BIMM 110,A02,895024,Staff,11,0,25,14
1745139745752,BIMM 110,A03,895025,Staff,22,0,25,3
1745139745752,BIMM 110,A04,895031,Staff,21,0,25,4
1745139746786,BIMM 120,A01,895114,Gustafson-Brown; Cindy,8,0,28,20
1745139746786,BIMM 120,A02,895126,Gustafson-Brown; Cindy,19,0,27,8
1745139747817,BIPN 100,A01,895130,Yang; Mingyu,13,0,38,25
1745139747817,BIPN 100,A02,895131,Yang; Mingyu,33,0,38,5
1745139747817,BIPN 100,A03,895132,Yang; Mingyu,33,0,38,5
1745139747817,BIPN 100,A04,895133,Yang; Mingyu,30,0,36,6
1745139748849,BIPN 120,A01,895135,Cooke; James Edward,0,3,13,13
1745139748849,BIPN 120,A02,895136,Cooke; James Edward,0,1,13,13
1745139748849,BIPN 120,A03,895137,Cooke; James Edward,0,0,13,13
1745139748849,BIPN 120,A04,895156,Cooke; James Edward,4,0,11,7
1745139749877,BIPN 134,A01,895235,Cooke; James Edward,0,3,25,25
1745139749877,BIPN 134,A02,895237,Cooke; James Edward,0,0,25,25
1745139749877,BIPN 134,A03,895240,Cooke; James Edward,13,0,25,12
1745139749877,BIPN 134,A04,895270,Cooke; James Edward,24,0,25,1
1745139750912,BIPN 189,A00,892103,Staff,0,20,9,9
1745139752968,CAT 124,A01,922009,Staff,0,1,20,20
1745139754008,CAT 125R,A00,886390,Morales; Celeste Georgianna,4,0,20,16
1745139754008,CAT 125R,B00,886391,Irwin; Matthew Joseph,0,1,20,20
1745139754008,CAT 125R,C00,886392,Smith; Lauryn Alissa,11,0,20,9
1745139754008,CAT 125R,D00,886393,Vanderschuit; Maya Alysia,6,0,20,14
1745139754008,CAT 125R,E00,886394,Marchisotto; Jennifer Anne,0,2,20,20
1745139755043,CENG 15,A01,886218,Drews; Aaron,1,0,5,4
1745139756074,CENG 113,A00,886219,Opatkiewicz; Justin Paul,16,0,25,9
1745139757104,CGS 101,A00,887044,Staff,13,0,20,7
1745139758130,CGS 105,A01,887046,Staff,16,0,25,9
1745139759156,CGS 112,A00,887047,Cuong; Marisol,12,0,15,3
1745139760183,CGS 113,A00,887048,Staff,24,0,30,6
1745139761212,CGS 120,A00,887049,Staff,12,0,17,5
1745139762243,CHEM 6A,A01,886336,Lam; Tin Yiu,44,0,50,6
1745139762243,CHEM 6A,A02,886338,Lam; Tin Yiu,43,0,50,7
1745139763276,CHEM 6B,A01,886341,Hopkins; Patrycja Anna,21,0,50,29
1745139763276,CHEM 6B,A02,886343,Hopkins; Patrycja Anna,46,0,50,4
1745139764305,CHEM 6C,A01,886346,Albizati; Kim F.,0,1,50,50
1745139764305,CHEM 6C,A02,886348,Albizati; Kim F.,38,0,50,12
1745139765336,CHEM 40A,A01,886352,Klosterman; Jeremy K,70,0,100,30
1745139766365,CHEM 40B,A01,886356,Klosterman; Jeremy K,0,4,100,100
1745139767391,CHEM 41B,A01,886360,Theodorakis; Emmanuel,30,0,50,20
1745139767391,CHEM 41B,A02,886362,Theodorakis; Emmanuel,46,0,50,4
1745139768420,CHIN 165A,A00,886382,Xu; Li,19,0,20,1
1745139769453,CLAS 120,A00,886387,Myerston Santana; Jacobo,36,0,40,4
1745139770480,COGS 9,A01,886967,Shannon; Kyle Michael,49,0,60,11
1745139771511,COGS 11,A01,886969,Staff,18,0,30,12
1745139772543,COGS 14A,A01,886971,Staff,26,0,60,34
1745139773569,COGS 14B,A01,886973,Hoffman; Drew Ellen,18,0,60,42
1745139774597,COGS 18,A01,886975,Morgan; Eric,41,0,60,19
1745139775624,COGS 20,A01,886977,Staff,6,0,8,2
1745139775624,COGS 20,A02,886978,Staff,6,0,7,1
1745139776650,COGS 100,A01,907783,Staff,6,0,30,24
1745139777675,COGS 101B,A01,886980,Staff,0,10,30,30
1745139778709,COGS 101C,A01,886982,Delgado; Tania,0,6,30,30
1745139779742,COGS 102A,A01,886984,Johnson; Christine M.,13,0,30,17
1745139780768,COGS 118B,A01,886986,Staff,0,25,60,60
1745139781795,COGS 150,A01,886988,Bergen; Benjamin,16,0,30,14
1745139782821,COGS 153,A00,886989,Delgado; Tania,0,6,30,30
1745139783848,COGS 186,A01,886991,Staff,3,0,30,27
1745139784873,COGS 187A,A01,886993,Boyle; Mary E. T.,12,0,30,18
1745139785899,COGS 189,A00,886994,Staff,13,0,30,17
1745139786927,COMM 10,A01,886996,Staff,11,0,25,14
1745139786927,COMM 10,A02,886997,Staff,21,0,25,4
1745139787954,COMM 20,A01,886999,Leuning; Grant Maurstad,33,0,40,7
1745139790008,COMM 100A,A01,887002,Staff,0,0,25,25
1745139790008,COMM 100A,A02,887003,Staff,20,0,25,5
1745139791035,COMM 100B,A01,887005,Staff,0,1,25,25
1745139792060,COMM 106D,A00,887006,Staff,22,0,40,18
1745139793092,COMM 110G,A00,887007,Whitworth-Smith; Andrew C,17,0,40,23
1745139794120,COMM 111B,A00,887008,Staff,31,0,40,9
1745139795153,COMM 113T,A00,887009,Abuelhiga; Soraya Jill,30,0,40,10
1745139795153,COMM 113T,B00,906733,Staff,40,0,40,0
1745139796180,COMM 145,A00,887010,Staff,21,0,40,19
1745139797207,COMM 146,A00,887054,Staff,31,0,40,9
1745139798234,COMM 190,A00,887012,Staff,9,0,23,14
1745139799262,CSE 8A,A50,887015,Cao; Yingjun,68,0,85,17
1745139800289,CSE 11,A01,887017,Cao; Yingjun,35,0,70,35
1745139801316,CSE 20,A01,887019,Staff,35,0,50,15
1745139802345,CSE 21,A01,887021,Braun; Oliver,81,0,100,19
1745139802345,CSE 21,B01,892583,Staff,48,0,50,2
1745139803372,CSE 30,A01,887025,Eldon; John,161,0,200,39
1745139804400,CSE 100,A01,887027,Staff,28,0,50,22
1745139804400,CSE 100,A02,887028,Staff,43,0,50,7
1745139805427,CSE 101,A01,887030,Braun; Oliver,79,0,100,21
1745139805427,CSE 101,B01,887032,Jones; Miles E,0,1,50,50
1745139805427,CSE 101,B02,887033,Jones; Miles E,13,0,50,37
1745139806464,CSE 105,A01,908084,Jones; Miles E,36,0,50,14
1745139806464,CSE 105,A02,908087,Jones; Miles E,38,0,50,12
1745139807496,CSE 135,A01,887035,Powell; Thomas Allan,8,0,50,42
1745139808523,CSE 142,A01,887037,Staff,22,0,60,38
1745139809551,CSE 142L,A01,887039,Staff,42,0,60,18
1745139810584,CSE 151A,A01,887041,Solares; Edwin A,60,0,100,40
1745139811617,CSE 175,A01,887043,Kumar; Rakesh,30,0,30,0
1745139812650,CSS 1,A01,886389,Staff,12,0,40,28
1745139813683,DSC 30,A01,908097,Liao; Soohyun Nam,54,0,75,21
1745139814710,DSC 40A,A01,908099,Shannon; Kyle Michael,37,0,50,13
1745139815738,DSC 40B,A01,908112,Staff,28,0,50,22
1745139816764,DSC 80,A01,908116,Staff,32,0,60,28
1745139817791,DSC 197,001,956863,Eldridge; Justin Matthew,9999,0,9999,0
1745139818824,ECE 5,A01,886400,Morris; Karcher William,3,0,6,3
1745139818824,ECE 5,A02,886401,Morris; Karcher William,5,0,6,1
1745139819855,ECE 148,A01,886403,Silberman; Jack,0,8,14,14
1745139820883,ECON 1,A01,887265,Crane; Meredith Helen,25,0,70,45
1745139820883,ECON 1,B01,887268,Staff,44,0,50,6
1745139821916,ECON 2,A01,887273,Crane; Meredith Helen,61,0,70,9
1745139822943,ECON 3,A01,887279,Rondina; Giacomo,44,0,70,26
1745139823971,ECON 4,A01,887282,Anderson; John Charles,0,1,10,10
1745139825003,ECON 5,A01,887285,Staff,39,0,45,6
1745139825003,ECON 5,B01,887292,Staff,43,0,45,2
1745139826032,ECON 100A,A01,887337,Newhouse; Herbert S,58,0,70,12
1745139826032,ECON 100A,B01,887349,Staff,45,0,50,5
1745139827065,ECON 100B,A01,887361,Du; Songzi,42,0,70,28
1745139828144,ECON 100C,A01,887445,Newhouse; Herbert S,61,0,70,9
1745139829172,ECON 105,A00,887488,Vespa; Emanuel Ignacio,24,0,35,11
1745139830198,ECON 109,A01,887506,Staff,29,0,35,6
1745139831236,ECON 110A,A01,887568,Alon; Titan Michael,1,0,35,34
1745139831236,ECON 110A,B01,907601,Alon; Titan Michael,27,0,35,8
1745139832268,ECON 110B,A01,887598,Levkoff; Steven B.,0,7,70,70
1745139833296,ECON 112,A00,887599,Rondina; Giacomo,20,0,35,15
1745139834322,ECON 120A,A01,887603,Dai; Yinlin,46,0,70,24
1745139835358,ECON 120C,A01,887608,Sun; Yixiao,0,0,35,35
1745139835358,ECON 120C,B01,887614,Sun; Yixiao,13,0,35,22
1745139836391,ECON 138,A00,887621,Bharadwaj; Prashant,0,18,20,20
1745139837422,ECON 171,A01,907666,Staff,27,0,35,8
1745139838449,ECON 175,A00,887626,Wu; Pak Yeung,27,0,35,8
1745139839473,ECON 190,A00,887640,Vespa; Emanuel Ignacio,26,0,35,9
1745139840506,EDS 25,A01,888197,Staff,0,0,0,0
1745139840506,EDS 25,A02,888209,Staff,0,0,0,0
1745139840506,EDS 25,A03,888210,Staff,0,0,0,0
1745139840506,EDS 25,A04,888212,Staff,0,0,0,0
1745139840506,EDS 25,A05,888213,Staff,0,0,0,0
1745139840506,EDS 25,A06,888214,Staff,0,0,0,0
1745139840506,EDS 25,A07,888235,Staff,0,0,0,0
1745139840506,EDS 25,A08,888236,Staff,0,0,0,0
1745139840506,EDS 25,A09,888240,Staff,0,0,0,0
1745139840506,EDS 25,A10,888244,Staff,0,0,0,0
1745139840506,EDS 25,B01,888273,Staff,0,0,0,0
1745139840506,EDS 25,B02,888285,Staff,0,0,0,0
1745139840506,EDS 25,B03,888423,Staff,29,0,30,1
1745139840506,EDS 25,B04,888432,Staff,0,0,0,0
1745139840506,EDS 25,B05,888433,Staff,0,0,0,0
1745139840506,EDS 25,B06,888467,Staff,0,0,0,0
1745139840506,EDS 25,B07,888468,Staff,0,0,0,0
1745139840506,EDS 25,B08,888479,Staff,0,0,0,0
1745139840506,EDS 25,B09,888484,Staff,0,0,0,0
1745139840506,EDS 25,B10,888487,Staff,0,0,0,0
1745139841534,EDS 38,A01,907700,Choi; Bailey Miyeon,30,0,30,0
1745139842568,EDS 112,A01,888601,Chapman; Thandeka K,23,0,40,17
1745139843603,EDS 115,A00,888697,Mendez; Kathrina Mendoza,17,0,30,13
1745139844631,EDS 116,A01,888893,Staff,38,0,40,2
1745139846689,EDS 124AR,A00,889133,Staff,33,0,50,17
1745139846689,EDS 124AR,B00,907471,Simon; Elizabeth A,42,0,50,8
1745139847719,EDS 124BR,A00,889134,Staff,57,0,100,43
1745139848750,EDS 125,A00,889135,Staff,26,0,30,4
1745139849782,EDS 126,A01,889138,Staff,37,0,40,3
1745139850810,EDS 164R,A01,889142,Wishard Guerra; Alison G.,38,0,50,12
1745139851842,ENG 30,A01,886396,Staff,0,0,0,0
1745139851842,ENG 30,B01,886398,Staff,0,0,0,0
1745139852873,ENVR 102,A00,906150,Montejo; Carolina,23,0,25,2
1745139853907,ETHN 103A,A00,887236,Man; Simeon S,0,5,0,0
1745139854936,ETHN 113,A00,887239,Staff,20,0,30,10
1745139855962,ETHN 116,A00,887240,Staff,20,0,25,5
1745139856990,ETHN 117,A00,887241,Choi; Esther Min,27,0,30,3
1745139858017,ETHN 118,A00,887243,Staff,24,0,30,6
1745139859045,ETHN 127,A00,887248,Cuong; Marisol,12,0,15,3
1745139860072,ETHN 139,A00,887250,Staff,8,0,10,2
1745139861099,ETHN 142,A00,887252,Staff,18,0,30,12
1745139862130,ETHN 161,A00,887253,Browne; Errol Tsekani,28,0,30,2
1745139863158,ETHN 163FR,A00,887255,Burelle; Julie Sara Veronique,4,0,5,1
1745139864185,GLBH 20,A00,889149,Elwardani; Nile Regina,15,0,42,27
1745139866237,GLBH 111,A01,889152,Burgos; Jose L.,17,0,17,0
1745139867263,GLBH 150,A00,889181,Sloane; Julia Kathryn,0,1,15,15
1745139869316,HDS 60,A01,886406,Warstadt; Melissa Fawn,76,0,80,4
1745139870344,HIAF 111,A00,889324,Gyamfi; Bright,0,4,0,0
1745139871370,HIEA 131,A00,889328,Staff,14,0,32,18
1745139872397,HIEA 144,A00,889333,Henry; Todd A.,29,0,32,3
1745139873427,HIEA 154,A00,889336,Henry; Todd A.,28,0,32,4
1745139874455,HIEU 106,A00,889339,Staff,28,0,32,4
1745139876508,HIEU 114,A00,889340,Staff,18,0,32,14
1745139877536,HIEU 135GS,A00,889342,Patterson; Patrick H.,0,0,1,22
1745139878562,HIEU 137,A00,889343,Edington; Claire Ellen,12,0,25,13
1745139879589,HIEU 148,A00,889345,Staff,16,0,32,16
1745139880621,HIEU 154,A00,889346,Biess; Frank Peter,24,0,32,8
1745139881661,HILA 102,A00,889351,Staff,13,0,32,19
1745139882690,HILD 2A,A01,889221,Lewandoski; Julia Mavis,0,5,32,32
1745139883721,HILD 7B,A01,889225,Man; Simeon S,0,7,32,32
1745139884747,HILD 7C,A01,889288,Alvarez; Luis A,0,8,32,32
1745139885774,HILD 30,A01,889323,Staff,0,1,32,32
1745139887835,HISC 119,A00,889383,Golan; Tal,22,0,32,10
1745139888863,HIUS 103,A00,889384,Man; Simeon S,10,0,32,22
1745139889896,HIUS 117,A00,919797,Kwak; Nancy,23,0,32,9
1745139890923,HIUS 142A,A00,919788,Staff,24,0,32,8
1745139892981,HIUS 149,A00,889386,Gyamfi; Bright,0,1,0,0
1745139894007,HIUS 155,A00,889387,Alvarez; Luis A,19,0,32,13
1745139895040,HUM 3,A01,886499,Caldwell; Michael Alan,24,0,50,26
1745139896070,HUM 3GS,A00,886500,Rodriguez; Bretton Sigfred,0,0,0,26
1745139897099,HUM 3R,A01,886502,Markman; Kristina,0,32,50,50
1745139898126,HUM 4,A01,886504,Crum; Matthew Stephen,28,0,50,22
1745139898126,HUM 4,B01,886506,West; Geoffrey Scott,25,0,50,25
1745139899192,HUM 4GS,A00,886507,Staff,0,0,0,13
1745139900220,HUM 5,A01,886509,Staff,35,0,50,15
1745139901248,HUM 5R,A01,886511,Zavodny; Tatiana Sophia,0,32,50,50
1745139902276,JAPN 180,A00,886407,Staff,25,0,40,15
1745139903303,LATI 50,A01,886409,Martin-Cabrera; Luis,9,0,22,13
1745139903303,LATI 50,A02,886410,Martin-Cabrera; Luis,20,0,22,2
1745139903303,LATI 50,A03,886411,Martin-Cabrera; Luis,22,0,22,0
1745139903303,LATI 50,A04,886412,Martin-Cabrera; Luis,15,0,22,7
1745139904331,LAWS 101,A00,907664,Staff,36,0,60,24
1745139905360,LIAB 1A,A00,889388,Saab; Dima,19,0,20,1
1745139906386,LIAB 1AX,A00,889389,El Cheddadi; Youniss,19,0,20,1
1745139907413,LIFR 1C,A00,889391,Van Moer; Vinciane G,9,0,20,11
1745139908440,LIFR 1CX,A00,889392,Van Moer; Vinciane G,8,0,20,12
1745139909465,LIFR 1D,A00,889393,Van Moer; Vinciane G,11,0,20,9
1745139910498,LIFR 1DX,A00,889394,Van Moer; Vinciane G,11,0,20,9
1745139911529,LIGN 7,A00,886923,Staff,30,0,50,20
1745139912555,LIGN 17,A00,886924,Kehler; Andrew Scott,133,0,150,17
1745139913582,LTAM 110,A00,889395,Staff,17,0,30,13
1745139914611,LTCH 101,A00,889397,Staff,22,0,25,3
1745139915638,LTCS 130,A00,889398,Staff,23,0,25,2
1745139916665,LTEA 138,A00,889399,Staff,25,0,40,15
1745139917692,LTEN 149,A00,889400,Wesling; Megan E.,6,0,25,19
1745139918720,LTEN 169,A00,889401,Staff,24,0,25,1
1745139919748,LTEN 180,A00,889402,Staff,12,0,15,3
1745139920777,LTEN 181,A00,889403,Staff,23,0,25,2
1745139921804,LTWL 100,A00,889404,Myerston Santana; Jacobo,8,0,25,17
1745139922834,LTWL 180GS,A00,889405,Staff,6,0,20,14
1745139923865,LTWL 181,A00,889406,Staff,19,0,25,6
1745139924893,LTWL 184,A00,889475,Mukherjee; Silpa,21,0,25,4
1745139925922,LTWR 102C,A00,889486,Staff,29,0,30,1
1745139926950,LTWR 115W,A00,889491,Staff,3,0,15,12
1745139927976,MAE 8,A01,886905,Staff,0,2,0,0
1745139929006,MAE 11,A00,886906,Bandaru; Prabhakar,0,0,50,50
1745139930032,MAE 20,A00,886907,Evdokimenko; Ekaterina,50,0,70,20
1745139931065,MAE 30B,A00,886909,Ghazinejad; Maziar,28,0,45,17
1745139932093,MAE 101B,A00,886910,Saintillan; David,36,0,45,9
1745139933118,MAE 105,A00,886911,Bandaru; Prabhakar,26,0,50,24
1745139934145,MAE 107,A00,886912,Staff,22,0,60,38
1745139935179,MAE 143B,A00,886913,Bewley; Thomas R,14,0,40,26
1745139936206,MAE 148,A01,886915,Silberman; Jack,5,0,14,9
1745139937236,MAE 160,A00,886916,Evdokimenko; Ekaterina,41,0,60,19
1745139938265,MATH 3C,A01,889681,Staff,2,0,30,28
1745139939294,MATH 10A,A01,889760,Staff,28,0,30,2
1745139939294,MATH 10A,A02,889783,Staff,30,0,30,0
1745139940324,MATH 10B,A01,889785,Verstraete; Jacques Allan,0,2,30,30
1745139940324,MATH 10B,A02,889795,Verstraete; Jacques Allan,0,2,30,30
1745139940324,MATH 10B,B01,889797,Verstraete; Jacques Allan,0,0,30,30
1745139940324,MATH 10B,B02,889828,Verstraete; Jacques Allan,23,0,30,7
1745139941355,MATH 10C,A01,889849,Habib; Yousaf,18,0,30,12
1745139941355,MATH 10C,A02,889852,Habib; Yousaf,20,0,30,10
1745139941355,MATH 10C,A03,889853,Habib; Yousaf,25,0,30,5
1745139941355,MATH 10C,A04,889858,Habib; Yousaf,21,0,30,9
1745139941355,MATH 10C,B01,889861,Staff,12,0,30,18
1745139941355,MATH 10C,B02,889862,Staff,26,0,30,4
1745139941355,MATH 10C,B03,889863,Staff,28,0,30,2
1745139941355,MATH 10C,B04,889967,Staff,25,0,30,5
1745139942390,MATH 18,A01,889974,Staff,15,0,30,15
1745139942390,MATH 18,A02,889977,Staff,25,0,30,5
1745139942390,MATH 18,B01,889984,Hardiman; Liam,26,0,30,4
1745139942390,MATH 18,B02,889985,Hardiman; Liam,28,0,30,2
1745139943417,MATH 20A,A01,889990,Suk; Andrew Hoon,31,0,35,4
1745139944447,MATH 20B,A01,889993,Ohm; Ko Woon,21,0,30,9
1745139944447,MATH 20B,A02,889994,Ohm; Ko Woon,30,0,30,0
1745139944447,MATH 20B,B01,889996,Ohm; Ko Woon,25,0,30,5
1745139944447,MATH 20B,B02,889997,Ohm; Ko Woon,24,0,30,6
1745139945482,MATH 20C,A01,889999,Hammock; Frances H,22,0,30,8
1745139945482,MATH 20C,A02,890003,Hammock; Frances H,23,0,30,7
1745139945482,MATH 20C,B01,890006,Hammock; Frances H,11,0,30,19
1745139945482,MATH 20C,B02,890007,Hammock; Frances H,18,0,30,12
1745139946511,MATH 20D,A01,890011,Cheng; Hsiao-Bing,6,0,30,24
1745139946511,MATH 20D,A02,890012,Cheng; Hsiao-Bing,27,0,30,3
1745139946511,MATH 20D,B01,890016,Cheng; Hsiao-Bing,19,0,30,11
1745139946511,MATH 20D,B02,890017,Cheng; Hsiao-Bing,15,0,30,15
1745139947551,MATH 20E,A01,890026,Harel; Guershon,10,0,30,20
1745139947551,MATH 20E,A02,890029,Harel; Guershon,24,0,30,6
1745139947551,MATH 20E,B01,890033,Harel; Guershon,14,0,30,16
1745139947551,MATH 20E,B02,890101,Harel; Guershon,27,0,30,3
1745139948581,MATH 102,A01,890104,Staff,20,0,30,10
1745139948581,MATH 102,A02,890105,Staff,30,0,30,0
1745139949617,MATH 103B,A01,890116,Salehi Golsefidy; Alireza,8,0,30,22
1745139949617,MATH 103B,B01,890118,Staff,0,4,30,30
1745139950646,MATH 109,A01,890121,Aliabadi Sr.; Mohsen,6,0,30,24
1745139950646,MATH 109,B01,890124,Upadrashta; Pranav Kumar,23,0,30,7
1745139951674,MATH 120A,A01,890126,Eggers; John Dietrich,15,0,30,15
1745139952702,MATH 142B,A01,890128,Ioana; Adrian,17,0,30,13
1745139952702,MATH 142B,A02,890129,Ioana; Adrian,15,0,30,15
1745139953734,MATH 154,A01,890174,Staff,0,1,30,30
1745139953734,MATH 154,A02,890182,Staff,15,0,30,15
1745139954762,MATH 168A,A01,890197,Dumitriu; Ioana,22,0,35,13
1745139955798,MATH 170A,A01,890240,Nie; Jiawang,6,0,30,24
1745139955798,MATH 170A,A02,890241,Nie; Jiawang,18,0,30,12
1745139955798,MATH 170A,A03,890249,Nie; Jiawang,23,0,30,7
1745139956825,MATH 170B,A01,957891,Nag; Panchali,25,0,35,10
1745139958882,MATH 181A,A01,908025,Staff,0,8,35,35
1745139959909,MATH 193B,A01,890265,Staff,3,0,35,32
1745139960937,MGT 4,A01,890311,Anderson; John Charles,57,0,88,31
1745139961968,MGT 5,A00,907740,Staff,41,0,98,57
1745139962996,MGT 12,A00,890312,Lindenberger; Wade Douglas,70,0,98,28
1745139964022,MGT 16,A00,957883,Staff,84,0,98,14
1745139966076,MGT 45,A00,890314,Pecore; Joseph P.,57,0,98,41
1745139967103,MGT 71,A00,890315,Staff,6,0,98,92
1745139968135,MGT 100,A00,890316,Yavorsky; Daniel Ryan,59,0,98,39
1745139969161,MGT 103,A00,890317,Ehrich; Kristine R,77,0,98,21
1745139970187,MGT 105,A00,890356,Bates; Kenneth Walter,19,0,98,79
1745139971217,MGT 112,A00,890360,Ehrich; Kristine R,65,0,98,33
1745139972245,MGT 127R,A00,907732,Zhu; Kevin Xiaoguo,32,0,98,66
1745139973270,MGT 131B,A00,890361,Anderson; John Charles,75,0,98,23
1745139974296,MGT 137,A00,890362,Lindenberger; Wade Douglas,68,0,98,30
1745139975328,MGT 160,A00,890369,Johnson; Erik Barry,37,0,98,61
1745139977378,MGT 164,A00,890372,Zimmermann; Carsten,0,28,98,98
1745139978405,MGT 180,A00,890374,Bliss; Barbara Ann,32,0,98,66
1745139979439,MMW 15,A01,886414,Chang; Edmond Yi-Teh,0,10,28,28
1745139979439,MMW 15,A02,886415,Chang; Edmond Yi-Teh,0,10,28,28
1745139979439,MMW 15,A03,886416,Chang; Edmond Yi-Teh,0,8,28,28
1745139979439,MMW 15,A04,886417,Chang; Edmond Yi-Teh,0,8,28,28
1745139979439,MMW 15,B01,886419,Chang; Edmond Yi-Teh,0,8,28,28
1745139979439,MMW 15,B02,886420,Chang; Edmond Yi-Teh,0,9,28,28
1745139979439,MMW 15,B03,886421,Chang; Edmond Yi-Teh,0,9,28,28
1745139979439,MMW 15,B04,886422,Chang; Edmond Yi-Teh,0,9,28,28
1745139979439,MMW 15,C01,886424,Staff,0,10,28,28
1745139979439,MMW 15,C02,886425,Staff,0,10,28,28
1745139979439,MMW 15,C03,886426,Staff,0,9,28,28
1745139979439,MMW 15,C04,886427,Staff,0,9,28,28
1745139980467,MMW 15GS,A00,906910,Patterson; Patrick H.,5,0,28,23
1745139981494,MMW 122R,A01,886429,Rahimi; Babak,0,23,28,28
1745139981494,MMW 122R,A02,886430,Rahimi; Babak,0,23,28,28
1745139982533,MUS 1A,A01,890937,Staff,8,0,25,17
1745139982533,MUS 1A,A02,891035,Staff,15,0,25,10
1745139982533,MUS 1A,B00,907849,Staff,48,0,50,2
1745139982533,MUS 1A,B01,907850,Staff,25,0,25,0
1745139982533,MUS 1A,B02,907851,Staff,25,0,25,0
1745139984592,MUS 2AK,A00,957092,Ohnishi; Takae,15,0,15,0
1745139985619,MUS 4,A01,891044,Staff,6,0,25,19
1745139985619,MUS 4,A02,891045,Staff,24,0,25,1
1745139985619,MUS 4,B01,891048,Staff,20,0,25,5
1745139985619,MUS 4,B02,891050,Staff,25,0,25,0
1745139986651,MUS 5,A01,957506,Dubnov; Shlomo,4,0,25,21
1745139986651,MUS 5,A02,957622,Dubnov; Shlomo,21,0,25,4
1745139986651,MUS 5,A03,957623,Dubnov; Shlomo,23,0,25,2
1745139987678,MUS 6,A01,891053,Freitas Caetano; Marcelo,23,0,25,2
1745139987678,MUS 6,A02,891054,Freitas Caetano; Marcelo,23,0,25,2
1745139988708,MUS 7,A01,891081,Staff,0,0,25,25
1745139988708,MUS 7,A02,891082,Staff,15,0,25,10
1745139989741,MUS 8GS,A00,891118,Borgo; David Garcia,5,0,25,20
1745139990767,MUS 11,A01,891140,Staff,12,0,25,13
1745139990767,MUS 11,A02,891141,Staff,24,0,25,1
1745139991796,MUS 13,A01,891143,Staff,10,0,25,15
1745139991796,MUS 13,A02,891144,Staff,25,0,25,0
1745139992823,MUS 15,A01,891146,Staff,7,0,25,18
1745139992823,MUS 15,A02,891148,Staff,22,0,25,3
1745139992823,MUS 15,B01,891150,Staff,18,0,25,7
1745139992823,MUS 15,B02,891151,Staff,25,0,25,0
1745139993851,MUS 20,A01,891153,Staff,9,0,20,11
1745139993851,MUS 20,A02,891155,Staff,16,0,20,4
1745139994878,MUS 80,A00,891156,Staff,19,0,25,6
1745139994878,MUS 80,B00,891157,Staff,25,0,25,0
1745139995904,MUS 130,A00,891158,Ohnishi; Takae,35,0,35,0
1745139996928,MUS 150GS,A01,891160,Borgo; David Garcia,5,0,25,20
1745139997959,MUS 170,A01,891162,Freitas Caetano; Marcelo,21,0,25,4
1745139997959,MUS 170,A02,891164,Freitas Caetano; Marcelo,22,0,25,3
1745139998988,NANO 11,A00,886220,Vazquez Mena; Oscar,12,0,15,3
1745140000015,NANO 15,A01,886222,Drews; Aaron,9,0,10,1
1745140001044,NANO 104,A00,886224,Sirbuly; Donald,18,0,25,7
1745140002073,PH 40,A00,886528,Staff,29,0,40,11
1745140003147,PH 45,A01,886799,Staff,36,0,40,4
1745140004175,PH 110,A00,886802,Staff,7,0,40,33
1745140005207,PH 172,A00,906716,Staff,20,0,35,15
1745140006237,PH 191,A00,886803,Staff,23,0,40,17
1745140007264,PHIL 1,A00,889500,Staff,22,0,30,8
1745140008291,PHIL 10,A01,889549,Grush; Rick Scott,17,0,22,5
1745140008291,PHIL 10,A02,889551,Grush; Rick Scott,20,0,22,2
1745140009321,PHIL 28,A01,889559,Lamey; Andy M.,0,4,25,25
1745140009321,PHIL 28,A02,889561,Lamey; Andy M.,0,0,25,25
1745140009321,PHIL 28,A03,889572,Lamey; Andy M.,7,0,25,18
1745140010348,PHIL 35,A00,907839,Staff,32,0,33,1
1745140011377,PHIL 60,A00,889574,Staff,79,0,90,11
1745140012409,PHIL 105,A00,889579,Staff,0,1,0,0
1745140013441,PHIL 136,A00,889582,Fulkerson; Matthew Todd,27,0,45,18
1745140014478,PHIL 163,A01,889601,Staff,24,0,30,6
1745140014478,PHIL 163,B01,889606,Brandt; Reuven A,0,2,0,0
1745140015504,PHIL 164,A00,889610,Staff,20,0,30,10
1745140016535,PHIL 165,A00,889613,Staff,26,0,30,4
1745140017567,PHYS 1A,A00,886431,Staff,38,0,70,32
1745140018593,PHYS 1AL,001,886432,Tsai; Philbert S,0,0,30,30
1745140018593,PHYS 1AL,002,886436,Tsai; Philbert S,19,0,30,11
1745140019621,PHYS 1B,A00,886439,Staff,192,0,240,48
1745140020652,PHYS 1BL,001,886441,Tsai; Philbert S,0,1,30,30
1745140020652,PHYS 1BL,002,886444,Tsai; Philbert S,14,0,30,16
1745140021681,PHYS 1C,A00,896092,Arnold; Kam S,87,0,146,59
1745140022709,PHYS 1CL,001,886448,Tsai; Philbert S,0,4,30,30
1745140022709,PHYS 1CL,002,886449,Tsai; Philbert S,6,0,30,24
1745140022709,PHYS 1CL,003,886450,Tsai; Philbert S,22,0,30,8
1745140022709,PHYS 1CL,004,886451,Tsai; Philbert S,16,0,30,14
1745140023739,PHYS 2B,A01,886457,Staff,86,0,115,29
1745140024766,PHYS 2C,A01,886460,Shotwell; Brian,0,0,65,65
1745140025792,PHYS 2CL,A01,886467,Staff,0,3,28,28
1745140025792,PHYS 2CL,A02,886468,Staff,5,0,28,23
1745140026820,PHYS 2D,A01,886470,Staff,17,0,50,33
1745140027847,PHYS 4B,A01,886475,Grinstein; Benjamin,88,0,100,12
1745140028875,POLI 5,A00,891173,Desposato; Scott,17,0,25,8
1745140029905,POLI 5D,A01,891175,Staff,5,0,5,0
1745140029905,POLI 5D,B01,891178,Staff,5,0,5,0
1745140030938,POLI 11,A00,891179,Ferree; Karen E,3,0,25,22
1745140031970,POLI 12,A00,891180,Staff,21,0,30,9
1745140032995,POLI 27,A01,891182,Staff,29,0,75,46
1745140034024,POLI 30,A00,891183,Staff,0,3,30,30
1745140035058,POLI 100B,A00,891244,Staff,0,8,20,20
1745140036089,POLI 100I,A00,891247,Staff,19,0,30,11
1745140037116,POLI 104J,A00,891248,Nichter; Maysa,18,0,30,12
1745140038142,POLI 104U,A00,891250,Nichter; Maysa,9,0,30,21
1745140039169,POLI 108,A00,891253,Staff,0,0,0,4
1745140040197,POLI 110B,A00,891255,Wiens; David,22,0,25,3
1745140041226,POLI 112A,A00,891256,Wiens; David,15,0,25,10
1745140042256,POLI 114BR,A00,891261,Staff,22,0,30,8
1745140043285,POLI 117R,A00,891262,Forman; Fonna,12,0,50,38
1745140044319,POLI 118,A00,891264,Ingham; Sean,22,0,25,3
1745140045346,POLI 124A,A00,891265,Staff,19,0,20,1
1745140046379,POLI 125D,A00,891266,Nichter; Simeon C,9,0,25,16
1745140047405,POLI 126,A00,891268,Nichter; Simeon C,11,0,25,14
1745140048436,POLI 126AA,A00,891272,Staff,19,0,25,6
1745140049466,POLI 130AA,A00,891273,Staff,17,0,20,3
1745140050495,POLI 134AA,A00,891274,Staff,12,0,20,8
1745140052548,POLI 138,A00,891278,Staff,22,0,25,3
1745140053575,POLI 142K,A00,891280,Staff,17,0,25,8
1745140054603,POLI 142M,A00,891281,Gartzke; Erik,22,0,30,8
1745140055629,POLI 142P,A00,891284,Staff,21,0,30,9
1745140056655,POLI 143,A00,891285,Gartzke; Erik,17,0,30,13
1745140057682,POLI 153,A00,891286,Staff,20,0,20,0
1745140058709,POLI 170A,A00,891288,Staff,19,0,25,6
1745140059733,POLI 175,A00,891290,Staff,18,0,20,2
1745140060802,PSYC 1,A00,890674,Steiner; Eric Tomas,0,4,45,45
1745140061834,PSYC 2,A00,890676,Albright; Thomas D,25,0,35,10
1745140062864,PSYC 3,A00,890679,Staff,18,0,20,2
1745140063891,PSYC 60,A01,890684,Rickard; Timothy C.,7,0,45,38
1745140064922,PSYC 70,A01,890689,Geller; Emma Harlan,14,0,30,16
1745140065950,PSYC 100,A00,890690,Lacefield; Katharine I,0,43,180,180
1745140066978,PSYC 102,A00,890695,Staff,25,0,40,15
1745140068005,PSYC 105,A00,890699,Geller; Emma Harlan,78,0,100,22
1745140069030,PSYC 106,A00,890701,Gorman; Michael R.,15,0,30,15
1745140070058,PSYC 108,A00,890704,Adrian; Julia Anna,0,23,50,50
1745140071088,PSYC 118,A01,890712,Staff,18,0,30,12
1745140072113,PSYC 124,A00,890716,Chapman; Eddie Nathaniel,36,0,60,24
1745140073139,PSYC 131,A00,890717,Anagnostaras; Stephan,6,0,80,74
1745140074166,PSYC 137,A00,890719,Winkielman; Piotr,0,2,30,30
1745140075194,PSYC 144,A00,890721,Adrian; Julia Anna,0,3,45,45
1745140076219,PSYC 162,A00,890805,Staff,21,0,75,54
1745140077245,PSYC 169,A00,890810,Staff,0,15,30,30
1745140078271,PSYC 172,A00,890814,Gorman; Michael R.,14,0,30,16
1745140079297,PSYC 181,A00,890818,Anagnostaras; Stephan,63,0,200,137
1745140080323,PSYC 189,A00,890823,Staff,11,0,30,19
1745140081358,PSYC 191,A00,890884,Rickard; Timothy C.,0,11,35,35
1745140082400,PSYC 193,A00,890913,Staff,22,0,30,8
1745140082400,PSYC 193,B00,890914,Chapman; Eddie Nathaniel,25,0,30,5
1745140083432,PSYC 193L,A01,890918,Lowe; Angela Beth,29,0,30,1
1745140083432,PSYC 193L,B01,890921,Hurwitz; Ethan Scott,28,0,30,2
1745140083432,PSYC 193L,C01,890928,Staff,30,0,30,0
1745140084467,RELI 149,A00,886806,Rahimi; Babak,23,0,40,17
1745140085495,SE 9,A01,886814,Staff,13,0,20,7
1745140086528,SE 101B,A01,886816,Chadha; Mayank,8,0,30,22
1745140087568,SE 110B,A00,886818,Zhu; Qiang,0,16,45,45
1745140088593,SE 125,A01,886830,Staff,10,0,30,20
1745140089660,SE 130B,A01,886835,Staff,19,0,40,21
1745140090686,SE 131A,A01,886838,Krysl; Petr,37,0,55,18
1745140091713,SE 154,A00,886840,Staff,35,0,50,15
1745140092743,SE 164GS,A01,886849,Staff,13,0,20,7
1745140093772,SE 167GS,A01,886853,Staff,13,0,20,7
1745140094802,SIO 25,A01,890107,Staff,23,0,30,7
1745140095830,SIO 45,A00,890109,Cook; Geoffrey W,137,0,200,63
1745140096857,SIO 109R,A00,890110,Forman; Fonna,0,11,20,20
1745140097884,SIO 187,A01,890114,Kacev; David,21,0,40,19
1745140098914,SOCI 1,A01,890431,Thorpe; Charles Robert,21,0,30,9
1745140098914,SOCI 1,A02,890518,Thorpe; Charles Robert,30,0,30,0
1745140099943,SOCI 2,A01,957978,Staff,0,0,0,0
1745140099943,SOCI 2,A02,957979,Staff,0,3,0,0
1745140100970,SOCI 20,A01,890523,Calderon-Zaks; Michael Aar,24,0,30,6
1745140100970,SOCI 20,A02,890526,Calderon-Zaks; Michael Aar,29,0,30,1
1745140101998,SOCI 30,A01,890533,Pardo Guerra; Juan Pablo,37,0,40,3
1745140103024,SOCI 40,A01,890535,Staff,32,0,45,13
1745140104051,SOCI 104Q,A00,890559,Staff,20,0,30,10
1745140105078,SOCI 106,A00,890560,Arnal; Maud Marie Leonie,22,0,30,8
1745140106109,SOCI 110,A00,890567,Holkenbrink-Monk; Charlene,22,0,30,8
1745140107134,SOCI 112,A00,890568,Victoria Torres; Pablo,0,0,45,45
1745140108159,SOCI 115,A00,890597,Arnal; Maud Marie Leonie,33,0,45,12
1745140110250,SOCI 121,A00,890604,Pardo Guerra; Juan Pablo,40,0,45,5
1745140111281,SOCI 126,A01,890608,Staff,8,0,10,2
1745140112310,SOCI 127,A00,890609,Staff,23,0,30,7
1745140113339,SOCI 131,A00,890610,Thorpe; Charles Robert,38,0,45,7
1745140114366,SOCI 135,A00,890615,Payne; Christine Anna,20,0,45,25
1745140115393,SOCI 139,A00,890620,Staff,43,0,45,2
1745140116419,SOCI 148E,A00,890622,Calderon-Zaks; Michael Aar,39,0,45,6
1745140117451,SOCI 150,A00,890623,Kohler; Kristopher M.,36,0,45,9
1745140118478,SOCI 157,A00,890625,Jules-Rosette; Bennetta W.,18,0,20,2
1745140119508,SOCI 160,A00,890627,Payne; Christine Anna,26,0,45,19
1745140120548,SYN 1,A00,886855,Fish; Gwendolyn Anne,0,0,0,0
1745140120548,SYN 1,B00,906086,Fish; Gwendolyn Anne,0,0,0,2
1745140121575,SYN 2R,A00,886860,Staff,0,15,15,15
1745140121575,SYN 2R,B00,906106,Atkinson; Arthur Laird,0,14,15,15
1745140122606,SYN 100,A01,886866,Browne; Emily,0,29,20,20
1745140122606,SYN 100,B01,906128,Rock; Martin,0,4,20,20
1745140122606,SYN 100,C01,906140,Deavenport; James Cary,0,2,20,20
1745140122606,SYN 100,D01,907816,Deavenport; James Cary,0,3,20,20
1745140123634,TDAC 1,A00,890286,Walsh; Kim C.,11,0,20,9
1745140124665,TDAC 101,A00,890296,Basso; Beatrice,18,0,20,2
1745140125690,TDDE 131,A00,890297,Staff,47,0,50,3
1745140126721,TDDM 1,A00,890287,Weinberg; Sadie,26,0,30,4
1745140127756,TDGE 11,A00,890288,Fulton; Julia,155,0,200,45
1745140127756,TDGE 11,B00,890289,Castro; Robert Jess,188,0,200,12
1745140128784,TDGE 25,B00,957359,Walsh; Kim C.,9,0,20,11
1745140129814,TDGE 40,A01,890292,Power; Jade Yukana,28,0,30,2
1745140130841,TDGE 124,A00,890298,Havis; Allan,12,0,50,38
1745140131870,TDGE 131R,A00,890299,Burelle; Julie Sara Veronique,20,0,42,22
1745140132898,TDHT 101,A00,890300,Staff,12,0,20,8
1745140133923,TDHT 109,A01,890302,Anderson; Mysia Anyse,31,0,40,9
1745140134950,TDMV 1,A00,890293,Arcidiacono; Kristin,20,0,30,10
1745140135977,TDMV 2,A00,890294,Weinberg; Sadie,26,0,30,4
1745140137008,TDMV 3,A00,957878,Arcidiacono; Kristin,27,0,30,3
1745140139060,TDMV 138,A00,890304,Jun; Grace Shin Hae,25,0,40,15
1745140140087,TDMV 140,A00,890305,Corrales; Joseph Bernales,28,0,30,2
1745140141113,TDMV 142,A00,890307,Caligagan; Tony,30,0,40,10
1745140142142,TDMV 144,A00,890308,Camaya; Michelle Ann,26,0,30,4
1745140143174,TDPW 1,A00,890295,Stein; Deborah Isobel,5,0,20,15
1745140144200,USP 2,A01,890272,Lerner; Amy M,8,0,20,12
1745140145228,USP 3,A01,890274,Staff,21,0,30,9
1745140146257,USP 15,A01,890276,Sun; Feiyang,21,0,30,9
1745140147284,USP 25,A00,890277,Shenkman; Michael Thomas,21,0,25,4
1745140148311,USP 138,A00,890278,Staff,15,0,25,10
1745140149345,USP 143,A00,890279,Staff,30,0,70,40
1745140150372,USP 144,A00,890280,Chowdhury; Muhammed Zohir,19,0,30,11
1745140151405,USP 150,A00,890281,Boomhower; Matthew Charles,19,0,30,11
1745140152433,USP 151,A00,890282,Staff,17,0,20,3
1745140153459,USP 162,A00,890283,Andrews; Abigail Leslie,17,0,20,3
1745140154487,USP 168,A00,920477,Kwak; Nancy,2,0,5,3
1745140155514,USP 181,A00,890284,Staff,11,0,20,9
1745140156540,USP 191A,A00,890285,Staff,15,0,20,5
1745140157567,VIS 101,A00,886512,Staff,37,0,75,38
1745140158598,VIS 103,A00,886513,Cruz; Edwin Teddy,65,0,75,10
1745140159623,VIS 108,A00,886514,Staff,7,0,15,8
1745140160655,VIS 127P,A00,886515,Shen; Kuiyi,92,0,146,54
1745140161682,VIS 149,A00,886516,Yoldas; Pinar,1,0,15,14
1745140162709,VIS 164,A00,886526,Erdmann; Dean,21,0,22,1
1745140163736,VIS 194S,A00,886527,Staff,61,0,75,14
1745140164770,WCWP 10A,C00,886484,Staff,13,0,15,2
1745140165801,WCWP 10B,A00,886490,Staff,5,0,15,10
1745140165801,WCWP 10B,B00,886491,Staff,0,1,0,0
1745140165801,WCWP 10B,C00,886492,Staff,10,0,15,5
1745140166828,WCWP 100,A00,886494,Staff,0,2,15,15
1745140169044,AAS 10,A01,886199,Childs; Dennis R.,0,2,0,0
1745140170080,ANAR 104,A01,886940,Shtienberg; Gilad,27,0,30,3
1745140171112,ANAR 120,A00,886953,Staff,13,0,20,7
1745140172146,ANBI 148,A01,886955,Wilder; Linnea Lorene,32,0,40,8
1745140174202,ANSC 122,A00,886957,Staff,28,0,30,2
1745140175229,ANSC 150,A00,886958,Sloane; Julia Kathryn,6,0,15,9
1745140176257,ANSC 156,A00,886959,Jenkins; Janis A.,2,0,15,13
1745140177287,ANSC 180,A00,886960,Staff,12,0,17,5
1745140178319,ANSC 188,A00,886961,Jassal; Aftab,10,0,25,15
1745140179345,ANSC 190,A00,886962,Jassal; Aftab,14,0,25,11
1745140180374,ANSC 191,A00,886963,Staff,18,0,20,2
1745140181404,ANTH 3,A01,891689,Staff,19,0,20,1
1745140182431,ANTH 5,A00,886933,Semendeferi; Ekaterini,18,0,20,2
1745140183462,ANTH 10,A00,886934,Staff,0,9,30,30
1745140184488,ANTH 21,A01,886936,Staff,44,0,60,16
1745140185521,ANTH 23,A01,886938,Staff,94,0,100,6
1745140186552,ANTH 105,A00,886964,Stewart; Alexander B,94,0,100,6
1745140187584,ANTH 108,A00,886965,Pedersen; David,10,0,20,10
1745140188625,AWP 10,001,886147,Staff,0,0,0,0
1745140188625,AWP 10,002,886148,Staff,0,0,0,0
1745140188625,AWP 10,003,886149,Staff,0,0,0,0
1745140188625,AWP 10,004,886150,Staff,0,0,0,0
1745140188625,AWP 10,005,886151,Staff,0,0,0,0
1745140188625,AWP 10,006,886152,Staff,0,0,0,0
1745140188625,AWP 10,007,886153,Staff,0,0,0,0
1745140188625,AWP 10,008,886154,Staff,0,0,0,0
1745140188625,AWP 10,009,886155,Staff,0,0,0,0
1745140188625,AWP 10,010,886156,Staff,0,0,0,0
1745140188625,AWP 10,011,886158,Staff,0,0,0,0
1745140188625,AWP 10,012,886160,Staff,0,0,0,0
1745140188625,AWP 10,013,886161,Staff,0,0,0,0
1745140188625,AWP 10,014,886162,Staff,0,0,0,0
1745140188625,AWP 10,015,886163,Staff,0,0,0,0
1745140188625,AWP 10,016,886164,Staff,0,0,0,0
1745140188625,AWP 10,017,886165,Staff,0,0,0,0
1745140188625,AWP 10,018,886166,Staff,0,0,0,0
1745140188625,AWP 10,019,886168,Staff,0,0,0,0
1745140188625,AWP 10,020,886170,Staff,0,0,0,0
1745140188625,AWP 10,021,886172,Staff,0,0,0,0
1745140189656,AWP 10R,001,886173,Staff,0,0,0,0
1745140189656,AWP 10R,002,886174,Staff,0,1,0,0
1745140189656,AWP 10R,003,886175,Staff,0,0,0,0
1745140189656,AWP 10R,004,886176,Staff,0,0,0,0
1745140189656,AWP 10R,005,886177,Staff,0,0,0,0
1745140189656,AWP 10R,006,886178,Staff,0,0,0,0
1745140189656,AWP 10R,007,886179,Staff,0,0,0,0
1745140189656,AWP 10R,008,886181,Staff,0,0,0,0
1745140189656,AWP 10R,009,886182,Staff,0,0,0,0
1745140189656,AWP 10R,010,886183,Staff,0,0,0,0
1745140189656,AWP 10R,011,886184,Staff,0,0,0,0
1745140189656,AWP 10R,012,886185,Staff,0,0,0,0
1745140189656,AWP 10R,013,886186,Staff,0,0,0,0
1745140189656,AWP 10R,014,886187,Staff,0,0,0,0
1745140189656,AWP 10R,015,886188,Staff,0,0,0,0
1745140189656,AWP 10R,016,886189,Staff,0,0,0,0
1745140190682,AWP 102R,A00,886190,Staff,0,0,0,0
1745140190682,AWP 102R,B00,886191,Staff,0,0,0,0
1745140191713,BENG 100,A01,886193,Staff,19,0,30,11
1745140192746,BENG 122A,A01,886195,Hasty; Jeff M,20,0,30,10
1745140193778,BENG 166A,A00,886196,Sah; Robert Lie-Yuan,0,3,20,20
1745140194811,BIBC 102,A01,894320,Staff,0,2,46,46
1745140194811,BIBC 102,A02,894321,Staff,0,0,46,46
1745140194811,BIBC 102,A03,894344,Staff,21,0,46,25
1745140194811,BIBC 102,A04,894345,Staff,30,0,47,17
1745140195840,BICD 100R,A01,894365,Smith; Laurie,1,3,58,57
1745140195840,BICD 100R,A02,894366,Smith; Laurie,0,1,58,58
1745140195840,BICD 100R,A03,894367,Smith; Laurie,13,0,59,46
1745140196870,BICD 136,A01,894383,Gustafson-Brown; Cindy,16,0,50,34
1745140197901,BIEB 102,A01,894494,Butler; Shannon Rhey,67,0,130,63
1745140199979,BIEB 150,A01,894617,Wills; Christopher,0,3,13,13
1745140199979,BIEB 150,A02,894631,Wills; Christopher,0,3,13,13
1745140199979,BIEB 150,A03,894937,Wills; Christopher,0,3,13,13
1745140199979,BIEB 150,A04,894946,Wills; Christopher,0,1,11,11
1745140201005,BIEB 194,A00,906141,Kurle; Carolyn M.,14,0,20,6
1745140202039,BILD 1,A01,894154,Staff,8,0,19,11
1745140202039,BILD 1,A02,894155,Staff,15,0,19,4
1745140202039,BILD 1,A03,894160,Staff,18,0,19,1
1745140202039,BILD 1,A04,894161,Staff,16,0,18,2
1745140203065,BILD 2,A01,894168,Staff,0,0,50,50
1745140203065,BILD 2,A02,894169,Staff,0,0,50,50
1745140203065,BILD 2,A03,894179,Staff,27,0,50,23
1745140203065,BILD 2,A04,894203,Staff,42,0,50,8
1745140204096,BILD 3,A01,894213,Staff,24,0,31,7
1745140204096,BILD 3,A02,894214,Staff,28,0,31,3
1745140204096,BILD 3,A03,894235,Staff,30,0,31,1
1745140204096,BILD 3,A04,894236,Staff,29,0,32,3
1745140205129,BILD 4,A01,894253,Reuther; Keefe,12,0,24,12
1745140205129,BILD 4,A02,894258,Reuther; Keefe,19,0,24,5
1745140206161,BILD 5,A01,894276,Reuther; Keefe,40,0,50,10
1745140206161,BILD 5,A02,894277,Reuther; Keefe,48,0,50,2
1745140206161,BILD 5,A03,894290,Reuther; Keefe,47,0,50,3
1745140206161,BILD 5,A04,894291,Reuther; Keefe,50,0,50,0
1745140207190,BILD 24,A01,894297,Pirino; Giorgia,46,0,60,14
1745140208221,BIMM 100,A01,895012,Staff,0,14,0,1
1745140208221,BIMM 100,A02,895013,Staff,0,6,0,2
1745140208221,BIMM 100,A03,895014,Staff,0,7,0,0
1745140208221,BIMM 100,A04,895015,Staff,0,4,0,0
1745140209250,BIMM 101,A01,895017,McDonnell; Lisa Marie,0,2,24,24
1745140209250,BIMM 101,A02,895018,McDonnell; Lisa Marie,0,1,24,24
1745140209250,BIMM 101,B01,895020,McDonnell; Lisa Marie,0,3,24,24
1745140209250,BIMM 101,B02,895021,McDonnell; Lisa Marie,0,2,24,24
1745140210279,BIMM 110,A01,895023,Staff,7,0,25,18
1745140210279,BIMM 110,A02,895024,Staff,11,0,25,14
1745140210279,BIMM 110,A03,895025,Staff,22,0,25,3
1745140210279,BIMM 110,A04,895031,Staff,21,0,25,4
1745140211309,BIMM 120,A01,895114,Gustafson-Brown; Cindy,8,0,28,20
1745140211309,BIMM 120,A02,895126,Gustafson-Brown; Cindy,19,0,27,8
1745140212343,BIPN 100,A01,895130,Yang; Mingyu,13,0,38,25
1745140212343,BIPN 100,A02,895131,Yang; Mingyu,33,0,38,5
1745140212343,BIPN 100,A03,895132,Yang; Mingyu,33,0,38,5
1745140212343,BIPN 100,A04,895133,Yang; Mingyu,30,0,36,6
1745140213375,BIPN 120,A01,895135,Cooke; James Edward,0,3,13,13
1745140213375,BIPN 120,A02,895136,Cooke; James Edward,0,1,13,13
1745140213375,BIPN 120,A03,895137,Cooke; James Edward,0,0,13,13
1745140213375,BIPN 120,A04,895156,Cooke; James Edward,4,0,11,7
1745140214405,BIPN 134,A01,895235,Cooke; James Edward,0,3,25,25
1745140214405,BIPN 134,A02,895237,Cooke; James Edward,0,0,25,25
1745140214405,BIPN 134,A03,895240,Cooke; James Edward,13,0,25,12
1745140214405,BIPN 134,A04,895270,Cooke; James Edward,24,0,25,1
1745140215437,BIPN 189,A00,892103,Staff,0,20,9,9
1745140217499,CAT 124,A01,922009,Staff,0,1,20,20
1745140218536,CAT 125R,A00,886390,Morales; Celeste Georgianna,4,0,20,16
1745140218536,CAT 125R,B00,886391,Irwin; Matthew Joseph,0,1,20,20
1745140218536,CAT 125R,C00,886392,Smith; Lauryn Alissa,11,0,20,9
1745140218536,CAT 125R,D00,886393,Vanderschuit; Maya Alysia,6,0,20,14
1745140218536,CAT 125R,E00,886394,Marchisotto; Jennifer Anne,0,2,20,20
1745140219564,CENG 15,A01,886218,Drews; Aaron,1,0,5,4
1745140220597,CENG 113,A00,886219,Opatkiewicz; Justin Paul,16,0,25,9
1745140221625,CGS 101,A00,887044,Staff,13,0,20,7
1745140222652,CGS 105,A01,887046,Staff,16,0,25,9
1745140223685,CGS 112,A00,887047,Cuong; Marisol,12,0,15,3
1745140224714,CGS 113,A00,887048,Staff,24,0,30,6
1745140225745,CGS 120,A00,887049,Staff,12,0,17,5
1745140226773,CHEM 6A,A01,886336,Lam; Tin Yiu,44,0,50,6
1745140226773,CHEM 6A,A02,886338,Lam; Tin Yiu,43,0,50,7
1745140227801,CHEM 6B,A01,886341,Hopkins; Patrycja Anna,21,0,50,29
1745140227801,CHEM 6B,A02,886343,Hopkins; Patrycja Anna,46,0,50,4
1745140228830,CHEM 6C,A01,886346,Albizati; Kim F.,0,1,50,50
1745140228830,CHEM 6C,A02,886348,Albizati; Kim F.,38,0,50,12
1745140229859,CHEM 40A,A01,886352,Klosterman; Jeremy K,70,0,100,30
1745140230887,CHEM 40B,A01,886356,Klosterman; Jeremy K,0,4,100,100
1745140231915,CHEM 41B,A01,886360,Theodorakis; Emmanuel,30,0,50,20
1745140231915,CHEM 41B,A02,886362,Theodorakis; Emmanuel,46,0,50,4
1745140232942,CHIN 165A,A00,886382,Xu; Li,19,0,20,1
1745140233970,CLAS 120,A00,886387,Myerston Santana; Jacobo,36,0,40,4
1745140234999,COGS 9,A01,886967,Shannon; Kyle Michael,49,0,60,11
1745140236027,COGS 11,A01,886969,Staff,18,0,30,12
1745140237055,COGS 14A,A01,886971,Staff,26,0,60,34
1745140238090,COGS 14B,A01,886973,Hoffman; Drew Ellen,18,0,60,42
1745140239119,COGS 18,A01,886975,Morgan; Eric,41,0,60,19
1745140240149,COGS 20,A01,886977,Staff,6,0,8,2
1745140240149,COGS 20,A02,886978,Staff,6,0,7,1
1745140241175,COGS 100,A01,907783,Staff,6,0,30,24
1745140242246,COGS 101B,A01,886980,Staff,0,10,30,30
1745140243278,COGS 101C,A01,886982,Delgado; Tania,0,6,30,30
1745140244309,COGS 102A,A01,886984,Johnson; Christine M.,13,0,30,17
1745140245335,COGS 118B,A01,886986,Staff,0,25,60,60
1745140246370,COGS 150,A01,886988,Bergen; Benjamin,16,0,30,14
1745140247396,COGS 153,A00,886989,Delgado; Tania,0,6,30,30
1745140248428,COGS 186,A01,886991,Staff,3,0,30,27
1745140249458,COGS 187A,A01,886993,Boyle; Mary E. T.,12,0,30,18
1745140250489,COGS 189,A00,886994,Staff,13,0,30,17
1745140251521,COMM 10,A01,886996,Staff,11,0,25,14
1745140251521,COMM 10,A02,886997,Staff,21,0,25,4
1745140252552,COMM 20,A01,886999,Leuning; Grant Maurstad,33,0,40,7
1745140254629,COMM 100A,A01,887002,Staff,0,0,25,25
1745140254629,COMM 100A,A02,887003,Staff,20,0,25,5
1745140255655,COMM 100B,A01,887005,Staff,0,1,25,25
1745140256683,COMM 106D,A00,887006,Staff,22,0,40,18
1745140257716,COMM 110G,A00,887007,Whitworth-Smith; Andrew C,17,0,40,23
1745140258741,COMM 111B,A00,887008,Staff,31,0,40,9
1745140259779,COMM 113T,A00,887009,Abuelhiga; Soraya Jill,30,0,40,10
1745140259779,COMM 113T,B00,906733,Staff,40,0,40,0
1745140260806,COMM 145,A00,887010,Staff,21,0,40,19
1745140261833,COMM 146,A00,887054,Staff,31,0,40,9
1745140262859,COMM 190,A00,887012,Staff,9,0,23,14
1745140263887,CSE 8A,A50,887015,Cao; Yingjun,68,0,85,17
1745140264915,CSE 11,A01,887017,Cao; Yingjun,35,0,70,35
1745140265949,CSE 20,A01,887019,Staff,35,0,50,15
1745140266978,CSE 21,A01,887021,Braun; Oliver,81,0,100,19
1745140266978,CSE 21,B01,892583,Staff,48,0,50,2
1745140268010,CSE 30,A01,887025,Eldon; John,161,0,200,39
1745140269036,CSE 100,A01,887027,Staff,28,0,50,22
1745140269036,CSE 100,A02,887028,Staff,43,0,50,7
1745140270065,CSE 101,A01,887030,Braun; Oliver,79,0,100,21
1745140270065,CSE 101,B01,887032,Jones; Miles E,0,1,50,50
1745140270065,CSE 101,B02,887033,Jones; Miles E,13,0,50,37
1745140271101,CSE 105,A01,908084,Jones; Miles E,36,0,50,14
1745140271101,CSE 105,A02,908087,Jones; Miles E,38,0,50,12
1745140272137,CSE 135,A01,887035,Powell; Thomas Allan,8,0,50,42
1745140273166,CSE 142,A01,887037,Staff,22,0,60,38
1745140274192,CSE 142L,A01,887039,Staff,42,0,60,18
1745140275219,CSE 151A,A01,887041,Solares; Edwin A,60,0,100,40
1745140276251,CSE 175,A01,887043,Kumar; Rakesh,30,0,30,0
1745140277283,CSS 1,A01,886389,Staff,12,0,40,28
1745140278317,DSC 30,A01,908097,Liao; Soohyun Nam,54,0,75,21
1745140279349,DSC 40A,A01,908099,Shannon; Kyle Michael,37,0,50,13
1745140280380,DSC 40B,A01,908112,Staff,28,0,50,22
1745140281406,DSC 80,A01,908116,Staff,32,0,60,28
1745140282436,DSC 197,001,956863,Eldridge; Justin Matthew,9999,0,9999,0
1745140283470,ECE 5,A01,886400,Morris; Karcher William,3,0,6,3
1745140283470,ECE 5,A02,886401,Morris; Karcher William,5,0,6,1
1745140284504,ECE 148,A01,886403,Silberman; Jack,0,8,14,14
1745140285538,ECON 1,A01,887265,Crane; Meredith Helen,25,0,70,45
1745140285538,ECON 1,B01,887268,Staff,44,0,50,6
1745140286565,ECON 2,A01,887273,Crane; Meredith Helen,61,0,70,9
1745140287597,ECON 3,A01,887279,Rondina; Giacomo,44,0,70,26
1745140288633,ECON 4,A01,887282,Anderson; John Charles,0,1,10,10
1745140289660,ECON 5,A01,887285,Staff,39,0,45,6
1745140289660,ECON 5,B01,887292,Staff,43,0,45,2
1745140290733,ECON 100A,A01,887337,Newhouse; Herbert S,58,0,70,12
1745140290733,ECON 100A,B01,887349,Staff,45,0,50,5
1745140291770,ECON 100B,A01,887361,Du; Songzi,42,0,70,28
1745140292810,ECON 100C,A01,887445,Newhouse; Herbert S,61,0,70,9
1745140293839,ECON 105,A00,887488,Vespa; Emanuel Ignacio,24,0,35,11
1745140294865,ECON 109,A01,887506,Staff,29,0,35,6
1745140295923,ECON 110A,A01,887568,Alon; Titan Michael,1,0,35,34
1745140295923,ECON 110A,B01,907601,Alon; Titan Michael,27,0,35,8
1745140296950,ECON 110B,A01,887598,Levkoff; Steven B.,0,7,70,70
1745140297982,ECON 112,A00,887599,Rondina; Giacomo,20,0,35,15
1745140299008,ECON 120A,A01,887603,Dai; Yinlin,46,0,70,24
1745140309054,ECON 120C,A01,887608,Sun; Yixiao,0,0,35,35
1745140309054,ECON 120C,B01,887614,Sun; Yixiao,13,0,35,22
1745140310088,ECON 138,A00,887621,Bharadwaj; Prashant,0,18,20,20
1745140311114,ECON 171,A01,907666,Staff,27,0,35,8
1745140312141,ECON 175,A00,887626,Wu; Pak Yeung,27,0,35,8
1745140313169,ECON 190,A00,887640,Vespa; Emanuel Ignacio,26,0,35,9
1745140314203,EDS 25,A01,888197,Staff,0,0,0,0
1745140314203,EDS 25,A02,888209,Staff,0,0,0,0
1745140314203,EDS 25,A03,888210,Staff,0,0,0,0
1745140314203,EDS 25,A04,888212,Staff,0,0,0,0
1745140314203,EDS 25,A05,888213,Staff,0,0,0,0
1745140314203,EDS 25,A06,888214,Staff,0,0,0,0
1745140314203,EDS 25,A07,888235,Staff,0,0,0,0
1745140314203,EDS 25,A08,888236,Staff,0,0,0,0
1745140314203,EDS 25,A09,888240,Staff,0,0,0,0
1745140314203,EDS 25,A10,888244,Staff,0,0,0,0
1745140314203,EDS 25,B01,888273,Staff,0,0,0,0
1745140314203,EDS 25,B02,888285,Staff,0,0,0,0
1745140314203,EDS 25,B03,888423,Staff,29,0,30,1
1745140314203,EDS 25,B04,888432,Staff,0,0,0,0
1745140314203,EDS 25,B05,888433,Staff,0,0,0,0
1745140314203,EDS 25,B06,888467,Staff,0,0,0,0
1745140314203,EDS 25,B07,888468,Staff,0,0,0,0
1745140314203,EDS 25,B08,888479,Staff,0,0,0,0
1745140314203,EDS 25,B09,888484,Staff,0,0,0,0
1745140314203,EDS 25,B10,888487,Staff,0,0,0,0
1745140315231,EDS 38,A01,907700,Choi; Bailey Miyeon,30,0,30,0
1745140316258,EDS 112,A01,888601,Chapman; Thandeka K,23,0,40,17
1745140317284,EDS 115,A00,888697,Mendez; Kathrina Mendoza,17,0,30,13
1745140318321,EDS 116,A01,888893,Staff,38,0,40,2
1745140320388,EDS 124AR,A00,889133,Staff,33,0,50,17
1745140320388,EDS 124AR,B00,907471,Simon; Elizabeth A,42,0,50,8
1745140321413,EDS 124BR,A00,889134,Staff,57,0,100,43
1745140322446,EDS 125,A00,889135,Staff,26,0,30,4
1745140323472,EDS 126,A01,889138,Staff,37,0,40,3
1745140324499,EDS 164R,A01,889142,Wishard Guerra; Alison G.,38,0,50,12
1745140325528,ENG 30,A01,886396,Staff,0,0,0,0
1745140325528,ENG 30,B01,886398,Staff,0,0,0,0
1745140326557,ENVR 102,A00,906150,Montejo; Carolina,23,0,25,2
1745140327593,ETHN 103A,A00,887236,Man; Simeon S,0,5,0,0
1745140328622,ETHN 113,A00,887239,Staff,20,0,30,10
1745140329653,ETHN 116,A00,887240,Staff,20,0,25,5
1745140330680,ETHN 117,A00,887241,Choi; Esther Min,27,0,30,3
1745140331708,ETHN 118,A00,887243,Staff,24,0,30,6
1745140332743,ETHN 127,A00,887248,Cuong; Marisol,12,0,15,3
1745140333772,ETHN 139,A00,887250,Staff,8,0,10,2
1745140334799,ETHN 142,A00,887252,Staff,18,0,30,12
1745140335827,ETHN 161,A00,887253,Browne; Errol Tsekani,28,0,30,2
1745140336860,ETHN 163FR,A00,887255,Burelle; Julie Sara Veronique,4,0,5,1
1745140337892,GLBH 20,A00,889149,Elwardani; Nile Regina,15,0,42,27
1745140339953,GLBH 111,A01,889152,Burgos; Jose L.,17,0,17,0
1745140340983,GLBH 150,A00,889181,Sloane; Julia Kathryn,0,1,15,15
1745140343050,HDS 60,A01,886406,Warstadt; Melissa Fawn,76,0,80,4
1745140344078,HIAF 111,A00,889324,Gyamfi; Bright,0,4,0,0
1745140345103,HIEA 131,A00,889328,Staff,14,0,32,18
1745140346131,HIEA 144,A00,889333,Henry; Todd A.,29,0,32,3
1745140347163,HIEA 154,A00,889336,Henry; Todd A.,28,0,32,4
1745140348193,HIEU 106,A00,889339,Staff,28,0,32,4
1745140350250,HIEU 114,A00,889340,Staff,18,0,32,14
1745140351276,HIEU 135GS,A00,889342,Patterson; Patrick H.,0,0,1,22
1745140352303,HIEU 137,A00,889343,Edington; Claire Ellen,12,0,25,13
1745140353328,HIEU 148,A00,889345,Staff,16,0,32,16
1745140354354,HIEU 154,A00,889346,Biess; Frank Peter,24,0,32,8
1745140355384,HILA 102,A00,889351,Staff,13,0,32,19
1745140356414,HILD 2A,A01,889221,Lewandoski; Julia Mavis,0,5,32,32
1745140357441,HILD 7B,A01,889225,Man; Simeon S,0,7,32,32
1745140358469,HILD 7C,A01,889288,Alvarez; Luis A,0,8,32,32
1745140359497,HILD 30,A01,889323,Staff,0,1,32,32
1745140361555,HISC 119,A00,889383,Golan; Tal,22,0,32,10
1745140362586,HIUS 103,A00,889384,Man; Simeon S,10,0,32,22
1745140363614,HIUS 117,A00,919797,Kwak; Nancy,23,0,32,9
1745140364641,HIUS 142A,A00,919788,Staff,24,0,32,8
1745140366693,HIUS 149,A00,889386,Gyamfi; Bright,0,1,0,0
1745140367723,HIUS 155,A00,889387,Alvarez; Luis A,19,0,32,13
1745140368762,HUM 3,A01,886499,Caldwell; Michael Alan,24,0,50,26
1745140369787,HUM 3GS,A00,886500,Rodriguez; Bretton Sigfred,0,0,0,26
1745140370814,HUM 3R,A01,886502,Markman; Kristina,0,32,50,50
1745140371841,HUM 4,A01,886504,Crum; Matthew Stephen,27,0,50,23
1745140371841,HUM 4,B01,886506,West; Geoffrey Scott,25,0,50,25
1745140372869,HUM 4GS,A00,886507,Staff,0,0,0,13
1745140373895,HUM 5,A01,886509,Staff,35,0,50,15
1745140374926,HUM 5R,A01,886511,Zavodny; Tatiana Sophia,0,32,50,50
1745140375957,JAPN 180,A00,886407,Staff,25,0,40,15
1745140376986,LATI 50,A01,886409,Martin-Cabrera; Luis,9,0,22,13
1745140376986,LATI 50,A02,886410,Martin-Cabrera; Luis,20,0,22,2
1745140376986,LATI 50,A03,886411,Martin-Cabrera; Luis,22,0,22,0
1745140376986,LATI 50,A04,886412,Martin-Cabrera; Luis,15,0,22,7
1745140378019,LAWS 101,A00,907664,Staff,36,0,60,24
1745140379046,LIAB 1A,A00,889388,Saab; Dima,19,0,20,1
1745140380074,LIAB 1AX,A00,889389,El Cheddadi; Youniss,19,0,20,1
1745140381105,LIFR 1C,A00,889391,Van Moer; Vinciane G,9,0,20,11
1745140382147,LIFR 1CX,A00,889392,Van Moer; Vinciane G,8,0,20,12
1745140383181,LIFR 1D,A00,889393,Van Moer; Vinciane G,11,0,20,9
1745140384210,LIFR 1DX,A00,889394,Van Moer; Vinciane G,11,0,20,9
1745140385242,LIGN 7,A00,886923,Staff,30,0,50,20
1745140386273,LIGN 17,A00,886924,Kehler; Andrew Scott,133,0,150,17
1745140387305,LTAM 110,A00,889395,Staff,17,0,30,13
1745140388333,LTCH 101,A00,889397,Staff,22,0,25,3
1745140389363,LTCS 130,A00,889398,Staff,23,0,25,2
1745140390393,LTEA 138,A00,889399,Staff,25,0,40,15
1745140391423,LTEN 149,A00,889400,Wesling; Megan E.,6,0,25,19
1745140392453,LTEN 169,A00,889401,Staff,24,0,25,1
1745140393484,LTEN 180,A00,889402,Staff,12,0,15,3
1745140394514,LTEN 181,A00,889403,Staff,23,0,25,2
1745140395547,LTWL 100,A00,889404,Myerston Santana; Jacobo,8,0,25,17
1745140396574,LTWL 180GS,A00,889405,Staff,6,0,20,14
1745140397602,LTWL 181,A00,889406,Staff,19,0,25,6
1745140398630,LTWL 184,A00,889475,Mukherjee; Silpa,21,0,25,4
1745140399658,LTWR 102C,A00,889486,Staff,29,0,30,1
1745140400689,LTWR 115W,A00,889491,Staff,3,0,15,12
1745140401716,MAE 8,A01,886905,Staff,0,2,0,0
1745140402748,MAE 11,A00,886906,Bandaru; Prabhakar,0,0,50,50
1745140403777,MAE 20,A00,886907,Evdokimenko; Ekaterina,50,0,70,20
1745140404805,MAE 30B,A00,886909,Ghazinejad; Maziar,28,0,45,17
1745140405834,MAE 101B,A00,886910,Saintillan; David,36,0,45,9
1745140406861,MAE 105,A00,886911,Bandaru; Prabhakar,26,0,50,24
1745140407890,MAE 107,A00,886912,Staff,22,0,60,38
1745140408917,MAE 143B,A00,886913,Bewley; Thomas R,14,0,40,26
1745140409949,MAE 148,A01,886915,Silberman; Jack,5,0,14,9
1745140410975,MAE 160,A00,886916,Evdokimenko; Ekaterina,41,0,60,19
1745140412002,MATH 3C,A01,889681,Staff,2,0,30,28
1745140413035,MATH 10A,A01,889760,Staff,28,0,30,2
1745140413035,MATH 10A,A02,889783,Staff,30,0,30,0
1745140414074,MATH 10B,A01,889785,Verstraete; Jacques Allan,0,2,30,30
1745140414074,MATH 10B,A02,889795,Verstraete; Jacques Allan,0,2,30,30
1745140414074,MATH 10B,B01,889797,Verstraete; Jacques Allan,0,0,30,30
1745140414074,MATH 10B,B02,889828,Verstraete; Jacques Allan,23,0,30,7
1745140415103,MATH 10C,A01,889849,Habib; Yousaf,18,0,30,12
1745140415103,MATH 10C,A02,889852,Habib; Yousaf,20,0,30,10
1745140415103,MATH 10C,A03,889853,Habib; Yousaf,25,0,30,5
1745140415103,MATH 10C,A04,889858,Habib; Yousaf,21,0,30,9
1745140415103,MATH 10C,B01,889861,Staff,12,0,30,18
1745140415103,MATH 10C,B02,889862,Staff,26,0,30,4
1745140415103,MATH 10C,B03,889863,Staff,28,0,30,2
1745140415103,MATH 10C,B04,889967,Staff,25,0,30,5
1745140416131,MATH 18,A01,889974,Staff,15,0,30,15
1745140416131,MATH 18,A02,889977,Staff,25,0,30,5
1745140416131,MATH 18,B01,889984,Hardiman; Liam,26,0,30,4
1745140416131,MATH 18,B02,889985,Hardiman; Liam,28,0,30,2
1745140417166,MATH 20A,A01,889990,Suk; Andrew Hoon,31,0,35,4
1745140418194,MATH 20B,A01,889993,Ohm; Ko Woon,21,0,30,9
1745140418194,MATH 20B,A02,889994,Ohm; Ko Woon,30,0,30,0
1745140418194,MATH 20B,B01,889996,Ohm; Ko Woon,25,0,30,5
1745140418194,MATH 20B,B02,889997,Ohm; Ko Woon,24,0,30,6
1745140419223,MATH 20C,A01,889999,Hammock; Frances H,22,0,30,8
1745140419223,MATH 20C,A02,890003,Hammock; Frances H,23,0,30,7
1745140419223,MATH 20C,B01,890006,Hammock; Frances H,11,0,30,19
1745140419223,MATH 20C,B02,890007,Hammock; Frances H,18,0,30,12
1745140420259,MATH 20D,A01,890011,Cheng; Hsiao-Bing,6,0,30,24
1745140420259,MATH 20D,A02,890012,Cheng; Hsiao-Bing,27,0,30,3
1745140420259,MATH 20D,B01,890016,Cheng; Hsiao-Bing,19,0,30,11
1745140420259,MATH 20D,B02,890017,Cheng; Hsiao-Bing,15,0,30,15
1745140421300,MATH 20E,A01,890026,Harel; Guershon,10,0,30,20
1745140421300,MATH 20E,A02,890029,Harel; Guershon,24,0,30,6
1745140421300,MATH 20E,B01,890033,Harel; Guershon,14,0,30,16
1745140421300,MATH 20E,B02,890101,Harel; Guershon,27,0,30,3
1745140422331,MATH 102,A01,890104,Staff,20,0,30,10
1745140422331,MATH 102,A02,890105,Staff,30,0,30,0
1745140423463,MATH 103B,A01,890116,Salehi Golsefidy; Alireza,8,0,30,22
1745140423463,MATH 103B,B01,890118,Staff,0,4,30,30
1745140424492,MATH 109,A01,890121,Aliabadi Sr.; Mohsen,6,0,30,24
1745140424492,MATH 109,B01,890124,Upadrashta; Pranav Kumar,23,0,30,7
1745140425518,MATH 120A,A01,890126,Eggers; John Dietrich,15,0,30,15
1745140426551,MATH 142B,A01,890128,Ioana; Adrian,17,0,30,13
1745140426551,MATH 142B,A02,890129,Ioana; Adrian,15,0,30,15
1745140427578,MATH 154,A01,890174,Staff,0,1,30,30
1745140427578,MATH 154,A02,890182,Staff,15,0,30,15
1745140428607,MATH 168A,A01,890197,Dumitriu; Ioana,22,0,35,13
1745140429644,MATH 170A,A01,890240,Nie; Jiawang,6,0,30,24
1745140429644,MATH 170A,A02,890241,Nie; Jiawang,18,0,30,12
1745140429644,MATH 170A,A03,890249,Nie; Jiawang,23,0,30,7
1745140430672,MATH 170B,A01,957891,Nag; Panchali,25,0,35,10
1745140432730,MATH 181A,A01,908025,Staff,0,8,35,35
1745140433757,MATH 193B,A01,890265,Staff,3,0,35,32
1745140434785,MGT 4,A01,890311,Anderson; John Charles,57,0,88,31
1745140435843,MGT 5,A00,907740,Staff,41,0,98,57
1745140436872,MGT 12,A00,890312,Lindenberger; Wade Douglas,70,0,98,28
1745140437898,MGT 16,A00,957883,Staff,84,0,98,14
1745140439956,MGT 45,A00,890314,Pecore; Joseph P.,57,0,98,41
1745140440984,MGT 71,A00,890315,Staff,6,0,98,92
1745140442013,MGT 100,A00,890316,Yavorsky; Daniel Ryan,59,0,98,39
1745140443038,MGT 103,A00,890317,Ehrich; Kristine R,77,0,98,21
1745140444066,MGT 105,A00,890356,Bates; Kenneth Walter,19,0,98,79
1745140445096,MGT 112,A00,890360,Ehrich; Kristine R,65,0,98,33
1745140446122,MGT 127R,A00,907732,Zhu; Kevin Xiaoguo,32,0,98,66
1745140447153,MGT 131B,A00,890361,Anderson; John Charles,75,0,98,23
1745140448178,MGT 137,A00,890362,Lindenberger; Wade Douglas,68,0,98,30
1745140449207,MGT 160,A00,890369,Johnson; Erik Barry,37,0,98,61
1745140451264,MGT 164,A00,890372,Zimmermann; Carsten,0,28,98,98
1745140452290,MGT 180,A00,890374,Bliss; Barbara Ann,32,0,98,66
1745140453318,MMW 15,A01,886414,Chang; Edmond Yi-Teh,0,10,28,28
1745140453318,MMW 15,A02,886415,Chang; Edmond Yi-Teh,0,10,28,28
1745140453318,MMW 15,A03,886416,Chang; Edmond Yi-Teh,0,8,28,28
1745140453318,MMW 15,A04,886417,Chang; Edmond Yi-Teh,0,8,28,28
1745140453318,MMW 15,B01,886419,Chang; Edmond Yi-Teh,0,8,28,28
1745140453318,MMW 15,B02,886420,Chang; Edmond Yi-Teh,0,9,28,28
1745140453318,MMW 15,B03,886421,Chang; Edmond Yi-Teh,0,9,28,28
1745140453318,MMW 15,B04,886422,Chang; Edmond Yi-Teh,0,9,28,28
1745140453318,MMW 15,C01,886424,Staff,0,10,28,28
1745140453318,MMW 15,C02,886425,Staff,0,10,28,28
1745140453318,MMW 15,C03,886426,Staff,0,9,28,28
1745140453318,MMW 15,C04,886427,Staff,0,9,28,28
1745140454348,MMW 15GS,A00,906910,Patterson; Patrick H.,5,0,28,23
1745140455383,MMW 122R,A01,886429,Rahimi; Babak,0,23,28,28
1745140455383,MMW 122R,A02,886430,Rahimi; Babak,0,23,28,28
1745140456419,MUS 1A,A01,890937,Staff,8,0,25,17
1745140456419,MUS 1A,A02,891035,Staff,15,0,25,10
1745140456419,MUS 1A,B00,907849,Staff,48,0,50,2
1745140456419,MUS 1A,B01,907850,Staff,25,0,25,0
1745140456419,MUS 1A,B02,907851,Staff,25,0,25,0
1745140458490,MUS 2AK,A00,957092,Ohnishi; Takae,15,0,15,0
1745140459519,MUS 4,A01,891044,Staff,6,0,25,19
1745140459519,MUS 4,A02,891045,Staff,24,0,25,1
1745140459519,MUS 4,B01,891048,Staff,20,0,25,5
1745140459519,MUS 4,B02,891050,Staff,25,0,25,0
1745140460554,MUS 5,A01,957506,Dubnov; Shlomo,4,0,25,21
1745140460554,MUS 5,A02,957622,Dubnov; Shlomo,21,0,25,4
1745140460554,MUS 5,A03,957623,Dubnov; Shlomo,23,0,25,2
1745140461583,MUS 6,A01,891053,Freitas Caetano; Marcelo,23,0,25,2
1745140461583,MUS 6,A02,891054,Freitas Caetano; Marcelo,23,0,25,2
1745140462611,MUS 7,A01,891081,Staff,0,0,25,25
1745140462611,MUS 7,A02,891082,Staff,15,0,25,10
1745140463641,MUS 8GS,A00,891118,Borgo; David Garcia,5,0,25,20
1745140464674,MUS 11,A01,891140,Staff,12,0,25,13
1745140464674,MUS 11,A02,891141,Staff,24,0,25,1
1745140465703,MUS 13,A01,891143,Staff,10,0,25,15
1745140465703,MUS 13,A02,891144,Staff,25,0,25,0
1745140466729,MUS 15,A01,891146,Staff,7,0,25,18
1745140466729,MUS 15,A02,891148,Staff,22,0,25,3
1745140466729,MUS 15,B01,891150,Staff,18,0,25,7
1745140466729,MUS 15,B02,891151,Staff,25,0,25,0
1745140467757,MUS 20,A01,891153,Staff,9,0,20,11
1745140467757,MUS 20,A02,891155,Staff,16,0,20,4
1745140468785,MUS 80,A00,891156,Staff,19,0,25,6
1745140468785,MUS 80,B00,891157,Staff,25,0,25,0
1745140469813,MUS 130,A00,891158,Ohnishi; Takae,35,0,35,0
1745140470842,MUS 150GS,A01,891160,Borgo; David Garcia,5,0,25,20
1745140471868,MUS 170,A01,891162,Freitas Caetano; Marcelo,21,0,25,4
1745140471868,MUS 170,A02,891164,Freitas Caetano; Marcelo,22,0,25,3
1745140472897,NANO 11,A00,886220,Vazquez Mena; Oscar,12,0,15,3
1745140473926,NANO 15,A01,886222,Drews; Aaron,9,0,10,1
1745140474953,NANO 104,A00,886224,Sirbuly; Donald,18,0,25,7
1745140475980,PH 40,A00,886528,Staff,29,0,40,11
1745140477013,PH 45,A01,886799,Staff,36,0,40,4
1745140478043,PH 110,A00,886802,Staff,7,0,40,33
1745140479074,PH 172,A00,906716,Staff,20,0,35,15
1745140480104,PH 191,A00,886803,Staff,23,0,40,17
1745140481136,PHIL 1,A00,889500,Staff,22,0,30,8
1745140482173,PHIL 10,A01,889549,Grush; Rick Scott,17,0,22,5
1745140482173,PHIL 10,A02,889551,Grush; Rick Scott,20,0,22,2
1745140483210,PHIL 28,A01,889559,Lamey; Andy M.,0,4,25,25
1745140483210,PHIL 28,A02,889561,Lamey; Andy M.,0,0,25,25
1745140483210,PHIL 28,A03,889572,Lamey; Andy M.,7,0,25,18
1745140484244,PHIL 35,A00,907839,Staff,32,0,33,1
1745140485274,PHIL 60,A00,889574,Staff,79,0,90,11
1745140486304,PHIL 105,A00,889579,Staff,0,1,0,0
1745140487335,PHIL 136,A00,889582,Fulkerson; Matthew Todd,27,0,45,18
1745140488365,PHIL 163,A01,889601,Staff,24,0,30,6
1745140488365,PHIL 163,B01,889606,Brandt; Reuven A,0,2,0,0
1745140489397,PHIL 164,A00,889610,Staff,20,0,30,10
1745140490430,PHIL 165,A00,889613,Staff,26,0,30,4
1745140491463,PHYS 1A,A00,886431,Staff,38,0,70,32
1745140492492,PHYS 1AL,001,886432,Tsai; Philbert S,0,0,30,30
1745140492492,PHYS 1AL,002,886436,Tsai; Philbert S,19,0,30,11
1745140493522,PHYS 1B,A00,886439,Staff,192,0,240,48
1745140494548,PHYS 1BL,001,886441,Tsai; Philbert S,0,1,30,30
1745140494548,PHYS 1BL,002,886444,Tsai; Philbert S,14,0,30,16
1745140495577,PHYS 1C,A00,896092,Arnold; Kam S,87,0,146,59
1745140496611,PHYS 1CL,001,886448,Tsai; Philbert S,0,4,30,30
1745140496611,PHYS 1CL,002,886449,Tsai; Philbert S,6,0,30,24
1745140496611,PHYS 1CL,003,886450,Tsai; Philbert S,22,0,30,8
1745140496611,PHYS 1CL,004,886451,Tsai; Philbert S,16,0,30,14
1745140497641,PHYS 2B,A01,886457,Staff,86,0,115,29
1745140498676,PHYS 2C,A01,886460,Shotwell; Brian,0,0,65,65
1745140499704,PHYS 2CL,A01,886467,Staff,0,3,28,28
1745140499704,PHYS 2CL,A02,886468,Staff,5,0,28,23
1745140500734,PHYS 2D,A01,886470,Staff,17,0,50,33
1745140501759,PHYS 4B,A01,886475,Grinstein; Benjamin,88,0,100,12
1745140502793,POLI 5,A00,891173,Desposato; Scott,17,0,25,8
1745140503820,POLI 5D,A01,891175,Staff,5,0,5,0
1745140503820,POLI 5D,B01,891178,Staff,5,0,5,0
1745140504852,POLI 11,A00,891179,Ferree; Karen E,3,0,25,22
1745140505878,POLI 12,A00,891180,Staff,21,0,30,9
1745140506910,POLI 27,A01,891182,Staff,29,0,75,46
1745140507940,POLI 30,A00,891183,Staff,0,3,30,30
1745140508970,POLI 100B,A00,891244,Staff,0,8,20,20
1745140509998,POLI 100I,A00,891247,Staff,19,0,30,11
1745140511025,POLI 104J,A00,891248,Nichter; Maysa,18,0,30,12
1745140512057,POLI 104U,A00,891250,Nichter; Maysa,9,0,30,21
1745140513083,POLI 108,A00,891253,Staff,0,0,0,4
1745140514112,POLI 110B,A00,891255,Wiens; David,22,0,25,3
1745140515140,POLI 112A,A00,891256,Wiens; David,15,0,25,10
1745140516169,POLI 114BR,A00,891261,Staff,22,0,30,8
1745140517205,POLI 117R,A00,891262,Forman; Fonna,12,0,50,38
1745140518237,POLI 118,A00,891264,Ingham; Sean,22,0,25,3
1745140519270,POLI 124A,A00,891265,Staff,19,0,20,1
1745140520298,POLI 125D,A00,891266,Nichter; Simeon C,9,0,25,16
1745140521331,POLI 126,A00,891268,Nichter; Simeon C,11,0,25,14
1745140522363,POLI 126AA,A00,891272,Staff,19,0,25,6
1745140523393,POLI 130AA,A00,891273,Staff,17,0,20,3
1745140524424,POLI 134AA,A00,891274,Staff,12,0,20,8
1745140526487,POLI 138,A00,891278,Staff,22,0,25,3
1745140527514,POLI 142K,A00,891280,Staff,17,0,25,8
1745140528546,POLI 142M,A00,891281,Gartzke; Erik,22,0,30,8
1745140529575,POLI 142P,A00,891284,Staff,21,0,30,9
1745140530602,POLI 143,A00,891285,Gartzke; Erik,17,0,30,13
1745140531629,POLI 153,A00,891286,Staff,20,0,20,0
1745140532655,POLI 170A,A00,891288,Staff,19,0,25,6
1745140533684,POLI 175,A00,891290,Staff,18,0,20,2
1745140534725,PSYC 1,A00,890674,Steiner; Eric Tomas,0,4,45,45
1745140535760,PSYC 2,A00,890676,Albright; Thomas D,25,0,35,10
1745140536790,PSYC 3,A00,890679,Staff,18,0,20,2
1745140537817,PSYC 60,A01,890684,Rickard; Timothy C.,7,0,45,38
1745140538849,PSYC 70,A01,890689,Geller; Emma Harlan,14,0,30,16
1745140539882,PSYC 100,A00,890690,Lacefield; Katharine I,0,43,180,180
1745140540909,PSYC 102,A00,890695,Staff,25,0,40,15
1745140541937,PSYC 105,A00,890699,Geller; Emma Harlan,78,0,100,22
1745140542966,PSYC 106,A00,890701,Gorman; Michael R.,15,0,30,15
1745140543995,PSYC 108,A00,890704,Adrian; Julia Anna,0,23,50,50
1745140545022,PSYC 118,A01,890712,Staff,18,0,30,12
1745140546051,PSYC 124,A00,890716,Chapman; Eddie Nathaniel,36,0,60,24
1745140547079,PSYC 131,A00,890717,Anagnostaras; Stephan,6,0,80,74
1745140548112,PSYC 137,A00,890719,Winkielman; Piotr,0,2,30,30
1745140549147,PSYC 144,A00,890721,Adrian; Julia Anna,0,3,45,45
1745140550177,PSYC 162,A00,890805,Staff,21,0,75,54
1745140551206,PSYC 169,A00,890810,Staff,0,15,30,30
1745140552244,PSYC 172,A00,890814,Gorman; Michael R.,14,0,30,16
1745140553275,PSYC 181,A00,890818,Anagnostaras; Stephan,63,0,200,137
1745140554304,PSYC 189,A00,890823,Staff,11,0,30,19
1745140555334,PSYC 191,A00,890884,Rickard; Timothy C.,0,11,35,35
1745140556366,PSYC 193,A00,890913,Staff,22,0,30,8
1745140556366,PSYC 193,B00,890914,Chapman; Eddie Nathaniel,25,0,30,5
1745140557415,PSYC 193L,A01,890918,Lowe; Angela Beth,29,0,30,1
1745140557415,PSYC 193L,B01,890921,Hurwitz; Ethan Scott,28,0,30,2
1745140557415,PSYC 193L,C01,890928,Staff,30,0,30,0
1745140558444,RELI 149,A00,886806,Rahimi; Babak,23,0,40,17
1745140559473,SE 9,A01,886814,Staff,13,0,20,7
1745140560511,SE 101B,A01,886816,Chadha; Mayank,8,0,30,22
1745140561548,SE 110B,A00,886818,Zhu; Qiang,0,16,45,45
1745140562577,SE 125,A01,886830,Staff,10,0,30,20
1745140563606,SE 130B,A01,886835,Staff,19,0,40,21
1745140564641,SE 131A,A01,886838,Krysl; Petr,37,0,55,18
1745140565680,SE 154,A00,886840,Staff,35,0,50,15
1745140566707,SE 164GS,A01,886849,Staff,13,0,20,7
1745140567738,SE 167GS,A01,886853,Staff,13,0,20,7
1745140568765,SIO 25,A01,890107,Staff,23,0,30,7
1745140569794,SIO 45,A00,890109,Cook; Geoffrey W,137,0,200,63
1745140570821,SIO 109R,A00,890110,Forman; Fonna,0,11,20,20
1745140571849,SIO 187,A01,890114,Kacev; David,21,0,40,19
1745140572879,SOCI 1,A01,890431,Thorpe; Charles Robert,21,0,30,9
1745140572879,SOCI 1,A02,890518,Thorpe; Charles Robert,30,0,30,0
1745140573911,SOCI 2,A01,957978,Staff,0,0,0,0
1745140573911,SOCI 2,A02,957979,Staff,0,3,0,0
1745140574944,SOCI 20,A01,890523,Calderon-Zaks; Michael Aar,24,0,30,6
1745140574944,SOCI 20,A02,890526,Calderon-Zaks; Michael Aar,29,0,30,1
1745140575977,SOCI 30,A01,890533,Pardo Guerra; Juan Pablo,37,0,40,3
1745140577010,SOCI 40,A01,890535,Staff,32,0,45,13
1745140578038,SOCI 104Q,A00,890559,Staff,20,0,30,10
1745140579073,SOCI 106,A00,890560,Arnal; Maud Marie Leonie,22,0,30,8
1745140580103,SOCI 110,A00,890567,Holkenbrink-Monk; Charlene,22,0,30,8
1745140581132,SOCI 112,A00,890568,Victoria Torres; Pablo,0,0,45,45
1745140582164,SOCI 115,A00,890597,Arnal; Maud Marie Leonie,33,0,45,12
1745140584220,SOCI 121,A00,890604,Pardo Guerra; Juan Pablo,40,0,45,5
1745140585249,SOCI 126,A01,890608,Staff,8,0,10,2
1745140586279,SOCI 127,A00,890609,Staff,23,0,30,7
1745140587306,SOCI 131,A00,890610,Thorpe; Charles Robert,38,0,45,7
1745140588333,SOCI 135,A00,890615,Payne; Christine Anna,20,0,45,25
1745140589360,SOCI 139,A00,890620,Staff,43,0,45,2
1745140590395,SOCI 148E,A00,890622,Calderon-Zaks; Michael Aar,39,0,45,6
1745140591423,SOCI 150,A00,890623,Kohler; Kristopher M.,36,0,45,9
1745140592451,SOCI 157,A00,890625,Jules-Rosette; Bennetta W.,18,0,20,2
1745140593478,SOCI 160,A00,890627,Payne; Christine Anna,26,0,45,19
1745140594509,SYN 1,A00,886855,Fish; Gwendolyn Anne,0,0,0,0
1745140594509,SYN 1,B00,906086,Fish; Gwendolyn Anne,0,0,0,2
1745140595546,SYN 2R,A00,886860,Staff,0,15,15,15
1745140595546,SYN 2R,B00,906106,Atkinson; Arthur Laird,0,14,15,15
1745140596591,SYN 100,A01,886866,Browne; Emily,0,29,20,20
1745140596591,SYN 100,B01,906128,Rock; Martin,0,4,20,20
1745140596591,SYN 100,C01,906140,Deavenport; James Cary,0,2,20,20
1745140596591,SYN 100,D01,907816,Deavenport; James Cary,0,3,20,20
1745140597625,TDAC 1,A00,890286,Walsh; Kim C.,11,0,20,9
1745140598658,TDAC 101,A00,890296,Basso; Beatrice,18,0,20,2
1745140599684,TDDE 131,A00,890297,Staff,47,0,50,3
1745140600714,TDDM 1,A00,890287,Weinberg; Sadie,26,0,30,4
1745140601742,TDGE 11,A00,890288,Fulton; Julia,155,0,200,45
1745140601742,TDGE 11,B00,890289,Castro; Robert Jess,188,0,200,12
1745140602770,TDGE 25,B00,957359,Walsh; Kim C.,9,0,20,11
1745140603797,TDGE 40,A01,890292,Power; Jade Yukana,28,0,30,2
1745140604826,TDGE 124,A00,890298,Havis; Allan,12,0,50,38
1745140605851,TDGE 131R,A00,890299,Burelle; Julie Sara Veronique,20,0,42,22
1745140606885,TDHT 101,A00,890300,Staff,12,0,20,8
1745140607914,TDHT 109,A01,890302,Anderson; Mysia Anyse,31,0,40,9
1745140608940,TDMV 1,A00,890293,Arcidiacono; Kristin,20,0,30,10
1745140609968,TDMV 2,A00,890294,Weinberg; Sadie,26,0,30,4
1745140611002,TDMV 3,A00,957878,Arcidiacono; Kristin,27,0,30,3
1745140613059,TDMV 138,A00,890304,Jun; Grace Shin Hae,25,0,40,15
1745140614088,TDMV 140,A00,890305,Corrales; Joseph Bernales,28,0,30,2
1745140615116,TDMV 142,A00,890307,Caligagan; Tony,30,0,40,10
1745140616149,TDMV 144,A00,890308,Camaya; Michelle Ann,26,0,30,4
1745140617181,TDPW 1,A00,890295,Stein; Deborah Isobel,5,0,20,15
1745140618209,USP 2,A01,890272,Lerner; Amy M,8,0,20,12
1745140619236,USP 3,A01,890274,Staff,21,0,30,9
1745140620264,USP 15,A01,890276,Sun; Feiyang,21,0,30,9
1745140621289,USP 25,A00,890277,Shenkman; Michael Thomas,21,0,25,4
1745140622321,USP 138,A00,890278,Staff,15,0,25,10
1745140623350,USP 143,A00,890279,Staff,30,0,70,40
1745140624379,USP 144,A00,890280,Chowdhury; Muhammed Zohir,19,0,30,11
1745140625405,USP 150,A00,890281,Boomhower; Matthew Charles,19,0,30,11
1745140626431,USP 151,A00,890282,Staff,17,0,20,3
1745140627459,USP 162,A00,890283,Andrews; Abigail Leslie,17,0,20,3
1745140628490,USP 168,A00,920477,Kwak; Nancy,2,0,5,3
1745140629522,USP 181,A00,890284,Staff,11,0,20,9
1745140630552,USP 191A,A00,890285,Staff,15,0,20,5
1745140631585,VIS 101,A00,886512,Staff,37,0,75,38
1745140632613,VIS 103,A00,886513,Cruz; Edwin Teddy,65,0,75,10
1745140633640,VIS 108,A00,886514,Staff,7,0,15,8
1745140634674,VIS 127P,A00,886515,Shen; Kuiyi,92,0,146,54
1745140635704,VIS 149,A00,886516,Yoldas; Pinar,1,0,15,14
1745140636734,VIS 164,A00,886526,Erdmann; Dean,21,0,22,1
1745140637764,VIS 194S,A00,886527,Staff,61,0,75,14
1745140638791,WCWP 10A,C00,886484,Staff,13,0,15,2
1745140639819,WCWP 10B,A00,886490,Staff,5,0,15,10
1745140639819,WCWP 10B,B00,886491,Staff,0,1,0,0
1745140639819,WCWP 10B,C00,886492,Staff,10,0,15,5
1745140640850,WCWP 100,A00,886494,Staff,0,2,15,15
1745140643022,AAS 10,A01,886199,Childs; Dennis R.,0,2,0,0
1745140644055,ANAR 104,A01,886940,Shtienberg; Gilad,27,0,30,3
1745140645085,ANAR 120,A00,886953,Staff,13,0,20,7
1745140646117,ANBI 148,A01,886955,Wilder; Linnea Lorene,32,0,40,8
1745140648169,ANSC 122,A00,886957,Staff,28,0,30,2
1745140649202,ANSC 150,A00,886958,Sloane; Julia Kathryn,6,0,15,9
1745140650235,ANSC 156,A00,886959,Jenkins; Janis A.,2,0,15,13
1745140651260,ANSC 180,A00,886960,Staff,12,0,17,5
1745140652288,ANSC 188,A00,886961,Jassal; Aftab,10,0,25,15
1745140653313,ANSC 190,A00,886962,Jassal; Aftab,14,0,25,11
1745140654342,ANSC 191,A00,886963,Staff,18,0,20,2
1745140655374,ANTH 3,A01,891689,Staff,19,0,20,1
1745140656401,ANTH 5,A00,886933,Semendeferi; Ekaterini,18,0,20,2
1745140657426,ANTH 10,A00,886934,Staff,0,8,30,30
1745140658456,ANTH 21,A01,886936,Staff,44,0,60,16
1745140659482,ANTH 23,A01,886938,Staff,94,0,100,6
1745140660508,ANTH 105,A00,886964,Stewart; Alexander B,94,0,100,6
1745140661541,ANTH 108,A00,886965,Pedersen; David,10,0,20,10
1745140662571,AWP 10,001,886147,Staff,0,0,0,0
1745140662571,AWP 10,002,886148,Staff,0,0,0,0
1745140662571,AWP 10,003,886149,Staff,0,0,0,0
1745140662571,AWP 10,004,886150,Staff,0,0,0,0
1745140662571,AWP 10,005,886151,Staff,0,0,0,0
1745140662571,AWP 10,006,886152,Staff,0,0,0,0
1745140662571,AWP 10,007,886153,Staff,0,0,0,0
1745140662571,AWP 10,008,886154,Staff,0,0,0,0
1745140662571,AWP 10,009,886155,Staff,0,0,0,0
1745140662571,AWP 10,010,886156,Staff,0,0,0,0
1745140662571,AWP 10,011,886158,Staff,0,0,0,0
1745140662571,AWP 10,012,886160,Staff,0,0,0,0
1745140662571,AWP 10,013,886161,Staff,0,0,0,0
1745140662571,AWP 10,014,886162,Staff,0,0,0,0
1745140662571,AWP 10,015,886163,Staff,0,0,0,0
1745140662571,AWP 10,016,886164,Staff,0,0,0,0
1745140662571,AWP 10,017,886165,Staff,0,0,0,0
1745140662571,AWP 10,018,886166,Staff,0,0,0,0
1745140662571,AWP 10,019,886168,Staff,0,0,0,0
1745140662571,AWP 10,020,886170,Staff,0,0,0,0
1745140662571,AWP 10,021,886172,Staff,0,0,0,0
1745140663605,AWP 10R,001,886173,Staff,0,0,0,0
1745140663605,AWP 10R,002,886174,Staff,0,1,0,0
1745140663605,AWP 10R,003,886175,Staff,0,0,0,0
1745140663605,AWP 10R,004,886176,Staff,0,0,0,0
1745140663605,AWP 10R,005,886177,Staff,0,0,0,0
1745140663605,AWP 10R,006,886178,Staff,0,0,0,0
1745140663605,AWP 10R,007,886179,Staff,0,0,0,0
1745140663605,AWP 10R,008,886181,Staff,0,0,0,0
1745140663605,AWP 10R,009,886182,Staff,0,0,0,0
1745140663605,AWP 10R,010,886183,Staff,0,0,0,0
1745140663605,AWP 10R,011,886184,Staff,0,0,0,0
1745140663605,AWP 10R,012,886185,Staff,0,0,0,0
1745140663605,AWP 10R,013,886186,Staff,0,0,0,0
1745140663605,AWP 10R,014,886187,Staff,0,0,0,0
1745140663605,AWP 10R,015,886188,Staff,0,0,0,0
1745140663605,AWP 10R,016,886189,Staff,0,0,0,0
1745140664670,AWP 102R,A00,886190,Staff,0,0,0,0
1745140664670,AWP 102R,B00,886191,Staff,0,0,0,0
1745140665701,BENG 100,A01,886193,Staff,19,0,30,11
1745140666731,BENG 122A,A01,886195,Hasty; Jeff M,20,0,30,10
1745140667759,BENG 166A,A00,886196,Sah; Robert Lie-Yuan,0,3,20,20
1745140668788,BIBC 102,A01,894320,Staff,0,2,46,46
1745140668788,BIBC 102,A02,894321,Staff,0,0,46,46
1745140668788,BIBC 102,A03,894344,Staff,21,0,46,25
1745140668788,BIBC 102,A04,894345,Staff,30,0,47,17
1745140669816,BICD 100R,A01,894365,Smith; Laurie,1,3,58,57
1745140669816,BICD 100R,A02,894366,Smith; Laurie,0,1,58,58
1745140669816,BICD 100R,A03,894367,Smith; Laurie,13,0,59,46
1745140670844,BICD 136,A01,894383,Gustafson-Brown; Cindy,16,0,50,34
1745140671871,BIEB 102,A01,894494,Butler; Shannon Rhey,67,0,130,63
1745140673925,BIEB 150,A01,894617,Wills; Christopher,0,3,13,13
1745140673925,BIEB 150,A02,894631,Wills; Christopher,0,3,13,13
1745140673925,BIEB 150,A03,894937,Wills; Christopher,0,3,13,13
1745140673925,BIEB 150,A04,894946,Wills; Christopher,0,1,11,11
1745140674957,BIEB 194,A00,906141,Kurle; Carolyn M.,14,0,20,6
1745140675991,BILD 1,A01,894154,Staff,8,0,19,11
1745140675991,BILD 1,A02,894155,Staff,15,0,19,4
1745140675991,BILD 1,A03,894160,Staff,18,0,19,1
1745140675991,BILD 1,A04,894161,Staff,16,0,18,2
1745140677020,BILD 2,A01,894168,Staff,0,0,50,50
1745140677020,BILD 2,A02,894169,Staff,0,0,50,50
1745140677020,BILD 2,A03,894179,Staff,27,0,50,23
1745140677020,BILD 2,A04,894203,Staff,42,0,50,8
1745140678053,BILD 3,A01,894213,Staff,24,0,31,7
1745140678053,BILD 3,A02,894214,Staff,28,0,31,3
1745140678053,BILD 3,A03,894235,Staff,30,0,31,1
1745140678053,BILD 3,A04,894236,Staff,29,0,32,3
1745140679082,BILD 4,A01,894253,Reuther; Keefe,12,0,24,12
1745140679082,BILD 4,A02,894258,Reuther; Keefe,19,0,24,5
1745140680109,BILD 5,A01,894276,Reuther; Keefe,40,0,50,10
1745140680109,BILD 5,A02,894277,Reuther; Keefe,48,0,50,2
1745140680109,BILD 5,A03,894290,Reuther; Keefe,47,0,50,3
1745140680109,BILD 5,A04,894291,Reuther; Keefe,50,0,50,0
1745140681141,BILD 24,A01,894297,Pirino; Giorgia,46,0,60,14
1745140682169,BIMM 100,A01,895012,Staff,0,14,0,1
1745140682169,BIMM 100,A02,895013,Staff,0,6,0,2
1745140682169,BIMM 100,A03,895014,Staff,0,7,0,0
1745140682169,BIMM 100,A04,895015,Staff,0,4,0,0
1745140683198,BIMM 101,A01,895017,McDonnell; Lisa Marie,0,2,24,24
1745140683198,BIMM 101,A02,895018,McDonnell; Lisa Marie,0,1,24,24
1745140683198,BIMM 101,B01,895020,McDonnell; Lisa Marie,0,3,24,24
1745140683198,BIMM 101,B02,895021,McDonnell; Lisa Marie,0,2,24,24
1745140684223,BIMM 110,A01,895023,Staff,7,0,25,18
1745140684223,BIMM 110,A02,895024,Staff,11,0,25,14
1745140684223,BIMM 110,A03,895025,Staff,22,0,25,3
1745140684223,BIMM 110,A04,895031,Staff,21,0,25,4
1745140685250,BIMM 120,A01,895114,Gustafson-Brown; Cindy,8,0,28,20
1745140685250,BIMM 120,A02,895126,Gustafson-Brown; Cindy,19,0,27,8
1745140686279,BIPN 100,A01,895130,Yang; Mingyu,13,0,38,25
1745140686279,BIPN 100,A02,895131,Yang; Mingyu,33,0,38,5
1745140686279,BIPN 100,A03,895132,Yang; Mingyu,33,0,38,5
1745140686279,BIPN 100,A04,895133,Yang; Mingyu,30,0,36,6
1745140687312,BIPN 120,A01,895135,Cooke; James Edward,0,3,13,13
1745140687312,BIPN 120,A02,895136,Cooke; James Edward,0,1,13,13
1745140687312,BIPN 120,A03,895137,Cooke; James Edward,0,0,13,13
1745140687312,BIPN 120,A04,895156,Cooke; James Edward,4,0,11,7
1745140688340,BIPN 134,A01,895235,Cooke; James Edward,0,3,25,25
1745140688340,BIPN 134,A02,895237,Cooke; James Edward,0,0,25,25
1745140688340,BIPN 134,A03,895240,Cooke; James Edward,13,0,25,12
1745140688340,BIPN 134,A04,895270,Cooke; James Edward,24,0,25,1
1745140689369,BIPN 189,A00,892103,Staff,0,20,9,9
1745140691421,CAT 124,A01,922009,Staff,0,1,20,20
1745140692467,CAT 125R,A00,886390,Morales; Celeste Georgianna,4,0,20,16
1745140692467,CAT 125R,B00,886391,Irwin; Matthew Joseph,0,1,20,20
1745140692467,CAT 125R,C00,886392,Smith; Lauryn Alissa,11,0,20,9
1745140692467,CAT 125R,D00,886393,Vanderschuit; Maya Alysia,6,0,20,14
1745140692467,CAT 125R,E00,886394,Marchisotto; Jennifer Anne,0,2,20,20
1745140693501,CENG 15,A01,886218,Drews; Aaron,1,0,5,4
1745140694528,CENG 113,A00,886219,Opatkiewicz; Justin Paul,16,0,25,9
1745140695560,CGS 101,A00,887044,Staff,13,0,20,7
1745140696587,CGS 105,A01,887046,Staff,16,0,25,9
1745140697614,CGS 112,A00,887047,Cuong; Marisol,12,0,15,3
1745140698640,CGS 113,A00,887048,Staff,24,0,30,6
1745140699666,CGS 120,A00,887049,Staff,12,0,17,5
1745140700694,CHEM 6A,A01,886336,Lam; Tin Yiu,44,0,50,6
1745140700694,CHEM 6A,A02,886338,Lam; Tin Yiu,43,0,50,7
1745140701722,CHEM 6B,A01,886341,Hopkins; Patrycja Anna,21,0,50,29
1745140701722,CHEM 6B,A02,886343,Hopkins; Patrycja Anna,46,0,50,4
1745140702756,CHEM 6C,A01,886346,Albizati; Kim F.,0,1,50,50
1745140702756,CHEM 6C,A02,886348,Albizati; Kim F.,38,0,50,12
1745140703785,CHEM 40A,A01,886352,Klosterman; Jeremy K,70,0,100,30
1745140704815,CHEM 40B,A01,886356,Klosterman; Jeremy K,0,4,100,100
1745140705844,CHEM 41B,A01,886360,Theodorakis; Emmanuel,30,0,50,20
1745140705844,CHEM 41B,A02,886362,Theodorakis; Emmanuel,46,0,50,4
1745140706870,CHIN 165A,A00,886382,Xu; Li,19,0,20,1
1745140707903,CLAS 120,A00,886387,Myerston Santana; Jacobo,36,0,40,4
1745140708930,COGS 9,A01,886967,Shannon; Kyle Michael,49,0,60,11
1745140709957,COGS 11,A01,886969,Staff,18,0,30,12
1745140710989,COGS 14A,A01,886971,Staff,26,0,60,34
1745140712015,COGS 14B,A01,886973,Hoffman; Drew Ellen,18,0,60,42
1745140713040,COGS 18,A01,886975,Morgan; Eric,41,0,60,19
1745140714069,COGS 20,A01,886977,Staff,6,0,8,2
1745140714069,COGS 20,A02,886978,Staff,6,0,7,1
1745140715094,COGS 100,A01,907783,Staff,6,0,30,24
1745140716120,COGS 101B,A01,886980,Staff,0,10,30,30
1745140717152,COGS 101C,A01,886982,Delgado; Tania,0,6,30,30
1745140718179,COGS 102A,A01,886984,Johnson; Christine M.,13,0,30,17
1745140719206,COGS 118B,A01,886986,Staff,0,25,60,60
1745140720238,COGS 150,A01,886988,Bergen; Benjamin,16,0,30,14
1745140721264,COGS 153,A00,886989,Delgado; Tania,0,6,30,30
1745140722472,COGS 186,A01,886991,Staff,3,0,30,27
1745140723499,COGS 187A,A01,886993,Boyle; Mary E. T.,12,0,30,18
1745140724525,COGS 189,A00,886994,Staff,13,0,30,17
1745140725557,COMM 10,A01,886996,Staff,11,0,25,14
1745140725557,COMM 10,A02,886997,Staff,21,0,25,4
1745140726585,COMM 20,A01,886999,Leuning; Grant Maurstad,33,0,40,7
1745140728642,COMM 100A,A01,887002,Staff,0,0,25,25
1745140728642,COMM 100A,A02,887003,Staff,20,0,25,5
1745140729671,COMM 100B,A01,887005,Staff,0,1,25,25
1745140730698,COMM 106D,A00,887006,Staff,22,0,40,18
1745140731725,COMM 110G,A00,887007,Whitworth-Smith; Andrew C,17,0,40,23
1745140732755,COMM 111B,A00,887008,Staff,31,0,40,9
1745140733790,COMM 113T,A00,887009,Abuelhiga; Soraya Jill,30,0,40,10
1745140733790,COMM 113T,B00,906733,Staff,40,0,40,0
1745140734818,COMM 145,A00,887010,Staff,21,0,40,19
1745140735847,COMM 146,A00,887054,Staff,31,0,40,9
1745140736875,COMM 190,A00,887012,Staff,9,0,23,14
1745140737911,CSE 8A,A50,887015,Cao; Yingjun,68,0,85,17
1745140738941,CSE 11,A01,887017,Cao; Yingjun,35,0,70,35
1745140739973,CSE 20,A01,887019,Staff,35,0,50,15
1745140741002,CSE 21,A01,887021,Braun; Oliver,81,0,100,19
1745140741002,CSE 21,B01,892583,Staff,48,0,50,2
1745140742031,CSE 30,A01,887025,Eldon; John,161,0,200,39
1745140743061,CSE 100,A01,887027,Staff,28,0,50,22
1745140743061,CSE 100,A02,887028,Staff,43,0,50,7
1745140744088,CSE 101,A01,887030,Braun; Oliver,79,0,100,21
1745140744088,CSE 101,B01,887032,Jones; Miles E,0,1,50,50
1745140744088,CSE 101,B02,887033,Jones; Miles E,13,0,50,37
1745140745125,CSE 105,A01,908084,Jones; Miles E,36,0,50,14
1745140745125,CSE 105,A02,908087,Jones; Miles E,38,0,50,12
1745140746152,CSE 135,A01,887035,Powell; Thomas Allan,8,0,50,42
1745140747182,CSE 142,A01,887037,Staff,22,0,60,38
1745140748212,CSE 142L,A01,887039,Staff,42,0,60,18
1745140749239,CSE 151A,A01,887041,Solares; Edwin A,60,0,100,40
1745140750273,CSE 175,A01,887043,Kumar; Rakesh,30,0,30,0
1745140751306,CSS 1,A01,886389,Staff,12,0,40,28
1745140752339,DSC 30,A01,908097,Liao; Soohyun Nam,54,0,75,21
1745140753364,DSC 40A,A01,908099,Shannon; Kyle Michael,37,0,50,13
1745140754393,DSC 40B,A01,908112,Staff,28,0,50,22
1745140755420,DSC 80,A01,908116,Staff,32,0,60,28
1745140756454,DSC 197,001,956863,Eldridge; Justin Matthew,9999,0,9999,0
1745140757482,ECE 5,A01,886400,Morris; Karcher William,3,0,6,3
1745140757482,ECE 5,A02,886401,Morris; Karcher William,5,0,6,1
1745140758516,ECE 148,A01,886403,Silberman; Jack,0,8,14,14
1745140759550,ECON 1,A01,887265,Crane; Meredith Helen,25,0,70,45
1745140759550,ECON 1,B01,887268,Staff,44,0,50,6
1745140760579,ECON 2,A01,887273,Crane; Meredith Helen,61,0,70,9
1745140761606,ECON 3,A01,887279,Rondina; Giacomo,44,0,70,26
1745140762642,ECON 4,A01,887282,Anderson; John Charles,0,1,10,10
1745140763669,ECON 5,A01,887285,Staff,39,0,45,6
1745140763669,ECON 5,B01,887292,Staff,43,0,45,2
1745140764716,ECON 100A,A01,887337,Newhouse; Herbert S,58,0,70,12
1745140764716,ECON 100A,B01,887349,Staff,45,0,50,5
1745140765750,ECON 100B,A01,887361,Du; Songzi,42,0,70,28
1745140766782,ECON 100C,A01,887445,Newhouse; Herbert S,61,0,70,9
1745140767811,ECON 105,A00,887488,Vespa; Emanuel Ignacio,24,0,35,11
1745140768895,ECON 109,A01,887506,Staff,29,0,35,6
1745140769940,ECON 110A,A01,887568,Alon; Titan Michael,1,0,35,34
1745140769940,ECON 110A,B01,907601,Alon; Titan Michael,27,0,35,8
1745140770975,ECON 110B,A01,887598,Levkoff; Steven B.,0,7,70,70
1745140772005,ECON 112,A00,887599,Rondina; Giacomo,20,0,35,15
1745140773032,ECON 120A,A01,887603,Dai; Yinlin,46,0,70,24
1745140774061,ECON 120C,A01,887608,Sun; Yixiao,0,0,35,35
1745140774061,ECON 120C,B01,887614,Sun; Yixiao,13,0,35,22
1745140775090,ECON 138,A00,887621,Bharadwaj; Prashant,0,18,20,20
1745140776116,ECON 171,A01,907666,Staff,27,0,35,8
1745140777149,ECON 175,A00,887626,Wu; Pak Yeung,27,0,35,8
1745140778182,ECON 190,A00,887640,Vespa; Emanuel Ignacio,26,0,35,9
1745140779215,EDS 25,A01,888197,Staff,0,0,0,0
1745140779215,EDS 25,A02,888209,Staff,0,0,0,0
1745140779215,EDS 25,A03,888210,Staff,0,0,0,0
1745140779215,EDS 25,A04,888212,Staff,0,0,0,0
1745140779215,EDS 25,A05,888213,Staff,0,0,0,0
1745140779215,EDS 25,A06,888214,Staff,0,0,0,0
1745140779215,EDS 25,A07,888235,Staff,0,0,0,0
1745140779215,EDS 25,A08,888236,Staff,0,0,0,0
1745140779215,EDS 25,A09,888240,Staff,0,0,0,0
1745140779215,EDS 25,A10,888244,Staff,0,0,0,0
1745140779215,EDS 25,B01,888273,Staff,0,0,0,0
1745140779215,EDS 25,B02,888285,Staff,0,0,0,0
1745140779215,EDS 25,B03,888423,Staff,29,0,30,1
1745140779215,EDS 25,B04,888432,Staff,0,0,0,0
1745140779215,EDS 25,B05,888433,Staff,0,0,0,0
1745140779215,EDS 25,B06,888467,Staff,0,0,0,0
1745140779215,EDS 25,B07,888468,Staff,0,0,0,0
1745140779215,EDS 25,B08,888479,Staff,0,0,0,0
1745140779215,EDS 25,B09,888484,Staff,0,0,0,0
1745140779215,EDS 25,B10,888487,Staff,0,0,0,0
1745140780250,EDS 38,A01,907700,Choi; Bailey Miyeon,30,0,30,0
1745140781282,EDS 112,A01,888601,Chapman; Thandeka K,23,0,40,17
1745140782309,EDS 115,A00,888697,Mendez; Kathrina Mendoza,17,0,30,13
1745140783338,EDS 116,A01,888893,Staff,38,0,40,2
1745140785395,EDS 124AR,A00,889133,Staff,33,0,50,17
1745140785395,EDS 124AR,B00,907471,Simon; Elizabeth A,42,0,50,8
1745140786423,EDS 124BR,A00,889134,Staff,57,0,100,43
1745140787451,EDS 125,A00,889135,Staff,26,0,30,4
1745140788478,EDS 126,A01,889138,Staff,37,0,40,3
1745140789507,EDS 164R,A01,889142,Wishard Guerra; Alison G.,38,0,50,12
1745140790533,ENG 30,A01,886396,Staff,0,0,0,0
1745140790533,ENG 30,B01,886398,Staff,0,0,0,0
1745140791560,ENVR 102,A00,906150,Montejo; Carolina,23,0,25,2
1745140792595,ETHN 103A,A00,887236,Man; Simeon S,0,5,0,0
1745140793627,ETHN 113,A00,887239,Staff,20,0,30,10
1745140794662,ETHN 116,A00,887240,Staff,20,0,25,5
1745140795690,ETHN 117,A00,887241,Choi; Esther Min,27,0,30,3
1745140796717,ETHN 118,A00,887243,Staff,24,0,30,6
1745140797747,ETHN 127,A00,887248,Cuong; Marisol,12,0,15,3
1745140798777,ETHN 139,A00,887250,Staff,8,0,10,2
1745140799807,ETHN 142,A00,887252,Staff,18,0,30,12
1745140800840,ETHN 161,A00,887253,Browne; Errol Tsekani,28,0,30,2
1745140801866,ETHN 163FR,A00,887255,Burelle; Julie Sara Veronique,4,0,5,1
1745140802893,GLBH 20,A00,889149,Elwardani; Nile Regina,15,0,42,27
1745140804951,GLBH 111,A01,889152,Burgos; Jose L.,17,0,17,0
1745140805982,GLBH 150,A00,889181,Sloane; Julia Kathryn,0,1,15,15
1745140808036,HDS 60,A01,886406,Warstadt; Melissa Fawn,76,0,80,4
1745140809064,HIAF 111,A00,889324,Gyamfi; Bright,0,4,0,0
1745140810091,HIEA 131,A00,889328,Staff,14,0,32,18
1745140811119,HIEA 144,A00,889333,Henry; Todd A.,29,0,32,3
1745140812146,HIEA 154,A00,889336,Henry; Todd A.,28,0,32,4
1745140813174,HIEU 106,A00,889339,Staff,28,0,32,4
1745140815228,HIEU 114,A00,889340,Staff,18,0,32,14
1745140816258,HIEU 135GS,A00,889342,Patterson; Patrick H.,0,0,1,22
1745140817285,HIEU 137,A00,889343,Edington; Claire Ellen,12,0,25,13
1745140818309,HIEU 148,A00,889345,Staff,16,0,32,16
1745140819340,HIEU 154,A00,889346,Biess; Frank Peter,24,0,32,8
1745140820369,HILA 102,A00,889351,Staff,13,0,32,19
1745140821397,HILD 2A,A01,889221,Lewandoski; Julia Mavis,0,5,32,32
1745140822420,HILD 7B,A01,889225,Man; Simeon S,0,7,32,32
1745140823447,HILD 7C,A01,889288,Alvarez; Luis A,0,8,32,32
1745140824475,HILD 30,A01,889323,Staff,0,1,32,32
1745140826533,HISC 119,A00,889383,Golan; Tal,22,0,32,10
1745140827562,HIUS 103,A00,889384,Man; Simeon S,10,0,32,22
1745140828592,HIUS 117,A00,919797,Kwak; Nancy,23,0,32,9
1745140829622,HIUS 142A,A00,919788,Staff,24,0,32,8
1745140831679,HIUS 149,A00,889386,Gyamfi; Bright,0,1,0,0
1745140832704,HIUS 155,A00,889387,Alvarez; Luis A,19,0,32,13
1745140833733,HUM 3,A01,886499,Caldwell; Michael Alan,24,0,50,26
1745140834762,HUM 3GS,A00,886500,Rodriguez; Bretton Sigfred,0,0,0,26
1745140835792,HUM 3R,A01,886502,Markman; Kristina,0,32,50,50
1745140836823,HUM 4,A01,886504,Crum; Matthew Stephen,28,0,50,22
1745140836823,HUM 4,B01,886506,West; Geoffrey Scott,25,0,50,25
1745140837850,HUM 4GS,A00,886507,Staff,0,0,0,13
1745140838875,HUM 5,A01,886509,Staff,35,0,50,15
1745140839902,HUM 5R,A01,886511,Zavodny; Tatiana Sophia,0,32,50,50
1745140840928,JAPN 180,A00,886407,Staff,25,0,40,15
1745140841961,LATI 50,A01,886409,Martin-Cabrera; Luis,9,0,22,13
1745140841961,LATI 50,A02,886410,Martin-Cabrera; Luis,20,0,22,2
1745140841961,LATI 50,A03,886411,Martin-Cabrera; Luis,22,0,22,0
1745140841961,LATI 50,A04,886412,Martin-Cabrera; Luis,15,0,22,7
1745140842989,LAWS 101,A00,907664,Staff,36,0,60,24
1745140844015,LIAB 1A,A00,889388,Saab; Dima,19,0,20,1
1745140845050,LIAB 1AX,A00,889389,El Cheddadi; Youniss,19,0,20,1
1745140846079,LIFR 1C,A00,889391,Van Moer; Vinciane G,9,0,20,11
1745140847105,LIFR 1CX,A00,889392,Van Moer; Vinciane G,8,0,20,12
1745140848134,LIFR 1D,A00,889393,Van Moer; Vinciane G,11,0,20,9
1745140849218,LIFR 1DX,A00,889394,Van Moer; Vinciane G,11,0,20,9
1745140850246,LIGN 7,A00,886923,Staff,30,0,50,20
1745140851272,LIGN 17,A00,886924,Kehler; Andrew Scott,133,0,150,17
1745140852300,LTAM 110,A00,889395,Staff,17,0,30,13
1745140853334,LTCH 101,A00,889397,Staff,22,0,25,3
1745140854361,LTCS 130,A00,889398,Staff,23,0,25,2
1745140855389,LTEA 138,A00,889399,Staff,25,0,40,15
1745140856415,LTEN 149,A00,889400,Wesling; Megan E.,6,0,25,19
1745140857442,LTEN 169,A00,889401,Staff,24,0,25,1
1745140858469,LTEN 180,A00,889402,Staff,12,0,15,3
1745140859497,LTEN 181,A00,889403,Staff,23,0,25,2
1745140860529,LTWL 100,A00,889404,Myerston Santana; Jacobo,8,0,25,17
1745140861558,LTWL 180GS,A00,889405,Staff,6,0,20,14
1745140862587,LTWL 181,A00,889406,Staff,19,0,25,6
1745140863613,LTWL 184,A00,889475,Mukherjee; Silpa,21,0,25,4
1745140864640,LTWR 102C,A00,889486,Staff,29,0,30,1
1745140865668,LTWR 115W,A00,889491,Staff,3,0,15,12
1745140866699,MAE 8,A01,886905,Staff,0,2,0,0
1745140867731,MAE 11,A00,886906,Bandaru; Prabhakar,0,0,50,50
1745140868759,MAE 20,A00,886907,Evdokimenko; Ekaterina,50,0,70,20
1745140869788,MAE 30B,A00,886909,Ghazinejad; Maziar,28,0,45,17
1745140870815,MAE 101B,A00,886910,Saintillan; David,36,0,45,9
1745140871841,MAE 105,A00,886911,Bandaru; Prabhakar,26,0,50,24
1745140872906,MAE 107,A00,886912,Staff,22,0,60,38
1745140873938,MAE 143B,A00,886913,Bewley; Thomas R,14,0,40,26
1745140874965,MAE 148,A01,886915,Silberman; Jack,5,0,14,9
1745140875997,MAE 160,A00,886916,Evdokimenko; Ekaterina,41,0,60,19
1745140877028,MATH 3C,A01,889681,Staff,2,0,30,28
1745140878061,MATH 10A,A01,889760,Staff,28,0,30,2
1745140878061,MATH 10A,A02,889783,Staff,30,0,30,0
1745140879090,MATH 10B,A01,889785,Verstraete; Jacques Allan,0,2,30,30
1745140879090,MATH 10B,A02,889795,Verstraete; Jacques Allan,0,2,30,30
1745140879090,MATH 10B,B01,889797,Verstraete; Jacques Allan,0,0,30,30
1745140879090,MATH 10B,B02,889828,Verstraete; Jacques Allan,23,0,30,7
1745140880121,MATH 10C,A01,889849,Habib; Yousaf,18,0,30,12
1745140880121,MATH 10C,A02,889852,Habib; Yousaf,20,0,30,10
1745140880121,MATH 10C,A03,889853,Habib; Yousaf,25,0,30,5
1745140880121,MATH 10C,A04,889858,Habib; Yousaf,21,0,30,9
1745140880121,MATH 10C,B01,889861,Staff,12,0,30,18
1745140880121,MATH 10C,B02,889862,Staff,26,0,30,4
1745140880121,MATH 10C,B03,889863,Staff,28,0,30,2
1745140880121,MATH 10C,B04,889967,Staff,25,0,30,5
1745140881149,MATH 18,A01,889974,Staff,15,0,30,15
1745140881149,MATH 18,A02,889977,Staff,25,0,30,5
1745140881149,MATH 18,B01,889984,Hardiman; Liam,26,0,30,4
1745140881149,MATH 18,B02,889985,Hardiman; Liam,28,0,30,2
1745140882177,MATH 20A,A01,889990,Suk; Andrew Hoon,31,0,35,4
1745140883214,MATH 20B,A01,889993,Ohm; Ko Woon,21,0,30,9
1745140883214,MATH 20B,A02,889994,Ohm; Ko Woon,30,0,30,0
1745140883214,MATH 20B,B01,889996,Ohm; Ko Woon,25,0,30,5
1745140883214,MATH 20B,B02,889997,Ohm; Ko Woon,24,0,30,6
1745140884250,MATH 20C,A01,889999,Hammock; Frances H,22,0,30,8
1745140884250,MATH 20C,A02,890003,Hammock; Frances H,23,0,30,7
1745140884250,MATH 20C,B01,890006,Hammock; Frances H,11,0,30,19
1745140884250,MATH 20C,B02,890007,Hammock; Frances H,18,0,30,12
1745140885280,MATH 20D,A01,890011,Cheng; Hsiao-Bing,6,0,30,24
1745140885280,MATH 20D,A02,890012,Cheng; Hsiao-Bing,27,0,30,3
1745140885280,MATH 20D,B01,890016,Cheng; Hsiao-Bing,19,0,30,11
1745140885280,MATH 20D,B02,890017,Cheng; Hsiao-Bing,15,0,30,15
1745140886307,MATH 20E,A01,890026,Harel; Guershon,10,0,30,20
1745140886307,MATH 20E,A02,890029,Harel; Guershon,24,0,30,6
1745140886307,MATH 20E,B01,890033,Harel; Guershon,14,0,30,16
1745140886307,MATH 20E,B02,890101,Harel; Guershon,27,0,30,3
1745140887338,MATH 102,A01,890104,Staff,20,0,30,10
1745140887338,MATH 102,A02,890105,Staff,30,0,30,0
1745140888366,MATH 103B,A01,890116,Salehi Golsefidy; Alireza,8,0,30,22
1745140888366,MATH 103B,B01,890118,Staff,0,4,30,30
1745140889401,MATH 109,A01,890121,Aliabadi Sr.; Mohsen,6,0,30,24
1745140889401,MATH 109,B01,890124,Upadrashta; Pranav Kumar,23,0,30,7
1745140890429,MATH 120A,A01,890126,Eggers; John Dietrich,15,0,30,15
1745140891461,MATH 142B,A01,890128,Ioana; Adrian,17,0,30,13
1745140891461,MATH 142B,A02,890129,Ioana; Adrian,15,0,30,15
1745140892492,MATH 154,A01,890174,Staff,0,1,30,30
1745140892492,MATH 154,A02,890182,Staff,15,0,30,15
1745140893519,MATH 168A,A01,890197,Dumitriu; Ioana,22,0,35,13
1745140894547,MATH 170A,A01,890240,Nie; Jiawang,6,0,30,24
1745140894547,MATH 170A,A02,890241,Nie; Jiawang,18,0,30,12
1745140894547,MATH 170A,A03,890249,Nie; Jiawang,23,0,30,7
1745140895578,MATH 170B,A01,957891,Nag; Panchali,25,0,35,10
1745140897637,MATH 181A,A01,908025,Staff,0,8,35,35
1745140898663,MATH 193B,A01,890265,Staff,3,0,35,32
1745140899694,MGT 4,A01,890311,Anderson; John Charles,57,0,88,31
1745140900721,MGT 5,A00,907740,Staff,41,0,98,57
1745140901752,MGT 12,A00,890312,Lindenberger; Wade Douglas,70,0,98,28
1745140902779,MGT 16,A00,957883,Staff,84,0,98,14
1745140904841,MGT 45,A00,890314,Pecore; Joseph P.,57,0,98,41
1745140905870,MGT 71,A00,890315,Staff,6,0,98,92
1745140906898,MGT 100,A00,890316,Yavorsky; Daniel Ryan,59,0,98,39
1745140907927,MGT 103,A00,890317,Ehrich; Kristine R,77,0,98,21
1745140908959,MGT 105,A00,890356,Bates; Kenneth Walter,19,0,98,79
1745140909985,MGT 112,A00,890360,Ehrich; Kristine R,65,0,98,33
1745140911015,MGT 127R,A00,907732,Zhu; Kevin Xiaoguo,32,0,98,66
1745140912044,MGT 131B,A00,890361,Anderson; John Charles,75,0,98,23
1745140913073,MGT 137,A00,890362,Lindenberger; Wade Douglas,68,0,98,30
1745140914103,MGT 160,A00,890369,Johnson; Erik Barry,37,0,98,61
1745140916156,MGT 164,A00,890372,Zimmermann; Carsten,0,28,98,98
1745140917182,MGT 180,A00,890374,Bliss; Barbara Ann,32,0,98,66
1745140918210,MMW 15,A01,886414,Chang; Edmond Yi-Teh,0,10,28,28
1745140918210,MMW 15,A02,886415,Chang; Edmond Yi-Teh,0,10,28,28
1745140918210,MMW 15,A03,886416,Chang; Edmond Yi-Teh,0,8,28,28
1745140918210,MMW 15,A04,886417,Chang; Edmond Yi-Teh,0,8,28,28
1745140918210,MMW 15,B01,886419,Chang; Edmond Yi-Teh,0,8,28,28
1745140918210,MMW 15,B02,886420,Chang; Edmond Yi-Teh,0,9,28,28
1745140918210,MMW 15,B03,886421,Chang; Edmond Yi-Teh,0,9,28,28
1745140918210,MMW 15,B04,886422,Chang; Edmond Yi-Teh,0,9,28,28
1745140918210,MMW 15,C01,886424,Staff,0,10,28,28
1745140918210,MMW 15,C02,886425,Staff,0,10,28,28
1745140918210,MMW 15,C03,886426,Staff,0,9,28,28
1745140918210,MMW 15,C04,886427,Staff,0,9,28,28
1745140919242,MMW 15GS,A00,906910,Patterson; Patrick H.,5,0,28,23
1745140920269,MMW 122R,A01,886429,Rahimi; Babak,0,23,28,28
1745140920269,MMW 122R,A02,886430,Rahimi; Babak,0,23,28,28
1745140921303,MUS 1A,A01,890937,Staff,8,0,25,17
1745140921303,MUS 1A,A02,891035,Staff,15,0,25,10
1745140921303,MUS 1A,B00,907849,Staff,48,0,50,2
1745140921303,MUS 1A,B01,907850,Staff,25,0,25,0
1745140921303,MUS 1A,B02,907851,Staff,25,0,25,0
1745140923362,MUS 2AK,A00,957092,Ohnishi; Takae,15,0,15,0
1745140924396,MUS 4,A01,891044,Staff,6,0,25,19
1745140924396,MUS 4,A02,891045,Staff,24,0,25,1
1745140924396,MUS 4,B01,891048,Staff,20,0,25,5
1745140924396,MUS 4,B02,891050,Staff,25,0,25,0
1745140925432,MUS 5,A01,957506,Dubnov; Shlomo,4,0,25,21
1745140925432,MUS 5,A02,957622,Dubnov; Shlomo,21,0,25,4
1745140925432,MUS 5,A03,957623,Dubnov; Shlomo,23,0,25,2
1745140926459,MUS 6,A01,891053,Freitas Caetano; Marcelo,23,0,25,2
1745140926459,MUS 6,A02,891054,Freitas Caetano; Marcelo,23,0,25,2
1745140927485,MUS 7,A01,891081,Staff,0,0,25,25
1745140927485,MUS 7,A02,891082,Staff,15,0,25,10
1745140928512,MUS 8GS,A00,891118,Borgo; David Garcia,5,0,25,20
1745140929539,MUS 11,A01,891140,Staff,12,0,25,13
1745140929539,MUS 11,A02,891141,Staff,24,0,25,1
1745140930569,MUS 13,A01,891143,Staff,10,0,25,15
1745140930569,MUS 13,A02,891144,Staff,25,0,25,0
1745140931596,MUS 15,A01,891146,Staff,7,0,25,18
1745140931596,MUS 15,A02,891148,Staff,22,0,25,3
1745140931596,MUS 15,B01,891150,Staff,18,0,25,7
1745140931596,MUS 15,B02,891151,Staff,25,0,25,0
1745140932623,MUS 20,A01,891153,Staff,9,0,20,11
1745140932623,MUS 20,A02,891155,Staff,16,0,20,4
1745140933651,MUS 80,A00,891156,Staff,19,0,25,6
1745140933651,MUS 80,B00,891157,Staff,25,0,25,0
1745140934677,MUS 130,A00,891158,Ohnishi; Takae,35,0,35,0
1745140935709,MUS 150GS,A01,891160,Borgo; David Garcia,5,0,25,20
1745140936734,MUS 170,A01,891162,Freitas Caetano; Marcelo,21,0,25,4
1745140936734,MUS 170,A02,891164,Freitas Caetano; Marcelo,22,0,25,3
1745140937764,NANO 11,A00,886220,Vazquez Mena; Oscar,12,0,15,3
1745140938792,NANO 15,A01,886222,Drews; Aaron,9,0,10,1
1745140939821,NANO 104,A00,886224,Sirbuly; Donald,18,0,25,7
1745140940847,PH 40,A00,886528,Staff,29,0,40,11
1745140941874,PH 45,A01,886799,Staff,36,0,40,4
1745140942901,PH 110,A00,886802,Staff,7,0,40,33
1745140943932,PH 172,A00,906716,Staff,20,0,35,15
1745140944956,PH 191,A00,886803,Staff,23,0,40,17
1745140945985,PHIL 1,A00,889500,Staff,22,0,30,8
1745140947020,PHIL 10,A01,889549,Grush; Rick Scott,17,0,22,5
1745140947020,PHIL 10,A02,889551,Grush; Rick Scott,20,0,22,2
1745140948053,PHIL 28,A01,889559,Lamey; Andy M.,0,4,25,25
1745140948053,PHIL 28,A02,889561,Lamey; Andy M.,0,0,25,25
1745140948053,PHIL 28,A03,889572,Lamey; Andy M.,7,0,25,18
1745140949079,PHIL 35,A00,907839,Staff,32,0,33,1
1745140950106,PHIL 60,A00,889574,Staff,79,0,90,11
1745140951135,PHIL 105,A00,889579,Staff,0,1,0,0
1745140952161,PHIL 136,A00,889582,Fulkerson; Matthew Todd,27,0,45,18
1745140953185,PHIL 163,A01,889601,Staff,24,0,30,6
1745140953185,PHIL 163,B01,889606,Brandt; Reuven A,0,2,0,0
1745140954214,PHIL 164,A00,889610,Staff,20,0,30,10
1745140955239,PHIL 165,A00,889613,Staff,26,0,30,4
1745140956266,PHYS 1A,A00,886431,Staff,38,0,70,32
1745140957300,PHYS 1AL,001,886432,Tsai; Philbert S,0,0,30,30
1745140957300,PHYS 1AL,002,886436,Tsai; Philbert S,19,0,30,11
1745140958327,PHYS 1B,A00,886439,Staff,192,0,240,48
1745140959353,PHYS 1BL,001,886441,Tsai; Philbert S,0,1,30,30
1745140959353,PHYS 1BL,002,886444,Tsai; Philbert S,14,0,30,16
1745140960379,PHYS 1C,A00,896092,Arnold; Kam S,87,0,146,59
1745140961467,PHYS 1CL,001,886448,Tsai; Philbert S,0,4,30,30
1745140961467,PHYS 1CL,002,886449,Tsai; Philbert S,6,0,30,24
1745140961467,PHYS 1CL,003,886450,Tsai; Philbert S,22,0,30,8
1745140961467,PHYS 1CL,004,886451,Tsai; Philbert S,16,0,30,14
1745140962499,PHYS 2B,A01,886457,Staff,86,0,115,29
1745140963531,PHYS 2C,A01,886460,Shotwell; Brian,0,0,65,65
1745140964561,PHYS 2CL,A01,886467,Staff,0,3,28,28
1745140964561,PHYS 2CL,A02,886468,Staff,5,0,28,23
1745140965586,PHYS 2D,A01,886470,Staff,17,0,50,33
1745140966612,PHYS 4B,A01,886475,Grinstein; Benjamin,88,0,100,12
1745140967645,POLI 5,A00,891173,Desposato; Scott,17,0,25,8
1745140968673,POLI 5D,A01,891175,Staff,5,0,5,0
1745140968673,POLI 5D,B01,891178,Staff,5,0,5,0
1745140969699,POLI 11,A00,891179,Ferree; Karen E,3,0,25,22
1745140970726,POLI 12,A00,891180,Staff,21,0,30,9
1745140971752,POLI 27,A01,891182,Staff,29,0,75,46
1745140972782,POLI 30,A00,891183,Staff,0,3,30,30
1745140973810,POLI 100B,A00,891244,Staff,0,8,20,20
1745140974835,POLI 100I,A00,891247,Staff,19,0,30,11
1745140975862,POLI 104J,A00,891248,Nichter; Maysa,18,0,30,12
1745140976927,POLI 104U,A00,891250,Nichter; Maysa,9,0,30,21
1745140977957,POLI 108,A00,891253,Staff,0,0,0,4
1745140978983,POLI 110B,A00,891255,Wiens; David,22,0,25,3
1745140980008,POLI 112A,A00,891256,Wiens; David,15,0,25,10
1745140981033,POLI 114BR,A00,891261,Staff,22,0,30,8
1745140982057,POLI 117R,A00,891262,Forman; Fonna,12,0,50,38
1745140983088,POLI 118,A00,891264,Ingham; Sean,22,0,25,3
1745140984117,POLI 124A,A00,891265,Staff,19,0,20,1
1745140985148,POLI 125D,A00,891266,Nichter; Simeon C,9,0,25,16
1745140986175,POLI 126,A00,891268,Nichter; Simeon C,11,0,25,14
1745140987203,POLI 126AA,A00,891272,Staff,19,0,25,6
1745140988229,POLI 130AA,A00,891273,Staff,17,0,20,3
1745140989260,POLI 134AA,A00,891274,Staff,12,0,20,8
1745140991319,POLI 138,A00,891278,Staff,22,0,25,3
1745140992345,POLI 142K,A00,891280,Staff,17,0,25,8
1745140993375,POLI 142M,A00,891281,Gartzke; Erik,22,0,30,8
1745140994399,POLI 142P,A00,891284,Staff,21,0,30,9
1745140995428,POLI 143,A00,891285,Gartzke; Erik,17,0,30,13
1745140996453,POLI 153,A00,891286,Staff,20,0,20,0
1745140997482,POLI 170A,A00,891288,Staff,19,0,25,6
1745140998507,POLI 175,A00,891290,Staff,18,0,20,2
1745140999536,PSYC 1,A00,890674,Steiner; Eric Tomas,0,4,45,45
1745141000564,PSYC 2,A00,890676,Albright; Thomas D,25,0,35,10
1745141001594,PSYC 3,A00,890679,Staff,18,0,20,2
1745141002628,PSYC 60,A01,890684,Rickard; Timothy C.,7,0,45,38
1745141003652,PSYC 70,A01,890689,Geller; Emma Harlan,14,0,30,16
1745141004680,PSYC 100,A00,890690,Lacefield; Katharine I,0,43,180,180
1745141005708,PSYC 102,A00,890695,Staff,25,0,40,15
1745141006739,PSYC 105,A00,890699,Geller; Emma Harlan,78,0,100,22
1745141007765,PSYC 106,A00,890701,Gorman; Michael R.,15,0,30,15
1745141008793,PSYC 108,A00,890704,Adrian; Julia Anna,0,23,50,50
1745141009822,PSYC 118,A01,890712,Staff,18,0,30,12
1745141010848,PSYC 124,A00,890716,Chapman; Eddie Nathaniel,36,0,60,24
1745141011875,PSYC 131,A00,890717,Anagnostaras; Stephan,6,0,80,74
1745141012902,PSYC 137,A00,890719,Winkielman; Piotr,0,2,30,30
1745141013926,PSYC 144,A00,890721,Adrian; Julia Anna,0,3,45,45
1745141014953,PSYC 162,A00,890805,Staff,21,0,75,54
1745141015980,PSYC 169,A00,890810,Staff,0,15,30,30
1745141017007,PSYC 172,A00,890814,Gorman; Michael R.,14,0,30,16
1745141018035,PSYC 181,A00,890818,Anagnostaras; Stephan,63,0,200,137
1745141019064,PSYC 189,A00,890823,Staff,11,0,30,19
1745141020092,PSYC 191,A00,890884,Rickard; Timothy C.,0,11,35,35
1745141021118,PSYC 193,A00,890913,Staff,22,0,30,8
1745141021118,PSYC 193,B00,890914,Chapman; Eddie Nathaniel,25,0,30,5
1745141022145,PSYC 193L,A01,890918,Lowe; Angela Beth,29,0,30,1
1745141022145,PSYC 193L,B01,890921,Hurwitz; Ethan Scott,28,0,30,2
1745141022145,PSYC 193L,C01,890928,Staff,30,0,30,0
1745141023172,RELI 149,A00,886806,Rahimi; Babak,23,0,40,17
1745141024203,SE 9,A01,886814,Staff,13,0,20,7
1745141025229,SE 101B,A01,886816,Chadha; Mayank,8,0,30,22
1745141026262,SE 110B,A00,886818,Zhu; Qiang,0,16,45,45
1745141027287,SE 125,A01,886830,Staff,10,0,30,20
1745141028313,SE 130B,A01,886835,Staff,19,0,40,21
1745141029343,SE 131A,A01,886838,Krysl; Petr,37,0,55,18
1745141030374,SE 154,A00,886840,Staff,35,0,50,15
1745141031398,SE 164GS,A01,886849,Staff,13,0,20,7
1745141032424,SE 167GS,A01,886853,Staff,13,0,20,7
1745141033454,SIO 25,A01,890107,Staff,23,0,30,7
1745141034489,SIO 45,A00,890109,Cook; Geoffrey W,137,0,200,63
1745141035516,SIO 109R,A00,890110,Forman; Fonna,0,11,20,20
1745141036544,SIO 187,A01,890114,Kacev; David,21,0,40,19
1745141037574,SOCI 1,A01,890431,Thorpe; Charles Robert,21,0,30,9
1745141037574,SOCI 1,A02,890518,Thorpe; Charles Robert,30,0,30,0
1745141038600,SOCI 2,A01,957978,Staff,0,0,0,0
1745141038600,SOCI 2,A02,957979,Staff,0,3,0,0
1745141039627,SOCI 20,A01,890523,Calderon-Zaks; Michael Aar,24,0,30,6
1745141039627,SOCI 20,A02,890526,Calderon-Zaks; Michael Aar,29,0,30,1
1745141040659,SOCI 30,A01,890533,Pardo Guerra; Juan Pablo,37,0,40,3
1745141041689,SOCI 40,A01,890535,Staff,32,0,45,13
1745141042718,SOCI 104Q,A00,890559,Staff,20,0,30,10
1745141043749,SOCI 106,A00,890560,Arnal; Maud Marie Leonie,22,0,30,8
1745141044780,SOCI 110,A00,890567,Holkenbrink-Monk; Charlene,22,0,30,8
1745141045807,SOCI 112,A00,890568,Victoria Torres; Pablo,0,0,45,45
1745141046838,SOCI 115,A00,890597,Arnal; Maud Marie Leonie,33,0,45,12
1745141048900,SOCI 121,A00,890604,Pardo Guerra; Juan Pablo,40,0,45,5
1745141049930,SOCI 126,A01,890608,Staff,8,0,10,2
1745141050957,SOCI 127,A00,890609,Staff,23,0,30,7
1745141051986,SOCI 131,A00,890610,Thorpe; Charles Robert,38,0,45,7
1745141053013,SOCI 135,A00,890615,Payne; Christine Anna,20,0,45,25
1745141054039,SOCI 139,A00,890620,Staff,43,0,45,2
1745141055065,SOCI 148E,A00,890622,Calderon-Zaks; Michael Aar,39,0,45,6
1745141056093,SOCI 150,A00,890623,Kohler; Kristopher M.,36,0,45,9
1745141057123,SOCI 157,A00,890625,Jules-Rosette; Bennetta W.,18,0,20,2
1745141058151,SOCI 160,A00,890627,Payne; Christine Anna,26,0,45,19
1745141059186,SYN 1,A00,886855,Fish; Gwendolyn Anne,0,0,0,0
1745141059186,SYN 1,B00,906086,Fish; Gwendolyn Anne,0,0,0,2
1745141060218,SYN 2R,A00,886860,Staff,0,15,15,15
1745141060218,SYN 2R,B00,906106,Atkinson; Arthur Laird,0,14,15,15
1745141061261,SYN 100,A01,886866,Browne; Emily,0,29,20,20
1745141061261,SYN 100,B01,906128,Rock; Martin,0,4,20,20
1745141061261,SYN 100,C01,906140,Deavenport; James Cary,0,2,20,20
1745141061261,SYN 100,D01,907816,Deavenport; James Cary,0,3,20,20
1745141062289,TDAC 1,A00,890286,Walsh; Kim C.,11,0,20,9
1745141063317,TDAC 101,A00,890296,Basso; Beatrice,18,0,20,2
1745141064346,TDDE 131,A00,890297,Staff,47,0,50,3
1745141065380,TDDM 1,A00,890287,Weinberg; Sadie,26,0,30,4
1745141066414,TDGE 11,A00,890288,Fulton; Julia,155,0,200,45
1745141066414,TDGE 11,B00,890289,Castro; Robert Jess,188,0,200,12
1745141067441,TDGE 25,B00,957359,Walsh; Kim C.,9,0,20,11
1745141068469,TDGE 40,A01,890292,Power; Jade Yukana,28,0,30,2
1745141069499,TDGE 124,A00,890298,Havis; Allan,12,0,50,38
1745141070525,TDGE 131R,A00,890299,Burelle; Julie Sara Veronique,20,0,42,22
1745141071551,TDHT 101,A00,890300,Staff,12,0,20,8
1745141072613,TDHT 109,A01,890302,Anderson; Mysia Anyse,31,0,40,9
1745141073643,TDMV 1,A00,890293,Arcidiacono; Kristin,20,0,30,10
1745141074669,TDMV 2,A00,890294,Weinberg; Sadie,26,0,30,4
1745141075697,TDMV 3,A00,957878,Arcidiacono; Kristin,27,0,30,3
1745141078310,TDMV 138,A00,890304,Jun; Grace Shin Hae,25,0,40,15
1745141079336,TDMV 140,A00,890305,Corrales; Joseph Bernales,28,0,30,2
1745141080363,TDMV 142,A00,890307,Caligagan; Tony,30,0,40,10
1745141081392,TDMV 144,A00,890308,Camaya; Michelle Ann,26,0,30,4
1745141082418,TDPW 1,A00,890295,Stein; Deborah Isobel,5,0,20,15
1745141083451,USP 2,A01,890272,Lerner; Amy M,8,0,20,12
1745141084478,USP 3,A01,890274,Staff,21,0,30,9
1745141085504,USP 15,A01,890276,Sun; Feiyang,21,0,30,9
1745141086537,USP 25,A00,890277,Shenkman; Michael Thomas,21,0,25,4
1745141087563,USP 138,A00,890278,Staff,15,0,25,10
1745141088592,USP 143,A00,890279,Staff,30,0,70,40
1745141089624,USP 144,A00,890280,Chowdhury; Muhammed Zohir,19,0,30,11
1745141090651,USP 150,A00,890281,Boomhower; Matthew Charles,19,0,30,11
1745141091678,USP 151,A00,890282,Staff,17,0,20,3
1745141092705,USP 162,A00,890283,Andrews; Abigail Leslie,17,0,20,3
1745141093732,USP 168,A00,920477,Kwak; Nancy,2,0,5,3
1745141094762,USP 181,A00,890284,Staff,11,0,20,9
1745141095835,USP 191A,A00,890285,Staff,15,0,20,5
1745141096862,VIS 101,A00,886512,Staff,37,0,75,38
1745141097895,VIS 103,A00,886513,Cruz; Edwin Teddy,65,0,75,10
1745141098922,VIS 108,A00,886514,Staff,7,0,15,8
1745141099956,VIS 127P,A00,886515,Shen; Kuiyi,92,0,146,54
1745141100984,VIS 149,A00,886516,Yoldas; Pinar,1,0,15,14
1745141102013,VIS 164,A00,886526,Erdmann; Dean,21,0,22,1
1745141103042,VIS 194S,A00,886527,Staff,61,0,75,14
1745141104070,WCWP 10A,C00,886484,Staff,13,0,15,2
1745141105105,WCWP 10B,A00,886490,Staff,5,0,15,10
1745141105105,WCWP 10B,B00,886491,Staff,0,1,0,0
1745141105105,WCWP 10B,C00,886492,Staff,10,0,15,5
1745141106136,WCWP 100,A00,886494,Staff,0,2,15,15
1745141108270,AAS 10,A01,886199,Childs; Dennis R.,0,2,0,0
1745141109299,ANAR 104,A01,886940,Shtienberg; Gilad,27,0,30,3
1745141110326,ANAR 120,A00,886953,Staff,13,0,20,7
1745141111356,ANBI 148,A01,886955,Wilder; Linnea Lorene,32,0,40,8
1745141113420,ANSC 122,A00,886957,Staff,28,0,30,2
1745141114449,ANSC 150,A00,886958,Sloane; Julia Kathryn,6,0,15,9
1745141115479,ANSC 156,A00,886959,Jenkins; Janis A.,2,0,15,13
1745141116509,ANSC 180,A00,886960,Staff,12,0,17,5
1745141117542,ANSC 188,A00,886961,Jassal; Aftab,10,0,25,15
1745141118573,ANSC 190,A00,886962,Jassal; Aftab,14,0,25,11
1745141119601,ANSC 191,A00,886963,Staff,18,0,20,2
1745141120629,ANTH 3,A01,891689,Staff,19,0,20,1
1745141121654,ANTH 5,A00,886933,Semendeferi; Ekaterini,18,0,20,2
1745141122683,ANTH 10,A00,886934,Staff,0,8,30,30
1745141123712,ANTH 21,A01,886936,Staff,44,0,60,16
1745141124744,ANTH 23,A01,886938,Staff,94,0,100,6
1745141125771,ANTH 105,A00,886964,Stewart; Alexander B,94,0,100,6
1745141126802,ANTH 108,A00,886965,Pedersen; David,10,0,20,10
1745141127841,AWP 10,001,886147,Staff,0,0,0,0
1745141127841,AWP 10,002,886148,Staff,0,0,0,0
1745141127841,AWP 10,003,886149,Staff,0,0,0,0
1745141127841,AWP 10,004,886150,Staff,0,0,0,0
1745141127841,AWP 10,005,886151,Staff,0,0,0,0
1745141127841,AWP 10,006,886152,Staff,0,0,0,0
1745141127841,AWP 10,007,886153,Staff,0,0,0,0
1745141127841,AWP 10,008,886154,Staff,0,0,0,0
1745141127841,AWP 10,009,886155,Staff,0,0,0,0
1745141127841,AWP 10,010,886156,Staff,0,0,0,0
1745141127841,AWP 10,011,886158,Staff,0,0,0,0
1745141127841,AWP 10,012,886160,Staff,0,0,0,0
1745141127841,AWP 10,013,886161,Staff,0,0,0,0
1745141127841,AWP 10,014,886162,Staff,0,0,0,0
1745141127841,AWP 10,015,886163,Staff,0,0,0,0
1745141127841,AWP 10,016,886164,Staff,0,0,0,0
1745141127841,AWP 10,017,886165,Staff,0,0,0,0
1745141127841,AWP 10,018,886166,Staff,0,0,0,0
1745141127841,AWP 10,019,886168,Staff,0,0,0,0
1745141127841,AWP 10,020,886170,Staff,0,0,0,0
1745141127841,AWP 10,021,886172,Staff,0,0,0,0
1745141128884,AWP 10R,001,886173,Staff,0,0,0,0
1745141128884,AWP 10R,002,886174,Staff,0,1,0,0
1745141128884,AWP 10R,003,886175,Staff,0,0,0,0
1745141128884,AWP 10R,004,886176,Staff,0,0,0,0
1745141128884,AWP 10R,005,886177,Staff,0,0,0,0
1745141128884,AWP 10R,006,886178,Staff,0,0,0,0
1745141128884,AWP 10R,007,886179,Staff,0,0,0,0
1745141128884,AWP 10R,008,886181,Staff,0,0,0,0
1745141128884,AWP 10R,009,886182,Staff,0,0,0,0
1745141128884,AWP 10R,010,886183,Staff,0,0,0,0
1745141128884,AWP 10R,011,886184,Staff,0,0,0,0
1745141128884,AWP 10R,012,886185,Staff,0,0,0,0
1745141128884,AWP 10R,013,886186,Staff,0,0,0,0
1745141128884,AWP 10R,014,886187,Staff,0,0,0,0
1745141128884,AWP 10R,015,886188,Staff,0,0,0,0
1745141128884,AWP 10R,016,886189,Staff,0,0,0,0
1745141129910,AWP 102R,A00,886190,Staff,0,0,0,0
1745141129910,AWP 102R,B00,886191,Staff,0,0,0,0
1745141130940,BENG 100,A01,886193,Staff,19,0,30,11
1745141131965,BENG 122A,A01,886195,Hasty; Jeff M,20,0,30,10
1745141132992,BENG 166A,A00,886196,Sah; Robert Lie-Yuan,0,3,20,20
1745141134021,BIBC 102,A01,894320,Staff,0,2,46,46
1745141134021,BIBC 102,A02,894321,Staff,0,0,46,46
1745141134021,BIBC 102,A03,894344,Staff,21,0,46,25
1745141134021,BIBC 102,A04,894345,Staff,30,0,47,17
1745141135047,BICD 100R,A01,894365,Smith; Laurie,1,3,58,57
1745141135047,BICD 100R,A02,894366,Smith; Laurie,0,1,58,58
1745141135047,BICD 100R,A03,894367,Smith; Laurie,13,0,59,46
1745141136080,BICD 136,A01,894383,Gustafson-Brown; Cindy,16,0,50,34
1745141137108,BIEB 102,A01,894494,Butler; Shannon Rhey,67,0,130,63
1745141139172,BIEB 150,A01,894617,Wills; Christopher,0,3,13,13
1745141139172,BIEB 150,A02,894631,Wills; Christopher,0,3,13,13
1745141139172,BIEB 150,A03,894937,Wills; Christopher,0,3,13,13
1745141139172,BIEB 150,A04,894946,Wills; Christopher,0,1,11,11
1745141140197,BIEB 194,A00,906141,Kurle; Carolyn M.,14,0,20,6
1745141141223,BILD 1,A01,894154,Staff,8,0,19,11
1745141141223,BILD 1,A02,894155,Staff,15,0,19,4
1745141141223,BILD 1,A03,894160,Staff,18,0,19,1
1745141141223,BILD 1,A04,894161,Staff,16,0,18,2
1745141142248,BILD 2,A01,894168,Staff,0,0,50,50
1745141142248,BILD 2,A02,894169,Staff,0,0,50,50
1745141142248,BILD 2,A03,894179,Staff,27,0,50,23
1745141142248,BILD 2,A04,894203,Staff,42,0,50,8
1745141143274,BILD 3,A01,894213,Staff,24,0,31,7
1745141143274,BILD 3,A02,894214,Staff,28,0,31,3
1745141143274,BILD 3,A03,894235,Staff,30,0,31,1
1745141143274,BILD 3,A04,894236,Staff,29,0,32,3
1745141144306,BILD 4,A01,894253,Reuther; Keefe,12,0,24,12
1745141144306,BILD 4,A02,894258,Reuther; Keefe,19,0,24,5
1745141145333,BILD 5,A01,894276,Reuther; Keefe,40,0,50,10
1745141145333,BILD 5,A02,894277,Reuther; Keefe,48,0,50,2
1745141145333,BILD 5,A03,894290,Reuther; Keefe,47,0,50,3
1745141145333,BILD 5,A04,894291,Reuther; Keefe,50,0,50,0
1745141146375,BILD 24,A01,894297,Pirino; Giorgia,45,0,60,15
1745141147405,BIMM 100,A01,895012,Staff,0,14,0,1
1745141147405,BIMM 100,A02,895013,Staff,0,6,0,2
1745141147405,BIMM 100,A03,895014,Staff,0,7,0,0
1745141147405,BIMM 100,A04,895015,Staff,0,4,0,0
1745141148432,BIMM 101,A01,895017,McDonnell; Lisa Marie,0,2,24,24
1745141148432,BIMM 101,A02,895018,McDonnell; Lisa Marie,0,1,24,24
1745141148432,BIMM 101,B01,895020,McDonnell; Lisa Marie,0,3,24,24
1745141148432,BIMM 101,B02,895021,McDonnell; Lisa Marie,0,2,24,24
1745141149458,BIMM 110,A01,895023,Staff,7,0,25,18
1745141149458,BIMM 110,A02,895024,Staff,11,0,25,14
1745141149458,BIMM 110,A03,895025,Staff,22,0,25,3
1745141149458,BIMM 110,A04,895031,Staff,21,0,25,4
1745141150492,BIMM 120,A01,895114,Gustafson-Brown; Cindy,8,0,28,20
1745141150492,BIMM 120,A02,895126,Gustafson-Brown; Cindy,19,0,27,8
1745141151524,BIPN 100,A01,895130,Yang; Mingyu,13,0,38,25
1745141151524,BIPN 100,A02,895131,Yang; Mingyu,33,0,38,5
1745141151524,BIPN 100,A03,895132,Yang; Mingyu,33,0,38,5
1745141151524,BIPN 100,A04,895133,Yang; Mingyu,30,0,36,6
1745141152551,BIPN 120,A01,895135,Cooke; James Edward,0,2,13,13
1745141152551,BIPN 120,A02,895136,Cooke; James Edward,0,1,13,13
1745141152551,BIPN 120,A03,895137,Cooke; James Edward,0,0,13,13
1745141152551,BIPN 120,A04,895156,Cooke; James Edward,3,0,11,8
1745141153578,BIPN 134,A01,895235,Cooke; James Edward,0,2,25,25
1745141153578,BIPN 134,A02,895237,Cooke; James Edward,0,0,25,25
1745141153578,BIPN 134,A03,895240,Cooke; James Edward,12,0,25,13
1745141153578,BIPN 134,A04,895270,Cooke; James Edward,24,0,25,1
1745141154612,BIPN 189,A00,892103,Staff,0,20,9,9
1745141156667,CAT 124,A01,922009,Staff,0,1,20,20
1745141157696,CAT 125R,A00,886390,Morales; Celeste Georgianna,4,0,20,16
1745141157696,CAT 125R,B00,886391,Irwin; Matthew Joseph,0,1,20,20
1745141157696,CAT 125R,C00,886392,Smith; Lauryn Alissa,11,0,20,9
1745141157696,CAT 125R,D00,886393,Vanderschuit; Maya Alysia,6,0,20,14
1745141157696,CAT 125R,E00,886394,Marchisotto; Jennifer Anne,0,2,20,20
1745141158730,CENG 15,A01,886218,Drews; Aaron,1,0,5,4
1745141159772,CENG 113,A00,886219,Opatkiewicz; Justin Paul,16,0,25,9
1745141160803,CGS 101,A00,887044,Staff,13,0,20,7
1745141161831,CGS 105,A01,887046,Staff,16,0,25,9
1745141162862,CGS 112,A00,887047,Cuong; Marisol,12,0,15,3
1745141163890,CGS 113,A00,887048,Staff,24,0,30,6
1745141164916,CGS 120,A00,887049,Staff,12,0,17,5
1745141165946,CHEM 6A,A01,886336,Lam; Tin Yiu,44,0,50,6
1745141165946,CHEM 6A,A02,886338,Lam; Tin Yiu,43,0,50,7
1745141166979,CHEM 6B,A01,886341,Hopkins; Patrycja Anna,21,0,50,29
1745141166979,CHEM 6B,A02,886343,Hopkins; Patrycja Anna,46,0,50,4
1745141168012,CHEM 6C,A01,886346,Albizati; Kim F.,0,1,50,50
1745141168012,CHEM 6C,A02,886348,Albizati; Kim F.,38,0,50,12
1745141169041,CHEM 40A,A01,886352,Klosterman; Jeremy K,70,0,100,30
1745141170071,CHEM 40B,A01,886356,Klosterman; Jeremy K,0,4,100,100
1745141171104,CHEM 41B,A01,886360,Theodorakis; Emmanuel,30,0,50,20
1745141171104,CHEM 41B,A02,886362,Theodorakis; Emmanuel,46,0,50,4
1745141172131,CHIN 165A,A00,886382,Xu; Li,19,0,20,1
1745141173158,CLAS 120,A00,886387,Myerston Santana; Jacobo,36,0,40,4
1745141174185,COGS 9,A01,886967,Shannon; Kyle Michael,49,0,60,11
1745141175211,COGS 11,A01,886969,Staff,18,0,30,12
1745141176237,COGS 14A,A01,886971,Staff,26,0,60,34
1745141177263,COGS 14B,A01,886973,Hoffman; Drew Ellen,18,0,60,42
1745141178290,COGS 18,A01,886975,Morgan; Eric,41,0,60,19
1745141179315,COGS 20,A01,886977,Staff,6,0,8,2
1745141179315,COGS 20,A02,886978,Staff,6,0,7,1
1745141180342,COGS 100,A01,907783,Staff,6,0,30,24
1745141181376,COGS 101B,A01,886980,Staff,0,10,30,30
1745141182402,COGS 101C,A01,886982,Delgado; Tania,0,6,30,30
1745141183434,COGS 102A,A01,886984,Johnson; Christine M.,13,0,30,17
1745141184460,COGS 118B,A01,886986,Staff,0,25,60,60
1745141185491,COGS 150,A01,886988,Bergen; Benjamin,16,0,30,14
1745141186521,COGS 153,A00,886989,Delgado; Tania,0,6,30,30
1745141187550,COGS 186,A01,886991,Staff,3,0,30,27
1745141188580,COGS 187A,A01,886993,Boyle; Mary E. T.,12,0,30,18
1745141189605,COGS 189,A00,886994,Staff,13,0,30,17
1745141190631,COMM 10,A01,886996,Staff,11,0,25,14
1745141190631,COMM 10,A02,886997,Staff,21,0,25,4
1745141191659,COMM 20,A01,886999,Leuning; Grant Maurstad,33,0,40,7
1745141193710,COMM 100A,A01,887002,Staff,0,0,25,25
1745141193710,COMM 100A,A02,887003,Staff,20,0,25,5
1745141194739,COMM 100B,A01,887005,Staff,0,1,25,25
1745141195768,COMM 106D,A00,887006,Staff,22,0,40,18
1745141196793,COMM 110G,A00,887007,Whitworth-Smith; Andrew C,17,0,40,23
1745141197819,COMM 111B,A00,887008,Staff,31,0,40,9
1745141198845,COMM 113T,A00,887009,Abuelhiga; Soraya Jill,30,0,40,10
1745141198845,COMM 113T,B00,906733,Staff,40,0,40,0
1745141199874,COMM 145,A00,887010,Staff,21,0,40,19
1745141200900,COMM 146,A00,887054,Staff,31,0,40,9
1745141201926,COMM 190,A00,887012,Staff,9,0,23,14
1745141202954,CSE 8A,A50,887015,Cao; Yingjun,68,0,85,17
1745141203985,CSE 11,A01,887017,Cao; Yingjun,35,0,70,35
1745141205014,CSE 20,A01,887019,Staff,35,0,50,15
1745141206042,CSE 21,A01,887021,Braun; Oliver,81,0,100,19
1745141206042,CSE 21,B01,892583,Staff,48,0,50,2
1745141207068,CSE 30,A01,887025,Eldon; John,161,0,200,39
1745141208154,CSE 100,A01,887027,Staff,28,0,50,22
1745141208154,CSE 100,A02,887028,Staff,43,0,50,7
1745141209181,CSE 101,A01,887030,Braun; Oliver,79,0,100,21
1745141209181,CSE 101,B01,887032,Jones; Miles E,0,1,50,50
1745141209181,CSE 101,B02,887033,Jones; Miles E,13,0,50,37
1745141210208,CSE 105,A01,908084,Jones; Miles E,36,0,50,14
1745141210208,CSE 105,A02,908087,Jones; Miles E,38,0,50,12
1745141211239,CSE 135,A01,887035,Powell; Thomas Allan,8,0,50,42
1745141212268,CSE 142,A01,887037,Staff,22,0,60,38
1745141213296,CSE 142L,A01,887039,Staff,42,0,60,18
1745141214325,CSE 151A,A01,887041,Solares; Edwin A,60,0,100,40
1745141215354,CSE 175,A01,887043,Kumar; Rakesh,30,0,30,0
1745141216381,CSS 1,A01,886389,Staff,12,0,40,28
1745141217412,DSC 30,A01,908097,Liao; Soohyun Nam,54,0,75,21
1745141218443,DSC 40A,A01,908099,Shannon; Kyle Michael,37,0,50,13
1745141219468,DSC 40B,A01,908112,Staff,28,0,50,22
1745141220493,DSC 80,A01,908116,Staff,32,0,60,28
1745141221520,DSC 197,001,956863,Eldridge; Justin Matthew,9999,0,9999,0
1745141222554,ECE 5,A01,886400,Morris; Karcher William,3,0,6,3
1745141222554,ECE 5,A02,886401,Morris; Karcher William,5,0,6,1
1745141223581,ECE 148,A01,886403,Silberman; Jack,0,8,14,14
1745141224610,ECON 1,A01,887265,Crane; Meredith Helen,25,0,70,45
1745141224610,ECON 1,B01,887268,Staff,44,0,50,6
1745141225637,ECON 2,A01,887273,Crane; Meredith Helen,61,0,70,9
1745141226669,ECON 3,A01,887279,Rondina; Giacomo,44,0,70,26
1745141227701,ECON 4,A01,887282,Anderson; John Charles,0,1,10,10
1745141228730,ECON 5,A01,887285,Staff,39,0,45,6
1745141228730,ECON 5,B01,887292,Staff,43,0,45,2
1745141229763,ECON 100A,A01,887337,Newhouse; Herbert S,58,0,70,12
1745141229763,ECON 100A,B01,887349,Staff,45,0,50,5
1745141230789,ECON 100B,A01,887361,Du; Songzi,42,0,70,28
1745141231816,ECON 100C,A01,887445,Newhouse; Herbert S,61,0,70,9
1745141232850,ECON 105,A00,887488,Vespa; Emanuel Ignacio,24,0,35,11
1745141233880,ECON 109,A01,887506,Staff,29,0,35,6
1745141234910,ECON 110A,A01,887568,Alon; Titan Michael,1,0,35,34
1745141234910,ECON 110A,B01,907601,Alon; Titan Michael,27,0,35,8
1745141235937,ECON 110B,A01,887598,Levkoff; Steven B.,0,7,70,70
1745141236965,ECON 112,A00,887599,Rondina; Giacomo,20,0,35,15
1745141237996,ECON 120A,A01,887603,Dai; Yinlin,46,0,70,24
1745141239024,ECON 120C,A01,887608,Sun; Yixiao,0,0,35,35
1745141239024,ECON 120C,B01,887614,Sun; Yixiao,13,0,35,22
1745141240054,ECON 138,A00,887621,Bharadwaj; Prashant,0,18,20,20
1745141241080,ECON 171,A01,907666,Staff,27,0,35,8
1745141242111,ECON 175,A00,887626,Wu; Pak Yeung,27,0,35,8
1745141243142,ECON 190,A00,887640,Vespa; Emanuel Ignacio,26,0,35,9
1745141244174,EDS 25,A01,888197,Staff,0,0,0,0
1745141244174,EDS 25,A02,888209,Staff,0,0,0,0
1745141244174,EDS 25,A03,888210,Staff,0,0,0,0
1745141244174,EDS 25,A04,888212,Staff,0,0,0,0
1745141244174,EDS 25,A05,888213,Staff,0,0,0,0
1745141244174,EDS 25,A06,888214,Staff,0,0,0,0
1745141244174,EDS 25,A07,888235,Staff,0,0,0,0
1745141244174,EDS 25,A08,888236,Staff,0,0,0,0
1745141244174,EDS 25,A09,888240,Staff,0,0,0,0
1745141244174,EDS 25,A10,888244,Staff,0,0,0,0
1745141244174,EDS 25,B01,888273,Staff,0,0,0,0
1745141244174,EDS 25,B02,888285,Staff,0,0,0,0
1745141244174,EDS 25,B03,888423,Staff,29,0,30,1
1745141244174,EDS 25,B04,888432,Staff,0,0,0,0
1745141244174,EDS 25,B05,888433,Staff,0,0,0,0
1745141244174,EDS 25,B06,888467,Staff,0,0,0,0
1745141244174,EDS 25,B07,888468,Staff,0,0,0,0
1745141244174,EDS 25,B08,888479,Staff,0,0,0,0
1745141244174,EDS 25,B09,888484,Staff,0,0,0,0
1745141244174,EDS 25,B10,888487,Staff,0,0,0,0
1745141245201,EDS 38,A01,907700,Choi; Bailey Miyeon,30,0,30,0
1745141246228,EDS 112,A01,888601,Chapman; Thandeka K,23,0,40,17
1745141247255,EDS 115,A00,888697,Mendez; Kathrina Mendoza,17,0,30,13
1745141248282,EDS 116,A01,888893,Staff,38,0,40,2
1745141250342,EDS 124AR,A00,889133,Staff,33,0,50,17
1745141250342,EDS 124AR,B00,907471,Simon; Elizabeth A,42,0,50,8
1745141251375,EDS 124BR,A00,889134,Staff,57,0,100,43
1745141252403,EDS 125,A00,889135,Staff,26,0,30,4
1745141253428,EDS 126,A01,889138,Staff,37,0,40,3
1745141254455,EDS 164R,A01,889142,Wishard Guerra; Alison G.,38,0,50,12
1745141255482,ENG 30,A01,886396,Staff,0,0,0,0
1745141255482,ENG 30,B01,886398,Staff,0,0,0,0
1745141256510,ENVR 102,A00,906150,Montejo; Carolina,23,0,25,2
1745141257543,ETHN 103A,A00,887236,Man; Simeon S,0,5,0,0
1745141258569,ETHN 113,A00,887239,Staff,20,0,30,10
1745141259597,ETHN 116,A00,887240,Staff,20,0,25,5
1745141260623,ETHN 117,A00,887241,Choi; Esther Min,27,0,30,3
1745141261649,ETHN 118,A00,887243,Staff,24,0,30,6
1745141262676,ETHN 127,A00,887248,Cuong; Marisol,12,0,15,3
1745141263707,ETHN 139,A00,887250,Staff,8,0,10,2
1745141264732,ETHN 142,A00,887252,Staff,18,0,30,12
1745141265763,ETHN 161,A00,887253,Browne; Errol Tsekani,28,0,30,2
1745141266791,ETHN 163FR,A00,887255,Burelle; Julie Sara Veronique,4,0,5,1
1745141267819,GLBH 20,A00,889149,Elwardani; Nile Regina,15,0,42,27
1745141269872,GLBH 111,A01,889152,Burgos; Jose L.,17,0,17,0
1745141270903,GLBH 150,A00,889181,Sloane; Julia Kathryn,0,1,15,15
1745141272960,HDS 60,A01,886406,Warstadt; Melissa Fawn,76,0,80,4
1745141273987,HIAF 111,A00,889324,Gyamfi; Bright,0,4,0,0
1745141275013,HIEA 131,A00,889328,Staff,14,0,32,18
1745141276041,HIEA 144,A00,889333,Henry; Todd A.,29,0,32,3
1745141277067,HIEA 154,A00,889336,Henry; Todd A.,28,0,32,4
1745141278094,HIEU 106,A00,889339,Staff,28,0,32,4
1745141280154,HIEU 114,A00,889340,Staff,18,0,32,14
1745141281185,HIEU 135GS,A00,889342,Patterson; Patrick H.,0,0,1,22
1745141282210,HIEU 137,A00,889343,Edington; Claire Ellen,12,0,25,13
1745141283236,HIEU 148,A00,889345,Staff,16,0,32,16
1745141284263,HIEU 154,A00,889346,Biess; Frank Peter,24,0,32,8
1745141285289,HILA 102,A00,889351,Staff,13,0,32,19
1745141286317,HILD 2A,A01,889221,Lewandoski; Julia Mavis,0,5,32,32
1745141287347,HILD 7B,A01,889225,Man; Simeon S,0,7,32,32
1745141288378,HILD 7C,A01,889288,Alvarez; Luis A,0,8,32,32
1745141289404,HILD 30,A01,889323,Staff,0,1,32,32
1745141291456,HISC 119,A00,889383,Golan; Tal,22,0,32,10
1745141292483,HIUS 103,A00,889384,Man; Simeon S,10,0,32,22
1745141293511,HIUS 117,A00,919797,Kwak; Nancy,23,0,32,9
1745141294539,HIUS 142A,A00,919788,Staff,24,0,32,8
1745141296593,HIUS 149,A00,889386,Gyamfi; Bright,0,1,0,0
1745141297618,HIUS 155,A00,889387,Alvarez; Luis A,19,0,32,13
1745141298646,HUM 3,A01,886499,Caldwell; Michael Alan,24,0,50,26
1745141299676,HUM 3GS,A00,886500,Rodriguez; Bretton Sigfred,0,0,0,26
1745141300708,HUM 3R,A01,886502,Markman; Kristina,0,32,50,50
1745141301745,HUM 4,A01,886504,Crum; Matthew Stephen,28,0,50,22
1745141301745,HUM 4,B01,886506,West; Geoffrey Scott,25,0,50,25
1745141302771,HUM 4GS,A00,886507,Staff,0,0,0,13
1745141303798,HUM 5,A01,886509,Staff,35,0,50,15
1745141304825,HUM 5R,A01,886511,Zavodny; Tatiana Sophia,0,32,50,50
1745141305852,JAPN 180,A00,886407,Staff,25,0,40,15
1745141306887,LATI 50,A01,886409,Martin-Cabrera; Luis,9,0,22,13
1745141306887,LATI 50,A02,886410,Martin-Cabrera; Luis,20,0,22,2
1745141306887,LATI 50,A03,886411,Martin-Cabrera; Luis,22,0,22,0
1745141306887,LATI 50,A04,886412,Martin-Cabrera; Luis,15,0,22,7
1745141307919,LAWS 101,A00,907664,Staff,36,0,60,24
1745141308943,LIAB 1A,A00,889388,Saab; Dima,19,0,20,1
1745141309970,LIAB 1AX,A00,889389,El Cheddadi; Youniss,19,0,20,1
1745141310998,LIFR 1C,A00,889391,Van Moer; Vinciane G,9,0,20,11
1745141312024,LIFR 1CX,A00,889392,Van Moer; Vinciane G,8,0,20,12
1745141313050,LIFR 1D,A00,889393,Van Moer; Vinciane G,11,0,20,9
1745141314083,LIFR 1DX,A00,889394,Van Moer; Vinciane G,11,0,20,9
1745141315110,LIGN 7,A00,886923,Staff,30,0,50,20
1745141316137,LIGN 17,A00,886924,Kehler; Andrew Scott,133,0,150,17
1745141317166,LTAM 110,A00,889395,Staff,17,0,30,13
1745141318198,LTCH 101,A00,889397,Staff,22,0,25,3
1745141319227,LTCS 130,A00,889398,Staff,23,0,25,2
1745141320252,LTEA 138,A00,889399,Staff,25,0,40,15
1745141321280,LTEN 149,A00,889400,Wesling; Megan E.,6,0,25,19
1745141322306,LTEN 169,A00,889401,Staff,24,0,25,1
1745141323336,LTEN 180,A00,889402,Staff,12,0,15,3
1745141324365,LTEN 181,A00,889403,Staff,23,0,25,2
1745141325390,LTWL 100,A00,889404,Myerston Santana; Jacobo,8,0,25,17
1745141326416,LTWL 180GS,A00,889405,Staff,6,0,20,14
1745141327441,LTWL 181,A00,889406,Staff,19,0,25,6
1745141328467,LTWL 184,A00,889475,Mukherjee; Silpa,21,0,25,4
1745141329496,LTWR 102C,A00,889486,Staff,29,0,30,1
1745141330526,LTWR 115W,A00,889491,Staff,3,0,15,12
1745141331553,MAE 8,A01,886905,Staff,0,2,0,0
1745141332580,MAE 11,A00,886906,Bandaru; Prabhakar,0,0,50,50
1745141333607,MAE 20,A00,886907,Evdokimenko; Ekaterina,50,0,70,20
1745141334641,MAE 30B,A00,886909,Ghazinejad; Maziar,28,0,45,17
1745141335673,MAE 101B,A00,886910,Saintillan; David,36,0,45,9
1745141336701,MAE 105,A00,886911,Bandaru; Prabhakar,26,0,50,24
1745141337727,MAE 107,A00,886912,Staff,22,0,60,38
1745141338808,MAE 143B,A00,886913,Bewley; Thomas R,14,0,40,26
1745141339834,MAE 148,A01,886915,Silberman; Jack,5,0,14,9
1745141340861,MAE 160,A00,886916,Evdokimenko; Ekaterina,41,0,60,19
1745141341893,MATH 3C,A01,889681,Staff,2,0,30,28
1745141342920,MATH 10A,A01,889760,Staff,28,0,30,2
1745141342920,MATH 10A,A02,889783,Staff,30,0,30,0
1745141343956,MATH 10B,A01,889785,Verstraete; Jacques Allan,0,2,30,30
1745141343956,MATH 10B,A02,889795,Verstraete; Jacques Allan,0,2,30,30
1745141343956,MATH 10B,B01,889797,Verstraete; Jacques Allan,0,0,30,30
1745141343956,MATH 10B,B02,889828,Verstraete; Jacques Allan,23,0,30,7
1745141344994,MATH 10C,A01,889849,Habib; Yousaf,18,0,30,12
1745141344994,MATH 10C,A02,889852,Habib; Yousaf,20,0,30,10
1745141344994,MATH 10C,A03,889853,Habib; Yousaf,25,0,30,5
1745141344994,MATH 10C,A04,889858,Habib; Yousaf,21,0,30,9
1745141344994,MATH 10C,B01,889861,Staff,12,0,30,18
1745141344994,MATH 10C,B02,889862,Staff,26,0,30,4
1745141344994,MATH 10C,B03,889863,Staff,28,0,30,2
1745141344994,MATH 10C,B04,889967,Staff,25,0,30,5
1745141346027,MATH 18,A01,889974,Staff,15,0,30,15
1745141346027,MATH 18,A02,889977,Staff,25,0,30,5
1745141346027,MATH 18,B01,889984,Hardiman; Liam,26,0,30,4
1745141346027,MATH 18,B02,889985,Hardiman; Liam,28,0,30,2
1745141347060,MATH 20A,A01,889990,Suk; Andrew Hoon,31,0,35,4
1745141348096,MATH 20B,A01,889993,Ohm; Ko Woon,21,0,30,9
1745141348096,MATH 20B,A02,889994,Ohm; Ko Woon,30,0,30,0
1745141348096,MATH 20B,B01,889996,Ohm; Ko Woon,25,0,30,5
1745141348096,MATH 20B,B02,889997,Ohm; Ko Woon,24,0,30,6
1745141349131,MATH 20C,A01,889999,Hammock; Frances H,22,0,30,8
1745141349131,MATH 20C,A02,890003,Hammock; Frances H,23,0,30,7
1745141349131,MATH 20C,B01,890006,Hammock; Frances H,11,0,30,19
1745141349131,MATH 20C,B02,890007,Hammock; Frances H,18,0,30,12
1745141350159,MATH 20D,A01,890011,Cheng; Hsiao-Bing,6,0,30,24
1745141350159,MATH 20D,A02,890012,Cheng; Hsiao-Bing,27,0,30,3
1745141350159,MATH 20D,B01,890016,Cheng; Hsiao-Bing,19,0,30,11
1745141350159,MATH 20D,B02,890017,Cheng; Hsiao-Bing,15,0,30,15
1745141351188,MATH 20E,A01,890026,Harel; Guershon,10,0,30,20
1745141351188,MATH 20E,A02,890029,Harel; Guershon,24,0,30,6
1745141351188,MATH 20E,B01,890033,Harel; Guershon,14,0,30,16
1745141351188,MATH 20E,B02,890101,Harel; Guershon,27,0,30,3
1745141352220,MATH 102,A01,890104,Staff,20,0,30,10
1745141352220,MATH 102,A02,890105,Staff,30,0,30,0
1745141353253,MATH 103B,A01,890116,Salehi Golsefidy; Alireza,8,0,30,22
1745141353253,MATH 103B,B01,890118,Staff,0,4,30,30
1745141354287,MATH 109,A01,890121,Aliabadi Sr.; Mohsen,6,0,30,24
1745141354287,MATH 109,B01,890124,Upadrashta; Pranav Kumar,23,0,30,7
1745141355319,MATH 120A,A01,890126,Eggers; John Dietrich,15,0,30,15
1745141356351,MATH 142B,A01,890128,Ioana; Adrian,17,0,30,13
1745141356351,MATH 142B,A02,890129,Ioana; Adrian,15,0,30,15
1745141357383,MATH 154,A01,890174,Staff,0,1,30,30
1745141357383,MATH 154,A02,890182,Staff,15,0,30,15
1745141358409,MATH 168A,A01,890197,Dumitriu; Ioana,22,0,35,13
1745141359437,MATH 170A,A01,890240,Nie; Jiawang,6,0,30,24
1745141359437,MATH 170A,A02,890241,Nie; Jiawang,18,0,30,12
1745141359437,MATH 170A,A03,890249,Nie; Jiawang,23,0,30,7
1745141360466,MATH 170B,A01,957891,Nag; Panchali,25,0,35,10
1745141362518,MATH 181A,A01,908025,Staff,0,8,35,35
1745141363547,MATH 193B,A01,890265,Staff,3,0,35,32
1745141364574,MGT 4,A01,890311,Anderson; John Charles,57,0,88,31
1745141365604,MGT 5,A00,907740,Staff,41,0,98,57
1745141366634,MGT 12,A00,890312,Lindenberger; Wade Douglas,70,0,98,28
1745141367661,MGT 16,A00,957883,Staff,84,0,98,14
1745141369714,MGT 45,A00,890314,Pecore; Joseph P.,57,0,98,41
1745141370742,MGT 71,A00,890315,Staff,6,0,98,92
1745141371767,MGT 100,A00,890316,Yavorsky; Daniel Ryan,59,0,98,39
1745141372799,MGT 103,A00,890317,Ehrich; Kristine R,77,0,98,21
1745141373831,MGT 105,A00,890356,Bates; Kenneth Walter,19,0,98,79
1745141374858,MGT 112,A00,890360,Ehrich; Kristine R,65,0,98,33
1745141375885,MGT 127R,A00,907732,Zhu; Kevin Xiaoguo,32,0,98,66
1745141376916,MGT 131B,A00,890361,Anderson; John Charles,75,0,98,23
1745141377945,MGT 137,A00,890362,Lindenberger; Wade Douglas,68,0,98,30
1745141378972,MGT 160,A00,890369,Johnson; Erik Barry,36,0,98,62
1745141381027,MGT 164,A00,890372,Zimmermann; Carsten,0,29,98,98
1745141382052,MGT 180,A00,890374,Bliss; Barbara Ann,31,0,98,67
1745141383084,MMW 15,A01,886414,Chang; Edmond Yi-Teh,0,10,28,28
1745141383084,MMW 15,A02,886415,Chang; Edmond Yi-Teh,0,10,28,28
1745141383084,MMW 15,A03,886416,Chang; Edmond Yi-Teh,0,8,28,28
1745141383084,MMW 15,A04,886417,Chang; Edmond Yi-Teh,0,8,28,28
1745141383084,MMW 15,B01,886419,Chang; Edmond Yi-Teh,0,8,28,28
1745141383084,MMW 15,B02,886420,Chang; Edmond Yi-Teh,0,9,28,28
1745141383084,MMW 15,B03,886421,Chang; Edmond Yi-Teh,0,9,28,28
1745141383084,MMW 15,B04,886422,Chang; Edmond Yi-Teh,0,9,28,28
1745141383084,MMW 15,C01,886424,Staff,0,10,28,28
1745141383084,MMW 15,C02,886425,Staff,0,10,28,28
1745141383084,MMW 15,C03,886426,Staff,0,9,28,28
1745141383084,MMW 15,C04,886427,Staff,0,9,28,28
1745141384115,MMW 15GS,A00,906910,Patterson; Patrick H.,5,0,28,23
1745141385143,MMW 122R,A01,886429,Rahimi; Babak,0,23,28,28
1745141385143,MMW 122R,A02,886430,Rahimi; Babak,0,23,28,28
1745141386173,MUS 1A,A01,890937,Staff,8,0,25,17
1745141386173,MUS 1A,A02,891035,Staff,15,0,25,10
1745141386173,MUS 1A,B00,907849,Staff,48,0,50,2
1745141386173,MUS 1A,B01,907850,Staff,25,0,25,0
1745141386173,MUS 1A,B02,907851,Staff,25,0,25,0
1745141388231,MUS 2AK,A00,957092,Ohnishi; Takae,15,0,15,0
1745141389262,MUS 4,A01,891044,Staff,6,0,25,19
1745141389262,MUS 4,A02,891045,Staff,24,0,25,1
1745141389262,MUS 4,B01,891048,Staff,20,0,25,5
1745141389262,MUS 4,B02,891050,Staff,25,0,25,0
1745141390298,MUS 5,A01,957506,Dubnov; Shlomo,4,0,25,21
1745141390298,MUS 5,A02,957622,Dubnov; Shlomo,21,0,25,4
1745141390298,MUS 5,A03,957623,Dubnov; Shlomo,23,0,25,2
1745141391326,MUS 6,A01,891053,Freitas Caetano; Marcelo,23,0,25,2
1745141391326,MUS 6,A02,891054,Freitas Caetano; Marcelo,23,0,25,2
1745141392357,MUS 7,A01,891081,Staff,0,0,25,25
1745141392357,MUS 7,A02,891082,Staff,15,0,25,10
1745141393386,MUS 8GS,A00,891118,Borgo; David Garcia,5,0,25,20
1745141394415,MUS 11,A01,891140,Staff,12,0,25,13
1745141394415,MUS 11,A02,891141,Staff,24,0,25,1
1745141395441,MUS 13,A01,891143,Staff,10,0,25,15
1745141395441,MUS 13,A02,891144,Staff,25,0,25,0
1745141396470,MUS 15,A01,891146,Staff,7,0,25,18
1745141396470,MUS 15,A02,891148,Staff,22,0,25,3
1745141396470,MUS 15,B01,891150,Staff,18,0,25,7
1745141396470,MUS 15,B02,891151,Staff,25,0,25,0
1745141397499,MUS 20,A01,891153,Staff,9,0,20,11
1745141397499,MUS 20,A02,891155,Staff,16,0,20,4
1745141398526,MUS 80,A00,891156,Staff,19,0,25,6
1745141398526,MUS 80,B00,891157,Staff,25,0,25,0
1745141399556,MUS 130,A00,891158,Ohnishi; Takae,35,0,35,0
1745141400587,MUS 150GS,A01,891160,Borgo; David Garcia,5,0,25,20
1745141401619,MUS 170,A01,891162,Freitas Caetano; Marcelo,21,0,25,4
1745141401619,MUS 170,A02,891164,Freitas Caetano; Marcelo,22,0,25,3
1745141402653,NANO 11,A00,886220,Vazquez Mena; Oscar,12,0,15,3
1745141403685,NANO 15,A01,886222,Drews; Aaron,9,0,10,1
1745141404711,NANO 104,A00,886224,Sirbuly; Donald,18,0,25,7
1745141405738,PH 40,A00,886528,Staff,29,0,40,11
1745141406774,PH 45,A01,886799,Staff,36,0,40,4
1745141407805,PH 110,A00,886802,Staff,7,0,40,33
1745141408834,PH 172,A00,906716,Staff,20,0,35,15
1745141409861,PH 191,A00,886803,Staff,23,0,40,17
1745141410889,PHIL 1,A00,889500,Staff,22,0,30,8
1745141411923,PHIL 10,A01,889549,Grush; Rick Scott,17,0,22,5
1745141411923,PHIL 10,A02,889551,Grush; Rick Scott,20,0,22,2
1745141412954,PHIL 28,A01,889559,Lamey; Andy M.,0,4,25,25
1745141412954,PHIL 28,A02,889561,Lamey; Andy M.,0,0,25,25
1745141412954,PHIL 28,A03,889572,Lamey; Andy M.,7,0,25,18
1745141413982,PHIL 35,A00,907839,Staff,32,0,33,1
1745141415011,PHIL 60,A00,889574,Staff,79,0,90,11
1745141416039,PHIL 105,A00,889579,Staff,0,1,0,0
1745141417070,PHIL 136,A00,889582,Fulkerson; Matthew Todd,27,0,45,18
1745141418102,PHIL 163,A01,889601,Staff,24,0,30,6
1745141418102,PHIL 163,B01,889606,Brandt; Reuven A,0,2,0,0
1745141419128,PHIL 164,A00,889610,Staff,20,0,30,10
1745141420157,PHIL 165,A00,889613,Staff,26,0,30,4
1745141421191,PHYS 1A,A00,886431,Staff,38,0,70,32
1745141422224,PHYS 1AL,001,886432,Tsai; Philbert S,0,0,30,30
1745141422224,PHYS 1AL,002,886436,Tsai; Philbert S,19,0,30,11
1745141423256,PHYS 1B,A00,886439,Staff,192,0,240,48
1745141424287,PHYS 1BL,001,886441,Tsai; Philbert S,0,1,30,30
1745141424287,PHYS 1BL,002,886444,Tsai; Philbert S,14,0,30,16
1745141425318,PHYS 1C,A00,896092,Arnold; Kam S,87,0,146,59
1745141426351,PHYS 1CL,001,886448,Tsai; Philbert S,0,4,30,30
1745141426351,PHYS 1CL,002,886449,Tsai; Philbert S,6,0,30,24
1745141426351,PHYS 1CL,003,886450,Tsai; Philbert S,22,0,30,8
1745141426351,PHYS 1CL,004,886451,Tsai; Philbert S,16,0,30,14
1745141427378,PHYS 2B,A01,886457,Staff,86,0,115,29
1745141428403,PHYS 2C,A01,886460,Shotwell; Brian,0,0,65,65
1745141429429,PHYS 2CL,A01,886467,Staff,0,3,28,28
1745141429429,PHYS 2CL,A02,886468,Staff,5,0,28,23
1745141430461,PHYS 2D,A01,886470,Staff,17,0,50,33
1745141431493,PHYS 4B,A01,886475,Grinstein; Benjamin,88,0,100,12
1745141432521,POLI 5,A00,891173,Desposato; Scott,17,0,25,8
1745141433547,POLI 5D,A01,891175,Staff,5,0,5,0
1745141433547,POLI 5D,B01,891178,Staff,5,0,5,0
1745141434574,POLI 11,A00,891179,Ferree; Karen E,3,0,25,22
1745141435604,POLI 12,A00,891180,Staff,21,0,30,9
1745141436636,POLI 27,A01,891182,Staff,29,0,75,46
1745141437663,POLI 30,A00,891183,Staff,0,3,30,30
1745141438689,POLI 100B,A00,891244,Staff,0,8,20,20
1745141439714,POLI 100I,A00,891247,Staff,19,0,30,11
1745141440747,POLI 104J,A00,891248,Nichter; Maysa,18,0,30,12
1745141441776,POLI 104U,A00,891250,Nichter; Maysa,9,0,30,21
1745141442846,POLI 108,A00,891253,Staff,0,0,0,4
1745141443872,POLI 110B,A00,891255,Wiens; David,22,0,25,3
1745141444902,POLI 112A,A00,891256,Wiens; David,15,0,25,10
1745141445930,POLI 114BR,A00,891261,Staff,22,0,30,8
1745141446958,POLI 117R,A00,891262,Forman; Fonna,12,0,50,38
1745141447985,POLI 118,A00,891264,Ingham; Sean,22,0,25,3
1745141449012,POLI 124A,A00,891265,Staff,19,0,20,1
1745141450038,POLI 125D,A00,891266,Nichter; Simeon C,9,0,25,16
1745141451064,POLI 126,A00,891268,Nichter; Simeon C,11,0,25,14
1745141452090,POLI 126AA,A00,891272,Staff,19,0,25,6
1745141453123,POLI 130AA,A00,891273,Staff,17,0,20,3
1745141454152,POLI 134AA,A00,891274,Staff,12,0,20,8
1745141456210,POLI 138,A00,891278,Staff,22,0,25,3
1745141457249,POLI 142K,A00,891280,Staff,17,0,25,8
1745141458279,POLI 142M,A00,891281,Gartzke; Erik,22,0,30,8
1745141459307,POLI 142P,A00,891284,Staff,21,0,30,9
1745141460334,POLI 143,A00,891285,Gartzke; Erik,17,0,30,13
1745141461364,POLI 153,A00,891286,Staff,20,0,20,0
1745141462393,POLI 170A,A00,891288,Staff,19,0,25,6
1745141463421,POLI 175,A00,891290,Staff,18,0,20,2
1745141464454,PSYC 1,A00,890674,Steiner; Eric Tomas,0,4,45,45
1745141465480,PSYC 2,A00,890676,Albright; Thomas D,25,0,35,10
1745141466513,PSYC 3,A00,890679,Staff,18,0,20,2
1745141467546,PSYC 60,A01,890684,Rickard; Timothy C.,7,0,45,38
1745141468575,PSYC 70,A01,890689,Geller; Emma Harlan,14,0,30,16
1745141469604,PSYC 100,A00,890690,Lacefield; Katharine I,0,43,180,180
1745141470630,PSYC 102,A00,890695,Staff,25,0,40,15
1745141471657,PSYC 105,A00,890699,Geller; Emma Harlan,78,0,100,22
1745141472683,PSYC 106,A00,890701,Gorman; Michael R.,15,0,30,15
1745141473717,PSYC 108,A00,890704,Adrian; Julia Anna,0,23,50,50
1745141474747,PSYC 118,A01,890712,Staff,18,0,30,12
1745141475776,PSYC 124,A00,890716,Chapman; Eddie Nathaniel,36,0,60,24
1745141476803,PSYC 131,A00,890717,Anagnostaras; Stephan,6,0,80,74
1745141477830,PSYC 137,A00,890719,Winkielman; Piotr,0,2,30,30
1745141478860,PSYC 144,A00,890721,Adrian; Julia Anna,0,3,45,45
1745141479888,PSYC 162,A00,890805,Staff,21,0,75,54
1745141480917,PSYC 169,A00,890810,Staff,0,15,30,30
1745141481944,PSYC 172,A00,890814,Gorman; Michael R.,14,0,30,16
1745141482971,PSYC 181,A00,890818,Anagnostaras; Stephan,63,0,200,137
1745141483999,PSYC 189,A00,890823,Staff,11,0,30,19
1745141485037,PSYC 191,A00,890884,Rickard; Timothy C.,0,11,35,35
1745141486065,PSYC 193,A00,890913,Staff,22,0,30,8
1745141486065,PSYC 193,B00,890914,Chapman; Eddie Nathaniel,25,0,30,5
1745141487093,PSYC 193L,A01,890918,Lowe; Angela Beth,29,0,30,1
1745141487093,PSYC 193L,B01,890921,Hurwitz; Ethan Scott,28,0,30,2
1745141487093,PSYC 193L,C01,890928,Staff,30,0,30,0
1745141488122,RELI 149,A00,886806,Rahimi; Babak,23,0,40,17
1745141489151,SE 9,A01,886814,Staff,13,0,20,7
1745141490178,SE 101B,A01,886816,Chadha; Mayank,8,0,30,22
1745141491206,SE 110B,A00,886818,Zhu; Qiang,0,16,45,45
1745141492236,SE 125,A01,886830,Staff,10,0,30,20
1745141493265,SE 130B,A01,886835,Staff,19,0,40,21
1745141494300,SE 131A,A01,886838,Krysl; Petr,37,0,55,18
1745141495330,SE 154,A00,886840,Staff,35,0,50,15
1745141496356,SE 164GS,A01,886849,Staff,13,0,20,7
1745141497382,SE 167GS,A01,886853,Staff,13,0,20,7
1745141498408,SIO 25,A01,890107,Staff,23,0,30,7
1745141499436,SIO 45,A00,890109,Cook; Geoffrey W,137,0,200,63
1745141500459,SIO 109R,A00,890110,Forman; Fonna,0,11,20,20
1745141501486,SIO 187,A01,890114,Kacev; David,21,0,40,19
1745141502519,SOCI 1,A01,890431,Thorpe; Charles Robert,21,0,30,9
1745141502519,SOCI 1,A02,890518,Thorpe; Charles Robert,30,0,30,0
1745141503544,SOCI 2,A01,957978,Staff,0,0,0,0
1745141503544,SOCI 2,A02,957979,Staff,0,3,0,0
1745141504571,SOCI 20,A01,890523,Calderon-Zaks; Michael Aar,24,0,30,6
1745141504571,SOCI 20,A02,890526,Calderon-Zaks; Michael Aar,29,0,30,1
1745141505598,SOCI 30,A01,890533,Pardo Guerra; Juan Pablo,37,0,40,3
1745141506624,SOCI 40,A01,890535,Staff,32,0,45,13
1745141507655,SOCI 104Q,A00,890559,Staff,20,0,30,10
1745141508680,SOCI 106,A00,890560,Arnal; Maud Marie Leonie,22,0,30,8
1745141509707,SOCI 110,A00,890567,Holkenbrink-Monk; Charlene,22,0,30,8
1745141510735,SOCI 112,A00,890568,Victoria Torres; Pablo,0,0,45,45
1745141511764,SOCI 115,A00,890597,Arnal; Maud Marie Leonie,33,0,45,12
1745141513817,SOCI 121,A00,890604,Pardo Guerra; Juan Pablo,40,0,45,5
1745141514848,SOCI 126,A01,890608,Staff,8,0,10,2
1745141515877,SOCI 127,A00,890609,Staff,23,0,30,7
1745141516905,SOCI 131,A00,890610,Thorpe; Charles Robert,38,0,45,7
1745141517932,SOCI 135,A00,890615,Payne; Christine Anna,20,0,45,25
1745141518957,SOCI 139,A00,890620,Staff,43,0,45,2
1745141519984,SOCI 148E,A00,890622,Calderon-Zaks; Michael Aar,39,0,45,6
1745141521014,SOCI 150,A00,890623,Kohler; Kristopher M.,36,0,45,9
1745141522045,SOCI 157,A00,890625,Jules-Rosette; Bennetta W.,18,0,20,2
1745141523074,SOCI 160,A00,890627,Payne; Christine Anna,26,0,45,19
1745141524101,SYN 1,A00,886855,Fish; Gwendolyn Anne,0,0,0,0
1745141524101,SYN 1,B00,906086,Fish; Gwendolyn Anne,0,0,0,2
1745141525127,SYN 2R,A00,886860,Staff,0,15,15,15
1745141525127,SYN 2R,B00,906106,Atkinson; Arthur Laird,0,14,15,15
1745141526163,SYN 100,A01,886866,Browne; Emily,0,29,20,20
1745141526163,SYN 100,B01,906128,Rock; Martin,0,4,20,20
1745141526163,SYN 100,C01,906140,Deavenport; James Cary,0,2,20,20
1745141526163,SYN 100,D01,907816,Deavenport; James Cary,0,3,20,20
1745141527189,TDAC 1,A00,890286,Walsh; Kim C.,11,0,20,9
1745141528220,TDAC 101,A00,890296,Basso; Beatrice,18,0,20,2
1745141529250,TDDE 131,A00,890297,Staff,47,0,50,3
1745141530282,TDDM 1,A00,890287,Weinberg; Sadie,26,0,30,4
1745141531307,TDGE 11,A00,890288,Fulton; Julia,155,0,200,45
1745141531307,TDGE 11,B00,890289,Castro; Robert Jess,188,0,200,12
1745141532338,TDGE 25,B00,957359,Walsh; Kim C.,9,0,20,11
1745141533366,TDGE 40,A01,890292,Power; Jade Yukana,28,0,30,2
1745141534393,TDGE 124,A00,890298,Havis; Allan,12,0,50,38
1745141535426,TDGE 131R,A00,890299,Burelle; Julie Sara Veronique,20,0,42,22
1745141536452,TDHT 101,A00,890300,Staff,12,0,20,8
1745141537480,TDHT 109,A01,890302,Anderson; Mysia Anyse,31,0,40,9
1745141538507,TDMV 1,A00,890293,Arcidiacono; Kristin,20,0,30,10
1745141539534,TDMV 2,A00,890294,Weinberg; Sadie,26,0,30,4
1745141540561,TDMV 3,A00,957878,Arcidiacono; Kristin,27,0,30,3
1745141542619,TDMV 138,A00,890304,Jun; Grace Shin Hae,25,0,40,15
1745141543650,TDMV 140,A00,890305,Corrales; Joseph Bernales,28,0,30,2
1745141544685,TDMV 142,A00,890307,Caligagan; Tony,30,0,40,10
1745141545712,TDMV 144,A00,890308,Camaya; Michelle Ann,26,0,30,4
1745141546742,TDPW 1,A00,890295,Stein; Deborah Isobel,5,0,20,15
1745141547775,USP 2,A01,890272,Lerner; Amy M,8,0,20,12
1745141548804,USP 3,A01,890274,Staff,21,0,30,9
1745141549837,USP 15,A01,890276,Sun; Feiyang,21,0,30,9
1745141550864,USP 25,A00,890277,Shenkman; Michael Thomas,21,0,25,4
1745141551890,USP 138,A00,890278,Staff,15,0,25,10
1745141552916,USP 143,A00,890279,Staff,30,0,70,40
1745141553942,USP 144,A00,890280,Chowdhury; Muhammed Zohir,19,0,30,11
1745141554969,USP 150,A00,890281,Boomhower; Matthew Charles,19,0,30,11
1745141555995,USP 151,A00,890282,Staff,17,0,20,3
1745141557025,USP 162,A00,890283,Andrews; Abigail Leslie,17,0,20,3
1745141558053,USP 168,A00,920477,Kwak; Nancy,2,0,5,3
1745141559081,USP 181,A00,890284,Staff,11,0,20,9
1745141560112,USP 191A,A00,890285,Staff,15,0,20,5
1745141561145,VIS 101,A00,886512,Staff,37,0,75,38
1745141562178,VIS 103,A00,886513,Cruz; Edwin Teddy,65,0,75,10
1745141563207,VIS 108,A00,886514,Staff,7,0,15,8
1745141564237,VIS 127P,A00,886515,Shen; Kuiyi,92,0,146,54
1745141565267,VIS 149,A00,886516,Yoldas; Pinar,1,0,15,14
1745141566293,VIS 164,A00,886526,Erdmann; Dean,21,0,22,1
1745141567322,VIS 194S,A00,886527,Staff,61,0,75,14
1745141568354,WCWP 10A,C00,886484,Staff,13,0,15,2
1745141569380,WCWP 10B,A00,886490,Staff,5,0,15,10
1745141569380,WCWP 10B,B00,886491,Staff,0,1,0,0
1745141569380,WCWP 10B,C00,886492,Staff,10,0,15,5
1745141570406,WCWP 100,A00,886494,Staff,0,2,15,15
1745141572584,AAS 10,A01,886199,Childs; Dennis R.,0,2,0,0
1745141573611,ANAR 104,A01,886940,Shtienberg; Gilad,27,0,30,3
1745141574637,ANAR 120,A00,886953,Staff,13,0,20,7
1745141575662,ANBI 148,A01,886955,Wilder; Linnea Lorene,32,0,40,8
1745141577720,ANSC 122,A00,886957,Staff,28,0,30,2
1745141578749,ANSC 150,A00,886958,Sloane; Julia Kathryn,6,0,15,9
1745141579778,ANSC 156,A00,886959,Jenkins; Janis A.,2,0,15,13
1745141580806,ANSC 180,A00,886960,Staff,12,0,17,5
1745141581833,ANSC 188,A00,886961,Jassal; Aftab,10,0,25,15
1745141582862,ANSC 190,A00,886962,Jassal; Aftab,14,0,25,11
1745141583887,ANSC 191,A00,886963,Staff,18,0,20,2
1745141584918,ANTH 3,A01,891689,Staff,19,0,20,1
1745141585942,ANTH 5,A00,886933,Semendeferi; Ekaterini,18,0,20,2
1745141586968,ANTH 10,A00,886934,Staff,0,8,30,30
1745141587997,ANTH 21,A01,886936,Staff,44,0,60,16
1745141589022,ANTH 23,A01,886938,Staff,94,0,100,6
1745141590050,ANTH 105,A00,886964,Stewart; Alexander B,94,0,100,6
1745141591077,ANTH 108,A00,886965,Pedersen; David,10,0,20,10
1745141592104,AWP 10,001,886147,Staff,0,0,0,0
1745141592104,AWP 10,002,886148,Staff,0,0,0,0
1745141592104,AWP 10,003,886149,Staff,0,0,0,0
1745141592104,AWP 10,004,886150,Staff,0,0,0,0
1745141592104,AWP 10,005,886151,Staff,0,0,0,0
1745141592104,AWP 10,006,886152,Staff,0,0,0,0
1745141592104,AWP 10,007,886153,Staff,0,0,0,0
1745141592104,AWP 10,008,886154,Staff,0,0,0,0
1745141592104,AWP 10,009,886155,Staff,0,0,0,0
1745141592104,AWP 10,010,886156,Staff,0,0,0,0
1745141592104,AWP 10,011,886158,Staff,0,0,0,0
1745141592104,AWP 10,012,886160,Staff,0,0,0,0
1745141592104,AWP 10,013,886161,Staff,0,0,0,0
1745141592104,AWP 10,014,886162,Staff,0,0,0,0
1745141592104,AWP 10,015,886163,Staff,0,0,0,0
1745141592104,AWP 10,016,886164,Staff,0,0,0,0
1745141592104,AWP 10,017,886165,Staff,0,0,0,0
1745141592104,AWP 10,018,886166,Staff,0,0,0,0
1745141592104,AWP 10,019,886168,Staff,0,0,0,0
1745141592104,AWP 10,020,886170,Staff,0,0,0,0
1745141592104,AWP 10,021,886172,Staff,0,0,0,0
1745141593136,AWP 10R,001,886173,Staff,0,0,0,0
1745141593136,AWP 10R,002,886174,Staff,0,1,0,0
1745141593136,AWP 10R,003,886175,Staff,0,0,0,0
1745141593136,AWP 10R,004,886176,Staff,0,0,0,0
1745141593136,AWP 10R,005,886177,Staff,0,0,0,0
1745141593136,AWP 10R,006,886178,Staff,0,0,0,0
1745141593136,AWP 10R,007,886179,Staff,0,0,0,0
1745141593136,AWP 10R,008,886181,Staff,0,0,0,0
1745141593136,AWP 10R,009,886182,Staff,0,0,0,0
1745141593136,AWP 10R,010,886183,Staff,0,0,0,0
1745141593136,AWP 10R,011,886184,Staff,0,0,0,0
1745141593136,AWP 10R,012,886185,Staff,0,0,0,0
1745141593136,AWP 10R,013,886186,Staff,0,0,0,0
1745141593136,AWP 10R,014,886187,Staff,0,0,0,0
1745141593136,AWP 10R,015,886188,Staff,0,0,0,0
1745141593136,AWP 10R,016,886189,Staff,0,0,0,0
1745141594166,AWP 102R,A00,886190,Staff,0,0,0,0
1745141594166,AWP 102R,B00,886191,Staff,0,0,0,0
1745141595190,BENG 100,A01,886193,Staff,19,0,30,11
1745141596215,BENG 122A,A01,886195,Hasty; Jeff M,20,0,30,10
1745141597239,BENG 166A,A00,886196,Sah; Robert Lie-Yuan,0,3,20,20
1745141598269,BIBC 102,A01,894320,Staff,0,2,46,46
1745141598269,BIBC 102,A02,894321,Staff,0,0,46,46
1745141598269,BIBC 102,A03,894344,Staff,21,0,46,25
1745141598269,BIBC 102,A04,894345,Staff,30,0,47,17
1745141599296,BICD 100R,A01,894365,Smith; Laurie,1,3,58,57
1745141599296,BICD 100R,A02,894366,Smith; Laurie,0,1,58,58
1745141599296,BICD 100R,A03,894367,Smith; Laurie,13,0,59,46
1745141600329,BICD 136,A01,894383,Gustafson-Brown; Cindy,16,0,50,34
1745141601357,BIEB 102,A01,894494,Butler; Shannon Rhey,67,0,130,63
1745141603423,BIEB 150,A01,894617,Wills; Christopher,0,3,13,13
1745141603423,BIEB 150,A02,894631,Wills; Christopher,0,3,13,13
1745141603423,BIEB 150,A03,894937,Wills; Christopher,0,3,13,13
1745141603423,BIEB 150,A04,894946,Wills; Christopher,0,1,11,11
1745141604453,BIEB 194,A00,906141,Kurle; Carolyn M.,14,0,20,6
1745141605484,BILD 1,A01,894154,Staff,8,0,19,11
1745141605484,BILD 1,A02,894155,Staff,15,0,19,4
1745141605484,BILD 1,A03,894160,Staff,18,0,19,1
1745141605484,BILD 1,A04,894161,Staff,16,0,18,2
1745141606510,BILD 2,A01,894168,Staff,0,0,50,50
1745141606510,BILD 2,A02,894169,Staff,0,0,50,50
1745141606510,BILD 2,A03,894179,Staff,27,0,50,23
1745141606510,BILD 2,A04,894203,Staff,42,0,50,8
1745141607537,BILD 3,A01,894213,Staff,24,0,31,7
1745141607537,BILD 3,A02,894214,Staff,28,0,31,3
1745141607537,BILD 3,A03,894235,Staff,30,0,31,1
1745141607537,BILD 3,A04,894236,Staff,29,0,32,3
1745141608567,BILD 4,A01,894253,Reuther; Keefe,12,0,24,12
1745141608567,BILD 4,A02,894258,Reuther; Keefe,19,0,24,5
1745141609594,BILD 5,A01,894276,Reuther; Keefe,40,0,50,10
1745141609594,BILD 5,A02,894277,Reuther; Keefe,48,0,50,2
1745141609594,BILD 5,A03,894290,Reuther; Keefe,47,0,50,3
1745141609594,BILD 5,A04,894291,Reuther; Keefe,50,0,50,0
1745141610620,BILD 24,A01,894297,Pirino; Giorgia,45,0,60,15
1745141611654,BIMM 100,A01,895012,Staff,0,14,0,1
1745141611654,BIMM 100,A02,895013,Staff,0,6,0,2
1745141611654,BIMM 100,A03,895014,Staff,0,7,0,0
1745141611654,BIMM 100,A04,895015,Staff,0,4,0,0
1745141612681,BIMM 101,A01,895017,McDonnell; Lisa Marie,0,2,24,24
1745141612681,BIMM 101,A02,895018,McDonnell; Lisa Marie,0,1,24,24
1745141612681,BIMM 101,B01,895020,McDonnell; Lisa Marie,0,3,24,24
1745141612681,BIMM 101,B02,895021,McDonnell; Lisa Marie,0,2,24,24
1745141613709,BIMM 110,A01,895023,Staff,7,0,25,18
1745141613709,BIMM 110,A02,895024,Staff,11,0,25,14
1745141613709,BIMM 110,A03,895025,Staff,22,0,25,3
1745141613709,BIMM 110,A04,895031,Staff,21,0,25,4
1745141614741,BIMM 120,A01,895114,Gustafson-Brown; Cindy,8,0,28,20
1745141614741,BIMM 120,A02,895126,Gustafson-Brown; Cindy,19,0,27,8
1745141615813,BIPN 100,A01,895130,Yang; Mingyu,13,0,38,25
1745141615813,BIPN 100,A02,895131,Yang; Mingyu,33,0,38,5
1745141615813,BIPN 100,A03,895132,Yang; Mingyu,33,0,38,5
1745141615813,BIPN 100,A04,895133,Yang; Mingyu,30,0,36,6
1745141616839,BIPN 120,A01,895135,Cooke; James Edward,0,2,13,13
1745141616839,BIPN 120,A02,895136,Cooke; James Edward,0,1,13,13
1745141616839,BIPN 120,A03,895137,Cooke; James Edward,0,0,13,13
1745141616839,BIPN 120,A04,895156,Cooke; James Edward,3,0,11,8
1745141617866,BIPN 134,A01,895235,Cooke; James Edward,0,2,25,25
1745141617866,BIPN 134,A02,895237,Cooke; James Edward,0,0,25,25
1745141617866,BIPN 134,A03,895240,Cooke; James Edward,12,0,25,13
1745141617866,BIPN 134,A04,895270,Cooke; James Edward,24,0,25,1
1745141618895,BIPN 189,A00,892103,Staff,0,20,9,9
1745141620946,CAT 124,A01,922009,Staff,0,1,20,20
1745141621977,CAT 125R,A00,886390,Morales; Celeste Georgianna,4,0,20,16
1745141621977,CAT 125R,B00,886391,Irwin; Matthew Joseph,0,1,20,20
1745141621977,CAT 125R,C00,886392,Smith; Lauryn Alissa,11,0,20,9
1745141621977,CAT 125R,D00,886393,Vanderschuit; Maya Alysia,6,0,20,14
1745141621977,CAT 125R,E00,886394,Marchisotto; Jennifer Anne,0,2,20,20
1745141623003,CENG 15,A01,886218,Drews; Aaron,1,0,5,4
1745141624030,CENG 113,A00,886219,Opatkiewicz; Justin Paul,16,0,25,9
1745141625061,CGS 101,A00,887044,Staff,13,0,20,7
1745141626092,CGS 105,A01,887046,Staff,16,0,25,9
1745141627121,CGS 112,A00,887047,Cuong; Marisol,12,0,15,3
1745141628151,CGS 113,A00,887048,Staff,24,0,30,6
1745141629179,CGS 120,A00,887049,Staff,12,0,17,5
1745141630213,CHEM 6A,A01,886336,Lam; Tin Yiu,44,0,50,6
1745141630213,CHEM 6A,A02,886338,Lam; Tin Yiu,43,0,50,7
1745141631241,CHEM 6B,A01,886341,Hopkins; Patrycja Anna,21,0,50,29
1745141631241,CHEM 6B,A02,886343,Hopkins; Patrycja Anna,46,0,50,4
1745141632269,CHEM 6C,A01,886346,Albizati; Kim F.,0,1,50,50
1745141632269,CHEM 6C,A02,886348,Albizati; Kim F.,38,0,50,12
1745141633301,CHEM 40A,A01,886352,Klosterman; Jeremy K,70,0,100,30
1745141634328,CHEM 40B,A01,886356,Klosterman; Jeremy K,0,4,100,100
1745141635360,CHEM 41B,A01,886360,Theodorakis; Emmanuel,30,0,50,20
1745141635360,CHEM 41B,A02,886362,Theodorakis; Emmanuel,46,0,50,4
1745141636385,CHIN 165A,A00,886382,Xu; Li,19,0,20,1
1745141637410,CLAS 120,A00,886387,Myerston Santana; Jacobo,36,0,40,4
1745141638436,COGS 9,A01,886967,Shannon; Kyle Michael,49,0,60,11
1745141639465,COGS 11,A01,886969,Staff,18,0,30,12
1745141640492,COGS 14A,A01,886971,Staff,26,0,60,34
1745141641520,COGS 14B,A01,886973,Hoffman; Drew Ellen,18,0,60,42
1745141642547,COGS 18,A01,886975,Morgan; Eric,41,0,60,19
1745141643577,COGS 20,A01,886977,Staff,6,0,8,2
1745141643577,COGS 20,A02,886978,Staff,6,0,7,1
1745141644609,COGS 100,A01,907783,Staff,6,0,30,24
1745141645634,COGS 101B,A01,886980,Staff,0,10,30,30
1745141646664,COGS 101C,A01,886982,Delgado; Tania,0,6,30,30
1745141647696,COGS 102A,A01,886984,Johnson; Christine M.,13,0,30,17
1745141648725,COGS 118B,A01,886986,Staff,0,25,60,60
1745141649752,COGS 150,A01,886988,Bergen; Benjamin,16,0,30,14
1745141650776,COGS 153,A00,886989,Delgado; Tania,0,6,30,30
1745141651803,COGS 186,A01,886991,Staff,3,0,30,27
1745141652829,COGS 187A,A01,886993,Boyle; Mary E. T.,12,0,30,18
1745141653854,COGS 189,A00,886994,Staff,13,0,30,17
1745141654881,COMM 10,A01,886996,Staff,11,0,25,14
1745141654881,COMM 10,A02,886997,Staff,21,0,25,4
1745141655907,COMM 20,A01,886999,Leuning; Grant Maurstad,33,0,40,7
1745141657961,COMM 100A,A01,887002,Staff,0,0,25,25
1745141657961,COMM 100A,A02,887003,Staff,20,0,25,5
1745141658991,COMM 100B,A01,887005,Staff,0,1,25,25
1745141660016,COMM 106D,A00,887006,Staff,22,0,40,18
1745141661048,COMM 110G,A00,887007,Whitworth-Smith; Andrew C,17,0,40,23
1745141662077,COMM 111B,A00,887008,Staff,31,0,40,9
1745141663102,COMM 113T,A00,887009,Abuelhiga; Soraya Jill,30,0,40,10
1745141663102,COMM 113T,B00,906733,Staff,40,0,40,0
1745141664129,COMM 145,A00,887010,Staff,21,0,40,19
1745141665158,COMM 146,A00,887054,Staff,31,0,40,9
1745141666183,COMM 190,A00,887012,Staff,9,0,23,14
1745141667210,CSE 8A,A50,887015,Cao; Yingjun,68,0,85,17
1745141668263,CSE 11,A01,887017,Cao; Yingjun,35,0,70,35
1745141669288,CSE 20,A01,887019,Staff,35,0,50,15
1745141670321,CSE 21,A01,887021,Braun; Oliver,81,0,100,19
1745141670321,CSE 21,B01,892583,Staff,48,0,50,2
1745141671353,CSE 30,A01,887025,Eldon; John,161,0,200,39
1745141672386,CSE 100,A01,887027,Staff,28,0,50,22
1745141672386,CSE 100,A02,887028,Staff,43,0,50,7
1745141673415,CSE 101,A01,887030,Braun; Oliver,79,0,100,21
1745141673415,CSE 101,B01,887032,Jones; Miles E,0,1,50,50
1745141673415,CSE 101,B02,887033,Jones; Miles E,13,0,50,37
1745141674439,CSE 105,A01,908084,Jones; Miles E,36,0,50,14
1745141674439,CSE 105,A02,908087,Jones; Miles E,38,0,50,12
1745141675466,CSE 135,A01,887035,Powell; Thomas Allan,8,0,50,42
1745141676495,CSE 142,A01,887037,Staff,22,0,60,38
1745141677522,CSE 142L,A01,887039,Staff,42,0,60,18
1745141678552,CSE 151A,A01,887041,Solares; Edwin A,60,0,100,40
1745141679583,CSE 175,A01,887043,Kumar; Rakesh,30,0,30,0
1745141680614,CSS 1,A01,886389,Staff,12,0,40,28
1745141681641,DSC 30,A01,908097,Liao; Soohyun Nam,54,0,75,21
1745141682666,DSC 40A,A01,908099,Shannon; Kyle Michael,37,0,50,13
1745141683691,DSC 40B,A01,908112,Staff,28,0,50,22
1745141684717,DSC 80,A01,908116,Staff,32,0,60,28
1745141685747,DSC 197,001,956863,Eldridge; Justin Matthew,9999,0,9999,0
1745141686781,ECE 5,A01,886400,Morris; Karcher William,3,0,6,3
1745141686781,ECE 5,A02,886401,Morris; Karcher William,5,0,6,1
1745141687806,ECE 148,A01,886403,Silberman; Jack,0,8,14,14
1745141688832,ECON 1,A01,887265,Crane; Meredith Helen,25,0,70,45
1745141688832,ECON 1,B01,887268,Staff,44,0,50,6
1745141689858,ECON 2,A01,887273,Crane; Meredith Helen,61,0,70,9
1745141690886,ECON 3,A01,887279,Rondina; Giacomo,44,0,70,26
1745141691912,ECON 4,A01,887282,Anderson; John Charles,0,1,10,10
1745141692940,ECON 5,A01,887285,Staff,39,0,45,6
1745141692940,ECON 5,B01,887292,Staff,43,0,45,2
1745141693979,ECON 100A,A01,887337,Newhouse; Herbert S,58,0,70,12
1745141693979,ECON 100A,B01,887349,Staff,45,0,50,5
1745141695006,ECON 100B,A01,887361,Du; Songzi,42,0,70,28
1745141696030,ECON 100C,A01,887445,Newhouse; Herbert S,61,0,70,9
1745141697058,ECON 105,A00,887488,Vespa; Emanuel Ignacio,24,0,35,11
1745141698088,ECON 109,A01,887506,Staff,29,0,35,6
1745141699124,ECON 110A,A01,887568,Alon; Titan Michael,1,0,35,34
1745141699124,ECON 110A,B01,907601,Alon; Titan Michael,27,0,35,8
1745141700155,ECON 110B,A01,887598,Levkoff; Steven B.,0,7,70,70
1745141701185,ECON 112,A00,887599,Rondina; Giacomo,20,0,35,15
1745141702221,ECON 120A,A01,887603,Dai; Yinlin,46,0,70,24
1745141703256,ECON 120C,A01,887608,Sun; Yixiao,0,0,35,35
1745141703256,ECON 120C,B01,887614,Sun; Yixiao,13,0,35,22
1745141704287,ECON 138,A00,887621,Bharadwaj; Prashant,0,18,20,20
1745141705314,ECON 171,A01,907666,Staff,27,0,35,8
1745141706346,ECON 175,A00,887626,Wu; Pak Yeung,27,0,35,8
1745141707371,ECON 190,A00,887640,Vespa; Emanuel Ignacio,26,0,35,9
1745141708408,EDS 25,A01,888197,Staff,0,0,0,0
1745141708408,EDS 25,A02,888209,Staff,0,0,0,0
1745141708408,EDS 25,A03,888210,Staff,0,0,0,0
1745141708408,EDS 25,A04,888212,Staff,0,0,0,0
1745141708408,EDS 25,A05,888213,Staff,0,0,0,0
1745141708408,EDS 25,A06,888214,Staff,0,0,0,0
1745141708408,EDS 25,A07,888235,Staff,0,0,0,0
1745141708408,EDS 25,A08,888236,Staff,0,0,0,0
1745141708408,EDS 25,A09,888240,Staff,0,0,0,0
1745141708408,EDS 25,A10,888244,Staff,0,0,0,0
1745141708408,EDS 25,B01,888273,Staff,0,0,0,0
1745141708408,EDS 25,B02,888285,Staff,0,0,0,0
1745141708408,EDS 25,B03,888423,Staff,29,0,30,1
1745141708408,EDS 25,B04,888432,Staff,0,0,0,0
1745141708408,EDS 25,B05,888433,Staff,0,0,0,0
1745141708408,EDS 25,B06,888467,Staff,0,0,0,0
1745141708408,EDS 25,B07,888468,Staff,0,0,0,0
1745141708408,EDS 25,B08,888479,Staff,0,0,0,0
1745141708408,EDS 25,B09,888484,Staff,0,0,0,0
1745141708408,EDS 25,B10,888487,Staff,0,0,0,0
1745141709440,EDS 38,A01,907700,Choi; Bailey Miyeon,30,0,30,0
1745141710468,EDS 112,A01,888601,Chapman; Thandeka K,23,0,40,17
1745141711495,EDS 115,A00,888697,Mendez; Kathrina Mendoza,17,0,30,13
1745141712521,EDS 116,A01,888893,Staff,38,0,40,2
1745141714581,EDS 124AR,A00,889133,Staff,33,0,50,17
1745141714581,EDS 124AR,B00,907471,Simon; Elizabeth A,42,0,50,8
1745141715610,EDS 124BR,A00,889134,Staff,57,0,100,43
1745141716636,EDS 125,A00,889135,Staff,26,0,30,4
1745141717666,EDS 126,A01,889138,Staff,37,0,40,3
1745141718694,EDS 164R,A01,889142,Wishard Guerra; Alison G.,38,0,50,12
1745141719722,ENG 30,A01,886396,Staff,0,0,0,0
1745141719722,ENG 30,B01,886398,Staff,0,0,0,0
1745141720753,ENVR 102,A00,906150,Montejo; Carolina,23,0,25,2
1745141721781,ETHN 103A,A00,887236,Man; Simeon S,0,5,0,0
1745141722807,ETHN 113,A00,887239,Staff,20,0,30,10
1745141723833,ETHN 116,A00,887240,Staff,20,0,25,5
1745141724863,ETHN 117,A00,887241,Choi; Esther Min,27,0,30,3
1745141725892,ETHN 118,A00,887243,Staff,24,0,30,6
1745141726919,ETHN 127,A00,887248,Cuong; Marisol,12,0,15,3
1745141727947,ETHN 139,A00,887250,Staff,8,0,10,2
1745141728977,ETHN 142,A00,887252,Staff,18,0,30,12
1745141730003,ETHN 161,A00,887253,Browne; Errol Tsekani,28,0,30,2
1745141731029,ETHN 163FR,A00,887255,Burelle; Julie Sara Veronique,4,0,5,1
1745141732056,GLBH 20,A00,889149,Elwardani; Nile Regina,15,0,42,27
1745141734144,GLBH 111,A01,889152,Burgos; Jose L.,17,0,17,0
1745141735177,GLBH 150,A00,889181,Sloane; Julia Kathryn,0,1,15,15
1745141737233,HDS 60,A01,886406,Warstadt; Melissa Fawn,76,0,80,4
1745141738258,HIAF 111,A00,889324,Gyamfi; Bright,0,4,0,0
1745141739285,HIEA 131,A00,889328,Staff,14,0,32,18
1745141740313,HIEA 144,A00,889333,Henry; Todd A.,29,0,32,3
1745141741340,HIEA 154,A00,889336,Henry; Todd A.,28,0,32,4
1745141742369,HIEU 106,A00,889339,Staff,28,0,32,4
1745141744420,HIEU 114,A00,889340,Staff,18,0,32,14
1745141745452,HIEU 135GS,A00,889342,Patterson; Patrick H.,0,0,1,22
1745141746477,HIEU 137,A00,889343,Edington; Claire Ellen,12,0,25,13
1745141747501,HIEU 148,A00,889345,Staff,16,0,32,16
1745141748527,HIEU 154,A00,889346,Biess; Frank Peter,24,0,32,8
1745141749555,HILA 102,A00,889351,Staff,13,0,32,19
1745141750587,HILD 2A,A01,889221,Lewandoski; Julia Mavis,0,5,32,32
1745141751618,HILD 7B,A01,889225,Man; Simeon S,0,7,32,32
1745141752646,HILD 7C,A01,889288,Alvarez; Luis A,0,8,32,32
1745141753671,HILD 30,A01,889323,Staff,0,1,32,32
1745141755721,HISC 119,A00,889383,Golan; Tal,22,0,32,10
1745141756745,HIUS 103,A00,889384,Man; Simeon S,10,0,32,22
1745141757775,HIUS 117,A00,919797,Kwak; Nancy,23,0,32,9
1745141758801,HIUS 142A,A00,919788,Staff,24,0,32,8
1745141760860,HIUS 149,A00,889386,Gyamfi; Bright,0,1,0,0
1745141761889,HIUS 155,A00,889387,Alvarez; Luis A,19,0,32,13
1745141762921,HUM 3,A01,886499,Caldwell; Michael Alan,24,0,50,26
1745141763950,HUM 3GS,A00,886500,Rodriguez; Bretton Sigfred,0,0,0,26
1745141764977,HUM 3R,A01,886502,Markman; Kristina,0,32,50,50
1745141766005,HUM 4,A01,886504,Crum; Matthew Stephen,28,0,50,22
1745141766005,HUM 4,B01,886506,West; Geoffrey Scott,25,0,50,25
1745141767030,HUM 4GS,A00,886507,Staff,0,0,0,13
1745141768056,HUM 5,A01,886509,Staff,35,0,50,15
1745141769084,HUM 5R,A01,886511,Zavodny; Tatiana Sophia,0,32,50,50
1745141770113,JAPN 180,A00,886407,Staff,25,0,40,15
1745141771139,LATI 50,A01,886409,Martin-Cabrera; Luis,9,0,22,13
1745141771139,LATI 50,A02,886410,Martin-Cabrera; Luis,20,0,22,2
1745141771139,LATI 50,A03,886411,Martin-Cabrera; Luis,22,0,22,0
1745141771139,LATI 50,A04,886412,Martin-Cabrera; Luis,15,0,22,7
1745141772167,LAWS 101,A00,907664,Staff,36,0,60,24
1745141773192,LIAB 1A,A00,889388,Saab; Dima,19,0,20,1
1745141774222,LIAB 1AX,A00,889389,El Cheddadi; Youniss,19,0,20,1
1745141775248,LIFR 1C,A00,889391,Van Moer; Vinciane G,9,0,20,11
1745141776273,LIFR 1CX,A00,889392,Van Moer; Vinciane G,8,0,20,12
1745141777299,LIFR 1D,A00,889393,Van Moer; Vinciane G,11,0,20,9
1745141778324,LIFR 1DX,A00,889394,Van Moer; Vinciane G,11,0,20,9
1745141779350,LIGN 7,A00,886923,Staff,30,0,50,20
1745141780378,LIGN 17,A00,886924,Kehler; Andrew Scott,133,0,150,17
1745141781405,LTAM 110,A00,889395,Staff,17,0,30,13
1745141782434,LTCH 101,A00,889397,Staff,22,0,25,3
1745141783460,LTCS 130,A00,889398,Staff,23,0,25,2
1745141784491,LTEA 138,A00,889399,Staff,25,0,40,15
1745141785517,LTEN 149,A00,889400,Wesling; Megan E.,6,0,25,19
1745141786546,LTEN 169,A00,889401,Staff,24,0,25,1
1745141787575,LTEN 180,A00,889402,Staff,12,0,15,3
1745141788602,LTEN 181,A00,889403,Staff,23,0,25,2
1745141789628,LTWL 100,A00,889404,Myerston Santana; Jacobo,8,0,25,17
1745141790655,LTWL 180GS,A00,889405,Staff,6,0,20,14
1745141791683,LTWL 181,A00,889406,Staff,19,0,25,6
1745141792710,LTWL 184,A00,889475,Mukherjee; Silpa,21,0,25,4
1745141793735,LTWR 102C,A00,889486,Staff,29,0,30,1
1745141794763,LTWR 115W,A00,889491,Staff,3,0,15,12
1745141795794,MAE 8,A01,886905,Staff,0,2,0,0
1745141796821,MAE 11,A00,886906,Bandaru; Prabhakar,0,0,50,50
1745141797854,MAE 20,A00,886907,Evdokimenko; Ekaterina,50,0,70,20
1745141798884,MAE 30B,A00,886909,Ghazinejad; Maziar,28,0,45,17
1745141799911,MAE 101B,A00,886910,Saintillan; David,36,0,45,9
1745141800940,MAE 105,A00,886911,Bandaru; Prabhakar,26,0,50,24
1745141801964,MAE 107,A00,886912,Staff,22,0,60,38
1745141802992,MAE 143B,A00,886913,Bewley; Thomas R,14,0,40,26
1745141804020,MAE 148,A01,886915,Silberman; Jack,5,0,14,9
1745141805050,MAE 160,A00,886916,Evdokimenko; Ekaterina,41,0,60,19
1745141806079,MATH 3C,A01,889681,Staff,2,0,30,28
1745141807110,MATH 10A,A01,889760,Staff,28,0,30,2
1745141807110,MATH 10A,A02,889783,Staff,30,0,30,0
1745141808143,MATH 10B,A01,889785,Verstraete; Jacques Allan,0,2,30,30
1745141808143,MATH 10B,A02,889795,Verstraete; Jacques Allan,0,2,30,30
1745141808143,MATH 10B,B01,889797,Verstraete; Jacques Allan,0,0,30,30
1745141808143,MATH 10B,B02,889828,Verstraete; Jacques Allan,23,0,30,7
1745141809178,MATH 10C,A01,889849,Habib; Yousaf,18,0,30,12
1745141809178,MATH 10C,A02,889852,Habib; Yousaf,20,0,30,10
1745141809178,MATH 10C,A03,889853,Habib; Yousaf,25,0,30,5
1745141809178,MATH 10C,A04,889858,Habib; Yousaf,21,0,30,9
1745141809178,MATH 10C,B01,889861,Staff,12,0,30,18
1745141809178,MATH 10C,B02,889862,Staff,26,0,30,4
1745141809178,MATH 10C,B03,889863,Staff,28,0,30,2
1745141809178,MATH 10C,B04,889967,Staff,25,0,30,5
1745141810206,MATH 18,A01,889974,Staff,15,0,30,15
1745141810206,MATH 18,A02,889977,Staff,25,0,30,5
1745141810206,MATH 18,B01,889984,Hardiman; Liam,26,0,30,4
1745141810206,MATH 18,B02,889985,Hardiman; Liam,28,0,30,2
1745141811231,MATH 20A,A01,889990,Suk; Andrew Hoon,31,0,35,4
1745141812263,MATH 20B,A01,889993,Ohm; Ko Woon,21,0,30,9
1745141812263,MATH 20B,A02,889994,Ohm; Ko Woon,30,0,30,0
1745141812263,MATH 20B,B01,889996,Ohm; Ko Woon,25,0,30,5
1745141812263,MATH 20B,B02,889997,Ohm; Ko Woon,24,0,30,6
1745141813292,MATH 20C,A01,889999,Hammock; Frances H,22,0,30,8
1745141813292,MATH 20C,A02,890003,Hammock; Frances H,23,0,30,7
1745141813292,MATH 20C,B01,890006,Hammock; Frances H,11,0,30,19
1745141813292,MATH 20C,B02,890007,Hammock; Frances H,18,0,30,12
1745141814322,MATH 20D,A01,890011,Cheng; Hsiao-Bing,6,0,30,24
1745141814322,MATH 20D,A02,890012,Cheng; Hsiao-Bing,27,0,30,3
1745141814322,MATH 20D,B01,890016,Cheng; Hsiao-Bing,19,0,30,11
1745141814322,MATH 20D,B02,890017,Cheng; Hsiao-Bing,15,0,30,15
1745141815351,MATH 20E,A01,890026,Harel; Guershon,10,0,30,20
1745141815351,MATH 20E,A02,890029,Harel; Guershon,24,0,30,6
1745141815351,MATH 20E,B01,890033,Harel; Guershon,14,0,30,16
1745141815351,MATH 20E,B02,890101,Harel; Guershon,27,0,30,3
1745141816377,MATH 102,A01,890104,Staff,20,0,30,10
1745141816377,MATH 102,A02,890105,Staff,30,0,30,0
1745141817409,MATH 103B,A01,890116,Salehi Golsefidy; Alireza,8,0,30,22
1745141817409,MATH 103B,B01,890118,Staff,0,4,30,30
1745141818434,MATH 109,A01,890121,Aliabadi Sr.; Mohsen,6,0,30,24
1745141818434,MATH 109,B01,890124,Upadrashta; Pranav Kumar,23,0,30,7
1745141819466,MATH 120A,A01,890126,Eggers; John Dietrich,15,0,30,15
1745141820499,MATH 142B,A01,890128,Ioana; Adrian,17,0,30,13
1745141820499,MATH 142B,A02,890129,Ioana; Adrian,15,0,30,15
1745141821526,MATH 154,A01,890174,Staff,0,1,30,30
1745141821526,MATH 154,A02,890182,Staff,15,0,30,15
1745141822552,MATH 168A,A01,890197,Dumitriu; Ioana,22,0,35,13
1745141823579,MATH 170A,A01,890240,Nie; Jiawang,6,0,30,24
1745141823579,MATH 170A,A02,890241,Nie; Jiawang,18,0,30,12
1745141823579,MATH 170A,A03,890249,Nie; Jiawang,23,0,30,7
1745141824610,MATH 170B,A01,957891,Nag; Panchali,25,0,35,10
1745141826661,MATH 181A,A01,908025,Staff,0,8,35,35
1745141827688,MATH 193B,A01,890265,Staff,3,0,35,32
1745141828715,MGT 4,A01,890311,Anderson; John Charles,57,0,88,31
1745141829744,MGT 5,A00,907740,Staff,41,0,98,57
1745141830771,MGT 12,A00,890312,Lindenberger; Wade Douglas,70,0,98,28
1745141831796,MGT 16,A00,957883,Staff,84,0,98,14
1745141833847,MGT 45,A00,890314,Pecore; Joseph P.,57,0,98,41
1745141834877,MGT 71,A00,890315,Staff,6,0,98,92
1745141835903,MGT 100,A00,890316,Yavorsky; Daniel Ryan,59,0,98,39
1745141836932,MGT 103,A00,890317,Ehrich; Kristine R,77,0,98,21
1745141837962,MGT 105,A00,890356,Bates; Kenneth Walter,19,0,98,79
1745141838992,MGT 112,A00,890360,Ehrich; Kristine R,65,0,98,33
1745141840020,MGT 127R,A00,907732,Zhu; Kevin Xiaoguo,32,0,98,66
1745141841047,MGT 131B,A00,890361,Anderson; John Charles,75,0,98,23
1745141842075,MGT 137,A00,890362,Lindenberger; Wade Douglas,68,0,98,30
1745141843101,MGT 160,A00,890369,Johnson; Erik Barry,36,0,98,62
1745141845152,MGT 164,A00,890372,Zimmermann; Carsten,0,29,98,98
1745141846182,MGT 180,A00,890374,Bliss; Barbara Ann,31,0,98,67
1745141847212,MMW 15,A01,886414,Chang; Edmond Yi-Teh,0,10,28,28
1745141847212,MMW 15,A02,886415,Chang; Edmond Yi-Teh,0,10,28,28
1745141847212,MMW 15,A03,886416,Chang; Edmond Yi-Teh,0,8,28,28
1745141847212,MMW 15,A04,886417,Chang; Edmond Yi-Teh,0,8,28,28
1745141847212,MMW 15,B01,886419,Chang; Edmond Yi-Teh,0,8,28,28
1745141847212,MMW 15,B02,886420,Chang; Edmond Yi-Teh,0,9,28,28
1745141847212,MMW 15,B03,886421,Chang; Edmond Yi-Teh,0,9,28,28
1745141847212,MMW 15,B04,886422,Chang; Edmond Yi-Teh,0,9,28,28
1745141847212,MMW 15,C01,886424,Staff,0,10,28,28
1745141847212,MMW 15,C02,886425,Staff,0,10,28,28
1745141847212,MMW 15,C03,886426,Staff,0,9,28,28
1745141847212,MMW 15,C04,886427,Staff,0,9,28,28
1745141848239,MMW 15GS,A00,906910,Patterson; Patrick H.,5,0,28,23
1745141849269,MMW 122R,A01,886429,Rahimi; Babak,0,23,28,28
1745141849269,MMW 122R,A02,886430,Rahimi; Babak,0,23,28,28
1745141850295,MUS 1A,A01,890937,Staff,8,0,25,17
1745141850295,MUS 1A,A02,891035,Staff,15,0,25,10
1745141850295,MUS 1A,B00,907849,Staff,48,0,50,2
1745141850295,MUS 1A,B01,907850,Staff,25,0,25,0
1745141850295,MUS 1A,B02,907851,Staff,25,0,25,0
1745141852349,MUS 2AK,A00,957092,Ohnishi; Takae,15,0,15,0
1745141853376,MUS 4,A01,891044,Staff,6,0,25,19
1745141853376,MUS 4,A02,891045,Staff,24,0,25,1
1745141853376,MUS 4,B01,891048,Staff,20,0,25,5
1745141853376,MUS 4,B02,891050,Staff,25,0,25,0
1745141854408,MUS 5,A01,957506,Dubnov; Shlomo,4,0,25,21
1745141854408,MUS 5,A02,957622,Dubnov; Shlomo,21,0,25,4
1745141854408,MUS 5,A03,957623,Dubnov; Shlomo,23,0,25,2
1745141855434,MUS 6,A01,891053,Freitas Caetano; Marcelo,23,0,25,2
1745141855434,MUS 6,A02,891054,Freitas Caetano; Marcelo,23,0,25,2
1745141856464,MUS 7,A01,891081,Staff,0,0,25,25
1745141856464,MUS 7,A02,891082,Staff,15,0,25,10
1745141857490,MUS 8GS,A00,891118,Borgo; David Garcia,5,0,25,20
1745141858516,MUS 11,A01,891140,Staff,12,0,25,13
1745141858516,MUS 11,A02,891141,Staff,24,0,25,1
1745141859542,MUS 13,A01,891143,Staff,10,0,25,15
1745141859542,MUS 13,A02,891144,Staff,25,0,25,0
1745141860570,MUS 15,A01,891146,Staff,7,0,25,18
1745141860570,MUS 15,A02,891148,Staff,22,0,25,3
1745141860570,MUS 15,B01,891150,Staff,18,0,25,7
1745141860570,MUS 15,B02,891151,Staff,25,0,25,0
1745141861595,MUS 20,A01,891153,Staff,9,0,20,11
1745141861595,MUS 20,A02,891155,Staff,16,0,20,4
1745141862621,MUS 80,A00,891156,Staff,19,0,25,6
1745141862621,MUS 80,B00,891157,Staff,25,0,25,0
1745141863651,MUS 130,A00,891158,Ohnishi; Takae,35,0,35,0
1745141864679,MUS 150GS,A01,891160,Borgo; David Garcia,5,0,25,20
1745141865705,MUS 170,A01,891162,Freitas Caetano; Marcelo,21,0,25,4
1745141865705,MUS 170,A02,891164,Freitas Caetano; Marcelo,22,0,25,3
1745141866738,NANO 11,A00,886220,Vazquez Mena; Oscar,12,0,15,3
1745141867771,NANO 15,A01,886222,Drews; Aaron,9,0,10,1
1745141868798,NANO 104,A00,886224,Sirbuly; Donald,18,0,25,7
1745141869829,PH 40,A00,886528,Staff,29,0,40,11
1745141870855,PH 45,A01,886799,Staff,36,0,40,4
1745141871881,PH 110,A00,886802,Staff,7,0,40,33
1745141872905,PH 172,A00,906716,Staff,20,0,35,15
1745141873929,PH 191,A00,886803,Staff,23,0,40,17
1745141875011,PHIL 1,A00,889500,Staff,22,0,30,8
1745141876038,PHIL 10,A01,889549,Grush; Rick Scott,17,0,22,5
1745141876038,PHIL 10,A02,889551,Grush; Rick Scott,20,0,22,2
1745141877066,PHIL 28,A01,889559,Lamey; Andy M.,0,4,25,25
1745141877066,PHIL 28,A02,889561,Lamey; Andy M.,0,0,25,25
1745141877066,PHIL 28,A03,889572,Lamey; Andy M.,7,0,25,18
1745141878090,PHIL 35,A00,907839,Staff,32,0,33,1
1745141879115,PHIL 60,A00,889574,Staff,79,0,90,11
1745141880145,PHIL 105,A00,889579,Staff,0,1,0,0
1745141881170,PHIL 136,A00,889582,Fulkerson; Matthew Todd,27,0,45,18
1745141882196,PHIL 163,A01,889601,Staff,24,0,30,6
1745141882196,PHIL 163,B01,889606,Brandt; Reuven A,0,2,0,0
1745141883220,PHIL 164,A00,889610,Staff,20,0,30,10
1745141884247,PHIL 165,A00,889613,Staff,26,0,30,4
1745141885273,PHYS 1A,A00,886431,Staff,38,0,70,32
1745141886301,PHYS 1AL,001,886432,Tsai; Philbert S,0,0,30,30
1745141886301,PHYS 1AL,002,886436,Tsai; Philbert S,19,0,30,11
1745141887326,PHYS 1B,A00,886439,Staff,192,0,240,48
1745141888354,PHYS 1BL,001,886441,Tsai; Philbert S,0,1,30,30
1745141888354,PHYS 1BL,002,886444,Tsai; Philbert S,14,0,30,16
1745141889382,PHYS 1C,A00,896092,Arnold; Kam S,87,0,146,59
1745141890407,PHYS 1CL,001,886448,Tsai; Philbert S,0,4,30,30
1745141890407,PHYS 1CL,002,886449,Tsai; Philbert S,6,0,30,24
1745141890407,PHYS 1CL,003,886450,Tsai; Philbert S,22,0,30,8
1745141890407,PHYS 1CL,004,886451,Tsai; Philbert S,16,0,30,14
1745141891436,PHYS 2B,A01,886457,Staff,86,0,115,29
1745141892463,PHYS 2C,A01,886460,Shotwell; Brian,0,0,65,65
1745141893489,PHYS 2CL,A01,886467,Staff,0,3,28,28
1745141893489,PHYS 2CL,A02,886468,Staff,5,0,28,23
1745141894520,PHYS 2D,A01,886470,Staff,17,0,50,33
1745141895551,PHYS 4B,A01,886475,Grinstein; Benjamin,88,0,100,12
1745141896579,POLI 5,A00,891173,Desposato; Scott,17,0,25,8
1745141897604,POLI 5D,A01,891175,Staff,5,0,5,0
1745141897604,POLI 5D,B01,891178,Staff,5,0,5,0
1745141898634,POLI 11,A00,891179,Ferree; Karen E,3,0,25,22
1745141899658,POLI 12,A00,891180,Staff,21,0,30,9
1745141900684,POLI 27,A01,891182,Staff,29,0,75,46
1745141901709,POLI 30,A00,891183,Staff,0,3,30,30
1745141902738,POLI 100B,A00,891244,Staff,0,8,20,20
1745141903764,POLI 100I,A00,891247,Staff,19,0,30,11
1745141904791,POLI 104J,A00,891248,Nichter; Maysa,18,0,30,12
1745141905815,POLI 104U,A00,891250,Nichter; Maysa,9,0,30,21
1745141906839,POLI 108,A00,891253,Staff,0,0,0,4
1745141907865,POLI 110B,A00,891255,Wiens; David,22,0,25,3
1745141908890,POLI 112A,A00,891256,Wiens; David,15,0,25,10
1745141909918,POLI 114BR,A00,891261,Staff,22,0,30,8
1745141910946,POLI 117R,A00,891262,Forman; Fonna,12,0,50,38
1745141911971,POLI 118,A00,891264,Ingham; Sean,22,0,25,3
1745141912996,POLI 124A,A00,891265,Staff,19,0,20,1
1745141914024,POLI 125D,A00,891266,Nichter; Simeon C,9,0,25,16
1745141915053,POLI 126,A00,891268,Nichter; Simeon C,11,0,25,14
1745141916077,POLI 126AA,A00,891272,Staff,19,0,25,6
1745141917101,POLI 130AA,A00,891273,Staff,17,0,20,3
1745141918126,POLI 134AA,A00,891274,Staff,12,0,20,8
1745141920184,POLI 138,A00,891278,Staff,22,0,25,3
1745141921212,POLI 142K,A00,891280,Staff,17,0,25,8
1745141922237,POLI 142M,A00,891281,Gartzke; Erik,22,0,30,8
1745141923263,POLI 142P,A00,891284,Staff,21,0,30,9
1745141924288,POLI 143,A00,891285,Gartzke; Erik,17,0,30,13
1745141925314,POLI 153,A00,891286,Staff,20,0,20,0
1745141926341,POLI 170A,A00,891288,Staff,19,0,25,6
1745141927369,POLI 175,A00,891290,Staff,18,0,20,2
1745141928396,PSYC 1,A00,890674,Steiner; Eric Tomas,0,4,45,45
1745141929421,PSYC 2,A00,890676,Albright; Thomas D,25,0,35,10
1745141930448,PSYC 3,A00,890679,Staff,18,0,20,2
1745141931481,PSYC 60,A01,890684,Rickard; Timothy C.,7,0,45,38
1745141932511,PSYC 70,A01,890689,Geller; Emma Harlan,14,0,30,16
1745141933539,PSYC 100,A00,890690,Lacefield; Katharine I,0,43,180,180
1745141934568,PSYC 102,A00,890695,Staff,25,0,40,15
1745141935599,PSYC 105,A00,890699,Geller; Emma Harlan,78,0,100,22
1745141936626,PSYC 106,A00,890701,Gorman; Michael R.,15,0,30,15
1745141937651,PSYC 108,A00,890704,Adrian; Julia Anna,0,23,50,50
1745141938677,PSYC 118,A01,890712,Staff,18,0,30,12
1745141939707,PSYC 124,A00,890716,Chapman; Eddie Nathaniel,36,0,60,24
1745141940738,PSYC 131,A00,890717,Anagnostaras; Stephan,6,0,80,74
1745141941765,PSYC 137,A00,890719,Winkielman; Piotr,0,2,30,30
1745141942795,PSYC 144,A00,890721,Adrian; Julia Anna,0,3,45,45
1745141943821,PSYC 162,A00,890805,Staff,21,0,75,54
1745141944849,PSYC 169,A00,890810,Staff,0,15,30,30
1745141945875,PSYC 172,A00,890814,Gorman; Michael R.,14,0,30,16
1745141946903,PSYC 181,A00,890818,Anagnostaras; Stephan,63,0,200,137
1745141947933,PSYC 189,A00,890823,Staff,11,0,30,19
1745141948958,PSYC 191,A00,890884,Rickard; Timothy C.,0,11,35,35
1745141949987,PSYC 193,A00,890913,Staff,22,0,30,8
1745141949987,PSYC 193,B00,890914,Chapman; Eddie Nathaniel,25,0,30,5
1745141951016,PSYC 193L,A01,890918,Lowe; Angela Beth,29,0,30,1
1745141951016,PSYC 193L,B01,890921,Hurwitz; Ethan Scott,28,0,30,2
1745141951016,PSYC 193L,C01,890928,Staff,30,0,30,0
1745141952045,RELI 149,A00,886806,Rahimi; Babak,23,0,40,17
1745141953072,SE 9,A01,886814,Staff,13,0,20,7
1745141954099,SE 101B,A01,886816,Chadha; Mayank,8,0,30,22
1745141955128,SE 110B,A00,886818,Zhu; Qiang,0,16,45,45
1745141956156,SE 125,A01,886830,Staff,10,0,30,20
1745141957181,SE 130B,A01,886835,Staff,19,0,40,21
1745141958210,SE 131A,A01,886838,Krysl; Petr,37,0,55,18
1745141959239,SE 154,A00,886840,Staff,35,0,50,15
1745141960265,SE 164GS,A01,886849,Staff,13,0,20,7
1745141961290,SE 167GS,A01,886853,Staff,13,0,20,7
1745141962316,SIO 25,A01,890107,Staff,23,0,30,7
1745141963350,SIO 45,A00,890109,Cook; Geoffrey W,137,0,200,63
1745141964377,SIO 109R,A00,890110,Forman; Fonna,0,11,20,20
1745141965409,SIO 187,A01,890114,Kacev; David,21,0,40,19
1745141966437,SOCI 1,A01,890431,Thorpe; Charles Robert,21,0,30,9
1745141966437,SOCI 1,A02,890518,Thorpe; Charles Robert,30,0,30,0
1745141967463,SOCI 2,A01,957978,Staff,0,0,0,0
1745141967463,SOCI 2,A02,957979,Staff,0,3,0,0
1745141968490,SOCI 20,A01,890523,Calderon-Zaks; Michael Aar,24,0,30,6
1745141968490,SOCI 20,A02,890526,Calderon-Zaks; Michael Aar,29,0,30,1
1745141969519,SOCI 30,A01,890533,Pardo Guerra; Juan Pablo,37,0,40,3
1745141970549,SOCI 40,A01,890535,Staff,32,0,45,13
1745141971576,SOCI 104Q,A00,890559,Staff,20,0,30,10
1745141972604,SOCI 106,A00,890560,Arnal; Maud Marie Leonie,22,0,30,8
1745141973630,SOCI 110,A00,890567,Holkenbrink-Monk; Charlene,22,0,30,8
1745141974656,SOCI 112,A00,890568,Victoria Torres; Pablo,0,0,45,45
1745141975685,SOCI 115,A00,890597,Arnal; Maud Marie Leonie,33,0,45,12
1745141977743,SOCI 121,A00,890604,Pardo Guerra; Juan Pablo,40,0,45,5
1745141978770,SOCI 126,A01,890608,Staff,8,0,10,2
1745141979798,SOCI 127,A00,890609,Staff,23,0,30,7
1745141980823,SOCI 131,A00,890610,Thorpe; Charles Robert,38,0,45,7
1745141981855,SOCI 135,A00,890615,Payne; Christine Anna,20,0,45,25
1745141982885,SOCI 139,A00,890620,Staff,43,0,45,2
1745141983910,SOCI 148E,A00,890622,Calderon-Zaks; Michael Aar,39,0,45,6
1745141984936,SOCI 150,A00,890623,Kohler; Kristopher M.,36,0,45,9
1745141985963,SOCI 157,A00,890625,Jules-Rosette; Bennetta W.,18,0,20,2
1745141986992,SOCI 160,A00,890627,Payne; Christine Anna,26,0,45,19
1745141988024,SYN 1,A00,886855,Fish; Gwendolyn Anne,0,0,0,0
1745141988024,SYN 1,B00,906086,Fish; Gwendolyn Anne,0,0,0,2
1745141989053,SYN 2R,A00,886860,Staff,0,15,15,15
1745141989053,SYN 2R,B00,906106,Atkinson; Arthur Laird,0,14,15,15
1745141990083,SYN 100,A01,886866,Browne; Emily,0,29,20,20
1745141990083,SYN 100,B01,906128,Rock; Martin,0,4,20,20
1745141990083,SYN 100,C01,906140,Deavenport; James Cary,0,2,20,20
1745141990083,SYN 100,D01,907816,Deavenport; James Cary,0,3,20,20
1745141991111,TDAC 1,A00,890286,Walsh; Kim C.,11,0,20,9
1745141992139,TDAC 101,A00,890296,Basso; Beatrice,18,0,20,2
1745141993166,TDDE 131,A00,890297,Staff,47,0,50,3
1745141994197,TDDM 1,A00,890287,Weinberg; Sadie,26,0,30,4
1745141995228,TDGE 11,A00,890288,Fulton; Julia,155,0,200,45
1745141995228,TDGE 11,B00,890289,Castro; Robert Jess,188,0,200,12
1745141996254,TDGE 25,B00,957359,Walsh; Kim C.,9,0,20,11
1745141997281,TDGE 40,A01,890292,Power; Jade Yukana,28,0,30,2
1745141998305,TDGE 124,A00,890298,Havis; Allan,12,0,50,38
1745141999334,TDGE 131R,A00,890299,Burelle; Julie Sara Veronique,20,0,42,22
1745142000364,TDHT 101,A00,890300,Staff,12,0,20,8
1745142001401,TDHT 109,A01,890302,Anderson; Mysia Anyse,31,0,40,9
1745142002430,TDMV 1,A00,890293,Arcidiacono; Kristin,20,0,30,10
1745142003456,TDMV 2,A00,890294,Weinberg; Sadie,26,0,30,4
1745142004485,TDMV 3,A00,957878,Arcidiacono; Kristin,27,0,30,3
1745142006539,TDMV 138,A00,890304,Jun; Grace Shin Hae,25,0,40,15
1745142007565,TDMV 140,A00,890305,Corrales; Joseph Bernales,28,0,30,2
1745142008596,TDMV 142,A00,890307,Caligagan; Tony,30,0,40,10
1745142009625,TDMV 144,A00,890308,Camaya; Michelle Ann,26,0,30,4
1745142010655,TDPW 1,A00,890295,Stein; Deborah Isobel,5,0,20,15
1745142011681,USP 2,A01,890272,Lerner; Amy M,8,0,20,12
1745142012707,USP 3,A01,890274,Staff,21,0,30,9
1745142013733,USP 15,A01,890276,Sun; Feiyang,21,0,30,9
1745142014764,USP 25,A00,890277,Shenkman; Michael Thomas,21,0,25,4
1745142015792,USP 138,A00,890278,Staff,15,0,25,10
1745142016817,USP 143,A00,890279,Staff,30,0,70,40
1745142017848,USP 144,A00,890280,Chowdhury; Muhammed Zohir,19,0,30,11
1745142018880,USP 150,A00,890281,Boomhower; Matthew Charles,19,0,30,11
1745142019909,USP 151,A00,890282,Staff,17,0,20,3
1745142020933,USP 162,A00,890283,Andrews; Abigail Leslie,17,0,20,3
1745142021960,USP 168,A00,920477,Kwak; Nancy,2,0,5,3
1745142022986,USP 181,A00,890284,Staff,11,0,20,9
1745142024012,USP 191A,A00,890285,Staff,15,0,20,5
1745142025038,VIS 101,A00,886512,Staff,37,0,75,38
1745142026066,VIS 103,A00,886513,Cruz; Edwin Teddy,65,0,75,10
1745142027095,VIS 108,A00,886514,Staff,7,0,15,8
1745142028120,VIS 127P,A00,886515,Shen; Kuiyi,92,0,146,54
1745142029150,VIS 149,A00,886516,Yoldas; Pinar,1,0,15,14
1745142030180,VIS 164,A00,886526,Erdmann; Dean,21,0,22,1
1745142031210,VIS 194S,A00,886527,Staff,61,0,75,14
1745142032235,WCWP 10A,C00,886484,Staff,13,0,15,2
1745142033262,WCWP 10B,A00,886490,Staff,5,0,15,10
1745142033262,WCWP 10B,B00,886491,Staff,0,1,0,0
1745142033262,WCWP 10B,C00,886492,Staff,10,0,15,5
1745142034292,WCWP 100,A00,886494,Staff,0,2,15,15
1745142036469,AAS 10,A01,886199,Childs; Dennis R.,0,2,0,0
1745142037496,ANAR 104,A01,886940,Shtienberg; Gilad,27,0,30,3
1745142038524,ANAR 120,A00,886953,Staff,13,0,20,7
1745142039554,ANBI 148,A01,886955,Wilder; Linnea Lorene,32,0,40,8
1745142041610,ANSC 122,A00,886957,Staff,28,0,30,2
1745142042636,ANSC 150,A00,886958,Sloane; Julia Kathryn,6,0,15,9
1745142043663,ANSC 156,A00,886959,Jenkins; Janis A.,2,0,15,13
1745142044689,ANSC 180,A00,886960,Staff,12,0,17,5
1745142045720,ANSC 188,A00,886961,Jassal; Aftab,10,0,25,15
1745142046747,ANSC 190,A00,886962,Jassal; Aftab,14,0,25,11
1745142047775,ANSC 191,A00,886963,Staff,18,0,20,2
1745142048801,ANTH 3,A01,891689,Staff,19,0,20,1
1745142049829,ANTH 5,A00,886933,Semendeferi; Ekaterini,18,0,20,2
1745142050855,ANTH 10,A00,886934,Staff,0,8,30,30
1745142051884,ANTH 21,A01,886936,Staff,44,0,60,16
1745142052913,ANTH 23,A01,886938,Staff,94,0,100,6
1745142053939,ANTH 105,A00,886964,Stewart; Alexander B,94,0,100,6
1745142054971,ANTH 108,A00,886965,Pedersen; David,10,0,20,10
1745142055999,AWP 10,001,886147,Staff,0,0,0,0
1745142055999,AWP 10,002,886148,Staff,0,0,0,0
1745142055999,AWP 10,003,886149,Staff,0,0,0,0
1745142055999,AWP 10,004,886150,Staff,0,0,0,0
1745142055999,AWP 10,005,886151,Staff,0,0,0,0
1745142055999,AWP 10,006,886152,Staff,0,0,0,0
1745142055999,AWP 10,007,886153,Staff,0,0,0,0
1745142055999,AWP 10,008,886154,Staff,0,0,0,0
1745142055999,AWP 10,009,886155,Staff,0,0,0,0
1745142055999,AWP 10,010,886156,Staff,0,0,0,0
1745142055999,AWP 10,011,886158,Staff,0,0,0,0
1745142055999,AWP 10,012,886160,Staff,0,0,0,0
1745142055999,AWP 10,013,886161,Staff,0,0,0,0
1745142055999,AWP 10,014,886162,Staff,0,0,0,0
1745142055999,AWP 10,015,886163,Staff,0,0,0,0
1745142055999,AWP 10,016,886164,Staff,0,0,0,0
1745142055999,AWP 10,017,886165,Staff,0,0,0,0
1745142055999,AWP 10,018,886166,Staff,0,0,0,0
1745142055999,AWP 10,019,886168,Staff,0,0,0,0
1745142055999,AWP 10,020,886170,Staff,0,0,0,0
1745142055999,AWP 10,021,886172,Staff,0,0,0,0
1745142057034,AWP 10R,001,886173,Staff,0,0,0,0
1745142057034,AWP 10R,002,886174,Staff,0,1,0,0
1745142057034,AWP 10R,003,886175,Staff,0,0,0,0
1745142057034,AWP 10R,004,886176,Staff,0,0,0,0
1745142057034,AWP 10R,005,886177,Staff,0,0,0,0
1745142057034,AWP 10R,006,886178,Staff,0,0,0,0
1745142057034,AWP 10R,007,886179,Staff,0,0,0,0
1745142057034,AWP 10R,008,886181,Staff,0,0,0,0
1745142057034,AWP 10R,009,886182,Staff,0,0,0,0
1745142057034,AWP 10R,010,886183,Staff,0,0,0,0
1745142057034,AWP 10R,011,886184,Staff,0,0,0,0
1745142057034,AWP 10R,012,886185,Staff,0,0,0,0
1745142057034,AWP 10R,013,886186,Staff,0,0,0,0
1745142057034,AWP 10R,014,886187,Staff,0,0,0,0
1745142057034,AWP 10R,015,886188,Staff,0,0,0,0
1745142057034,AWP 10R,016,886189,Staff,0,0,0,0
1745142058060,AWP 102R,A00,886190,Staff,0,0,0,0
1745142058060,AWP 102R,B00,886191,Staff,0,0,0,0
1745142059087,BENG 100,A01,886193,Staff,19,0,30,11
1745142060114,BENG 122A,A01,886195,Hasty; Jeff M,20,0,30,10
1745142061141,BENG 166A,A00,886196,Sah; Robert Lie-Yuan,0,3,20,20
1745142062168,BIBC 102,A01,894320,Staff,0,2,46,46
1745142062168,BIBC 102,A02,894321,Staff,0,0,46,46
1745142062168,BIBC 102,A03,894344,Staff,21,0,46,25
1745142062168,BIBC 102,A04,894345,Staff,30,0,47,17
1745142063194,BICD 100R,A01,894365,Smith; Laurie,1,3,58,57
1745142063194,BICD 100R,A02,894366,Smith; Laurie,0,1,58,58
1745142063194,BICD 100R,A03,894367,Smith; Laurie,13,0,59,46
1745142064230,BICD 136,A01,894383,Gustafson-Brown; Cindy,16,0,50,34
1745142065257,BIEB 102,A01,894494,Butler; Shannon Rhey,67,0,130,63
1745142067321,BIEB 150,A01,894617,Wills; Christopher,0,3,13,13
1745142067321,BIEB 150,A02,894631,Wills; Christopher,0,3,13,13
1745142067321,BIEB 150,A03,894937,Wills; Christopher,0,3,13,13
1745142067321,BIEB 150,A04,894946,Wills; Christopher,0,1,11,11
1745142068348,BIEB 194,A00,906141,Kurle; Carolyn M.,14,0,20,6
1745142069379,BILD 1,A01,894154,Staff,8,0,19,11
1745142069379,BILD 1,A02,894155,Staff,15,0,19,4
1745142069379,BILD 1,A03,894160,Staff,18,0,19,1
1745142069379,BILD 1,A04,894161,Staff,16,0,18,2
1745142070405,BILD 2,A01,894168,Staff,0,0,50,50
1745142070405,BILD 2,A02,894169,Staff,0,0,50,50
1745142070405,BILD 2,A03,894179,Staff,27,0,50,23
1745142070405,BILD 2,A04,894203,Staff,42,0,50,8
1745142071433,BILD 3,A01,894213,Staff,24,0,31,7
1745142071433,BILD 3,A02,894214,Staff,28,0,31,3
1745142071433,BILD 3,A03,894235,Staff,30,0,31,1
1745142071433,BILD 3,A04,894236,Staff,29,0,32,3
1745142072459,BILD 4,A01,894253,Reuther; Keefe,12,0,24,12
1745142072459,BILD 4,A02,894258,Reuther; Keefe,19,0,24,5
1745142073490,BILD 5,A01,894276,Reuther; Keefe,40,0,50,10
1745142073490,BILD 5,A02,894277,Reuther; Keefe,48,0,50,2
1745142073490,BILD 5,A03,894290,Reuther; Keefe,47,0,50,3
1745142073490,BILD 5,A04,894291,Reuther; Keefe,50,0,50,0
1745142074517,BILD 24,A01,894297,Pirino; Giorgia,45,0,60,15
1745142075547,BIMM 100,A01,895012,Staff,0,14,0,1
1745142075547,BIMM 100,A02,895013,Staff,0,6,0,2
1745142075547,BIMM 100,A03,895014,Staff,0,7,0,0
1745142075547,BIMM 100,A04,895015,Staff,0,4,0,0
1745142076580,BIMM 101,A01,895017,McDonnell; Lisa Marie,0,2,24,24
1745142076580,BIMM 101,A02,895018,McDonnell; Lisa Marie,0,1,24,24
1745142076580,BIMM 101,B01,895020,McDonnell; Lisa Marie,0,3,24,24
1745142076580,BIMM 101,B02,895021,McDonnell; Lisa Marie,0,2,24,24
1745142077606,BIMM 110,A01,895023,Staff,7,0,25,18
1745142077606,BIMM 110,A02,895024,Staff,11,0,25,14
1745142077606,BIMM 110,A03,895025,Staff,22,0,25,3
1745142077606,BIMM 110,A04,895031,Staff,21,0,25,4
1745142078635,BIMM 120,A01,895114,Gustafson-Brown; Cindy,8,0,28,20
1745142078635,BIMM 120,A02,895126,Gustafson-Brown; Cindy,19,0,27,8
1745142079661,BIPN 100,A01,895130,Yang; Mingyu,13,0,38,25
1745142079661,BIPN 100,A02,895131,Yang; Mingyu,33,0,38,5
1745142079661,BIPN 100,A03,895132,Yang; Mingyu,33,0,38,5
1745142079661,BIPN 100,A04,895133,Yang; Mingyu,30,0,36,6
1745142080690,BIPN 120,A01,895135,Cooke; James Edward,0,2,13,13
1745142080690,BIPN 120,A02,895136,Cooke; James Edward,0,1,13,13
1745142080690,BIPN 120,A03,895137,Cooke; James Edward,0,0,13,13
1745142080690,BIPN 120,A04,895156,Cooke; James Edward,3,0,11,8
1745142081717,BIPN 134,A01,895235,Cooke; James Edward,0,2,25,25
1745142081717,BIPN 134,A02,895237,Cooke; James Edward,0,0,25,25
1745142081717,BIPN 134,A03,895240,Cooke; James Edward,12,0,25,13
1745142081717,BIPN 134,A04,895270,Cooke; James Edward,24,0,25,1
1745142082743,BIPN 189,A00,892103,Staff,0,20,9,9
1745142084801,CAT 124,A01,922009,Staff,0,1,20,20
1745142085831,CAT 125R,A00,886390,Morales; Celeste Georgianna,4,0,20,16
1745142085831,CAT 125R,B00,886391,Irwin; Matthew Joseph,0,1,20,20
1745142085831,CAT 125R,C00,886392,Smith; Lauryn Alissa,11,0,20,9
1745142085831,CAT 125R,D00,886393,Vanderschuit; Maya Alysia,6,0,20,14
1745142085831,CAT 125R,E00,886394,Marchisotto; Jennifer Anne,0,2,20,20
1745142086863,CENG 15,A01,886218,Drews; Aaron,1,0,5,4
1745142087895,CENG 113,A00,886219,Opatkiewicz; Justin Paul,16,0,25,9
1745142088919,CGS 101,A00,887044,Staff,13,0,20,7
1745142089944,CGS 105,A01,887046,Staff,16,0,25,9
1745142090974,CGS 112,A00,887047,Cuong; Marisol,12,0,15,3
1745142092000,CGS 113,A00,887048,Staff,24,0,30,6
1745142093025,CGS 120,A00,887049,Staff,12,0,17,5
1745142094053,CHEM 6A,A01,886336,Lam; Tin Yiu,44,0,50,6
1745142094053,CHEM 6A,A02,886338,Lam; Tin Yiu,43,0,50,7
1745142095081,CHEM 6B,A01,886341,Hopkins; Patrycja Anna,21,0,50,29
1745142095081,CHEM 6B,A02,886343,Hopkins; Patrycja Anna,46,0,50,4
1745142096107,CHEM 6C,A01,886346,Albizati; Kim F.,0,1,50,50
1745142096107,CHEM 6C,A02,886348,Albizati; Kim F.,38,0,50,12
1745142097135,CHEM 40A,A01,886352,Klosterman; Jeremy K,70,0,100,30
1745142098166,CHEM 40B,A01,886356,Klosterman; Jeremy K,0,4,100,100
1745142099197,CHEM 41B,A01,886360,Theodorakis; Emmanuel,30,0,50,20
1745142099197,CHEM 41B,A02,886362,Theodorakis; Emmanuel,46,0,50,4
1745142100224,CHIN 165A,A00,886382,Xu; Li,19,0,20,1
1745142101253,CLAS 120,A00,886387,Myerston Santana; Jacobo,36,0,40,4
1745142102290,COGS 9,A01,886967,Shannon; Kyle Michael,49,0,60,11
1745142103317,COGS 11,A01,886969,Staff,18,0,30,12
1745142104343,COGS 14A,A01,886971,Staff,26,0,60,34
1745142105375,COGS 14B,A01,886973,Hoffman; Drew Ellen,18,0,60,42
1745142106401,COGS 18,A01,886975,Morgan; Eric,41,0,60,19
1745142107433,COGS 20,A01,886977,Staff,6,0,8,2
1745142107433,COGS 20,A02,886978,Staff,6,0,7,1
1745142108459,COGS 100,A01,907783,Staff,6,0,30,24
1745142109485,COGS 101B,A01,886980,Staff,0,10,30,30
1745142110512,COGS 101C,A01,886982,Delgado; Tania,0,6,30,30
1745142111537,COGS 102A,A01,886984,Johnson; Christine M.,13,0,30,17
1745142112562,COGS 118B,A01,886986,Staff,0,25,60,60
1745142113589,COGS 150,A01,886988,Bergen; Benjamin,16,0,30,14
1745142114626,COGS 153,A00,886989,Delgado; Tania,0,6,30,30
1745142115651,COGS 186,A01,886991,Staff,3,0,30,27
1745142116684,COGS 187A,A01,886993,Boyle; Mary E. T.,12,0,30,18
1745142117713,COGS 189,A00,886994,Staff,13,0,30,17
1745142118742,COMM 10,A01,886996,Staff,11,0,25,14
1745142118742,COMM 10,A02,886997,Staff,21,0,25,4
1745142119774,COMM 20,A01,886999,Leuning; Grant Maurstad,33,0,40,7
1745142121825,COMM 100A,A01,887002,Staff,0,0,25,25
1745142121825,COMM 100A,A02,887003,Staff,20,0,25,5
1745142122852,COMM 100B,A01,887005,Staff,0,1,25,25
1745142123877,COMM 106D,A00,887006,Staff,22,0,40,18
1745142124904,COMM 110G,A00,887007,Whitworth-Smith; Andrew C,17,0,40,23
1745142125930,COMM 111B,A00,887008,Staff,31,0,40,9
1745142126959,COMM 113T,A00,887009,Abuelhiga; Soraya Jill,30,0,40,10
1745142126959,COMM 113T,B00,906733,Staff,40,0,40,0
1745142127987,COMM 145,A00,887010,Staff,21,0,40,19
1745142129012,COMM 146,A00,887054,Staff,31,0,40,9
1745142130038,COMM 190,A00,887012,Staff,9,0,23,14
1745142131065,CSE 8A,A50,887015,Cao; Yingjun,68,0,85,17
1745142132093,CSE 11,A01,887017,Cao; Yingjun,35,0,70,35
1745142133122,CSE 20,A01,887019,Staff,35,0,50,15
1745142134146,CSE 21,A01,887021,Braun; Oliver,81,0,100,19
1745142134146,CSE 21,B01,892583,Staff,48,0,50,2
1745142135173,CSE 30,A01,887025,Eldon; John,161,0,200,39
1745142136200,CSE 100,A01,887027,Staff,28,0,50,22
1745142136200,CSE 100,A02,887028,Staff,43,0,50,7
1745142137230,CSE 101,A01,887030,Braun; Oliver,79,0,100,21
1745142137230,CSE 101,B01,887032,Jones; Miles E,0,1,50,50
1745142137230,CSE 101,B02,887033,Jones; Miles E,13,0,50,37
1745142138262,CSE 105,A01,908084,Jones; Miles E,36,0,50,14
1745142138262,CSE 105,A02,908087,Jones; Miles E,38,0,50,12
1745142139288,CSE 135,A01,887035,Powell; Thomas Allan,8,0,50,42
1745142140316,CSE 142,A01,887037,Staff,22,0,60,38
1745142141342,CSE 142L,A01,887039,Staff,42,0,60,18
1745142142368,CSE 151A,A01,887041,Solares; Edwin A,60,0,100,40
1745142143393,CSE 175,A01,887043,Kumar; Rakesh,30,0,30,0
1745142144418,CSS 1,A01,886389,Staff,12,0,40,28
1745142145444,DSC 30,A01,908097,Liao; Soohyun Nam,54,0,75,21
1745142146470,DSC 40A,A01,908099,Shannon; Kyle Michael,37,0,50,13
1745142147496,DSC 40B,A01,908112,Staff,28,0,50,22
1745142148521,DSC 80,A01,908116,Staff,32,0,60,28
1745142149548,DSC 197,001,956863,Eldridge; Justin Matthew,9999,0,9999,0
1745142150574,ECE 5,A01,886400,Morris; Karcher William,3,0,6,3
1745142150574,ECE 5,A02,886401,Morris; Karcher William,5,0,6,1
1745142151602,ECE 148,A01,886403,Silberman; Jack,0,8,14,14
1745142152637,ECON 1,A01,887265,Crane; Meredith Helen,25,0,70,45
1745142152637,ECON 1,B01,887268,Staff,44,0,50,6
1745142153665,ECON 2,A01,887273,Crane; Meredith Helen,61,0,70,9
1745142154692,ECON 3,A01,887279,Rondina; Giacomo,44,0,70,26
1745142155718,ECON 4,A01,887282,Anderson; John Charles,0,1,10,10
1745142156750,ECON 5,A01,887285,Staff,39,0,45,6
1745142156750,ECON 5,B01,887292,Staff,43,0,45,2
1745142157783,ECON 100A,A01,887337,Newhouse; Herbert S,58,0,70,12
1745142157783,ECON 100A,B01,887349,Staff,45,0,50,5
1745142158808,ECON 100B,A01,887361,Du; Songzi,42,0,70,28
1745142159834,ECON 100C,A01,887445,Newhouse; Herbert S,61,0,70,9
1745142160859,ECON 105,A00,887488,Vespa; Emanuel Ignacio,24,0,35,11
1745142161885,ECON 109,A01,887506,Staff,29,0,35,6
1745142162911,ECON 110A,A01,887568,Alon; Titan Michael,1,0,35,34
1745142162911,ECON 110A,B01,907601,Alon; Titan Michael,27,0,35,8
1745142163941,ECON 110B,A01,887598,Levkoff; Steven B.,0,7,70,70
1745142164966,ECON 112,A00,887599,Rondina; Giacomo,20,0,35,15
1745142165995,ECON 120A,A01,887603,Dai; Yinlin,46,0,70,24
1745142167029,ECON 120C,A01,887608,Sun; Yixiao,0,0,35,35
1745142167029,ECON 120C,B01,887614,Sun; Yixiao,13,0,35,22
1745142168057,ECON 138,A00,887621,Bharadwaj; Prashant,0,18,20,20
1745142169083,ECON 171,A01,907666,Staff,27,0,35,8
1745142170109,ECON 175,A00,887626,Wu; Pak Yeung,27,0,35,8
1745142171136,ECON 190,A00,887640,Vespa; Emanuel Ignacio,26,0,35,9
1745142172166,EDS 25,A01,888197,Staff,0,0,0,0
1745142172166,EDS 25,A02,888209,Staff,0,0,0,0
1745142172166,EDS 25,A03,888210,Staff,0,0,0,0
1745142172166,EDS 25,A04,888212,Staff,0,0,0,0
1745142172166,EDS 25,A05,888213,Staff,0,0,0,0
1745142172166,EDS 25,A06,888214,Staff,0,0,0,0
1745142172166,EDS 25,A07,888235,Staff,0,0,0,0
1745142172166,EDS 25,A08,888236,Staff,0,0,0,0
1745142172166,EDS 25,A09,888240,Staff,0,0,0,0
1745142172166,EDS 25,A10,888244,Staff,0,0,0,0
1745142172166,EDS 25,B01,888273,Staff,0,0,0,0
1745142172166,EDS 25,B02,888285,Staff,0,0,0,0
1745142172166,EDS 25,B03,888423,Staff,29,0,30,1
1745142172166,EDS 25,B04,888432,Staff,0,0,0,0
1745142172166,EDS 25,B05,888433,Staff,0,0,0,0
1745142172166,EDS 25,B06,888467,Staff,0,0,0,0
1745142172166,EDS 25,B07,888468,Staff,0,0,0,0
1745142172166,EDS 25,B08,888479,Staff,0,0,0,0
1745142172166,EDS 25,B09,888484,Staff,0,0,0,0
1745142172166,EDS 25,B10,888487,Staff,0,0,0,0
1745142173192,EDS 38,A01,907700,Choi; Bailey Miyeon,30,0,30,0
1745142174222,EDS 112,A01,888601,Chapman; Thandeka K,23,0,40,17
1745142175248,EDS 115,A00,888697,Mendez; Kathrina Mendoza,17,0,30,13
1745142176273,EDS 116,A01,888893,Staff,38,0,40,2
1745142178330,EDS 124AR,A00,889133,Staff,33,0,50,17
1745142178330,EDS 124AR,B00,907471,Simon; Elizabeth A,42,0,50,8
1745142179354,EDS 124BR,A00,889134,Staff,57,0,100,43
1745142180398,EDS 125,A00,889135,Staff,26,0,30,4
1745142181426,EDS 126,A01,889138,Staff,37,0,40,3
1745142182452,EDS 164R,A01,889142,Wishard Guerra; Alison G.,38,0,50,12
1745142183480,ENG 30,A01,886396,Staff,0,0,0,0
1745142183480,ENG 30,B01,886398,Staff,0,0,0,0
1745142184507,ENVR 102,A00,906150,Montejo; Carolina,23,0,25,2
1745142185540,ETHN 103A,A00,887236,Man; Simeon S,0,5,0,0
1745142186565,ETHN 113,A00,887239,Staff,20,0,30,10
1745142187591,ETHN 116,A00,887240,Staff,20,0,25,5
1745142188617,ETHN 117,A00,887241,Choi; Esther Min,27,0,30,3
1745142189646,ETHN 118,A00,887243,Staff,24,0,30,6
1745142190673,ETHN 127,A00,887248,Cuong; Marisol,12,0,15,3
1745142191701,ETHN 139,A00,887250,Staff,8,0,10,2
1745142192727,ETHN 142,A00,887252,Staff,18,0,30,12
1745142193754,ETHN 161,A00,887253,Browne; Errol Tsekani,28,0,30,2
1745142194784,ETHN 163FR,A00,887255,Burelle; Julie Sara Veronique,4,0,5,1
1745142195810,GLBH 20,A00,889149,Elwardani; Nile Regina,15,0,42,27
1745142197868,GLBH 111,A01,889152,Burgos; Jose L.,17,0,17,0
1745142198899,GLBH 150,A00,889181,Sloane; Julia Kathryn,0,1,15,15
1745142200956,HDS 60,A01,886406,Warstadt; Melissa Fawn,76,0,80,4
1745142201986,HIAF 111,A00,889324,Gyamfi; Bright,0,4,0,0
1745142203014,HIEA 131,A00,889328,Staff,14,0,32,18
1745142204040,HIEA 144,A00,889333,Henry; Todd A.,29,0,32,3
1745142205068,HIEA 154,A00,889336,Henry; Todd A.,28,0,32,4
1745142206097,HIEU 106,A00,889339,Staff,28,0,32,4
1745142208150,HIEU 114,A00,889340,Staff,18,0,32,14
1745142209181,HIEU 135GS,A00,889342,Patterson; Patrick H.,0,0,1,22
1745142210205,HIEU 137,A00,889343,Edington; Claire Ellen,12,0,25,13
1745142211236,HIEU 148,A00,889345,Staff,16,0,32,16
1745142212266,HIEU 154,A00,889346,Biess; Frank Peter,24,0,32,8
1745142213292,HILA 102,A00,889351,Staff,13,0,32,19
1745142214322,HILD 2A,A01,889221,Lewandoski; Julia Mavis,0,5,32,32
1745142215352,HILD 7B,A01,889225,Man; Simeon S,0,7,32,32
1745142216379,HILD 7C,A01,889288,Alvarez; Luis A,0,8,32,32
1745142217404,HILD 30,A01,889323,Staff,0,1,32,32
1745142219457,HISC 119,A00,889383,Golan; Tal,22,0,32,10
1745142220484,HIUS 103,A00,889384,Man; Simeon S,10,0,32,22
1745142221515,HIUS 117,A00,919797,Kwak; Nancy,23,0,32,9
1745142222541,HIUS 142A,A00,919788,Staff,24,0,32,8
1745142224596,HIUS 149,A00,889386,Gyamfi; Bright,0,1,0,0
1745142225622,HIUS 155,A00,889387,Alvarez; Luis A,19,0,32,13
1745142226650,HUM 3,A01,886499,Caldwell; Michael Alan,24,0,50,26
1745142227675,HUM 3GS,A00,886500,Rodriguez; Bretton Sigfred,0,0,0,26
1745142228700,HUM 3R,A01,886502,Markman; Kristina,0,32,50,50
1745142229728,HUM 4,A01,886504,Crum; Matthew Stephen,28,0,50,22
1745142229728,HUM 4,B01,886506,West; Geoffrey Scott,25,0,50,25
1745142230752,HUM 4GS,A00,886507,Staff,0,0,0,13
1745142231779,HUM 5,A01,886509,Staff,35,0,50,15
1745142232810,HUM 5R,A01,886511,Zavodny; Tatiana Sophia,0,32,50,50
1745142233837,JAPN 180,A00,886407,Staff,25,0,40,15
1745142234873,LATI 50,A01,886409,Martin-Cabrera; Luis,9,0,22,13
1745142234873,LATI 50,A02,886410,Martin-Cabrera; Luis,20,0,22,2
1745142234873,LATI 50,A03,886411,Martin-Cabrera; Luis,22,0,22,0
1745142234873,LATI 50,A04,886412,Martin-Cabrera; Luis,15,0,22,7
1745142235902,LAWS 101,A00,907664,Staff,36,0,60,24
1745142236931,LIAB 1A,A00,889388,Saab; Dima,19,0,20,1
1745142237956,LIAB 1AX,A00,889389,El Cheddadi; Youniss,19,0,20,1
1745142238984,LIFR 1C,A00,889391,Van Moer; Vinciane G,9,0,20,11
1745142240010,LIFR 1CX,A00,889392,Van Moer; Vinciane G,8,0,20,12
1745142241037,LIFR 1D,A00,889393,Van Moer; Vinciane G,11,0,20,9
1745142242065,LIFR 1DX,A00,889394,Van Moer; Vinciane G,11,0,20,9
1745142243094,LIGN 7,A00,886923,Staff,30,0,50,20
1745142244126,LIGN 17,A00,886924,Kehler; Andrew Scott,133,0,150,17
1745142245155,LTAM 110,A00,889395,Staff,17,0,30,13
1745142246181,LTCH 101,A00,889397,Staff,22,0,25,3
1745142247212,LTCS 130,A00,889398,Staff,23,0,25,2
1745142248239,LTEA 138,A00,889399,Staff,25,0,40,15
1745142249264,LTEN 149,A00,889400,Wesling; Megan E.,6,0,25,19
1745142250290,LTEN 169,A00,889401,Staff,24,0,25,1
1745142251317,LTEN 180,A00,889402,Staff,12,0,15,3
1745142252342,LTEN 181,A00,889403,Staff,23,0,25,2
1745142253373,LTWL 100,A00,889404,Myerston Santana; Jacobo,8,0,25,17
1745142254399,LTWL 180GS,A00,889405,Staff,6,0,20,14
1745142255430,LTWL 181,A00,889406,Staff,19,0,25,6
1745142256457,LTWL 184,A00,889475,Mukherjee; Silpa,21,0,25,4
1745142257483,LTWR 102C,A00,889486,Staff,29,0,30,1
1745142258508,LTWR 115W,A00,889491,Staff,3,0,15,12
1745142259534,MAE 8,A01,886905,Staff,0,2,0,0
1745142260562,MAE 11,A00,886906,Bandaru; Prabhakar,0,0,50,50
1745142261589,MAE 20,A00,886907,Evdokimenko; Ekaterina,50,0,70,20
1745142262621,MAE 30B,A00,886909,Ghazinejad; Maziar,28,0,45,17
1745142263652,MAE 101B,A00,886910,Saintillan; David,36,0,45,9
1745142264679,MAE 105,A00,886911,Bandaru; Prabhakar,26,0,50,24
1745142265704,MAE 107,A00,886912,Staff,22,0,60,38
1745142266732,MAE 143B,A00,886913,Bewley; Thomas R,14,0,40,26
1745142267760,MAE 148,A01,886915,Silberman; Jack,5,0,14,9
1745142268791,MAE 160,A00,886916,Evdokimenko; Ekaterina,41,0,60,19
1745142269816,MATH 3C,A01,889681,Staff,2,0,30,28
1745142270844,MATH 10A,A01,889760,Staff,28,0,30,2
1745142270844,MATH 10A,A02,889783,Staff,30,0,30,0
1745142271874,MATH 10B,A01,889785,Verstraete; Jacques Allan,0,2,30,30
1745142271874,MATH 10B,A02,889795,Verstraete; Jacques Allan,0,2,30,30
1745142271874,MATH 10B,B01,889797,Verstraete; Jacques Allan,0,0,30,30
1745142271874,MATH 10B,B02,889828,Verstraete; Jacques Allan,23,0,30,7
1745142272912,MATH 10C,A01,889849,Habib; Yousaf,18,0,30,12
1745142272912,MATH 10C,A02,889852,Habib; Yousaf,20,0,30,10
1745142272912,MATH 10C,A03,889853,Habib; Yousaf,25,0,30,5
1745142272912,MATH 10C,A04,889858,Habib; Yousaf,21,0,30,9
1745142272912,MATH 10C,B01,889861,Staff,12,0,30,18
1745142272912,MATH 10C,B02,889862,Staff,26,0,30,4
1745142272912,MATH 10C,B03,889863,Staff,28,0,30,2
1745142272912,MATH 10C,B04,889967,Staff,25,0,30,5
1745142273940,MATH 18,A01,889974,Staff,15,0,30,15
1745142273940,MATH 18,A02,889977,Staff,25,0,30,5
1745142273940,MATH 18,B01,889984,Hardiman; Liam,26,0,30,4
1745142273940,MATH 18,B02,889985,Hardiman; Liam,28,0,30,2
1745142274966,MATH 20A,A01,889990,Suk; Andrew Hoon,31,0,35,4
1745142275999,MATH 20B,A01,889993,Ohm; Ko Woon,21,0,30,9
1745142275999,MATH 20B,A02,889994,Ohm; Ko Woon,30,0,30,0
1745142275999,MATH 20B,B01,889996,Ohm; Ko Woon,25,0,30,5
1745142275999,MATH 20B,B02,889997,Ohm; Ko Woon,24,0,30,6
1745142277040,MATH 20C,A01,889999,Hammock; Frances H,22,0,30,8
1745142277040,MATH 20C,A02,890003,Hammock; Frances H,23,0,30,7
1745142277040,MATH 20C,B01,890006,Hammock; Frances H,11,0,30,19
1745142277040,MATH 20C,B02,890007,Hammock; Frances H,18,0,30,12
1745142278070,MATH 20D,A01,890011,Cheng; Hsiao-Bing,6,0,30,24
1745142278070,MATH 20D,A02,890012,Cheng; Hsiao-Bing,27,0,30,3
1745142278070,MATH 20D,B01,890016,Cheng; Hsiao-Bing,19,0,30,11
1745142278070,MATH 20D,B02,890017,Cheng; Hsiao-Bing,15,0,30,15
1745142279098,MATH 20E,A01,890026,Harel; Guershon,10,0,30,20
1745142279098,MATH 20E,A02,890029,Harel; Guershon,24,0,30,6
1745142279098,MATH 20E,B01,890033,Harel; Guershon,14,0,30,16
1745142279098,MATH 20E,B02,890101,Harel; Guershon,27,0,30,3
1745142280124,MATH 102,A01,890104,Staff,20,0,30,10
1745142280124,MATH 102,A02,890105,Staff,30,0,30,0
1745142281161,MATH 103B,A01,890116,Salehi Golsefidy; Alireza,8,0,30,22
1745142281161,MATH 103B,B01,890118,Staff,0,4,30,30
1745142282190,MATH 109,A01,890121,Aliabadi Sr.; Mohsen,6,0,30,24
1745142282190,MATH 109,B01,890124,Upadrashta; Pranav Kumar,23,0,30,7
1745142283217,MATH 120A,A01,890126,Eggers; John Dietrich,15,0,30,15
1745142284243,MATH 142B,A01,890128,Ioana; Adrian,17,0,30,13
1745142284243,MATH 142B,A02,890129,Ioana; Adrian,15,0,30,15
1745142285276,MATH 154,A01,890174,Staff,0,1,30,30
1745142285276,MATH 154,A02,890182,Staff,15,0,30,15
1745142286303,MATH 168A,A01,890197,Dumitriu; Ioana,22,0,35,13
1745142287328,MATH 170A,A01,890240,Nie; Jiawang,5,0,30,25
1745142287328,MATH 170A,A02,890241,Nie; Jiawang,18,0,30,12
1745142287328,MATH 170A,A03,890249,Nie; Jiawang,23,0,30,7
1745142288359,MATH 170B,A01,957891,Nag; Panchali,25,0,35,10
1745142290413,MATH 181A,A01,908025,Staff,0,8,35,35
1745142291440,MATH 193B,A01,890265,Staff,3,0,35,32
1745142292473,MGT 4,A01,890311,Anderson; John Charles,57,0,88,31
1745142293503,MGT 5,A00,907740,Staff,41,0,98,57
1745142294536,MGT 12,A00,890312,Lindenberger; Wade Douglas,70,0,98,28
1745142295562,MGT 16,A00,957883,Staff,84,0,98,14
1745142297616,MGT 45,A00,890314,Pecore; Joseph P.,57,0,98,41
1745142298641,MGT 71,A00,890315,Staff,6,0,98,92
1745142299668,MGT 100,A00,890316,Yavorsky; Daniel Ryan,59,0,98,39
1745142300696,MGT 103,A00,890317,Ehrich; Kristine R,77,0,98,21
1745142301722,MGT 105,A00,890356,Bates; Kenneth Walter,19,0,98,79
1745142302748,MGT 112,A00,890360,Ehrich; Kristine R,65,0,98,33
1745142303781,MGT 127R,A00,907732,Zhu; Kevin Xiaoguo,32,0,98,66
1745142304808,MGT 131B,A00,890361,Anderson; John Charles,75,0,98,23
1745142305838,MGT 137,A00,890362,Lindenberger; Wade Douglas,68,0,98,30
1745142306870,MGT 160,A00,890369,Johnson; Erik Barry,36,0,98,62
1745142308922,MGT 164,A00,890372,Zimmermann; Carsten,0,29,98,98
1745142309948,MGT 180,A00,890374,Bliss; Barbara Ann,31,0,98,67
1745142310983,MMW 15,A01,886414,Chang; Edmond Yi-Teh,0,10,28,28
1745142310983,MMW 15,A02,886415,Chang; Edmond Yi-Teh,0,10,28,28
1745142310983,MMW 15,A03,886416,Chang; Edmond Yi-Teh,0,8,28,28
1745142310983,MMW 15,A04,886417,Chang; Edmond Yi-Teh,0,8,28,28
1745142310983,MMW 15,B01,886419,Chang; Edmond Yi-Teh,0,8,28,28
1745142310983,MMW 15,B02,886420,Chang; Edmond Yi-Teh,0,9,28,28
1745142310983,MMW 15,B03,886421,Chang; Edmond Yi-Teh,0,9,28,28
1745142310983,MMW 15,B04,886422,Chang; Edmond Yi-Teh,0,9,28,28
1745142310983,MMW 15,C01,886424,Staff,0,10,28,28
1745142310983,MMW 15,C02,886425,Staff,0,10,28,28
1745142310983,MMW 15,C03,886426,Staff,0,9,28,28
1745142310983,MMW 15,C04,886427,Staff,0,9,28,28
1745142312009,MMW 15GS,A00,906910,Patterson; Patrick H.,5,0,28,23
1745142313036,MMW 122R,A01,886429,Rahimi; Babak,0,23,28,28
1745142313036,MMW 122R,A02,886430,Rahimi; Babak,0,23,28,28
1745142314067,MUS 1A,A01,890937,Staff,7,0,25,18
1745142314067,MUS 1A,A02,891035,Staff,15,0,25,10
1745142314067,MUS 1A,B00,907849,Staff,48,0,50,2
1745142314067,MUS 1A,B01,907850,Staff,25,0,25,0
1745142314067,MUS 1A,B02,907851,Staff,25,0,25,0
1745142316119,MUS 2AK,A00,957092,Ohnishi; Takae,15,0,15,0
1745142317152,MUS 4,A01,891044,Staff,6,0,25,19
1745142317152,MUS 4,A02,891045,Staff,24,0,25,1
1745142317152,MUS 4,B01,891048,Staff,20,0,25,5
1745142317152,MUS 4,B02,891050,Staff,25,0,25,0
1745142318182,MUS 5,A01,957506,Dubnov; Shlomo,4,0,25,21
1745142318182,MUS 5,A02,957622,Dubnov; Shlomo,21,0,25,4
1745142318182,MUS 5,A03,957623,Dubnov; Shlomo,23,0,25,2
1745142319210,MUS 6,A01,891053,Freitas Caetano; Marcelo,23,0,25,2
1745142319210,MUS 6,A02,891054,Freitas Caetano; Marcelo,23,0,25,2
1745142320242,MUS 7,A01,891081,Staff,0,0,25,25
1745142320242,MUS 7,A02,891082,Staff,15,0,25,10
1745142321292,MUS 8GS,A00,891118,Borgo; David Garcia,5,0,25,20
1745142322322,MUS 11,A01,891140,Staff,12,0,25,13
1745142322322,MUS 11,A02,891141,Staff,24,0,25,1
1745142323351,MUS 13,A01,891143,Staff,10,0,25,15
1745142323351,MUS 13,A02,891144,Staff,25,0,25,0
1745142324383,MUS 15,A01,891146,Staff,7,0,25,18
1745142324383,MUS 15,A02,891148,Staff,22,0,25,3
1745142324383,MUS 15,B01,891150,Staff,18,0,25,7
1745142324383,MUS 15,B02,891151,Staff,25,0,25,0
1745142325412,MUS 20,A01,891153,Staff,9,0,20,11
1745142325412,MUS 20,A02,891155,Staff,16,0,20,4
1745142326438,MUS 80,A00,891156,Staff,19,0,25,6
1745142326438,MUS 80,B00,891157,Staff,24,0,25,1
1745142327465,MUS 130,A00,891158,Ohnishi; Takae,35,0,35,0
1745142328491,MUS 150GS,A01,891160,Borgo; David Garcia,5,0,25,20
1745142329522,MUS 170,A01,891162,Freitas Caetano; Marcelo,21,0,25,4
1745142329522,MUS 170,A02,891164,Freitas Caetano; Marcelo,22,0,25,3
1745142330564,NANO 11,A00,886220,Vazquez Mena; Oscar,12,0,15,3
1745142331592,NANO 15,A01,886222,Drews; Aaron,9,0,10,1
1745142332619,NANO 104,A00,886224,Sirbuly; Donald,18,0,25,7
1745142333647,PH 40,A00,886528,Staff,29,0,40,11
1745142334675,PH 45,A01,886799,Staff,36,0,40,4
1745142335702,PH 110,A00,886802,Staff,7,0,40,33
1745142336730,PH 172,A00,906716,Staff,20,0,35,15
1745142337756,PH 191,A00,886803,Staff,23,0,40,17
1745142338785,PHIL 1,A00,889500,Staff,22,0,30,8
1745142339824,PHIL 10,A01,889549,Grush; Rick Scott,17,0,22,5
1745142339824,PHIL 10,A02,889551,Grush; Rick Scott,20,0,22,2
1745142340854,PHIL 28,A01,889559,Lamey; Andy M.,0,4,25,25
1745142340854,PHIL 28,A02,889561,Lamey; Andy M.,0,0,25,25
1745142340854,PHIL 28,A03,889572,Lamey; Andy M.,7,0,25,18
1745142341882,PHIL 35,A00,907839,Staff,32,0,33,1
1745142342909,PHIL 60,A00,889574,Staff,79,0,90,11
1745142343937,PHIL 105,A00,889579,Staff,0,1,0,0
1745142344964,PHIL 136,A00,889582,Fulkerson; Matthew Todd,27,0,45,18
1745142346000,PHIL 163,A01,889601,Staff,24,0,30,6
1745142346000,PHIL 163,B01,889606,Brandt; Reuven A,0,2,0,0
1745142347033,PHIL 164,A00,889610,Staff,20,0,30,10
1745142348062,PHIL 165,A00,889613,Staff,26,0,30,4
1745142349094,PHYS 1A,A00,886431,Staff,38,0,70,32
1745142350123,PHYS 1AL,001,886432,Tsai; Philbert S,0,0,30,30
1745142350123,PHYS 1AL,002,886436,Tsai; Philbert S,19,0,30,11
1745142351149,PHYS 1B,A00,886439,Staff,192,0,240,48
1745142352178,PHYS 1BL,001,886441,Tsai; Philbert S,0,1,30,30
1745142352178,PHYS 1BL,002,886444,Tsai; Philbert S,14,0,30,16
1745142353208,PHYS 1C,A00,896092,Arnold; Kam S,87,0,146,59
1745142354242,PHYS 1CL,001,886448,Tsai; Philbert S,0,4,30,30
1745142354242,PHYS 1CL,002,886449,Tsai; Philbert S,6,0,30,24
1745142354242,PHYS 1CL,003,886450,Tsai; Philbert S,22,0,30,8
1745142354242,PHYS 1CL,004,886451,Tsai; Philbert S,16,0,30,14
1745142355270,PHYS 2B,A01,886457,Staff,86,0,115,29
1745142356298,PHYS 2C,A01,886460,Shotwell; Brian,0,0,65,65
1745142357328,PHYS 2CL,A01,886467,Staff,0,3,28,28
1745142357328,PHYS 2CL,A02,886468,Staff,5,0,28,23
1745142358356,PHYS 2D,A01,886470,Staff,17,0,50,33
1745142369274,PHYS 4B,A01,886475,Grinstein; Benjamin,88,0,100,12
1745142370302,POLI 5,A00,891173,Desposato; Scott,17,0,25,8
1745142371328,POLI 5D,A01,891175,Staff,5,0,5,0
1745142371328,POLI 5D,B01,891178,Staff,5,0,5,0
1745142372359,POLI 11,A00,891179,Ferree; Karen E,3,0,25,22
1745142373389,POLI 12,A00,891180,Staff,21,0,30,9
1745142374419,POLI 27,A01,891182,Staff,29,0,75,46
1745142375445,POLI 30,A00,891183,Staff,0,3,30,30
1745142376474,POLI 100B,A00,891244,Staff,0,8,20,20
1745142377504,POLI 100I,A00,891247,Staff,19,0,30,11
1745142378532,POLI 104J,A00,891248,Nichter; Maysa,18,0,30,12
1745142379558,POLI 104U,A00,891250,Nichter; Maysa,9,0,30,21
1745142380585,POLI 108,A00,891253,Staff,0,0,0,4
1745142381612,POLI 110B,A00,891255,Wiens; David,22,0,25,3
1745142382644,POLI 112A,A00,891256,Wiens; David,15,0,25,10
1745142383670,POLI 114BR,A00,891261,Staff,22,0,30,8
1745142384697,POLI 117R,A00,891262,Forman; Fonna,12,0,50,38
1745142385728,POLI 118,A00,891264,Ingham; Sean,22,0,25,3
1745142386754,POLI 124A,A00,891265,Staff,19,0,20,1
1745142387785,POLI 125D,A00,891266,Nichter; Simeon C,9,0,25,16
1745142388815,POLI 126,A00,891268,Nichter; Simeon C,11,0,25,14
1745142389844,POLI 126AA,A00,891272,Staff,19,0,25,6
1745142390870,POLI 130AA,A00,891273,Staff,17,0,20,3
1745142391895,POLI 134AA,A00,891274,Staff,12,0,20,8
1745142393943,POLI 138,A00,891278,Staff,22,0,25,3
1745142394970,POLI 142K,A00,891280,Staff,17,0,25,8
1745142395996,POLI 142M,A00,891281,Gartzke; Erik,22,0,30,8
1745142397024,POLI 142P,A00,891284,Staff,21,0,30,9
1745142398053,POLI 143,A00,891285,Gartzke; Erik,17,0,30,13
1745142399084,POLI 153,A00,891286,Staff,20,0,20,0
1745142400109,POLI 170A,A00,891288,Staff,19,0,25,6
1745142401135,POLI 175,A00,891290,Staff,18,0,20,2
1745142402164,PSYC 1,A00,890674,Steiner; Eric Tomas,0,4,45,45
1745142403197,PSYC 2,A00,890676,Albright; Thomas D,25,0,35,10
1745142404226,PSYC 3,A00,890679,Staff,18,0,20,2
1745142405254,PSYC 60,A01,890684,Rickard; Timothy C.,7,0,45,38
1745142406280,PSYC 70,A01,890689,Geller; Emma Harlan,14,0,30,16
1745142407312,PSYC 100,A00,890690,Lacefield; Katharine I,0,43,180,180
1745142408337,PSYC 102,A00,890695,Staff,25,0,40,15
1745142409363,PSYC 105,A00,890699,Geller; Emma Harlan,78,0,100,22
1745142410389,PSYC 106,A00,890701,Gorman; Michael R.,15,0,30,15
1745142411415,PSYC 108,A00,890704,Adrian; Julia Anna,0,23,50,50
1745142412444,PSYC 118,A01,890712,Staff,18,0,30,12
1745142413476,PSYC 124,A00,890716,Chapman; Eddie Nathaniel,36,0,60,24
1745142414502,PSYC 131,A00,890717,Anagnostaras; Stephan,6,0,80,74
1745142415529,PSYC 137,A00,890719,Winkielman; Piotr,0,2,30,30
1745142416555,PSYC 144,A00,890721,Adrian; Julia Anna,0,3,45,45
1745142417587,PSYC 162,A00,890805,Staff,21,0,75,54
1745142418618,PSYC 169,A00,890810,Staff,0,15,30,30
1745142419644,PSYC 172,A00,890814,Gorman; Michael R.,14,0,30,16
1745142420671,PSYC 181,A00,890818,Anagnostaras; Stephan,63,0,200,137
1745142421697,PSYC 189,A00,890823,Staff,11,0,30,19
1745142422724,PSYC 191,A00,890884,Rickard; Timothy C.,0,11,35,35
1745142423752,PSYC 193,A00,890913,Staff,22,0,30,8
1745142423752,PSYC 193,B00,890914,Chapman; Eddie Nathaniel,25,0,30,5
1745142424787,PSYC 193L,A01,890918,Lowe; Angela Beth,29,0,30,1
1745142424787,PSYC 193L,B01,890921,Hurwitz; Ethan Scott,28,0,30,2
1745142424787,PSYC 193L,C01,890928,Staff,30,0,30,0
1745142425817,RELI 149,A00,886806,Rahimi; Babak,23,0,40,17
1745142426844,SE 9,A01,886814,Staff,13,0,20,7
1745142427872,SE 101B,A01,886816,Chadha; Mayank,8,0,30,22
1745142428907,SE 110B,A00,886818,Zhu; Qiang,0,16,45,45
1745142429932,SE 125,A01,886830,Staff,10,0,30,20
1745142430957,SE 130B,A01,886835,Staff,19,0,40,21
1745142431989,SE 131A,A01,886838,Krysl; Petr,37,0,55,18
1745142433016,SE 154,A00,886840,Staff,35,0,50,15
1745142434043,SE 164GS,A01,886849,Staff,13,0,20,7
1745142435070,SE 167GS,A01,886853,Staff,13,0,20,7
1745142436107,SIO 25,A01,890107,Staff,23,0,30,7
1745142437134,SIO 45,A00,890109,Cook; Geoffrey W,137,0,200,63
1745142438161,SIO 109R,A00,890110,Forman; Fonna,0,11,20,20
1745142439191,SIO 187,A01,890114,Kacev; David,21,0,40,19
1745142440221,SOCI 1,A01,890431,Thorpe; Charles Robert,21,0,30,9
1745142440221,SOCI 1,A02,890518,Thorpe; Charles Robert,30,0,30,0
1745142441248,SOCI 2,A01,957978,Staff,0,0,0,0
1745142441248,SOCI 2,A02,957979,Staff,0,3,0,0
1745142442274,SOCI 20,A01,890523,Calderon-Zaks; Michael Aar,24,0,30,6
1745142442274,SOCI 20,A02,890526,Calderon-Zaks; Michael Aar,29,0,30,1
1745142443304,SOCI 30,A01,890533,Pardo Guerra; Juan Pablo,37,0,40,3
1745142444330,SOCI 40,A01,890535,Staff,32,0,45,13
1745142445357,SOCI 104Q,A00,890559,Staff,20,0,30,10
1745142446384,SOCI 106,A00,890560,Arnal; Maud Marie Leonie,22,0,30,8
1745142447411,SOCI 110,A00,890567,Holkenbrink-Monk; Charlene,22,0,30,8
1745142448437,SOCI 112,A00,890568,Victoria Torres; Pablo,0,0,45,45
1745142449466,SOCI 115,A00,890597,Arnal; Maud Marie Leonie,33,0,45,12
1745142451519,SOCI 121,A00,890604,Pardo Guerra; Juan Pablo,40,0,45,5
1745142452544,SOCI 126,A01,890608,Staff,8,0,10,2
1745142453572,SOCI 127,A00,890609,Staff,23,0,30,7
1745142454599,SOCI 131,A00,890610,Thorpe; Charles Robert,38,0,45,7
1745142455624,SOCI 135,A00,890615,Payne; Christine Anna,20,0,45,25
1745142456655,SOCI 139,A00,890620,Staff,43,0,45,2
1745142457680,SOCI 148E,A00,890622,Calderon-Zaks; Michael Aar,39,0,45,6
1745142458712,SOCI 150,A00,890623,Kohler; Kristopher M.,36,0,45,9
1745142459739,SOCI 157,A00,890625,Jules-Rosette; Bennetta W.,18,0,20,2
1745142460769,SOCI 160,A00,890627,Payne; Christine Anna,26,0,45,19
1745142461800,SYN 1,A00,886855,Fish; Gwendolyn Anne,0,0,0,0
1745142461800,SYN 1,B00,906086,Fish; Gwendolyn Anne,0,0,0,2
1745142462836,SYN 2R,A00,886860,Staff,0,15,15,15
1745142462836,SYN 2R,B00,906106,Atkinson; Arthur Laird,0,14,15,15
1745142463868,SYN 100,A01,886866,Browne; Emily,0,29,20,20
1745142463868,SYN 100,B01,906128,Rock; Martin,0,4,20,20
1745142463868,SYN 100,C01,906140,Deavenport; James Cary,0,2,20,20
1745142463868,SYN 100,D01,907816,Deavenport; James Cary,0,3,20,20
1745142464896,TDAC 1,A00,890286,Walsh; Kim C.,11,0,20,9
1745142465925,TDAC 101,A00,890296,Basso; Beatrice,18,0,20,2
1745142466951,TDDE 131,A00,890297,Staff,47,0,50,3
1745142467979,TDDM 1,A00,890287,Weinberg; Sadie,26,0,30,4
1745142469011,TDGE 11,A00,890288,Fulton; Julia,155,0,200,45
1745142469011,TDGE 11,B00,890289,Castro; Robert Jess,188,0,200,12
1745142470037,TDGE 25,B00,957359,Walsh; Kim C.,9,0,20,11
1745142471062,TDGE 40,A01,890292,Power; Jade Yukana,28,0,30,2
1745142472095,TDGE 124,A00,890298,Havis; Allan,12,0,50,38
1745142473123,TDGE 131R,A00,890299,Burelle; Julie Sara Veronique,20,0,42,22
1745142474153,TDHT 101,A00,890300,Staff,12,0,20,8
1745142475184,TDHT 109,A01,890302,Anderson; Mysia Anyse,31,0,40,9
1745142476215,TDMV 1,A00,890293,Arcidiacono; Kristin,20,0,30,10
1745142477242,TDMV 2,A00,890294,Weinberg; Sadie,26,0,30,4
1745142478267,TDMV 3,A00,957878,Arcidiacono; Kristin,27,0,30,3
1745142480329,TDMV 138,A00,890304,Jun; Grace Shin Hae,25,0,40,15
1745142481359,TDMV 140,A00,890305,Corrales; Joseph Bernales,28,0,30,2
1745142482401,TDMV 142,A00,890307,Caligagan; Tony,30,0,40,10
1745142483427,TDMV 144,A00,890308,Camaya; Michelle Ann,26,0,30,4
1745142484457,TDPW 1,A00,890295,Stein; Deborah Isobel,5,0,20,15
1745142485489,USP 2,A01,890272,Lerner; Amy M,8,0,20,12
1745142486515,USP 3,A01,890274,Staff,21,0,30,9
1745142487548,USP 15,A01,890276,Sun; Feiyang,21,0,30,9
1745142488581,USP 25,A00,890277,Shenkman; Michael Thomas,21,0,25,4
1745142489609,USP 138,A00,890278,Staff,15,0,25,10
1745142490636,USP 143,A00,890279,Staff,30,0,70,40
1745142491662,USP 144,A00,890280,Chowdhury; Muhammed Zohir,19,0,30,11
1745142492688,USP 150,A00,890281,Boomhower; Matthew Charles,19,0,30,11
1745142493715,USP 151,A00,890282,Staff,17,0,20,3
1745142494743,USP 162,A00,890283,Andrews; Abigail Leslie,17,0,20,3
1745142495770,USP 168,A00,920477,Kwak; Nancy,2,0,5,3
1745142496799,USP 181,A00,890284,Staff,11,0,20,9
1745142497825,USP 191A,A00,890285,Staff,15,0,20,5
1745142498856,VIS 101,A00,886512,Staff,37,0,75,38
1745142499885,VIS 103,A00,886513,Cruz; Edwin Teddy,65,0,75,10
1745142500913,VIS 108,A00,886514,Staff,7,0,15,8
1745142501943,VIS 127P,A00,886515,Shen; Kuiyi,92,0,146,54
1745142502975,VIS 149,A00,886516,Yoldas; Pinar,1,0,15,14
1745142504002,VIS 164,A00,886526,Erdmann; Dean,21,0,22,1
1745142505027,VIS 194S,A00,886527,Staff,61,0,75,14
1745142506055,WCWP 10A,C00,886484,Staff,13,0,15,2
1745142507084,WCWP 10B,A00,886490,Staff,5,0,15,10
1745142507084,WCWP 10B,B00,886491,Staff,0,1,0,0
1745142507084,WCWP 10B,C00,886492,Staff,10,0,15,5
1745142508117,WCWP 100,A00,886494,Staff,0,2,15,15
1745142510267,AAS 10,A01,886199,Childs; Dennis R.,0,2,0,0
1745142511295,ANAR 104,A01,886940,Shtienberg; Gilad,27,0,30,3
1745142512325,ANAR 120,A00,886953,Staff,13,0,20,7
1745142513357,ANBI 148,A01,886955,Wilder; Linnea Lorene,32,0,40,8
1745142515412,ANSC 122,A00,886957,Staff,28,0,30,2
1745142516439,ANSC 150,A00,886958,Sloane; Julia Kathryn,6,0,15,9
1745142517467,ANSC 156,A00,886959,Jenkins; Janis A.,2,0,15,13
1745142518494,ANSC 180,A00,886960,Staff,12,0,17,5
1745142519521,ANSC 188,A00,886961,Jassal; Aftab,10,0,25,15
1745142520546,ANSC 190,A00,886962,Jassal; Aftab,14,0,25,11
1745142521576,ANSC 191,A00,886963,Staff,18,0,20,2
1745142522607,ANTH 3,A01,891689,Staff,19,0,20,1
1745142523637,ANTH 5,A00,886933,Semendeferi; Ekaterini,18,0,20,2
1745142524662,ANTH 10,A00,886934,Staff,0,8,30,30
1745142525688,ANTH 21,A01,886936,Staff,44,0,60,16
1745142526717,ANTH 23,A01,886938,Staff,94,0,100,6
1745142527744,ANTH 105,A00,886964,Stewart; Alexander B,94,0,100,6
1745142528770,ANTH 108,A00,886965,Pedersen; David,10,0,20,10
1745142529809,AWP 10,001,886147,Staff,0,0,0,0
1745142529809,AWP 10,002,886148,Staff,0,0,0,0
1745142529809,AWP 10,003,886149,Staff,0,0,0,0
1745142529809,AWP 10,004,886150,Staff,0,0,0,0
1745142529809,AWP 10,005,886151,Staff,0,0,0,0
1745142529809,AWP 10,006,886152,Staff,0,0,0,0
1745142529809,AWP 10,007,886153,Staff,0,0,0,0
1745142529809,AWP 10,008,886154,Staff,0,0,0,0
1745142529809,AWP 10,009,886155,Staff,0,0,0,0
1745142529809,AWP 10,010,886156,Staff,0,0,0,0
1745142529809,AWP 10,011,886158,Staff,0,0,0,0
1745142529809,AWP 10,012,886160,Staff,0,0,0,0
1745142529809,AWP 10,013,886161,Staff,0,0,0,0
1745142529809,AWP 10,014,886162,Staff,0,0,0,0
1745142529809,AWP 10,015,886163,Staff,0,0,0,0
1745142529809,AWP 10,016,886164,Staff,0,0,0,0
1745142529809,AWP 10,017,886165,Staff,0,0,0,0
1745142529809,AWP 10,018,886166,Staff,0,0,0,0
1745142529809,AWP 10,019,886168,Staff,0,0,0,0
1745142529809,AWP 10,020,886170,Staff,0,0,0,0
1745142529809,AWP 10,021,886172,Staff,0,0,0,0
1745142530842,AWP 10R,001,886173,Staff,0,0,0,0
1745142530842,AWP 10R,002,886174,Staff,0,1,0,0
1745142530842,AWP 10R,003,886175,Staff,0,0,0,0
1745142530842,AWP 10R,004,886176,Staff,0,0,0,0
1745142530842,AWP 10R,005,886177,Staff,0,0,0,0
1745142530842,AWP 10R,006,886178,Staff,0,0,0,0
1745142530842,AWP 10R,007,886179,Staff,0,0,0,0
1745142530842,AWP 10R,008,886181,Staff,0,0,0,0
1745142530842,AWP 10R,009,886182,Staff,0,0,0,0
1745142530842,AWP 10R,010,886183,Staff,0,0,0,0
1745142530842,AWP 10R,011,886184,Staff,0,0,0,0
1745142530842,AWP 10R,012,886185,Staff,0,0,0,0
1745142530842,AWP 10R,013,886186,Staff,0,0,0,0
1745142530842,AWP 10R,014,886187,Staff,0,0,0,0
1745142530842,AWP 10R,015,886188,Staff,0,0,0,0
1745142530842,AWP 10R,016,886189,Staff,0,0,0,0
1745142531868,AWP 102R,A00,886190,Staff,0,0,0,0
1745142531868,AWP 102R,B00,886191,Staff,0,0,0,0
1745142532896,BENG 100,A01,886193,Staff,19,0,30,11
1745142533923,BENG 122A,A01,886195,Hasty; Jeff M,20,0,30,10
1745142534957,BENG 166A,A00,886196,Sah; Robert Lie-Yuan,0,3,20,20
1745142535985,BIBC 102,A01,894320,Staff,0,2,46,46
1745142535985,BIBC 102,A02,894321,Staff,0,0,46,46
1745142535985,BIBC 102,A03,894344,Staff,21,0,46,25
1745142535985,BIBC 102,A04,894345,Staff,30,0,47,17
1745142537018,BICD 100R,A01,894365,Smith; Laurie,1,3,58,57
1745142537018,BICD 100R,A02,894366,Smith; Laurie,0,1,58,58
1745142537018,BICD 100R,A03,894367,Smith; Laurie,13,0,59,46
1745142538047,BICD 136,A01,894383,Gustafson-Brown; Cindy,16,0,50,34
1745142539078,BIEB 102,A01,894494,Butler; Shannon Rhey,67,0,130,63
1745142541166,BIEB 150,A01,894617,Wills; Christopher,0,3,13,13
1745142541166,BIEB 150,A02,894631,Wills; Christopher,0,3,13,13
1745142541166,BIEB 150,A03,894937,Wills; Christopher,0,3,13,13
1745142541166,BIEB 150,A04,894946,Wills; Christopher,0,1,11,11
1745142542193,BIEB 194,A00,906141,Kurle; Carolyn M.,14,0,20,6
1745142543220,BILD 1,A01,894154,Staff,8,0,19,11
1745142543220,BILD 1,A02,894155,Staff,15,0,19,4
1745142543220,BILD 1,A03,894160,Staff,18,0,19,1
1745142543220,BILD 1,A04,894161,Staff,16,0,18,2
1745142544251,BILD 2,A01,894168,Staff,0,0,50,50
1745142544251,BILD 2,A02,894169,Staff,0,0,50,50
1745142544251,BILD 2,A03,894179,Staff,27,0,50,23
1745142544251,BILD 2,A04,894203,Staff,42,0,50,8
1745142545277,BILD 3,A01,894213,Staff,24,0,31,7
1745142545277,BILD 3,A02,894214,Staff,28,0,31,3
1745142545277,BILD 3,A03,894235,Staff,30,0,31,1
1745142545277,BILD 3,A04,894236,Staff,29,0,32,3
1745142546309,BILD 4,A01,894253,Reuther; Keefe,12,0,24,12
1745142546309,BILD 4,A02,894258,Reuther; Keefe,19,0,24,5
1745142547339,BILD 5,A01,894276,Reuther; Keefe,40,0,50,10
1745142547339,BILD 5,A02,894277,Reuther; Keefe,48,0,50,2
1745142547339,BILD 5,A03,894290,Reuther; Keefe,47,0,50,3
1745142547339,BILD 5,A04,894291,Reuther; Keefe,50,0,50,0
1745142548374,BILD 24,A01,894297,Pirino; Giorgia,45,0,60,15
1745142549409,BIMM 100,A01,895012,Staff,0,14,0,1
1745142549409,BIMM 100,A02,895013,Staff,0,6,0,2
1745142549409,BIMM 100,A03,895014,Staff,0,7,0,0
1745142549409,BIMM 100,A04,895015,Staff,0,4,0,0
1745142550453,BIMM 101,A01,895017,McDonnell; Lisa Marie,0,2,24,24
1745142550453,BIMM 101,A02,895018,McDonnell; Lisa Marie,0,1,24,24
1745142550453,BIMM 101,B01,895020,McDonnell; Lisa Marie,0,3,24,24
1745142550453,BIMM 101,B02,895021,McDonnell; Lisa Marie,0,2,24,24
1745142551486,BIMM 110,A01,895023,Staff,7,0,25,18
1745142551486,BIMM 110,A02,895024,Staff,11,0,25,14
1745142551486,BIMM 110,A03,895025,Staff,22,0,25,3
1745142551486,BIMM 110,A04,895031,Staff,21,0,25,4
1745142552514,BIMM 120,A01,895114,Gustafson-Brown; Cindy,8,0,28,20
1745142552514,BIMM 120,A02,895126,Gustafson-Brown; Cindy,19,0,27,8
1745142553540,BIPN 100,A01,895130,Yang; Mingyu,13,0,38,25
1745142553540,BIPN 100,A02,895131,Yang; Mingyu,33,0,38,5
1745142553540,BIPN 100,A03,895132,Yang; Mingyu,33,0,38,5
1745142553540,BIPN 100,A04,895133,Yang; Mingyu,30,0,36,6
1745142554566,BIPN 120,A01,895135,Cooke; James Edward,0,2,13,13
1745142554566,BIPN 120,A02,895136,Cooke; James Edward,0,1,13,13
1745142554566,BIPN 120,A03,895137,Cooke; James Edward,0,0,13,13
1745142554566,BIPN 120,A04,895156,Cooke; James Edward,3,0,11,8
1745142555596,BIPN 134,A01,895235,Cooke; James Edward,0,2,25,25
1745142555596,BIPN 134,A02,895237,Cooke; James Edward,0,0,25,25
1745142555596,BIPN 134,A03,895240,Cooke; James Edward,12,0,25,13
1745142555596,BIPN 134,A04,895270,Cooke; James Edward,24,0,25,1
1745142556625,BIPN 189,A00,892103,Staff,0,20,9,9
1745142558676,CAT 124,A01,922009,Staff,0,1,20,20
1745142559710,CAT 125R,A00,886390,Morales; Celeste Georgianna,4,0,20,16
1745142559710,CAT 125R,B00,886391,Irwin; Matthew Joseph,0,1,20,20
1745142559710,CAT 125R,C00,886392,Smith; Lauryn Alissa,11,0,20,9
1745142559710,CAT 125R,D00,886393,Vanderschuit; Maya Alysia,6,0,20,14
1745142559710,CAT 125R,E00,886394,Marchisotto; Jennifer Anne,0,2,20,20
1745142560737,CENG 15,A01,886218,Drews; Aaron,1,0,5,4
1745142561770,CENG 113,A00,886219,Opatkiewicz; Justin Paul,16,0,25,9
1745142562797,CGS 101,A00,887044,Staff,13,0,20,7
1745142563824,CGS 105,A01,887046,Staff,16,0,25,9
1745142564853,CGS 112,A00,887047,Cuong; Marisol,12,0,15,3
1745142565883,CGS 113,A00,887048,Staff,24,0,30,6
1745142566908,CGS 120,A00,887049,Staff,12,0,17,5
1745142567938,CHEM 6A,A01,886336,Lam; Tin Yiu,44,0,50,6
1745142567938,CHEM 6A,A02,886338,Lam; Tin Yiu,43,0,50,7
1745142568972,CHEM 6B,A01,886341,Hopkins; Patrycja Anna,21,0,50,29
1745142568972,CHEM 6B,A02,886343,Hopkins; Patrycja Anna,46,0,50,4
1745142570004,CHEM 6C,A01,886346,Albizati; Kim F.,0,1,50,50
1745142570004,CHEM 6C,A02,886348,Albizati; Kim F.,38,0,50,12
1745142571037,CHEM 40A,A01,886352,Klosterman; Jeremy K,70,0,100,30
1745142572064,CHEM 40B,A01,886356,Klosterman; Jeremy K,0,4,100,100
1745142573092,CHEM 41B,A01,886360,Theodorakis; Emmanuel,30,0,50,20
1745142573092,CHEM 41B,A02,886362,Theodorakis; Emmanuel,46,0,50,4
1745142574119,CHIN 165A,A00,886382,Xu; Li,19,0,20,1
1745142575146,CLAS 120,A00,886387,Myerston Santana; Jacobo,36,0,40,4
1745142576179,COGS 9,A01,886967,Shannon; Kyle Michael,49,0,60,11
1745142577209,COGS 11,A01,886969,Staff,18,0,30,12
1745142578236,COGS 14A,A01,886971,Staff,26,0,60,34
1745142579268,COGS 14B,A01,886973,Hoffman; Drew Ellen,18,0,60,42
1745142580296,COGS 18,A01,886975,Morgan; Eric,41,0,60,19
1745142581326,COGS 20,A01,886977,Staff,6,0,8,2
1745142581326,COGS 20,A02,886978,Staff,6,0,7,1
1745142582352,COGS 100,A01,907783,Staff,6,0,30,24
1745142583381,COGS 101B,A01,886980,Staff,0,10,30,30
1745142584413,COGS 101C,A01,886982,Delgado; Tania,0,6,30,30
1745142585441,COGS 102A,A01,886984,Johnson; Christine M.,13,0,30,17
1745142586467,COGS 118B,A01,886986,Staff,0,25,60,60
1745142587494,COGS 150,A01,886988,Bergen; Benjamin,16,0,30,14
1745142588521,COGS 153,A00,886989,Delgado; Tania,0,6,30,30
1745142589552,COGS 186,A01,886991,Staff,3,0,30,27
1745142590579,COGS 187A,A01,886993,Boyle; Mary E. T.,12,0,30,18
1745142591605,COGS 189,A00,886994,Staff,13,0,30,17
1745142592631,COMM 10,A01,886996,Staff,11,0,25,14
1745142592631,COMM 10,A02,886997,Staff,21,0,25,4
1745142593661,COMM 20,A01,886999,Leuning; Grant Maurstad,33,0,40,7
1745142595714,COMM 100A,A01,887002,Staff,0,0,25,25
1745142595714,COMM 100A,A02,887003,Staff,20,0,25,5
1745142596743,COMM 100B,A01,887005,Staff,0,1,25,25
1745142597771,COMM 106D,A00,887006,Staff,22,0,40,18
1745142598800,COMM 110G,A00,887007,Whitworth-Smith; Andrew C,17,0,40,23
1745142599828,COMM 111B,A00,887008,Staff,31,0,40,9
1745142600911,COMM 113T,A00,887009,Abuelhiga; Soraya Jill,30,0,40,10
1745142600911,COMM 113T,B00,906733,Staff,40,0,40,0
1745142601940,COMM 145,A00,887010,Staff,21,0,40,19
1745142602964,COMM 146,A00,887054,Staff,31,0,40,9
1745142603993,COMM 190,A00,887012,Staff,9,0,23,14
1745142605026,CSE 8A,A50,887015,Cao; Yingjun,68,0,85,17
1745142606051,CSE 11,A01,887017,Cao; Yingjun,35,0,70,35
1745142607083,CSE 20,A01,887019,Staff,35,0,50,15
1745142608121,CSE 21,A01,887021,Braun; Oliver,81,0,100,19
1745142608121,CSE 21,B01,892583,Staff,48,0,50,2
1745142609148,CSE 30,A01,887025,Eldon; John,161,0,200,39
1745142610178,CSE 100,A01,887027,Staff,28,0,50,22
1745142610178,CSE 100,A02,887028,Staff,43,0,50,7
1745142611203,CSE 101,A01,887030,Braun; Oliver,79,0,100,21
1745142611203,CSE 101,B01,887032,Jones; Miles E,0,1,50,50
1745142611203,CSE 101,B02,887033,Jones; Miles E,13,0,50,37
1745142612230,CSE 105,A01,908084,Jones; Miles E,36,0,50,14
1745142612230,CSE 105,A02,908087,Jones; Miles E,38,0,50,12
1745142613259,CSE 135,A01,887035,Powell; Thomas Allan,8,0,50,42
1745142614283,CSE 142,A01,887037,Staff,22,0,60,38
1745142615312,CSE 142L,A01,887039,Staff,42,0,60,18
1745142616341,CSE 151A,A01,887041,Solares; Edwin A,60,0,100,40
1745142617367,CSE 175,A01,887043,Kumar; Rakesh,30,0,30,0
1745142618403,CSS 1,A01,886389,Staff,12,0,40,28
1745142619436,DSC 30,A01,908097,Liao; Soohyun Nam,54,0,75,21
1745142620462,DSC 40A,A01,908099,Shannon; Kyle Michael,37,0,50,13
1745142621492,DSC 40B,A01,908112,Staff,28,0,50,22
1745142622520,DSC 80,A01,908116,Staff,32,0,60,28
1745142623551,DSC 197,001,956863,Eldridge; Justin Matthew,9999,0,9999,0
1745142624587,ECE 5,A01,886400,Morris; Karcher William,3,0,6,3
1745142624587,ECE 5,A02,886401,Morris; Karcher William,5,0,6,1
1745142625618,ECE 148,A01,886403,Silberman; Jack,0,8,14,14
1745142626645,ECON 1,A01,887265,Crane; Meredith Helen,25,0,70,45
1745142626645,ECON 1,B01,887268,Staff,44,0,50,6
1745142627672,ECON 2,A01,887273,Crane; Meredith Helen,61,0,70,9
1745142628699,ECON 3,A01,887279,Rondina; Giacomo,44,0,70,26
1745142629734,ECON 4,A01,887282,Anderson; John Charles,0,1,10,10
1745142630770,ECON 5,A01,887285,Staff,39,0,45,6
1745142630770,ECON 5,B01,887292,Staff,43,0,45,2
1745142631798,ECON 100A,A01,887337,Newhouse; Herbert S,58,0,70,12
1745142631798,ECON 100A,B01,887349,Staff,45,0,50,5
1745142632827,ECON 100B,A01,887361,Du; Songzi,42,0,70,28
1745142633852,ECON 100C,A01,887445,Newhouse; Herbert S,61,0,70,9
1745142634879,ECON 105,A00,887488,Vespa; Emanuel Ignacio,24,0,35,11
1745142635907,ECON 109,A01,887506,Staff,29,0,35,6
1745142636939,ECON 110A,A01,887568,Alon; Titan Michael,1,0,35,34
1745142636939,ECON 110A,B01,907601,Alon; Titan Michael,27,0,35,8
1745142637970,ECON 110B,A01,887598,Levkoff; Steven B.,0,7,70,70
1745142639001,ECON 112,A00,887599,Rondina; Giacomo,20,0,35,15
1745142640035,ECON 120A,A01,887603,Dai; Yinlin,46,0,70,24
1745142641069,ECON 120C,A01,887608,Sun; Yixiao,0,0,35,35
1745142641069,ECON 120C,B01,887614,Sun; Yixiao,13,0,35,22
1745142642095,ECON 138,A00,887621,Bharadwaj; Prashant,0,18,20,20
1745142643125,ECON 171,A01,907666,Staff,27,0,35,8
1745142644156,ECON 175,A00,887626,Wu; Pak Yeung,27,0,35,8
1745142645186,ECON 190,A00,887640,Vespa; Emanuel Ignacio,26,0,35,9
1745142646232,EDS 25,A01,888197,Staff,0,0,0,0
1745142646232,EDS 25,A02,888209,Staff,0,0,0,0
1745142646232,EDS 25,A03,888210,Staff,0,0,0,0
1745142646232,EDS 25,A04,888212,Staff,0,0,0,0
1745142646232,EDS 25,A05,888213,Staff,0,0,0,0
1745142646232,EDS 25,A06,888214,Staff,0,0,0,0
1745142646232,EDS 25,A07,888235,Staff,0,0,0,0
1745142646232,EDS 25,A08,888236,Staff,0,0,0,0
1745142646232,EDS 25,A09,888240,Staff,0,0,0,0
1745142646232,EDS 25,A10,888244,Staff,0,0,0,0
1745142646232,EDS 25,B01,888273,Staff,0,0,0,0
1745142646232,EDS 25,B02,888285,Staff,0,0,0,0
1745142646232,EDS 25,B03,888423,Staff,29,0,30,1
1745142646232,EDS 25,B04,888432,Staff,0,0,0,0
1745142646232,EDS 25,B05,888433,Staff,0,0,0,0
1745142646232,EDS 25,B06,888467,Staff,0,0,0,0
1745142646232,EDS 25,B07,888468,Staff,0,0,0,0
1745142646232,EDS 25,B08,888479,Staff,0,0,0,0
1745142646232,EDS 25,B09,888484,Staff,0,0,0,0
1745142646232,EDS 25,B10,888487,Staff,0,0,0,0
1745142647260,EDS 38,A01,907700,Choi; Bailey Miyeon,30,0,30,0
1745142648291,EDS 112,A01,888601,Chapman; Thandeka K,23,0,40,17
1745142649318,EDS 115,A00,888697,Mendez; Kathrina Mendoza,17,0,30,13
1745142650347,EDS 116,A01,888893,Staff,38,0,40,2
1745142652409,EDS 124AR,A00,889133,Staff,33,0,50,17
1745142652409,EDS 124AR,B00,907471,Simon; Elizabeth A,42,0,50,8
1745142653437,EDS 124BR,A00,889134,Staff,57,0,100,43
1745142654464,EDS 125,A00,889135,Staff,26,0,30,4
1745142655490,EDS 126,A01,889138,Staff,37,0,40,3
1745142656520,EDS 164R,A01,889142,Wishard Guerra; Alison G.,38,0,50,12
1745142657547,ENG 30,A01,886396,Staff,0,0,0,0
1745142657547,ENG 30,B01,886398,Staff,0,0,0,0
1745142658575,ENVR 102,A00,906150,Montejo; Carolina,23,0,25,2
1745142659600,ETHN 103A,A00,887236,Man; Simeon S,0,5,0,0
1745142660627,ETHN 113,A00,887239,Staff,20,0,30,10
1745142661656,ETHN 116,A00,887240,Staff,20,0,25,5
1745142662683,ETHN 117,A00,887241,Choi; Esther Min,27,0,30,3
1745142663712,ETHN 118,A00,887243,Staff,24,0,30,6
1745142664744,ETHN 127,A00,887248,Cuong; Marisol,12,0,15,3
1745142665770,ETHN 139,A00,887250,Staff,8,0,10,2
1745142666798,ETHN 142,A00,887252,Staff,18,0,30,12
1745142667824,ETHN 161,A00,887253,Browne; Errol Tsekani,28,0,30,2
1745142668851,ETHN 163FR,A00,887255,Burelle; Julie Sara Veronique,4,0,5,1
1745142669884,GLBH 20,A00,889149,Elwardani; Nile Regina,15,0,42,27
1745142671936,GLBH 111,A01,889152,Burgos; Jose L.,17,0,17,0
1745142672964,GLBH 150,A00,889181,Sloane; Julia Kathryn,0,1,15,15
1745142675021,HDS 60,A01,886406,Warstadt; Melissa Fawn,76,0,80,4
1745142676054,HIAF 111,A00,889324,Gyamfi; Bright,0,4,0,0
1745142677080,HIEA 131,A00,889328,Staff,14,0,32,18
1745142678107,HIEA 144,A00,889333,Henry; Todd A.,29,0,32,3
1745142679137,HIEA 154,A00,889336,Henry; Todd A.,28,0,32,4
1745142680164,HIEU 106,A00,889339,Staff,28,0,32,4
1745142682215,HIEU 114,A00,889340,Staff,18,0,32,14
1745142683246,HIEU 135GS,A00,889342,Patterson; Patrick H.,0,0,1,22
1745142684271,HIEU 137,A00,889343,Edington; Claire Ellen,12,0,25,13
1745142685296,HIEU 148,A00,889345,Staff,16,0,32,16
1745142686326,HIEU 154,A00,889346,Biess; Frank Peter,24,0,32,8
1745142687352,HILA 102,A00,889351,Staff,13,0,32,19
1745142688380,HILD 2A,A01,889221,Lewandoski; Julia Mavis,0,5,32,32
1745142689405,HILD 7B,A01,889225,Man; Simeon S,0,7,32,32
1745142690438,HILD 7C,A01,889288,Alvarez; Luis A,0,8,32,32
1745142691464,HILD 30,A01,889323,Staff,0,1,32,32
1745142693516,HISC 119,A00,889383,Golan; Tal,22,0,32,10
1745142694551,HIUS 103,A00,889384,Man; Simeon S,10,0,32,22
1745142695580,HIUS 117,A00,919797,Kwak; Nancy,23,0,32,9
1745142696609,HIUS 142A,A00,919788,Staff,24,0,32,8
1745142698665,HIUS 149,A00,889386,Gyamfi; Bright,0,1,0,0
1745142699695,HIUS 155,A00,889387,Alvarez; Luis A,19,0,32,13
1745142700721,HUM 3,A01,886499,Caldwell; Michael Alan,24,0,50,26
1745142701769,HUM 3GS,A00,886500,Rodriguez; Bretton Sigfred,0,0,0,26
1745142702797,HUM 3R,A01,886502,Markman; Kristina,0,32,50,50
1745142703831,HUM 4,A01,886504,Crum; Matthew Stephen,28,0,50,22
1745142703831,HUM 4,B01,886506,West; Geoffrey Scott,25,0,50,25
1745142704897,HUM 4GS,A00,886507,Staff,0,0,0,13
1745142705926,HUM 5,A01,886509,Staff,35,0,50,15
1745142706958,HUM 5R,A01,886511,Zavodny; Tatiana Sophia,0,32,50,50
1745142707984,JAPN 180,A00,886407,Staff,25,0,40,15
1745142709018,LATI 50,A01,886409,Martin-Cabrera; Luis,9,0,22,13
1745142709018,LATI 50,A02,886410,Martin-Cabrera; Luis,20,0,22,2
1745142709018,LATI 50,A03,886411,Martin-Cabrera; Luis,22,0,22,0
1745142709018,LATI 50,A04,886412,Martin-Cabrera; Luis,15,0,22,7
1745142710046,LAWS 101,A00,907664,Staff,36,0,60,24
1745142711076,LIAB 1A,A00,889388,Saab; Dima,19,0,20,1
1745142712103,LIAB 1AX,A00,889389,El Cheddadi; Youniss,19,0,20,1
1745142713135,LIFR 1C,A00,889391,Van Moer; Vinciane G,9,0,20,11
1745142714165,LIFR 1CX,A00,889392,Van Moer; Vinciane G,8,0,20,12
1745142715195,LIFR 1D,A00,889393,Van Moer; Vinciane G,11,0,20,9
1745142716225,LIFR 1DX,A00,889394,Van Moer; Vinciane G,11,0,20,9
1745142717250,LIGN 7,A00,886923,Staff,30,0,50,20
1745142718287,LIGN 17,A00,886924,Kehler; Andrew Scott,133,0,150,17
1745142719314,LTAM 110,A00,889395,Staff,17,0,30,13
1745142720341,LTCH 101,A00,889397,Staff,22,0,25,3
1745142721367,LTCS 130,A00,889398,Staff,23,0,25,2
1745142722396,LTEA 138,A00,889399,Staff,25,0,40,15
1745142723422,LTEN 149,A00,889400,Wesling; Megan E.,6,0,25,19
1745142724452,LTEN 169,A00,889401,Staff,24,0,25,1
1745142725479,LTEN 180,A00,889402,Staff,12,0,15,3
1745142726508,LTEN 181,A00,889403,Staff,23,0,25,2
1745142727538,LTWL 100,A00,889404,Myerston Santana; Jacobo,8,0,25,17
1745142728565,LTWL 180GS,A00,889405,Staff,6,0,20,14
1745142729591,LTWL 181,A00,889406,Staff,19,0,25,6
1745142730624,LTWL 184,A00,889475,Mukherjee; Silpa,21,0,25,4
1745142731651,LTWR 102C,A00,889486,Staff,29,0,30,1
1745142732676,LTWR 115W,A00,889491,Staff,3,0,15,12
1745142733702,MAE 8,A01,886905,Staff,0,2,0,0
1745142734732,MAE 11,A00,886906,Bandaru; Prabhakar,0,0,50,50
1745142735762,MAE 20,A00,886907,Evdokimenko; Ekaterina,50,0,70,20
1745142736794,MAE 30B,A00,886909,Ghazinejad; Maziar,28,0,45,17
1745142737825,MAE 101B,A00,886910,Saintillan; David,36,0,45,9
1745142738849,MAE 105,A00,886911,Bandaru; Prabhakar,26,0,50,24
1745142739878,MAE 107,A00,886912,Staff,22,0,60,38
1745142740907,MAE 143B,A00,886913,Bewley; Thomas R,14,0,40,26
1745142741934,MAE 148,A01,886915,Silberman; Jack,5,0,14,9
1745142742960,MAE 160,A00,886916,Evdokimenko; Ekaterina,41,0,60,19
1745142743985,MATH 3C,A01,889681,Staff,2,0,30,28
1745142745013,MATH 10A,A01,889760,Staff,28,0,30,2
1745142745013,MATH 10A,A02,889783,Staff,30,0,30,0
1745142746049,MATH 10B,A01,889785,Verstraete; Jacques Allan,0,2,30,30
1745142746049,MATH 10B,A02,889795,Verstraete; Jacques Allan,0,2,30,30
1745142746049,MATH 10B,B01,889797,Verstraete; Jacques Allan,0,0,30,30
1745142746049,MATH 10B,B02,889828,Verstraete; Jacques Allan,23,0,30,7
1745142747089,MATH 10C,A01,889849,Habib; Yousaf,18,0,30,12
1745142747089,MATH 10C,A02,889852,Habib; Yousaf,20,0,30,10
1745142747089,MATH 10C,A03,889853,Habib; Yousaf,25,0,30,5
1745142747089,MATH 10C,A04,889858,Habib; Yousaf,21,0,30,9
1745142747089,MATH 10C,B01,889861,Staff,12,0,30,18
1745142747089,MATH 10C,B02,889862,Staff,26,0,30,4
1745142747089,MATH 10C,B03,889863,Staff,28,0,30,2
1745142747089,MATH 10C,B04,889967,Staff,25,0,30,5
1745142748117,MATH 18,A01,889974,Staff,15,0,30,15
1745142748117,MATH 18,A02,889977,Staff,25,0,30,5
1745142748117,MATH 18,B01,889984,Hardiman; Liam,26,0,30,4
1745142748117,MATH 18,B02,889985,Hardiman; Liam,28,0,30,2
1745142749148,MATH 20A,A01,889990,Suk; Andrew Hoon,31,0,35,4
1745142750183,MATH 20B,A01,889993,Ohm; Ko Woon,21,0,30,9
1745142750183,MATH 20B,A02,889994,Ohm; Ko Woon,30,0,30,0
1745142750183,MATH 20B,B01,889996,Ohm; Ko Woon,25,0,30,5
1745142750183,MATH 20B,B02,889997,Ohm; Ko Woon,24,0,30,6
1745142751212,MATH 20C,A01,889999,Hammock; Frances H,22,0,30,8
1745142751212,MATH 20C,A02,890003,Hammock; Frances H,23,0,30,7
1745142751212,MATH 20C,B01,890006,Hammock; Frances H,11,0,30,19
1745142751212,MATH 20C,B02,890007,Hammock; Frances H,18,0,30,12
1745142752240,MATH 20D,A01,890011,Cheng; Hsiao-Bing,6,0,30,24
1745142752240,MATH 20D,A02,890012,Cheng; Hsiao-Bing,27,0,30,3
1745142752240,MATH 20D,B01,890016,Cheng; Hsiao-Bing,19,0,30,11
1745142752240,MATH 20D,B02,890017,Cheng; Hsiao-Bing,15,0,30,15
1745142753270,MATH 20E,A01,890026,Harel; Guershon,10,0,30,20
1745142753270,MATH 20E,A02,890029,Harel; Guershon,24,0,30,6
1745142753270,MATH 20E,B01,890033,Harel; Guershon,14,0,30,16
1745142753270,MATH 20E,B02,890101,Harel; Guershon,27,0,30,3
1745142754299,MATH 102,A01,890104,Staff,20,0,30,10
1745142754299,MATH 102,A02,890105,Staff,30,0,30,0
1745142755325,MATH 103B,A01,890116,Salehi Golsefidy; Alireza,8,0,30,22
1745142755325,MATH 103B,B01,890118,Staff,0,4,30,30
1745142756356,MATH 109,A01,890121,Aliabadi Sr.; Mohsen,6,0,30,24
1745142756356,MATH 109,B01,890124,Upadrashta; Pranav Kumar,23,0,30,7
1745142757391,MATH 120A,A01,890126,Eggers; John Dietrich,15,0,30,15
1745142758416,MATH 142B,A01,890128,Ioana; Adrian,17,0,30,13
1745142758416,MATH 142B,A02,890129,Ioana; Adrian,15,0,30,15
1745142759443,MATH 154,A01,890174,Staff,0,1,30,30
1745142759443,MATH 154,A02,890182,Staff,15,0,30,15
1745142760470,MATH 168A,A01,890197,Dumitriu; Ioana,22,0,35,13
1745142761497,MATH 170A,A01,890240,Nie; Jiawang,5,0,30,25
1745142761497,MATH 170A,A02,890241,Nie; Jiawang,18,0,30,12
1745142761497,MATH 170A,A03,890249,Nie; Jiawang,23,0,30,7
1745142762524,MATH 170B,A01,957891,Nag; Panchali,25,0,35,10
1745142764582,MATH 181A,A01,908025,Staff,0,8,35,35
1745142765608,MATH 193B,A01,890265,Staff,3,0,35,32
1745142766633,MGT 4,A01,890311,Anderson; John Charles,57,0,88,31
1745142767658,MGT 5,A00,907740,Staff,41,0,98,57
1745142768689,MGT 12,A00,890312,Lindenberger; Wade Douglas,70,0,98,28
1745142769716,MGT 16,A00,957883,Staff,84,0,98,14
1745142771770,MGT 45,A00,890314,Pecore; Joseph P.,57,0,98,41
1745142772799,MGT 71,A00,890315,Staff,6,0,98,92
1745142773829,MGT 100,A00,890316,Yavorsky; Daniel Ryan,59,0,98,39
1745142774855,MGT 103,A00,890317,Ehrich; Kristine R,77,0,98,21
1745142775882,MGT 105,A00,890356,Bates; Kenneth Walter,19,0,98,79
1745142776908,MGT 112,A00,890360,Ehrich; Kristine R,65,0,98,33
1745142777941,MGT 127R,A00,907732,Zhu; Kevin Xiaoguo,32,0,98,66
1745142778970,MGT 131B,A00,890361,Anderson; John Charles,75,0,98,23
1745142780003,MGT 137,A00,890362,Lindenberger; Wade Douglas,68,0,98,30
1745142781032,MGT 160,A00,890369,Johnson; Erik Barry,36,0,98,62
1745142783084,MGT 164,A00,890372,Zimmermann; Carsten,0,29,98,98
1745142784114,MGT 180,A00,890374,Bliss; Barbara Ann,31,0,98,67
1745142785147,MMW 15,A01,886414,Chang; Edmond Yi-Teh,0,10,28,28
1745142785147,MMW 15,A02,886415,Chang; Edmond Yi-Teh,0,10,28,28
1745142785147,MMW 15,A03,886416,Chang; Edmond Yi-Teh,0,8,28,28
1745142785147,MMW 15,A04,886417,Chang; Edmond Yi-Teh,0,8,28,28
1745142785147,MMW 15,B01,886419,Chang; Edmond Yi-Teh,0,8,28,28
1745142785147,MMW 15,B02,886420,Chang; Edmond Yi-Teh,0,9,28,28
1745142785147,MMW 15,B03,886421,Chang; Edmond Yi-Teh,0,9,28,28
1745142785147,MMW 15,B04,886422,Chang; Edmond Yi-Teh,0,9,28,28
1745142785147,MMW 15,C01,886424,Staff,0,10,28,28
1745142785147,MMW 15,C02,886425,Staff,0,10,28,28
1745142785147,MMW 15,C03,886426,Staff,0,9,28,28
1745142785147,MMW 15,C04,886427,Staff,0,9,28,28
1745142786179,MMW 15GS,A00,906910,Patterson; Patrick H.,5,0,28,23
1745142787213,MMW 122R,A01,886429,Rahimi; Babak,0,23,28,28
1745142787213,MMW 122R,A02,886430,Rahimi; Babak,0,23,28,28
1745142788254,MUS 1A,A01,890937,Staff,7,0,25,18
1745142788254,MUS 1A,A02,891035,Staff,15,0,25,10
1745142788254,MUS 1A,B00,907849,Staff,48,0,50,2
1745142788254,MUS 1A,B01,907850,Staff,25,0,25,0
1745142788254,MUS 1A,B02,907851,Staff,25,0,25,0
1745142790308,MUS 2AK,A00,957092,Ohnishi; Takae,15,0,15,0
1745142791342,MUS 4,A01,891044,Staff,6,0,25,19
1745142791342,MUS 4,A02,891045,Staff,24,0,25,1
1745142791342,MUS 4,B01,891048,Staff,20,0,25,5
1745142791342,MUS 4,B02,891050,Staff,25,0,25,0
1745142792387,MUS 5,A01,957506,Dubnov; Shlomo,4,0,25,21
1745142792387,MUS 5,A02,957622,Dubnov; Shlomo,21,0,25,4
1745142792387,MUS 5,A03,957623,Dubnov; Shlomo,23,0,25,2
1745142793413,MUS 6,A01,891053,Freitas Caetano; Marcelo,23,0,25,2
1745142793413,MUS 6,A02,891054,Freitas Caetano; Marcelo,23,0,25,2
1745142794446,MUS 7,A01,891081,Staff,0,0,25,25
1745142794446,MUS 7,A02,891082,Staff,14,0,25,11
1745142795473,MUS 8GS,A00,891118,Borgo; David Garcia,5,0,25,20
1745142796503,MUS 11,A01,891140,Staff,12,0,25,13
1745142796503,MUS 11,A02,891141,Staff,24,0,25,1
1745142797531,MUS 13,A01,891143,Staff,10,0,25,15
1745142797531,MUS 13,A02,891144,Staff,25,0,25,0
1745142798558,MUS 15,A01,891146,Staff,7,0,25,18
1745142798558,MUS 15,A02,891148,Staff,22,0,25,3
1745142798558,MUS 15,B01,891150,Staff,18,0,25,7
1745142798558,MUS 15,B02,891151,Staff,25,0,25,0
1745142799585,MUS 20,A01,891153,Staff,9,0,20,11
1745142799585,MUS 20,A02,891155,Staff,16,0,20,4
1745142800614,MUS 80,A00,891156,Staff,19,0,25,6
1745142800614,MUS 80,B00,891157,Staff,24,0,25,1
1745142801638,MUS 130,A00,891158,Ohnishi; Takae,35,0,35,0
1745142802664,MUS 150GS,A01,891160,Borgo; David Garcia,5,0,25,20
1745142803696,MUS 170,A01,891162,Freitas Caetano; Marcelo,21,0,25,4
1745142803696,MUS 170,A02,891164,Freitas Caetano; Marcelo,22,0,25,3
1745142804724,NANO 11,A00,886220,Vazquez Mena; Oscar,12,0,15,3
1745142805756,NANO 15,A01,886222,Drews; Aaron,9,0,10,1
1745142806787,NANO 104,A00,886224,Sirbuly; Donald,18,0,25,7
1745142807818,PH 40,A00,886528,Staff,29,0,40,11
1745142808901,PH 45,A01,886799,Staff,36,0,40,4
1745142809925,PH 110,A00,886802,Staff,7,0,40,33
1745142810953,PH 172,A00,906716,Staff,20,0,35,15
1745142811978,PH 191,A00,886803,Staff,23,0,40,17
1745142813008,PHIL 1,A00,889500,Staff,22,0,30,8
1745142814045,PHIL 10,A01,889549,Grush; Rick Scott,17,0,22,5
1745142814045,PHIL 10,A02,889551,Grush; Rick Scott,20,0,22,2
1745142815073,PHIL 28,A01,889559,Lamey; Andy M.,0,4,25,25
1745142815073,PHIL 28,A02,889561,Lamey; Andy M.,0,0,25,25
1745142815073,PHIL 28,A03,889572,Lamey; Andy M.,7,0,25,18
1745142816101,PHIL 35,A00,907839,Staff,32,0,33,1
1745142817130,PHIL 60,A00,889574,Staff,79,0,90,11
1745142818155,PHIL 105,A00,889579,Staff,0,1,0,0
1745142819180,PHIL 136,A00,889582,Fulkerson; Matthew Todd,27,0,45,18
1745142820207,PHIL 163,A01,889601,Staff,24,0,30,6
1745142820207,PHIL 163,B01,889606,Brandt; Reuven A,0,2,0,0
1745142821237,PHIL 164,A00,889610,Staff,20,0,30,10
1745142822263,PHIL 165,A00,889613,Staff,26,0,30,4
1745142823295,PHYS 1A,A00,886431,Staff,38,0,70,32
1745142824331,PHYS 1AL,001,886432,Tsai; Philbert S,0,0,30,30
1745142824331,PHYS 1AL,002,886436,Tsai; Philbert S,19,0,30,11
1745142825358,PHYS 1B,A00,886439,Staff,192,0,240,48
1745142826388,PHYS 1BL,001,886441,Tsai; Philbert S,0,1,30,30
1745142826388,PHYS 1BL,002,886444,Tsai; Philbert S,14,0,30,16
1745142827416,PHYS 1C,A00,896092,Arnold; Kam S,87,0,146,59
1745142828449,PHYS 1CL,001,886448,Tsai; Philbert S,0,4,30,30
1745142828449,PHYS 1CL,002,886449,Tsai; Philbert S,6,0,30,24
1745142828449,PHYS 1CL,003,886450,Tsai; Philbert S,22,0,30,8
1745142828449,PHYS 1CL,004,886451,Tsai; Philbert S,16,0,30,14
1745142829477,PHYS 2B,A01,886457,Staff,86,0,115,29
1745142830511,PHYS 2C,A01,886460,Shotwell; Brian,0,0,65,65
1745142831542,PHYS 2CL,A01,886467,Staff,0,3,28,28
1745142831542,PHYS 2CL,A02,886468,Staff,5,0,28,23
1745142832570,PHYS 2D,A01,886470,Staff,17,0,50,33
1745142833597,PHYS 4B,A01,886475,Grinstein; Benjamin,87,0,100,13
1745142834630,POLI 5,A00,891173,Desposato; Scott,17,0,25,8
1745142835656,POLI 5D,A01,891175,Staff,5,0,5,0
1745142835656,POLI 5D,B01,891178,Staff,5,0,5,0
1745142836683,POLI 11,A00,891179,Ferree; Karen E,3,0,25,22
1745142837710,POLI 12,A00,891180,Staff,21,0,30,9
1745142838737,POLI 27,A01,891182,Staff,29,0,75,46
1745142839766,POLI 30,A00,891183,Staff,0,3,30,30
1745142840804,POLI 100B,A00,891244,Staff,0,8,20,20
1745142841835,POLI 100I,A00,891247,Staff,19,0,30,11
1745142842860,POLI 104J,A00,891248,Nichter; Maysa,18,0,30,12
1745142843887,POLI 104U,A00,891250,Nichter; Maysa,9,0,30,21
1745142844917,POLI 108,A00,891253,Staff,0,0,0,4
1745142845947,POLI 110B,A00,891255,Wiens; David,22,0,25,3
1745142846977,POLI 112A,A00,891256,Wiens; David,15,0,25,10
1745142848007,POLI 114BR,A00,891261,Staff,22,0,30,8
1745142849032,POLI 117R,A00,891262,Forman; Fonna,12,0,50,38
1745142850060,POLI 118,A00,891264,Ingham; Sean,22,0,25,3
1745142851088,POLI 124A,A00,891265,Staff,19,0,20,1
1745142852114,POLI 125D,A00,891266,Nichter; Simeon C,9,0,25,16
1745142853142,POLI 126,A00,891268,Nichter; Simeon C,11,0,25,14
1745142854168,POLI 126AA,A00,891272,Staff,19,0,25,6
1745142855196,POLI 130AA,A00,891273,Staff,17,0,20,3
1745142856226,POLI 134AA,A00,891274,Staff,12,0,20,8
1745142858277,POLI 138,A00,891278,Staff,22,0,25,3
1745142859304,POLI 142K,A00,891280,Staff,17,0,25,8
1745142860335,POLI 142M,A00,891281,Gartzke; Erik,22,0,30,8
1745142861368,POLI 142P,A00,891284,Staff,21,0,30,9
1745142862396,POLI 143,A00,891285,Gartzke; Erik,17,0,30,13
1745142863426,POLI 153,A00,891286,Staff,20,0,20,0
1745142864452,POLI 170A,A00,891288,Staff,19,0,25,6
1745142865484,POLI 175,A00,891290,Staff,18,0,20,2
1745142866513,PSYC 1,A00,890674,Steiner; Eric Tomas,0,4,45,45
1745142867539,PSYC 2,A00,890676,Albright; Thomas D,25,0,35,10
1745142868569,PSYC 3,A00,890679,Staff,18,0,20,2
1745142869597,PSYC 60,A01,890684,Rickard; Timothy C.,7,0,45,38
1745142870626,PSYC 70,A01,890689,Geller; Emma Harlan,14,0,30,16
1745142871660,PSYC 100,A00,890690,Lacefield; Katharine I,0,43,180,180
1745142872692,PSYC 102,A00,890695,Staff,25,0,40,15
1745142873721,PSYC 105,A00,890699,Geller; Emma Harlan,78,0,100,22
1745142874746,PSYC 106,A00,890701,Gorman; Michael R.,15,0,30,15
1745142875772,PSYC 108,A00,890704,Adrian; Julia Anna,0,23,50,50
1745142876797,PSYC 118,A01,890712,Staff,18,0,30,12
1745142877825,PSYC 124,A00,890716,Chapman; Eddie Nathaniel,36,0,60,24
1745142878851,PSYC 131,A00,890717,Anagnostaras; Stephan,6,0,80,74
1745142879878,PSYC 137,A00,890719,Winkielman; Piotr,0,2,30,30
1745142880904,PSYC 144,A00,890721,Adrian; Julia Anna,0,3,45,45
1745142881931,PSYC 162,A00,890805,Staff,21,0,75,54
1745142882956,PSYC 169,A00,890810,Staff,0,15,30,30
1745142883987,PSYC 172,A00,890814,Gorman; Michael R.,14,0,30,16
1745142885015,PSYC 181,A00,890818,Anagnostaras; Stephan,63,0,200,137
1745142886040,PSYC 189,A00,890823,Staff,11,0,30,19
1745142887068,PSYC 191,A00,890884,Rickard; Timothy C.,0,11,35,35
1745142888094,PSYC 193,A00,890913,Staff,22,0,30,8
1745142888094,PSYC 193,B00,890914,Chapman; Eddie Nathaniel,25,0,30,5
1745142889121,PSYC 193L,A01,890918,Lowe; Angela Beth,29,0,30,1
1745142889121,PSYC 193L,B01,890921,Hurwitz; Ethan Scott,28,0,30,2
1745142889121,PSYC 193L,C01,890928,Staff,30,0,30,0
1745142890152,RELI 149,A00,886806,Rahimi; Babak,23,0,40,17
1745142891177,SE 9,A01,886814,Staff,13,0,20,7
1745142892206,SE 101B,A01,886816,Chadha; Mayank,8,0,30,22
1745142893235,SE 110B,A00,886818,Zhu; Qiang,0,16,45,45
1745142894266,SE 125,A01,886830,Staff,10,0,30,20
1745142895293,SE 130B,A01,886835,Staff,19,0,40,21
1745142896325,SE 131A,A01,886838,Krysl; Petr,37,0,55,18
1745142897355,SE 154,A00,886840,Staff,35,0,50,15
1745142898382,SE 164GS,A01,886849,Staff,13,0,20,7
1745142899409,SE 167GS,A01,886853,Staff,13,0,20,7
1745142900437,SIO 25,A01,890107,Staff,23,0,30,7
1745142901470,SIO 45,A00,890109,Cook; Geoffrey W,137,0,200,63
1745142902504,SIO 109R,A00,890110,Forman; Fonna,0,11,20,20
1745142903534,SIO 187,A01,890114,Kacev; David,21,0,40,19
1745142904571,SOCI 1,A01,890431,Thorpe; Charles Robert,21,0,30,9
1745142904571,SOCI 1,A02,890518,Thorpe; Charles Robert,30,0,30,0
1745142905601,SOCI 2,A01,957978,Staff,0,0,0,0
1745142905601,SOCI 2,A02,957979,Staff,0,3,0,0
1745142906629,SOCI 20,A01,890523,Calderon-Zaks; Michael Aar,24,0,30,6
1745142906629,SOCI 20,A02,890526,Calderon-Zaks; Michael Aar,29,0,30,1
1745142907660,SOCI 30,A01,890533,Pardo Guerra; Juan Pablo,37,0,40,3
1745142908690,SOCI 40,A01,890535,Staff,32,0,45,13
1745142909720,SOCI 104Q,A00,890559,Staff,20,0,30,10
1745142910751,SOCI 106,A00,890560,Arnal; Maud Marie Leonie,22,0,30,8
1745142911781,SOCI 110,A00,890567,Holkenbrink-Monk; Charlene,22,0,30,8
1745142912848,SOCI 112,A00,890568,Victoria Torres; Pablo,0,0,45,45
1745142913877,SOCI 115,A00,890597,Arnal; Maud Marie Leonie,33,0,45,12
1745142915936,SOCI 121,A00,890604,Pardo Guerra; Juan Pablo,40,0,45,5
1745142916965,SOCI 126,A01,890608,Staff,8,0,10,2
1745142917992,SOCI 127,A00,890609,Staff,23,0,30,7
1745142919022,SOCI 131,A00,890610,Thorpe; Charles Robert,38,0,45,7
1745142920052,SOCI 135,A00,890615,Payne; Christine Anna,20,0,45,25
1745142921077,SOCI 139,A00,890620,Staff,43,0,45,2
1745142922102,SOCI 148E,A00,890622,Calderon-Zaks; Michael Aar,39,0,45,6
1745142923129,SOCI 150,A00,890623,Kohler; Kristopher M.,36,0,45,9
1745142924161,SOCI 157,A00,890625,Jules-Rosette; Bennetta W.,18,0,20,2
1745142925189,SOCI 160,A00,890627,Payne; Christine Anna,26,0,45,19
1745142926224,SYN 1,A00,886855,Fish; Gwendolyn Anne,0,0,0,0
1745142926224,SYN 1,B00,906086,Fish; Gwendolyn Anne,0,0,0,2
1745142927252,SYN 2R,A00,886860,Staff,0,15,15,15
1745142927252,SYN 2R,B00,906106,Atkinson; Arthur Laird,0,14,15,15
1745142928292,SYN 100,A01,886866,Browne; Emily,0,29,20,20
1745142928292,SYN 100,B01,906128,Rock; Martin,0,4,20,20
1745142928292,SYN 100,C01,906140,Deavenport; James Cary,0,2,20,20
1745142928292,SYN 100,D01,907816,Deavenport; James Cary,0,3,20,20
1745142929321,TDAC 1,A00,890286,Walsh; Kim C.,11,0,20,9
1745142930348,TDAC 101,A00,890296,Basso; Beatrice,18,0,20,2
1745142931376,TDDE 131,A00,890297,Staff,47,0,50,3
1745142932408,TDDM 1,A00,890287,Weinberg; Sadie,26,0,30,4
1745142933436,TDGE 11,A00,890288,Fulton; Julia,155,0,200,45
1745142933436,TDGE 11,B00,890289,Castro; Robert Jess,188,0,200,12
1745142934470,TDGE 25,B00,957359,Walsh; Kim C.,9,0,20,11
1745142935497,TDGE 40,A01,890292,Power; Jade Yukana,28,0,30,2
1745142936523,TDGE 124,A00,890298,Havis; Allan,12,0,50,38
1745142937550,TDGE 131R,A00,890299,Burelle; Julie Sara Veronique,20,0,42,22
1745142938580,TDHT 101,A00,890300,Staff,12,0,20,8
1745142939607,TDHT 109,A01,890302,Anderson; Mysia Anyse,31,0,40,9
1745142940638,TDMV 1,A00,890293,Arcidiacono; Kristin,20,0,30,10
1745142941664,TDMV 2,A00,890294,Weinberg; Sadie,26,0,30,4
1745142942693,TDMV 3,A00,957878,Arcidiacono; Kristin,27,0,30,3
1745142944753,TDMV 138,A00,890304,Jun; Grace Shin Hae,25,0,40,15
1745142945784,TDMV 140,A00,890305,Corrales; Joseph Bernales,28,0,30,2
1745142946816,TDMV 142,A00,890307,Caligagan; Tony,30,0,40,10
1745142947847,TDMV 144,A00,890308,Camaya; Michelle Ann,26,0,30,4
1745142948873,TDPW 1,A00,890295,Stein; Deborah Isobel,5,0,20,15
1745142949900,USP 2,A01,890272,Lerner; Amy M,8,0,20,12
1745142950926,USP 3,A01,890274,Staff,21,0,30,9
1745142951957,USP 15,A01,890276,Sun; Feiyang,21,0,30,9
1745142952989,USP 25,A00,890277,Shenkman; Michael Thomas,21,0,25,4
1745142954016,USP 138,A00,890278,Staff,15,0,25,10
1745142955044,USP 143,A00,890279,Staff,30,0,70,40
1745142956078,USP 144,A00,890280,Chowdhury; Muhammed Zohir,19,0,30,11
1745142957108,USP 150,A00,890281,Boomhower; Matthew Charles,19,0,30,11
1745142958142,USP 151,A00,890282,Staff,17,0,20,3
1745142959168,USP 162,A00,890283,Andrews; Abigail Leslie,17,0,20,3
1745142960196,USP 168,A00,920477,Kwak; Nancy,2,0,5,3
1745142961228,USP 181,A00,890284,Staff,11,0,20,9
1745142962262,USP 191A,A00,890285,Staff,15,0,20,5
1745142963289,VIS 101,A00,886512,Staff,37,0,75,38
1745142964316,VIS 103,A00,886513,Cruz; Edwin Teddy,65,0,75,10
1745142965344,VIS 108,A00,886514,Staff,7,0,15,8
1745142966370,VIS 127P,A00,886515,Shen; Kuiyi,92,0,146,54
1745142967396,VIS 149,A00,886516,Yoldas; Pinar,1,0,15,14
1745142968424,VIS 164,A00,886526,Erdmann; Dean,21,0,22,1
1745142969453,VIS 194S,A00,886527,Staff,61,0,75,14
1745142970480,WCWP 10A,C00,886484,Staff,13,0,15,2
1745142971507,WCWP 10B,A00,886490,Staff,5,0,15,10
1745142971507,WCWP 10B,B00,886491,Staff,0,1,0,0
1745142971507,WCWP 10B,C00,886492,Staff,10,0,15,5
1745142972538,WCWP 100,A00,886494,Staff,0,2,15,15
1745142974699,AAS 10,A01,886199,Childs; Dennis R.,0,2,0,0
1745142975730,ANAR 104,A01,886940,Shtienberg; Gilad,27,0,30,3
1745142976757,ANAR 120,A00,886953,Staff,13,0,20,7
1745142977783,ANBI 148,A01,886955,Wilder; Linnea Lorene,32,0,40,8
1745142979837,ANSC 122,A00,886957,Staff,28,0,30,2
1745142980864,ANSC 150,A00,886958,Sloane; Julia Kathryn,6,0,15,9
1745142981907,ANSC 156,A00,886959,Jenkins; Janis A.,2,0,15,13
1745142982935,ANSC 180,A00,886960,Staff,12,0,17,5
1745142983962,ANSC 188,A00,886961,Jassal; Aftab,10,0,25,15
1745142985002,ANSC 190,A00,886962,Jassal; Aftab,14,0,25,11
1745142986030,ANSC 191,A00,886963,Staff,18,0,20,2
1745142987056,ANTH 3,A01,891689,Staff,19,0,20,1
1745142988083,ANTH 5,A00,886933,Semendeferi; Ekaterini,18,0,20,2
1745142989109,ANTH 10,A00,886934,Staff,0,8,30,30
1745142990136,ANTH 21,A01,886936,Staff,44,0,60,16
1745143001076,ANTH 23,A01,886938,Staff,94,0,100,6
1745143002119,ANTH 105,A00,886964,Stewart; Alexander B,94,0,100,6
1745143003147,ANTH 108,A00,886965,Pedersen; David,10,0,20,10
1745143004177,AWP 10,001,886147,Staff,0,0,0,0
1745143004177,AWP 10,002,886148,Staff,0,0,0,0
1745143004177,AWP 10,003,886149,Staff,0,0,0,0
1745143004177,AWP 10,004,886150,Staff,0,0,0,0
1745143004177,AWP 10,005,886151,Staff,0,0,0,0
1745143004177,AWP 10,006,886152,Staff,0,0,0,0
1745143004177,AWP 10,007,886153,Staff,0,0,0,0
1745143004177,AWP 10,008,886154,Staff,0,0,0,0
1745143004177,AWP 10,009,886155,Staff,0,0,0,0
1745143004177,AWP 10,010,886156,Staff,0,0,0,0
1745143004177,AWP 10,011,886158,Staff,0,0,0,0
1745143004177,AWP 10,012,886160,Staff,0,0,0,0
1745143004177,AWP 10,013,886161,Staff,0,0,0,0
1745143004177,AWP 10,014,886162,Staff,0,0,0,0
1745143004177,AWP 10,015,886163,Staff,0,0,0,0
1745143004177,AWP 10,016,886164,Staff,0,0,0,0
1745143004177,AWP 10,017,886165,Staff,0,0,0,0
1745143004177,AWP 10,018,886166,Staff,0,0,0,0
1745143004177,AWP 10,019,886168,Staff,0,0,0,0
1745143004177,AWP 10,020,886170,Staff,0,0,0,0
1745143004177,AWP 10,021,886172,Staff,0,0,0,0
1745143005204,AWP 10R,001,886173,Staff,0,0,0,0
1745143005204,AWP 10R,002,886174,Staff,0,1,0,0
1745143005204,AWP 10R,003,886175,Staff,0,0,0,0
1745143005204,AWP 10R,004,886176,Staff,0,0,0,0
1745143005204,AWP 10R,005,886177,Staff,0,0,0,0
1745143005204,AWP 10R,006,886178,Staff,0,0,0,0
1745143005204,AWP 10R,007,886179,Staff,0,0,0,0
1745143005204,AWP 10R,008,886181,Staff,0,0,0,0
1745143005204,AWP 10R,009,886182,Staff,0,0,0,0
1745143005204,AWP 10R,010,886183,Staff,0,0,0,0
1745143005204,AWP 10R,011,886184,Staff,0,0,0,0
1745143005204,AWP 10R,012,886185,Staff,0,0,0,0
1745143005204,AWP 10R,013,886186,Staff,0,0,0,0
1745143005204,AWP 10R,014,886187,Staff,0,0,0,0
1745143005204,AWP 10R,015,886188,Staff,0,0,0,0
1745143005204,AWP 10R,016,886189,Staff,0,0,0,0
1745143006229,AWP 102R,A00,886190,Staff,0,0,0,0
1745143006229,AWP 102R,B00,886191,Staff,0,0,0,0
1745143007257,BENG 100,A01,886193,Staff,19,0,30,11
1745143008301,BENG 122A,A01,886195,Hasty; Jeff M,20,0,30,10
1745143009350,BENG 166A,A00,886196,Sah; Robert Lie-Yuan,0,3,20,20
1745143010436,BIBC 102,A01,894320,Staff,0,2,46,46
1745143010436,BIBC 102,A02,894321,Staff,0,0,46,46
1745143010436,BIBC 102,A03,894344,Staff,21,0,46,25
1745143010436,BIBC 102,A04,894345,Staff,30,0,47,17
1745143011483,BICD 100R,A01,894365,Smith; Laurie,1,3,58,57
1745143011483,BICD 100R,A02,894366,Smith; Laurie,0,1,58,58
1745143011483,BICD 100R,A03,894367,Smith; Laurie,13,0,59,46
1745143012516,BICD 136,A01,894383,Gustafson-Brown; Cindy,16,0,50,34
1745143013568,BIEB 102,A01,894494,Butler; Shannon Rhey,67,0,130,63
1745143015661,BIEB 150,A01,894617,Wills; Christopher,0,3,13,13
1745143015661,BIEB 150,A02,894631,Wills; Christopher,0,3,13,13
1745143015661,BIEB 150,A03,894937,Wills; Christopher,0,3,13,13
1745143015661,BIEB 150,A04,894946,Wills; Christopher,0,1,11,11
1745143016688,BIEB 194,A00,906141,Kurle; Carolyn M.,14,0,20,6
1745143017728,BILD 1,A01,894154,Staff,8,0,19,11
1745143017728,BILD 1,A02,894155,Staff,15,0,19,4
1745143017728,BILD 1,A03,894160,Staff,18,0,19,1
1745143017728,BILD 1,A04,894161,Staff,16,0,18,2
1745143018754,BILD 2,A01,894168,Staff,0,0,50,50
1745143018754,BILD 2,A02,894169,Staff,0,0,50,50
1745143018754,BILD 2,A03,894179,Staff,27,0,50,23
1745143018754,BILD 2,A04,894203,Staff,42,0,50,8
1745143019782,BILD 3,A01,894213,Staff,24,0,31,7
1745143019782,BILD 3,A02,894214,Staff,28,0,31,3
1745143019782,BILD 3,A03,894235,Staff,30,0,31,1
1745143019782,BILD 3,A04,894236,Staff,29,0,32,3
1745143020810,BILD 4,A01,894253,Reuther; Keefe,12,0,24,12
1745143020810,BILD 4,A02,894258,Reuther; Keefe,19,0,24,5
1745143021850,BILD 5,A01,894276,Reuther; Keefe,40,0,50,10
1745143021850,BILD 5,A02,894277,Reuther; Keefe,48,0,50,2
1745143021850,BILD 5,A03,894290,Reuther; Keefe,47,0,50,3
1745143021850,BILD 5,A04,894291,Reuther; Keefe,50,0,50,0
1745143022878,BILD 24,A01,894297,Pirino; Giorgia,45,0,60,15
1745143023920,BIMM 100,A01,895012,Staff,0,14,0,1
1745143023920,BIMM 100,A02,895013,Staff,0,6,0,2
1745143023920,BIMM 100,A03,895014,Staff,0,7,0,0
1745143023920,BIMM 100,A04,895015,Staff,0,4,0,0
1745143024947,BIMM 101,A01,895017,McDonnell; Lisa Marie,0,2,24,24
1745143024947,BIMM 101,A02,895018,McDonnell; Lisa Marie,0,1,24,24
1745143024947,BIMM 101,B01,895020,McDonnell; Lisa Marie,0,3,24,24
1745143024947,BIMM 101,B02,895021,McDonnell; Lisa Marie,0,2,24,24
1745143025998,BIMM 110,A01,895023,Staff,7,0,25,18
1745143025998,BIMM 110,A02,895024,Staff,11,0,25,14
1745143025998,BIMM 110,A03,895025,Staff,22,0,25,3
1745143025998,BIMM 110,A04,895031,Staff,21,0,25,4
1745143027051,BIMM 120,A01,895114,Gustafson-Brown; Cindy,8,0,28,20
1745143027051,BIMM 120,A02,895126,Gustafson-Brown; Cindy,19,0,27,8
1745143028078,BIPN 100,A01,895130,Yang; Mingyu,13,0,38,25
1745143028078,BIPN 100,A02,895131,Yang; Mingyu,33,0,38,5
1745143028078,BIPN 100,A03,895132,Yang; Mingyu,33,0,38,5
1745143028078,BIPN 100,A04,895133,Yang; Mingyu,30,0,36,6
1745143029105,BIPN 120,A01,895135,Cooke; James Edward,0,2,13,13
1745143029105,BIPN 120,A02,895136,Cooke; James Edward,0,1,13,13
1745143029105,BIPN 120,A03,895137,Cooke; James Edward,0,0,13,13
1745143029105,BIPN 120,A04,895156,Cooke; James Edward,3,0,11,8
1745143030181,BIPN 134,A01,895235,Cooke; James Edward,0,2,25,25
1745143030181,BIPN 134,A02,895237,Cooke; James Edward,0,0,25,25
1745143030181,BIPN 134,A03,895240,Cooke; James Edward,12,0,25,13
1745143030181,BIPN 134,A04,895270,Cooke; James Edward,24,0,25,1
1745143031209,BIPN 189,A00,892103,Staff,0,20,9,9
1745143033270,CAT 124,A01,922009,Staff,0,1,20,20
1745143034303,CAT 125R,A00,886390,Morales; Celeste Georgianna,4,0,20,16
1745143034303,CAT 125R,B00,886391,Irwin; Matthew Joseph,0,1,20,20
1745143034303,CAT 125R,C00,886392,Smith; Lauryn Alissa,11,0,20,9
1745143034303,CAT 125R,D00,886393,Vanderschuit; Maya Alysia,6,0,20,14
1745143034303,CAT 125R,E00,886394,Marchisotto; Jennifer Anne,0,2,20,20
1745143035342,CENG 15,A01,886218,Drews; Aaron,1,0,5,4
1745143036386,CENG 113,A00,886219,Opatkiewicz; Justin Paul,16,0,25,9
1745143037411,CGS 101,A00,887044,Staff,13,0,20,7
1745143038450,CGS 105,A01,887046,Staff,16,0,25,9
1745143039489,CGS 112,A00,887047,Cuong; Marisol,12,0,15,3
1745143040515,CGS 113,A00,887048,Staff,24,0,30,6
1745143041540,CGS 120,A00,887049,Staff,12,0,17,5
1745143042599,CHEM 6A,A01,886336,Lam; Tin Yiu,44,0,50,6
1745143042599,CHEM 6A,A02,886338,Lam; Tin Yiu,43,0,50,7
1745143043626,CHEM 6B,A01,886341,Hopkins; Patrycja Anna,21,0,50,29
1745143043626,CHEM 6B,A02,886343,Hopkins; Patrycja Anna,46,0,50,4
1745143044705,CHEM 6C,A01,886346,Albizati; Kim F.,0,1,50,50
1745143044705,CHEM 6C,A02,886348,Albizati; Kim F.,38,0,50,12
1745143045731,CHEM 40A,A01,886352,Klosterman; Jeremy K,70,0,100,30
1745143046757,CHEM 40B,A01,886356,Klosterman; Jeremy K,0,4,100,100
1745143047804,CHEM 41B,A01,886360,Theodorakis; Emmanuel,30,0,50,20
1745143047804,CHEM 41B,A02,886362,Theodorakis; Emmanuel,46,0,50,4
1745143048895,CHIN 165A,A00,886382,Xu; Li,19,0,20,1
1745143049921,CLAS 120,A00,886387,Myerston Santana; Jacobo,36,0,40,4
1745143050964,COGS 9,A01,886967,Shannon; Kyle Michael,49,0,60,11
1745143052028,COGS 11,A01,886969,Staff,18,0,30,12
1745143061154,COGS 14A,A01,886971,Staff,26,0,60,34
1745143062204,COGS 14B,A01,886973,Hoffman; Drew Ellen,18,0,60,42
1745143063246,COGS 18,A01,886975,Morgan; Eric,41,0,60,19
1745143064272,COGS 20,A01,886977,Staff,6,0,8,2
1745143064272,COGS 20,A02,886978,Staff,6,0,7,1
1745143065297,COGS 100,A01,907783,Staff,6,0,30,24
1745143066335,COGS 101B,A01,886980,Staff,0,10,30,30
1745143067362,COGS 101C,A01,886982,Delgado; Tania,0,6,30,30
1745143068406,COGS 102A,A01,886984,Johnson; Christine M.,13,0,30,17
1745143069431,COGS 118B,A01,886986,Staff,0,25,60,60
1745143070457,COGS 150,A01,886988,Bergen; Benjamin,16,0,30,14
1745143071497,COGS 153,A00,886989,Delgado; Tania,0,6,30,30
1745143072537,COGS 186,A01,886991,Staff,3,0,30,27
1745143073563,COGS 187A,A01,886993,Boyle; Mary E. T.,12,0,30,18
1745143074599,COGS 189,A00,886994,Staff,13,0,30,17
1745143075638,COMM 10,A01,886996,Staff,11,0,25,14
1745143075638,COMM 10,A02,886997,Staff,21,0,25,4
1745143076665,COMM 20,A01,886999,Leuning; Grant Maurstad,33,0,40,7
1745143078714,COMM 100A,A01,887002,Staff,0,0,25,25
1745143078714,COMM 100A,A02,887003,Staff,20,0,25,5
1745143079741,COMM 100B,A01,887005,Staff,0,1,25,25
1745143080773,COMM 106D,A00,887006,Staff,22,0,40,18
1745143081808,COMM 110G,A00,887007,Whitworth-Smith; Andrew C,17,0,40,23
1745143082833,COMM 111B,A00,887008,Staff,31,0,40,9
1745143083859,COMM 113T,A00,887009,Abuelhiga; Soraya Jill,30,0,40,10
1745143083859,COMM 113T,B00,906733,Staff,40,0,40,0
1745143084885,COMM 145,A00,887010,Staff,21,0,40,19
1745143085918,COMM 146,A00,887054,Staff,31,0,40,9
1745143086950,COMM 190,A00,887012,Staff,9,0,23,14
1745143087989,CSE 8A,A50,887015,Cao; Yingjun,68,0,85,17
1745143089022,CSE 11,A01,887017,Cao; Yingjun,35,0,70,35
1745143090049,CSE 20,A01,887019,Staff,35,0,50,15
1745143091127,CSE 21,A01,887021,Braun; Oliver,81,0,100,19
1745143091127,CSE 21,B01,892583,Staff,48,0,50,2
1745143092160,CSE 30,A01,887025,Eldon; John,161,0,200,39
1745143093192,CSE 100,A01,887027,Staff,28,0,50,22
1745143093192,CSE 100,A02,887028,Staff,43,0,50,7
1745143094227,CSE 101,A01,887030,Braun; Oliver,79,0,100,21
1745143094227,CSE 101,B01,887032,Jones; Miles E,0,1,50,50
1745143094227,CSE 101,B02,887033,Jones; Miles E,13,0,50,37
1745143095254,CSE 105,A01,908084,Jones; Miles E,36,0,50,14
1745143095254,CSE 105,A02,908087,Jones; Miles E,38,0,50,12
1745143096287,CSE 135,A01,887035,Powell; Thomas Allan,8,0,50,42
1745143097323,CSE 142,A01,887037,Staff,22,0,60,38
1745143098350,CSE 142L,A01,887039,Staff,42,0,60,18
1745143099387,CSE 151A,A01,887041,Solares; Edwin A,60,0,100,40
1745143100413,CSE 175,A01,887043,Kumar; Rakesh,30,0,30,0
1745143101439,CSS 1,A01,886389,Staff,12,0,40,28
1745143102472,DSC 30,A01,908097,Liao; Soohyun Nam,54,0,75,21
1745143103497,DSC 40A,A01,908099,Shannon; Kyle Michael,37,0,50,13
1745143104537,DSC 40B,A01,908112,Staff,28,0,50,22
1745143105568,DSC 80,A01,908116,Staff,32,0,60,28
1745143106600,DSC 197,001,956863,Eldridge; Justin Matthew,9999,0,9999,0
1745143107627,ECE 5,A01,886400,Morris; Karcher William,3,0,6,3
1745143107627,ECE 5,A02,886401,Morris; Karcher William,5,0,6,1
1745143108652,ECE 148,A01,886403,Silberman; Jack,0,8,14,14
1745143109680,ECON 1,A01,887265,Crane; Meredith Helen,25,0,70,45
1745143109680,ECON 1,B01,887268,Staff,44,0,50,6
1745143110707,ECON 2,A01,887273,Crane; Meredith Helen,61,0,70,9
1745143111740,ECON 3,A01,887279,Rondina; Giacomo,44,0,70,26
1745143112767,ECON 4,A01,887282,Anderson; John Charles,0,1,10,10
1745143113793,ECON 5,A01,887285,Staff,39,0,45,6
1745143113793,ECON 5,B01,887292,Staff,43,0,45,2
1745143114819,ECON 100A,A01,887337,Newhouse; Herbert S,58,0,70,12
1745143114819,ECON 100A,B01,887349,Staff,45,0,50,5
1745143115845,ECON 100B,A01,887361,Du; Songzi,42,0,70,28
1745143116872,ECON 100C,A01,887445,Newhouse; Herbert S,61,0,70,9
1745143117899,ECON 105,A00,887488,Vespa; Emanuel Ignacio,24,0,35,11
1745143118924,ECON 109,A01,887506,Staff,29,0,35,6
1745143119960,ECON 110A,A01,887568,Alon; Titan Michael,1,0,35,34
1745143119960,ECON 110A,B01,907601,Alon; Titan Michael,27,0,35,8
1745143120987,ECON 110B,A01,887598,Levkoff; Steven B.,0,7,70,70
1745143122015,ECON 112,A00,887599,Rondina; Giacomo,20,0,35,15
1745143123041,ECON 120A,A01,887603,Dai; Yinlin,46,0,70,24
1745143124074,ECON 120C,A01,887608,Sun; Yixiao,0,0,35,35
1745143124074,ECON 120C,B01,887614,Sun; Yixiao,13,0,35,22
1745143125099,ECON 138,A00,887621,Bharadwaj; Prashant,0,18,20,20
1745143126144,ECON 171,A01,907666,Staff,27,0,35,8
1745143127174,ECON 175,A00,887626,Wu; Pak Yeung,27,0,35,8
1745143128209,ECON 190,A00,887640,Vespa; Emanuel Ignacio,26,0,35,9
1745143129258,EDS 25,A01,888197,Staff,0,0,0,0
1745143129258,EDS 25,A02,888209,Staff,0,0,0,0
1745143129258,EDS 25,A03,888210,Staff,0,0,0,0
1745143129258,EDS 25,A04,888212,Staff,0,0,0,0
1745143129258,EDS 25,A05,888213,Staff,0,0,0,0
1745143129258,EDS 25,A06,888214,Staff,0,0,0,0
1745143129258,EDS 25,A07,888235,Staff,0,0,0,0
1745143129258,EDS 25,A08,888236,Staff,0,0,0,0
1745143129258,EDS 25,A09,888240,Staff,0,0,0,0
1745143129258,EDS 25,A10,888244,Staff,0,0,0,0
1745143129258,EDS 25,B01,888273,Staff,0,0,0,0
1745143129258,EDS 25,B02,888285,Staff,0,0,0,0
1745143129258,EDS 25,B03,888423,Staff,29,0,30,1
1745143129258,EDS 25,B04,888432,Staff,0,0,0,0
1745143129258,EDS 25,B05,888433,Staff,0,0,0,0
1745143129258,EDS 25,B06,888467,Staff,0,0,0,0
1745143129258,EDS 25,B07,888468,Staff,0,0,0,0
1745143129258,EDS 25,B08,888479,Staff,0,0,0,0
1745143129258,EDS 25,B09,888484,Staff,0,0,0,0
1745143129258,EDS 25,B10,888487,Staff,0,0,0,0
1745143130304,EDS 38,A01,907700,Choi; Bailey Miyeon,30,0,30,0
1745143131332,EDS 112,A01,888601,Chapman; Thandeka K,23,0,40,17
1745143132358,EDS 115,A00,888697,Mendez; Kathrina Mendoza,17,0,30,13
1745143133390,EDS 116,A01,888893,Staff,38,0,40,2
1745143135451,EDS 124AR,A00,889133,Staff,33,0,50,17
1745143135451,EDS 124AR,B00,907471,Simon; Elizabeth A,42,0,50,8
1745143136476,EDS 124BR,A00,889134,Staff,57,0,100,43
1745143137501,EDS 125,A00,889135,Staff,26,0,30,4
1745143138533,EDS 126,A01,889138,Staff,37,0,40,3
1745143139560,EDS 164R,A01,889142,Wishard Guerra; Alison G.,38,0,50,12
1745143140586,ENG 30,A01,886396,Staff,0,0,0,0
1745143140586,ENG 30,B01,886398,Staff,0,0,0,0
1745143141622,ENVR 102,A00,906150,Montejo; Carolina,23,0,25,2
1745143142648,ETHN 103A,A00,887236,Man; Simeon S,0,5,0,0
1745143143680,ETHN 113,A00,887239,Staff,20,0,30,10
1745143144704,ETHN 116,A00,887240,Staff,20,0,25,5
1745143145730,ETHN 117,A00,887241,Choi; Esther Min,27,0,30,3
1745143146762,ETHN 118,A00,887243,Staff,24,0,30,6
1745143147789,ETHN 127,A00,887248,Cuong; Marisol,12,0,15,3
1745143148814,ETHN 139,A00,887250,Staff,8,0,10,2
1745143149840,ETHN 142,A00,887252,Staff,18,0,30,12
1745143150872,ETHN 161,A00,887253,Browne; Errol Tsekani,28,0,30,2
1745143151899,ETHN 163FR,A00,887255,Burelle; Julie Sara Veronique,4,0,5,1
1745143152924,GLBH 20,A00,889149,Elwardani; Nile Regina,15,0,42,27
1745143154976,GLBH 111,A01,889152,Burgos; Jose L.,17,0,17,0
1745143156008,GLBH 150,A00,889181,Sloane; Julia Kathryn,0,1,15,15
1745143158074,HDS 60,A01,886406,Warstadt; Melissa Fawn,76,0,80,4
1745143159101,HIAF 111,A00,889324,Gyamfi; Bright,0,4,0,0
1745143160131,HIEA 131,A00,889328,Staff,14,0,32,18
1745143161157,HIEA 144,A00,889333,Henry; Todd A.,29,0,32,3
1745143162182,HIEA 154,A00,889336,Henry; Todd A.,28,0,32,4
1745143163212,HIEU 106,A00,889339,Staff,28,0,32,4
1745143165263,HIEU 114,A00,889340,Staff,18,0,32,14
1745143166290,HIEU 135GS,A00,889342,Patterson; Patrick H.,0,0,1,22
1745143167315,HIEU 137,A00,889343,Edington; Claire Ellen,12,0,25,13
1745143168341,HIEU 148,A00,889345,Staff,16,0,32,16
1745143169374,HIEU 154,A00,889346,Biess; Frank Peter,24,0,32,8
1745143170400,HILA 102,A00,889351,Staff,13,0,32,19
1745143171430,HILD 2A,A01,889221,Lewandoski; Julia Mavis,0,5,32,32
1745143172495,HILD 7B,A01,889225,Man; Simeon S,0,7,32,32
1745143173522,HILD 7C,A01,889288,Alvarez; Luis A,0,8,32,32
1745143174551,HILD 30,A01,889323,Staff,0,1,32,32
1745143176610,HISC 119,A00,889383,Golan; Tal,22,0,32,10
1745143177639,HIUS 103,A00,889384,Man; Simeon S,10,0,32,22
1745143178666,HIUS 117,A00,919797,Kwak; Nancy,23,0,32,9
1745143179699,HIUS 142A,A00,919788,Staff,24,0,32,8
1745143181751,HIUS 149,A00,889386,Gyamfi; Bright,0,1,0,0
1745143182778,HIUS 155,A00,889387,Alvarez; Luis A,19,0,32,13
1745143183806,HUM 3,A01,886499,Caldwell; Michael Alan,24,0,50,26
1745143184832,HUM 3GS,A00,886500,Rodriguez; Bretton Sigfred,0,0,0,26
1745143185859,HUM 3R,A01,886502,Markman; Kristina,0,32,50,50
1745143186887,HUM 4,A01,886504,Crum; Matthew Stephen,28,0,50,22
1745143186887,HUM 4,B01,886506,West; Geoffrey Scott,25,0,50,25
1745143187914,HUM 4GS,A00,886507,Staff,0,0,0,13
1745143188940,HUM 5,A01,886509,Staff,35,0,50,15
1745143189970,HUM 5R,A01,886511,Zavodny; Tatiana Sophia,0,32,50,50
1745143190997,JAPN 180,A00,886407,Staff,25,0,40,15
1745143192023,LATI 50,A01,886409,Martin-Cabrera; Luis,9,0,22,13
1745143192023,LATI 50,A02,886410,Martin-Cabrera; Luis,20,0,22,2
1745143192023,LATI 50,A03,886411,Martin-Cabrera; Luis,22,0,22,0
1745143192023,LATI 50,A04,886412,Martin-Cabrera; Luis,15,0,22,7
1745143193049,LAWS 101,A00,907664,Staff,36,0,60,24
1745143194075,LIAB 1A,A00,889388,Saab; Dima,19,0,20,1
1745143195107,LIAB 1AX,A00,889389,El Cheddadi; Youniss,19,0,20,1
1745143196134,LIFR 1C,A00,889391,Van Moer; Vinciane G,9,0,20,11
1745143197164,LIFR 1CX,A00,889392,Van Moer; Vinciane G,8,0,20,12
1745143198192,LIFR 1D,A00,889393,Van Moer; Vinciane G,11,0,20,9
1745143199222,LIFR 1DX,A00,889394,Van Moer; Vinciane G,11,0,20,9
1745143200247,LIGN 7,A00,886923,Staff,30,0,50,20
1745143201275,LIGN 17,A00,886924,Kehler; Andrew Scott,133,0,150,17
1745143202306,LTAM 110,A00,889395,Staff,17,0,30,13
1745143203330,LTCH 101,A00,889397,Staff,22,0,25,3
1745143204361,LTCS 130,A00,889398,Staff,23,0,25,2
1745143205392,LTEA 138,A00,889399,Staff,25,0,40,15
1745143206418,LTEN 149,A00,889400,Wesling; Megan E.,6,0,25,19
1745143207445,LTEN 169,A00,889401,Staff,24,0,25,1
1745143208471,LTEN 180,A00,889402,Staff,12,0,15,3
1745143209497,LTEN 181,A00,889403,Staff,23,0,25,2
1745143210523,LTWL 100,A00,889404,Myerston Santana; Jacobo,8,0,25,17
1745143211551,LTWL 180GS,A00,889405,Staff,6,0,20,14
1745143212581,LTWL 181,A00,889406,Staff,19,0,25,6
1745143213609,LTWL 184,A00,889475,Mukherjee; Silpa,21,0,25,4
1745143214635,LTWR 102C,A00,889486,Staff,29,0,30,1
1745143215665,LTWR 115W,A00,889491,Staff,3,0,15,12
1745143216695,MAE 8,A01,886905,Staff,0,2,0,0
1745143217721,MAE 11,A00,886906,Bandaru; Prabhakar,0,0,50,50
1745143218748,MAE 20,A00,886907,Evdokimenko; Ekaterina,50,0,70,20
1745143219772,MAE 30B,A00,886909,Ghazinejad; Maziar,28,0,45,17
1745143220803,MAE 101B,A00,886910,Saintillan; David,36,0,45,9
1745143221829,MAE 105,A00,886911,Bandaru; Prabhakar,26,0,50,24
1745143222855,MAE 107,A00,886912,Staff,22,0,60,38
1745143223881,MAE 143B,A00,886913,Bewley; Thomas R,14,0,40,26
1745143224907,MAE 148,A01,886915,Silberman; Jack,5,0,14,9
1745143225938,MAE 160,A00,886916,Evdokimenko; Ekaterina,41,0,60,19
1745143226966,MATH 3C,A01,889681,Staff,2,0,30,28
1745143227994,MATH 10A,A01,889760,Staff,28,0,30,2
1745143227994,MATH 10A,A02,889783,Staff,30,0,30,0
1745143229023,MATH 10B,A01,889785,Verstraete; Jacques Allan,0,2,30,30
1745143229023,MATH 10B,A02,889795,Verstraete; Jacques Allan,0,2,30,30
1745143229023,MATH 10B,B01,889797,Verstraete; Jacques Allan,0,0,30,30
1745143229023,MATH 10B,B02,889828,Verstraete; Jacques Allan,23,0,30,7
1745143230052,MATH 10C,A01,889849,Habib; Yousaf,18,0,30,12
1745143230052,MATH 10C,A02,889852,Habib; Yousaf,20,0,30,10
1745143230052,MATH 10C,A03,889853,Habib; Yousaf,25,0,30,5
1745143230052,MATH 10C,A04,889858,Habib; Yousaf,21,0,30,9
1745143230052,MATH 10C,B01,889861,Staff,12,0,30,18
1745143230052,MATH 10C,B02,889862,Staff,26,0,30,4
1745143230052,MATH 10C,B03,889863,Staff,28,0,30,2
1745143230052,MATH 10C,B04,889967,Staff,25,0,30,5
1745143231079,MATH 18,A01,889974,Staff,15,0,30,15
1745143231079,MATH 18,A02,889977,Staff,25,0,30,5
1745143231079,MATH 18,B01,889984,Hardiman; Liam,26,0,30,4
1745143231079,MATH 18,B02,889985,Hardiman; Liam,28,0,30,2
1745143232107,MATH 20A,A01,889990,Suk; Andrew Hoon,31,0,35,4
1745143233141,MATH 20B,A01,889993,Ohm; Ko Woon,21,0,30,9
1745143233141,MATH 20B,A02,889994,Ohm; Ko Woon,30,0,30,0
1745143233141,MATH 20B,B01,889996,Ohm; Ko Woon,25,0,30,5
1745143233141,MATH 20B,B02,889997,Ohm; Ko Woon,24,0,30,6
1745143234170,MATH 20C,A01,889999,Hammock; Frances H,22,0,30,8
1745143234170,MATH 20C,A02,890003,Hammock; Frances H,23,0,30,7
1745143234170,MATH 20C,B01,890006,Hammock; Frances H,11,0,30,19
1745143234170,MATH 20C,B02,890007,Hammock; Frances H,18,0,30,12
1745143235251,MATH 20D,A01,890011,Cheng; Hsiao-Bing,6,0,30,24
1745143235251,MATH 20D,A02,890012,Cheng; Hsiao-Bing,27,0,30,3
1745143235251,MATH 20D,B01,890016,Cheng; Hsiao-Bing,19,0,30,11
1745143235251,MATH 20D,B02,890017,Cheng; Hsiao-Bing,15,0,30,15
1745143236282,MATH 20E,A01,890026,Harel; Guershon,10,0,30,20
1745143236282,MATH 20E,A02,890029,Harel; Guershon,24,0,30,6
1745143236282,MATH 20E,B01,890033,Harel; Guershon,14,0,30,16
1745143236282,MATH 20E,B02,890101,Harel; Guershon,27,0,30,3
1745143237312,MATH 102,A01,890104,Staff,20,0,30,10
1745143237312,MATH 102,A02,890105,Staff,30,0,30,0
1745143238340,MATH 103B,A01,890116,Salehi Golsefidy; Alireza,8,0,30,22
1745143238340,MATH 103B,B01,890118,Staff,0,4,30,30
1745143239365,MATH 109,A01,890121,Aliabadi Sr.; Mohsen,6,0,30,24
1745143239365,MATH 109,B01,890124,Upadrashta; Pranav Kumar,23,0,30,7
1745143240392,MATH 120A,A01,890126,Eggers; John Dietrich,15,0,30,15
1745143241418,MATH 142B,A01,890128,Ioana; Adrian,17,0,30,13
1745143241418,MATH 142B,A02,890129,Ioana; Adrian,15,0,30,15
1745143242449,MATH 154,A01,890174,Staff,0,1,30,30
1745143242449,MATH 154,A02,890182,Staff,15,0,30,15
1745143243480,MATH 168A,A01,890197,Dumitriu; Ioana,22,0,35,13
1745143244507,MATH 170A,A01,890240,Nie; Jiawang,5,0,30,25
1745143244507,MATH 170A,A02,890241,Nie; Jiawang,18,0,30,12
1745143244507,MATH 170A,A03,890249,Nie; Jiawang,23,0,30,7
1745143245538,MATH 170B,A01,957891,Nag; Panchali,25,0,35,10
1745143247654,MATH 181A,A01,908025,Staff,0,8,35,35
1745143248684,MATH 193B,A01,890265,Staff,3,0,35,32
1745143249718,MGT 4,A01,890311,Anderson; John Charles,57,0,88,31
1745143250749,MGT 5,A00,907740,Staff,41,0,98,57
1745143251774,MGT 12,A00,890312,Lindenberger; Wade Douglas,70,0,98,28
1745143252802,MGT 16,A00,957883,Staff,84,0,98,14
1745143254856,MGT 45,A00,890314,Pecore; Joseph P.,57,0,98,41
1745143255889,MGT 71,A00,890315,Staff,6,0,98,92
1745143256915,MGT 100,A00,890316,Yavorsky; Daniel Ryan,59,0,98,39
1745143257944,MGT 103,A00,890317,Ehrich; Kristine R,77,0,98,21
1745143258969,MGT 105,A00,890356,Bates; Kenneth Walter,19,0,98,79
1745143259995,MGT 112,A00,890360,Ehrich; Kristine R,65,0,98,33
1745143261021,MGT 127R,A00,907732,Zhu; Kevin Xiaoguo,32,0,98,66
1745143262047,MGT 131B,A00,890361,Anderson; John Charles,75,0,98,23
1745143263073,MGT 137,A00,890362,Lindenberger; Wade Douglas,68,0,98,30
1745143264100,MGT 160,A00,890369,Johnson; Erik Barry,36,0,98,62
1745143266155,MGT 164,A00,890372,Zimmermann; Carsten,0,29,98,98
1745143267186,MGT 180,A00,890374,Bliss; Barbara Ann,31,0,98,67
1745143268212,MMW 15,A01,886414,Chang; Edmond Yi-Teh,0,10,28,28
1745143268212,MMW 15,A02,886415,Chang; Edmond Yi-Teh,0,10,28,28
1745143268212,MMW 15,A03,886416,Chang; Edmond Yi-Teh,0,8,28,28
1745143268212,MMW 15,A04,886417,Chang; Edmond Yi-Teh,0,8,28,28
1745143268212,MMW 15,B01,886419,Chang; Edmond Yi-Teh,0,8,28,28
1745143268212,MMW 15,B02,886420,Chang; Edmond Yi-Teh,0,9,28,28
1745143268212,MMW 15,B03,886421,Chang; Edmond Yi-Teh,0,9,28,28
1745143268212,MMW 15,B04,886422,Chang; Edmond Yi-Teh,0,9,28,28
1745143268212,MMW 15,C01,886424,Staff,0,10,28,28
1745143268212,MMW 15,C02,886425,Staff,0,10,28,28
1745143268212,MMW 15,C03,886426,Staff,0,9,28,28
1745143268212,MMW 15,C04,886427,Staff,0,9,28,28
1745143269240,MMW 15GS,A00,906910,Patterson; Patrick H.,5,0,28,23
1745143270271,MMW 122R,A01,886429,Rahimi; Babak,0,23,28,28
1745143270271,MMW 122R,A02,886430,Rahimi; Babak,0,23,28,28
1745143271310,MUS 1A,A01,890937,Staff,7,0,25,18
1745143271310,MUS 1A,A02,891035,Staff,15,0,25,10
1745143271310,MUS 1A,B00,907849,Staff,48,0,50,2
1745143271310,MUS 1A,B01,907850,Staff,25,0,25,0
1745143271310,MUS 1A,B02,907851,Staff,25,0,25,0
1745143273364,MUS 2AK,A00,957092,Ohnishi; Takae,15,0,15,0
1745143274391,MUS 4,A01,891044,Staff,6,0,25,19
1745143274391,MUS 4,A02,891045,Staff,24,0,25,1
1745143274391,MUS 4,B01,891048,Staff,20,0,25,5
1745143274391,MUS 4,B02,891050,Staff,25,0,25,0
1745143275428,MUS 5,A01,957506,Dubnov; Shlomo,4,0,25,21
1745143275428,MUS 5,A02,957622,Dubnov; Shlomo,21,0,25,4
1745143275428,MUS 5,A03,957623,Dubnov; Shlomo,23,0,25,2
1745143276500,MUS 6,A01,891053,Freitas Caetano; Marcelo,23,0,25,2
1745143276500,MUS 6,A02,891054,Freitas Caetano; Marcelo,23,0,25,2
1745143277526,MUS 7,A01,891081,Staff,0,0,25,25
1745143277526,MUS 7,A02,891082,Staff,14,0,25,11
1745143278555,MUS 8GS,A00,891118,Borgo; David Garcia,5,0,25,20
1745143279583,MUS 11,A01,891140,Staff,12,0,25,13
1745143279583,MUS 11,A02,891141,Staff,24,0,25,1
1745143280611,MUS 13,A01,891143,Staff,10,0,25,15
1745143280611,MUS 13,A02,891144,Staff,25,0,25,0
1745143281644,MUS 15,A01,891146,Staff,7,0,25,18
1745143281644,MUS 15,A02,891148,Staff,22,0,25,3
1745143281644,MUS 15,B01,891150,Staff,18,0,25,7
1745143281644,MUS 15,B02,891151,Staff,25,0,25,0
1745143282673,MUS 20,A01,891153,Staff,9,0,20,11
1745143282673,MUS 20,A02,891155,Staff,16,0,20,4
1745143283700,MUS 80,A00,891156,Staff,19,0,25,6
1745143283700,MUS 80,B00,891157,Staff,24,0,25,1
1745143284727,MUS 130,A00,891158,Ohnishi; Takae,35,0,35,0
1745143285754,MUS 150GS,A01,891160,Borgo; David Garcia,5,0,25,20
1745143286783,MUS 170,A01,891162,Freitas Caetano; Marcelo,21,0,25,4
1745143286783,MUS 170,A02,891164,Freitas Caetano; Marcelo,22,0,25,3
1745143287812,NANO 11,A00,886220,Vazquez Mena; Oscar,12,0,15,3
1745143288839,NANO 15,A01,886222,Drews; Aaron,9,0,10,1
1745143289869,NANO 104,A00,886224,Sirbuly; Donald,18,0,25,7
1745143290900,PH 40,A00,886528,Staff,29,0,40,11
1745143291927,PH 45,A01,886799,Staff,36,0,40,4
1745143292952,PH 110,A00,886802,Staff,7,0,40,33
1745143293979,PH 172,A00,906716,Staff,20,0,35,15
1745143295005,PH 191,A00,886803,Staff,23,0,40,17
1745143296032,PHIL 1,A00,889500,Staff,22,0,30,8
1745143297060,PHIL 10,A01,889549,Grush; Rick Scott,17,0,22,5
1745143297060,PHIL 10,A02,889551,Grush; Rick Scott,20,0,22,2
1745143298094,PHIL 28,A01,889559,Lamey; Andy M.,0,4,25,25
1745143298094,PHIL 28,A02,889561,Lamey; Andy M.,0,0,25,25
1745143298094,PHIL 28,A03,889572,Lamey; Andy M.,7,0,25,18
1745143299124,PHIL 35,A00,907839,Staff,32,0,33,1
1745143300153,PHIL 60,A00,889574,Staff,79,0,90,11
1745143301184,PHIL 105,A00,889579,Staff,0,1,0,0
1745143302213,PHIL 136,A00,889582,Fulkerson; Matthew Todd,27,0,45,18
1745143303245,PHIL 163,A01,889601,Staff,24,0,30,6
1745143303245,PHIL 163,B01,889606,Brandt; Reuven A,0,2,0,0
1745143304275,PHIL 164,A00,889610,Staff,20,0,30,10
1745143305301,PHIL 165,A00,889613,Staff,26,0,30,4
1745143306327,PHYS 1A,A00,886431,Staff,38,0,70,32
1745143307353,PHYS 1AL,001,886432,Tsai; Philbert S,0,0,30,30
1745143307353,PHYS 1AL,002,886436,Tsai; Philbert S,19,0,30,11
1745143308383,PHYS 1B,A00,886439,Staff,192,0,240,48
1745143309412,PHYS 1BL,001,886441,Tsai; Philbert S,0,1,30,30
1745143309412,PHYS 1BL,002,886444,Tsai; Philbert S,14,0,30,16
1745143310445,PHYS 1C,A00,896092,Arnold; Kam S,87,0,146,59
1745143311475,PHYS 1CL,001,886448,Tsai; Philbert S,0,4,30,30
1745143311475,PHYS 1CL,002,886449,Tsai; Philbert S,6,0,30,24
1745143311475,PHYS 1CL,003,886450,Tsai; Philbert S,22,0,30,8
1745143311475,PHYS 1CL,004,886451,Tsai; Philbert S,16,0,30,14
1745143312507,PHYS 2B,A01,886457,Staff,86,0,115,29
1745143313534,PHYS 2C,A01,886460,Shotwell; Brian,0,0,65,65
1745143314561,PHYS 2CL,A01,886467,Staff,0,3,28,28
1745143314561,PHYS 2CL,A02,886468,Staff,5,0,28,23
1745143315591,PHYS 2D,A01,886470,Staff,17,0,50,33
1745143316617,PHYS 4B,A01,886475,Grinstein; Benjamin,87,0,100,13
1745143317643,POLI 5,A00,891173,Desposato; Scott,17,0,25,8
1745143318674,POLI 5D,A01,891175,Staff,5,0,5,0
1745143318674,POLI 5D,B01,891178,Staff,5,0,5,0
1745143319702,POLI 11,A00,891179,Ferree; Karen E,3,0,25,22
1745143320733,POLI 12,A00,891180,Staff,21,0,30,9
1745143321759,POLI 27,A01,891182,Staff,29,0,75,46
1745143322786,POLI 30,A00,891183,Staff,0,3,30,30
1745143323813,POLI 100B,A00,891244,Staff,0,8,20,20
1745143324842,POLI 100I,A00,891247,Staff,19,0,30,11
1745143325871,POLI 104J,A00,891248,Nichter; Maysa,18,0,30,12
1745143326895,POLI 104U,A00,891250,Nichter; Maysa,9,0,30,21
1745143327919,POLI 108,A00,891253,Staff,0,0,0,4
1745143328945,POLI 110B,A00,891255,Wiens; David,22,0,25,3
1745143329970,POLI 112A,A00,891256,Wiens; David,15,0,25,10
1745143330995,POLI 114BR,A00,891261,Staff,22,0,30,8
1745143332025,POLI 117R,A00,891262,Forman; Fonna,12,0,50,38
1745143333052,POLI 118,A00,891264,Ingham; Sean,22,0,25,3
1745143334080,POLI 124A,A00,891265,Staff,19,0,20,1
1745143335110,POLI 125D,A00,891266,Nichter; Simeon C,9,0,25,16
1745143336140,POLI 126,A00,891268,Nichter; Simeon C,11,0,25,14
1745143337167,POLI 126AA,A00,891272,Staff,19,0,25,6
1745143338193,POLI 130AA,A00,891273,Staff,17,0,20,3
1745143339219,POLI 134AA,A00,891274,Staff,12,0,20,8
1745143341272,POLI 138,A00,891278,Staff,22,0,25,3
1745143342299,POLI 142K,A00,891280,Staff,17,0,25,8
1745143343333,POLI 142M,A00,891281,Gartzke; Erik,22,0,30,8
1745143344362,POLI 142P,A00,891284,Staff,21,0,30,9
1745143345392,POLI 143,A00,891285,Gartzke; Erik,17,0,30,13
1745143346418,POLI 153,A00,891286,Staff,20,0,20,0
1745143347444,POLI 170A,A00,891288,Staff,19,0,25,6
1745143348473,POLI 175,A00,891290,Staff,18,0,20,2
1745143349500,PSYC 1,A00,890674,Steiner; Eric Tomas,0,4,45,45
1745143350527,PSYC 2,A00,890676,Albright; Thomas D,25,0,35,10
1745143351556,PSYC 3,A00,890679,Staff,18,0,20,2
1745143352581,PSYC 60,A01,890684,Rickard; Timothy C.,7,0,45,38
1745143353606,PSYC 70,A01,890689,Geller; Emma Harlan,14,0,30,16
1745143354634,PSYC 100,A00,890690,Lacefield; Katharine I,0,43,180,180
1745143355658,PSYC 102,A00,890695,Staff,25,0,40,15
1745143356685,PSYC 105,A00,890699,Geller; Emma Harlan,78,0,100,22
1745143357714,PSYC 106,A00,890701,Gorman; Michael R.,15,0,30,15
1745143358747,PSYC 108,A00,890704,Adrian; Julia Anna,0,23,50,50
1745143359773,PSYC 118,A01,890712,Staff,18,0,30,12
1745143360800,PSYC 124,A00,890716,Chapman; Eddie Nathaniel,36,0,60,24
1745143361831,PSYC 131,A00,890717,Anagnostaras; Stephan,6,0,80,74
1745143362857,PSYC 137,A00,890719,Winkielman; Piotr,0,2,30,30
1745143363883,PSYC 144,A00,890721,Adrian; Julia Anna,0,3,45,45
1745143364911,PSYC 162,A00,890805,Staff,21,0,75,54
1745143365938,PSYC 169,A00,890810,Staff,0,15,30,30
1745143366968,PSYC 172,A00,890814,Gorman; Michael R.,14,0,30,16
1745143367999,PSYC 181,A00,890818,Anagnostaras; Stephan,63,0,200,137
1745143369024,PSYC 189,A00,890823,Staff,11,0,30,19
1745143370052,PSYC 191,A00,890884,Rickard; Timothy C.,0,11,35,35
1745143371078,PSYC 193,A00,890913,Staff,22,0,30,8
1745143371078,PSYC 193,B00,890914,Chapman; Eddie Nathaniel,25,0,30,5
1745143372111,PSYC 193L,A01,890918,Lowe; Angela Beth,29,0,30,1
1745143372111,PSYC 193L,B01,890921,Hurwitz; Ethan Scott,28,0,30,2
1745143372111,PSYC 193L,C01,890928,Staff,30,0,30,0
1745143373143,RELI 149,A00,886806,Rahimi; Babak,23,0,40,17
1745143374168,SE 9,A01,886814,Staff,13,0,20,7
1745143375194,SE 101B,A01,886816,Chadha; Mayank,8,0,30,22
1745143376226,SE 110B,A00,886818,Zhu; Qiang,0,16,45,45
1745143377254,SE 125,A01,886830,Staff,10,0,30,20
1745143378284,SE 130B,A01,886835,Staff,19,0,40,21
1745143379313,SE 131A,A01,886838,Krysl; Petr,37,0,55,18
1745143380339,SE 154,A00,886840,Staff,35,0,50,15
1745143381365,SE 164GS,A01,886849,Staff,13,0,20,7
1745143382394,SE 167GS,A01,886853,Staff,13,0,20,7
1745143383423,SIO 25,A01,890107,Staff,23,0,30,7
1745143384453,SIO 45,A00,890109,Cook; Geoffrey W,137,0,200,63
1745143385479,SIO 109R,A00,890110,Forman; Fonna,0,11,20,20
1745143386544,SIO 187,A01,890114,Kacev; David,21,0,40,19
1745143387572,SOCI 1,A01,890431,Thorpe; Charles Robert,21,0,30,9
1745143387572,SOCI 1,A02,890518,Thorpe; Charles Robert,30,0,30,0
1745143388597,SOCI 2,A01,957978,Staff,0,0,0,0
1745143388597,SOCI 2,A02,957979,Staff,0,3,0,0
1745143389624,SOCI 20,A01,890523,Calderon-Zaks; Michael Aar,24,0,30,6
1745143389624,SOCI 20,A02,890526,Calderon-Zaks; Michael Aar,29,0,30,1
1745143390651,SOCI 30,A01,890533,Pardo Guerra; Juan Pablo,37,0,40,3
1745143391676,SOCI 40,A01,890535,Staff,32,0,45,13
1745143392707,SOCI 104Q,A00,890559,Staff,20,0,30,10
1745143393738,SOCI 106,A00,890560,Arnal; Maud Marie Leonie,22,0,30,8
1745143394765,SOCI 110,A00,890567,Holkenbrink-Monk; Charlene,22,0,30,8
1745143395790,SOCI 112,A00,890568,Victoria Torres; Pablo,0,0,45,45
1745143396816,SOCI 115,A00,890597,Arnal; Maud Marie Leonie,33,0,45,12
1745143398878,SOCI 121,A00,890604,Pardo Guerra; Juan Pablo,40,0,45,5
1745143399909,SOCI 126,A01,890608,Staff,8,0,10,2
1745143400935,SOCI 127,A00,890609,Staff,23,0,30,7
1745143401964,SOCI 131,A00,890610,Thorpe; Charles Robert,38,0,45,7
1745143402991,SOCI 135,A00,890615,Payne; Christine Anna,20,0,45,25
1745143404015,SOCI 139,A00,890620,Staff,43,0,45,2
1745143405042,SOCI 148E,A00,890622,Calderon-Zaks; Michael Aar,39,0,45,6
1745143406076,SOCI 150,A00,890623,Kohler; Kristopher M.,36,0,45,9
1745143407105,SOCI 157,A00,890625,Jules-Rosette; Bennetta W.,18,0,20,2
1745143408132,SOCI 160,A00,890627,Payne; Christine Anna,26,0,45,19
1745143409169,SYN 1,A00,886855,Fish; Gwendolyn Anne,0,0,0,0
1745143409169,SYN 1,B00,906086,Fish; Gwendolyn Anne,0,0,0,2
1745143410196,SYN 2R,A00,886860,Staff,0,15,15,15
1745143410196,SYN 2R,B00,906106,Atkinson; Arthur Laird,0,14,15,15
1745143411239,SYN 100,A01,886866,Browne; Emily,0,29,20,20
1745143411239,SYN 100,B01,906128,Rock; Martin,0,4,20,20
1745143411239,SYN 100,C01,906140,Deavenport; James Cary,0,2,20,20
1745143411239,SYN 100,D01,907816,Deavenport; James Cary,0,3,20,20
1745143412273,TDAC 1,A00,890286,Walsh; Kim C.,11,0,20,9
1745143413299,TDAC 101,A00,890296,Basso; Beatrice,18,0,20,2
1745143414326,TDDE 131,A00,890297,Staff,47,0,50,3
1745143415357,TDDM 1,A00,890287,Weinberg; Sadie,26,0,30,4
1745143416385,TDGE 11,A00,890288,Fulton; Julia,155,0,200,45
1745143416385,TDGE 11,B00,890289,Castro; Robert Jess,188,0,200,12
1745143417410,TDGE 25,B00,957359,Walsh; Kim C.,9,0,20,11
1745143418435,TDGE 40,A01,890292,Power; Jade Yukana,28,0,30,2
1745143419466,TDGE 124,A00,890298,Havis; Allan,12,0,50,38
1745143420493,TDGE 131R,A00,890299,Burelle; Julie Sara Veronique,20,0,42,22
1745143421525,TDHT 101,A00,890300,Staff,12,0,20,8
1745143422555,TDHT 109,A01,890302,Anderson; Mysia Anyse,31,0,40,9
1745143423581,TDMV 1,A00,890293,Arcidiacono; Kristin,20,0,30,10
1745143424610,TDMV 2,A00,890294,Weinberg; Sadie,26,0,30,4
1745143425642,TDMV 3,A00,957878,Arcidiacono; Kristin,27,0,30,3
1745143427692,TDMV 138,A00,890304,Jun; Grace Shin Hae,25,0,40,15
1745143428721,TDMV 140,A00,890305,Corrales; Joseph Bernales,28,0,30,2
1745143429752,TDMV 142,A00,890307,Caligagan; Tony,30,0,40,10
1745143430781,TDMV 144,A00,890308,Camaya; Michelle Ann,26,0,30,4
1745143431810,TDPW 1,A00,890295,Stein; Deborah Isobel,5,0,20,15
1745143432842,USP 2,A01,890272,Lerner; Amy M,8,0,20,12
1745143433867,USP 3,A01,890274,Staff,21,0,30,9
1745143434912,USP 15,A01,890276,Sun; Feiyang,21,0,30,9
1745143435939,USP 25,A00,890277,Shenkman; Michael Thomas,21,0,25,4
1745143436964,USP 138,A00,890278,Staff,15,0,25,10
1745143437988,USP 143,A00,890279,Staff,30,0,70,40
1745143439019,USP 144,A00,890280,Chowdhury; Muhammed Zohir,19,0,30,11
1745143440044,USP 150,A00,890281,Boomhower; Matthew Charles,19,0,30,11
1745143441069,USP 151,A00,890282,Staff,17,0,20,3
1745143442094,USP 162,A00,890283,Andrews; Abigail Leslie,17,0,20,3
1745143443120,USP 168,A00,920477,Kwak; Nancy,2,0,5,3
1745143444150,USP 181,A00,890284,Staff,11,0,20,9
1745143445175,USP 191A,A00,890285,Staff,15,0,20,5
1745143446201,VIS 101,A00,886512,Staff,37,0,75,38
1745143447228,VIS 103,A00,886513,Cruz; Edwin Teddy,65,0,75,10
1745143448253,VIS 108,A00,886514,Staff,7,0,15,8
1745143449280,VIS 127P,A00,886515,Shen; Kuiyi,92,0,146,54
1745143450309,VIS 149,A00,886516,Yoldas; Pinar,1,0,15,14
1745143451338,VIS 164,A00,886526,Erdmann; Dean,21,0,22,1
1745143452364,VIS 194S,A00,886527,Staff,61,0,75,14
1745143453390,WCWP 10A,C00,886484,Staff,13,0,15,2
1745143454416,WCWP 10B,A00,886490,Staff,5,0,15,10
1745143454416,WCWP 10B,B00,886491,Staff,0,1,0,0
1745143454416,WCWP 10B,C00,886492,Staff,10,0,15,5
1745143455442,WCWP 100,A00,886494,Staff,0,2,15,15
1745143457604,AAS 10,A01,886199,Childs; Dennis R.,0,2,0,0
1745143458630,ANAR 104,A01,886940,Shtienberg; Gilad,27,0,30,3
1745143459658,ANAR 120,A00,886953,Staff,13,0,20,7
1745143460686,ANBI 148,A01,886955,Wilder; Linnea Lorene,32,0,40,8
1745143462745,ANSC 122,A00,886957,Staff,28,0,30,2
1745143463771,ANSC 150,A00,886958,Sloane; Julia Kathryn,6,0,15,9
1745143464797,ANSC 156,A00,886959,Jenkins; Janis A.,2,0,15,13
1745143465823,ANSC 180,A00,886960,Staff,12,0,17,5
1745143466849,ANSC 188,A00,886961,Jassal; Aftab,10,0,25,15
1745143467875,ANSC 190,A00,886962,Jassal; Aftab,14,0,25,11
1745143468900,ANSC 191,A00,886963,Staff,18,0,20,2
1745143469934,ANTH 3,A01,891689,Staff,19,0,20,1
1745143470960,ANTH 5,A00,886933,Semendeferi; Ekaterini,18,0,20,2
1745143471987,ANTH 10,A00,886934,Staff,0,8,30,30
1745143473011,ANTH 21,A01,886936,Staff,44,0,60,16
1745143474037,ANTH 23,A01,886938,Staff,94,0,100,6
1745143475071,ANTH 105,A00,886964,Stewart; Alexander B,94,0,100,6
1745143476097,ANTH 108,A00,886965,Pedersen; David,10,0,20,10
1745143477134,AWP 10,001,886147,Staff,0,0,0,0
1745143477134,AWP 10,002,886148,Staff,0,0,0,0
1745143477134,AWP 10,003,886149,Staff,0,0,0,0
1745143477134,AWP 10,004,886150,Staff,0,0,0,0
1745143477134,AWP 10,005,886151,Staff,0,0,0,0
1745143477134,AWP 10,006,886152,Staff,0,0,0,0
1745143477134,AWP 10,007,886153,Staff,0,0,0,0
1745143477134,AWP 10,008,886154,Staff,0,0,0,0
1745143477134,AWP 10,009,886155,Staff,0,0,0,0
1745143477134,AWP 10,010,886156,Staff,0,0,0,0
1745143477134,AWP 10,011,886158,Staff,0,0,0,0
1745143477134,AWP 10,012,886160,Staff,0,0,0,0
1745143477134,AWP 10,013,886161,Staff,0,0,0,0
1745143477134,AWP 10,014,886162,Staff,0,0,0,0
1745143477134,AWP 10,015,886163,Staff,0,0,0,0
1745143477134,AWP 10,016,886164,Staff,0,0,0,0
1745143477134,AWP 10,017,886165,Staff,0,0,0,0
1745143477134,AWP 10,018,886166,Staff,0,0,0,0
1745143477134,AWP 10,019,886168,Staff,0,0,0,0
1745143477134,AWP 10,020,886170,Staff,0,0,0,0
1745143477134,AWP 10,021,886172,Staff,0,0,0,0
1745143478168,AWP 10R,001,886173,Staff,0,0,0,0
1745143478168,AWP 10R,002,886174,Staff,0,1,0,0
1745143478168,AWP 10R,003,886175,Staff,0,0,0,0
1745143478168,AWP 10R,004,886176,Staff,0,0,0,0
1745143478168,AWP 10R,005,886177,Staff,0,0,0,0
1745143478168,AWP 10R,006,886178,Staff,0,0,0,0
1745143478168,AWP 10R,007,886179,Staff,0,0,0,0
1745143478168,AWP 10R,008,886181,Staff,0,0,0,0
1745143478168,AWP 10R,009,886182,Staff,0,0,0,0
1745143478168,AWP 10R,010,886183,Staff,0,0,0,0
1745143478168,AWP 10R,011,886184,Staff,0,0,0,0
1745143478168,AWP 10R,012,886185,Staff,0,0,0,0
1745143478168,AWP 10R,013,886186,Staff,0,0,0,0
1745143478168,AWP 10R,014,886187,Staff,0,0,0,0
1745143478168,AWP 10R,015,886188,Staff,0,0,0,0
1745143478168,AWP 10R,016,886189,Staff,0,0,0,0
1745143479194,AWP 102R,A00,886190,Staff,0,0,0,0
1745143479194,AWP 102R,B00,886191,Staff,0,0,0,0
1745143480219,BENG 100,A01,886193,Staff,19,0,30,11
1745143481251,BENG 122A,A01,886195,Hasty; Jeff M,20,0,30,10
1745143482282,BENG 166A,A00,886196,Sah; Robert Lie-Yuan,0,3,20,20
1745143483315,BIBC 102,A01,894320,Staff,0,2,46,46
1745143483315,BIBC 102,A02,894321,Staff,0,0,46,46
1745143483315,BIBC 102,A03,894344,Staff,21,0,46,25
1745143483315,BIBC 102,A04,894345,Staff,30,0,47,17
1745143484343,BICD 100R,A01,894365,Smith; Laurie,1,3,58,57
1745143484343,BICD 100R,A02,894366,Smith; Laurie,0,1,58,58
1745143484343,BICD 100R,A03,894367,Smith; Laurie,13,0,59,46
1745143485371,BICD 136,A01,894383,Gustafson-Brown; Cindy,16,0,50,34
1745143486408,BIEB 102,A01,894494,Butler; Shannon Rhey,67,0,130,63
1745143488466,BIEB 150,A01,894617,Wills; Christopher,0,3,13,13
1745143488466,BIEB 150,A02,894631,Wills; Christopher,0,3,13,13
1745143488466,BIEB 150,A03,894937,Wills; Christopher,0,3,13,13
1745143488466,BIEB 150,A04,894946,Wills; Christopher,0,1,11,11
1745143489493,BIEB 194,A00,906141,Kurle; Carolyn M.,14,0,20,6
1745143490562,BILD 1,A01,894154,Staff,8,0,19,11
1745143490562,BILD 1,A02,894155,Staff,15,0,19,4
1745143490562,BILD 1,A03,894160,Staff,18,0,19,1
1745143490562,BILD 1,A04,894161,Staff,16,0,18,2
1745143491589,BILD 2,A01,894168,Staff,0,0,50,50
1745143491589,BILD 2,A02,894169,Staff,0,0,50,50
1745143491589,BILD 2,A03,894179,Staff,27,0,50,23
1745143491589,BILD 2,A04,894203,Staff,42,0,50,8
1745143492615,BILD 3,A01,894213,Staff,24,0,31,7
1745143492615,BILD 3,A02,894214,Staff,28,0,31,3
1745143492615,BILD 3,A03,894235,Staff,30,0,31,1
1745143492615,BILD 3,A04,894236,Staff,29,0,32,3
1745143493687,BILD 4,A01,894253,Reuther; Keefe,12,0,24,12
1745143493687,BILD 4,A02,894258,Reuther; Keefe,19,0,24,5
1745143494713,BILD 5,A01,894276,Reuther; Keefe,40,0,50,10
1745143494713,BILD 5,A02,894277,Reuther; Keefe,48,0,50,2
1745143494713,BILD 5,A03,894290,Reuther; Keefe,47,0,50,3
1745143494713,BILD 5,A04,894291,Reuther; Keefe,50,0,50,0
1745143495741,BILD 24,A01,894297,Pirino; Giorgia,45,0,60,15
1745143496769,BIMM 100,A01,895012,Staff,0,14,0,1
1745143496769,BIMM 100,A02,895013,Staff,0,6,0,2
1745143496769,BIMM 100,A03,895014,Staff,0,7,0,0
1745143496769,BIMM 100,A04,895015,Staff,0,4,0,0
1745143497803,BIMM 101,A01,895017,McDonnell; Lisa Marie,0,2,24,24
1745143497803,BIMM 101,A02,895018,McDonnell; Lisa Marie,0,1,24,24
1745143497803,BIMM 101,B01,895020,McDonnell; Lisa Marie,0,3,24,24
1745143497803,BIMM 101,B02,895021,McDonnell; Lisa Marie,0,2,24,24
1745143498829,BIMM 110,A01,895023,Staff,7,0,25,18
1745143498829,BIMM 110,A02,895024,Staff,11,0,25,14
1745143498829,BIMM 110,A03,895025,Staff,22,0,25,3
1745143498829,BIMM 110,A04,895031,Staff,21,0,25,4
1745143499865,BIMM 120,A01,895114,Gustafson-Brown; Cindy,8,0,28,20
1745143499865,BIMM 120,A02,895126,Gustafson-Brown; Cindy,19,0,27,8
1745143500894,BIPN 100,A01,895130,Yang; Mingyu,13,0,38,25
1745143500894,BIPN 100,A02,895131,Yang; Mingyu,33,0,38,5
1745143500894,BIPN 100,A03,895132,Yang; Mingyu,33,0,38,5
1745143500894,BIPN 100,A04,895133,Yang; Mingyu,30,0,36,6
1745143501933,BIPN 120,A01,895135,Cooke; James Edward,0,2,13,13
1745143501933,BIPN 120,A02,895136,Cooke; James Edward,0,1,13,13
1745143501933,BIPN 120,A03,895137,Cooke; James Edward,0,0,13,13
1745143501933,BIPN 120,A04,895156,Cooke; James Edward,3,0,11,8
1745143502966,BIPN 134,A01,895235,Cooke; James Edward,0,2,25,25
1745143502966,BIPN 134,A02,895237,Cooke; James Edward,0,0,25,25
1745143502966,BIPN 134,A03,895240,Cooke; James Edward,12,0,25,13
1745143502966,BIPN 134,A04,895270,Cooke; James Edward,24,0,25,1
1745143503993,BIPN 189,A00,892103,Staff,0,20,9,9
1745143506052,CAT 124,A01,922009,Staff,0,1,20,20
1745143507092,CAT 125R,A00,886390,Morales; Celeste Georgianna,4,0,20,16
1745143507092,CAT 125R,B00,886391,Irwin; Matthew Joseph,0,1,20,20
1745143507092,CAT 125R,C00,886392,Smith; Lauryn Alissa,11,0,20,9
1745143507092,CAT 125R,D00,886393,Vanderschuit; Maya Alysia,6,0,20,14
1745143507092,CAT 125R,E00,886394,Marchisotto; Jennifer Anne,0,2,20,20
1745143508123,CENG 15,A01,886218,Drews; Aaron,1,0,5,4
1745143509153,CENG 113,A00,886219,Opatkiewicz; Justin Paul,16,0,25,9
1745143510180,CGS 101,A00,887044,Staff,13,0,20,7
1745143511208,CGS 105,A01,887046,Staff,16,0,25,9
1745143512234,CGS 112,A00,887047,Cuong; Marisol,12,0,15,3
1745143513278,CGS 113,A00,887048,Staff,24,0,30,6
1745143514305,CGS 120,A00,887049,Staff,12,0,17,5
1745143515333,CHEM 6A,A01,886336,Lam; Tin Yiu,44,0,50,6
1745143515333,CHEM 6A,A02,886338,Lam; Tin Yiu,43,0,50,7
1745143516369,CHEM 6B,A01,886341,Hopkins; Patrycja Anna,21,0,50,29
1745143516369,CHEM 6B,A02,886343,Hopkins; Patrycja Anna,46,0,50,4
1745143517402,CHEM 6C,A01,886346,Albizati; Kim F.,0,1,50,50
1745143517402,CHEM 6C,A02,886348,Albizati; Kim F.,38,0,50,12
1745143518429,CHEM 40A,A01,886352,Klosterman; Jeremy K,70,0,100,30
1745143519456,CHEM 40B,A01,886356,Klosterman; Jeremy K,0,4,100,100
1745143520492,CHEM 41B,A01,886360,Theodorakis; Emmanuel,30,0,50,20
1745143520492,CHEM 41B,A02,886362,Theodorakis; Emmanuel,46,0,50,4
1745143521516,CHIN 165A,A00,886382,Xu; Li,19,0,20,1
1745143522546,CLAS 120,A00,886387,Myerston Santana; Jacobo,36,0,40,4
1745143523575,COGS 9,A01,886967,Shannon; Kyle Michael,49,0,60,11
1745143524605,COGS 11,A01,886969,Staff,18,0,30,12
1745143525633,COGS 14A,A01,886971,Staff,26,0,60,34
1745143526660,COGS 14B,A01,886973,Hoffman; Drew Ellen,18,0,60,42
1745143527686,COGS 18,A01,886975,Morgan; Eric,41,0,60,19
1745143528716,COGS 20,A01,886977,Staff,6,0,8,2
1745143528716,COGS 20,A02,886978,Staff,6,0,7,1
1745143529744,COGS 100,A01,907783,Staff,6,0,30,24
1745143530770,COGS 101B,A01,886980,Staff,0,10,30,30
1745143531803,COGS 101C,A01,886982,Delgado; Tania,0,6,30,30
1745143532833,COGS 102A,A01,886984,Johnson; Christine M.,13,0,30,17
1745143533863,COGS 118B,A01,886986,Staff,0,25,60,60
1745143534896,COGS 150,A01,886988,Bergen; Benjamin,16,0,30,14
1745143535925,COGS 153,A00,886989,Delgado; Tania,0,6,30,30
1745143536950,COGS 186,A01,886991,Staff,3,0,30,27
1745143537980,COGS 187A,A01,886993,Boyle; Mary E. T.,12,0,30,18
1745143539007,COGS 189,A00,886994,Staff,13,0,30,17
1745143540033,COMM 10,A01,886996,Staff,11,0,25,14
1745143540033,COMM 10,A02,886997,Staff,21,0,25,4
1745143541066,COMM 20,A01,886999,Leuning; Grant Maurstad,33,0,40,7
1745143543116,COMM 100A,A01,887002,Staff,0,0,25,25
1745143543116,COMM 100A,A02,887003,Staff,20,0,25,5
1745143544146,COMM 100B,A01,887005,Staff,0,1,25,25
1745143545176,COMM 106D,A00,887006,Staff,22,0,40,18
1745143546207,COMM 110G,A00,887007,Whitworth-Smith; Andrew C,17,0,40,23
1745143547233,COMM 111B,A00,887008,Staff,31,0,40,9
1745143548265,COMM 113T,A00,887009,Abuelhiga; Soraya Jill,30,0,40,10
1745143548265,COMM 113T,B00,906733,Staff,40,0,40,0
1745143549301,COMM 145,A00,887010,Staff,21,0,40,19
1745143550329,COMM 146,A00,887054,Staff,31,0,40,9
1745143551355,COMM 190,A00,887012,Staff,9,0,23,14
1745143552392,CSE 8A,A50,887015,Cao; Yingjun,68,0,85,17
1745143553418,CSE 11,A01,887017,Cao; Yingjun,35,0,70,35
1745143554445,CSE 20,A01,887019,Staff,35,0,50,15
1745143555479,CSE 21,A01,887021,Braun; Oliver,81,0,100,19
1745143555479,CSE 21,B01,892583,Staff,48,0,50,2
1745143556511,CSE 30,A01,887025,Eldon; John,161,0,200,39
1745143557539,CSE 100,A01,887027,Staff,28,0,50,22
1745143557539,CSE 100,A02,887028,Staff,43,0,50,7
1745143558565,CSE 101,A01,887030,Braun; Oliver,79,0,100,21
1745143558565,CSE 101,B01,887032,Jones; Miles E,0,1,50,50
1745143558565,CSE 101,B02,887033,Jones; Miles E,13,0,50,37
1745143559593,CSE 105,A01,908084,Jones; Miles E,36,0,50,14
1745143559593,CSE 105,A02,908087,Jones; Miles E,38,0,50,12
1745143560620,CSE 135,A01,887035,Powell; Thomas Allan,8,0,50,42
1745143561645,CSE 142,A01,887037,Staff,22,0,60,38
1745143562673,CSE 142L,A01,887039,Staff,42,0,60,18
1745143563704,CSE 151A,A01,887041,Solares; Edwin A,60,0,100,40
1745143564732,CSE 175,A01,887043,Kumar; Rakesh,30,0,30,0
1745143565757,CSS 1,A01,886389,Staff,12,0,40,28
1745143566784,DSC 30,A01,908097,Liao; Soohyun Nam,54,0,75,21
1745143567809,DSC 40A,A01,908099,Shannon; Kyle Michael,37,0,50,13
1745143568840,DSC 40B,A01,908112,Staff,28,0,50,22
1745143569870,DSC 80,A01,908116,Staff,32,0,60,28
1745143570901,DSC 197,001,956863,Eldridge; Justin Matthew,9999,0,9999,0
1745143571993,ECE 5,A01,886400,Morris; Karcher William,3,0,6,3
1745143571993,ECE 5,A02,886401,Morris; Karcher William,5,0,6,1
1745143573021,ECE 148,A01,886403,Silberman; Jack,0,8,14,14
1745143574054,ECON 1,A01,887265,Crane; Meredith Helen,25,0,70,45
1745143574054,ECON 1,B01,887268,Staff,44,0,50,6
1745143575084,ECON 2,A01,887273,Crane; Meredith Helen,61,0,70,9
1745143576114,ECON 3,A01,887279,Rondina; Giacomo,44,0,70,26
1745143577140,ECON 4,A01,887282,Anderson; John Charles,0,1,10,10
1745143578166,ECON 5,A01,887285,Staff,39,0,45,6
1745143578166,ECON 5,B01,887292,Staff,43,0,45,2
1745143579195,ECON 100A,A01,887337,Newhouse; Herbert S,58,0,70,12
1745143579195,ECON 100A,B01,887349,Staff,45,0,50,5
1745143580223,ECON 100B,A01,887361,Du; Songzi,42,0,70,28
1745143581250,ECON 100C,A01,887445,Newhouse; Herbert S,61,0,70,9
1745143582276,ECON 105,A00,887488,Vespa; Emanuel Ignacio,24,0,35,11
1745143583306,ECON 109,A01,887506,Staff,29,0,35,6
1745143584335,ECON 110A,A01,887568,Alon; Titan Michael,1,0,35,34
1745143584335,ECON 110A,B01,907601,Alon; Titan Michael,27,0,35,8
1745143585362,ECON 110B,A01,887598,Levkoff; Steven B.,0,7,70,70
1745143586389,ECON 112,A00,887599,Rondina; Giacomo,20,0,35,15
1745143587419,ECON 120A,A01,887603,Dai; Yinlin,46,0,70,24
1745143588447,ECON 120C,A01,887608,Sun; Yixiao,0,0,35,35
1745143588447,ECON 120C,B01,887614,Sun; Yixiao,13,0,35,22
1745143589474,ECON 138,A00,887621,Bharadwaj; Prashant,0,18,20,20
1745143590501,ECON 171,A01,907666,Staff,27,0,35,8
1745143591527,ECON 175,A00,887626,Wu; Pak Yeung,27,0,35,8
1745143592556,ECON 190,A00,887640,Vespa; Emanuel Ignacio,26,0,35,9
1745143593600,EDS 25,A01,888197,Staff,0,0,0,0
1745143593600,EDS 25,A02,888209,Staff,0,0,0,0
1745143593600,EDS 25,A03,888210,Staff,0,0,0,0
1745143593600,EDS 25,A04,888212,Staff,0,0,0,0
1745143593600,EDS 25,A05,888213,Staff,0,0,0,0
1745143593600,EDS 25,A06,888214,Staff,0,0,0,0
1745143593600,EDS 25,A07,888235,Staff,0,0,0,0
1745143593600,EDS 25,A08,888236,Staff,0,0,0,0
1745143593600,EDS 25,A09,888240,Staff,0,0,0,0
1745143593600,EDS 25,A10,888244,Staff,0,0,0,0
1745143593600,EDS 25,B01,888273,Staff,0,0,0,0
1745143593600,EDS 25,B02,888285,Staff,0,0,0,0
1745143593600,EDS 25,B03,888423,Staff,29,0,30,1
1745143593600,EDS 25,B04,888432,Staff,0,0,0,0
1745143593600,EDS 25,B05,888433,Staff,0,0,0,0
1745143593600,EDS 25,B06,888467,Staff,0,0,0,0
1745143593600,EDS 25,B07,888468,Staff,0,0,0,0
1745143593600,EDS 25,B08,888479,Staff,0,0,0,0
1745143593600,EDS 25,B09,888484,Staff,0,0,0,0
1745143593600,EDS 25,B10,888487,Staff,0,0,0,0
1745143594627,EDS 38,A01,907700,Choi; Bailey Miyeon,30,0,30,0
1745143595659,EDS 112,A01,888601,Chapman; Thandeka K,23,0,40,17
1745143596686,EDS 115,A00,888697,Mendez; Kathrina Mendoza,17,0,30,13
1745143597713,EDS 116,A01,888893,Staff,38,0,40,2
1745143599764,EDS 124AR,A00,889133,Staff,33,0,50,17
1745143599764,EDS 124AR,B00,907471,Simon; Elizabeth A,42,0,50,8
1745143600789,EDS 124BR,A00,889134,Staff,57,0,100,43
1745143601815,EDS 125,A00,889135,Staff,26,0,30,4
1745143602842,EDS 126,A01,889138,Staff,37,0,40,3
1745143603870,EDS 164R,A01,889142,Wishard Guerra; Alison G.,38,0,50,12
1745143604902,ENG 30,A01,886396,Staff,0,0,0,0
1745143604902,ENG 30,B01,886398,Staff,0,0,0,0
1745143605932,ENVR 102,A00,906150,Montejo; Carolina,23,0,25,2
1745143606960,ETHN 103A,A00,887236,Man; Simeon S,0,5,0,0
1745143607986,ETHN 113,A00,887239,Staff,20,0,30,10
1745143609015,ETHN 116,A00,887240,Staff,20,0,25,5
1745143610042,ETHN 117,A00,887241,Choi; Esther Min,27,0,30,3
1745143611068,ETHN 118,A00,887243,Staff,24,0,30,6
1745143612094,ETHN 127,A00,887248,Cuong; Marisol,12,0,15,3
1745143613120,ETHN 139,A00,887250,Staff,8,0,10,2
1745143614150,ETHN 142,A00,887252,Staff,18,0,30,12
1745143615177,ETHN 161,A00,887253,Browne; Errol Tsekani,28,0,30,2
1745143616202,ETHN 163FR,A00,887255,Burelle; Julie Sara Veronique,4,0,5,1
1745143617228,GLBH 20,A00,889149,Elwardani; Nile Regina,15,0,42,27
1745143619282,GLBH 111,A01,889152,Burgos; Jose L.,17,0,17,0
1745143620312,GLBH 150,A00,889181,Sloane; Julia Kathryn,0,1,15,15
1745143622369,HDS 60,A01,886406,Warstadt; Melissa Fawn,76,0,80,4
1745143623401,HIAF 111,A00,889324,Gyamfi; Bright,0,4,0,0
1745143624428,HIEA 131,A00,889328,Staff,14,0,32,18
1745143625453,HIEA 144,A00,889333,Henry; Todd A.,29,0,32,3
1745143626483,HIEA 154,A00,889336,Henry; Todd A.,28,0,32,4
1745143627511,HIEU 106,A00,889339,Staff,28,0,32,4
1745143629567,HIEU 114,A00,889340,Staff,18,0,32,14
1745143630594,HIEU 135GS,A00,889342,Patterson; Patrick H.,0,0,1,22
1745143631621,HIEU 137,A00,889343,Edington; Claire Ellen,12,0,25,13
1745143632645,HIEU 148,A00,889345,Staff,16,0,32,16
1745143633672,HIEU 154,A00,889346,Biess; Frank Peter,24,0,32,8
1745143634700,HILA 102,A00,889351,Staff,13,0,32,19
1745143635733,HILD 2A,A01,889221,Lewandoski; Julia Mavis,0,5,32,32
1745143636762,HILD 7B,A01,889225,Man; Simeon S,0,7,32,32
1745143637796,HILD 7C,A01,889288,Alvarez; Luis A,0,8,32,32
1745143638823,HILD 30,A01,889323,Staff,0,1,32,32
1745143640873,HISC 119,A00,889383,Golan; Tal,22,0,32,10
1745143641902,HIUS 103,A00,889384,Man; Simeon S,10,0,32,22
1745143642933,HIUS 117,A00,919797,Kwak; Nancy,23,0,32,9
1745143643956,HIUS 142A,A00,919788,Staff,24,0,32,8
1745143646008,HIUS 149,A00,889386,Gyamfi; Bright,0,1,0,0
1745143647033,HIUS 155,A00,889387,Alvarez; Luis A,19,0,32,13
1745143648060,HUM 3,A01,886499,Caldwell; Michael Alan,24,0,50,26
1745143649086,HUM 3GS,A00,886500,Rodriguez; Bretton Sigfred,0,0,0,26
1745143650112,HUM 3R,A01,886502,Markman; Kristina,0,32,50,50
1745143651141,HUM 4,A01,886504,Crum; Matthew Stephen,28,0,50,22
1745143651141,HUM 4,B01,886506,West; Geoffrey Scott,25,0,50,25
1745143652170,HUM 4GS,A00,886507,Staff,0,0,0,13
1745143653196,HUM 5,A01,886509,Staff,35,0,50,15
1745143654225,HUM 5R,A01,886511,Zavodny; Tatiana Sophia,0,32,50,50
1745143655251,JAPN 180,A00,886407,Staff,25,0,40,15
1745143656284,LATI 50,A01,886409,Martin-Cabrera; Luis,9,0,22,13
1745143656284,LATI 50,A02,886410,Martin-Cabrera; Luis,20,0,22,2
1745143656284,LATI 50,A03,886411,Martin-Cabrera; Luis,22,0,22,0
1745143656284,LATI 50,A04,886412,Martin-Cabrera; Luis,15,0,22,7
1745143657310,LAWS 101,A00,907664,Staff,36,0,60,24
1745143658341,LIAB 1A,A00,889388,Saab; Dima,19,0,20,1
1745143659373,LIAB 1AX,A00,889389,El Cheddadi; Youniss,19,0,20,1
1745143660399,LIFR 1C,A00,889391,Van Moer; Vinciane G,9,0,20,11
1745143661425,LIFR 1CX,A00,889392,Van Moer; Vinciane G,8,0,20,12
1745143662452,LIFR 1D,A00,889393,Van Moer; Vinciane G,11,0,20,9
1745143663483,LIFR 1DX,A00,889394,Van Moer; Vinciane G,11,0,20,9
1745143664511,LIGN 7,A00,886923,Staff,30,0,50,20
1745143665541,LIGN 17,A00,886924,Kehler; Andrew Scott,133,0,150,17
1745143666569,LTAM 110,A00,889395,Staff,17,0,30,13
1745143667594,LTCH 101,A00,889397,Staff,22,0,25,3
1745143668621,LTCS 130,A00,889398,Staff,23,0,25,2
1745143669645,LTEA 138,A00,889399,Staff,25,0,40,15
1745143670676,LTEN 149,A00,889400,Wesling; Megan E.,6,0,25,19
1745143671706,LTEN 169,A00,889401,Staff,24,0,25,1
1745143672732,LTEN 180,A00,889402,Staff,12,0,15,3
1745143673762,LTEN 181,A00,889403,Staff,23,0,25,2
1745143674791,LTWL 100,A00,889404,Myerston Santana; Jacobo,8,0,25,17
1745143675819,LTWL 180GS,A00,889405,Staff,6,0,20,14
1745143676846,LTWL 181,A00,889406,Staff,19,0,25,6
1745143677876,LTWL 184,A00,889475,Mukherjee; Silpa,21,0,25,4
1745143678901,LTWR 102C,A00,889486,Staff,29,0,30,1
1745143679925,LTWR 115W,A00,889491,Staff,3,0,15,12
1745143680951,MAE 8,A01,886905,Staff,0,2,0,0
1745143681984,MAE 11,A00,886906,Bandaru; Prabhakar,0,0,50,50
1745143683009,MAE 20,A00,886907,Evdokimenko; Ekaterina,50,0,70,20
1745143684036,MAE 30B,A00,886909,Ghazinejad; Maziar,28,0,45,17
1745143685064,MAE 101B,A00,886910,Saintillan; David,36,0,45,9
1745143686093,MAE 105,A00,886911,Bandaru; Prabhakar,26,0,50,24
1745143687123,MAE 107,A00,886912,Staff,22,0,60,38
1745143688153,MAE 143B,A00,886913,Bewley; Thomas R,14,0,40,26
1745143689180,MAE 148,A01,886915,Silberman; Jack,5,0,14,9
1745143690207,MAE 160,A00,886916,Evdokimenko; Ekaterina,41,0,60,19
1745143691237,MATH 3C,A01,889681,Staff,2,0,30,28
1745143692265,MATH 10A,A01,889760,Staff,28,0,30,2
1745143692265,MATH 10A,A02,889783,Staff,30,0,30,0
1745143693292,MATH 10B,A01,889785,Verstraete; Jacques Allan,0,2,30,30
1745143693292,MATH 10B,A02,889795,Verstraete; Jacques Allan,0,2,30,30
1745143693292,MATH 10B,B01,889797,Verstraete; Jacques Allan,0,0,30,30
1745143693292,MATH 10B,B02,889828,Verstraete; Jacques Allan,23,0,30,7
1745143694320,MATH 10C,A01,889849,Habib; Yousaf,18,0,30,12
1745143694320,MATH 10C,A02,889852,Habib; Yousaf,20,0,30,10
1745143694320,MATH 10C,A03,889853,Habib; Yousaf,24,0,30,6
1745143694320,MATH 10C,A04,889858,Habib; Yousaf,21,0,30,9
1745143694320,MATH 10C,B01,889861,Staff,12,0,30,18
1745143694320,MATH 10C,B02,889862,Staff,26,0,30,4
1745143694320,MATH 10C,B03,889863,Staff,28,0,30,2
1745143694320,MATH 10C,B04,889967,Staff,25,0,30,5
1745143695349,MATH 18,A01,889974,Staff,15,0,30,15
1745143695349,MATH 18,A02,889977,Staff,25,0,30,5
1745143695349,MATH 18,B01,889984,Hardiman; Liam,26,0,30,4
1745143695349,MATH 18,B02,889985,Hardiman; Liam,28,0,30,2
1745143696378,MATH 20A,A01,889990,Suk; Andrew Hoon,31,0,35,4
1745143697406,MATH 20B,A01,889993,Ohm; Ko Woon,21,0,30,9
1745143697406,MATH 20B,A02,889994,Ohm; Ko Woon,30,0,30,0
1745143697406,MATH 20B,B01,889996,Ohm; Ko Woon,25,0,30,5
1745143697406,MATH 20B,B02,889997,Ohm; Ko Woon,24,0,30,6
1745143698440,MATH 20C,A01,889999,Hammock; Frances H,22,0,30,8
1745143698440,MATH 20C,A02,890003,Hammock; Frances H,23,0,30,7
1745143698440,MATH 20C,B01,890006,Hammock; Frances H,11,0,30,19
1745143698440,MATH 20C,B02,890007,Hammock; Frances H,18,0,30,12
1745143699468,MATH 20D,A01,890011,Cheng; Hsiao-Bing,6,0,30,24
1745143699468,MATH 20D,A02,890012,Cheng; Hsiao-Bing,27,0,30,3
1745143699468,MATH 20D,B01,890016,Cheng; Hsiao-Bing,19,0,30,11
1745143699468,MATH 20D,B02,890017,Cheng; Hsiao-Bing,15,0,30,15
1745143700501,MATH 20E,A01,890026,Harel; Guershon,10,0,30,20
1745143700501,MATH 20E,A02,890029,Harel; Guershon,24,0,30,6
1745143700501,MATH 20E,B01,890033,Harel; Guershon,14,0,30,16
1745143700501,MATH 20E,B02,890101,Harel; Guershon,27,0,30,3
1745143701525,MATH 102,A01,890104,Staff,20,0,30,10
1745143701525,MATH 102,A02,890105,Staff,30,0,30,0
1745143702554,MATH 103B,A01,890116,Salehi Golsefidy; Alireza,8,0,30,22
1745143702554,MATH 103B,B01,890118,Staff,0,4,30,30
1745143703581,MATH 109,A01,890121,Aliabadi Sr.; Mohsen,6,0,30,24
1745143703581,MATH 109,B01,890124,Upadrashta; Pranav Kumar,23,0,30,7
1745143704608,MATH 120A,A01,890126,Eggers; John Dietrich,15,0,30,15
1745143705633,MATH 142B,A01,890128,Ioana; Adrian,17,0,30,13
1745143705633,MATH 142B,A02,890129,Ioana; Adrian,15,0,30,15
1745143706659,MATH 154,A01,890174,Staff,0,1,30,30
1745143706659,MATH 154,A02,890182,Staff,15,0,30,15
1745143707686,MATH 168A,A01,890197,Dumitriu; Ioana,22,0,35,13
1745143708718,MATH 170A,A01,890240,Nie; Jiawang,5,0,30,25
1745143708718,MATH 170A,A02,890241,Nie; Jiawang,18,0,30,12
1745143708718,MATH 170A,A03,890249,Nie; Jiawang,23,0,30,7
1745143709749,MATH 170B,A01,957891,Nag; Panchali,25,0,35,10
1745143711808,MATH 181A,A01,908025,Staff,0,8,35,35
1745143712833,MATH 193B,A01,890265,Staff,3,0,35,32
1745143713860,MGT 4,A01,890311,Anderson; John Charles,57,0,88,31
1745143714929,MGT 5,A00,907740,Staff,41,0,98,57
1745143715962,MGT 12,A00,890312,Lindenberger; Wade Douglas,70,0,98,28
1745143716986,MGT 16,A00,957883,Staff,84,0,98,14
1745143719041,MGT 45,A00,890314,Pecore; Joseph P.,57,0,98,41
1745143720069,MGT 71,A00,890315,Staff,6,0,98,92
1745143721096,MGT 100,A00,890316,Yavorsky; Daniel Ryan,59,0,98,39
1745143722122,MGT 103,A00,890317,Ehrich; Kristine R,77,0,98,21
1745143723153,MGT 105,A00,890356,Bates; Kenneth Walter,19,0,98,79
1745143724185,MGT 112,A00,890360,Ehrich; Kristine R,65,0,98,33
1745143725212,MGT 127R,A00,907732,Zhu; Kevin Xiaoguo,32,0,98,66
1745143726243,MGT 131B,A00,890361,Anderson; John Charles,75,0,98,23
1745143727270,MGT 137,A00,890362,Lindenberger; Wade Douglas,68,0,98,30
1745143728298,MGT 160,A00,890369,Johnson; Erik Barry,36,0,98,62
1745143730354,MGT 164,A00,890372,Zimmermann; Carsten,0,29,98,98
1745143731379,MGT 180,A00,890374,Bliss; Barbara Ann,31,0,98,67
1745143732412,MMW 15,A01,886414,Chang; Edmond Yi-Teh,0,10,28,28
1745143732412,MMW 15,A02,886415,Chang; Edmond Yi-Teh,0,10,28,28
1745143732412,MMW 15,A03,886416,Chang; Edmond Yi-Teh,0,8,28,28
1745143732412,MMW 15,A04,886417,Chang; Edmond Yi-Teh,0,8,28,28
1745143732412,MMW 15,B01,886419,Chang; Edmond Yi-Teh,0,8,28,28
1745143732412,MMW 15,B02,886420,Chang; Edmond Yi-Teh,0,9,28,28
1745143732412,MMW 15,B03,886421,Chang; Edmond Yi-Teh,0,9,28,28
1745143732412,MMW 15,B04,886422,Chang; Edmond Yi-Teh,0,9,28,28
1745143732412,MMW 15,C01,886424,Staff,0,10,28,28
1745143732412,MMW 15,C02,886425,Staff,0,10,28,28
1745143732412,MMW 15,C03,886426,Staff,0,9,28,28
1745143732412,MMW 15,C04,886427,Staff,0,9,28,28
1745143733444,MMW 15GS,A00,906910,Patterson; Patrick H.,5,0,28,23
1745143734471,MMW 122R,A01,886429,Rahimi; Babak,0,23,28,28
1745143734471,MMW 122R,A02,886430,Rahimi; Babak,0,23,28,28
1745143735509,MUS 1A,A01,890937,Staff,7,0,25,18
1745143735509,MUS 1A,A02,891035,Staff,15,0,25,10
1745143735509,MUS 1A,B00,907849,Staff,48,0,50,2
1745143735509,MUS 1A,B01,907850,Staff,25,0,25,0
1745143735509,MUS 1A,B02,907851,Staff,25,0,25,0
1745143737564,MUS 2AK,A00,957092,Ohnishi; Takae,15,0,15,0
1745143738598,MUS 4,A01,891044,Staff,6,0,25,19
1745143738598,MUS 4,A02,891045,Staff,24,0,25,1
1745143738598,MUS 4,B01,891048,Staff,20,0,25,5
1745143738598,MUS 4,B02,891050,Staff,25,0,25,0
1745143739628,MUS 5,A01,957506,Dubnov; Shlomo,4,0,25,21
1745143739628,MUS 5,A02,957622,Dubnov; Shlomo,21,0,25,4
1745143739628,MUS 5,A03,957623,Dubnov; Shlomo,23,0,25,2
1745143740657,MUS 6,A01,891053,Freitas Caetano; Marcelo,23,0,25,2
1745143740657,MUS 6,A02,891054,Freitas Caetano; Marcelo,23,0,25,2
1745143741686,MUS 7,A01,891081,Staff,0,0,25,25
1745143741686,MUS 7,A02,891082,Staff,14,0,25,11
1745143742715,MUS 8GS,A00,891118,Borgo; David Garcia,5,0,25,20
1745143743744,MUS 11,A01,891140,Staff,12,0,25,13
1745143743744,MUS 11,A02,891141,Staff,24,0,25,1
1745143744772,MUS 13,A01,891143,Staff,10,0,25,15
1745143744772,MUS 13,A02,891144,Staff,25,0,25,0
1745143745805,MUS 15,A01,891146,Staff,7,0,25,18
1745143745805,MUS 15,A02,891148,Staff,22,0,25,3
1745143745805,MUS 15,B01,891150,Staff,18,0,25,7
1745143745805,MUS 15,B02,891151,Staff,25,0,25,0
1745143746835,MUS 20,A01,891153,Staff,9,0,20,11
1745143746835,MUS 20,A02,891155,Staff,16,0,20,4
1745143747861,MUS 80,A00,891156,Staff,19,0,25,6
1745143747861,MUS 80,B00,891157,Staff,24,0,25,1
1745143748887,MUS 130,A00,891158,Ohnishi; Takae,35,0,35,0
1745143749917,MUS 150GS,A01,891160,Borgo; David Garcia,5,0,25,20
1745143750948,MUS 170,A01,891162,Freitas Caetano; Marcelo,21,0,25,4
1745143750948,MUS 170,A02,891164,Freitas Caetano; Marcelo,22,0,25,3
1745143751976,NANO 11,A00,886220,Vazquez Mena; Oscar,12,0,15,3
1745143753003,NANO 15,A01,886222,Drews; Aaron,9,0,10,1
1745143754028,NANO 104,A00,886224,Sirbuly; Donald,18,0,25,7
1745143755054,PH 40,A00,886528,Staff,29,0,40,11
1745143756081,PH 45,A01,886799,Staff,36,0,40,4
1745143757110,PH 110,A00,886802,Staff,7,0,40,33
1745143758171,PH 172,A00,906716,Staff,20,0,35,15
1745143759197,PH 191,A00,886803,Staff,23,0,40,17
1745143760225,PHIL 1,A00,889500,Staff,22,0,30,8
1745143761251,PHIL 10,A01,889549,Grush; Rick Scott,17,0,22,5
1745143761251,PHIL 10,A02,889551,Grush; Rick Scott,20,0,22,2
1745143762290,PHIL 28,A01,889559,Lamey; Andy M.,0,4,25,25
1745143762290,PHIL 28,A02,889561,Lamey; Andy M.,0,0,25,25
1745143762290,PHIL 28,A03,889572,Lamey; Andy M.,7,0,25,18
1745143763316,PHIL 35,A00,907839,Staff,32,0,33,1
1745143764340,PHIL 60,A00,889574,Staff,79,0,90,11
1745143765365,PHIL 105,A00,889579,Staff,0,1,0,0
1745143766393,PHIL 136,A00,889582,Fulkerson; Matthew Todd,27,0,45,18
1745143767425,PHIL 163,A01,889601,Staff,24,0,30,6
1745143767425,PHIL 163,B01,889606,Brandt; Reuven A,0,2,0,0
1745143768453,PHIL 164,A00,889610,Staff,20,0,30,10
1745143769479,PHIL 165,A00,889613,Staff,26,0,30,4
1745143770506,PHYS 1A,A00,886431,Staff,38,0,70,32
1745143771537,PHYS 1AL,001,886432,Tsai; Philbert S,0,0,30,30
1745143771537,PHYS 1AL,002,886436,Tsai; Philbert S,19,0,30,11
1745143772564,PHYS 1B,A00,886439,Staff,192,0,240,48
1745143773588,PHYS 1BL,001,886441,Tsai; Philbert S,0,1,30,30
1745143773588,PHYS 1BL,002,886444,Tsai; Philbert S,14,0,30,16
1745143774617,PHYS 1C,A00,896092,Arnold; Kam S,87,0,146,59
1745143775644,PHYS 1CL,001,886448,Tsai; Philbert S,0,4,30,30
1745143775644,PHYS 1CL,002,886449,Tsai; Philbert S,6,0,30,24
1745143775644,PHYS 1CL,003,886450,Tsai; Philbert S,22,0,30,8
1745143775644,PHYS 1CL,004,886451,Tsai; Philbert S,16,0,30,14
1745143776672,PHYS 2B,A01,886457,Staff,86,0,115,29
1745143777704,PHYS 2C,A01,886460,Shotwell; Brian,0,0,65,65
1745143778734,PHYS 2CL,A01,886467,Staff,0,3,28,28
1745143778734,PHYS 2CL,A02,886468,Staff,5,0,28,23
1745143779761,PHYS 2D,A01,886470,Staff,17,0,50,33
1745143780788,PHYS 4B,A01,886475,Grinstein; Benjamin,87,0,100,13
1745143781816,POLI 5,A00,891173,Desposato; Scott,17,0,25,8
1745143782842,POLI 5D,A01,891175,Staff,5,0,5,0
1745143782842,POLI 5D,B01,891178,Staff,5,0,5,0
1745143783869,POLI 11,A00,891179,Ferree; Karen E,3,0,25,22
1745143784896,POLI 12,A00,891180,Staff,21,0,30,9
1745143785924,POLI 27,A01,891182,Staff,29,0,75,46
1745143786950,POLI 30,A00,891183,Staff,0,3,30,30
1745143787983,POLI 100B,A00,891244,Staff,0,8,20,20
1745143789012,POLI 100I,A00,891247,Staff,19,0,30,11
1745143790040,POLI 104J,A00,891248,Nichter; Maysa,18,0,30,12
1745143791071,POLI 104U,A00,891250,Nichter; Maysa,9,0,30,21
1745143792104,POLI 108,A00,891253,Staff,0,0,0,4
1745143793130,POLI 110B,A00,891255,Wiens; David,22,0,25,3
1745143794158,POLI 112A,A00,891256,Wiens; David,15,0,25,10
1745143795189,POLI 114BR,A00,891261,Staff,22,0,30,8
1745143796215,POLI 117R,A00,891262,Forman; Fonna,12,0,50,38
1745143797241,POLI 118,A00,891264,Ingham; Sean,22,0,25,3
1745143798265,POLI 124A,A00,891265,Staff,19,0,20,1
1745143799297,POLI 125D,A00,891266,Nichter; Simeon C,9,0,25,16
1745143800323,POLI 126,A00,891268,Nichter; Simeon C,11,0,25,14
1745143801353,POLI 126AA,A00,891272,Staff,19,0,25,6
1745143802388,POLI 130AA,A00,891273,Staff,17,0,20,3
1745143803413,POLI 134AA,A00,891274,Staff,12,0,20,8
1745143805471,POLI 138,A00,891278,Staff,22,0,25,3
1745143806496,POLI 142K,A00,891280,Staff,17,0,25,8
1745143807526,POLI 142M,A00,891281,Gartzke; Erik,22,0,30,8
1745143808556,POLI 142P,A00,891284,Staff,21,0,30,9
1745143809589,POLI 143,A00,891285,Gartzke; Erik,17,0,30,13
1745143810613,POLI 153,A00,891286,Staff,20,0,20,0
1745143811640,POLI 170A,A00,891288,Staff,19,0,25,6
1745143812667,POLI 175,A00,891290,Staff,18,0,20,2
1745143813697,PSYC 1,A00,890674,Steiner; Eric Tomas,0,4,45,45
1745143814724,PSYC 2,A00,890676,Albright; Thomas D,25,0,35,10
1745143815750,PSYC 3,A00,890679,Staff,18,0,20,2
1745143816775,PSYC 60,A01,890684,Rickard; Timothy C.,7,0,45,38
1745143817803,PSYC 70,A01,890689,Geller; Emma Harlan,14,0,30,16
1745143818831,PSYC 100,A00,890690,Lacefield; Katharine I,0,43,180,180
1745143819858,PSYC 102,A00,890695,Staff,25,0,40,15
1745143820889,PSYC 105,A00,890699,Geller; Emma Harlan,78,0,100,22
1745143821920,PSYC 106,A00,890701,Gorman; Michael R.,15,0,30,15
1745143822948,PSYC 108,A00,890704,Adrian; Julia Anna,0,23,50,50
1745143823979,PSYC 118,A01,890712,Staff,18,0,30,12
1745143825005,PSYC 124,A00,890716,Chapman; Eddie Nathaniel,36,0,60,24
1745143826032,PSYC 131,A00,890717,Anagnostaras; Stephan,6,0,80,74
1745143827057,PSYC 137,A00,890719,Winkielman; Piotr,0,2,30,30
1745143828087,PSYC 144,A00,890721,Adrian; Julia Anna,0,3,45,45
1745143829120,PSYC 162,A00,890805,Staff,21,0,75,54
1745143830184,PSYC 169,A00,890810,Staff,0,15,30,30
1745143831212,PSYC 172,A00,890814,Gorman; Michael R.,14,0,30,16
1745143832238,PSYC 181,A00,890818,Anagnostaras; Stephan,63,0,200,137
1745143833262,PSYC 189,A00,890823,Staff,11,0,30,19
1745143834299,PSYC 191,A00,890884,Rickard; Timothy C.,0,11,35,35
1745143835328,PSYC 193,A00,890913,Staff,22,0,30,8
1745143835328,PSYC 193,B00,890914,Chapman; Eddie Nathaniel,25,0,30,5
1745143836358,PSYC 193L,A01,890918,Lowe; Angela Beth,29,0,30,1
1745143836358,PSYC 193L,B01,890921,Hurwitz; Ethan Scott,28,0,30,2
1745143836358,PSYC 193L,C01,890928,Staff,30,0,30,0
1745143837388,RELI 149,A00,886806,Rahimi; Babak,23,0,40,17
1745143838413,SE 9,A01,886814,Staff,13,0,20,7
1745143839442,SE 101B,A01,886816,Chadha; Mayank,8,0,30,22
1745143840470,SE 110B,A00,886818,Zhu; Qiang,0,16,45,45
1745143841500,SE 125,A01,886830,Staff,10,0,30,20
1745143842527,SE 130B,A01,886835,Staff,19,0,40,21
1745143843556,SE 131A,A01,886838,Krysl; Petr,37,0,55,18
1745143844586,SE 154,A00,886840,Staff,35,0,50,15
1745143845612,SE 164GS,A01,886849,Staff,13,0,20,7
1745143846639,SE 167GS,A01,886853,Staff,13,0,20,7
1745143847668,SIO 25,A01,890107,Staff,23,0,30,7
1745143848699,SIO 45,A00,890109,Cook; Geoffrey W,137,0,200,63
1745143849730,SIO 109R,A00,890110,Forman; Fonna,0,11,20,20
1745143850761,SIO 187,A01,890114,Kacev; David,21,0,40,19
1745143851788,SOCI 1,A01,890431,Thorpe; Charles Robert,21,0,30,9
1745143851788,SOCI 1,A02,890518,Thorpe; Charles Robert,30,0,30,0
1745143852817,SOCI 2,A01,957978,Staff,0,0,0,0
1745143852817,SOCI 2,A02,957979,Staff,0,3,0,0
1745143853849,SOCI 20,A01,890523,Calderon-Zaks; Michael Aar,24,0,30,6
1745143853849,SOCI 20,A02,890526,Calderon-Zaks; Michael Aar,29,0,30,1
1745143854883,SOCI 30,A01,890533,Pardo Guerra; Juan Pablo,37,0,40,3
1745143855912,SOCI 40,A01,890535,Staff,32,0,45,13
1745143856937,SOCI 104Q,A00,890559,Staff,20,0,30,10
1745143857969,SOCI 106,A00,890560,Arnal; Maud Marie Leonie,22,0,30,8
1745143858998,SOCI 110,A00,890567,Holkenbrink-Monk; Charlene,22,0,30,8
1745143860033,SOCI 112,A00,890568,Victoria Torres; Pablo,0,0,45,45
1745143861108,SOCI 115,A00,890597,Arnal; Maud Marie Leonie,33,0,45,12
1745143863165,SOCI 121,A00,890604,Pardo Guerra; Juan Pablo,40,0,45,5
1745143864194,SOCI 126,A01,890608,Staff,8,0,10,2
1745143865219,SOCI 127,A00,890609,Staff,23,0,30,7
1745143866246,SOCI 131,A00,890610,Thorpe; Charles Robert,38,0,45,7
1745143867278,SOCI 135,A00,890615,Payne; Christine Anna,19,0,45,26
1745143868306,SOCI 139,A00,890620,Staff,43,0,45,2
1745143869337,SOCI 148E,A00,890622,Calderon-Zaks; Michael Aar,39,0,45,6
1745143870367,SOCI 150,A00,890623,Kohler; Kristopher M.,36,0,45,9
1745143871394,SOCI 157,A00,890625,Jules-Rosette; Bennetta W.,18,0,20,2
1745143872419,SOCI 160,A00,890627,Payne; Christine Anna,26,0,45,19
1745143873451,SYN 1,A00,886855,Fish; Gwendolyn Anne,0,0,0,0
1745143873451,SYN 1,B00,906086,Fish; Gwendolyn Anne,0,0,0,2
1745143874480,SYN 2R,A00,886860,Staff,0,15,15,15
1745143874480,SYN 2R,B00,906106,Atkinson; Arthur Laird,0,14,15,15
1745143875510,SYN 100,A01,886866,Browne; Emily,0,29,20,20
1745143875510,SYN 100,B01,906128,Rock; Martin,0,4,20,20
1745143875510,SYN 100,C01,906140,Deavenport; James Cary,0,2,20,20
1745143875510,SYN 100,D01,907816,Deavenport; James Cary,0,3,20,20
1745143876539,TDAC 1,A00,890286,Walsh; Kim C.,11,0,20,9
1745143877567,TDAC 101,A00,890296,Basso; Beatrice,18,0,20,2
1745143878596,TDDE 131,A00,890297,Staff,47,0,50,3
1745143879622,TDDM 1,A00,890287,Weinberg; Sadie,26,0,30,4
1745143880651,TDGE 11,A00,890288,Fulton; Julia,155,0,200,45
1745143880651,TDGE 11,B00,890289,Castro; Robert Jess,188,0,200,12
1745143881684,TDGE 25,B00,957359,Walsh; Kim C.,9,0,20,11
1745143882711,TDGE 40,A01,890292,Power; Jade Yukana,28,0,30,2
1745143883736,TDGE 124,A00,890298,Havis; Allan,12,0,50,38
1745143884766,TDGE 131R,A00,890299,Burelle; Julie Sara Veronique,20,0,42,22
1745143885797,TDHT 101,A00,890300,Staff,12,0,20,8
1745143886826,TDHT 109,A01,890302,Anderson; Mysia Anyse,31,0,40,9
1745143887856,TDMV 1,A00,890293,Arcidiacono; Kristin,20,0,30,10
1745143888883,TDMV 2,A00,890294,Weinberg; Sadie,26,0,30,4
1745143889909,TDMV 3,A00,957878,Arcidiacono; Kristin,27,0,30,3
1745143891966,TDMV 138,A00,890304,Jun; Grace Shin Hae,25,0,40,15
1745143892991,TDMV 140,A00,890305,Corrales; Joseph Bernales,28,0,30,2
1745143894017,TDMV 142,A00,890307,Caligagan; Tony,30,0,40,10
1745143895044,TDMV 144,A00,890308,Camaya; Michelle Ann,26,0,30,4
1745143896070,TDPW 1,A00,890295,Stein; Deborah Isobel,5,0,20,15
1745143897104,USP 2,A01,890272,Lerner; Amy M,8,0,20,12
1745143898130,USP 3,A01,890274,Staff,21,0,30,9
1745143899157,USP 15,A01,890276,Sun; Feiyang,21,0,30,9
1745143900183,USP 25,A00,890277,Shenkman; Michael Thomas,21,0,25,4
1745143901210,USP 138,A00,890278,Staff,15,0,25,10
1745143902235,USP 143,A00,890279,Staff,30,0,70,40
1745143903267,USP 144,A00,890280,Chowdhury; Muhammed Zohir,19,0,30,11
1745143904298,USP 150,A00,890281,Boomhower; Matthew Charles,19,0,30,11
1745143905323,USP 151,A00,890282,Staff,17,0,20,3
1745143906350,USP 162,A00,890283,Andrews; Abigail Leslie,17,0,20,3
1745143907377,USP 168,A00,920477,Kwak; Nancy,2,0,5,3
1745143908404,USP 181,A00,890284,Staff,11,0,20,9
1745143909433,USP 191A,A00,890285,Staff,15,0,20,5
1745143910462,VIS 101,A00,886512,Staff,37,0,75,38
1745143911492,VIS 103,A00,886513,Cruz; Edwin Teddy,65,0,75,10
1745143912517,VIS 108,A00,886514,Staff,7,0,15,8
1745143913544,VIS 127P,A00,886515,Shen; Kuiyi,92,0,146,54
1745143914570,VIS 149,A00,886516,Yoldas; Pinar,1,0,15,14
1745143915600,VIS 164,A00,886526,Erdmann; Dean,21,0,22,1
1745143916627,VIS 194S,A00,886527,Staff,61,0,75,14
1745143917653,WCWP 10A,C00,886484,Staff,13,0,15,2
1745143918680,WCWP 10B,A00,886490,Staff,5,0,15,10
1745143918680,WCWP 10B,B00,886491,Staff,0,1,0,0
1745143918680,WCWP 10B,C00,886492,Staff,10,0,15,5
1745143919704,WCWP 100,A00,886494,Staff,0,3,15,15
1745143921800,AAS 10,A01,886199,Childs; Dennis R.,0,2,0,0
1745143922832,ANAR 104,A01,886940,Shtienberg; Gilad,27,0,30,3
1745143923901,ANAR 120,A00,886953,Staff,13,0,20,7
1745143924933,ANBI 148,A01,886955,Wilder; Linnea Lorene,32,0,40,8
1745143926989,ANSC 122,A00,886957,Staff,28,0,30,2
1745143928018,ANSC 150,A00,886958,Sloane; Julia Kathryn,6,0,15,9
1745143929046,ANSC 156,A00,886959,Jenkins; Janis A.,2,0,15,13
1745143930074,ANSC 180,A00,886960,Staff,12,0,17,5
1745143931103,ANSC 188,A00,886961,Jassal; Aftab,10,0,25,15
1745143932128,ANSC 190,A00,886962,Jassal; Aftab,14,0,25,11
1745143933153,ANSC 191,A00,886963,Staff,18,0,20,2
1745143934182,ANTH 3,A01,891689,Staff,19,0,20,1
1745143935212,ANTH 5,A00,886933,Semendeferi; Ekaterini,18,0,20,2
1745143936242,ANTH 10,A00,886934,Staff,0,8,30,30
1745143937268,ANTH 21,A01,886936,Staff,44,0,60,16
1745143938294,ANTH 23,A01,886938,Staff,94,0,100,6
1745143939321,ANTH 105,A00,886964,Stewart; Alexander B,94,0,100,6
1745143940349,ANTH 108,A00,886965,Pedersen; David,10,0,20,10
1745143941380,AWP 10,001,886147,Staff,0,0,0,0
1745143941380,AWP 10,002,886148,Staff,0,0,0,0
1745143941380,AWP 10,003,886149,Staff,0,0,0,0
1745143941380,AWP 10,004,886150,Staff,0,0,0,0
1745143941380,AWP 10,005,886151,Staff,0,0,0,0
1745143941380,AWP 10,006,886152,Staff,0,0,0,0
1745143941380,AWP 10,007,886153,Staff,0,0,0,0
1745143941380,AWP 10,008,886154,Staff,0,0,0,0
1745143941380,AWP 10,009,886155,Staff,0,0,0,0
1745143941380,AWP 10,010,886156,Staff,0,0,0,0
1745143941380,AWP 10,011,886158,Staff,0,0,0,0
1745143941380,AWP 10,012,886160,Staff,0,0,0,0
1745143941380,AWP 10,013,886161,Staff,0,0,0,0
1745143941380,AWP 10,014,886162,Staff,0,0,0,0
1745143941380,AWP 10,015,886163,Staff,0,0,0,0
1745143941380,AWP 10,016,886164,Staff,0,0,0,0
1745143941380,AWP 10,017,886165,Staff,0,0,0,0
1745143941380,AWP 10,018,886166,Staff,0,0,0,0
1745143941380,AWP 10,019,886168,Staff,0,0,0,0
1745143941380,AWP 10,020,886170,Staff,0,0,0,0
1745143941380,AWP 10,021,886172,Staff,0,0,0,0
1745143942408,AWP 10R,001,886173,Staff,0,0,0,0
1745143942408,AWP 10R,002,886174,Staff,0,1,0,0
1745143942408,AWP 10R,003,886175,Staff,0,0,0,0
1745143942408,AWP 10R,004,886176,Staff,0,0,0,0
1745143942408,AWP 10R,005,886177,Staff,0,0,0,0
1745143942408,AWP 10R,006,886178,Staff,0,0,0,0
1745143942408,AWP 10R,007,886179,Staff,0,0,0,0
1745143942408,AWP 10R,008,886181,Staff,0,0,0,0
1745143942408,AWP 10R,009,886182,Staff,0,0,0,0
1745143942408,AWP 10R,010,886183,Staff,0,0,0,0
1745143942408,AWP 10R,011,886184,Staff,0,0,0,0
1745143942408,AWP 10R,012,886185,Staff,0,0,0,0
1745143942408,AWP 10R,013,886186,Staff,0,0,0,0
1745143942408,AWP 10R,014,886187,Staff,0,0,0,0
1745143942408,AWP 10R,015,886188,Staff,0,0,0,0
1745143942408,AWP 10R,016,886189,Staff,0,0,0,0
1745143943435,AWP 102R,A00,886190,Staff,0,0,0,0
1745143943435,AWP 102R,B00,886191,Staff,0,0,0,0
1745143944463,BENG 100,A01,886193,Staff,19,0,30,11
1745143945491,BENG 122A,A01,886195,Hasty; Jeff M,20,0,30,10
1745143946518,BENG 166A,A00,886196,Sah; Robert Lie-Yuan,0,3,20,20
1745143947544,BIBC 102,A01,894320,Staff,0,2,46,46
1745143947544,BIBC 102,A02,894321,Staff,0,0,46,46
1745143947544,BIBC 102,A03,894344,Staff,21,0,46,25
1745143947544,BIBC 102,A04,894345,Staff,30,0,47,17
1745143948580,BICD 100R,A01,894365,Smith; Laurie,1,3,58,57
1745143948580,BICD 100R,A02,894366,Smith; Laurie,0,1,58,58
1745143948580,BICD 100R,A03,894367,Smith; Laurie,13,0,59,46
1745143949616,BICD 136,A01,894383,Gustafson-Brown; Cindy,16,0,50,34
1745143950643,BIEB 102,A01,894494,Butler; Shannon Rhey,67,0,130,63
1745143952697,BIEB 150,A01,894617,Wills; Christopher,0,3,13,13
1745143952697,BIEB 150,A02,894631,Wills; Christopher,0,3,13,13
1745143952697,BIEB 150,A03,894937,Wills; Christopher,0,3,13,13
1745143952697,BIEB 150,A04,894946,Wills; Christopher,0,1,11,11
1745143953723,BIEB 194,A00,906141,Kurle; Carolyn M.,14,0,20,6
1745143954750,BILD 1,A01,894154,Staff,8,0,19,11
1745143954750,BILD 1,A02,894155,Staff,15,0,19,4
1745143954750,BILD 1,A03,894160,Staff,18,0,19,1
1745143954750,BILD 1,A04,894161,Staff,16,0,18,2
1745143955781,BILD 2,A01,894168,Staff,0,0,50,50
1745143955781,BILD 2,A02,894169,Staff,0,0,50,50
1745143955781,BILD 2,A03,894179,Staff,27,0,50,23
1745143955781,BILD 2,A04,894203,Staff,42,0,50,8
1745143956811,BILD 3,A01,894213,Staff,24,0,31,7
1745143956811,BILD 3,A02,894214,Staff,28,0,31,3
1745143956811,BILD 3,A03,894235,Staff,30,0,31,1
1745143956811,BILD 3,A04,894236,Staff,29,0,32,3
1745143957843,BILD 4,A01,894253,Reuther; Keefe,12,0,24,12
1745143957843,BILD 4,A02,894258,Reuther; Keefe,19,0,24,5
1745143958869,BILD 5,A01,894276,Reuther; Keefe,40,0,50,10
1745143958869,BILD 5,A02,894277,Reuther; Keefe,48,0,50,2
1745143958869,BILD 5,A03,894290,Reuther; Keefe,47,0,50,3
1745143958869,BILD 5,A04,894291,Reuther; Keefe,50,0,50,0
1745143959897,BILD 24,A01,894297,Pirino; Giorgia,45,0,60,15
1745143960929,BIMM 100,A01,895012,Staff,0,14,0,1
1745143960929,BIMM 100,A02,895013,Staff,0,6,0,2
1745143960929,BIMM 100,A03,895014,Staff,0,7,0,0
1745143960929,BIMM 100,A04,895015,Staff,0,4,0,0
1745143961962,BIMM 101,A01,895017,McDonnell; Lisa Marie,0,2,24,24
1745143961962,BIMM 101,A02,895018,McDonnell; Lisa Marie,0,1,24,24
1745143961962,BIMM 101,B01,895020,McDonnell; Lisa Marie,0,3,24,24
1745143961962,BIMM 101,B02,895021,McDonnell; Lisa Marie,0,2,24,24
1745143962992,BIMM 110,A01,895023,Staff,7,0,25,18
1745143962992,BIMM 110,A02,895024,Staff,11,0,25,14
1745143962992,BIMM 110,A03,895025,Staff,22,0,25,3
1745143962992,BIMM 110,A04,895031,Staff,21,0,25,4
1745143964021,BIMM 120,A01,895114,Gustafson-Brown; Cindy,8,0,28,20
1745143964021,BIMM 120,A02,895126,Gustafson-Brown; Cindy,19,0,27,8
1745143965048,BIPN 100,A01,895130,Yang; Mingyu,13,0,38,25
1745143965048,BIPN 100,A02,895131,Yang; Mingyu,33,0,38,5
1745143965048,BIPN 100,A03,895132,Yang; Mingyu,33,0,38,5
1745143965048,BIPN 100,A04,895133,Yang; Mingyu,30,0,36,6
1745143966080,BIPN 120,A01,895135,Cooke; James Edward,0,2,13,13
1745143966080,BIPN 120,A02,895136,Cooke; James Edward,0,1,13,13
1745143966080,BIPN 120,A03,895137,Cooke; James Edward,0,0,13,13
1745143966080,BIPN 120,A04,895156,Cooke; James Edward,3,0,11,8
1745143967112,BIPN 134,A01,895235,Cooke; James Edward,0,2,25,25
1745143967112,BIPN 134,A02,895237,Cooke; James Edward,0,0,25,25
1745143967112,BIPN 134,A03,895240,Cooke; James Edward,12,0,25,13
1745143967112,BIPN 134,A04,895270,Cooke; James Edward,24,0,25,1
1745143968137,BIPN 189,A00,892103,Staff,0,20,9,9
1745143970193,CAT 124,A01,922009,Staff,0,1,20,20
1745143971236,CAT 125R,A00,886390,Morales; Celeste Georgianna,4,0,20,16
1745143971236,CAT 125R,B00,886391,Irwin; Matthew Joseph,0,1,20,20
1745143971236,CAT 125R,C00,886392,Smith; Lauryn Alissa,11,0,20,9
1745143971236,CAT 125R,D00,886393,Vanderschuit; Maya Alysia,6,0,20,14
1745143971236,CAT 125R,E00,886394,Marchisotto; Jennifer Anne,0,2,20,20
1745143972262,CENG 15,A01,886218,Drews; Aaron,1,0,5,4
1745143973289,CENG 113,A00,886219,Opatkiewicz; Justin Paul,16,0,25,9
1745143974319,CGS 101,A00,887044,Staff,13,0,20,7
1745143975345,CGS 105,A01,887046,Staff,16,0,25,9
1745143976370,CGS 112,A00,887047,Cuong; Marisol,12,0,15,3
1745143977399,CGS 113,A00,887048,Staff,24,0,30,6
1745143978427,CGS 120,A00,887049,Staff,12,0,17,5
1745143979457,CHEM 6A,A01,886336,Lam; Tin Yiu,44,0,50,6
1745143979457,CHEM 6A,A02,886338,Lam; Tin Yiu,43,0,50,7
1745143980484,CHEM 6B,A01,886341,Hopkins; Patrycja Anna,21,0,50,29
1745143980484,CHEM 6B,A02,886343,Hopkins; Patrycja Anna,46,0,50,4
1745143981517,CHEM 6C,A01,886346,Albizati; Kim F.,0,1,50,50
1745143981517,CHEM 6C,A02,886348,Albizati; Kim F.,38,0,50,12
1745143982548,CHEM 40A,A01,886352,Klosterman; Jeremy K,70,0,100,30
1745143983573,CHEM 40B,A01,886356,Klosterman; Jeremy K,0,4,100,100
1745143984598,CHEM 41B,A01,886360,Theodorakis; Emmanuel,30,0,50,20
1745143984598,CHEM 41B,A02,886362,Theodorakis; Emmanuel,46,0,50,4
1745143985622,CHIN 165A,A00,886382,Xu; Li,19,0,20,1
1745143986653,CLAS 120,A00,886387,Myerston Santana; Jacobo,36,0,40,4
1745143987679,COGS 9,A01,886967,Shannon; Kyle Michael,49,0,60,11
1745143988707,COGS 11,A01,886969,Staff,18,0,30,12
1745143989733,COGS 14A,A01,886971,Staff,26,0,60,34
1745143990758,COGS 14B,A01,886973,Hoffman; Drew Ellen,18,0,60,42
1745143991788,COGS 18,A01,886975,Morgan; Eric,41,0,60,19
1745143992817,COGS 20,A01,886977,Staff,6,0,8,2
1745143992817,COGS 20,A02,886978,Staff,6,0,7,1
1745143993843,COGS 100,A01,907783,Staff,6,0,30,24
1745143994870,COGS 101B,A01,886980,Staff,0,10,30,30
1745143995896,COGS 101C,A01,886982,Delgado; Tania,0,6,30,30
1745143996926,COGS 102A,A01,886984,Johnson; Christine M.,13,0,30,17
1745143997953,COGS 118B,A01,886986,Staff,0,25,60,60
1745143998979,COGS 150,A01,886988,Bergen; Benjamin,16,0,30,14
1745144000008,COGS 153,A00,886989,Delgado; Tania,0,6,30,30
1745144001036,COGS 186,A01,886991,Staff,3,0,30,27
1745144002063,COGS 187A,A01,886993,Boyle; Mary E. T.,12,0,30,18
1745144003087,COGS 189,A00,886994,Staff,13,0,30,17
1745144004117,COMM 10,A01,886996,Staff,11,0,25,14
1745144004117,COMM 10,A02,886997,Staff,21,0,25,4
1745144005144,COMM 20,A01,886999,Leuning; Grant Maurstad,33,0,40,7
1745144007197,COMM 100A,A01,887002,Staff,0,0,25,25
1745144007197,COMM 100A,A02,887003,Staff,20,0,25,5
1745144008226,COMM 100B,A01,887005,Staff,0,1,25,25
1745144009252,COMM 106D,A00,887006,Staff,22,0,40,18
1745144010283,COMM 110G,A00,887007,Whitworth-Smith; Andrew C,17,0,40,23
1745144011314,COMM 111B,A00,887008,Staff,31,0,40,9
1745144012342,COMM 113T,A00,887009,Abuelhiga; Soraya Jill,30,0,40,10
1745144012342,COMM 113T,B00,906733,Staff,40,0,40,0
1745144013371,COMM 145,A00,887010,Staff,21,0,40,19
1745144014399,COMM 146,A00,887054,Staff,31,0,40,9
1745144015428,COMM 190,A00,887012,Staff,9,0,23,14
1745144016454,CSE 8A,A50,887015,Cao; Yingjun,68,0,85,17
1745144017480,CSE 11,A01,887017,Cao; Yingjun,35,0,70,35
1745144018506,CSE 20,A01,887019,Staff,35,0,50,15
1745144019533,CSE 21,A01,887021,Braun; Oliver,81,0,100,19
1745144019533,CSE 21,B01,892583,Staff,48,0,50,2
1745144020559,CSE 30,A01,887025,Eldon; John,161,0,200,39
1745144021584,CSE 100,A01,887027,Staff,28,0,50,22
1745144021584,CSE 100,A02,887028,Staff,43,0,50,7
1745144022609,CSE 101,A01,887030,Braun; Oliver,79,0,100,21
1745144022609,CSE 101,B01,887032,Jones; Miles E,0,1,50,50
1745144022609,CSE 101,B02,887033,Jones; Miles E,13,0,50,37
1745144023635,CSE 105,A01,908084,Jones; Miles E,36,0,50,14
1745144023635,CSE 105,A02,908087,Jones; Miles E,38,0,50,12
1745144024662,CSE 135,A01,887035,Powell; Thomas Allan,8,0,50,42
1745144025689,CSE 142,A01,887037,Staff,22,0,60,38
1745144026715,CSE 142L,A01,887039,Staff,42,0,60,18
1745144027743,CSE 151A,A01,887041,Solares; Edwin A,60,0,100,40
1745144028770,CSE 175,A01,887043,Kumar; Rakesh,30,0,30,0
1745144029796,CSS 1,A01,886389,Staff,12,0,40,28
1745144030826,DSC 30,A01,908097,Liao; Soohyun Nam,54,0,75,21
1745144031869,DSC 40A,A01,908099,Shannon; Kyle Michael,37,0,50,13
1745144032899,DSC 40B,A01,908112,Staff,28,0,50,22
1745144033925,DSC 80,A01,908116,Staff,32,0,60,28
1745144034951,DSC 197,001,956863,Eldridge; Justin Matthew,9999,0,9999,0
1745144035980,ECE 5,A01,886400,Morris; Karcher William,3,0,6,3
1745144035980,ECE 5,A02,886401,Morris; Karcher William,5,0,6,1
1745144037005,ECE 148,A01,886403,Silberman; Jack,0,8,14,14
1745144038034,ECON 1,A01,887265,Crane; Meredith Helen,25,0,70,45
1745144038034,ECON 1,B01,887268,Staff,44,0,50,6
1745144039064,ECON 2,A01,887273,Crane; Meredith Helen,61,0,70,9
1745144040091,ECON 3,A01,887279,Rondina; Giacomo,44,0,70,26
1745144041117,ECON 4,A01,887282,Anderson; John Charles,0,1,10,10
1745144042146,ECON 5,A01,887285,Staff,39,0,45,6
1745144042146,ECON 5,B01,887292,Staff,43,0,45,2
1745144043173,ECON 100A,A01,887337,Newhouse; Herbert S,58,0,70,12
1745144043173,ECON 100A,B01,887349,Staff,45,0,50,5
1745144044200,ECON 100B,A01,887361,Du; Songzi,42,0,70,28
1745144045233,ECON 100C,A01,887445,Newhouse; Herbert S,61,0,70,9
1745144046260,ECON 105,A00,887488,Vespa; Emanuel Ignacio,24,0,35,11
1745144047290,ECON 109,A01,887506,Staff,29,0,35,6
1745144048321,ECON 110A,A01,887568,Alon; Titan Michael,1,0,35,34
1745144048321,ECON 110A,B01,907601,Alon; Titan Michael,27,0,35,8
1745144049346,ECON 110B,A01,887598,Levkoff; Steven B.,0,7,70,70
1745144050378,ECON 112,A00,887599,Rondina; Giacomo,20,0,35,15
1745144051405,ECON 120A,A01,887603,Dai; Yinlin,46,0,70,24
1745144052432,ECON 120C,A01,887608,Sun; Yixiao,0,0,35,35
1745144052432,ECON 120C,B01,887614,Sun; Yixiao,13,0,35,22
1745144053462,ECON 138,A00,887621,Bharadwaj; Prashant,0,18,20,20
1745144054492,ECON 171,A01,907666,Staff,27,0,35,8
1745144055518,ECON 175,A00,887626,Wu; Pak Yeung,27,0,35,8
1745144056548,ECON 190,A00,887640,Vespa; Emanuel Ignacio,26,0,35,9
1745144057580,EDS 25,A01,888197,Staff,0,0,0,0
1745144057580,EDS 25,A02,888209,Staff,0,0,0,0
1745144057580,EDS 25,A03,888210,Staff,0,0,0,0
1745144057580,EDS 25,A04,888212,Staff,0,0,0,0
1745144057580,EDS 25,A05,888213,Staff,0,0,0,0
1745144057580,EDS 25,A06,888214,Staff,0,0,0,0
1745144057580,EDS 25,A07,888235,Staff,0,0,0,0
1745144057580,EDS 25,A08,888236,Staff,0,0,0,0
1745144057580,EDS 25,A09,888240,Staff,0,0,0,0
1745144057580,EDS 25,A10,888244,Staff,0,0,0,0
1745144057580,EDS 25,B01,888273,Staff,0,0,0,0
1745144057580,EDS 25,B02,888285,Staff,0,0,0,0
1745144057580,EDS 25,B03,888423,Staff,29,0,30,1
1745144057580,EDS 25,B04,888432,Staff,0,0,0,0
1745144057580,EDS 25,B05,888433,Staff,0,0,0,0
1745144057580,EDS 25,B06,888467,Staff,0,0,0,0
1745144057580,EDS 25,B07,888468,Staff,0,0,0,0
1745144057580,EDS 25,B08,888479,Staff,0,0,0,0
1745144057580,EDS 25,B09,888484,Staff,0,0,0,0
1745144057580,EDS 25,B10,888487,Staff,0,0,0,0
1745144058608,EDS 38,A01,907700,Choi; Bailey Miyeon,30,0,30,0
1745144059639,EDS 112,A01,888601,Chapman; Thandeka K,23,0,40,17
1745144060671,EDS 115,A00,888697,Mendez; Kathrina Mendoza,17,0,30,13
1745144061698,EDS 116,A01,888893,Staff,38,0,40,2
1745144063958,EDS 124AR,A00,889133,Staff,33,0,50,17
1745144063958,EDS 124AR,B00,907471,Simon; Elizabeth A,42,0,50,8
1745144064986,EDS 124BR,A00,889134,Staff,57,0,100,43
1745144066015,EDS 125,A00,889135,Staff,26,0,30,4
1745144067044,EDS 126,A01,889138,Staff,37,0,40,3
1745144068071,EDS 164R,A01,889142,Wishard Guerra; Alison G.,38,0,50,12
1745144069100,ENG 30,A01,886396,Staff,0,0,0,0
1745144069100,ENG 30,B01,886398,Staff,0,0,0,0
1745144070182,ENVR 102,A00,906150,Montejo; Carolina,23,0,25,2
1745144071213,ETHN 103A,A00,887236,Man; Simeon S,0,5,0,0
1745144072241,ETHN 113,A00,887239,Staff,20,0,30,10
1745144073267,ETHN 116,A00,887240,Staff,20,0,25,5
1745144074296,ETHN 117,A00,887241,Choi; Esther Min,27,0,30,3
1745144075324,ETHN 118,A00,887243,Staff,24,0,30,6
1745144076355,ETHN 127,A00,887248,Cuong; Marisol,12,0,15,3
1745144077381,ETHN 139,A00,887250,Staff,8,0,10,2
1745144078407,ETHN 142,A00,887252,Staff,18,0,30,12
1745144079435,ETHN 161,A00,887253,Browne; Errol Tsekani,28,0,30,2
1745144080467,ETHN 163FR,A00,887255,Burelle; Julie Sara Veronique,4,0,5,1
1745144081501,GLBH 20,A00,889149,Elwardani; Nile Regina,15,0,42,27
1745144083559,GLBH 111,A01,889152,Burgos; Jose L.,17,0,17,0
1745144084586,GLBH 150,A00,889181,Sloane; Julia Kathryn,0,1,15,15
1745144086645,HDS 60,A01,886406,Warstadt; Melissa Fawn,76,0,80,4
1745144087672,HIAF 111,A00,889324,Gyamfi; Bright,0,4,0,0
1745144088703,HIEA 131,A00,889328,Staff,14,0,32,18
1745144089732,HIEA 144,A00,889333,Henry; Todd A.,29,0,32,3
1745144090758,HIEA 154,A00,889336,Henry; Todd A.,28,0,32,4
1745144091786,HIEU 106,A00,889339,Staff,28,0,32,4
1745144093838,HIEU 114,A00,889340,Staff,18,0,32,14
1745144094866,HIEU 135GS,A00,889342,Patterson; Patrick H.,0,0,1,22
1745144095892,HIEU 137,A00,889343,Edington; Claire Ellen,12,0,25,13
1745144096922,HIEU 148,A00,889345,Staff,16,0,32,16
1745144097953,HIEU 154,A00,889346,Biess; Frank Peter,24,0,32,8
1745144098980,HILA 102,A00,889351,Staff,13,0,32,19
1745144100007,HILD 2A,A01,889221,Lewandoski; Julia Mavis,0,5,32,32
1745144101032,HILD 7B,A01,889225,Man; Simeon S,0,7,32,32
1745144102059,HILD 7C,A01,889288,Alvarez; Luis A,0,8,32,32
1745144103086,HILD 30,A01,889323,Staff,0,1,32,32
1745144105143,HISC 119,A00,889383,Golan; Tal,22,0,32,10
1745144106166,HIUS 103,A00,889384,Man; Simeon S,10,0,32,22
1745144107194,HIUS 117,A00,919797,Kwak; Nancy,23,0,32,9
1745144108219,HIUS 142A,A00,919788,Staff,24,0,32,8
1745144110276,HIUS 149,A00,889386,Gyamfi; Bright,0,1,0,0
1745144111306,HIUS 155,A00,889387,Alvarez; Luis A,19,0,32,13
1745144112338,HUM 3,A01,886499,Caldwell; Michael Alan,24,0,50,26
1745144113368,HUM 3GS,A00,886500,Rodriguez; Bretton Sigfred,0,0,0,26
1745144114396,HUM 3R,A01,886502,Markman; Kristina,0,32,50,50
1745144115425,HUM 4,A01,886504,Crum; Matthew Stephen,28,0,50,22
1745144115425,HUM 4,B01,886506,West; Geoffrey Scott,25,0,50,25
1745144116452,HUM 4GS,A00,886507,Staff,0,0,0,13
1745144117481,HUM 5,A01,886509,Staff,35,0,50,15
1745144118510,HUM 5R,A01,886511,Zavodny; Tatiana Sophia,0,32,50,50
1745144119536,JAPN 180,A00,886407,Staff,25,0,40,15
1745144120564,LATI 50,A01,886409,Martin-Cabrera; Luis,9,0,22,13
1745144120564,LATI 50,A02,886410,Martin-Cabrera; Luis,20,0,22,2
1745144120564,LATI 50,A03,886411,Martin-Cabrera; Luis,22,0,22,0
1745144120564,LATI 50,A04,886412,Martin-Cabrera; Luis,15,0,22,7
1745144121594,LAWS 101,A00,907664,Staff,36,0,60,24
1745144122621,LIAB 1A,A00,889388,Saab; Dima,19,0,20,1
1745144123648,LIAB 1AX,A00,889389,El Cheddadi; Youniss,19,0,20,1
1745144124674,LIFR 1C,A00,889391,Van Moer; Vinciane G,9,0,20,11
1745144125701,LIFR 1CX,A00,889392,Van Moer; Vinciane G,8,0,20,12
1745144126730,LIFR 1D,A00,889393,Van Moer; Vinciane G,11,0,20,9
1745144127762,LIFR 1DX,A00,889394,Van Moer; Vinciane G,11,0,20,9
1745144128789,LIGN 7,A00,886923,Staff,30,0,50,20
1745144129820,LIGN 17,A00,886924,Kehler; Andrew Scott,133,0,150,17
1745144130849,LTAM 110,A00,889395,Staff,17,0,30,13
1745144131880,LTCH 101,A00,889397,Staff,22,0,25,3
1745144132908,LTCS 130,A00,889398,Staff,23,0,25,2
1745144133936,LTEA 138,A00,889399,Staff,25,0,40,15
1745144134964,LTEN 149,A00,889400,Wesling; Megan E.,6,0,25,19
1745144135991,LTEN 169,A00,889401,Staff,24,0,25,1
1745144137021,LTEN 180,A00,889402,Staff,12,0,15,3
1745144138048,LTEN 181,A00,889403,Staff,23,0,25,2
1745144139080,LTWL 100,A00,889404,Myerston Santana; Jacobo,8,0,25,17
1745144140116,LTWL 180GS,A00,889405,Staff,6,0,20,14
1745144141140,LTWL 181,A00,889406,Staff,19,0,25,6
1745144142172,LTWL 184,A00,889475,Mukherjee; Silpa,21,0,25,4
1745144143198,LTWR 102C,A00,889486,Staff,29,0,30,1
1745144144226,LTWR 115W,A00,889491,Staff,3,0,15,12
1745144145254,MAE 8,A01,886905,Staff,0,2,0,0
1745144146288,MAE 11,A00,886906,Bandaru; Prabhakar,0,0,50,50
1745144147320,MAE 20,A00,886907,Evdokimenko; Ekaterina,50,0,70,20
1745144148353,MAE 30B,A00,886909,Ghazinejad; Maziar,28,0,45,17
1745144149387,MAE 101B,A00,886910,Saintillan; David,36,0,45,9
1745144150412,MAE 105,A00,886911,Bandaru; Prabhakar,26,0,50,24
1745144151439,MAE 107,A00,886912,Staff,22,0,60,38
1745144152467,MAE 143B,A00,886913,Bewley; Thomas R,14,0,40,26
1745144153494,MAE 148,A01,886915,Silberman; Jack,5,0,14,9
1745144154526,MAE 160,A00,886916,Evdokimenko; Ekaterina,41,0,60,19
1745144155559,MATH 3C,A01,889681,Staff,2,0,30,28
1745144156587,MATH 10A,A01,889760,Staff,28,0,30,2
1745144156587,MATH 10A,A02,889783,Staff,30,0,30,0
1745144157618,MATH 10B,A01,889785,Verstraete; Jacques Allan,0,2,30,30
1745144157618,MATH 10B,A02,889795,Verstraete; Jacques Allan,0,2,30,30
1745144157618,MATH 10B,B01,889797,Verstraete; Jacques Allan,0,0,30,30
1745144157618,MATH 10B,B02,889828,Verstraete; Jacques Allan,23,0,30,7
1745144158656,MATH 10C,A01,889849,Habib; Yousaf,18,0,30,12
1745144158656,MATH 10C,A02,889852,Habib; Yousaf,20,0,30,10
1745144158656,MATH 10C,A03,889853,Habib; Yousaf,24,0,30,6
1745144158656,MATH 10C,A04,889858,Habib; Yousaf,21,0,30,9
1745144158656,MATH 10C,B01,889861,Staff,12,0,30,18
1745144158656,MATH 10C,B02,889862,Staff,26,0,30,4
1745144158656,MATH 10C,B03,889863,Staff,28,0,30,2
1745144158656,MATH 10C,B04,889967,Staff,25,0,30,5
1745144159704,MATH 18,A01,889974,Staff,15,0,30,15
1745144159704,MATH 18,A02,889977,Staff,25,0,30,5
1745144159704,MATH 18,B01,889984,Hardiman; Liam,26,0,30,4
1745144159704,MATH 18,B02,889985,Hardiman; Liam,28,0,30,2
1745144160735,MATH 20A,A01,889990,Suk; Andrew Hoon,31,0,35,4
1745144161763,MATH 20B,A01,889993,Ohm; Ko Woon,21,0,30,9
1745144161763,MATH 20B,A02,889994,Ohm; Ko Woon,30,0,30,0
1745144161763,MATH 20B,B01,889996,Ohm; Ko Woon,25,0,30,5
1745144161763,MATH 20B,B02,889997,Ohm; Ko Woon,24,0,30,6
1745144162791,MATH 20C,A01,889999,Hammock; Frances H,22,0,30,8
1745144162791,MATH 20C,A02,890003,Hammock; Frances H,23,0,30,7
1745144162791,MATH 20C,B01,890006,Hammock; Frances H,11,0,30,19
1745144162791,MATH 20C,B02,890007,Hammock; Frances H,18,0,30,12
1745144163824,MATH 20D,A01,890011,Cheng; Hsiao-Bing,6,0,30,24
1745144163824,MATH 20D,A02,890012,Cheng; Hsiao-Bing,27,0,30,3
1745144163824,MATH 20D,B01,890016,Cheng; Hsiao-Bing,19,0,30,11
1745144163824,MATH 20D,B02,890017,Cheng; Hsiao-Bing,15,0,30,15
1745144164853,MATH 20E,A01,890026,Harel; Guershon,10,0,30,20
1745144164853,MATH 20E,A02,890029,Harel; Guershon,24,0,30,6
1745144164853,MATH 20E,B01,890033,Harel; Guershon,14,0,30,16
1745144164853,MATH 20E,B02,890101,Harel; Guershon,27,0,30,3
1745144165881,MATH 102,A01,890104,Staff,20,0,30,10
1745144165881,MATH 102,A02,890105,Staff,30,0,30,0
1745144166908,MATH 103B,A01,890116,Salehi Golsefidy; Alireza,8,0,30,22
1745144166908,MATH 103B,B01,890118,Staff,0,4,30,30
1745144167943,MATH 109,A01,890121,Aliabadi Sr.; Mohsen,6,0,30,24
1745144167943,MATH 109,B01,890124,Upadrashta; Pranav Kumar,23,0,30,7
1745144168975,MATH 120A,A01,890126,Eggers; John Dietrich,15,0,30,15
1745144170000,MATH 142B,A01,890128,Ioana; Adrian,17,0,30,13
1745144170000,MATH 142B,A02,890129,Ioana; Adrian,15,0,30,15
1745144171030,MATH 154,A01,890174,Staff,0,1,30,30
1745144171030,MATH 154,A02,890182,Staff,15,0,30,15
1745144172060,MATH 168A,A01,890197,Dumitriu; Ioana,22,0,35,13
1745144173095,MATH 170A,A01,890240,Nie; Jiawang,5,0,30,25
1745144173095,MATH 170A,A02,890241,Nie; Jiawang,18,0,30,12
1745144173095,MATH 170A,A03,890249,Nie; Jiawang,23,0,30,7
1745144174126,MATH 170B,A01,957891,Nag; Panchali,25,0,35,10
1745144176179,MATH 181A,A01,908025,Staff,0,8,35,35
1745144177205,MATH 193B,A01,890265,Staff,3,0,35,32
1745144178239,MGT 4,A01,890311,Anderson; John Charles,57,0,88,31
1745144179267,MGT 5,A00,907740,Staff,41,0,98,57
1745144180305,MGT 12,A00,890312,Lindenberger; Wade Douglas,70,0,98,28
1745144181334,MGT 16,A00,957883,Staff,84,0,98,14
1745144183384,MGT 45,A00,890314,Pecore; Joseph P.,57,0,98,41
1745144184412,MGT 71,A00,890315,Staff,6,0,98,92
1745144185438,MGT 100,A00,890316,Yavorsky; Daniel Ryan,59,0,98,39
1745144186465,MGT 103,A00,890317,Ehrich; Kristine R,77,0,98,21
1745144187493,MGT 105,A00,890356,Bates; Kenneth Walter,19,0,98,79
1745144188524,MGT 112,A00,890360,Ehrich; Kristine R,65,0,98,33
1745144189557,MGT 127R,A00,907732,Zhu; Kevin Xiaoguo,32,0,98,66
1745144190584,MGT 131B,A00,890361,Anderson; John Charles,75,0,98,23
1745144191616,MGT 137,A00,890362,Lindenberger; Wade Douglas,68,0,98,30
1745144192646,MGT 160,A00,890369,Johnson; Erik Barry,36,0,98,62
1745144194699,MGT 164,A00,890372,Zimmermann; Carsten,0,29,98,98
1745144195726,MGT 180,A00,890374,Bliss; Barbara Ann,31,0,98,67
1745144196753,MMW 15,A01,886414,Chang; Edmond Yi-Teh,0,10,28,28
1745144196753,MMW 15,A02,886415,Chang; Edmond Yi-Teh,0,10,28,28
1745144196753,MMW 15,A03,886416,Chang; Edmond Yi-Teh,0,8,28,28
1745144196753,MMW 15,A04,886417,Chang; Edmond Yi-Teh,0,8,28,28
1745144196753,MMW 15,B01,886419,Chang; Edmond Yi-Teh,0,8,28,28
1745144196753,MMW 15,B02,886420,Chang; Edmond Yi-Teh,0,9,28,28
1745144196753,MMW 15,B03,886421,Chang; Edmond Yi-Teh,0,9,28,28
1745144196753,MMW 15,B04,886422,Chang; Edmond Yi-Teh,0,9,28,28
1745144196753,MMW 15,C01,886424,Staff,0,10,28,28
1745144196753,MMW 15,C02,886425,Staff,0,10,28,28
1745144196753,MMW 15,C03,886426,Staff,0,9,28,28
1745144196753,MMW 15,C04,886427,Staff,0,9,28,28
1745144197785,MMW 15GS,A00,906910,Patterson; Patrick H.,5,0,28,23
1745144198818,MMW 122R,A01,886429,Rahimi; Babak,0,23,28,28
1745144198818,MMW 122R,A02,886430,Rahimi; Babak,0,23,28,28
1745144199847,MUS 1A,A01,890937,Staff,7,0,25,18
1745144199847,MUS 1A,A02,891035,Staff,15,0,25,10
1745144199847,MUS 1A,B00,907849,Staff,48,0,50,2
1745144199847,MUS 1A,B01,907850,Staff,25,0,25,0
1745144199847,MUS 1A,B02,907851,Staff,25,0,25,0
1745144201899,MUS 2AK,A00,957092,Ohnishi; Takae,15,0,15,0
1745144202926,MUS 4,A01,891044,Staff,6,0,25,19
1745144202926,MUS 4,A02,891045,Staff,24,0,25,1
1745144202926,MUS 4,B01,891048,Staff,20,0,25,5
1745144202926,MUS 4,B02,891050,Staff,25,0,25,0
1745144203954,MUS 5,A01,957506,Dubnov; Shlomo,4,0,25,21
1745144203954,MUS 5,A02,957622,Dubnov; Shlomo,21,0,25,4
1745144203954,MUS 5,A03,957623,Dubnov; Shlomo,23,0,25,2
1745144204982,MUS 6,A01,891053,Freitas Caetano; Marcelo,23,0,25,2
1745144204982,MUS 6,A02,891054,Freitas Caetano; Marcelo,23,0,25,2
1745144206012,MUS 7,A01,891081,Staff,0,0,25,25
1745144206012,MUS 7,A02,891082,Staff,14,0,25,11
1745144207044,MUS 8GS,A00,891118,Borgo; David Garcia,5,0,25,20
1745144208068,MUS 11,A01,891140,Staff,12,0,25,13
1745144208068,MUS 11,A02,891141,Staff,24,0,25,1
1745144209097,MUS 13,A01,891143,Staff,10,0,25,15
1745144209097,MUS 13,A02,891144,Staff,25,0,25,0
1745144210125,MUS 15,A01,891146,Staff,7,0,25,18
1745144210125,MUS 15,A02,891148,Staff,22,0,25,3
1745144210125,MUS 15,B01,891150,Staff,18,0,25,7
1745144210125,MUS 15,B02,891151,Staff,25,0,25,0
1745144211155,MUS 20,A01,891153,Staff,9,0,20,11
1745144211155,MUS 20,A02,891155,Staff,16,0,20,4
1745144212184,MUS 80,A00,891156,Staff,19,0,25,6
1745144212184,MUS 80,B00,891157,Staff,24,0,25,1
1745144213210,MUS 130,A00,891158,Ohnishi; Takae,35,0,35,0
1745144214238,MUS 150GS,A01,891160,Borgo; David Garcia,5,0,25,20
1745144215292,MUS 170,A01,891162,Freitas Caetano; Marcelo,21,0,25,4
1745144215292,MUS 170,A02,891164,Freitas Caetano; Marcelo,22,0,25,3
1745144216327,NANO 11,A00,886220,Vazquez Mena; Oscar,12,0,15,3
1745144217352,NANO 15,A01,886222,Drews; Aaron,9,0,10,1
1745144218383,NANO 104,A00,886224,Sirbuly; Donald,18,0,25,7
1745144219409,PH 40,A00,886528,Staff,29,0,40,11
1745144220438,PH 45,A01,886799,Staff,36,0,40,4
1745144221464,PH 110,A00,886802,Staff,7,0,40,33
1745144222494,PH 172,A00,906716,Staff,20,0,35,15
1745144223519,PH 191,A00,886803,Staff,23,0,40,17
1745144224545,PHIL 1,A00,889500,Staff,22,0,30,8
1745144225572,PHIL 10,A01,889549,Grush; Rick Scott,17,0,22,5
1745144225572,PHIL 10,A02,889551,Grush; Rick Scott,20,0,22,2
1745144226607,PHIL 28,A01,889559,Lamey; Andy M.,0,4,25,25
1745144226607,PHIL 28,A02,889561,Lamey; Andy M.,0,0,25,25
1745144226607,PHIL 28,A03,889572,Lamey; Andy M.,7,0,25,18
1745144227632,PHIL 35,A00,907839,Staff,32,0,33,1
1745144228658,PHIL 60,A00,889574,Staff,79,0,90,11
1745144229692,PHIL 105,A00,889579,Staff,0,1,0,0
1745144230720,PHIL 136,A00,889582,Fulkerson; Matthew Todd,27,0,45,18
1745144231755,PHIL 163,A01,889601,Staff,24,0,30,6
1745144231755,PHIL 163,B01,889606,Brandt; Reuven A,0,2,0,0
1745144232782,PHIL 164,A00,889610,Staff,20,0,30,10
1745144233809,PHIL 165,A00,889613,Staff,26,0,30,4
1745144234834,PHYS 1A,A00,886431,Staff,38,0,70,32
1745144235860,PHYS 1AL,001,886432,Tsai; Philbert S,0,0,30,30
1745144235860,PHYS 1AL,002,886436,Tsai; Philbert S,19,0,30,11
1745144236890,PHYS 1B,A00,886439,Staff,192,0,240,48
1745144237923,PHYS 1BL,001,886441,Tsai; Philbert S,0,1,30,30
1745144237923,PHYS 1BL,002,886444,Tsai; Philbert S,14,0,30,16
1745144238955,PHYS 1C,A00,896092,Arnold; Kam S,87,0,146,59
1745144239989,PHYS 1CL,001,886448,Tsai; Philbert S,0,4,30,30
1745144239989,PHYS 1CL,002,886449,Tsai; Philbert S,6,0,30,24
1745144239989,PHYS 1CL,003,886450,Tsai; Philbert S,22,0,30,8
1745144239989,PHYS 1CL,004,886451,Tsai; Philbert S,16,0,30,14
1745144241015,PHYS 2B,A01,886457,Staff,86,0,115,29
1745144242042,PHYS 2C,A01,886460,Shotwell; Brian,0,0,65,65
1745144243071,PHYS 2CL,A01,886467,Staff,0,3,28,28
1745144243071,PHYS 2CL,A02,886468,Staff,5,0,28,23
1745144244096,PHYS 2D,A01,886470,Staff,17,0,50,33
1745144245133,PHYS 4B,A01,886475,Grinstein; Benjamin,87,0,100,13
1745144246159,POLI 5,A00,891173,Desposato; Scott,17,0,25,8
1745144247183,POLI 5D,A01,891175,Staff,5,0,5,0
1745144247183,POLI 5D,B01,891178,Staff,5,0,5,0
1745144248209,POLI 11,A00,891179,Ferree; Karen E,3,0,25,22
1745144249238,POLI 12,A00,891180,Staff,21,0,30,9
1745144250268,POLI 27,A01,891182,Staff,29,0,75,46
1745144251295,POLI 30,A00,891183,Staff,0,3,30,30
1745144252321,POLI 100B,A00,891244,Staff,0,8,20,20
1745144253347,POLI 100I,A00,891247,Staff,19,0,30,11
1745144254376,POLI 104J,A00,891248,Nichter; Maysa,18,0,30,12
1745144255405,POLI 104U,A00,891250,Nichter; Maysa,9,0,30,21
1745144256433,POLI 108,A00,891253,Staff,0,0,0,4
1745144257464,POLI 110B,A00,891255,Wiens; David,22,0,25,3
1745144258494,POLI 112A,A00,891256,Wiens; David,15,0,25,10
1745144259524,POLI 114BR,A00,891261,Staff,22,0,30,8
1745144260550,POLI 117R,A00,891262,Forman; Fonna,12,0,50,38
1745144261575,POLI 118,A00,891264,Ingham; Sean,22,0,25,3
1745144262601,POLI 124A,A00,891265,Staff,19,0,20,1
1745144263627,POLI 125D,A00,891266,Nichter; Simeon C,9,0,25,16
1745144264653,POLI 126,A00,891268,Nichter; Simeon C,11,0,25,14
1745144265681,POLI 126AA,A00,891272,Staff,19,0,25,6
1745144266708,POLI 130AA,A00,891273,Staff,17,0,20,3
1745144267733,POLI 134AA,A00,891274,Staff,12,0,20,8
1745144269787,POLI 138,A00,891278,Staff,22,0,25,3
1745144270811,POLI 142K,A00,891280,Staff,17,0,25,8
1745144271838,POLI 142M,A00,891281,Gartzke; Erik,22,0,30,8
1745144272864,POLI 142P,A00,891284,Staff,21,0,30,9
1745144273891,POLI 143,A00,891285,Gartzke; Erik,17,0,30,13
1745144274919,POLI 153,A00,891286,Staff,20,0,20,0
1745144275945,POLI 170A,A00,891288,Staff,19,0,25,6
1745144276977,POLI 175,A00,891290,Staff,18,0,20,2
1745144278064,PSYC 1,A00,890674,Steiner; Eric Tomas,0,4,45,45
1745144279093,PSYC 2,A00,890676,Albright; Thomas D,25,0,35,10
1745144280122,PSYC 3,A00,890679,Staff,18,0,20,2
1745144281153,PSYC 60,A01,890684,Rickard; Timothy C.,7,0,45,38
1745144282200,PSYC 70,A01,890689,Geller; Emma Harlan,14,0,30,16
1745144283226,PSYC 100,A00,890690,Lacefield; Katharine I,0,43,180,180
1745144284252,PSYC 102,A00,890695,Staff,25,0,40,15
1745144285278,PSYC 105,A00,890699,Geller; Emma Harlan,78,0,100,22
1745144286306,PSYC 106,A00,890701,Gorman; Michael R.,15,0,30,15
1745144287333,PSYC 108,A00,890704,Adrian; Julia Anna,0,23,50,50
1745144288362,PSYC 118,A01,890712,Staff,18,0,30,12
1745144289392,PSYC 124,A00,890716,Chapman; Eddie Nathaniel,36,0,60,24
1745144290417,PSYC 131,A00,890717,Anagnostaras; Stephan,6,0,80,74
1745144291448,PSYC 137,A00,890719,Winkielman; Piotr,0,2,30,30
1745144292475,PSYC 144,A00,890721,Adrian; Julia Anna,0,3,45,45
1745144293502,PSYC 162,A00,890805,Staff,21,0,75,54
1745144294532,PSYC 169,A00,890810,Staff,0,15,30,30
1745144295563,PSYC 172,A00,890814,Gorman; Michael R.,14,0,30,16
1745144296590,PSYC 181,A00,890818,Anagnostaras; Stephan,63,0,200,137
1745144297616,PSYC 189,A00,890823,Staff,11,0,30,19
1745144298643,PSYC 191,A00,890884,Rickard; Timothy C.,0,11,35,35
1745144299679,PSYC 193,A00,890913,Staff,22,0,30,8
1745144299679,PSYC 193,B00,890914,Chapman; Eddie Nathaniel,25,0,30,5
1745144300707,PSYC 193L,A01,890918,Lowe; Angela Beth,29,0,30,1
1745144300707,PSYC 193L,B01,890921,Hurwitz; Ethan Scott,28,0,30,2
1745144300707,PSYC 193L,C01,890928,Staff,30,0,30,0
1745144301734,RELI 149,A00,886806,Rahimi; Babak,23,0,40,17
1745144302765,SE 9,A01,886814,Staff,13,0,20,7
1745144303795,SE 101B,A01,886816,Chadha; Mayank,8,0,30,22
1745144304824,SE 110B,A00,886818,Zhu; Qiang,0,16,45,45
1745144305850,SE 125,A01,886830,Staff,10,0,30,20
1745144306876,SE 130B,A01,886835,Staff,19,0,40,21
1745144307908,SE 131A,A01,886838,Krysl; Petr,37,0,55,18
1745144308937,SE 154,A00,886840,Staff,35,0,50,15
1745144309961,SE 164GS,A01,886849,Staff,13,0,20,7
1745144310985,SE 167GS,A01,886853,Staff,13,0,20,7
1745144312012,SIO 25,A01,890107,Staff,23,0,30,7
1745144313037,SIO 45,A00,890109,Cook; Geoffrey W,137,0,200,63
1745144314063,SIO 109R,A00,890110,Forman; Fonna,0,11,20,20
1745144315094,SIO 187,A01,890114,Kacev; David,21,0,40,19
1745144316128,SOCI 1,A01,890431,Thorpe; Charles Robert,21,0,30,9
1745144316128,SOCI 1,A02,890518,Thorpe; Charles Robert,30,0,30,0
1745144317152,SOCI 2,A01,957978,Staff,0,0,0,0
1745144317152,SOCI 2,A02,957979,Staff,0,3,0,0
1745144318177,SOCI 20,A01,890523,Calderon-Zaks; Michael Aar,24,0,30,6
1745144318177,SOCI 20,A02,890526,Calderon-Zaks; Michael Aar,29,0,30,1
1745144319203,SOCI 30,A01,890533,Pardo Guerra; Juan Pablo,37,0,40,3
1745144320228,SOCI 40,A01,890535,Staff,32,0,45,13
1745144321254,SOCI 104Q,A00,890559,Staff,20,0,30,10
1745144322284,SOCI 106,A00,890560,Arnal; Maud Marie Leonie,22,0,30,8
1745144323315,SOCI 110,A00,890567,Holkenbrink-Monk; Charlene,22,0,30,8
1745144324342,SOCI 112,A00,890568,Victoria Torres; Pablo,0,0,45,45
1745144325367,SOCI 115,A00,890597,Arnal; Maud Marie Leonie,33,0,45,12
1745144327423,SOCI 121,A00,890604,Pardo Guerra; Juan Pablo,40,0,45,5
1745144328452,SOCI 126,A01,890608,Staff,8,0,10,2
1745144329482,SOCI 127,A00,890609,Staff,23,0,30,7
1745144330513,SOCI 131,A00,890610,Thorpe; Charles Robert,38,0,45,7
1745144331539,SOCI 135,A00,890615,Payne; Christine Anna,19,0,45,26
1745144332563,SOCI 139,A00,890620,Staff,43,0,45,2
1745144333589,SOCI 148E,A00,890622,Calderon-Zaks; Michael Aar,39,0,45,6
1745144334621,SOCI 150,A00,890623,Kohler; Kristopher M.,36,0,45,9
1745144335652,SOCI 157,A00,890625,Jules-Rosette; Bennetta W.,18,0,20,2
1745144336677,SOCI 160,A00,890627,Payne; Christine Anna,26,0,45,19
1745144337705,SYN 1,A00,886855,Fish; Gwendolyn Anne,0,0,0,0
1745144337705,SYN 1,B00,906086,Fish; Gwendolyn Anne,0,0,0,2
1745144338732,SYN 2R,A00,886860,Staff,0,15,15,15
1745144338732,SYN 2R,B00,906106,Atkinson; Arthur Laird,0,14,15,15
1745144339771,SYN 100,A01,886866,Browne; Emily,0,29,20,20
1745144339771,SYN 100,B01,906128,Rock; Martin,0,4,20,20
1745144339771,SYN 100,C01,906140,Deavenport; James Cary,0,2,20,20
1745144339771,SYN 100,D01,907816,Deavenport; James Cary,0,3,20,20
1745144340800,TDAC 1,A00,890286,Walsh; Kim C.,11,0,20,9
1745144341830,TDAC 101,A00,890296,Basso; Beatrice,18,0,20,2
1745144342856,TDDE 131,A00,890297,Staff,47,0,50,3
1745144343888,TDDM 1,A00,890287,Weinberg; Sadie,26,0,30,4
1745144344916,TDGE 11,A00,890288,Fulton; Julia,155,0,200,45
1745144344916,TDGE 11,B00,890289,Castro; Robert Jess,188,0,200,12
1745144345946,TDGE 25,B00,957359,Walsh; Kim C.,9,0,20,11
1745144346979,TDGE 40,A01,890292,Power; Jade Yukana,28,0,30,2
1745144348005,TDGE 124,A00,890298,Havis; Allan,12,0,50,38
1745144349031,TDGE 131R,A00,890299,Burelle; Julie Sara Veronique,20,0,42,22
1745144350057,TDHT 101,A00,890300,Staff,12,0,20,8
1745144351084,TDHT 109,A01,890302,Anderson; Mysia Anyse,31,0,40,9
1745144352131,TDMV 1,A00,890293,Arcidiacono; Kristin,20,0,30,10
1745144353156,TDMV 2,A00,890294,Weinberg; Sadie,26,0,30,4
1745144354182,TDMV 3,A00,957878,Arcidiacono; Kristin,27,0,30,3
1745144356233,TDMV 138,A00,890304,Jun; Grace Shin Hae,25,0,40,15
1745144357260,TDMV 140,A00,890305,Corrales; Joseph Bernales,28,0,30,2
1745144358291,TDMV 142,A00,890307,Caligagan; Tony,30,0,40,10
1745144359318,TDMV 144,A00,890308,Camaya; Michelle Ann,26,0,30,4
1745144360345,TDPW 1,A00,890295,Stein; Deborah Isobel,5,0,20,15
1745144361372,USP 2,A01,890272,Lerner; Amy M,8,0,20,12
1745144362404,USP 3,A01,890274,Staff,21,0,30,9
1745144363431,USP 15,A01,890276,Sun; Feiyang,21,0,30,9
1745144364463,USP 25,A00,890277,Shenkman; Michael Thomas,21,0,25,4
1745144365491,USP 138,A00,890278,Staff,15,0,25,10
1745144366520,USP 143,A00,890279,Staff,30,0,70,40
1745144367549,USP 144,A00,890280,Chowdhury; Muhammed Zohir,19,0,30,11
1745144368574,USP 150,A00,890281,Boomhower; Matthew Charles,19,0,30,11
1745144369604,USP 151,A00,890282,Staff,17,0,20,3
1745144370631,USP 162,A00,890283,Andrews; Abigail Leslie,17,0,20,3
1745144371660,USP 168,A00,920477,Kwak; Nancy,2,0,5,3
1745144372688,USP 181,A00,890284,Staff,11,0,20,9
1745144373713,USP 191A,A00,890285,Staff,15,0,20,5
1745144374741,VIS 101,A00,886512,Staff,37,0,75,38
1745144375769,VIS 103,A00,886513,Cruz; Edwin Teddy,65,0,75,10
1745144376797,VIS 108,A00,886514,Staff,7,0,15,8
1745144377828,VIS 127P,A00,886515,Shen; Kuiyi,92,0,146,54
1745144378860,VIS 149,A00,886516,Yoldas; Pinar,1,0,15,14
1745144379891,VIS 164,A00,886526,Erdmann; Dean,21,0,22,1
1745144380921,VIS 194S,A00,886527,Staff,61,0,75,14
1745144382007,WCWP 10A,C00,886484,Staff,13,0,15,2
1745144383034,WCWP 10B,A00,886490,Staff,5,0,15,10
1745144383034,WCWP 10B,B00,886491,Staff,0,1,0,0
1745144383034,WCWP 10B,C00,886492,Staff,10,0,15,5
1745144384060,WCWP 100,A00,886494,Staff,0,3,15,15
1745144386136,AAS 10,A01,886199,Childs; Dennis R.,0,2,0,0
1745144387164,ANAR 104,A01,886940,Shtienberg; Gilad,27,0,30,3
1745144388191,ANAR 120,A00,886953,Staff,13,0,20,7
1745144389220,ANBI 148,A01,886955,Wilder; Linnea Lorene,32,0,40,8
1745144391277,ANSC 122,A00,886957,Staff,28,0,30,2
1745144392307,ANSC 150,A00,886958,Sloane; Julia Kathryn,6,0,15,9
1745144393339,ANSC 156,A00,886959,Jenkins; Janis A.,2,0,15,13
1745144394368,ANSC 180,A00,886960,Staff,12,0,17,5
1745144395396,ANSC 188,A00,886961,Jassal; Aftab,10,0,25,15
1745144396421,ANSC 190,A00,886962,Jassal; Aftab,14,0,25,11
1745144397449,ANSC 191,A00,886963,Staff,18,0,20,2
1745144398476,ANTH 3,A01,891689,Staff,19,0,20,1
1745144399506,ANTH 5,A00,886933,Semendeferi; Ekaterini,18,0,20,2
1745144400533,ANTH 10,A00,886934,Staff,0,8,30,30
1745144401563,ANTH 21,A01,886936,Staff,44,0,60,16
1745144402590,ANTH 23,A01,886938,Staff,94,0,100,6
1745144403617,ANTH 105,A00,886964,Stewart; Alexander B,94,0,100,6
1745144404642,ANTH 108,A00,886965,Pedersen; David,10,0,20,10
1745144405672,AWP 10,001,886147,Staff,0,0,0,0
1745144405672,AWP 10,002,886148,Staff,0,0,0,0
1745144405672,AWP 10,003,886149,Staff,0,0,0,0
1745144405672,AWP 10,004,886150,Staff,0,0,0,0
1745144405672,AWP 10,005,886151,Staff,0,0,0,0
1745144405672,AWP 10,006,886152,Staff,0,0,0,0
1745144405672,AWP 10,007,886153,Staff,0,0,0,0
1745144405672,AWP 10,008,886154,Staff,0,0,0,0
1745144405672,AWP 10,009,886155,Staff,0,0,0,0
1745144405672,AWP 10,010,886156,Staff,0,0,0,0
1745144405672,AWP 10,011,886158,Staff,0,0,0,0
1745144405672,AWP 10,012,886160,Staff,0,0,0,0
1745144405672,AWP 10,013,886161,Staff,0,0,0,0
1745144405672,AWP 10,014,886162,Staff,0,0,0,0
1745144405672,AWP 10,015,886163,Staff,0,0,0,0
1745144405672,AWP 10,016,886164,Staff,0,0,0,0
1745144405672,AWP 10,017,886165,Staff,0,0,0,0
1745144405672,AWP 10,018,886166,Staff,0,0,0,0
1745144405672,AWP 10,019,886168,Staff,0,0,0,0
1745144405672,AWP 10,020,886170,Staff,0,0,0,0
1745144405672,AWP 10,021,886172,Staff,0,0,0,0
1745144406707,AWP 10R,001,886173,Staff,0,0,0,0
1745144406707,AWP 10R,002,886174,Staff,0,1,0,0
1745144406707,AWP 10R,003,886175,Staff,0,0,0,0
1745144406707,AWP 10R,004,886176,Staff,0,0,0,0
1745144406707,AWP 10R,005,886177,Staff,0,0,0,0
1745144406707,AWP 10R,006,886178,Staff,0,0,0,0
1745144406707,AWP 10R,007,886179,Staff,0,0,0,0
1745144406707,AWP 10R,008,886181,Staff,0,0,0,0
1745144406707,AWP 10R,009,886182,Staff,0,0,0,0
1745144406707,AWP 10R,010,886183,Staff,0,0,0,0
1745144406707,AWP 10R,011,886184,Staff,0,0,0,0
1745144406707,AWP 10R,012,886185,Staff,0,0,0,0
1745144406707,AWP 10R,013,886186,Staff,0,0,0,0
1745144406707,AWP 10R,014,886187,Staff,0,0,0,0
1745144406707,AWP 10R,015,886188,Staff,0,0,0,0
1745144406707,AWP 10R,016,886189,Staff,0,0,0,0
1745144407735,AWP 102R,A00,886190,Staff,0,0,0,0
1745144407735,AWP 102R,B00,886191,Staff,0,0,0,0
1745144408765,BENG 100,A01,886193,Staff,19,0,30,11
1745144409796,BENG 122A,A01,886195,Hasty; Jeff M,20,0,30,10
1745144410824,BENG 166A,A00,886196,Sah; Robert Lie-Yuan,0,3,20,20
1745144411851,BIBC 102,A01,894320,Staff,0,2,46,46
1745144411851,BIBC 102,A02,894321,Staff,0,0,46,46
1745144411851,BIBC 102,A03,894344,Staff,21,0,46,25
1745144411851,BIBC 102,A04,894345,Staff,30,0,47,17
1745144412880,BICD 100R,A01,894365,Smith; Laurie,1,3,58,57
1745144412880,BICD 100R,A02,894366,Smith; Laurie,0,1,58,58
1745144412880,BICD 100R,A03,894367,Smith; Laurie,13,0,59,46
1745144413907,BICD 136,A01,894383,Gustafson-Brown; Cindy,16,0,50,34
1745144414937,BIEB 102,A01,894494,Butler; Shannon Rhey,67,0,130,63
1745144417003,BIEB 150,A01,894617,Wills; Christopher,0,3,13,13
1745144417003,BIEB 150,A02,894631,Wills; Christopher,0,3,13,13
1745144417003,BIEB 150,A03,894937,Wills; Christopher,0,3,13,13
1745144417003,BIEB 150,A04,894946,Wills; Christopher,0,1,11,11
1745144418029,BIEB 194,A00,906141,Kurle; Carolyn M.,14,0,20,6
1745144419056,BILD 1,A01,894154,Staff,8,0,19,11
1745144419056,BILD 1,A02,894155,Staff,15,0,19,4
1745144419056,BILD 1,A03,894160,Staff,18,0,19,1
1745144419056,BILD 1,A04,894161,Staff,16,0,18,2
1745144420085,BILD 2,A01,894168,Staff,0,0,50,50
1745144420085,BILD 2,A02,894169,Staff,0,0,50,50
1745144420085,BILD 2,A03,894179,Staff,27,0,50,23
1745144420085,BILD 2,A04,894203,Staff,42,0,50,8
1745144421110,BILD 3,A01,894213,Staff,24,0,31,7
1745144421110,BILD 3,A02,894214,Staff,28,0,31,3
1745144421110,BILD 3,A03,894235,Staff,30,0,31,1
1745144421110,BILD 3,A04,894236,Staff,29,0,32,3
1745144422143,BILD 4,A01,894253,Reuther; Keefe,12,0,24,12
1745144422143,BILD 4,A02,894258,Reuther; Keefe,19,0,24,5
1745144423174,BILD 5,A01,894276,Reuther; Keefe,40,0,50,10
1745144423174,BILD 5,A02,894277,Reuther; Keefe,48,0,50,2
1745144423174,BILD 5,A03,894290,Reuther; Keefe,47,0,50,3
1745144423174,BILD 5,A04,894291,Reuther; Keefe,50,0,50,0
1745144424204,BILD 24,A01,894297,Pirino; Giorgia,45,0,60,15
1745144425231,BIMM 100,A01,895012,Staff,0,14,0,1
1745144425231,BIMM 100,A02,895013,Staff,0,6,0,2
1745144425231,BIMM 100,A03,895014,Staff,0,7,0,0
1745144425231,BIMM 100,A04,895015,Staff,0,4,0,0
1745144426259,BIMM 101,A01,895017,McDonnell; Lisa Marie,0,2,24,24
1745144426259,BIMM 101,A02,895018,McDonnell; Lisa Marie,0,1,24,24
1745144426259,BIMM 101,B01,895020,McDonnell; Lisa Marie,0,3,24,24
1745144426259,BIMM 101,B02,895021,McDonnell; Lisa Marie,0,2,24,24
1745144427286,BIMM 110,A01,895023,Staff,7,0,25,18
1745144427286,BIMM 110,A02,895024,Staff,11,0,25,14
1745144427286,BIMM 110,A03,895025,Staff,22,0,25,3
1745144427286,BIMM 110,A04,895031,Staff,21,0,25,4
1745144428312,BIMM 120,A01,895114,Gustafson-Brown; Cindy,8,0,28,20
1745144428312,BIMM 120,A02,895126,Gustafson-Brown; Cindy,19,0,27,8
1745144429340,BIPN 100,A01,895130,Yang; Mingyu,13,0,38,25
1745144429340,BIPN 100,A02,895131,Yang; Mingyu,33,0,38,5
1745144429340,BIPN 100,A03,895132,Yang; Mingyu,33,0,38,5
1745144429340,BIPN 100,A04,895133,Yang; Mingyu,30,0,36,6
1745144430367,BIPN 120,A01,895135,Cooke; James Edward,0,2,13,13
1745144430367,BIPN 120,A02,895136,Cooke; James Edward,0,1,13,13
1745144430367,BIPN 120,A03,895137,Cooke; James Edward,0,0,13,13
1745144430367,BIPN 120,A04,895156,Cooke; James Edward,3,0,11,8
1745144431393,BIPN 134,A01,895235,Cooke; James Edward,0,2,25,25
1745144431393,BIPN 134,A02,895237,Cooke; James Edward,0,0,25,25
1745144431393,BIPN 134,A03,895240,Cooke; James Edward,12,0,25,13
1745144431393,BIPN 134,A04,895270,Cooke; James Edward,24,0,25,1
1745144432422,BIPN 189,A00,892103,Staff,0,20,9,9
1745144434478,CAT 124,A01,922009,Staff,0,1,20,20
1745144435510,CAT 125R,A00,886390,Morales; Celeste Georgianna,4,0,20,16
1745144435510,CAT 125R,B00,886391,Irwin; Matthew Joseph,0,1,20,20
1745144435510,CAT 125R,C00,886392,Smith; Lauryn Alissa,11,0,20,9
1745144435510,CAT 125R,D00,886393,Vanderschuit; Maya Alysia,6,0,20,14
1745144435510,CAT 125R,E00,886394,Marchisotto; Jennifer Anne,0,2,20,20
1745144436536,CENG 15,A01,886218,Drews; Aaron,1,0,5,4
1745144437564,CENG 113,A00,886219,Opatkiewicz; Justin Paul,16,0,25,9
1745144438594,CGS 101,A00,887044,Staff,13,0,20,7
1745144439624,CGS 105,A01,887046,Staff,16,0,25,9
1745144440651,CGS 112,A00,887047,Cuong; Marisol,12,0,15,3
1745144441677,CGS 113,A00,887048,Staff,24,0,30,6
1745144442707,CGS 120,A00,887049,Staff,12,0,17,5
1745144443738,CHEM 6A,A01,886336,Lam; Tin Yiu,44,0,50,6
1745144443738,CHEM 6A,A02,886338,Lam; Tin Yiu,43,0,50,7
1745144444767,CHEM 6B,A01,886341,Hopkins; Patrycja Anna,21,0,50,29
1745144444767,CHEM 6B,A02,886343,Hopkins; Patrycja Anna,46,0,50,4
1745144445794,CHEM 6C,A01,886346,Albizati; Kim F.,0,1,50,50
1745144445794,CHEM 6C,A02,886348,Albizati; Kim F.,38,0,50,12
1745144446821,CHEM 40A,A01,886352,Klosterman; Jeremy K,70,0,100,30
1745144447846,CHEM 40B,A01,886356,Klosterman; Jeremy K,0,4,100,100
1745144448873,CHEM 41B,A01,886360,Theodorakis; Emmanuel,30,0,50,20
1745144448873,CHEM 41B,A02,886362,Theodorakis; Emmanuel,46,0,50,4
1745144449905,CHIN 165A,A00,886382,Xu; Li,19,0,20,1
1745144450937,CLAS 120,A00,886387,Myerston Santana; Jacobo,36,0,40,4
1745144451965,COGS 9,A01,886967,Shannon; Kyle Michael,49,0,60,11
1745144452996,COGS 11,A01,886969,Staff,18,0,30,12
1745144454025,COGS 14A,A01,886971,Staff,26,0,60,34
1745144455052,COGS 14B,A01,886973,Hoffman; Drew Ellen,18,0,60,42
1745144456083,COGS 18,A01,886975,Morgan; Eric,41,0,60,19
1745144457111,COGS 20,A01,886977,Staff,6,0,8,2
1745144457111,COGS 20,A02,886978,Staff,6,0,7,1
1745144458140,COGS 100,A01,907783,Staff,6,0,30,24
1745144459175,COGS 101B,A01,886980,Staff,0,10,30,30
1745144460206,COGS 101C,A01,886982,Delgado; Tania,0,6,30,30
1745144461233,COGS 102A,A01,886984,Johnson; Christine M.,13,0,30,17
1745144462263,COGS 118B,A01,886986,Staff,0,25,60,60
1745144463293,COGS 150,A01,886988,Bergen; Benjamin,16,0,30,14
1745144464319,COGS 153,A00,886989,Delgado; Tania,0,6,30,30
1745144465350,COGS 186,A01,886991,Staff,3,0,30,27
1745144466380,COGS 187A,A01,886993,Boyle; Mary E. T.,12,0,30,18
1745144467407,COGS 189,A00,886994,Staff,13,0,30,17
1745144468434,COMM 10,A01,886996,Staff,11,0,25,14
1745144468434,COMM 10,A02,886997,Staff,21,0,25,4
1745144469465,COMM 20,A01,886999,Leuning; Grant Maurstad,33,0,40,7
1745144471524,COMM 100A,A01,887002,Staff,0,0,25,25
1745144471524,COMM 100A,A02,887003,Staff,20,0,25,5
1745144472549,COMM 100B,A01,887005,Staff,0,1,25,25
1745144473579,COMM 106D,A00,887006,Staff,22,0,40,18
1745144474605,COMM 110G,A00,887007,Whitworth-Smith; Andrew C,17,0,40,23
1745144475631,COMM 111B,A00,887008,Staff,31,0,40,9
1745144476658,COMM 113T,A00,887009,Abuelhiga; Soraya Jill,30,0,40,10
1745144476658,COMM 113T,B00,906733,Staff,40,0,40,0
1745144477684,COMM 145,A00,887010,Staff,21,0,40,19
1745144478711,COMM 146,A00,887054,Staff,31,0,40,9
1745144479738,COMM 190,A00,887012,Staff,9,0,23,14
1745144480765,CSE 8A,A50,887015,Cao; Yingjun,68,0,85,17
1745144481791,CSE 11,A01,887017,Cao; Yingjun,35,0,70,35
1745144482818,CSE 20,A01,887019,Staff,35,0,50,15
1745144483846,CSE 21,A01,887021,Braun; Oliver,81,0,100,19
1745144483846,CSE 21,B01,892583,Staff,48,0,50,2
1745144484876,CSE 30,A01,887025,Eldon; John,161,0,200,39
1745144485942,CSE 100,A01,887027,Staff,28,0,50,22
1745144485942,CSE 100,A02,887028,Staff,43,0,50,7
1745144486973,CSE 101,A01,887030,Braun; Oliver,79,0,100,21
1745144486973,CSE 101,B01,887032,Jones; Miles E,0,1,50,50
1745144486973,CSE 101,B02,887033,Jones; Miles E,13,0,50,37
1745144488004,CSE 105,A01,908084,Jones; Miles E,36,0,50,14
1745144488004,CSE 105,A02,908087,Jones; Miles E,38,0,50,12
1745144489036,CSE 135,A01,887035,Powell; Thomas Allan,8,0,50,42
1745144490063,CSE 142,A01,887037,Staff,22,0,60,38
1745144491090,CSE 142L,A01,887039,Staff,42,0,60,18
1745144492116,CSE 151A,A01,887041,Solares; Edwin A,60,0,100,40
1745144493146,CSE 175,A01,887043,Kumar; Rakesh,30,0,30,0
1745144494172,CSS 1,A01,886389,Staff,12,0,40,28
1745144495198,DSC 30,A01,908097,Liao; Soohyun Nam,54,0,75,21
1745144496225,DSC 40A,A01,908099,Shannon; Kyle Michael,37,0,50,13
1745144497254,DSC 40B,A01,908112,Staff,28,0,50,22
1745144498279,DSC 80,A01,908116,Staff,32,0,60,28
1745144499304,DSC 197,001,956863,Eldridge; Justin Matthew,9999,0,9999,0
1745144500334,ECE 5,A01,886400,Morris; Karcher William,3,0,6,3
1745144500334,ECE 5,A02,886401,Morris; Karcher William,5,0,6,1
1745144501364,ECE 148,A01,886403,Silberman; Jack,0,8,14,14
1745144502390,ECON 1,A01,887265,Crane; Meredith Helen,25,0,70,45
1745144502390,ECON 1,B01,887268,Staff,44,0,50,6
1745144503416,ECON 2,A01,887273,Crane; Meredith Helen,61,0,70,9
1745144504449,ECON 3,A01,887279,Rondina; Giacomo,44,0,70,26
1745144505482,ECON 4,A01,887282,Anderson; John Charles,0,1,10,10
1745144506511,ECON 5,A01,887285,Staff,39,0,45,6
1745144506511,ECON 5,B01,887292,Staff,43,0,45,2
1745144507543,ECON 100A,A01,887337,Newhouse; Herbert S,58,0,70,12
1745144507543,ECON 100A,B01,887349,Staff,45,0,50,5
1745144508570,ECON 100B,A01,887361,Du; Songzi,42,0,70,28
1745144509596,ECON 100C,A01,887445,Newhouse; Herbert S,61,0,70,9
1745144510625,ECON 105,A00,887488,Vespa; Emanuel Ignacio,24,0,35,11
1745144511651,ECON 109,A01,887506,Staff,29,0,35,6
1745144512686,ECON 110A,A01,887568,Alon; Titan Michael,1,0,35,34
1745144512686,ECON 110A,B01,907601,Alon; Titan Michael,27,0,35,8
1745144513713,ECON 110B,A01,887598,Levkoff; Steven B.,0,7,70,70
1745144514743,ECON 112,A00,887599,Rondina; Giacomo,20,0,35,15
1745144515767,ECON 120A,A01,887603,Dai; Yinlin,46,0,70,24
1745144516805,ECON 120C,A01,887608,Sun; Yixiao,0,0,35,35
1745144516805,ECON 120C,B01,887614,Sun; Yixiao,13,0,35,22
1745144517835,ECON 138,A00,887621,Bharadwaj; Prashant,0,18,20,20
1745144518862,ECON 171,A01,907666,Staff,27,0,35,8
1745144519889,ECON 175,A00,887626,Wu; Pak Yeung,27,0,35,8
1745144520915,ECON 190,A00,887640,Vespa; Emanuel Ignacio,26,0,35,9
1745144521959,EDS 25,A01,888197,Staff,0,0,0,0
1745144521959,EDS 25,A02,888209,Staff,0,0,0,0
1745144521959,EDS 25,A03,888210,Staff,0,0,0,0
1745144521959,EDS 25,A04,888212,Staff,0,0,0,0
1745144521959,EDS 25,A05,888213,Staff,0,0,0,0
1745144521959,EDS 25,A06,888214,Staff,0,0,0,0
1745144521959,EDS 25,A07,888235,Staff,0,0,0,0
1745144521959,EDS 25,A08,888236,Staff,0,0,0,0
1745144521959,EDS 25,A09,888240,Staff,0,0,0,0
1745144521959,EDS 25,A10,888244,Staff,0,0,0,0
1745144521959,EDS 25,B01,888273,Staff,0,0,0,0
1745144521959,EDS 25,B02,888285,Staff,0,0,0,0
1745144521959,EDS 25,B03,888423,Staff,29,0,30,1
1745144521959,EDS 25,B04,888432,Staff,0,0,0,0
1745144521959,EDS 25,B05,888433,Staff,0,0,0,0
1745144521959,EDS 25,B06,888467,Staff,0,0,0,0
1745144521959,EDS 25,B07,888468,Staff,0,0,0,0
1745144521959,EDS 25,B08,888479,Staff,0,0,0,0
1745144521959,EDS 25,B09,888484,Staff,0,0,0,0
1745144521959,EDS 25,B10,888487,Staff,0,0,0,0
1745144522988,EDS 38,A01,907700,Choi; Bailey Miyeon,30,0,30,0
1745144524017,EDS 112,A01,888601,Chapman; Thandeka K,23,0,40,17
1745144525049,EDS 115,A00,888697,Mendez; Kathrina Mendoza,17,0,30,13
1745144526079,EDS 116,A01,888893,Staff,38,0,40,2
1745144528136,EDS 124AR,A00,889133,Staff,33,0,50,17
1745144528136,EDS 124AR,B00,907471,Simon; Elizabeth A,42,0,50,8
1745144529162,EDS 124BR,A00,889134,Staff,57,0,100,43
1745144530189,EDS 125,A00,889135,Staff,26,0,30,4
1745144531220,EDS 126,A01,889138,Staff,37,0,40,3
1745144532289,EDS 164R,A01,889142,Wishard Guerra; Alison G.,38,0,50,12
1745144533315,ENG 30,A01,886396,Staff,0,0,0,0
1745144533315,ENG 30,B01,886398,Staff,0,0,0,0
1745144534344,ENVR 102,A00,906150,Montejo; Carolina,23,0,25,2
1745144535376,ETHN 103A,A00,887236,Man; Simeon S,0,5,0,0
1745144536402,ETHN 113,A00,887239,Staff,20,0,30,10
1745144537428,ETHN 116,A00,887240,Staff,20,0,25,5
1745144538455,ETHN 117,A00,887241,Choi; Esther Min,27,0,30,3
1745144539482,ETHN 118,A00,887243,Staff,24,0,30,6
1745144540508,ETHN 127,A00,887248,Cuong; Marisol,12,0,15,3
1745144541533,ETHN 139,A00,887250,Staff,8,0,10,2
1745144542559,ETHN 142,A00,887252,Staff,18,0,30,12
1745144543589,ETHN 161,A00,887253,Browne; Errol Tsekani,28,0,30,2
1745144544613,ETHN 163FR,A00,887255,Burelle; Julie Sara Veronique,4,0,5,1
1745144545640,GLBH 20,A00,889149,Elwardani; Nile Regina,15,0,42,27
1745144547693,GLBH 111,A01,889152,Burgos; Jose L.,17,0,17,0
1745144548725,GLBH 150,A00,889181,Sloane; Julia Kathryn,0,1,15,15
1745144550778,HDS 60,A01,886406,Warstadt; Melissa Fawn,76,0,80,4
1745144551808,HIAF 111,A00,889324,Gyamfi; Bright,0,4,0,0
1745144552836,HIEA 131,A00,889328,Staff,14,0,32,18
1745144553866,HIEA 144,A00,889333,Henry; Todd A.,29,0,32,3
1745144554896,HIEA 154,A00,889336,Henry; Todd A.,28,0,32,4
1745144555921,HIEU 106,A00,889339,Staff,28,0,32,4
1745144557970,HIEU 114,A00,889340,Staff,18,0,32,14
1745144559000,HIEU 135GS,A00,889342,Patterson; Patrick H.,0,0,1,22
1745144560026,HIEU 137,A00,889343,Edington; Claire Ellen,12,0,25,13
1745144561052,HIEU 148,A00,889345,Staff,16,0,32,16
1745144562077,HIEU 154,A00,889346,Biess; Frank Peter,24,0,32,8
1745144563102,HILA 102,A00,889351,Staff,13,0,32,19
1745144564128,HILD 2A,A01,889221,Lewandoski; Julia Mavis,0,5,32,32
1745144565155,HILD 7B,A01,889225,Man; Simeon S,0,7,32,32
1745144566182,HILD 7C,A01,889288,Alvarez; Luis A,0,8,32,32
1745144567210,HILD 30,A01,889323,Staff,0,1,32,32
1745144569264,HISC 119,A00,889383,Golan; Tal,22,0,32,10
1745144570290,HIUS 103,A00,889384,Man; Simeon S,10,0,32,22
1745144571316,HIUS 117,A00,919797,Kwak; Nancy,23,0,32,9
1745144572342,HIUS 142A,A00,919788,Staff,24,0,32,8
1745144574397,HIUS 149,A00,889386,Gyamfi; Bright,0,1,0,0
1745144575424,HIUS 155,A00,889387,Alvarez; Luis A,19,0,32,13
1745144576450,HUM 3,A01,886499,Caldwell; Michael Alan,24,0,50,26
1745144577474,HUM 3GS,A00,886500,Rodriguez; Bretton Sigfred,0,0,0,26
1745144578503,HUM 3R,A01,886502,Markman; Kristina,0,32,50,50
1745144579533,HUM 4,A01,886504,Crum; Matthew Stephen,28,0,50,22
1745144579533,HUM 4,B01,886506,West; Geoffrey Scott,25,0,50,25
1745144580562,HUM 4GS,A00,886507,Staff,0,0,0,13
1745144581591,HUM 5,A01,886509,Staff,35,0,50,15
1745144582618,HUM 5R,A01,886511,Zavodny; Tatiana Sophia,0,32,50,50
1745144583644,JAPN 180,A00,886407,Staff,25,0,40,15
1745144584668,LATI 50,A01,886409,Martin-Cabrera; Luis,9,0,22,13
1745144584668,LATI 50,A02,886410,Martin-Cabrera; Luis,20,0,22,2
1745144584668,LATI 50,A03,886411,Martin-Cabrera; Luis,22,0,22,0
1745144584668,LATI 50,A04,886412,Martin-Cabrera; Luis,15,0,22,7
1745144585697,LAWS 101,A00,907664,Staff,36,0,60,24
1745144586725,LIAB 1A,A00,889388,Saab; Dima,19,0,20,1
1745144587750,LIAB 1AX,A00,889389,El Cheddadi; Youniss,19,0,20,1
1745144588775,LIFR 1C,A00,889391,Van Moer; Vinciane G,9,0,20,11
1745144589854,LIFR 1CX,A00,889392,Van Moer; Vinciane G,8,0,20,12
1745144590880,LIFR 1D,A00,889393,Van Moer; Vinciane G,11,0,20,9
1745144591904,LIFR 1DX,A00,889394,Van Moer; Vinciane G,11,0,20,9
1745144592930,LIGN 7,A00,886923,Staff,30,0,50,20
1745144593960,LIGN 17,A00,886924,Kehler; Andrew Scott,133,0,150,17
1745144594989,LTAM 110,A00,889395,Staff,17,0,30,13
1745144596015,LTCH 101,A00,889397,Staff,22,0,25,3
1745144597040,LTCS 130,A00,889398,Staff,23,0,25,2
1745144598065,LTEA 138,A00,889399,Staff,25,0,40,15
1745144599092,LTEN 149,A00,889400,Wesling; Megan E.,6,0,25,19
1745144600122,LTEN 169,A00,889401,Staff,24,0,25,1
1745144601149,LTEN 180,A00,889402,Staff,12,0,15,3
1745144602178,LTEN 181,A00,889403,Staff,23,0,25,2
1745144603207,LTWL 100,A00,889404,Myerston Santana; Jacobo,8,0,25,17
1745144604233,LTWL 180GS,A00,889405,Staff,6,0,20,14
1745144605260,LTWL 181,A00,889406,Staff,19,0,25,6
1745144606286,LTWL 184,A00,889475,Mukherjee; Silpa,21,0,25,4
1745144607313,LTWR 102C,A00,889486,Staff,29,0,30,1
1745144608339,LTWR 115W,A00,889491,Staff,3,0,15,12
1745144609370,MAE 8,A01,886905,Staff,0,2,0,0
1745144610401,MAE 11,A00,886906,Bandaru; Prabhakar,0,0,50,50
1745144611428,MAE 20,A00,886907,Evdokimenko; Ekaterina,50,0,70,20
1745144612453,MAE 30B,A00,886909,Ghazinejad; Maziar,28,0,45,17
1745144613479,MAE 101B,A00,886910,Saintillan; David,36,0,45,9
1745144614505,MAE 105,A00,886911,Bandaru; Prabhakar,26,0,50,24
1745144615534,MAE 107,A00,886912,Staff,22,0,60,38
1745144616562,MAE 143B,A00,886913,Bewley; Thomas R,14,0,40,26
1745144617589,MAE 148,A01,886915,Silberman; Jack,5,0,14,9
1745144618615,MAE 160,A00,886916,Evdokimenko; Ekaterina,41,0,60,19
1745144619641,MATH 3C,A01,889681,Staff,2,0,30,28
1745144620668,MATH 10A,A01,889760,Staff,28,0,30,2
1745144620668,MATH 10A,A02,889783,Staff,30,0,30,0
1745144621697,MATH 10B,A01,889785,Verstraete; Jacques Allan,0,2,30,30
1745144621697,MATH 10B,A02,889795,Verstraete; Jacques Allan,0,2,30,30
1745144621697,MATH 10B,B01,889797,Verstraete; Jacques Allan,0,0,30,30
1745144621697,MATH 10B,B02,889828,Verstraete; Jacques Allan,23,0,30,7
1745144622730,MATH 10C,A01,889849,Habib; Yousaf,18,0,30,12
1745144622730,MATH 10C,A02,889852,Habib; Yousaf,20,0,30,10
1745144622730,MATH 10C,A03,889853,Habib; Yousaf,24,0,30,6
1745144622730,MATH 10C,A04,889858,Habib; Yousaf,21,0,30,9
1745144622730,MATH 10C,B01,889861,Staff,12,0,30,18
1745144622730,MATH 10C,B02,889862,Staff,26,0,30,4
1745144622730,MATH 10C,B03,889863,Staff,28,0,30,2
1745144622730,MATH 10C,B04,889967,Staff,25,0,30,5
1745144623763,MATH 18,A01,889974,Staff,15,0,30,15
1745144623763,MATH 18,A02,889977,Staff,25,0,30,5
1745144623763,MATH 18,B01,889984,Hardiman; Liam,26,0,30,4
1745144623763,MATH 18,B02,889985,Hardiman; Liam,28,0,30,2
1745144624789,MATH 20A,A01,889990,Suk; Andrew Hoon,31,0,35,4
1745144625821,MATH 20B,A01,889993,Ohm; Ko Woon,21,0,30,9
1745144625821,MATH 20B,A02,889994,Ohm; Ko Woon,30,0,30,0
1745144625821,MATH 20B,B01,889996,Ohm; Ko Woon,25,0,30,5
1745144625821,MATH 20B,B02,889997,Ohm; Ko Woon,24,0,30,6
1745144626868,MATH 20C,A01,889999,Hammock; Frances H,22,0,30,8
1745144626868,MATH 20C,A02,890003,Hammock; Frances H,23,0,30,7
1745144626868,MATH 20C,B01,890006,Hammock; Frances H,11,0,30,19
1745144626868,MATH 20C,B02,890007,Hammock; Frances H,18,0,30,12
1745144627900,MATH 20D,A01,890011,Cheng; Hsiao-Bing,6,0,30,24
1745144627900,MATH 20D,A02,890012,Cheng; Hsiao-Bing,27,0,30,3
1745144627900,MATH 20D,B01,890016,Cheng; Hsiao-Bing,19,0,30,11
1745144627900,MATH 20D,B02,890017,Cheng; Hsiao-Bing,15,0,30,15
1745144628926,MATH 20E,A01,890026,Harel; Guershon,10,0,30,20
1745144628926,MATH 20E,A02,890029,Harel; Guershon,24,0,30,6
1745144628926,MATH 20E,B01,890033,Harel; Guershon,14,0,30,16
1745144628926,MATH 20E,B02,890101,Harel; Guershon,27,0,30,3
1745144629990,MATH 102,A01,890104,Staff,20,0,30,10
1745144629990,MATH 102,A02,890105,Staff,30,0,30,0
1745144631022,MATH 103B,A01,890116,Salehi Golsefidy; Alireza,8,0,30,22
1745144631022,MATH 103B,B01,890118,Staff,0,4,30,30
1745144632048,MATH 109,A01,890121,Aliabadi Sr.; Mohsen,6,0,30,24
1745144632048,MATH 109,B01,890124,Upadrashta; Pranav Kumar,23,0,30,7
1745144633075,MATH 120A,A01,890126,Eggers; John Dietrich,15,0,30,15
1745144634107,MATH 142B,A01,890128,Ioana; Adrian,17,0,30,13
1745144634107,MATH 142B,A02,890129,Ioana; Adrian,15,0,30,15
1745144635138,MATH 154,A01,890174,Staff,0,1,30,30
1745144635138,MATH 154,A02,890182,Staff,15,0,30,15
1745144636169,MATH 168A,A01,890197,Dumitriu; Ioana,22,0,35,13
1745144637201,MATH 170A,A01,890240,Nie; Jiawang,5,0,30,25
1745144637201,MATH 170A,A02,890241,Nie; Jiawang,18,0,30,12
1745144637201,MATH 170A,A03,890249,Nie; Jiawang,23,0,30,7
1745144638229,MATH 170B,A01,957891,Nag; Panchali,25,0,35,10
1745144640285,MATH 181A,A01,908025,Staff,0,8,35,35
1745144641313,MATH 193B,A01,890265,Staff,3,0,35,32
1745144642339,MGT 4,A01,890311,Anderson; John Charles,57,0,88,31
1745144643364,MGT 5,A00,907740,Staff,41,0,98,57
1745144644393,MGT 12,A00,890312,Lindenberger; Wade Douglas,70,0,98,28
1745144645423,MGT 16,A00,957883,Staff,84,0,98,14
1745144647476,MGT 45,A00,890314,Pecore; Joseph P.,57,0,98,41
1745144648504,MGT 71,A00,890315,Staff,6,0,98,92
1745144649536,MGT 100,A00,890316,Yavorsky; Daniel Ryan,58,0,98,40
1745144650562,MGT 103,A00,890317,Ehrich; Kristine R,77,0,98,21
1745144651591,MGT 105,A00,890356,Bates; Kenneth Walter,19,0,98,79
1745144652620,MGT 112,A00,890360,Ehrich; Kristine R,65,0,98,33
1745144653645,MGT 127R,A00,907732,Zhu; Kevin Xiaoguo,32,0,98,66
1745144654672,MGT 131B,A00,890361,Anderson; John Charles,75,0,98,23
1745144655702,MGT 137,A00,890362,Lindenberger; Wade Douglas,68,0,98,30
1745144656730,MGT 160,A00,890369,Johnson; Erik Barry,36,0,98,62
1745144658780,MGT 164,A00,890372,Zimmermann; Carsten,0,29,98,98
1745144659807,MGT 180,A00,890374,Bliss; Barbara Ann,31,0,98,67
1745144660841,MMW 15,A01,886414,Chang; Edmond Yi-Teh,0,10,28,28
1745144660841,MMW 15,A02,886415,Chang; Edmond Yi-Teh,0,10,28,28
1745144660841,MMW 15,A03,886416,Chang; Edmond Yi-Teh,0,8,28,28
1745144660841,MMW 15,A04,886417,Chang; Edmond Yi-Teh,0,8,28,28
1745144660841,MMW 15,B01,886419,Chang; Edmond Yi-Teh,0,8,28,28
1745144660841,MMW 15,B02,886420,Chang; Edmond Yi-Teh,0,9,28,28
1745144660841,MMW 15,B03,886421,Chang; Edmond Yi-Teh,0,9,28,28
1745144660841,MMW 15,B04,886422,Chang; Edmond Yi-Teh,0,9,28,28
1745144660841,MMW 15,C01,886424,Staff,0,10,28,28
1745144660841,MMW 15,C02,886425,Staff,0,10,28,28
1745144660841,MMW 15,C03,886426,Staff,0,9,28,28
1745144660841,MMW 15,C04,886427,Staff,0,9,28,28
1745144661869,MMW 15GS,A00,906910,Patterson; Patrick H.,5,0,28,23
1745144662894,MMW 122R,A01,886429,Rahimi; Babak,0,23,28,28
1745144662894,MMW 122R,A02,886430,Rahimi; Babak,0,23,28,28
1745144663923,MUS 1A,A01,890937,Staff,7,0,25,18
1745144663923,MUS 1A,A02,891035,Staff,15,0,25,10
1745144663923,MUS 1A,B00,907849,Staff,48,0,50,2
1745144663923,MUS 1A,B01,907850,Staff,25,0,25,0
1745144663923,MUS 1A,B02,907851,Staff,25,0,25,0
1745144665975,MUS 2AK,A00,957092,Ohnishi; Takae,15,0,15,0
1745144667001,MUS 4,A01,891044,Staff,6,0,25,19
1745144667001,MUS 4,A02,891045,Staff,24,0,25,1
1745144667001,MUS 4,B01,891048,Staff,20,0,25,5
1745144667001,MUS 4,B02,891050,Staff,25,0,25,0
1745144668036,MUS 5,A01,957506,Dubnov; Shlomo,4,0,25,21
1745144668036,MUS 5,A02,957622,Dubnov; Shlomo,21,0,25,4
1745144668036,MUS 5,A03,957623,Dubnov; Shlomo,23,0,25,2
1745144669064,MUS 6,A01,891053,Freitas Caetano; Marcelo,23,0,25,2
1745144669064,MUS 6,A02,891054,Freitas Caetano; Marcelo,23,0,25,2
1745144670091,MUS 7,A01,891081,Staff,0,0,25,25
1745144670091,MUS 7,A02,891082,Staff,14,0,25,11
1745144671117,MUS 8GS,A00,891118,Borgo; David Garcia,5,0,25,20
1745144672143,MUS 11,A01,891140,Staff,12,0,25,13
1745144672143,MUS 11,A02,891141,Staff,24,0,25,1
1745144673173,MUS 13,A01,891143,Staff,10,0,25,15
1745144673173,MUS 13,A02,891144,Staff,25,0,25,0
1745144674202,MUS 15,A01,891146,Staff,7,0,25,18
1745144674202,MUS 15,A02,891148,Staff,22,0,25,3
1745144674202,MUS 15,B01,891150,Staff,18,0,25,7
1745144674202,MUS 15,B02,891151,Staff,25,0,25,0
1745144675230,MUS 20,A01,891153,Staff,9,0,20,11
1745144675230,MUS 20,A02,891155,Staff,16,0,20,4
1745144676255,MUS 80,A00,891156,Staff,19,0,25,6
1745144676255,MUS 80,B00,891157,Staff,24,0,25,1
1745144677283,MUS 130,A00,891158,Ohnishi; Takae,35,0,35,0
1745144678311,MUS 150GS,A01,891160,Borgo; David Garcia,5,0,25,20
1745144679342,MUS 170,A01,891162,Freitas Caetano; Marcelo,21,0,25,4
1745144679342,MUS 170,A02,891164,Freitas Caetano; Marcelo,22,0,25,3
1745144680373,NANO 11,A00,886220,Vazquez Mena; Oscar,12,0,15,3
1745144681397,NANO 15,A01,886222,Drews; Aaron,9,0,10,1
1745144682428,NANO 104,A00,886224,Sirbuly; Donald,18,0,25,7
1745144683458,PH 40,A00,886528,Staff,29,0,40,11
1745144684484,PH 45,A01,886799,Staff,36,0,40,4
1745144685511,PH 110,A00,886802,Staff,7,0,40,33
1745144686539,PH 172,A00,906716,Staff,20,0,35,15
1745144687567,PH 191,A00,886803,Staff,23,0,40,17
1745144688598,PHIL 1,A00,889500,Staff,22,0,30,8
1745144689625,PHIL 10,A01,889549,Grush; Rick Scott,17,0,22,5
1745144689625,PHIL 10,A02,889551,Grush; Rick Scott,20,0,22,2
1745144690658,PHIL 28,A01,889559,Lamey; Andy M.,0,4,25,25
1745144690658,PHIL 28,A02,889561,Lamey; Andy M.,0,0,25,25
1745144690658,PHIL 28,A03,889572,Lamey; Andy M.,7,0,25,18
1745144691684,PHIL 35,A00,907839,Staff,32,0,33,1
1745144692714,PHIL 60,A00,889574,Staff,79,0,90,11
1745144693742,PHIL 105,A00,889579,Staff,0,1,0,0
1745144694776,PHIL 136,A00,889582,Fulkerson; Matthew Todd,27,0,45,18
1745144695804,PHIL 163,A01,889601,Staff,24,0,30,6
1745144695804,PHIL 163,B01,889606,Brandt; Reuven A,0,2,0,0
1745144696830,PHIL 164,A00,889610,Staff,20,0,30,10
1745144697860,PHIL 165,A00,889613,Staff,26,0,30,4
1745144698887,PHYS 1A,A00,886431,Staff,38,0,70,32
1745144699918,PHYS 1AL,001,886432,Tsai; Philbert S,0,0,30,30
1745144699918,PHYS 1AL,002,886436,Tsai; Philbert S,19,0,30,11
1745144700945,PHYS 1B,A00,886439,Staff,192,0,240,48
1745144701970,PHYS 1BL,001,886441,Tsai; Philbert S,0,1,30,30
1745144701970,PHYS 1BL,002,886444,Tsai; Philbert S,14,0,30,16
1745144702997,PHYS 1C,A00,896092,Arnold; Kam S,87,0,146,59
1745144704024,PHYS 1CL,001,886448,Tsai; Philbert S,0,4,30,30
1745144704024,PHYS 1CL,002,886449,Tsai; Philbert S,6,0,30,24
1745144704024,PHYS 1CL,003,886450,Tsai; Philbert S,22,0,30,8
1745144704024,PHYS 1CL,004,886451,Tsai; Philbert S,16,0,30,14
1745144705067,PHYS 2B,A01,886457,Staff,86,0,115,29
1745144706093,PHYS 2C,A01,886460,Shotwell; Brian,0,0,65,65
1745144707122,PHYS 2CL,A01,886467,Staff,0,3,28,28
1745144707122,PHYS 2CL,A02,886468,Staff,5,0,28,23
1745144708149,PHYS 2D,A01,886470,Staff,17,0,50,33
1745144709177,PHYS 4B,A01,886475,Grinstein; Benjamin,87,0,100,13
1745144710204,POLI 5,A00,891173,Desposato; Scott,17,0,25,8
1745144711229,POLI 5D,A01,891175,Staff,5,0,5,0
1745144711229,POLI 5D,B01,891178,Staff,5,0,5,0
1745144712258,POLI 11,A00,891179,Ferree; Karen E,3,0,25,22
1745144713286,POLI 12,A00,891180,Staff,21,0,30,9
1745144714313,POLI 27,A01,891182,Staff,29,0,75,46
1745144715339,POLI 30,A00,891183,Staff,0,3,30,30
1745144716410,POLI 100B,A00,891244,Staff,0,8,20,20
1745144717436,POLI 100I,A00,891247,Staff,19,0,30,11
1745144718464,POLI 104J,A00,891248,Nichter; Maysa,18,0,30,12
1745144719494,POLI 104U,A00,891250,Nichter; Maysa,9,0,30,21
1745144720520,POLI 108,A00,891253,Staff,0,0,0,4
1745144721544,POLI 110B,A00,891255,Wiens; David,22,0,25,3
1745144722574,POLI 112A,A00,891256,Wiens; David,15,0,25,10
1745144723599,POLI 114BR,A00,891261,Staff,22,0,30,8
1745144724624,POLI 117R,A00,891262,Forman; Fonna,12,0,50,38
1745144725654,POLI 118,A00,891264,Ingham; Sean,22,0,25,3
1745144726680,POLI 124A,A00,891265,Staff,19,0,20,1
1745144727706,POLI 125D,A00,891266,Nichter; Simeon C,9,0,25,16
1745144728733,POLI 126,A00,891268,Nichter; Simeon C,11,0,25,14
1745144729758,POLI 126AA,A00,891272,Staff,19,0,25,6
1745144730785,POLI 130AA,A00,891273,Staff,17,0,20,3
1745144731811,POLI 134AA,A00,891274,Staff,12,0,20,8
1745144733869,POLI 138,A00,891278,Staff,22,0,25,3
1745144734894,POLI 142K,A00,891280,Staff,17,0,25,8
1745144735922,POLI 142M,A00,891281,Gartzke; Erik,22,0,30,8
1745144736951,POLI 142P,A00,891284,Staff,21,0,30,9
1745144737980,POLI 143,A00,891285,Gartzke; Erik,17,0,30,13
1745144739006,POLI 153,A00,891286,Staff,20,0,20,0
1745144740031,POLI 170A,A00,891288,Staff,19,0,25,6
1745144741058,POLI 175,A00,891290,Staff,18,0,20,2
1745144742084,PSYC 1,A00,890674,Steiner; Eric Tomas,0,4,45,45
1745144743114,PSYC 2,A00,890676,Albright; Thomas D,25,0,35,10
1745144744144,PSYC 3,A00,890679,Staff,18,0,20,2
1745144745171,PSYC 60,A01,890684,Rickard; Timothy C.,7,0,45,38
1745144746199,PSYC 70,A01,890689,Geller; Emma Harlan,14,0,30,16
1745144747224,PSYC 100,A00,890690,Lacefield; Katharine I,0,43,180,180
1745144748250,PSYC 102,A00,890695,Staff,25,0,40,15
1745144749280,PSYC 105,A00,890699,Geller; Emma Harlan,78,0,100,22
1745144750312,PSYC 106,A00,890701,Gorman; Michael R.,15,0,30,15
1745144751339,PSYC 108,A00,890704,Adrian; Julia Anna,0,23,50,50
1745144752379,PSYC 118,A01,890712,Staff,18,0,30,12
1745144753406,PSYC 124,A00,890716,Chapman; Eddie Nathaniel,36,0,60,24
1745144754433,PSYC 131,A00,890717,Anagnostaras; Stephan,6,0,80,74
1745144755464,PSYC 137,A00,890719,Winkielman; Piotr,0,2,30,30
1745144756492,PSYC 144,A00,890721,Adrian; Julia Anna,0,3,45,45
1745144757523,PSYC 162,A00,890805,Staff,21,0,75,54
1745144758552,PSYC 169,A00,890810,Staff,0,15,30,30
1745144759582,PSYC 172,A00,890814,Gorman; Michael R.,14,0,30,16
1745144760613,PSYC 181,A00,890818,Anagnostaras; Stephan,63,0,200,137
1745144761640,PSYC 189,A00,890823,Staff,11,0,30,19
1745144762665,PSYC 191,A00,890884,Rickard; Timothy C.,0,11,35,35
1745144763692,PSYC 193,A00,890913,Staff,22,0,30,8
1745144763692,PSYC 193,B00,890914,Chapman; Eddie Nathaniel,25,0,30,5
1745144764718,PSYC 193L,A01,890918,Lowe; Angela Beth,29,0,30,1
1745144764718,PSYC 193L,B01,890921,Hurwitz; Ethan Scott,28,0,30,2
1745144764718,PSYC 193L,C01,890928,Staff,30,0,30,0
1745144765745,RELI 149,A00,886806,Rahimi; Babak,23,0,40,17
1745144766774,SE 9,A01,886814,Staff,13,0,20,7
1745144767807,SE 101B,A01,886816,Chadha; Mayank,8,0,30,22
1745144768837,SE 110B,A00,886818,Zhu; Qiang,0,16,45,45
1745144769865,SE 125,A01,886830,Staff,10,0,30,20
1745144770891,SE 130B,A01,886835,Staff,19,0,40,21
1745144771917,SE 131A,A01,886838,Krysl; Petr,37,0,55,18
1745144772944,SE 154,A00,886840,Staff,35,0,50,15
1745144773973,SE 164GS,A01,886849,Staff,13,0,20,7
1745144775000,SE 167GS,A01,886853,Staff,13,0,20,7
1745144776026,SIO 25,A01,890107,Staff,23,0,30,7
1745144777053,SIO 45,A00,890109,Cook; Geoffrey W,137,0,200,63
1745144778079,SIO 109R,A00,890110,Forman; Fonna,0,11,20,20
1745144779106,SIO 187,A01,890114,Kacev; David,21,0,40,19
1745144780135,SOCI 1,A01,890431,Thorpe; Charles Robert,21,0,30,9
1745144780135,SOCI 1,A02,890518,Thorpe; Charles Robert,30,0,30,0
1745144781161,SOCI 2,A01,957978,Staff,0,0,0,0
1745144781161,SOCI 2,A02,957979,Staff,0,3,0,0
1745144782188,SOCI 20,A01,890523,Calderon-Zaks; Michael Aar,24,0,30,6
1745144782188,SOCI 20,A02,890526,Calderon-Zaks; Michael Aar,29,0,30,1
1745144783214,SOCI 30,A01,890533,Pardo Guerra; Juan Pablo,37,0,40,3
1745144784243,SOCI 40,A01,890535,Staff,32,0,45,13
1745144785273,SOCI 104Q,A00,890559,Staff,20,0,30,10
1745144786304,SOCI 106,A00,890560,Arnal; Maud Marie Leonie,22,0,30,8
1745144787330,SOCI 110,A00,890567,Holkenbrink-Monk; Charlene,22,0,30,8
1745144788355,SOCI 112,A00,890568,Victoria Torres; Pablo,0,0,45,45
1745144789380,SOCI 115,A00,890597,Arnal; Maud Marie Leonie,33,0,45,12
1745144791442,SOCI 121,A00,890604,Pardo Guerra; Juan Pablo,40,0,45,5
1745144792473,SOCI 126,A01,890608,Staff,8,0,10,2
1745144793498,SOCI 127,A00,890609,Staff,23,0,30,7
1745144794523,SOCI 131,A00,890610,Thorpe; Charles Robert,38,0,45,7
1745144795550,SOCI 135,A00,890615,Payne; Christine Anna,19,0,45,26
1745144796579,SOCI 139,A00,890620,Staff,43,0,45,2
1745144797606,SOCI 148E,A00,890622,Calderon-Zaks; Michael Aar,39,0,45,6
1745144798632,SOCI 150,A00,890623,Kohler; Kristopher M.,36,0,45,9
1745144799659,SOCI 157,A00,890625,Jules-Rosette; Bennetta W.,18,0,20,2
1745144800684,SOCI 160,A00,890627,Payne; Christine Anna,26,0,45,19
1745144801711,SYN 1,A00,886855,Fish; Gwendolyn Anne,0,0,0,0
1745144801711,SYN 1,B00,906086,Fish; Gwendolyn Anne,0,0,0,2
1745144802738,SYN 2R,A00,886860,Staff,0,15,15,15
1745144802738,SYN 2R,B00,906106,Atkinson; Arthur Laird,0,14,15,15
1745144803767,SYN 100,A01,886866,Browne; Emily,0,29,20,20
1745144803767,SYN 100,B01,906128,Rock; Martin,0,4,20,20
1745144803767,SYN 100,C01,906140,Deavenport; James Cary,0,2,20,20
1745144803767,SYN 100,D01,907816,Deavenport; James Cary,0,3,20,20
1745144804799,TDAC 1,A00,890286,Walsh; Kim C.,11,0,20,9
1745144805828,TDAC 101,A00,890296,Basso; Beatrice,18,0,20,2
1745144806859,TDDE 131,A00,890297,Staff,47,0,50,3
1745144807886,TDDM 1,A00,890287,Weinberg; Sadie,26,0,30,4
1745144808918,TDGE 11,A00,890288,Fulton; Julia,155,0,200,45
1745144808918,TDGE 11,B00,890289,Castro; Robert Jess,188,0,200,12
1745144809948,TDGE 25,B00,957359,Walsh; Kim C.,9,0,20,11
1745144810973,TDGE 40,A01,890292,Power; Jade Yukana,28,0,30,2
1745144812005,TDGE 124,A00,890298,Havis; Allan,12,0,50,38
1745144813035,TDGE 131R,A00,890299,Burelle; Julie Sara Veronique,20,0,42,22
1745144814060,TDHT 101,A00,890300,Staff,12,0,20,8
1745144815086,TDHT 109,A01,890302,Anderson; Mysia Anyse,31,0,40,9
1745144816112,TDMV 1,A00,890293,Arcidiacono; Kristin,20,0,30,10
1745144817141,TDMV 2,A00,890294,Weinberg; Sadie,26,0,30,4
1745144818171,TDMV 3,A00,957878,Arcidiacono; Kristin,27,0,30,3
1745144820263,TDMV 138,A00,890304,Jun; Grace Shin Hae,25,0,40,15
1745144821288,TDMV 140,A00,890305,Corrales; Joseph Bernales,28,0,30,2
1745144822314,TDMV 142,A00,890307,Caligagan; Tony,30,0,40,10
1745144823345,TDMV 144,A00,890308,Camaya; Michelle Ann,26,0,30,4
1745144824371,TDPW 1,A00,890295,Stein; Deborah Isobel,5,0,20,15
1745144825402,USP 2,A01,890272,Lerner; Amy M,8,0,20,12
1745144826433,USP 3,A01,890274,Staff,21,0,30,9
1745144827461,USP 15,A01,890276,Sun; Feiyang,21,0,30,9
1745144828487,USP 25,A00,890277,Shenkman; Michael Thomas,21,0,25,4
1745144829513,USP 138,A00,890278,Staff,15,0,25,10
1745144830543,USP 143,A00,890279,Staff,30,0,70,40
1745144831567,USP 144,A00,890280,Chowdhury; Muhammed Zohir,19,0,30,11
1745144832596,USP 150,A00,890281,Boomhower; Matthew Charles,19,0,30,11
1745144833624,USP 151,A00,890282,Staff,17,0,20,3
1745144834650,USP 162,A00,890283,Andrews; Abigail Leslie,17,0,20,3
1745144835679,USP 168,A00,920477,Kwak; Nancy,2,0,5,3
1745144836707,USP 181,A00,890284,Staff,11,0,20,9
1745144837733,USP 191A,A00,890285,Staff,15,0,20,5
1745144838762,VIS 101,A00,886512,Staff,37,0,75,38
1745144839793,VIS 103,A00,886513,Cruz; Edwin Teddy,65,0,75,10
1745144840822,VIS 108,A00,886514,Staff,7,0,15,8
1745144841848,VIS 127P,A00,886515,Shen; Kuiyi,92,0,146,54
1745144842876,VIS 149,A00,886516,Yoldas; Pinar,1,0,15,14
1745144843903,VIS 164,A00,886526,Erdmann; Dean,21,0,22,1
1745144844933,VIS 194S,A00,886527,Staff,61,0,75,14
1745144845964,WCWP 10A,C00,886484,Staff,13,0,15,2
1745144846989,WCWP 10B,A00,886490,Staff,5,0,15,10
1745144846989,WCWP 10B,B00,886491,Staff,0,1,0,0
1745144846989,WCWP 10B,C00,886492,Staff,10,0,15,5
1745144848014,WCWP 100,A00,886494,Staff,0,3,15,15
1745144850149,AAS 10,A01,886199,Childs; Dennis R.,0,2,0,0
1745144851175,ANAR 104,A01,886940,Shtienberg; Gilad,27,0,30,3
1745144852201,ANAR 120,A00,886953,Staff,13,0,20,7
1745144853231,ANBI 148,A01,886955,Wilder; Linnea Lorene,32,0,40,8
1745144855282,ANSC 122,A00,886957,Staff,28,0,30,2
1745144856313,ANSC 150,A00,886958,Sloane; Julia Kathryn,6,0,15,9
1745144857345,ANSC 156,A00,886959,Jenkins; Janis A.,2,0,15,13
1745144858372,ANSC 180,A00,886960,Staff,12,0,17,5
1745144859399,ANSC 188,A00,886961,Jassal; Aftab,10,0,25,15
1745144860428,ANSC 190,A00,886962,Jassal; Aftab,14,0,25,11
1745144861454,ANSC 191,A00,886963,Staff,18,0,20,2
1745144862484,ANTH 3,A01,891689,Staff,19,0,20,1
1745144863513,ANTH 5,A00,886933,Semendeferi; Ekaterini,18,0,20,2
1745144864538,ANTH 10,A00,886934,Staff,0,8,30,30
1745144865564,ANTH 21,A01,886936,Staff,44,0,60,16
1745144866591,ANTH 23,A01,886938,Staff,94,0,100,6
1745144867618,ANTH 105,A00,886964,Stewart; Alexander B,94,0,100,6
1745144868643,ANTH 108,A00,886965,Pedersen; David,10,0,20,10
1745144869681,AWP 10,001,886147,Staff,0,0,0,0
1745144869681,AWP 10,002,886148,Staff,0,0,0,0
1745144869681,AWP 10,003,886149,Staff,0,0,0,0
1745144869681,AWP 10,004,886150,Staff,0,0,0,0
1745144869681,AWP 10,005,886151,Staff,0,0,0,0
1745144869681,AWP 10,006,886152,Staff,0,0,0,0
1745144869681,AWP 10,007,886153,Staff,0,0,0,0
1745144869681,AWP 10,008,886154,Staff,0,0,0,0
1745144869681,AWP 10,009,886155,Staff,0,0,0,0
1745144869681,AWP 10,010,886156,Staff,0,0,0,0
1745144869681,AWP 10,011,886158,Staff,0,0,0,0
1745144869681,AWP 10,012,886160,Staff,0,0,0,0
1745144869681,AWP 10,013,886161,Staff,0,0,0,0
1745144869681,AWP 10,014,886162,Staff,0,0,0,0
1745144869681,AWP 10,015,886163,Staff,0,0,0,0
1745144869681,AWP 10,016,886164,Staff,0,0,0,0
1745144869681,AWP 10,017,886165,Staff,0,0,0,0
1745144869681,AWP 10,018,886166,Staff,0,0,0,0
1745144869681,AWP 10,019,886168,Staff,0,0,0,0
1745144869681,AWP 10,020,886170,Staff,0,0,0,0
1745144869681,AWP 10,021,886172,Staff,0,0,0,0
1745144870709,AWP 10R,001,886173,Staff,0,0,0,0
1745144870709,AWP 10R,002,886174,Staff,0,1,0,0
1745144870709,AWP 10R,003,886175,Staff,0,0,0,0
1745144870709,AWP 10R,004,886176,Staff,0,0,0,0
1745144870709,AWP 10R,005,886177,Staff,0,0,0,0
1745144870709,AWP 10R,006,886178,Staff,0,0,0,0
1745144870709,AWP 10R,007,886179,Staff,0,0,0,0
1745144870709,AWP 10R,008,886181,Staff,0,0,0,0
1745144870709,AWP 10R,009,886182,Staff,0,0,0,0
1745144870709,AWP 10R,010,886183,Staff,0,0,0,0
1745144870709,AWP 10R,011,886184,Staff,0,0,0,0
1745144870709,AWP 10R,012,886185,Staff,0,0,0,0
1745144870709,AWP 10R,013,886186,Staff,0,0,0,0
1745144870709,AWP 10R,014,886187,Staff,0,0,0,0
1745144870709,AWP 10R,015,886188,Staff,0,0,0,0
1745144870709,AWP 10R,016,886189,Staff,0,0,0,0
1745144871735,AWP 102R,A00,886190,Staff,0,0,0,0
1745144871735,AWP 102R,B00,886191,Staff,0,0,0,0
1745144872761,BENG 100,A01,886193,Staff,19,0,30,11
1745144873789,BENG 122A,A01,886195,Hasty; Jeff M,20,0,30,10
1745144874816,BENG 166A,A00,886196,Sah; Robert Lie-Yuan,0,3,20,20
1745144875843,BIBC 102,A01,894320,Staff,0,2,46,46
1745144875843,BIBC 102,A02,894321,Staff,0,0,46,46
1745144875843,BIBC 102,A03,894344,Staff,21,0,46,25
1745144875843,BIBC 102,A04,894345,Staff,30,0,47,17
1745144876870,BICD 100R,A01,894365,Smith; Laurie,1,3,58,57
1745144876870,BICD 100R,A02,894366,Smith; Laurie,0,1,58,58
1745144876870,BICD 100R,A03,894367,Smith; Laurie,13,0,59,46
1745144877897,BICD 136,A01,894383,Gustafson-Brown; Cindy,16,0,50,34
1745144878926,BIEB 102,A01,894494,Butler; Shannon Rhey,67,0,130,63
1745144880991,BIEB 150,A01,894617,Wills; Christopher,0,3,13,13
1745144880991,BIEB 150,A02,894631,Wills; Christopher,0,3,13,13
1745144880991,BIEB 150,A03,894937,Wills; Christopher,0,3,13,13
1745144880991,BIEB 150,A04,894946,Wills; Christopher,0,1,11,11
1745144882020,BIEB 194,A00,906141,Kurle; Carolyn M.,14,0,20,6
1745144883049,BILD 1,A01,894154,Staff,8,0,19,11
1745144883049,BILD 1,A02,894155,Staff,15,0,19,4
1745144883049,BILD 1,A03,894160,Staff,18,0,19,1
1745144883049,BILD 1,A04,894161,Staff,16,0,18,2
1745144884078,BILD 2,A01,894168,Staff,0,0,50,50
1745144884078,BILD 2,A02,894169,Staff,0,0,50,50
1745144884078,BILD 2,A03,894179,Staff,27,0,50,23
1745144884078,BILD 2,A04,894203,Staff,42,0,50,8
1745144885104,BILD 3,A01,894213,Staff,24,0,31,7
1745144885104,BILD 3,A02,894214,Staff,28,0,31,3
1745144885104,BILD 3,A03,894235,Staff,30,0,31,1
1745144885104,BILD 3,A04,894236,Staff,29,0,32,3
1745144886136,BILD 4,A01,894253,Reuther; Keefe,12,0,24,12
1745144886136,BILD 4,A02,894258,Reuther; Keefe,19,0,24,5
1745144887163,BILD 5,A01,894276,Reuther; Keefe,40,0,50,10
1745144887163,BILD 5,A02,894277,Reuther; Keefe,48,0,50,2
1745144887163,BILD 5,A03,894290,Reuther; Keefe,47,0,50,3
1745144887163,BILD 5,A04,894291,Reuther; Keefe,50,0,50,0
1745144888191,BILD 24,A01,894297,Pirino; Giorgia,45,0,60,15
1745144889222,BIMM 100,A01,895012,Staff,0,14,0,1
1745144889222,BIMM 100,A02,895013,Staff,0,6,0,2
1745144889222,BIMM 100,A03,895014,Staff,0,7,0,0
1745144889222,BIMM 100,A04,895015,Staff,0,4,0,0
1745144890250,BIMM 101,A01,895017,McDonnell; Lisa Marie,0,2,24,24
1745144890250,BIMM 101,A02,895018,McDonnell; Lisa Marie,0,1,24,24
1745144890250,BIMM 101,B01,895020,McDonnell; Lisa Marie,0,3,24,24
1745144890250,BIMM 101,B02,895021,McDonnell; Lisa Marie,0,2,24,24
1745144891276,BIMM 110,A01,895023,Staff,7,0,25,18
1745144891276,BIMM 110,A02,895024,Staff,11,0,25,14
1745144891276,BIMM 110,A03,895025,Staff,22,0,25,3
1745144891276,BIMM 110,A04,895031,Staff,21,0,25,4
1745144892303,BIMM 120,A01,895114,Gustafson-Brown; Cindy,8,0,28,20
1745144892303,BIMM 120,A02,895126,Gustafson-Brown; Cindy,19,0,27,8
1745144893330,BIPN 100,A01,895130,Yang; Mingyu,13,0,38,25
1745144893330,BIPN 100,A02,895131,Yang; Mingyu,33,0,38,5
1745144893330,BIPN 100,A03,895132,Yang; Mingyu,33,0,38,5
1745144893330,BIPN 100,A04,895133,Yang; Mingyu,30,0,36,6
1745144894376,BIPN 120,A01,895135,Cooke; James Edward,0,2,13,13
1745144894376,BIPN 120,A02,895136,Cooke; James Edward,0,1,13,13
1745144894376,BIPN 120,A03,895137,Cooke; James Edward,0,0,13,13
1745144894376,BIPN 120,A04,895156,Cooke; James Edward,3,0,11,8
1745144895404,BIPN 134,A01,895235,Cooke; James Edward,0,2,25,25
1745144895404,BIPN 134,A02,895237,Cooke; James Edward,0,0,25,25
1745144895404,BIPN 134,A03,895240,Cooke; James Edward,12,0,25,13
1745144895404,BIPN 134,A04,895270,Cooke; James Edward,24,0,25,1
1745144896435,BIPN 189,A00,892103,Staff,0,20,9,9
1745144898493,CAT 124,A01,922009,Staff,0,1,20,20
1745144899532,CAT 125R,A00,886390,Morales; Celeste Georgianna,4,0,20,16
1745144899532,CAT 125R,B00,886391,Irwin; Matthew Joseph,0,1,20,20
1745144899532,CAT 125R,C00,886392,Smith; Lauryn Alissa,11,0,20,9
1745144899532,CAT 125R,D00,886393,Vanderschuit; Maya Alysia,6,0,20,14
1745144899532,CAT 125R,E00,886394,Marchisotto; Jennifer Anne,0,2,20,20
1745144900559,CENG 15,A01,886218,Drews; Aaron,1,0,5,4
1745144901589,CENG 113,A00,886219,Opatkiewicz; Justin Paul,16,0,25,9
1745144902620,CGS 101,A00,887044,Staff,13,0,20,7
1745144903646,CGS 105,A01,887046,Staff,16,0,25,9
1745144904676,CGS 112,A00,887047,Cuong; Marisol,12,0,15,3
1745144905705,CGS 113,A00,887048,Staff,24,0,30,6
1745144906730,CGS 120,A00,887049,Staff,12,0,17,5
1745144907758,CHEM 6A,A01,886336,Lam; Tin Yiu,44,0,50,6
1745144907758,CHEM 6A,A02,886338,Lam; Tin Yiu,43,0,50,7
1745144908792,CHEM 6B,A01,886341,Hopkins; Patrycja Anna,21,0,50,29
1745144908792,CHEM 6B,A02,886343,Hopkins; Patrycja Anna,46,0,50,4
1745144909825,CHEM 6C,A01,886346,Albizati; Kim F.,0,1,50,50
1745144909825,CHEM 6C,A02,886348,Albizati; Kim F.,38,0,50,12
1745144910851,CHEM 40A,A01,886352,Klosterman; Jeremy K,70,0,100,30
1745144911877,CHEM 40B,A01,886356,Klosterman; Jeremy K,0,4,100,100
1745144912902,CHEM 41B,A01,886360,Theodorakis; Emmanuel,30,0,50,20
1745144912902,CHEM 41B,A02,886362,Theodorakis; Emmanuel,46,0,50,4
1745144913933,CHIN 165A,A00,886382,Xu; Li,19,0,20,1
1745144914969,CLAS 120,A00,886387,Myerston Santana; Jacobo,36,0,40,4
1745144916001,COGS 9,A01,886967,Shannon; Kyle Michael,49,0,60,11
1745144917028,COGS 11,A01,886969,Staff,18,0,30,12
1745144918055,COGS 14A,A01,886971,Staff,26,0,60,34
1745144919086,COGS 14B,A01,886973,Hoffman; Drew Ellen,18,0,60,42
1745144920120,COGS 18,A01,886975,Morgan; Eric,41,0,60,19
1745144921149,COGS 20,A01,886977,Staff,6,0,8,2
1745144921149,COGS 20,A02,886978,Staff,6,0,7,1
1745144922176,COGS 100,A01,907783,Staff,6,0,30,24
1745144923203,COGS 101B,A01,886980,Staff,0,10,30,30
1745144924271,COGS 101C,A01,886982,Delgado; Tania,0,6,30,30
1745144925298,COGS 102A,A01,886984,Johnson; Christine M.,13,0,30,17
1745144926324,COGS 118B,A01,886986,Staff,0,25,60,60
1745144927355,COGS 150,A01,886988,Bergen; Benjamin,16,0,30,14
1745144928387,COGS 153,A00,886989,Delgado; Tania,0,6,30,30
1745144929414,COGS 186,A01,886991,Staff,3,0,30,27
1745144930456,COGS 187A,A01,886993,Boyle; Mary E. T.,12,0,30,18
1745144931485,COGS 189,A00,886994,Staff,13,0,30,17
1745144932512,COMM 10,A01,886996,Staff,11,0,25,14
1745144932512,COMM 10,A02,886997,Staff,21,0,25,4
1745144933539,COMM 20,A01,886999,Leuning; Grant Maurstad,33,0,40,7
1745144935592,COMM 100A,A01,887002,Staff,0,0,25,25
1745144935592,COMM 100A,A02,887003,Staff,20,0,25,5
1745144936618,COMM 100B,A01,887005,Staff,0,1,25,25
1745144937643,COMM 106D,A00,887006,Staff,22,0,40,18
1745144938668,COMM 110G,A00,887007,Whitworth-Smith; Andrew C,17,0,40,23
1745144939698,COMM 111B,A00,887008,Staff,31,0,40,9
1745144940725,COMM 113T,A00,887009,Abuelhiga; Soraya Jill,30,0,40,10
1745144940725,COMM 113T,B00,906733,Staff,40,0,40,0
1745144941756,COMM 145,A00,887010,Staff,21,0,40,19
1745144942783,COMM 146,A00,887054,Staff,31,0,40,9
1745144943811,COMM 190,A00,887012,Staff,9,0,23,14
1745144944842,CSE 8A,A50,887015,Cao; Yingjun,68,0,85,17
1745144945878,CSE 11,A01,887017,Cao; Yingjun,35,0,70,35
1745144946904,CSE 20,A01,887019,Staff,35,0,50,15
1745144947931,CSE 21,A01,887021,Braun; Oliver,81,0,100,19
1745144947931,CSE 21,B01,892583,Staff,48,0,50,2
1745144948957,CSE 30,A01,887025,Eldon; John,161,0,200,39
1745144949986,CSE 100,A01,887027,Staff,28,0,50,22
1745144949986,CSE 100,A02,887028,Staff,43,0,50,7
1745144951012,CSE 101,A01,887030,Braun; Oliver,79,0,100,21
1745144951012,CSE 101,B01,887032,Jones; Miles E,0,1,50,50
1745144951012,CSE 101,B02,887033,Jones; Miles E,13,0,50,37
1745144952039,CSE 105,A01,908084,Jones; Miles E,36,0,50,14
1745144952039,CSE 105,A02,908087,Jones; Miles E,38,0,50,12
1745144953066,CSE 135,A01,887035,Powell; Thomas Allan,8,0,50,42
1745144954094,CSE 142,A01,887037,Staff,22,0,60,38
1745144955120,CSE 142L,A01,887039,Staff,42,0,60,18
1745144956147,CSE 151A,A01,887041,Solares; Edwin A,60,0,100,40
1745144957174,CSE 175,A01,887043,Kumar; Rakesh,30,0,30,0
1745144958202,CSS 1,A01,886389,Staff,12,0,40,28
1745144959229,DSC 30,A01,908097,Liao; Soohyun Nam,54,0,75,21
1745144960259,DSC 40A,A01,908099,Shannon; Kyle Michael,37,0,50,13
1745144961288,DSC 40B,A01,908112,Staff,28,0,50,22
1745144962317,DSC 80,A01,908116,Staff,32,0,60,28
1745144963343,DSC 197,001,956863,Eldridge; Justin Matthew,9999,0,9999,0
1745144964371,ECE 5,A01,886400,Morris; Karcher William,3,0,6,3
1745144964371,ECE 5,A02,886401,Morris; Karcher William,5,0,6,1
1745144965400,ECE 148,A01,886403,Silberman; Jack,0,8,14,14
1745144966433,ECON 1,A01,887265,Crane; Meredith Helen,25,0,70,45
1745144966433,ECON 1,B01,887268,Staff,44,0,50,6
1745144967460,ECON 2,A01,887273,Crane; Meredith Helen,61,0,70,9
1745144968491,ECON 3,A01,887279,Rondina; Giacomo,44,0,70,26
1745144969523,ECON 4,A01,887282,Anderson; John Charles,0,1,10,10
1745144970550,ECON 5,A01,887285,Staff,39,0,45,6
1745144970550,ECON 5,B01,887292,Staff,43,0,45,2
1745144971580,ECON 100A,A01,887337,Newhouse; Herbert S,58,0,70,12
1745144971580,ECON 100A,B01,887349,Staff,45,0,50,5
1745144972608,ECON 100B,A01,887361,Du; Songzi,42,0,70,28
1745144973637,ECON 100C,A01,887445,Newhouse; Herbert S,61,0,70,9
1745144974668,ECON 105,A00,887488,Vespa; Emanuel Ignacio,24,0,35,11
1745144975698,ECON 109,A01,887506,Staff,29,0,35,6
1745144976735,ECON 110A,A01,887568,Alon; Titan Michael,1,0,35,34
1745144976735,ECON 110A,B01,907601,Alon; Titan Michael,27,0,35,8
1745144977763,ECON 110B,A01,887598,Levkoff; Steven B.,0,7,70,70
1745144978790,ECON 112,A00,887599,Rondina; Giacomo,20,0,35,15
1745144979823,ECON 120A,A01,887603,Dai; Yinlin,46,0,70,24
1745144980855,ECON 120C,A01,887608,Sun; Yixiao,0,0,35,35
1745144980855,ECON 120C,B01,887614,Sun; Yixiao,13,0,35,22
1745144981881,ECON 138,A00,887621,Bharadwaj; Prashant,0,18,20,20
1745144982908,ECON 171,A01,907666,Staff,27,0,35,8
1745144983934,ECON 175,A00,887626,Wu; Pak Yeung,27,0,35,8
1745144984961,ECON 190,A00,887640,Vespa; Emanuel Ignacio,26,0,35,9
1745144985993,EDS 25,A01,888197,Staff,0,0,0,0
1745144985993,EDS 25,A02,888209,Staff,0,0,0,0
1745144985993,EDS 25,A03,888210,Staff,0,0,0,0
1745144985993,EDS 25,A04,888212,Staff,0,0,0,0
1745144985993,EDS 25,A05,888213,Staff,0,0,0,0
1745144985993,EDS 25,A06,888214,Staff,0,0,0,0
1745144985993,EDS 25,A07,888235,Staff,0,0,0,0
1745144985993,EDS 25,A08,888236,Staff,0,0,0,0
1745144985993,EDS 25,A09,888240,Staff,0,0,0,0
1745144985993,EDS 25,A10,888244,Staff,0,0,0,0
1745144985993,EDS 25,B01,888273,Staff,0,0,0,0
1745144985993,EDS 25,B02,888285,Staff,0,0,0,0
1745144985993,EDS 25,B03,888423,Staff,29,0,30,1
1745144985993,EDS 25,B04,888432,Staff,0,0,0,0
1745144985993,EDS 25,B05,888433,Staff,0,0,0,0
1745144985993,EDS 25,B06,888467,Staff,0,0,0,0
1745144985993,EDS 25,B07,888468,Staff,0,0,0,0
1745144985993,EDS 25,B08,888479,Staff,0,0,0,0
1745144985993,EDS 25,B09,888484,Staff,0,0,0,0
1745144985993,EDS 25,B10,888487,Staff,0,0,0,0
1745144987021,EDS 38,A01,907700,Choi; Bailey Miyeon,30,0,30,0
1745144988048,EDS 112,A01,888601,Chapman; Thandeka K,23,0,40,17
1745144989073,EDS 115,A00,888697,Mendez; Kathrina Mendoza,17,0,30,13
1745144990104,EDS 116,A01,888893,Staff,38,0,40,2
1745144992168,EDS 124AR,A00,889133,Staff,33,0,50,17
1745144992168,EDS 124AR,B00,907471,Simon; Elizabeth A,42,0,50,8
1745144993195,EDS 124BR,A00,889134,Staff,57,0,100,43
1745144994222,EDS 125,A00,889135,Staff,26,0,30,4
1745144995250,EDS 126,A01,889138,Staff,37,0,40,3
1745144996282,EDS 164R,A01,889142,Wishard Guerra; Alison G.,38,0,50,12
1745144997309,ENG 30,A01,886396,Staff,0,0,0,0
1745144997309,ENG 30,B01,886398,Staff,0,0,0,0
1745144998342,ENVR 102,A00,906150,Montejo; Carolina,23,0,25,2
1745144999368,ETHN 103A,A00,887236,Man; Simeon S,0,5,0,0
1745145000398,ETHN 113,A00,887239,Staff,20,0,30,10
1745145001429,ETHN 116,A00,887240,Staff,20,0,25,5
1745145002454,ETHN 117,A00,887241,Choi; Esther Min,27,0,30,3
1745145003480,ETHN 118,A00,887243,Staff,24,0,30,6
1745145004508,ETHN 127,A00,887248,Cuong; Marisol,12,0,15,3
1745145005535,ETHN 139,A00,887250,Staff,8,0,10,2
1745145006567,ETHN 142,A00,887252,Staff,18,0,30,12
1745145007594,ETHN 161,A00,887253,Browne; Errol Tsekani,28,0,30,2
1745145008623,ETHN 163FR,A00,887255,Burelle; Julie Sara Veronique,4,0,5,1
1745145009651,GLBH 20,A00,889149,Elwardani; Nile Regina,15,0,42,27
1745145011701,GLBH 111,A01,889152,Burgos; Jose L.,17,0,17,0
1745145012733,GLBH 150,A00,889181,Sloane; Julia Kathryn,0,1,15,15
1745145014792,HDS 60,A01,886406,Warstadt; Melissa Fawn,76,0,80,4
1745145015820,HIAF 111,A00,889324,Gyamfi; Bright,0,4,0,0
1745145016847,HIEA 131,A00,889328,Staff,14,0,32,18
1745145017876,HIEA 144,A00,889333,Henry; Todd A.,29,0,32,3
1745145018902,HIEA 154,A00,889336,Henry; Todd A.,28,0,32,4
1745145019929,HIEU 106,A00,889339,Staff,28,0,32,4
1745145021987,HIEU 114,A00,889340,Staff,18,0,32,14
1745145023014,HIEU 135GS,A00,889342,Patterson; Patrick H.,0,0,1,22
1745145024040,HIEU 137,A00,889343,Edington; Claire Ellen,12,0,25,13
1745145025069,HIEU 148,A00,889345,Staff,16,0,32,16
1745145026095,HIEU 154,A00,889346,Biess; Frank Peter,24,0,32,8
1745145027121,HILA 102,A00,889351,Staff,13,0,32,19
1745145028147,HILD 2A,A01,889221,Lewandoski; Julia Mavis,0,5,32,32
1745145029172,HILD 7B,A01,889225,Man; Simeon S,0,7,32,32
1745145030198,HILD 7C,A01,889288,Alvarez; Luis A,0,8,32,32
1745145031226,HILD 30,A01,889323,Staff,0,1,32,32
1745145033274,HISC 119,A00,889383,Golan; Tal,22,0,32,10
1745145034304,HIUS 103,A00,889384,Man; Simeon S,10,0,32,22
1745145035331,HIUS 117,A00,919797,Kwak; Nancy,23,0,32,9
1745145036357,HIUS 142A,A00,919788,Staff,24,0,32,8
1745145038416,HIUS 149,A00,889386,Gyamfi; Bright,0,1,0,0
1745145039442,HIUS 155,A00,889387,Alvarez; Luis A,19,0,32,13
1745145040470,HUM 3,A01,886499,Caldwell; Michael Alan,24,0,50,26
1745145041496,HUM 3GS,A00,886500,Rodriguez; Bretton Sigfred,0,0,0,26
1745145042527,HUM 3R,A01,886502,Markman; Kristina,0,32,50,50
1745145043561,HUM 4,A01,886504,Crum; Matthew Stephen,28,0,50,22
1745145043561,HUM 4,B01,886506,West; Geoffrey Scott,25,0,50,25
1745145044587,HUM 4GS,A00,886507,Staff,0,0,0,13
1745145045614,HUM 5,A01,886509,Staff,35,0,50,15
1745145046646,HUM 5R,A01,886511,Zavodny; Tatiana Sophia,0,32,50,50
1745145047677,JAPN 180,A00,886407,Staff,25,0,40,15
1745145048705,LATI 50,A01,886409,Martin-Cabrera; Luis,9,0,22,13
1745145048705,LATI 50,A02,886410,Martin-Cabrera; Luis,20,0,22,2
1745145048705,LATI 50,A03,886411,Martin-Cabrera; Luis,22,0,22,0
1745145048705,LATI 50,A04,886412,Martin-Cabrera; Luis,15,0,22,7
1745145049731,LAWS 101,A00,907664,Staff,36,0,60,24
1745145050756,LIAB 1A,A00,889388,Saab; Dima,19,0,20,1
1745145051787,LIAB 1AX,A00,889389,El Cheddadi; Youniss,19,0,20,1
1745145052813,LIFR 1C,A00,889391,Van Moer; Vinciane G,9,0,20,11
1745145053838,LIFR 1CX,A00,889392,Van Moer; Vinciane G,8,0,20,12
1745145054868,LIFR 1D,A00,889393,Van Moer; Vinciane G,11,0,20,9
1745145055896,LIFR 1DX,A00,889394,Van Moer; Vinciane G,11,0,20,9
1745145056922,LIGN 7,A00,886923,Staff,30,0,50,20
1745145057953,LIGN 17,A00,886924,Kehler; Andrew Scott,133,0,150,17
1745145058979,LTAM 110,A00,889395,Staff,17,0,30,13
1745145060005,LTCH 101,A00,889397,Staff,22,0,25,3
1745145061031,LTCS 130,A00,889398,Staff,23,0,25,2
1745145062059,LTEA 138,A00,889399,Staff,25,0,40,15
1745145063090,LTEN 149,A00,889400,Wesling; Megan E.,6,0,25,19
1745145064119,LTEN 169,A00,889401,Staff,24,0,25,1
1745145065144,LTEN 180,A00,889402,Staff,12,0,15,3
1745145066170,LTEN 181,A00,889403,Staff,23,0,25,2
1745145067200,LTWL 100,A00,889404,Myerston Santana; Jacobo,8,0,25,17
1745145068225,LTWL 180GS,A00,889405,Staff,6,0,20,14
1745145069248,LTWL 181,A00,889406,Staff,19,0,25,6
1745145070280,LTWL 184,A00,889475,Mukherjee; Silpa,21,0,25,4
1745145071363,LTWR 102C,A00,889486,Staff,29,0,30,1
1745145072399,LTWR 115W,A00,889491,Staff,3,0,15,12
1745145073425,MAE 8,A01,886905,Staff,0,2,0,0
1745145074453,MAE 11,A00,886906,Bandaru; Prabhakar,0,0,50,50
1745145075485,MAE 20,A00,886907,Evdokimenko; Ekaterina,50,0,70,20
1745145076515,MAE 30B,A00,886909,Ghazinejad; Maziar,28,0,45,17
1745145077540,MAE 101B,A00,886910,Saintillan; David,36,0,45,9
1745145078569,MAE 105,A00,886911,Bandaru; Prabhakar,26,0,50,24
1745145079595,MAE 107,A00,886912,Staff,22,0,60,38
1745145080626,MAE 143B,A00,886913,Bewley; Thomas R,14,0,40,26
1745145081652,MAE 148,A01,886915,Silberman; Jack,5,0,14,9
1745145082677,MAE 160,A00,886916,Evdokimenko; Ekaterina,41,0,60,19
1745145083704,MATH 3C,A01,889681,Staff,2,0,30,28
1745145084730,MATH 10A,A01,889760,Staff,28,0,30,2
1745145084730,MATH 10A,A02,889783,Staff,30,0,30,0
1745145085759,MATH 10B,A01,889785,Verstraete; Jacques Allan,0,2,30,30
1745145085759,MATH 10B,A02,889795,Verstraete; Jacques Allan,0,2,30,30
1745145085759,MATH 10B,B01,889797,Verstraete; Jacques Allan,0,0,30,30
1745145085759,MATH 10B,B02,889828,Verstraete; Jacques Allan,23,0,30,7
1745145086790,MATH 10C,A01,889849,Habib; Yousaf,18,0,30,12
1745145086790,MATH 10C,A02,889852,Habib; Yousaf,20,0,30,10
1745145086790,MATH 10C,A03,889853,Habib; Yousaf,24,0,30,6
1745145086790,MATH 10C,A04,889858,Habib; Yousaf,21,0,30,9
1745145086790,MATH 10C,B01,889861,Staff,12,0,30,18
1745145086790,MATH 10C,B02,889862,Staff,26,0,30,4
1745145086790,MATH 10C,B03,889863,Staff,28,0,30,2
1745145086790,MATH 10C,B04,889967,Staff,25,0,30,5
1745145087824,MATH 18,A01,889974,Staff,15,0,30,15
1745145087824,MATH 18,A02,889977,Staff,25,0,30,5
1745145087824,MATH 18,B01,889984,Hardiman; Liam,26,0,30,4
1745145087824,MATH 18,B02,889985,Hardiman; Liam,28,0,30,2
1745145088856,MATH 20A,A01,889990,Suk; Andrew Hoon,31,0,35,4
1745145089884,MATH 20B,A01,889993,Ohm; Ko Woon,21,0,30,9
1745145089884,MATH 20B,A02,889994,Ohm; Ko Woon,30,0,30,0
1745145089884,MATH 20B,B01,889996,Ohm; Ko Woon,25,0,30,5
1745145089884,MATH 20B,B02,889997,Ohm; Ko Woon,24,0,30,6
1745145090919,MATH 20C,A01,889999,Hammock; Frances H,22,0,30,8
1745145090919,MATH 20C,A02,890003,Hammock; Frances H,23,0,30,7
1745145090919,MATH 20C,B01,890006,Hammock; Frances H,11,0,30,19
1745145090919,MATH 20C,B02,890007,Hammock; Frances H,18,0,30,12
1745145091945,MATH 20D,A01,890011,Cheng; Hsiao-Bing,6,0,30,24
1745145091945,MATH 20D,A02,890012,Cheng; Hsiao-Bing,27,0,30,3
1745145091945,MATH 20D,B01,890016,Cheng; Hsiao-Bing,19,0,30,11
1745145091945,MATH 20D,B02,890017,Cheng; Hsiao-Bing,15,0,30,15
1745145092971,MATH 20E,A01,890026,Harel; Guershon,10,0,30,20
1745145092971,MATH 20E,A02,890029,Harel; Guershon,24,0,30,6
1745145092971,MATH 20E,B01,890033,Harel; Guershon,14,0,30,16
1745145092971,MATH 20E,B02,890101,Harel; Guershon,27,0,30,3
1745145094000,MATH 102,A01,890104,Staff,20,0,30,10
1745145094000,MATH 102,A02,890105,Staff,30,0,30,0
1745145095026,MATH 103B,A01,890116,Salehi Golsefidy; Alireza,8,0,30,22
1745145095026,MATH 103B,B01,890118,Staff,0,4,30,30
1745145096053,MATH 109,A01,890121,Aliabadi Sr.; Mohsen,6,0,30,24
1745145096053,MATH 109,B01,890124,Upadrashta; Pranav Kumar,23,0,30,7
1745145097079,MATH 120A,A01,890126,Eggers; John Dietrich,15,0,30,15
1745145098105,MATH 142B,A01,890128,Ioana; Adrian,17,0,30,13
1745145098105,MATH 142B,A02,890129,Ioana; Adrian,15,0,30,15
1745145099131,MATH 154,A01,890174,Staff,0,1,30,30
1745145099131,MATH 154,A02,890182,Staff,15,0,30,15
1745145100159,MATH 168A,A01,890197,Dumitriu; Ioana,22,0,35,13
1745145101214,MATH 170A,A01,890240,Nie; Jiawang,5,0,30,25
1745145101214,MATH 170A,A02,890241,Nie; Jiawang,18,0,30,12
1745145101214,MATH 170A,A03,890249,Nie; Jiawang,23,0,30,7
1745145102244,MATH 170B,A01,957891,Nag; Panchali,25,0,35,10
1745145104298,MATH 181A,A01,908025,Staff,0,8,35,35
1745145105328,MATH 193B,A01,890265,Staff,3,0,35,32
1745145106356,MGT 4,A01,890311,Anderson; John Charles,57,0,88,31
1745145107382,MGT 5,A00,907740,Staff,41,0,98,57
1745145108416,MGT 12,A00,890312,Lindenberger; Wade Douglas,70,0,98,28
1745145109443,MGT 16,A00,957883,Staff,84,0,98,14
1745145111498,MGT 45,A00,890314,Pecore; Joseph P.,57,0,98,41
1745145112526,MGT 71,A00,890315,Staff,6,0,98,92
1745145113556,MGT 100,A00,890316,Yavorsky; Daniel Ryan,58,0,98,40
1745145114583,MGT 103,A00,890317,Ehrich; Kristine R,77,0,98,21
1745145115612,MGT 105,A00,890356,Bates; Kenneth Walter,19,0,98,79
1745145116638,MGT 112,A00,890360,Ehrich; Kristine R,65,0,98,33
1745145117727,MGT 127R,A00,907732,Zhu; Kevin Xiaoguo,32,0,98,66
1745145118751,MGT 131B,A00,890361,Anderson; John Charles,75,0,98,23
1745145119778,MGT 137,A00,890362,Lindenberger; Wade Douglas,68,0,98,30
1745145120807,MGT 160,A00,890369,Johnson; Erik Barry,36,0,98,62
1745145122873,MGT 164,A00,890372,Zimmermann; Carsten,0,29,98,98
1745145123904,MGT 180,A00,890374,Bliss; Barbara Ann,31,0,98,67
1745145124935,MMW 15,A01,886414,Chang; Edmond Yi-Teh,0,10,28,28
1745145124935,MMW 15,A02,886415,Chang; Edmond Yi-Teh,0,10,28,28
1745145124935,MMW 15,A03,886416,Chang; Edmond Yi-Teh,0,8,28,28
1745145124935,MMW 15,A04,886417,Chang; Edmond Yi-Teh,0,8,28,28
1745145124935,MMW 15,B01,886419,Chang; Edmond Yi-Teh,0,8,28,28
1745145124935,MMW 15,B02,886420,Chang; Edmond Yi-Teh,0,9,28,28
1745145124935,MMW 15,B03,886421,Chang; Edmond Yi-Teh,0,9,28,28
1745145124935,MMW 15,B04,886422,Chang; Edmond Yi-Teh,0,9,28,28
1745145124935,MMW 15,C01,886424,Staff,0,10,28,28
1745145124935,MMW 15,C02,886425,Staff,0,10,28,28
1745145124935,MMW 15,C03,886426,Staff,0,9,28,28
1745145124935,MMW 15,C04,886427,Staff,0,9,28,28
1745145125963,MMW 15GS,A00,906910,Patterson; Patrick H.,5,0,28,23
1745145126990,MMW 122R,A01,886429,Rahimi; Babak,0,23,28,28
1745145126990,MMW 122R,A02,886430,Rahimi; Babak,0,23,28,28
1745145128022,MUS 1A,A01,890937,Staff,7,0,25,18
1745145128022,MUS 1A,A02,891035,Staff,15,0,25,10
1745145128022,MUS 1A,B00,907849,Staff,48,0,50,2
1745145128022,MUS 1A,B01,907850,Staff,25,0,25,0
1745145128022,MUS 1A,B02,907851,Staff,25,0,25,0
1745145130075,MUS 2AK,A00,957092,Ohnishi; Takae,15,0,15,0
1745145131102,MUS 4,A01,891044,Staff,6,0,25,19
1745145131102,MUS 4,A02,891045,Staff,24,0,25,1
1745145131102,MUS 4,B01,891048,Staff,20,0,25,5
1745145131102,MUS 4,B02,891050,Staff,25,0,25,0
1745145132131,MUS 5,A01,957506,Dubnov; Shlomo,4,0,25,21
1745145132131,MUS 5,A02,957622,Dubnov; Shlomo,21,0,25,4
1745145132131,MUS 5,A03,957623,Dubnov; Shlomo,23,0,25,2
1745145133162,MUS 6,A01,891053,Freitas Caetano; Marcelo,23,0,25,2
1745145133162,MUS 6,A02,891054,Freitas Caetano; Marcelo,23,0,25,2
1745145134191,MUS 7,A01,891081,Staff,0,0,25,25
1745145134191,MUS 7,A02,891082,Staff,14,0,25,11
1745145135220,MUS 8GS,A00,891118,Borgo; David Garcia,5,0,25,20
1745145136248,MUS 11,A01,891140,Staff,12,0,25,13
1745145136248,MUS 11,A02,891141,Staff,24,0,25,1
1745145137275,MUS 13,A01,891143,Staff,10,0,25,15
1745145137275,MUS 13,A02,891144,Staff,25,0,25,0
1745145138306,MUS 15,A01,891146,Staff,7,0,25,18
1745145138306,MUS 15,A02,891148,Staff,22,0,25,3
1745145138306,MUS 15,B01,891150,Staff,18,0,25,7
1745145138306,MUS 15,B02,891151,Staff,25,0,25,0
1745145139336,MUS 20,A01,891153,Staff,9,0,20,11
1745145139336,MUS 20,A02,891155,Staff,16,0,20,4
1745145140361,MUS 80,A00,891156,Staff,19,0,25,6
1745145140361,MUS 80,B00,891157,Staff,24,0,25,1
1745145141388,MUS 130,A00,891158,Ohnishi; Takae,35,0,35,0
1745145142414,MUS 150GS,A01,891160,Borgo; David Garcia,5,0,25,20
1745145143483,MUS 170,A01,891162,Freitas Caetano; Marcelo,21,0,25,4
1745145143483,MUS 170,A02,891164,Freitas Caetano; Marcelo,22,0,25,3
1745145144515,NANO 11,A00,886220,Vazquez Mena; Oscar,12,0,15,3
1745145145544,NANO 15,A01,886222,Drews; Aaron,9,0,10,1
1745145146574,NANO 104,A00,886224,Sirbuly; Donald,18,0,25,7
1745145147600,PH 40,A00,886528,Staff,29,0,40,11
1745145148627,PH 45,A01,886799,Staff,36,0,40,4
1745145149654,PH 110,A00,886802,Staff,7,0,40,33
1745145150680,PH 172,A00,906716,Staff,20,0,35,15
1745145151705,PH 191,A00,886803,Staff,23,0,40,17
1745145152731,PHIL 1,A00,889500,Staff,22,0,30,8
1745145153758,PHIL 10,A01,889549,Grush; Rick Scott,17,0,22,5
1745145153758,PHIL 10,A02,889551,Grush; Rick Scott,20,0,22,2
1745145154787,PHIL 28,A01,889559,Lamey; Andy M.,0,4,25,25
1745145154787,PHIL 28,A02,889561,Lamey; Andy M.,0,0,25,25
1745145154787,PHIL 28,A03,889572,Lamey; Andy M.,7,0,25,18
1745145155813,PHIL 35,A00,907839,Staff,32,0,33,1
1745145156841,PHIL 60,A00,889574,Staff,79,0,90,11
1745145157867,PHIL 105,A00,889579,Staff,0,1,0,0
1745145158892,PHIL 136,A00,889582,Fulkerson; Matthew Todd,27,0,45,18
1745145159925,PHIL 163,A01,889601,Staff,24,0,30,6
1745145159925,PHIL 163,B01,889606,Brandt; Reuven A,0,2,0,0
1745145160955,PHIL 164,A00,889610,Staff,20,0,30,10
1745145162186,PHIL 165,A00,889613,Staff,26,0,30,4
1745145163218,PHYS 1A,A00,886431,Staff,38,0,70,32
1745145164244,PHYS 1AL,001,886432,Tsai; Philbert S,0,0,30,30
1745145164244,PHYS 1AL,002,886436,Tsai; Philbert S,19,0,30,11
1745145165268,PHYS 1B,A00,886439,Staff,192,0,240,48
1745145166295,PHYS 1BL,001,886441,Tsai; Philbert S,0,1,30,30
1745145166295,PHYS 1BL,002,886444,Tsai; Philbert S,14,0,30,16
1745145167321,PHYS 1C,A00,896092,Arnold; Kam S,87,0,146,59
1745145168353,PHYS 1CL,001,886448,Tsai; Philbert S,0,4,30,30
1745145168353,PHYS 1CL,002,886449,Tsai; Philbert S,6,0,30,24
1745145168353,PHYS 1CL,003,886450,Tsai; Philbert S,22,0,30,8
1745145168353,PHYS 1CL,004,886451,Tsai; Philbert S,16,0,30,14
1745145169379,PHYS 2B,A01,886457,Staff,86,0,115,29
1745145170412,PHYS 2C,A01,886460,Shotwell; Brian,0,0,65,65
1745145171439,PHYS 2CL,A01,886467,Staff,0,3,28,28
1745145171439,PHYS 2CL,A02,886468,Staff,5,0,28,23
1745145172468,PHYS 2D,A01,886470,Staff,17,0,50,33
1745145173496,PHYS 4B,A01,886475,Grinstein; Benjamin,87,0,100,13
1745145174526,POLI 5,A00,891173,Desposato; Scott,17,0,25,8
1745145175553,POLI 5D,A01,891175,Staff,5,0,5,0
1745145175553,POLI 5D,B01,891178,Staff,5,0,5,0
1745145176582,POLI 11,A00,891179,Ferree; Karen E,3,0,25,22
1745145177609,POLI 12,A00,891180,Staff,21,0,30,9
1745145178636,POLI 27,A01,891182,Staff,29,0,75,46
1745145179667,POLI 30,A00,891183,Staff,0,3,30,30
1745145180694,POLI 100B,A00,891244,Staff,0,8,20,20
1745145181722,POLI 100I,A00,891247,Staff,19,0,30,11
1745145182752,POLI 104J,A00,891248,Nichter; Maysa,18,0,30,12
1745145183778,POLI 104U,A00,891250,Nichter; Maysa,9,0,30,21
1745145184806,POLI 108,A00,891253,Staff,0,0,0,4
1745145185832,POLI 110B,A00,891255,Wiens; David,22,0,25,3
1745145186857,POLI 112A,A00,891256,Wiens; David,15,0,25,10
1745145187883,POLI 114BR,A00,891261,Staff,22,0,30,8
1745145188911,POLI 117R,A00,891262,Forman; Fonna,12,0,50,38
1745145189943,POLI 118,A00,891264,Ingham; Sean,22,0,25,3
1745145190967,POLI 124A,A00,891265,Staff,19,0,20,1
1745145191993,POLI 125D,A00,891266,Nichter; Simeon C,9,0,25,16
1745145193022,POLI 126,A00,891268,Nichter; Simeon C,11,0,25,14
1745145194045,POLI 126AA,A00,891272,Staff,19,0,25,6
1745145195073,POLI 130AA,A00,891273,Staff,17,0,20,3
1745145196098,POLI 134AA,A00,891274,Staff,12,0,20,8
1745145198151,POLI 138,A00,891278,Staff,22,0,25,3
1745145199181,POLI 142K,A00,891280,Staff,17,0,25,8
1745145200210,POLI 142M,A00,891281,Gartzke; Erik,22,0,30,8
1745145201234,POLI 142P,A00,891284,Staff,21,0,30,9
1745145202259,POLI 143,A00,891285,Gartzke; Erik,17,0,30,13
1745145203285,POLI 153,A00,891286,Staff,20,0,20,0
1745145204314,POLI 170A,A00,891288,Staff,19,0,25,6
1745145205343,POLI 175,A00,891290,Staff,18,0,20,2
1745145206373,PSYC 1,A00,890674,Steiner; Eric Tomas,0,4,45,45
1745145207405,PSYC 2,A00,890676,Albright; Thomas D,25,0,35,10
1745145208431,PSYC 3,A00,890679,Staff,18,0,20,2
1745145209458,PSYC 60,A01,890684,Rickard; Timothy C.,7,0,45,38
1745145210487,PSYC 70,A01,890689,Geller; Emma Harlan,14,0,30,16
1745145211513,PSYC 100,A00,890690,Lacefield; Katharine I,0,43,180,180
1745145212539,PSYC 102,A00,890695,Staff,25,0,40,15
1745145213565,PSYC 105,A00,890699,Geller; Emma Harlan,78,0,100,22
1745145214593,PSYC 106,A00,890701,Gorman; Michael R.,15,0,30,15
1745145215626,PSYC 108,A00,890704,Adrian; Julia Anna,0,23,50,50
1745145216652,PSYC 118,A01,890712,Staff,18,0,30,12
1745145217677,PSYC 124,A00,890716,Chapman; Eddie Nathaniel,36,0,60,24
1745145218703,PSYC 131,A00,890717,Anagnostaras; Stephan,6,0,80,74
1745145219729,PSYC 137,A00,890719,Winkielman; Piotr,0,2,30,30
1745145220756,PSYC 144,A00,890721,Adrian; Julia Anna,0,3,45,45
1745145221783,PSYC 162,A00,890805,Staff,21,0,75,54
1745145222810,PSYC 169,A00,890810,Staff,0,15,30,30
1745145223839,PSYC 172,A00,890814,Gorman; Michael R.,14,0,30,16
1745145224865,PSYC 181,A00,890818,Anagnostaras; Stephan,63,0,200,137
1745145225891,PSYC 189,A00,890823,Staff,11,0,30,19
1745145226918,PSYC 191,A00,890884,Rickard; Timothy C.,0,11,35,35
1745145227949,PSYC 193,A00,890913,Staff,22,0,30,8
1745145227949,PSYC 193,B00,890914,Chapman; Eddie Nathaniel,25,0,30,5
1745145228982,PSYC 193L,A01,890918,Lowe; Angela Beth,29,0,30,1
1745145228982,PSYC 193L,B01,890921,Hurwitz; Ethan Scott,28,0,30,2
1745145228982,PSYC 193L,C01,890928,Staff,30,0,30,0
1745145230013,RELI 149,A00,886806,Rahimi; Babak,23,0,40,17
1745145231038,SE 9,A01,886814,Staff,13,0,20,7
1745145232063,SE 101B,A01,886816,Chadha; Mayank,8,0,30,22
1745145233089,SE 110B,A00,886818,Zhu; Qiang,0,16,45,45
1745145234116,SE 125,A01,886830,Staff,10,0,30,20
1745145235144,SE 130B,A01,886835,Staff,19,0,40,21
1745145236170,SE 131A,A01,886838,Krysl; Petr,37,0,55,18
1745145237197,SE 154,A00,886840,Staff,35,0,50,15
1745145238225,SE 164GS,A01,886849,Staff,13,0,20,7
1745145239251,SE 167GS,A01,886853,Staff,13,0,20,7
1745145240278,SIO 25,A01,890107,Staff,23,0,30,7
1745145241304,SIO 45,A00,890109,Cook; Geoffrey W,137,0,200,63
1745145242332,SIO 109R,A00,890110,Forman; Fonna,0,11,20,20
1745145243358,SIO 187,A01,890114,Kacev; David,21,0,40,19
1745145244392,SOCI 1,A01,890431,Thorpe; Charles Robert,21,0,30,9
1745145244392,SOCI 1,A02,890518,Thorpe; Charles Robert,30,0,30,0
1745145245417,SOCI 2,A01,957978,Staff,0,0,0,0
1745145245417,SOCI 2,A02,957979,Staff,0,3,0,0
1745145246446,SOCI 20,A01,890523,Calderon-Zaks; Michael Aar,24,0,30,6
1745145246446,SOCI 20,A02,890526,Calderon-Zaks; Michael Aar,29,0,30,1
1745145247473,SOCI 30,A01,890533,Pardo Guerra; Juan Pablo,37,0,40,3
1745145248500,SOCI 40,A01,890535,Staff,32,0,45,13
1745145249527,SOCI 104Q,A00,890559,Staff,20,0,30,10
1745145250555,SOCI 106,A00,890560,Arnal; Maud Marie Leonie,22,0,30,8
1745145251581,SOCI 110,A00,890567,Holkenbrink-Monk; Charlene,22,0,30,8
1745145252605,SOCI 112,A00,890568,Victoria Torres; Pablo,0,0,45,45
1745145253636,SOCI 115,A00,890597,Arnal; Maud Marie Leonie,33,0,45,12
1745145255695,SOCI 121,A00,890604,Pardo Guerra; Juan Pablo,40,0,45,5
1745145256720,SOCI 126,A01,890608,Staff,8,0,10,2
1745145257744,SOCI 127,A00,890609,Staff,23,0,30,7
1745145258769,SOCI 131,A00,890610,Thorpe; Charles Robert,38,0,45,7
1745145259795,SOCI 135,A00,890615,Payne; Christine Anna,19,0,45,26
1745145260863,SOCI 139,A00,890620,Staff,43,0,45,2
1745145261889,SOCI 148E,A00,890622,Calderon-Zaks; Michael Aar,39,0,45,6
1745145262916,SOCI 150,A00,890623,Kohler; Kristopher M.,36,0,45,9
1745145263942,SOCI 157,A00,890625,Jules-Rosette; Bennetta W.,18,0,20,2
1745145264967,SOCI 160,A00,890627,Payne; Christine Anna,26,0,45,19
1745145265996,SYN 1,A00,886855,Fish; Gwendolyn Anne,0,0,0,0
1745145265996,SYN 1,B00,906086,Fish; Gwendolyn Anne,0,0,0,2
1745145267020,SYN 2R,A00,886860,Staff,0,15,15,15
1745145267020,SYN 2R,B00,906106,Atkinson; Arthur Laird,0,14,15,15
1745145268048,SYN 100,A01,886866,Browne; Emily,0,29,20,20
1745145268048,SYN 100,B01,906128,Rock; Martin,0,4,20,20
1745145268048,SYN 100,C01,906140,Deavenport; James Cary,0,2,20,20
1745145268048,SYN 100,D01,907816,Deavenport; James Cary,0,3,20,20
1745145269076,TDAC 1,A00,890286,Walsh; Kim C.,11,0,20,9
1745145270100,TDAC 101,A00,890296,Basso; Beatrice,18,0,20,2
1745145271127,TDDE 131,A00,890297,Staff,47,0,50,3
1745145272154,TDDM 1,A00,890287,Weinberg; Sadie,26,0,30,4
1745145273180,TDGE 11,A00,890288,Fulton; Julia,155,0,200,45
1745145273180,TDGE 11,B00,890289,Castro; Robert Jess,188,0,200,12
1745145274209,TDGE 25,B00,957359,Walsh; Kim C.,9,0,20,11
1745145275240,TDGE 40,A01,890292,Power; Jade Yukana,28,0,30,2
1745145276270,TDGE 124,A00,890298,Havis; Allan,12,0,50,38
1745145277298,TDGE 131R,A00,890299,Burelle; Julie Sara Veronique,20,0,42,22
1745145278323,TDHT 101,A00,890300,Staff,12,0,20,8
1745145279347,TDHT 109,A01,890302,Anderson; Mysia Anyse,31,0,40,9
1745145280374,TDMV 1,A00,890293,Arcidiacono; Kristin,20,0,30,10
1745145281406,TDMV 2,A00,890294,Weinberg; Sadie,26,0,30,4
1745145282431,TDMV 3,A00,957878,Arcidiacono; Kristin,27,0,30,3
1745145284510,TDMV 138,A00,890304,Jun; Grace Shin Hae,25,0,40,15
1745145285538,TDMV 140,A00,890305,Corrales; Joseph Bernales,28,0,30,2
1745145286566,TDMV 142,A00,890307,Caligagan; Tony,30,0,40,10
1745145287589,TDMV 144,A00,890308,Camaya; Michelle Ann,26,0,30,4
1745145288615,TDPW 1,A00,890295,Stein; Deborah Isobel,5,0,20,15
1745145289640,USP 2,A01,890272,Lerner; Amy M,8,0,20,12
1745145290665,USP 3,A01,890274,Staff,21,0,30,9
1745145291691,USP 15,A01,890276,Sun; Feiyang,21,0,30,9
1745145292722,USP 25,A00,890277,Shenkman; Michael Thomas,21,0,25,4
1745145293752,USP 138,A00,890278,Staff,15,0,25,10
1745145294779,USP 143,A00,890279,Staff,30,0,70,40
1745145295807,USP 144,A00,890280,Chowdhury; Muhammed Zohir,19,0,30,11
1745145296834,USP 150,A00,890281,Boomhower; Matthew Charles,19,0,30,11
1745145297863,USP 151,A00,890282,Staff,17,0,20,3
1745145298889,USP 162,A00,890283,Andrews; Abigail Leslie,17,0,20,3
1745145299915,USP 168,A00,920477,Kwak; Nancy,2,0,5,3
1745145300944,USP 181,A00,890284,Staff,11,0,20,9
1745145301973,USP 191A,A00,890285,Staff,15,0,20,5
1745145303001,VIS 101,A00,886512,Staff,37,0,75,38
1745145304028,VIS 103,A00,886513,Cruz; Edwin Teddy,65,0,75,10
1745145305056,VIS 108,A00,886514,Staff,7,0,15,8
1745145306082,VIS 127P,A00,886515,Shen; Kuiyi,92,0,146,54
1745145307108,VIS 149,A00,886516,Yoldas; Pinar,1,0,15,14
1745145308135,VIS 164,A00,886526,Erdmann; Dean,21,0,22,1
1745145309165,VIS 194S,A00,886527,Staff,61,0,75,14
1745145310195,WCWP 10A,C00,886484,Staff,13,0,15,2
1745145311221,WCWP 10B,A00,886490,Staff,5,0,15,10
1745145311221,WCWP 10B,B00,886491,Staff,0,1,0,0
1745145311221,WCWP 10B,C00,886492,Staff,10,0,15,5
1745145312248,WCWP 100,A00,886494,Staff,0,3,15,15
1745145314365,AAS 10,A01,886199,Childs; Dennis R.,0,2,0,0
1745145315392,ANAR 104,A01,886940,Shtienberg; Gilad,27,0,30,3
1745145316419,ANAR 120,A00,886953,Staff,13,0,20,7
1745145317445,ANBI 148,A01,886955,Wilder; Linnea Lorene,32,0,40,8
1745145319505,ANSC 122,A00,886957,Staff,28,0,30,2
1745145320534,ANSC 150,A00,886958,Sloane; Julia Kathryn,6,0,15,9
1745145321566,ANSC 156,A00,886959,Jenkins; Janis A.,2,0,15,13
1745145322592,ANSC 180,A00,886960,Staff,12,0,17,5
1745145323618,ANSC 188,A00,886961,Jassal; Aftab,10,0,25,15
1745145324647,ANSC 190,A00,886962,Jassal; Aftab,14,0,25,11
1745145325672,ANSC 191,A00,886963,Staff,18,0,20,2
1745145326697,ANTH 3,A01,891689,Staff,19,0,20,1
1745145327723,ANTH 5,A00,886933,Semendeferi; Ekaterini,18,0,20,2
1745145328748,ANTH 10,A00,886934,Staff,0,8,30,30
1745145329779,ANTH 21,A01,886936,Staff,44,0,60,16
1745145330806,ANTH 23,A01,886938,Staff,94,0,100,6
1745145331836,ANTH 105,A00,886964,Stewart; Alexander B,94,0,100,6
1745145332863,ANTH 108,A00,886965,Pedersen; David,10,0,20,10
1745145333891,AWP 10,001,886147,Staff,0,0,0,0
1745145333891,AWP 10,002,886148,Staff,0,0,0,0
1745145333891,AWP 10,003,886149,Staff,0,0,0,0
1745145333891,AWP 10,004,886150,Staff,0,0,0,0
1745145333891,AWP 10,005,886151,Staff,0,0,0,0
1745145333891,AWP 10,006,886152,Staff,0,0,0,0
1745145333891,AWP 10,007,886153,Staff,0,0,0,0
1745145333891,AWP 10,008,886154,Staff,0,0,0,0
1745145333891,AWP 10,009,886155,Staff,0,0,0,0
1745145333891,AWP 10,010,886156,Staff,0,0,0,0
1745145333891,AWP 10,011,886158,Staff,0,0,0,0
1745145333891,AWP 10,012,886160,Staff,0,0,0,0
1745145333891,AWP 10,013,886161,Staff,0,0,0,0
1745145333891,AWP 10,014,886162,Staff,0,0,0,0
1745145333891,AWP 10,015,886163,Staff,0,0,0,0
1745145333891,AWP 10,016,886164,Staff,0,0,0,0
1745145333891,AWP 10,017,886165,Staff,0,0,0,0
1745145333891,AWP 10,018,886166,Staff,0,0,0,0
1745145333891,AWP 10,019,886168,Staff,0,0,0,0
1745145333891,AWP 10,020,886170,Staff,0,0,0,0
1745145333891,AWP 10,021,886172,Staff,0,0,0,0
1745145334920,AWP 10R,001,886173,Staff,0,0,0,0
1745145334920,AWP 10R,002,886174,Staff,0,1,0,0
1745145334920,AWP 10R,003,886175,Staff,0,0,0,0
1745145334920,AWP 10R,004,886176,Staff,0,0,0,0
1745145334920,AWP 10R,005,886177,Staff,0,0,0,0
1745145334920,AWP 10R,006,886178,Staff,0,0,0,0
1745145334920,AWP 10R,007,886179,Staff,0,0,0,0
1745145334920,AWP 10R,008,886181,Staff,0,0,0,0
1745145334920,AWP 10R,009,886182,Staff,0,0,0,0
1745145334920,AWP 10R,010,886183,Staff,0,0,0,0
1745145334920,AWP 10R,011,886184,Staff,0,0,0,0
1745145334920,AWP 10R,012,886185,Staff,0,0,0,0
1745145334920,AWP 10R,013,886186,Staff,0,0,0,0
1745145334920,AWP 10R,014,886187,Staff,0,0,0,0
1745145334920,AWP 10R,015,886188,Staff,0,0,0,0
1745145334920,AWP 10R,016,886189,Staff,0,0,0,0
1745145335949,AWP 102R,A00,886190,Staff,0,0,0,0
1745145335949,AWP 102R,B00,886191,Staff,0,0,0,0
1745145336976,BENG 100,A01,886193,Staff,19,0,30,11
1745145338054,BENG 122A,A01,886195,Hasty; Jeff M,20,0,30,10
1745145339084,BENG 166A,A00,886196,Sah; Robert Lie-Yuan,0,3,20,20
1745145340115,BIBC 102,A01,894320,Staff,0,2,46,46
1745145340115,BIBC 102,A02,894321,Staff,0,0,46,46
1745145340115,BIBC 102,A03,894344,Staff,21,0,46,25
1745145340115,BIBC 102,A04,894345,Staff,30,0,47,17
1745145341142,BICD 100R,A01,894365,Smith; Laurie,1,3,58,57
1745145341142,BICD 100R,A02,894366,Smith; Laurie,0,1,58,58
1745145341142,BICD 100R,A03,894367,Smith; Laurie,13,0,59,46
1745145342177,BICD 136,A01,894383,Gustafson-Brown; Cindy,16,0,50,34
1745145343202,BIEB 102,A01,894494,Butler; Shannon Rhey,67,0,130,63
1745145345263,BIEB 150,A01,894617,Wills; Christopher,0,3,13,13
1745145345263,BIEB 150,A02,894631,Wills; Christopher,0,3,13,13
1745145345263,BIEB 150,A03,894937,Wills; Christopher,0,3,13,13
1745145345263,BIEB 150,A04,894946,Wills; Christopher,0,1,11,11
1745145346289,BIEB 194,A00,906141,Kurle; Carolyn M.,14,0,20,6
1745145347320,BILD 1,A01,894154,Staff,8,0,19,11
1745145347320,BILD 1,A02,894155,Staff,15,0,19,4
1745145347320,BILD 1,A03,894160,Staff,18,0,19,1
1745145347320,BILD 1,A04,894161,Staff,16,0,18,2
1745145348350,BILD 2,A01,894168,Staff,0,0,50,50
1745145348350,BILD 2,A02,894169,Staff,0,0,50,50
1745145348350,BILD 2,A03,894179,Staff,27,0,50,23
1745145348350,BILD 2,A04,894203,Staff,42,0,50,8
1745145349382,BILD 3,A01,894213,Staff,24,0,31,7
1745145349382,BILD 3,A02,894214,Staff,28,0,31,3
1745145349382,BILD 3,A03,894235,Staff,30,0,31,1
1745145349382,BILD 3,A04,894236,Staff,29,0,32,3
1745145350408,BILD 4,A01,894253,Reuther; Keefe,12,0,24,12
1745145350408,BILD 4,A02,894258,Reuther; Keefe,19,0,24,5
1745145351435,BILD 5,A01,894276,Reuther; Keefe,40,0,50,10
1745145351435,BILD 5,A02,894277,Reuther; Keefe,48,0,50,2
1745145351435,BILD 5,A03,894290,Reuther; Keefe,47,0,50,3
1745145351435,BILD 5,A04,894291,Reuther; Keefe,50,0,50,0
1745145352462,BILD 24,A01,894297,Pirino; Giorgia,45,0,60,15
1745145353495,BIMM 100,A01,895012,Staff,0,14,0,1
1745145353495,BIMM 100,A02,895013,Staff,0,6,0,2
1745145353495,BIMM 100,A03,895014,Staff,0,7,0,0
1745145353495,BIMM 100,A04,895015,Staff,0,4,0,0
1745145354524,BIMM 101,A01,895017,McDonnell; Lisa Marie,0,2,24,24
1745145354524,BIMM 101,A02,895018,McDonnell; Lisa Marie,0,1,24,24
1745145354524,BIMM 101,B01,895020,McDonnell; Lisa Marie,0,3,24,24
1745145354524,BIMM 101,B02,895021,McDonnell; Lisa Marie,0,2,24,24
1745145355556,BIMM 110,A01,895023,Staff,7,0,25,18
1745145355556,BIMM 110,A02,895024,Staff,11,0,25,14
1745145355556,BIMM 110,A03,895025,Staff,22,0,25,3
1745145355556,BIMM 110,A04,895031,Staff,21,0,25,4
1745145356584,BIMM 120,A01,895114,Gustafson-Brown; Cindy,8,0,28,20
1745145356584,BIMM 120,A02,895126,Gustafson-Brown; Cindy,19,0,27,8
1745145357617,BIPN 100,A01,895130,Yang; Mingyu,13,0,38,25
1745145357617,BIPN 100,A02,895131,Yang; Mingyu,33,0,38,5
1745145357617,BIPN 100,A03,895132,Yang; Mingyu,33,0,38,5
1745145357617,BIPN 100,A04,895133,Yang; Mingyu,30,0,36,6
1745145358643,BIPN 120,A01,895135,Cooke; James Edward,0,2,13,13
1745145358643,BIPN 120,A02,895136,Cooke; James Edward,0,1,13,13
1745145358643,BIPN 120,A03,895137,Cooke; James Edward,0,0,13,13
1745145358643,BIPN 120,A04,895156,Cooke; James Edward,3,0,11,8
1745145359675,BIPN 134,A01,895235,Cooke; James Edward,0,2,25,25
1745145359675,BIPN 134,A02,895237,Cooke; James Edward,0,0,25,25
1745145359675,BIPN 134,A03,895240,Cooke; James Edward,12,0,25,13
1745145359675,BIPN 134,A04,895270,Cooke; James Edward,24,0,25,1
1745145360706,BIPN 189,A00,892103,Staff,0,20,9,9
1745145362763,CAT 124,A01,922009,Staff,0,1,20,20
1745145363794,CAT 125R,A00,886390,Morales; Celeste Georgianna,4,0,20,16
1745145363794,CAT 125R,B00,886391,Irwin; Matthew Joseph,0,1,20,20
1745145363794,CAT 125R,C00,886392,Smith; Lauryn Alissa,11,0,20,9
1745145363794,CAT 125R,D00,886393,Vanderschuit; Maya Alysia,6,0,20,14
1745145363794,CAT 125R,E00,886394,Marchisotto; Jennifer Anne,0,2,20,20
1745145364880,CENG 15,A01,886218,Drews; Aaron,1,0,5,4
1745145365911,CENG 113,A00,886219,Opatkiewicz; Justin Paul,16,0,25,9
1745145366938,CGS 101,A00,887044,Staff,13,0,20,7
1745145367968,CGS 105,A01,887046,Staff,16,0,25,9
1745145368995,CGS 112,A00,887047,Cuong; Marisol,12,0,15,3
1745145370024,CGS 113,A00,887048,Staff,24,0,30,6
1745145371049,CGS 120,A00,887049,Staff,12,0,17,5
1745145372081,CHEM 6A,A01,886336,Lam; Tin Yiu,44,0,50,6
1745145372081,CHEM 6A,A02,886338,Lam; Tin Yiu,43,0,50,7
1745145373107,CHEM 6B,A01,886341,Hopkins; Patrycja Anna,21,0,50,29
1745145373107,CHEM 6B,A02,886343,Hopkins; Patrycja Anna,46,0,50,4
1745145374136,CHEM 6C,A01,886346,Albizati; Kim F.,0,1,50,50
1745145374136,CHEM 6C,A02,886348,Albizati; Kim F.,38,0,50,12
1745145375162,CHEM 40A,A01,886352,Klosterman; Jeremy K,70,0,100,30
1745145376189,CHEM 40B,A01,886356,Klosterman; Jeremy K,0,4,100,100
1745145377220,CHEM 41B,A01,886360,Theodorakis; Emmanuel,30,0,50,20
1745145377220,CHEM 41B,A02,886362,Theodorakis; Emmanuel,46,0,50,4
1745145378247,CHIN 165A,A00,886382,Xu; Li,19,0,20,1
1745145379274,CLAS 120,A00,886387,Myerston Santana; Jacobo,36,0,40,4
1745145380300,COGS 9,A01,886967,Shannon; Kyle Michael,49,0,60,11
1745145381330,COGS 11,A01,886969,Staff,18,0,30,12
1745145382355,COGS 14A,A01,886971,Staff,26,0,60,34
1745145383382,COGS 14B,A01,886973,Hoffman; Drew Ellen,18,0,60,42
1745145384409,COGS 18,A01,886975,Morgan; Eric,41,0,60,19
1745145385438,COGS 20,A01,886977,Staff,6,0,8,2
1745145385438,COGS 20,A02,886978,Staff,6,0,7,1
1745145386467,COGS 100,A01,907783,Staff,6,0,30,24
1745145387496,COGS 101B,A01,886980,Staff,0,10,30,30
1745145388527,COGS 101C,A01,886982,Delgado; Tania,0,6,30,30
1745145389557,COGS 102A,A01,886984,Johnson; Christine M.,13,0,30,17
1745145390587,COGS 118B,A01,886986,Staff,0,25,60,60
1745145391613,COGS 150,A01,886988,Bergen; Benjamin,16,0,30,14
1745145392643,COGS 153,A00,886989,Delgado; Tania,0,6,30,30
1745145393674,COGS 186,A01,886991,Staff,3,0,30,27
1745145394699,COGS 187A,A01,886993,Boyle; Mary E. T.,12,0,30,18
1745145395727,COGS 189,A00,886994,Staff,13,0,30,17
1745145396757,COMM 10,A01,886996,Staff,11,0,25,14
1745145396757,COMM 10,A02,886997,Staff,21,0,25,4
1745145397788,COMM 20,A01,886999,Leuning; Grant Maurstad,33,0,40,7
1745145399841,COMM 100A,A01,887002,Staff,0,0,25,25
1745145399841,COMM 100A,A02,887003,Staff,20,0,25,5
1745145400866,COMM 100B,A01,887005,Staff,0,1,25,25
1745145401892,COMM 106D,A00,887006,Staff,22,0,40,18
1745145402919,COMM 110G,A00,887007,Whitworth-Smith; Andrew C,17,0,40,23
1745145403945,COMM 111B,A00,887008,Staff,31,0,40,9
1745145404974,COMM 113T,A00,887009,Abuelhiga; Soraya Jill,30,0,40,10
1745145404974,COMM 113T,B00,906733,Staff,40,0,40,0
1745145405999,COMM 145,A00,887010,Staff,21,0,40,19
1745145407029,COMM 146,A00,887054,Staff,31,0,40,9
1745145408056,COMM 190,A00,887012,Staff,9,0,23,14
1745145409087,CSE 8A,A50,887015,Cao; Yingjun,68,0,85,17
1745145410113,CSE 11,A01,887017,Cao; Yingjun,35,0,70,35
1745145411139,CSE 20,A01,887019,Staff,35,0,50,15
1745145412174,CSE 21,A01,887021,Braun; Oliver,81,0,100,19
1745145412174,CSE 21,B01,892583,Staff,48,0,50,2
1745145413206,CSE 30,A01,887025,Eldon; John,161,0,200,39
1745145414233,CSE 100,A01,887027,Staff,28,0,50,22
1745145414233,CSE 100,A02,887028,Staff,43,0,50,7
1745145415259,CSE 101,A01,887030,Braun; Oliver,79,0,100,21
1745145415259,CSE 101,B01,887032,Jones; Miles E,0,1,50,50
1745145415259,CSE 101,B02,887033,Jones; Miles E,13,0,50,37
1745145416287,CSE 105,A01,908084,Jones; Miles E,36,0,50,14
1745145416287,CSE 105,A02,908087,Jones; Miles E,38,0,50,12
1745145417318,CSE 135,A01,887035,Powell; Thomas Allan,8,0,50,42
1745145418343,CSE 142,A01,887037,Staff,22,0,60,38
1745145419370,CSE 142L,A01,887039,Staff,42,0,60,18
1745145420402,CSE 151A,A01,887041,Solares; Edwin A,60,0,100,40
1745145421427,CSE 175,A01,887043,Kumar; Rakesh,30,0,30,0
1745145422460,CSS 1,A01,886389,Staff,12,0,40,28
1745145423500,DSC 30,A01,908097,Liao; Soohyun Nam,54,0,75,21
1745145424531,DSC 40A,A01,908099,Shannon; Kyle Michael,37,0,50,13
1745145425557,DSC 40B,A01,908112,Staff,28,0,50,22
1745145426583,DSC 80,A01,908116,Staff,32,0,60,28
1745145427609,DSC 197,001,956863,Eldridge; Justin Matthew,9999,0,9999,0
1745145428641,ECE 5,A01,886400,Morris; Karcher William,3,0,6,3
1745145428641,ECE 5,A02,886401,Morris; Karcher William,5,0,6,1
1745145429667,ECE 148,A01,886403,Silberman; Jack,0,8,14,14
1745145430699,ECON 1,A01,887265,Crane; Meredith Helen,25,0,70,45
1745145430699,ECON 1,B01,887268,Staff,44,0,50,6
1745145431725,ECON 2,A01,887273,Crane; Meredith Helen,61,0,70,9
1745145432756,ECON 3,A01,887279,Rondina; Giacomo,44,0,70,26
1745145433789,ECON 4,A01,887282,Anderson; John Charles,0,1,10,10
1745145434819,ECON 5,A01,887285,Staff,39,0,45,6
1745145434819,ECON 5,B01,887292,Staff,43,0,45,2
1745145435846,ECON 100A,A01,887337,Newhouse; Herbert S,58,0,70,12
1745145435846,ECON 100A,B01,887349,Staff,45,0,50,5
1745145436873,ECON 100B,A01,887361,Du; Songzi,42,0,70,28
1745145437903,ECON 100C,A01,887445,Newhouse; Herbert S,61,0,70,9
1745145438933,ECON 105,A00,887488,Vespa; Emanuel Ignacio,24,0,35,11
1745145439963,ECON 109,A01,887506,Staff,29,0,35,6
1745145440998,ECON 110A,A01,887568,Alon; Titan Michael,1,0,35,34
1745145440998,ECON 110A,B01,907601,Alon; Titan Michael,27,0,35,8
1745145442030,ECON 110B,A01,887598,Levkoff; Steven B.,0,7,70,70
1745145443056,ECON 112,A00,887599,Rondina; Giacomo,20,0,35,15
1745145444081,ECON 120A,A01,887603,Dai; Yinlin,46,0,70,24
1745145445108,ECON 120C,A01,887608,Sun; Yixiao,0,0,35,35
1745145445108,ECON 120C,B01,887614,Sun; Yixiao,13,0,35,22
1745145446137,ECON 138,A00,887621,Bharadwaj; Prashant,0,18,20,20
1745145447167,ECON 171,A01,907666,Staff,27,0,35,8
1745145448199,ECON 175,A00,887626,Wu; Pak Yeung,27,0,35,8
1745145449225,ECON 190,A00,887640,Vespa; Emanuel Ignacio,26,0,35,9
1745145450256,EDS 25,A01,888197,Staff,0,0,0,0
1745145450256,EDS 25,A02,888209,Staff,0,0,0,0
1745145450256,EDS 25,A03,888210,Staff,0,0,0,0
1745145450256,EDS 25,A04,888212,Staff,0,0,0,0
1745145450256,EDS 25,A05,888213,Staff,0,0,0,0
1745145450256,EDS 25,A06,888214,Staff,0,0,0,0
1745145450256,EDS 25,A07,888235,Staff,0,0,0,0
1745145450256,EDS 25,A08,888236,Staff,0,0,0,0
1745145450256,EDS 25,A09,888240,Staff,0,0,0,0
1745145450256,EDS 25,A10,888244,Staff,0,0,0,0
1745145450256,EDS 25,B01,888273,Staff,0,0,0,0
1745145450256,EDS 25,B02,888285,Staff,0,0,0,0
1745145450256,EDS 25,B03,888423,Staff,29,0,30,1
1745145450256,EDS 25,B04,888432,Staff,0,0,0,0
1745145450256,EDS 25,B05,888433,Staff,0,0,0,0
1745145450256,EDS 25,B06,888467,Staff,0,0,0,0
1745145450256,EDS 25,B07,888468,Staff,0,0,0,0
1745145450256,EDS 25,B08,888479,Staff,0,0,0,0
1745145450256,EDS 25,B09,888484,Staff,0,0,0,0
1745145450256,EDS 25,B10,888487,Staff,0,0,0,0
1745145451285,EDS 38,A01,907700,Choi; Bailey Miyeon,30,0,30,0
1745145452311,EDS 112,A01,888601,Chapman; Thandeka K,23,0,40,17
1745145453339,EDS 115,A00,888697,Mendez; Kathrina Mendoza,17,0,30,13
1745145454369,EDS 116,A01,888893,Staff,38,0,40,2
1745145456432,EDS 124AR,A00,889133,Staff,33,0,50,17
1745145456432,EDS 124AR,B00,907471,Simon; Elizabeth A,42,0,50,8
1745145457459,EDS 124BR,A00,889134,Staff,57,0,100,43
1745145458488,EDS 125,A00,889135,Staff,26,0,30,4
1745145459515,EDS 126,A01,889138,Staff,37,0,40,3
1745145460541,EDS 164R,A01,889142,Wishard Guerra; Alison G.,38,0,50,12
1745145461569,ENG 30,A01,886396,Staff,0,0,0,0
1745145461569,ENG 30,B01,886398,Staff,0,0,0,0
1745145462596,ENVR 102,A00,906150,Montejo; Carolina,23,0,25,2
1745145463625,ETHN 103A,A00,887236,Man; Simeon S,0,5,0,0
1745145464650,ETHN 113,A00,887239,Staff,20,0,30,10
1745145465681,ETHN 116,A00,887240,Staff,20,0,25,5
1745145466708,ETHN 117,A00,887241,Choi; Esther Min,27,0,30,3
1745145467737,ETHN 118,A00,887243,Staff,24,0,30,6
1745145468802,ETHN 127,A00,887248,Cuong; Marisol,12,0,15,3
1745145469828,ETHN 139,A00,887250,Staff,8,0,10,2
1745145470859,ETHN 142,A00,887252,Staff,18,0,30,12
1745145471892,ETHN 161,A00,887253,Browne; Errol Tsekani,28,0,30,2
1745145472922,ETHN 163FR,A00,887255,Burelle; Julie Sara Veronique,4,0,5,1
1745145473955,GLBH 20,A00,889149,Elwardani; Nile Regina,15,0,42,27
1745145476012,GLBH 111,A01,889152,Burgos; Jose L.,17,0,17,0
1745145477037,GLBH 150,A00,889181,Sloane; Julia Kathryn,0,1,15,15
1745145479089,HDS 60,A01,886406,Warstadt; Melissa Fawn,76,0,80,4
1745145480116,HIAF 111,A00,889324,Gyamfi; Bright,0,4,0,0
1745145481144,HIEA 131,A00,889328,Staff,14,0,32,18
1745145482187,HIEA 144,A00,889333,Henry; Todd A.,29,0,32,3
1745145483211,HIEA 154,A00,889336,Henry; Todd A.,28,0,32,4
1745145484241,HIEU 106,A00,889339,Staff,28,0,32,4
1745145486292,HIEU 114,A00,889340,Staff,18,0,32,14
1745145487318,HIEU 135GS,A00,889342,Patterson; Patrick H.,0,0,1,22
1745145488347,HIEU 137,A00,889343,Edington; Claire Ellen,12,0,25,13
1745145489372,HIEU 148,A00,889345,Staff,16,0,32,16
1745145490400,HIEU 154,A00,889346,Biess; Frank Peter,24,0,32,8
1745145491429,HILA 102,A00,889351,Staff,13,0,32,19
1745145492456,HILD 2A,A01,889221,Lewandoski; Julia Mavis,0,5,32,32
1745145493488,HILD 7B,A01,889225,Man; Simeon S,0,7,32,32
1745145494514,HILD 7C,A01,889288,Alvarez; Luis A,0,8,32,32
1745145495543,HILD 30,A01,889323,Staff,0,1,32,32
1745145497597,HISC 119,A00,889383,Golan; Tal,22,0,32,10
1745145498626,HIUS 103,A00,889384,Man; Simeon S,10,0,32,22
1745145499652,HIUS 117,A00,919797,Kwak; Nancy,23,0,32,9
1745145500681,HIUS 142A,A00,919788,Staff,24,0,32,8
1745145502737,HIUS 149,A00,889386,Gyamfi; Bright,0,1,0,0
1745145503766,HIUS 155,A00,889387,Alvarez; Luis A,19,0,32,13
1745145504797,HUM 3,A01,886499,Caldwell; Michael Alan,24,0,50,26
1745145505823,HUM 3GS,A00,886500,Rodriguez; Bretton Sigfred,0,0,0,26
1745145506850,HUM 3R,A01,886502,Markman; Kristina,0,32,50,50
1745145507885,HUM 4,A01,886504,Crum; Matthew Stephen,28,0,50,22
1745145507885,HUM 4,B01,886506,West; Geoffrey Scott,25,0,50,25
1745145508909,HUM 4GS,A00,886507,Staff,0,0,0,13
1745145509934,HUM 5,A01,886509,Staff,35,0,50,15
1745145510961,HUM 5R,A01,886511,Zavodny; Tatiana Sophia,0,32,50,50
1745145511986,JAPN 180,A00,886407,Staff,25,0,40,15
1745145513011,LATI 50,A01,886409,Martin-Cabrera; Luis,9,0,22,13
1745145513011,LATI 50,A02,886410,Martin-Cabrera; Luis,20,0,22,2
1745145513011,LATI 50,A03,886411,Martin-Cabrera; Luis,22,0,22,0
1745145513011,LATI 50,A04,886412,Martin-Cabrera; Luis,15,0,22,7
1745145514041,LAWS 101,A00,907664,Staff,36,0,60,24
1745145515072,LIAB 1A,A00,889388,Saab; Dima,19,0,20,1
1745145516099,LIAB 1AX,A00,889389,El Cheddadi; Youniss,19,0,20,1
1745145517129,LIFR 1C,A00,889391,Van Moer; Vinciane G,9,0,20,11
1745145518158,LIFR 1CX,A00,889392,Van Moer; Vinciane G,8,0,20,12
1745145519184,LIFR 1D,A00,889393,Van Moer; Vinciane G,11,0,20,9
1745145520211,LIFR 1DX,A00,889394,Van Moer; Vinciane G,11,0,20,9
1745145521237,LIGN 7,A00,886923,Staff,30,0,50,20
1745145522267,LIGN 17,A00,886924,Kehler; Andrew Scott,133,0,150,17
1745145523294,LTAM 110,A00,889395,Staff,17,0,30,13
1745145524321,LTCH 101,A00,889397,Staff,22,0,25,3
1745145525348,LTCS 130,A00,889398,Staff,23,0,25,2
1745145526376,LTEA 138,A00,889399,Staff,25,0,40,15
1745145527407,LTEN 149,A00,889400,Wesling; Megan E.,6,0,25,19
1745145528432,LTEN 169,A00,889401,Staff,24,0,25,1
1745145529461,LTEN 180,A00,889402,Staff,12,0,15,3
1745145530486,LTEN 181,A00,889403,Staff,23,0,25,2
1745145531511,LTWL 100,A00,889404,Myerston Santana; Jacobo,8,0,25,17
1745145532536,LTWL 180GS,A00,889405,Staff,6,0,20,14
1745145533567,LTWL 181,A00,889406,Staff,19,0,25,6
1745145534594,LTWL 184,A00,889475,Mukherjee; Silpa,21,0,25,4
1745145535622,LTWR 102C,A00,889486,Staff,29,0,30,1
1745145536652,LTWR 115W,A00,889491,Staff,3,0,15,12
1745145537680,MAE 8,A01,886905,Staff,0,2,0,0
1745145538707,MAE 11,A00,886906,Bandaru; Prabhakar,0,0,50,50
1745145539734,MAE 20,A00,886907,Evdokimenko; Ekaterina,50,0,70,20
1745145540762,MAE 30B,A00,886909,Ghazinejad; Maziar,28,0,45,17
1745145541795,MAE 101B,A00,886910,Saintillan; David,36,0,45,9
1745145542823,MAE 105,A00,886911,Bandaru; Prabhakar,26,0,50,24
1745145543852,MAE 107,A00,886912,Staff,22,0,60,38
1745145544879,MAE 143B,A00,886913,Bewley; Thomas R,14,0,40,26
1745145545905,MAE 148,A01,886915,Silberman; Jack,5,0,14,9
1745145546936,MAE 160,A00,886916,Evdokimenko; Ekaterina,41,0,60,19
1745145547964,MATH 3C,A01,889681,Staff,2,0,30,28
1745145548996,MATH 10A,A01,889760,Staff,28,0,30,2
1745145548996,MATH 10A,A02,889783,Staff,30,0,30,0
1745145550038,MATH 10B,A01,889785,Verstraete; Jacques Allan,0,2,30,30
1745145550038,MATH 10B,A02,889795,Verstraete; Jacques Allan,0,2,30,30
1745145550038,MATH 10B,B01,889797,Verstraete; Jacques Allan,0,0,30,30
1745145550038,MATH 10B,B02,889828,Verstraete; Jacques Allan,23,0,30,7
1745145551075,MATH 10C,A01,889849,Habib; Yousaf,18,0,30,12
1745145551075,MATH 10C,A02,889852,Habib; Yousaf,20,0,30,10
1745145551075,MATH 10C,A03,889853,Habib; Yousaf,24,0,30,6
1745145551075,MATH 10C,A04,889858,Habib; Yousaf,21,0,30,9
1745145551075,MATH 10C,B01,889861,Staff,12,0,30,18
1745145551075,MATH 10C,B02,889862,Staff,26,0,30,4
1745145551075,MATH 10C,B03,889863,Staff,28,0,30,2
1745145551075,MATH 10C,B04,889967,Staff,25,0,30,5
1745145552109,MATH 18,A01,889974,Staff,15,0,30,15
1745145552109,MATH 18,A02,889977,Staff,25,0,30,5
1745145552109,MATH 18,B01,889984,Hardiman; Liam,26,0,30,4
1745145552109,MATH 18,B02,889985,Hardiman; Liam,28,0,30,2
1745145553137,MATH 20A,A01,889990,Suk; Andrew Hoon,31,0,35,4
1745145554164,MATH 20B,A01,889993,Ohm; Ko Woon,21,0,30,9
1745145554164,MATH 20B,A02,889994,Ohm; Ko Woon,30,0,30,0
1745145554164,MATH 20B,B01,889996,Ohm; Ko Woon,25,0,30,5
1745145554164,MATH 20B,B02,889997,Ohm; Ko Woon,24,0,30,6
1745145555191,MATH 20C,A01,889999,Hammock; Frances H,22,0,30,8
1745145555191,MATH 20C,A02,890003,Hammock; Frances H,23,0,30,7
1745145555191,MATH 20C,B01,890006,Hammock; Frances H,11,0,30,19
1745145555191,MATH 20C,B02,890007,Hammock; Frances H,18,0,30,12
1745145556227,MATH 20D,A01,890011,Cheng; Hsiao-Bing,6,0,30,24
1745145556227,MATH 20D,A02,890012,Cheng; Hsiao-Bing,27,0,30,3
1745145556227,MATH 20D,B01,890016,Cheng; Hsiao-Bing,19,0,30,11
1745145556227,MATH 20D,B02,890017,Cheng; Hsiao-Bing,15,0,30,15
1745145557260,MATH 20E,A01,890026,Harel; Guershon,10,0,30,20
1745145557260,MATH 20E,A02,890029,Harel; Guershon,24,0,30,6
1745145557260,MATH 20E,B01,890033,Harel; Guershon,14,0,30,16
1745145557260,MATH 20E,B02,890101,Harel; Guershon,27,0,30,3
1745145558286,MATH 102,A01,890104,Staff,20,0,30,10
1745145558286,MATH 102,A02,890105,Staff,30,0,30,0
1745145559329,MATH 103B,A01,890116,Salehi Golsefidy; Alireza,8,0,30,22
1745145559329,MATH 103B,B01,890118,Staff,0,4,30,30
1745145560359,MATH 109,A01,890121,Aliabadi Sr.; Mohsen,6,0,30,24
1745145560359,MATH 109,B01,890124,Upadrashta; Pranav Kumar,23,0,30,7
1745145561387,MATH 120A,A01,890126,Eggers; John Dietrich,15,0,30,15
1745145562414,MATH 142B,A01,890128,Ioana; Adrian,17,0,30,13
1745145562414,MATH 142B,A02,890129,Ioana; Adrian,15,0,30,15
1745145563439,MATH 154,A01,890174,Staff,0,1,30,30
1745145563439,MATH 154,A02,890182,Staff,15,0,30,15
1745145564468,MATH 168A,A01,890197,Dumitriu; Ioana,22,0,35,13
1745145565497,MATH 170A,A01,890240,Nie; Jiawang,5,0,30,25
1745145565497,MATH 170A,A02,890241,Nie; Jiawang,18,0,30,12
1745145565497,MATH 170A,A03,890249,Nie; Jiawang,23,0,30,7
1745145566535,MATH 170B,A01,957891,Nag; Panchali,25,0,35,10
1745145568590,MATH 181A,A01,908025,Staff,0,8,35,35
1745145569622,MATH 193B,A01,890265,Staff,3,0,35,32
1745145570647,MGT 4,A01,890311,Anderson; John Charles,57,0,88,31
1745145571675,MGT 5,A00,907740,Staff,41,0,98,57
1745145572766,MGT 12,A00,890312,Lindenberger; Wade Douglas,70,0,98,28
1745145573795,MGT 16,A00,957883,Staff,84,0,98,14
1745145575856,MGT 45,A00,890314,Pecore; Joseph P.,57,0,98,41
1745145576886,MGT 71,A00,890315,Staff,6,0,98,92
1745145577912,MGT 100,A00,890316,Yavorsky; Daniel Ryan,58,0,98,40
1745145578938,MGT 103,A00,890317,Ehrich; Kristine R,77,0,98,21
1745145579969,MGT 105,A00,890356,Bates; Kenneth Walter,19,0,98,79
1745145580999,MGT 112,A00,890360,Ehrich; Kristine R,65,0,98,33
1745145582030,MGT 127R,A00,907732,Zhu; Kevin Xiaoguo,32,0,98,66
1745145583058,MGT 131B,A00,890361,Anderson; John Charles,75,0,98,23
1745145584084,MGT 137,A00,890362,Lindenberger; Wade Douglas,68,0,98,30
1745145585116,MGT 160,A00,890369,Johnson; Erik Barry,36,0,98,62
1745145587168,MGT 164,A00,890372,Zimmermann; Carsten,0,29,98,98
1745145588193,MGT 180,A00,890374,Bliss; Barbara Ann,31,0,98,67
1745145589222,MMW 15,A01,886414,Chang; Edmond Yi-Teh,0,10,28,28
1745145589222,MMW 15,A02,886415,Chang; Edmond Yi-Teh,0,10,28,28
1745145589222,MMW 15,A03,886416,Chang; Edmond Yi-Teh,0,8,28,28
1745145589222,MMW 15,A04,886417,Chang; Edmond Yi-Teh,0,8,28,28
1745145589222,MMW 15,B01,886419,Chang; Edmond Yi-Teh,0,8,28,28
1745145589222,MMW 15,B02,886420,Chang; Edmond Yi-Teh,0,9,28,28
1745145589222,MMW 15,B03,886421,Chang; Edmond Yi-Teh,0,9,28,28
1745145589222,MMW 15,B04,886422,Chang; Edmond Yi-Teh,0,9,28,28
1745145589222,MMW 15,C01,886424,Staff,0,10,28,28
1745145589222,MMW 15,C02,886425,Staff,0,10,28,28
1745145589222,MMW 15,C03,886426,Staff,0,9,28,28
1745145589222,MMW 15,C04,886427,Staff,0,9,28,28
1745145590250,MMW 15GS,A00,906910,Patterson; Patrick H.,5,0,28,23
1745145591277,MMW 122R,A01,886429,Rahimi; Babak,0,23,28,28
1745145591277,MMW 122R,A02,886430,Rahimi; Babak,0,23,28,28
1745145592309,MUS 1A,A01,890937,Staff,7,0,25,18
1745145592309,MUS 1A,A02,891035,Staff,15,0,25,10
1745145592309,MUS 1A,B00,907849,Staff,48,0,50,2
1745145592309,MUS 1A,B01,907850,Staff,25,0,25,0
1745145592309,MUS 1A,B02,907851,Staff,25,0,25,0
1745145594359,MUS 2AK,A00,957092,Ohnishi; Takae,15,0,15,0
1745145595388,MUS 4,A01,891044,Staff,6,0,25,19
1745145595388,MUS 4,A02,891045,Staff,24,0,25,1
1745145595388,MUS 4,B01,891048,Staff,20,0,25,5
1745145595388,MUS 4,B02,891050,Staff,25,0,25,0
1745145596416,MUS 5,A01,957506,Dubnov; Shlomo,4,0,25,21
1745145596416,MUS 5,A02,957622,Dubnov; Shlomo,21,0,25,4
1745145596416,MUS 5,A03,957623,Dubnov; Shlomo,23,0,25,2
1745145597443,MUS 6,A01,891053,Freitas Caetano; Marcelo,23,0,25,2
1745145597443,MUS 6,A02,891054,Freitas Caetano; Marcelo,23,0,25,2
1745145598471,MUS 7,A01,891081,Staff,0,0,25,25
1745145598471,MUS 7,A02,891082,Staff,14,0,25,11
1745145599503,MUS 8GS,A00,891118,Borgo; David Garcia,5,0,25,20
1745145600534,MUS 11,A01,891140,Staff,12,0,25,13
1745145600534,MUS 11,A02,891141,Staff,24,0,25,1
1745145601565,MUS 13,A01,891143,Staff,10,0,25,15
1745145601565,MUS 13,A02,891144,Staff,25,0,25,0
1745145602596,MUS 15,A01,891146,Staff,7,0,25,18
1745145602596,MUS 15,A02,891148,Staff,22,0,25,3
1745145602596,MUS 15,B01,891150,Staff,18,0,25,7
1745145602596,MUS 15,B02,891151,Staff,25,0,25,0
1745145603622,MUS 20,A01,891153,Staff,9,0,20,11
1745145603622,MUS 20,A02,891155,Staff,16,0,20,4
1745145604650,MUS 80,A00,891156,Staff,19,0,25,6
1745145604650,MUS 80,B00,891157,Staff,24,0,25,1
1745145605678,MUS 130,A00,891158,Ohnishi; Takae,35,0,35,0
1745145606702,MUS 150GS,A01,891160,Borgo; David Garcia,5,0,25,20
1745145607734,MUS 170,A01,891162,Freitas Caetano; Marcelo,21,0,25,4
1745145607734,MUS 170,A02,891164,Freitas Caetano; Marcelo,22,0,25,3
1745145608761,NANO 11,A00,886220,Vazquez Mena; Oscar,12,0,15,3
1745145609793,NANO 15,A01,886222,Drews; Aaron,9,0,10,1
1745145610822,NANO 104,A00,886224,Sirbuly; Donald,18,0,25,7
1745145611851,PH 40,A00,886528,Staff,29,0,40,11
1745145612877,PH 45,A01,886799,Staff,36,0,40,4
1745145613906,PH 110,A00,886802,Staff,7,0,40,33
1745145614932,PH 172,A00,906716,Staff,20,0,35,15
1745145615961,PH 191,A00,886803,Staff,23,0,40,17
1745145616989,PHIL 1,A00,889500,Staff,22,0,30,8
1745145618017,PHIL 10,A01,889549,Grush; Rick Scott,17,0,22,5
1745145618017,PHIL 10,A02,889551,Grush; Rick Scott,20,0,22,2
1745145619046,PHIL 28,A01,889559,Lamey; Andy M.,0,4,25,25
1745145619046,PHIL 28,A02,889561,Lamey; Andy M.,0,0,25,25
1745145619046,PHIL 28,A03,889572,Lamey; Andy M.,7,0,25,18
1745145620072,PHIL 35,A00,907839,Staff,32,0,33,1
1745145621098,PHIL 60,A00,889574,Staff,79,0,90,11
1745145622123,PHIL 105,A00,889579,Staff,0,1,0,0
1745145623154,PHIL 136,A00,889582,Fulkerson; Matthew Todd,27,0,45,18
1745145624182,PHIL 163,A01,889601,Staff,24,0,30,6
1745145624182,PHIL 163,B01,889606,Brandt; Reuven A,0,2,0,0
1745145625233,PHIL 164,A00,889610,Staff,20,0,30,10
1745145626259,PHIL 165,A00,889613,Staff,26,0,30,4
1745145627283,PHYS 1A,A00,886431,Staff,38,0,70,32
1745145628315,PHYS 1AL,001,886432,Tsai; Philbert S,0,0,30,30
1745145628315,PHYS 1AL,002,886436,Tsai; Philbert S,19,0,30,11
1745145629342,PHYS 1B,A00,886439,Staff,192,0,240,48
1745145630367,PHYS 1BL,001,886441,Tsai; Philbert S,0,1,30,30
1745145630367,PHYS 1BL,002,886444,Tsai; Philbert S,14,0,30,16
1745145631397,PHYS 1C,A00,896092,Arnold; Kam S,87,0,146,59
1745145632422,PHYS 1CL,001,886448,Tsai; Philbert S,0,4,30,30
1745145632422,PHYS 1CL,002,886449,Tsai; Philbert S,6,0,30,24
1745145632422,PHYS 1CL,003,886450,Tsai; Philbert S,22,0,30,8
1745145632422,PHYS 1CL,004,886451,Tsai; Philbert S,16,0,30,14
1745145633448,PHYS 2B,A01,886457,Staff,86,0,115,29
1745145634476,PHYS 2C,A01,886460,Shotwell; Brian,0,0,65,65
1745145635501,PHYS 2CL,A01,886467,Staff,0,3,28,28
1745145635501,PHYS 2CL,A02,886468,Staff,5,0,28,23
1745145636532,PHYS 2D,A01,886470,Staff,17,0,50,33
1745145637563,PHYS 4B,A01,886475,Grinstein; Benjamin,87,0,100,13
1745145638589,POLI 5,A00,891173,Desposato; Scott,17,0,25,8
1745145639619,POLI 5D,A01,891175,Staff,5,0,5,0
1745145639619,POLI 5D,B01,891178,Staff,5,0,5,0
1745145640643,POLI 11,A00,891179,Ferree; Karen E,3,0,25,22
1745145641669,POLI 12,A00,891180,Staff,21,0,30,9
1745145642697,POLI 27,A01,891182,Staff,29,0,75,46
1745145643722,POLI 30,A00,891183,Staff,0,3,30,30
1745145644747,POLI 100B,A00,891244,Staff,0,8,20,20
1745145645776,POLI 100I,A00,891247,Staff,19,0,30,11
1745145646803,POLI 104J,A00,891248,Nichter; Maysa,18,0,30,12
1745145647834,POLI 104U,A00,891250,Nichter; Maysa,9,0,30,21
1745145648859,POLI 108,A00,891253,Staff,0,0,0,4
1745145649887,POLI 110B,A00,891255,Wiens; David,22,0,25,3
1745145650913,POLI 112A,A00,891256,Wiens; David,15,0,25,10
1745145651938,POLI 114BR,A00,891261,Staff,22,0,30,8
1745145652964,POLI 117R,A00,891262,Forman; Fonna,12,0,50,38
1745145653997,POLI 118,A00,891264,Ingham; Sean,22,0,25,3
1745145655024,POLI 124A,A00,891265,Staff,19,0,20,1
1745145656050,POLI 125D,A00,891266,Nichter; Simeon C,9,0,25,16
1745145657078,POLI 126,A00,891268,Nichter; Simeon C,11,0,25,14
1745145658107,POLI 126AA,A00,891272,Staff,19,0,25,6
1745145659141,POLI 130AA,A00,891273,Staff,17,0,20,3
1745145660171,POLI 134AA,A00,891274,Staff,12,0,20,8
1745145662227,POLI 138,A00,891278,Staff,22,0,25,3
1745145663252,POLI 142K,A00,891280,Staff,17,0,25,8
1745145664279,POLI 142M,A00,891281,Gartzke; Erik,22,0,30,8
1745145665308,POLI 142P,A00,891284,Staff,21,0,30,9
1745145666338,POLI 143,A00,891285,Gartzke; Erik,17,0,30,13
1745145667365,POLI 153,A00,891286,Staff,20,0,20,0
1745145668395,POLI 170A,A00,891288,Staff,19,0,25,6
1745145669424,POLI 175,A00,891290,Staff,18,0,20,2
1745145670452,PSYC 1,A00,890674,Steiner; Eric Tomas,0,4,45,45
1745145671477,PSYC 2,A00,890676,Albright; Thomas D,25,0,35,10
1745145672506,PSYC 3,A00,890679,Staff,18,0,20,2
1745145673534,PSYC 60,A01,890684,Rickard; Timothy C.,7,0,45,38
1745145674560,PSYC 70,A01,890689,Geller; Emma Harlan,14,0,30,16
1745145675587,PSYC 100,A00,890690,Lacefield; Katharine I,0,43,180,180
1745145676614,PSYC 102,A00,890695,Staff,25,0,40,15
1745145677645,PSYC 105,A00,890699,Geller; Emma Harlan,78,0,100,22
1745145678671,PSYC 106,A00,890701,Gorman; Michael R.,15,0,30,15
1745145679706,PSYC 108,A00,890704,Adrian; Julia Anna,0,23,50,50
1745145680732,PSYC 118,A01,890712,Staff,18,0,30,12
1745145681761,PSYC 124,A00,890716,Chapman; Eddie Nathaniel,36,0,60,24
1745145682792,PSYC 131,A00,890717,Anagnostaras; Stephan,6,0,80,74
1745145683817,PSYC 137,A00,890719,Winkielman; Piotr,0,2,30,30
1745145684855,PSYC 144,A00,890721,Adrian; Julia Anna,0,3,45,45
1745145685882,PSYC 162,A00,890805,Staff,21,0,75,54
1745145686912,PSYC 169,A00,890810,Staff,0,15,30,30
1745145687942,PSYC 172,A00,890814,Gorman; Michael R.,14,0,30,16
1745145688968,PSYC 181,A00,890818,Anagnostaras; Stephan,63,0,200,137
1745145689995,PSYC 189,A00,890823,Staff,11,0,30,19
1745145691023,PSYC 191,A00,890884,Rickard; Timothy C.,0,11,35,35
1745145692049,PSYC 193,A00,890913,Staff,22,0,30,8
1745145692049,PSYC 193,B00,890914,Chapman; Eddie Nathaniel,25,0,30,5
1745145693074,PSYC 193L,A01,890918,Lowe; Angela Beth,29,0,30,1
1745145693074,PSYC 193L,B01,890921,Hurwitz; Ethan Scott,28,0,30,2
1745145693074,PSYC 193L,C01,890928,Staff,30,0,30,0
1745145694107,RELI 149,A00,886806,Rahimi; Babak,23,0,40,17
1745145695137,SE 9,A01,886814,Staff,13,0,20,7
1745145696165,SE 101B,A01,886816,Chadha; Mayank,8,0,30,22
1745145697194,SE 110B,A00,886818,Zhu; Qiang,0,16,45,45
1745145698221,SE 125,A01,886830,Staff,10,0,30,20
1745145699251,SE 130B,A01,886835,Staff,19,0,40,21
1745145700284,SE 131A,A01,886838,Krysl; Petr,37,0,55,18
1745145701315,SE 154,A00,886840,Staff,35,0,50,15
1745145702344,SE 164GS,A01,886849,Staff,13,0,20,7
1745145703368,SE 167GS,A01,886853,Staff,13,0,20,7
1745145704399,SIO 25,A01,890107,Staff,23,0,30,7
1745145705424,SIO 45,A00,890109,Cook; Geoffrey W,137,0,200,63
1745145706453,SIO 109R,A00,890110,Forman; Fonna,0,11,20,20
1745145707480,SIO 187,A01,890114,Kacev; David,21,0,40,19
1745145708509,SOCI 1,A01,890431,Thorpe; Charles Robert,21,0,30,9
1745145708509,SOCI 1,A02,890518,Thorpe; Charles Robert,30,0,30,0
1745145709536,SOCI 2,A01,957978,Staff,0,0,0,0
1745145709536,SOCI 2,A02,957979,Staff,0,3,0,0
1745145710563,SOCI 20,A01,890523,Calderon-Zaks; Michael Aar,24,0,30,6
1745145710563,SOCI 20,A02,890526,Calderon-Zaks; Michael Aar,29,0,30,1
1745145711593,SOCI 30,A01,890533,Pardo Guerra; Juan Pablo,37,0,40,3
1745145712620,SOCI 40,A01,890535,Staff,32,0,45,13
1745145713648,SOCI 104Q,A00,890559,Staff,20,0,30,10
1745145714673,SOCI 106,A00,890560,Arnal; Maud Marie Leonie,22,0,30,8
1745145715702,SOCI 110,A00,890567,Holkenbrink-Monk; Charlene,22,0,30,8
1745145716730,SOCI 112,A00,890568,Victoria Torres; Pablo,0,0,45,45
1745145717756,SOCI 115,A00,890597,Arnal; Maud Marie Leonie,33,0,45,12
1745145719815,SOCI 121,A00,890604,Pardo Guerra; Juan Pablo,40,0,45,5
1745145720846,SOCI 126,A01,890608,Staff,8,0,10,2
1745145721872,SOCI 127,A00,890609,Staff,23,0,30,7
1745145722898,SOCI 131,A00,890610,Thorpe; Charles Robert,38,0,45,7
1745145723931,SOCI 135,A00,890615,Payne; Christine Anna,19,0,45,26
1745145724959,SOCI 139,A00,890620,Staff,43,0,45,2
1745145725985,SOCI 148E,A00,890622,Calderon-Zaks; Michael Aar,39,0,45,6
1745145727012,SOCI 150,A00,890623,Kohler; Kristopher M.,36,0,45,9
1745145728046,SOCI 157,A00,890625,Jules-Rosette; Bennetta W.,18,0,20,2
1745145729072,SOCI 160,A00,890627,Payne; Christine Anna,26,0,45,19
1745145730107,SYN 1,A00,886855,Fish; Gwendolyn Anne,0,0,0,0
1745145730107,SYN 1,B00,906086,Fish; Gwendolyn Anne,0,0,0,2
1745145731135,SYN 2R,A00,886860,Staff,0,15,15,15
1745145731135,SYN 2R,B00,906106,Atkinson; Arthur Laird,0,14,15,15
1745145732171,SYN 100,A01,886866,Browne; Emily,0,29,20,20
1745145732171,SYN 100,B01,906128,Rock; Martin,0,4,20,20
1745145732171,SYN 100,C01,906140,Deavenport; James Cary,0,2,20,20
1745145732171,SYN 100,D01,907816,Deavenport; James Cary,0,3,20,20
1745145733199,TDAC 1,A00,890286,Walsh; Kim C.,11,0,20,9
1745145734229,TDAC 101,A00,890296,Basso; Beatrice,18,0,20,2
1745145735254,TDDE 131,A00,890297,Staff,47,0,50,3
1745145736284,TDDM 1,A00,890287,Weinberg; Sadie,26,0,30,4
1745145737317,TDGE 11,A00,890288,Fulton; Julia,155,0,200,45
1745145737317,TDGE 11,B00,890289,Castro; Robert Jess,188,0,200,12
1745145738347,TDGE 25,B00,957359,Walsh; Kim C.,9,0,20,11
1745145739374,TDGE 40,A01,890292,Power; Jade Yukana,28,0,30,2
1745145740403,TDGE 124,A00,890298,Havis; Allan,12,0,50,38
1745145741434,TDGE 131R,A00,890299,Burelle; Julie Sara Veronique,20,0,42,22
1745145742459,TDHT 101,A00,890300,Staff,12,0,20,8
1745145743487,TDHT 109,A01,890302,Anderson; Mysia Anyse,31,0,40,9
1745145744522,TDMV 1,A00,890293,Arcidiacono; Kristin,20,0,30,10
1745145745556,TDMV 2,A00,890294,Weinberg; Sadie,26,0,30,4
1745145746584,TDMV 3,A00,957878,Arcidiacono; Kristin,27,0,30,3
1745145748641,TDMV 138,A00,890304,Jun; Grace Shin Hae,25,0,40,15
1745145749672,TDMV 140,A00,890305,Corrales; Joseph Bernales,28,0,30,2
1745145750716,TDMV 142,A00,890307,Caligagan; Tony,30,0,40,10
1745145751745,TDMV 144,A00,890308,Camaya; Michelle Ann,26,0,30,4
1745145752777,TDPW 1,A00,890295,Stein; Deborah Isobel,5,0,20,15
1745145753804,USP 2,A01,890272,Lerner; Amy M,8,0,20,12
1745145754832,USP 3,A01,890274,Staff,21,0,30,9
1745145755860,USP 15,A01,890276,Sun; Feiyang,21,0,30,9
1745145756888,USP 25,A00,890277,Shenkman; Michael Thomas,21,0,25,4
1745145757913,USP 138,A00,890278,Staff,15,0,25,10
1745145758938,USP 143,A00,890279,Staff,30,0,70,40
1745145759965,USP 144,A00,890280,Chowdhury; Muhammed Zohir,19,0,30,11
1745145760990,USP 150,A00,890281,Boomhower; Matthew Charles,19,0,30,11
1745145762014,USP 151,A00,890282,Staff,17,0,20,3
1745145763042,USP 162,A00,890283,Andrews; Abigail Leslie,17,0,20,3
1745145764073,USP 168,A00,920477,Kwak; Nancy,2,0,5,3
1745145765100,USP 181,A00,890284,Staff,11,0,20,9
1745145766130,USP 191A,A00,890285,Staff,15,0,20,5
1745145767156,VIS 101,A00,886512,Staff,37,0,75,38
1745145768182,VIS 103,A00,886513,Cruz; Edwin Teddy,65,0,75,10
1745145769208,VIS 108,A00,886514,Staff,7,0,15,8
1745145770233,VIS 127P,A00,886515,Shen; Kuiyi,92,0,146,54
1745145771260,VIS 149,A00,886516,Yoldas; Pinar,1,0,15,14
1745145772302,VIS 164,A00,886526,Erdmann; Dean,21,0,22,1
1745145773331,VIS 194S,A00,886527,Staff,61,0,75,14
1745145774358,WCWP 10A,C00,886484,Staff,13,0,15,2
1745145775389,WCWP 10B,A00,886490,Staff,5,0,15,10
1745145775389,WCWP 10B,B00,886491,Staff,0,1,0,0
1745145775389,WCWP 10B,C00,886492,Staff,10,0,15,5
1745145776414,WCWP 100,A00,886494,Staff,0,3,15,15
1745145778570,AAS 10,A01,886199,Childs; Dennis R.,0,2,0,0
1745145779604,ANAR 104,A01,886940,Shtienberg; Gilad,27,0,30,3
1745145780634,ANAR 120,A00,886953,Staff,13,0,20,7
1745145781663,ANBI 148,A01,886955,Wilder; Linnea Lorene,32,0,40,8
1745145783716,ANSC 122,A00,886957,Staff,28,0,30,2
1745145784741,ANSC 150,A00,886958,Sloane; Julia Kathryn,6,0,15,9
1745145785766,ANSC 156,A00,886959,Jenkins; Janis A.,2,0,15,13
1745145786793,ANSC 180,A00,886960,Staff,12,0,17,5
1745145787820,ANSC 188,A00,886961,Jassal; Aftab,10,0,25,15
1745145788846,ANSC 190,A00,886962,Jassal; Aftab,14,0,25,11
1745145789873,ANSC 191,A00,886963,Staff,18,0,20,2
1745145790903,ANTH 3,A01,891689,Staff,19,0,20,1
1745145791929,ANTH 5,A00,886933,Semendeferi; Ekaterini,18,0,20,2
1745145792956,ANTH 10,A00,886934,Staff,0,8,30,30
1745145793984,ANTH 21,A01,886936,Staff,44,0,60,16
1745145795010,ANTH 23,A01,886938,Staff,94,0,100,6
1745145796037,ANTH 105,A00,886964,Stewart; Alexander B,94,0,100,6
1745145797063,ANTH 108,A00,886965,Pedersen; David,10,0,20,10
1745145798100,AWP 10,001,886147,Staff,0,0,0,0
1745145798100,AWP 10,002,886148,Staff,0,0,0,0
1745145798100,AWP 10,003,886149,Staff,0,0,0,0
1745145798100,AWP 10,004,886150,Staff,0,0,0,0
1745145798100,AWP 10,005,886151,Staff,0,0,0,0
1745145798100,AWP 10,006,886152,Staff,0,0,0,0
1745145798100,AWP 10,007,886153,Staff,0,0,0,0
1745145798100,AWP 10,008,886154,Staff,0,0,0,0
1745145798100,AWP 10,009,886155,Staff,0,0,0,0
1745145798100,AWP 10,010,886156,Staff,0,0,0,0
1745145798100,AWP 10,011,886158,Staff,0,0,0,0
1745145798100,AWP 10,012,886160,Staff,0,0,0,0
1745145798100,AWP 10,013,886161,Staff,0,0,0,0
1745145798100,AWP 10,014,886162,Staff,0,0,0,0
1745145798100,AWP 10,015,886163,Staff,0,0,0,0
1745145798100,AWP 10,016,886164,Staff,0,0,0,0
1745145798100,AWP 10,017,886165,Staff,0,0,0,0
1745145798100,AWP 10,018,886166,Staff,0,0,0,0
1745145798100,AWP 10,019,886168,Staff,0,0,0,0
1745145798100,AWP 10,020,886170,Staff,0,0,0,0
1745145798100,AWP 10,021,886172,Staff,0,0,0,0
1745145799135,AWP 10R,001,886173,Staff,0,0,0,0
1745145799135,AWP 10R,002,886174,Staff,0,1,0,0
1745145799135,AWP 10R,003,886175,Staff,0,0,0,0
1745145799135,AWP 10R,004,886176,Staff,0,0,0,0
1745145799135,AWP 10R,005,886177,Staff,0,0,0,0
1745145799135,AWP 10R,006,886178,Staff,0,0,0,0
1745145799135,AWP 10R,007,886179,Staff,0,0,0,0
1745145799135,AWP 10R,008,886181,Staff,0,0,0,0
1745145799135,AWP 10R,009,886182,Staff,0,0,0,0
1745145799135,AWP 10R,010,886183,Staff,0,0,0,0
1745145799135,AWP 10R,011,886184,Staff,0,0,0,0
1745145799135,AWP 10R,012,886185,Staff,0,0,0,0
1745145799135,AWP 10R,013,886186,Staff,0,0,0,0
1745145799135,AWP 10R,014,886187,Staff,0,0,0,0
1745145799135,AWP 10R,015,886188,Staff,0,0,0,0
1745145799135,AWP 10R,016,886189,Staff,0,0,0,0
1745145800161,AWP 102R,A00,886190,Staff,0,0,0,0
1745145800161,AWP 102R,B00,886191,Staff,0,0,0,0
1745145801187,BENG 100,A01,886193,Staff,19,0,30,11
1745145802216,BENG 122A,A01,886195,Hasty; Jeff M,20,0,30,10
1745145803243,BENG 166A,A00,886196,Sah; Robert Lie-Yuan,0,3,20,20
1745145804313,BIBC 102,A01,894320,Staff,0,2,46,46
1745145804313,BIBC 102,A02,894321,Staff,0,0,46,46
1745145804313,BIBC 102,A03,894344,Staff,21,0,46,25
1745145804313,BIBC 102,A04,894345,Staff,30,0,47,17
1745145805345,BICD 100R,A01,894365,Smith; Laurie,1,3,58,57
1745145805345,BICD 100R,A02,894366,Smith; Laurie,0,1,58,58
1745145805345,BICD 100R,A03,894367,Smith; Laurie,13,0,59,46
1745145806373,BICD 136,A01,894383,Gustafson-Brown; Cindy,16,0,50,34
1745145807401,BIEB 102,A01,894494,Butler; Shannon Rhey,67,0,130,63
1745145809456,BIEB 150,A01,894617,Wills; Christopher,0,3,13,13
1745145809456,BIEB 150,A02,894631,Wills; Christopher,0,3,13,13
1745145809456,BIEB 150,A03,894937,Wills; Christopher,0,3,13,13
1745145809456,BIEB 150,A04,894946,Wills; Christopher,0,1,11,11
1745145810488,BIEB 194,A00,906141,Kurle; Carolyn M.,14,0,20,6
1745145811514,BILD 1,A01,894154,Staff,8,0,19,11
1745145811514,BILD 1,A02,894155,Staff,15,0,19,4
1745145811514,BILD 1,A03,894160,Staff,18,0,19,1
1745145811514,BILD 1,A04,894161,Staff,16,0,18,2
1745145812545,BILD 2,A01,894168,Staff,0,0,50,50
1745145812545,BILD 2,A02,894169,Staff,0,0,50,50
1745145812545,BILD 2,A03,894179,Staff,27,0,50,23
1745145812545,BILD 2,A04,894203,Staff,42,0,50,8
1745145813574,BILD 3,A01,894213,Staff,24,0,31,7
1745145813574,BILD 3,A02,894214,Staff,28,0,31,3
1745145813574,BILD 3,A03,894235,Staff,30,0,31,1
1745145813574,BILD 3,A04,894236,Staff,29,0,32,3
1745145814602,BILD 4,A01,894253,Reuther; Keefe,12,0,24,12
1745145814602,BILD 4,A02,894258,Reuther; Keefe,19,0,24,5
1745145815633,BILD 5,A01,894276,Reuther; Keefe,40,0,50,10
1745145815633,BILD 5,A02,894277,Reuther; Keefe,48,0,50,2
1745145815633,BILD 5,A03,894290,Reuther; Keefe,47,0,50,3
1745145815633,BILD 5,A04,894291,Reuther; Keefe,50,0,50,0
1745145816664,BILD 24,A01,894297,Pirino; Giorgia,45,0,60,15
1745145817693,BIMM 100,A01,895012,Staff,0,14,0,1
1745145817693,BIMM 100,A02,895013,Staff,0,6,0,2
1745145817693,BIMM 100,A03,895014,Staff,0,7,0,0
1745145817693,BIMM 100,A04,895015,Staff,0,4,0,0
1745145818730,BIMM 101,A01,895017,McDonnell; Lisa Marie,0,2,24,24
1745145818730,BIMM 101,A02,895018,McDonnell; Lisa Marie,0,1,24,24
1745145818730,BIMM 101,B01,895020,McDonnell; Lisa Marie,0,3,24,24
1745145818730,BIMM 101,B02,895021,McDonnell; Lisa Marie,0,2,24,24
1745145819762,BIMM 110,A01,895023,Staff,7,0,25,18
1745145819762,BIMM 110,A02,895024,Staff,11,0,25,14
1745145819762,BIMM 110,A03,895025,Staff,22,0,25,3
1745145819762,BIMM 110,A04,895031,Staff,21,0,25,4
1745145820798,BIMM 120,A01,895114,Gustafson-Brown; Cindy,8,0,28,20
1745145820798,BIMM 120,A02,895126,Gustafson-Brown; Cindy,19,0,27,8
1745145821827,BIPN 100,A01,895130,Yang; Mingyu,13,0,38,25
1745145821827,BIPN 100,A02,895131,Yang; Mingyu,33,0,38,5
1745145821827,BIPN 100,A03,895132,Yang; Mingyu,33,0,38,5
1745145821827,BIPN 100,A04,895133,Yang; Mingyu,30,0,36,6
1745145822854,BIPN 120,A01,895135,Cooke; James Edward,0,2,13,13
1745145822854,BIPN 120,A02,895136,Cooke; James Edward,0,1,13,13
1745145822854,BIPN 120,A03,895137,Cooke; James Edward,0,0,13,13
1745145822854,BIPN 120,A04,895156,Cooke; James Edward,3,0,11,8
1745145823881,BIPN 134,A01,895235,Cooke; James Edward,0,2,25,25
1745145823881,BIPN 134,A02,895237,Cooke; James Edward,0,0,25,25
1745145823881,BIPN 134,A03,895240,Cooke; James Edward,12,0,25,13
1745145823881,BIPN 134,A04,895270,Cooke; James Edward,24,0,25,1
1745145824907,BIPN 189,A00,892103,Staff,0,20,9,9
1745145826961,CAT 124,A01,922009,Staff,0,1,20,20
1745145827997,CAT 125R,A00,886390,Morales; Celeste Georgianna,4,0,20,16
1745145827997,CAT 125R,B00,886391,Irwin; Matthew Joseph,0,1,20,20
1745145827997,CAT 125R,C00,886392,Smith; Lauryn Alissa,11,0,20,9
1745145827997,CAT 125R,D00,886393,Vanderschuit; Maya Alysia,6,0,20,14
1745145827997,CAT 125R,E00,886394,Marchisotto; Jennifer Anne,0,2,20,20
1745145829023,CENG 15,A01,886218,Drews; Aaron,1,0,5,4
1745145830050,CENG 113,A00,886219,Opatkiewicz; Justin Paul,16,0,25,9
1745145831075,CGS 101,A00,887044,Staff,13,0,20,7
1745145832101,CGS 105,A01,887046,Staff,16,0,25,9
1745145833172,CGS 112,A00,887047,Cuong; Marisol,12,0,15,3
1745145834198,CGS 113,A00,887048,Staff,24,0,30,6
1745145835224,CGS 120,A00,887049,Staff,12,0,17,5
1745145836258,CHEM 6A,A01,886336,Lam; Tin Yiu,44,0,50,6
1745145836258,CHEM 6A,A02,886338,Lam; Tin Yiu,43,0,50,7
1745145837285,CHEM 6B,A01,886341,Hopkins; Patrycja Anna,21,0,50,29
1745145837285,CHEM 6B,A02,886343,Hopkins; Patrycja Anna,46,0,50,4
1745145838312,CHEM 6C,A01,886346,Albizati; Kim F.,0,1,50,50
1745145838312,CHEM 6C,A02,886348,Albizati; Kim F.,38,0,50,12
1745145839339,CHEM 40A,A01,886352,Klosterman; Jeremy K,70,0,100,30
1745145840367,CHEM 40B,A01,886356,Klosterman; Jeremy K,0,4,100,100
1745145841397,CHEM 41B,A01,886360,Theodorakis; Emmanuel,30,0,50,20
1745145841397,CHEM 41B,A02,886362,Theodorakis; Emmanuel,46,0,50,4
1745145842423,CHIN 165A,A00,886382,Xu; Li,19,0,20,1
1745145843448,CLAS 120,A00,886387,Myerston Santana; Jacobo,36,0,40,4
1745145844477,COGS 9,A01,886967,Shannon; Kyle Michael,49,0,60,11
1745145845507,COGS 11,A01,886969,Staff,18,0,30,12
1745145846537,COGS 14A,A01,886971,Staff,26,0,60,34
1745145847562,COGS 14B,A01,886973,Hoffman; Drew Ellen,18,0,60,42
1745145848590,COGS 18,A01,886975,Morgan; Eric,41,0,60,19
1745145849617,COGS 20,A01,886977,Staff,6,0,8,2
1745145849617,COGS 20,A02,886978,Staff,6,0,7,1
1745145850642,COGS 100,A01,907783,Staff,6,0,30,24
1745145851668,COGS 101B,A01,886980,Staff,0,10,30,30
1745145852697,COGS 101C,A01,886982,Delgado; Tania,0,6,30,30
1745145853722,COGS 102A,A01,886984,Johnson; Christine M.,13,0,30,17
1745145854752,COGS 118B,A01,886986,Staff,0,25,60,60
1745145855778,COGS 150,A01,886988,Bergen; Benjamin,16,0,30,14
1745145856808,COGS 153,A00,886989,Delgado; Tania,0,6,30,30
1745145857835,COGS 186,A01,886991,Staff,3,0,30,27
1745145858864,COGS 187A,A01,886993,Boyle; Mary E. T.,12,0,30,18
1745145859890,COGS 189,A00,886994,Staff,13,0,30,17
1745145860917,COMM 10,A01,886996,Staff,11,0,25,14
1745145860917,COMM 10,A02,886997,Staff,21,0,25,4
1745145861947,COMM 20,A01,886999,Leuning; Grant Maurstad,33,0,40,7
1745145864002,COMM 100A,A01,887002,Staff,0,0,25,25
1745145864002,COMM 100A,A02,887003,Staff,20,0,25,5
1745145865029,COMM 100B,A01,887005,Staff,0,1,25,25
1745145866058,COMM 106D,A00,887006,Staff,22,0,40,18
1745145867085,COMM 110G,A00,887007,Whitworth-Smith; Andrew C,17,0,40,23
1745145868114,COMM 111B,A00,887008,Staff,31,0,40,9
1745145869142,COMM 113T,A00,887009,Abuelhiga; Soraya Jill,30,0,40,10
1745145869142,COMM 113T,B00,906733,Staff,40,0,40,0
1745145870169,COMM 145,A00,887010,Staff,21,0,40,19
1745145871198,COMM 146,A00,887054,Staff,31,0,40,9
1745145872227,COMM 190,A00,887012,Staff,9,0,23,14
1745145873251,CSE 8A,A50,887015,Cao; Yingjun,68,0,85,17
1745145874284,CSE 11,A01,887017,Cao; Yingjun,35,0,70,35
1745145875313,CSE 20,A01,887019,Staff,35,0,50,15
1745145876341,CSE 21,A01,887021,Braun; Oliver,81,0,100,19
1745145876341,CSE 21,B01,892583,Staff,48,0,50,2
1745145877370,CSE 30,A01,887025,Eldon; John,161,0,200,39
1745145878402,CSE 100,A01,887027,Staff,28,0,50,22
1745145878402,CSE 100,A02,887028,Staff,43,0,50,7
1745145879432,CSE 101,A01,887030,Braun; Oliver,79,0,100,21
1745145879432,CSE 101,B01,887032,Jones; Miles E,0,1,50,50
1745145879432,CSE 101,B02,887033,Jones; Miles E,13,0,50,37
1745145880464,CSE 105,A01,908084,Jones; Miles E,36,0,50,14
1745145880464,CSE 105,A02,908087,Jones; Miles E,38,0,50,12
1745145881493,CSE 135,A01,887035,Powell; Thomas Allan,8,0,50,42
1745145882521,CSE 142,A01,887037,Staff,22,0,60,38
1745145883548,CSE 142L,A01,887039,Staff,42,0,60,18
1745145884581,CSE 151A,A01,887041,Solares; Edwin A,60,0,100,40
1745145885608,CSE 175,A01,887043,Kumar; Rakesh,30,0,30,0
1745145886639,CSS 1,A01,886389,Staff,12,0,40,28
1745145887672,DSC 30,A01,908097,Liao; Soohyun Nam,54,0,75,21
1745145888703,DSC 40A,A01,908099,Shannon; Kyle Michael,37,0,50,13
1745145889734,DSC 40B,A01,908112,Staff,28,0,50,22
1745145890762,DSC 80,A01,908116,Staff,32,0,60,28
1745145891789,DSC 197,001,956863,Eldridge; Justin Matthew,9999,0,9999,0
1745145892818,ECE 5,A01,886400,Morris; Karcher William,3,0,6,3
1745145892818,ECE 5,A02,886401,Morris; Karcher William,5,0,6,1
1745145893845,ECE 148,A01,886403,Silberman; Jack,0,8,14,14
1745145894871,ECON 1,A01,887265,Crane; Meredith Helen,25,0,70,45
1745145894871,ECON 1,B01,887268,Staff,44,0,50,6
1745145895941,ECON 2,A01,887273,Crane; Meredith Helen,61,0,70,9
1745145896967,ECON 3,A01,887279,Rondina; Giacomo,44,0,70,26
1745145898001,ECON 4,A01,887282,Anderson; John Charles,0,1,10,10
1745145899027,ECON 5,A01,887285,Staff,39,0,45,6
1745145899027,ECON 5,B01,887292,Staff,43,0,45,2
1745145900054,ECON 100A,A01,887337,Newhouse; Herbert S,58,0,70,12
1745145900054,ECON 100A,B01,887349,Staff,45,0,50,5
1745145901082,ECON 100B,A01,887361,Du; Songzi,42,0,70,28
1745145902113,ECON 100C,A01,887445,Newhouse; Herbert S,61,0,70,9
1745145903142,ECON 105,A00,887488,Vespa; Emanuel Ignacio,24,0,35,11
1745145904169,ECON 109,A01,887506,Staff,29,0,35,6
1745145905203,ECON 110A,A01,887568,Alon; Titan Michael,1,0,35,34
1745145905203,ECON 110A,B01,907601,Alon; Titan Michael,27,0,35,8
1745145906231,ECON 110B,A01,887598,Levkoff; Steven B.,0,7,70,70
1745145907261,ECON 112,A00,887599,Rondina; Giacomo,20,0,35,15
1745145908345,ECON 120A,A01,887603,Dai; Yinlin,46,0,70,24
1745145909373,ECON 120C,A01,887608,Sun; Yixiao,0,0,35,35
1745145909373,ECON 120C,B01,887614,Sun; Yixiao,13,0,35,22
1745145910400,ECON 138,A00,887621,Bharadwaj; Prashant,0,18,20,20
1745145911432,ECON 171,A01,907666,Staff,27,0,35,8
1745145912458,ECON 175,A00,887626,Wu; Pak Yeung,27,0,35,8
1745145913488,ECON 190,A00,887640,Vespa; Emanuel Ignacio,26,0,35,9
1745145914519,EDS 25,A01,888197,Staff,0,0,0,0
1745145914519,EDS 25,A02,888209,Staff,0,0,0,0
1745145914519,EDS 25,A03,888210,Staff,0,0,0,0
1745145914519,EDS 25,A04,888212,Staff,0,0,0,0
1745145914519,EDS 25,A05,888213,Staff,0,0,0,0
1745145914519,EDS 25,A06,888214,Staff,0,0,0,0
1745145914519,EDS 25,A07,888235,Staff,0,0,0,0
1745145914519,EDS 25,A08,888236,Staff,0,0,0,0
1745145914519,EDS 25,A09,888240,Staff,0,0,0,0
1745145914519,EDS 25,A10,888244,Staff,0,0,0,0
1745145914519,EDS 25,B01,888273,Staff,0,0,0,0
1745145914519,EDS 25,B02,888285,Staff,0,0,0,0
1745145914519,EDS 25,B03,888423,Staff,29,0,30,1
1745145914519,EDS 25,B04,888432,Staff,0,0,0,0
1745145914519,EDS 25,B05,888433,Staff,0,0,0,0
1745145914519,EDS 25,B06,888467,Staff,0,0,0,0
1745145914519,EDS 25,B07,888468,Staff,0,0,0,0
1745145914519,EDS 25,B08,888479,Staff,0,0,0,0
1745145914519,EDS 25,B09,888484,Staff,0,0,0,0
1745145914519,EDS 25,B10,888487,Staff,0,0,0,0
1745145915546,EDS 38,A01,907700,Choi; Bailey Miyeon,30,0,30,0
1745145916572,EDS 112,A01,888601,Chapman; Thandeka K,23,0,40,17
1745145917603,EDS 115,A00,888697,Mendez; Kathrina Mendoza,17,0,30,13
1745145918631,EDS 116,A01,888893,Staff,38,0,40,2
1745145920685,EDS 124AR,A00,889133,Staff,33,0,50,17
1745145920685,EDS 124AR,B00,907471,Simon; Elizabeth A,42,0,50,8
1745145921714,EDS 124BR,A00,889134,Staff,57,0,100,43
1745145922745,EDS 125,A00,889135,Staff,26,0,30,4
1745145923770,EDS 126,A01,889138,Staff,37,0,40,3
1745145924802,EDS 164R,A01,889142,Wishard Guerra; Alison G.,38,0,50,12
1745145925833,ENG 30,A01,886396,Staff,0,0,0,0
1745145925833,ENG 30,B01,886398,Staff,0,0,0,0
1745145926860,ENVR 102,A00,906150,Montejo; Carolina,23,0,25,2
1745145927888,ETHN 103A,A00,887236,Man; Simeon S,0,5,0,0
1745145928915,ETHN 113,A00,887239,Staff,20,0,30,10
1745145929948,ETHN 116,A00,887240,Staff,20,0,25,5
1745145930975,ETHN 117,A00,887241,Choi; Esther Min,27,0,30,3
1745145932004,ETHN 118,A00,887243,Staff,24,0,30,6
1745145933034,ETHN 127,A00,887248,Cuong; Marisol,12,0,15,3
1745145934059,ETHN 139,A00,887250,Staff,8,0,10,2
1745145935086,ETHN 142,A00,887252,Staff,18,0,30,12
1745145936111,ETHN 161,A00,887253,Browne; Errol Tsekani,28,0,30,2
1745145937141,ETHN 163FR,A00,887255,Burelle; Julie Sara Veronique,4,0,5,1
1745145938169,GLBH 20,A00,889149,Elwardani; Nile Regina,15,0,42,27
1745145940238,GLBH 111,A01,889152,Burgos; Jose L.,17,0,17,0
1745145941270,GLBH 150,A00,889181,Sloane; Julia Kathryn,0,1,15,15
1745145943323,HDS 60,A01,886406,Warstadt; Melissa Fawn,76,0,80,4
1745145944351,HIAF 111,A00,889324,Gyamfi; Bright,0,4,0,0
1745145945376,HIEA 131,A00,889328,Staff,14,0,32,18
1745145946407,HIEA 144,A00,889333,Henry; Todd A.,29,0,32,3
1745145947434,HIEA 154,A00,889336,Henry; Todd A.,28,0,32,4
1745145948462,HIEU 106,A00,889339,Staff,28,0,32,4
1745145950517,HIEU 114,A00,889340,Staff,18,0,32,14
1745145951547,HIEU 135GS,A00,889342,Patterson; Patrick H.,0,0,1,22
1745145952574,HIEU 137,A00,889343,Edington; Claire Ellen,12,0,25,13
1745145953600,HIEU 148,A00,889345,Staff,16,0,32,16
1745145954627,HIEU 154,A00,889346,Biess; Frank Peter,24,0,32,8
1745145955654,HILA 102,A00,889351,Staff,13,0,32,19
1745145956681,HILD 2A,A01,889221,Lewandoski; Julia Mavis,0,5,32,32
1745145957708,HILD 7B,A01,889225,Man; Simeon S,0,7,32,32
1745145958741,HILD 7C,A01,889288,Alvarez; Luis A,0,8,32,32
1745145959775,HILD 30,A01,889323,Staff,0,1,32,32
1745145961836,HISC 119,A00,889383,Golan; Tal,22,0,32,10
1745145962862,HIUS 103,A00,889384,Man; Simeon S,10,0,32,22
1745145963888,HIUS 117,A00,919797,Kwak; Nancy,23,0,32,9
1745145964914,HIUS 142A,A00,919788,Staff,24,0,32,8
1745145966968,HIUS 149,A00,889386,Gyamfi; Bright,0,1,0,0
1745145967996,HIUS 155,A00,889387,Alvarez; Luis A,19,0,32,13
1745145969024,HUM 3,A01,886499,Caldwell; Michael Alan,24,0,50,26
1745145970051,HUM 3GS,A00,886500,Rodriguez; Bretton Sigfred,0,0,0,26
1745145971076,HUM 3R,A01,886502,Markman; Kristina,0,32,50,50
1745145972127,HUM 4,A01,886504,Crum; Matthew Stephen,28,0,50,22
1745145972127,HUM 4,B01,886506,West; Geoffrey Scott,25,0,50,25
1745145973152,HUM 4GS,A00,886507,Staff,0,0,0,13
1745145974178,HUM 5,A01,886509,Staff,35,0,50,15
1745145975203,HUM 5R,A01,886511,Zavodny; Tatiana Sophia,0,32,50,50
1745145976235,JAPN 180,A00,886407,Staff,25,0,40,15
1745145977262,LATI 50,A01,886409,Martin-Cabrera; Luis,9,0,22,13
1745145977262,LATI 50,A02,886410,Martin-Cabrera; Luis,20,0,22,2
1745145977262,LATI 50,A03,886411,Martin-Cabrera; Luis,22,0,22,0
1745145977262,LATI 50,A04,886412,Martin-Cabrera; Luis,15,0,22,7
1745145978287,LAWS 101,A00,907664,Staff,36,0,60,24
1745145979329,LIAB 1A,A00,889388,Saab; Dima,19,0,20,1
1745145980359,LIAB 1AX,A00,889389,El Cheddadi; Youniss,19,0,20,1
1745145981386,LIFR 1C,A00,889391,Van Moer; Vinciane G,9,0,20,11
1745145982414,LIFR 1CX,A00,889392,Van Moer; Vinciane G,8,0,20,12
1745145983442,LIFR 1D,A00,889393,Van Moer; Vinciane G,11,0,20,9
1745145984471,LIFR 1DX,A00,889394,Van Moer; Vinciane G,11,0,20,9
1745145985502,LIGN 7,A00,886923,Staff,30,0,50,20
1745145986535,LIGN 17,A00,886924,Kehler; Andrew Scott,133,0,150,17
1745145987560,LTAM 110,A00,889395,Staff,17,0,30,13
1745145988589,LTCH 101,A00,889397,Staff,22,0,25,3
1745145989617,LTCS 130,A00,889398,Staff,23,0,25,2
1745145990643,LTEA 138,A00,889399,Staff,25,0,40,15
1745145991668,LTEN 149,A00,889400,Wesling; Megan E.,6,0,25,19
1745145992696,LTEN 169,A00,889401,Staff,24,0,25,1
1745145993725,LTEN 180,A00,889402,Staff,12,0,15,3
1745145994751,LTEN 181,A00,889403,Staff,23,0,25,2
1745145995777,LTWL 100,A00,889404,Myerston Santana; Jacobo,8,0,25,17
1745145996803,LTWL 180GS,A00,889405,Staff,6,0,20,14
1745145997829,LTWL 181,A00,889406,Staff,19,0,25,6
1745145998856,LTWL 184,A00,889475,Mukherjee; Silpa,21,0,25,4
1745145999883,LTWR 102C,A00,889486,Staff,29,0,30,1
1745146000908,LTWR 115W,A00,889491,Staff,3,0,15,12
1745146001938,MAE 8,A01,886905,Staff,0,2,0,0
1745146002964,MAE 11,A00,886906,Bandaru; Prabhakar,0,0,50,50
1745146003991,MAE 20,A00,886907,Evdokimenko; Ekaterina,50,0,70,20
1745146005020,MAE 30B,A00,886909,Ghazinejad; Maziar,28,0,45,17
1745146006052,MAE 101B,A00,886910,Saintillan; David,36,0,45,9
1745146007077,MAE 105,A00,886911,Bandaru; Prabhakar,26,0,50,24
1745146008106,MAE 107,A00,886912,Staff,22,0,60,38
1745146009132,MAE 143B,A00,886913,Bewley; Thomas R,14,0,40,26
1745146010157,MAE 148,A01,886915,Silberman; Jack,5,0,14,9
1745146011183,MAE 160,A00,886916,Evdokimenko; Ekaterina,41,0,60,19
1745146012209,MATH 3C,A01,889681,Staff,2,0,30,28
1745146013236,MATH 10A,A01,889760,Staff,28,0,30,2
1745146013236,MATH 10A,A02,889783,Staff,30,0,30,0
1745146014271,MATH 10B,A01,889785,Verstraete; Jacques Allan,0,2,30,30
1745146014271,MATH 10B,A02,889795,Verstraete; Jacques Allan,0,2,30,30
1745146014271,MATH 10B,B01,889797,Verstraete; Jacques Allan,0,0,30,30
1745146014271,MATH 10B,B02,889828,Verstraete; Jacques Allan,23,0,30,7
1745146015300,MATH 10C,A01,889849,Habib; Yousaf,18,0,30,12
1745146015300,MATH 10C,A02,889852,Habib; Yousaf,20,0,30,10
1745146015300,MATH 10C,A03,889853,Habib; Yousaf,24,0,30,6
1745146015300,MATH 10C,A04,889858,Habib; Yousaf,21,0,30,9
1745146015300,MATH 10C,B01,889861,Staff,12,0,30,18
1745146015300,MATH 10C,B02,889862,Staff,26,0,30,4
1745146015300,MATH 10C,B03,889863,Staff,28,0,30,2
1745146015300,MATH 10C,B04,889967,Staff,25,0,30,5
1745146016329,MATH 18,A01,889974,Staff,15,0,30,15
1745146016329,MATH 18,A02,889977,Staff,25,0,30,5
1745146016329,MATH 18,B01,889984,Hardiman; Liam,26,0,30,4
1745146016329,MATH 18,B02,889985,Hardiman; Liam,28,0,30,2
1745146017368,MATH 20A,A01,889990,Suk; Andrew Hoon,31,0,35,4
1745146018401,MATH 20B,A01,889993,Ohm; Ko Woon,21,0,30,9
1745146018401,MATH 20B,A02,889994,Ohm; Ko Woon,30,0,30,0
1745146018401,MATH 20B,B01,889996,Ohm; Ko Woon,25,0,30,5
1745146018401,MATH 20B,B02,889997,Ohm; Ko Woon,24,0,30,6
1745146019429,MATH 20C,A01,889999,Hammock; Frances H,22,0,30,8
1745146019429,MATH 20C,A02,890003,Hammock; Frances H,23,0,30,7
1745146019429,MATH 20C,B01,890006,Hammock; Frances H,11,0,30,19
1745146019429,MATH 20C,B02,890007,Hammock; Frances H,18,0,30,12
1745146020456,MATH 20D,A01,890011,Cheng; Hsiao-Bing,6,0,30,24
1745146020456,MATH 20D,A02,890012,Cheng; Hsiao-Bing,27,0,30,3
1745146020456,MATH 20D,B01,890016,Cheng; Hsiao-Bing,19,0,30,11
1745146020456,MATH 20D,B02,890017,Cheng; Hsiao-Bing,15,0,30,15
1745146021490,MATH 20E,A01,890026,Harel; Guershon,10,0,30,20
1745146021490,MATH 20E,A02,890029,Harel; Guershon,24,0,30,6
1745146021490,MATH 20E,B01,890033,Harel; Guershon,14,0,30,16
1745146021490,MATH 20E,B02,890101,Harel; Guershon,27,0,30,3
1745146022516,MATH 102,A01,890104,Staff,20,0,30,10
1745146022516,MATH 102,A02,890105,Staff,30,0,30,0
1745146023549,MATH 103B,A01,890116,Salehi Golsefidy; Alireza,8,0,30,22
1745146023549,MATH 103B,B01,890118,Staff,0,4,30,30
1745146024579,MATH 109,A01,890121,Aliabadi Sr.; Mohsen,6,0,30,24
1745146024579,MATH 109,B01,890124,Upadrashta; Pranav Kumar,23,0,30,7
1745146025609,MATH 120A,A01,890126,Eggers; John Dietrich,15,0,30,15
1745146026641,MATH 142B,A01,890128,Ioana; Adrian,17,0,30,13
1745146026641,MATH 142B,A02,890129,Ioana; Adrian,15,0,30,15
1745146027670,MATH 154,A01,890174,Staff,0,1,30,30
1745146027670,MATH 154,A02,890182,Staff,15,0,30,15
1745146028700,MATH 168A,A01,890197,Dumitriu; Ioana,22,0,35,13
1745146029749,MATH 170A,A01,890240,Nie; Jiawang,5,0,30,25
1745146029749,MATH 170A,A02,890241,Nie; Jiawang,18,0,30,12
1745146029749,MATH 170A,A03,890249,Nie; Jiawang,23,0,30,7
1745146030774,MATH 170B,A01,957891,Nag; Panchali,25,0,35,10
1745146032835,MATH 181A,A01,908025,Staff,0,8,35,35
1745146033861,MATH 193B,A01,890265,Staff,3,0,35,32
1745146034888,MGT 4,A01,890311,Anderson; John Charles,57,0,88,31
1745146035917,MGT 5,A00,907740,Staff,41,0,98,57
1745146036944,MGT 12,A00,890312,Lindenberger; Wade Douglas,70,0,98,28
1745146037973,MGT 16,A00,957883,Staff,84,0,98,14
1745146040024,MGT 45,A00,890314,Pecore; Joseph P.,57,0,98,41
1745146041050,MGT 71,A00,890315,Staff,6,0,98,92
1745146042080,MGT 100,A00,890316,Yavorsky; Daniel Ryan,58,0,98,40
1745146043112,MGT 103,A00,890317,Ehrich; Kristine R,77,0,98,21
1745146044143,MGT 105,A00,890356,Bates; Kenneth Walter,19,0,98,79
1745146045169,MGT 112,A00,890360,Ehrich; Kristine R,65,0,98,33
1745146046196,MGT 127R,A00,907732,Zhu; Kevin Xiaoguo,32,0,98,66
1745146047221,MGT 131B,A00,890361,Anderson; John Charles,75,0,98,23
1745146048247,MGT 137,A00,890362,Lindenberger; Wade Douglas,68,0,98,30
1745146049273,MGT 160,A00,890369,Johnson; Erik Barry,36,0,98,62
1745146051333,MGT 164,A00,890372,Zimmermann; Carsten,0,29,98,98
1745146052363,MGT 180,A00,890374,Bliss; Barbara Ann,31,0,98,67
1745146053396,MMW 15,A01,886414,Chang; Edmond Yi-Teh,0,10,28,28
1745146053396,MMW 15,A02,886415,Chang; Edmond Yi-Teh,0,10,28,28
1745146053396,MMW 15,A03,886416,Chang; Edmond Yi-Teh,0,8,28,28
1745146053396,MMW 15,A04,886417,Chang; Edmond Yi-Teh,0,8,28,28
1745146053396,MMW 15,B01,886419,Chang; Edmond Yi-Teh,0,8,28,28
1745146053396,MMW 15,B02,886420,Chang; Edmond Yi-Teh,0,9,28,28
1745146053396,MMW 15,B03,886421,Chang; Edmond Yi-Teh,0,9,28,28
1745146053396,MMW 15,B04,886422,Chang; Edmond Yi-Teh,0,9,28,28
1745146053396,MMW 15,C01,886424,Staff,0,10,28,28
1745146053396,MMW 15,C02,886425,Staff,0,10,28,28
1745146053396,MMW 15,C03,886426,Staff,0,9,28,28
1745146053396,MMW 15,C04,886427,Staff,0,9,28,28
1745146054420,MMW 15GS,A00,906910,Patterson; Patrick H.,5,0,28,23
1745146055449,MMW 122R,A01,886429,Rahimi; Babak,0,23,28,28
1745146055449,MMW 122R,A02,886430,Rahimi; Babak,0,23,28,28
1745146056477,MUS 1A,A01,890937,Staff,7,0,25,18
1745146056477,MUS 1A,A02,891035,Staff,15,0,25,10
1745146056477,MUS 1A,B00,907849,Staff,48,0,50,2
1745146056477,MUS 1A,B01,907850,Staff,25,0,25,0
1745146056477,MUS 1A,B02,907851,Staff,25,0,25,0
1745146058528,MUS 2AK,A00,957092,Ohnishi; Takae,15,0,15,0
1745146059555,MUS 4,A01,891044,Staff,6,0,25,19
1745146059555,MUS 4,A02,891045,Staff,24,0,25,1
1745146059555,MUS 4,B01,891048,Staff,20,0,25,5
1745146059555,MUS 4,B02,891050,Staff,25,0,25,0
1745146060582,MUS 5,A01,957506,Dubnov; Shlomo,4,0,25,21
1745146060582,MUS 5,A02,957622,Dubnov; Shlomo,21,0,25,4
1745146060582,MUS 5,A03,957623,Dubnov; Shlomo,23,0,25,2
1745146061609,MUS 6,A01,891053,Freitas Caetano; Marcelo,23,0,25,2
1745146061609,MUS 6,A02,891054,Freitas Caetano; Marcelo,23,0,25,2
1745146062636,MUS 7,A01,891081,Staff,0,0,25,25
1745146062636,MUS 7,A02,891082,Staff,14,0,25,11
1745146063661,MUS 8GS,A00,891118,Borgo; David Garcia,5,0,25,20
1745146064687,MUS 11,A01,891140,Staff,12,0,25,13
1745146064687,MUS 11,A02,891141,Staff,24,0,25,1
1745146065712,MUS 13,A01,891143,Staff,10,0,25,15
1745146065712,MUS 13,A02,891144,Staff,25,0,25,0
1745146066739,MUS 15,A01,891146,Staff,7,0,25,18
1745146066739,MUS 15,A02,891148,Staff,22,0,25,3
1745146066739,MUS 15,B01,891150,Staff,18,0,25,7
1745146066739,MUS 15,B02,891151,Staff,25,0,25,0
1745146067765,MUS 20,A01,891153,Staff,9,0,20,11
1745146067765,MUS 20,A02,891155,Staff,16,0,20,4
1745146068790,MUS 80,A00,891156,Staff,19,0,25,6
1745146068790,MUS 80,B00,891157,Staff,24,0,25,1
1745146069820,MUS 130,A00,891158,Ohnishi; Takae,35,0,35,0
1745146070848,MUS 150GS,A01,891160,Borgo; David Garcia,5,0,25,20
1745146071875,MUS 170,A01,891162,Freitas Caetano; Marcelo,21,0,25,4
1745146071875,MUS 170,A02,891164,Freitas Caetano; Marcelo,22,0,25,3
1745146072909,NANO 11,A00,886220,Vazquez Mena; Oscar,12,0,15,3
1745146073935,NANO 15,A01,886222,Drews; Aaron,9,0,10,1
1745146074961,NANO 104,A00,886224,Sirbuly; Donald,18,0,25,7
1745146075987,PH 40,A00,886528,Staff,29,0,40,11
1745146077013,PH 45,A01,886799,Staff,36,0,40,4
1745146078040,PH 110,A00,886802,Staff,7,0,40,33
1745146079066,PH 172,A00,906716,Staff,20,0,35,15
1745146080090,PH 191,A00,886803,Staff,23,0,40,17
1745146081115,PHIL 1,A00,889500,Staff,22,0,30,8
1745146082147,PHIL 10,A01,889549,Grush; Rick Scott,17,0,22,5
1745146082147,PHIL 10,A02,889551,Grush; Rick Scott,20,0,22,2
1745146083173,PHIL 28,A01,889559,Lamey; Andy M.,0,4,25,25
1745146083173,PHIL 28,A02,889561,Lamey; Andy M.,0,0,25,25
1745146083173,PHIL 28,A03,889572,Lamey; Andy M.,7,0,25,18
1745146084200,PHIL 35,A00,907839,Staff,32,0,33,1
1745146085225,PHIL 60,A00,889574,Staff,79,0,90,11
1745146086256,PHIL 105,A00,889579,Staff,0,1,0,0
1745146087286,PHIL 136,A00,889582,Fulkerson; Matthew Todd,27,0,45,18
1745146088315,PHIL 163,A01,889601,Staff,24,0,30,6
1745146088315,PHIL 163,B01,889606,Brandt; Reuven A,0,2,0,0
1745146089343,PHIL 164,A00,889610,Staff,20,0,30,10
1745146090373,PHIL 165,A00,889613,Staff,26,0,30,4
1745146091402,PHYS 1A,A00,886431,Staff,38,0,70,32
1745146092429,PHYS 1AL,001,886432,Tsai; Philbert S,0,0,30,30
1745146092429,PHYS 1AL,002,886436,Tsai; Philbert S,19,0,30,11
1745146093455,PHYS 1B,A00,886439,Staff,192,0,240,48
1745146094485,PHYS 1BL,001,886441,Tsai; Philbert S,0,1,30,30
1745146094485,PHYS 1BL,002,886444,Tsai; Philbert S,14,0,30,16
1745146095515,PHYS 1C,A00,896092,Arnold; Kam S,87,0,146,59
1745146096542,PHYS 1CL,001,886448,Tsai; Philbert S,0,4,30,30
1745146096542,PHYS 1CL,002,886449,Tsai; Philbert S,6,0,30,24
1745146096542,PHYS 1CL,003,886450,Tsai; Philbert S,22,0,30,8
1745146096542,PHYS 1CL,004,886451,Tsai; Philbert S,16,0,30,14
1745146097576,PHYS 2B,A01,886457,Staff,86,0,115,29
1745146098602,PHYS 2C,A01,886460,Shotwell; Brian,0,0,65,65
1745146099632,PHYS 2CL,A01,886467,Staff,0,3,28,28
1745146099632,PHYS 2CL,A02,886468,Staff,5,0,28,23
1745146100661,PHYS 2D,A01,886470,Staff,17,0,50,33
1745146101693,PHYS 4B,A01,886475,Grinstein; Benjamin,87,0,100,13
1745146102722,POLI 5,A00,891173,Desposato; Scott,17,0,25,8
1745146103748,POLI 5D,A01,891175,Staff,5,0,5,0
1745146103748,POLI 5D,B01,891178,Staff,5,0,5,0
1745146104779,POLI 11,A00,891179,Ferree; Karen E,3,0,25,22
1745146105804,POLI 12,A00,891180,Staff,21,0,30,9
1745146106833,POLI 27,A01,891182,Staff,29,0,75,46
1745146107863,POLI 30,A00,891183,Staff,0,3,30,30
1745146108888,POLI 100B,A00,891244,Staff,0,8,20,20
1745146109913,POLI 100I,A00,891247,Staff,19,0,30,11
1745146110943,POLI 104J,A00,891248,Nichter; Maysa,18,0,30,12
1745146111968,POLI 104U,A00,891250,Nichter; Maysa,9,0,30,21
1745146112995,POLI 108,A00,891253,Staff,0,0,0,4
1745146114022,POLI 110B,A00,891255,Wiens; David,22,0,25,3
1745146115049,POLI 112A,A00,891256,Wiens; David,15,0,25,10
1745146116075,POLI 114BR,A00,891261,Staff,22,0,30,8
1745146117102,POLI 117R,A00,891262,Forman; Fonna,12,0,50,38
1745146118128,POLI 118,A00,891264,Ingham; Sean,22,0,25,3
1745146119153,POLI 124A,A00,891265,Staff,19,0,20,1
1745146120180,POLI 125D,A00,891266,Nichter; Simeon C,9,0,25,16
1745146121208,POLI 126,A00,891268,Nichter; Simeon C,11,0,25,14
1745146122235,POLI 126AA,A00,891272,Staff,19,0,25,6
1745146123260,POLI 130AA,A00,891273,Staff,17,0,20,3
1745146124286,POLI 134AA,A00,891274,Staff,12,0,20,8
1745146126344,POLI 138,A00,891278,Staff,22,0,25,3
1745146127370,POLI 142K,A00,891280,Staff,17,0,25,8
1745146128397,POLI 142M,A00,891281,Gartzke; Erik,22,0,30,8
1745146129425,POLI 142P,A00,891284,Staff,21,0,30,9
1745146130449,POLI 143,A00,891285,Gartzke; Erik,17,0,30,13
1745146131478,POLI 153,A00,891286,Staff,20,0,20,0
1745146132508,POLI 170A,A00,891288,Staff,19,0,25,6
1745146133535,POLI 175,A00,891290,Staff,18,0,20,2
1745146134561,PSYC 1,A00,890674,Steiner; Eric Tomas,0,4,45,45
1745146135588,PSYC 2,A00,890676,Albright; Thomas D,25,0,35,10
1745146136612,PSYC 3,A00,890679,Staff,18,0,20,2
1745146137637,PSYC 60,A01,890684,Rickard; Timothy C.,7,0,45,38
1745146138663,PSYC 70,A01,890689,Geller; Emma Harlan,14,0,30,16
1745146139692,PSYC 100,A00,890690,Lacefield; Katharine I,0,43,180,180
1745146140727,PSYC 102,A00,890695,Staff,25,0,40,15
1745146141766,PSYC 105,A00,890699,Geller; Emma Harlan,78,0,100,22
1745146142795,PSYC 106,A00,890701,Gorman; Michael R.,15,0,30,15
1745146143828,PSYC 108,A00,890704,Adrian; Julia Anna,0,23,50,50
1745146144859,PSYC 118,A01,890712,Staff,18,0,30,12
1745146145885,PSYC 124,A00,890716,Chapman; Eddie Nathaniel,36,0,60,24
1745146146910,PSYC 131,A00,890717,Anagnostaras; Stephan,6,0,80,74
1745146147935,PSYC 137,A00,890719,Winkielman; Piotr,0,2,30,30
1745146148961,PSYC 144,A00,890721,Adrian; Julia Anna,0,3,45,45
1745146149994,PSYC 162,A00,890805,Staff,21,0,75,54
1745146151021,PSYC 169,A00,890810,Staff,0,15,30,30
1745146152046,PSYC 172,A00,890814,Gorman; Michael R.,14,0,30,16
1745146153074,PSYC 181,A00,890818,Anagnostaras; Stephan,63,0,200,137
1745146154099,PSYC 189,A00,890823,Staff,11,0,30,19
1745146155125,PSYC 191,A00,890884,Rickard; Timothy C.,0,11,35,35
1745146156153,PSYC 193,A00,890913,Staff,22,0,30,8
1745146156153,PSYC 193,B00,890914,Chapman; Eddie Nathaniel,25,0,30,5
1745146157187,PSYC 193L,A01,890918,Lowe; Angela Beth,29,0,30,1
1745146157187,PSYC 193L,B01,890921,Hurwitz; Ethan Scott,28,0,30,2
1745146157187,PSYC 193L,C01,890928,Staff,30,0,30,0
1745146158215,RELI 149,A00,886806,Rahimi; Babak,23,0,40,17
1745146159240,SE 9,A01,886814,Staff,13,0,20,7
1745146160265,SE 101B,A01,886816,Chadha; Mayank,8,0,30,22
1745146161297,SE 110B,A00,886818,Zhu; Qiang,0,16,45,45
1745146162324,SE 125,A01,886830,Staff,10,0,30,20
1745146163370,SE 130B,A01,886835,Staff,19,0,40,21
1745146164396,SE 131A,A01,886838,Krysl; Petr,37,0,55,18
1745146165425,SE 154,A00,886840,Staff,35,0,50,15
1745146166451,SE 164GS,A01,886849,Staff,13,0,20,7
1745146167478,SE 167GS,A01,886853,Staff,13,0,20,7
1745146168503,SIO 25,A01,890107,Staff,23,0,30,7
1745146169534,SIO 45,A00,890109,Cook; Geoffrey W,137,0,200,63
1745146170559,SIO 109R,A00,890110,Forman; Fonna,0,11,20,20
1745146171590,SIO 187,A01,890114,Kacev; David,21,0,40,19
1745146172618,SOCI 1,A01,890431,Thorpe; Charles Robert,21,0,30,9
1745146172618,SOCI 1,A02,890518,Thorpe; Charles Robert,30,0,30,0
1745146173648,SOCI 2,A01,957978,Staff,0,0,0,0
1745146173648,SOCI 2,A02,957979,Staff,0,3,0,0
1745146174683,SOCI 20,A01,890523,Calderon-Zaks; Michael Aar,24,0,30,6
1745146174683,SOCI 20,A02,890526,Calderon-Zaks; Michael Aar,29,0,30,1
1745146175718,SOCI 30,A01,890533,Pardo Guerra; Juan Pablo,37,0,40,3
1745146176745,SOCI 40,A01,890535,Staff,32,0,45,13
1745146177773,SOCI 104Q,A00,890559,Staff,20,0,30,10
1745146178799,SOCI 106,A00,890560,Arnal; Maud Marie Leonie,22,0,30,8
1745146179826,SOCI 110,A00,890567,Holkenbrink-Monk; Charlene,22,0,30,8
1745146180858,SOCI 112,A00,890568,Victoria Torres; Pablo,0,0,45,45
1745146181889,SOCI 115,A00,890597,Arnal; Maud Marie Leonie,33,0,45,12
1745146183946,SOCI 121,A00,890604,Pardo Guerra; Juan Pablo,40,0,45,5
1745146184971,SOCI 126,A01,890608,Staff,8,0,10,2
1745146186000,SOCI 127,A00,890609,Staff,23,0,30,7
1745146187031,SOCI 131,A00,890610,Thorpe; Charles Robert,38,0,45,7
1745146188055,SOCI 135,A00,890615,Payne; Christine Anna,19,0,45,26
1745146189080,SOCI 139,A00,890620,Staff,43,0,45,2
1745146190110,SOCI 148E,A00,890622,Calderon-Zaks; Michael Aar,39,0,45,6
1745146191143,SOCI 150,A00,890623,Kohler; Kristopher M.,36,0,45,9
1745146192168,SOCI 157,A00,890625,Jules-Rosette; Bennetta W.,18,0,20,2
1745146193192,SOCI 160,A00,890627,Payne; Christine Anna,26,0,45,19
1745146194227,SYN 1,A00,886855,Fish; Gwendolyn Anne,0,0,0,0
1745146194227,SYN 1,B00,906086,Fish; Gwendolyn Anne,0,0,0,2
1745146195252,SYN 2R,A00,886860,Staff,0,15,15,15
1745146195252,SYN 2R,B00,906106,Atkinson; Arthur Laird,0,14,15,15
1745146196283,SYN 100,A01,886866,Browne; Emily,0,29,20,20
1745146196283,SYN 100,B01,906128,Rock; Martin,0,4,20,20
1745146196283,SYN 100,C01,906140,Deavenport; James Cary,0,2,20,20
1745146196283,SYN 100,D01,907816,Deavenport; James Cary,0,3,20,20
1745146197314,TDAC 1,A00,890286,Walsh; Kim C.,11,0,20,9
1745146198340,TDAC 101,A00,890296,Basso; Beatrice,18,0,20,2
1745146199369,TDDE 131,A00,890297,Staff,47,0,50,3
1745146200395,TDDM 1,A00,890287,Weinberg; Sadie,26,0,30,4
1745146201428,TDGE 11,A00,890288,Fulton; Julia,155,0,200,45
1745146201428,TDGE 11,B00,890289,Castro; Robert Jess,188,0,200,12
1745146202456,TDGE 25,B00,957359,Walsh; Kim C.,9,0,20,11
1745146203485,TDGE 40,A01,890292,Power; Jade Yukana,28,0,30,2
1745146204515,TDGE 124,A00,890298,Havis; Allan,12,0,50,38
1745146205541,TDGE 131R,A00,890299,Burelle; Julie Sara Veronique,20,0,42,22
1745146206568,TDHT 101,A00,890300,Staff,12,0,20,8
1745146207595,TDHT 109,A01,890302,Anderson; Mysia Anyse,31,0,40,9
1745146208620,TDMV 1,A00,890293,Arcidiacono; Kristin,20,0,30,10
1745146209647,TDMV 2,A00,890294,Weinberg; Sadie,26,0,30,4
1745146210674,TDMV 3,A00,957878,Arcidiacono; Kristin,27,0,30,3
1745146212728,TDMV 138,A00,890304,Jun; Grace Shin Hae,25,0,40,15
1745146213756,TDMV 140,A00,890305,Corrales; Joseph Bernales,28,0,30,2
1745146214783,TDMV 142,A00,890307,Caligagan; Tony,30,0,40,10
1745146215810,TDMV 144,A00,890308,Camaya; Michelle Ann,26,0,30,4
1745146216841,TDPW 1,A00,890295,Stein; Deborah Isobel,5,0,20,15
1745146217868,USP 2,A01,890272,Lerner; Amy M,8,0,20,12
1745146218894,USP 3,A01,890274,Staff,21,0,30,9
1745146219920,USP 15,A01,890276,Sun; Feiyang,21,0,30,9
1745146220946,USP 25,A00,890277,Shenkman; Michael Thomas,21,0,25,4
1745146221975,USP 138,A00,890278,Staff,15,0,25,10
1745146223005,USP 143,A00,890279,Staff,30,0,70,40
1745146224031,USP 144,A00,890280,Chowdhury; Muhammed Zohir,19,0,30,11
1745146225058,USP 150,A00,890281,Boomhower; Matthew Charles,19,0,30,11
1745146226083,USP 151,A00,890282,Staff,17,0,20,3
1745146227108,USP 162,A00,890283,Andrews; Abigail Leslie,17,0,20,3
1745146228138,USP 168,A00,920477,Kwak; Nancy,2,0,5,3
1745146229165,USP 181,A00,890284,Staff,11,0,20,9
1745146230191,USP 191A,A00,890285,Staff,15,0,20,5
1745146231217,VIS 101,A00,886512,Staff,37,0,75,38
1745146232244,VIS 103,A00,886513,Cruz; Edwin Teddy,65,0,75,10
1745146233273,VIS 108,A00,886514,Staff,7,0,15,8
1745146234299,VIS 127P,A00,886515,Shen; Kuiyi,92,0,146,54
1745146235325,VIS 149,A00,886516,Yoldas; Pinar,1,0,15,14
1745146236351,VIS 164,A00,886526,Erdmann; Dean,21,0,22,1
1745146237378,VIS 194S,A00,886527,Staff,61,0,75,14
1745146238407,WCWP 10A,C00,886484,Staff,13,0,15,2
1745146239433,WCWP 10B,A00,886490,Staff,5,0,15,10
1745146239433,WCWP 10B,B00,886491,Staff,0,1,0,0
1745146239433,WCWP 10B,C00,886492,Staff,10,0,15,5
1745146240463,WCWP 100,A00,886494,Staff,0,3,15,15
1745146242608,AAS 10,A01,886199,Childs; Dennis R.,0,2,0,0
1745146243635,ANAR 104,A01,886940,Shtienberg; Gilad,27,0,30,3
1745146244664,ANAR 120,A00,886953,Staff,13,0,20,7
1745146245694,ANBI 148,A01,886955,Wilder; Linnea Lorene,32,0,40,8
1745146247750,ANSC 122,A00,886957,Staff,28,0,30,2
1745146248777,ANSC 150,A00,886958,Sloane; Julia Kathryn,6,0,15,9
1745146249805,ANSC 156,A00,886959,Jenkins; Janis A.,2,0,15,13
1745146250831,ANSC 180,A00,886960,Staff,12,0,17,5
1745146251857,ANSC 188,A00,886961,Jassal; Aftab,10,0,25,15
1745146252886,ANSC 190,A00,886962,Jassal; Aftab,14,0,25,11
1745146253913,ANSC 191,A00,886963,Staff,18,0,20,2
1745146254940,ANTH 3,A01,891689,Staff,19,0,20,1
1745146255966,ANTH 5,A00,886933,Semendeferi; Ekaterini,18,0,20,2
1745146256994,ANTH 10,A00,886934,Staff,0,8,30,30
1745146258071,ANTH 21,A01,886936,Staff,44,0,60,16
1745146259100,ANTH 23,A01,886938,Staff,94,0,100,6
1745146260126,ANTH 105,A00,886964,Stewart; Alexander B,94,0,100,6
1745146261152,ANTH 108,A00,886965,Pedersen; David,10,0,20,10
1745146262195,AWP 10,001,886147,Staff,0,0,0,0
1745146262195,AWP 10,002,886148,Staff,0,0,0,0
1745146262195,AWP 10,003,886149,Staff,0,0,0,0
1745146262195,AWP 10,004,886150,Staff,0,0,0,0
1745146262195,AWP 10,005,886151,Staff,0,0,0,0
1745146262195,AWP 10,006,886152,Staff,0,0,0,0
1745146262195,AWP 10,007,886153,Staff,0,0,0,0
1745146262195,AWP 10,008,886154,Staff,0,0,0,0
1745146262195,AWP 10,009,886155,Staff,0,0,0,0
1745146262195,AWP 10,010,886156,Staff,0,0,0,0
1745146262195,AWP 10,011,886158,Staff,0,0,0,0
1745146262195,AWP 10,012,886160,Staff,0,0,0,0
1745146262195,AWP 10,013,886161,Staff,0,0,0,0
1745146262195,AWP 10,014,886162,Staff,0,0,0,0
1745146262195,AWP 10,015,886163,Staff,0,0,0,0
1745146262195,AWP 10,016,886164,Staff,0,0,0,0
1745146262195,AWP 10,017,886165,Staff,0,0,0,0
1745146262195,AWP 10,018,886166,Staff,0,0,0,0
1745146262195,AWP 10,019,886168,Staff,0,0,0,0
1745146262195,AWP 10,020,886170,Staff,0,0,0,0
1745146262195,AWP 10,021,886172,Staff,0,0,0,0
1745146263230,AWP 10R,001,886173,Staff,0,0,0,0
1745146263230,AWP 10R,002,886174,Staff,0,1,0,0
1745146263230,AWP 10R,003,886175,Staff,0,0,0,0
1745146263230,AWP 10R,004,886176,Staff,0,0,0,0
1745146263230,AWP 10R,005,886177,Staff,0,0,0,0
1745146263230,AWP 10R,006,886178,Staff,0,0,0,0
1745146263230,AWP 10R,007,886179,Staff,0,0,0,0
1745146263230,AWP 10R,008,886181,Staff,0,0,0,0
1745146263230,AWP 10R,009,886182,Staff,0,0,0,0
1745146263230,AWP 10R,010,886183,Staff,0,0,0,0
1745146263230,AWP 10R,011,886184,Staff,0,0,0,0
1745146263230,AWP 10R,012,886185,Staff,0,0,0,0
1745146263230,AWP 10R,013,886186,Staff,0,0,0,0
1745146263230,AWP 10R,014,886187,Staff,0,0,0,0
1745146263230,AWP 10R,015,886188,Staff,0,0,0,0
1745146263230,AWP 10R,016,886189,Staff,0,0,0,0
1745146264260,AWP 102R,A00,886190,Staff,0,0,0,0
1745146264260,AWP 102R,B00,886191,Staff,0,0,0,0
1745146265289,BENG 100,A01,886193,Staff,19,0,30,11
1745146266324,BENG 122A,A01,886195,Hasty; Jeff M,20,0,30,10
1745146267356,BENG 166A,A00,886196,Sah; Robert Lie-Yuan,0,3,20,20
1745146268388,BIBC 102,A01,894320,Staff,0,2,46,46
1745146268388,BIBC 102,A02,894321,Staff,0,0,46,46
1745146268388,BIBC 102,A03,894344,Staff,21,0,46,25
1745146268388,BIBC 102,A04,894345,Staff,30,0,47,17
1745146269415,BICD 100R,A01,894365,Smith; Laurie,1,3,58,57
1745146269415,BICD 100R,A02,894366,Smith; Laurie,0,1,58,58
1745146269415,BICD 100R,A03,894367,Smith; Laurie,13,0,59,46
1745146270442,BICD 136,A01,894383,Gustafson-Brown; Cindy,16,0,50,34
1745146271471,BIEB 102,A01,894494,Butler; Shannon Rhey,67,0,130,63
1745146273538,BIEB 150,A01,894617,Wills; Christopher,0,3,13,13
1745146273538,BIEB 150,A02,894631,Wills; Christopher,0,3,13,13
1745146273538,BIEB 150,A03,894937,Wills; Christopher,0,3,13,13
1745146273538,BIEB 150,A04,894946,Wills; Christopher,0,1,11,11
1745146274566,BIEB 194,A00,906141,Kurle; Carolyn M.,14,0,20,6
1745146275593,BILD 1,A01,894154,Staff,8,0,19,11
1745146275593,BILD 1,A02,894155,Staff,15,0,19,4
1745146275593,BILD 1,A03,894160,Staff,18,0,19,1
1745146275593,BILD 1,A04,894161,Staff,16,0,18,2
1745146276618,BILD 2,A01,894168,Staff,0,0,50,50
1745146276618,BILD 2,A02,894169,Staff,0,0,50,50
1745146276618,BILD 2,A03,894179,Staff,27,0,50,23
1745146276618,BILD 2,A04,894203,Staff,42,0,50,8
1745146277644,BILD 3,A01,894213,Staff,24,0,31,7
1745146277644,BILD 3,A02,894214,Staff,28,0,31,3
1745146277644,BILD 3,A03,894235,Staff,30,0,31,1
1745146277644,BILD 3,A04,894236,Staff,29,0,32,3
1745146278671,BILD 4,A01,894253,Reuther; Keefe,12,0,24,12
1745146278671,BILD 4,A02,894258,Reuther; Keefe,19,0,24,5
1745146279700,BILD 5,A01,894276,Reuther; Keefe,40,0,50,10
1745146279700,BILD 5,A02,894277,Reuther; Keefe,48,0,50,2
1745146279700,BILD 5,A03,894290,Reuther; Keefe,47,0,50,3
1745146279700,BILD 5,A04,894291,Reuther; Keefe,50,0,50,0
1745146280728,BILD 24,A01,894297,Pirino; Giorgia,45,0,60,15
1745146281755,BIMM 100,A01,895012,Staff,0,14,0,1
1745146281755,BIMM 100,A02,895013,Staff,0,6,0,2
1745146281755,BIMM 100,A03,895014,Staff,0,7,0,0
1745146281755,BIMM 100,A04,895015,Staff,0,4,0,0
1745146282789,BIMM 101,A01,895017,McDonnell; Lisa Marie,0,2,24,24
1745146282789,BIMM 101,A02,895018,McDonnell; Lisa Marie,0,1,24,24
1745146282789,BIMM 101,B01,895020,McDonnell; Lisa Marie,0,3,24,24
1745146282789,BIMM 101,B02,895021,McDonnell; Lisa Marie,0,2,24,24
1745146283820,BIMM 110,A01,895023,Staff,7,0,25,18
1745146283820,BIMM 110,A02,895024,Staff,11,0,25,14
1745146283820,BIMM 110,A03,895025,Staff,22,0,25,3
1745146283820,BIMM 110,A04,895031,Staff,21,0,25,4
1745146284854,BIMM 120,A01,895114,Gustafson-Brown; Cindy,8,0,28,20
1745146284854,BIMM 120,A02,895126,Gustafson-Brown; Cindy,19,0,27,8
1745146285881,BIPN 100,A01,895130,Yang; Mingyu,13,0,38,25
1745146285881,BIPN 100,A02,895131,Yang; Mingyu,33,0,38,5
1745146285881,BIPN 100,A03,895132,Yang; Mingyu,33,0,38,5
1745146285881,BIPN 100,A04,895133,Yang; Mingyu,30,0,36,6
1745146286914,BIPN 120,A01,895135,Cooke; James Edward,0,2,13,13
1745146286914,BIPN 120,A02,895136,Cooke; James Edward,0,1,13,13
1745146286914,BIPN 120,A03,895137,Cooke; James Edward,0,0,13,13
1745146286914,BIPN 120,A04,895156,Cooke; James Edward,3,0,11,8
1745146287949,BIPN 134,A01,895235,Cooke; James Edward,0,2,25,25
1745146287949,BIPN 134,A02,895237,Cooke; James Edward,0,0,25,25
1745146287949,BIPN 134,A03,895240,Cooke; James Edward,12,0,25,13
1745146287949,BIPN 134,A04,895270,Cooke; James Edward,24,0,25,1
1745146288978,BIPN 189,A00,892103,Staff,0,20,9,9
1745146291036,CAT 124,A01,922009,Staff,0,1,20,20
1745146292072,CAT 125R,A00,886390,Morales; Celeste Georgianna,4,0,20,16
1745146292072,CAT 125R,B00,886391,Irwin; Matthew Joseph,0,1,20,20
1745146292072,CAT 125R,C00,886392,Smith; Lauryn Alissa,11,0,20,9
1745146292072,CAT 125R,D00,886393,Vanderschuit; Maya Alysia,6,0,20,14
1745146292072,CAT 125R,E00,886394,Marchisotto; Jennifer Anne,0,2,20,20
1745146293097,CENG 15,A01,886218,Drews; Aaron,1,0,5,4
1745146294129,CENG 113,A00,886219,Opatkiewicz; Justin Paul,16,0,25,9
1745146295156,CGS 101,A00,887044,Staff,13,0,20,7
1745146296183,CGS 105,A01,887046,Staff,16,0,25,9
1745146297210,CGS 112,A00,887047,Cuong; Marisol,12,0,15,3
1745146298238,CGS 113,A00,887048,Staff,24,0,30,6
1745146299265,CGS 120,A00,887049,Staff,12,0,17,5
1745146300293,CHEM 6A,A01,886336,Lam; Tin Yiu,44,0,50,6
1745146300293,CHEM 6A,A02,886338,Lam; Tin Yiu,43,0,50,7
1745146301321,CHEM 6B,A01,886341,Hopkins; Patrycja Anna,21,0,50,29
1745146301321,CHEM 6B,A02,886343,Hopkins; Patrycja Anna,46,0,50,4
1745146302349,CHEM 6C,A01,886346,Albizati; Kim F.,0,1,50,50
1745146302349,CHEM 6C,A02,886348,Albizati; Kim F.,38,0,50,12
1745146303377,CHEM 40A,A01,886352,Klosterman; Jeremy K,70,0,100,30
1745146304403,CHEM 40B,A01,886356,Klosterman; Jeremy K,0,4,100,100
1745146305430,CHEM 41B,A01,886360,Theodorakis; Emmanuel,30,0,50,20
1745146305430,CHEM 41B,A02,886362,Theodorakis; Emmanuel,46,0,50,4
1745146306460,CHIN 165A,A00,886382,Xu; Li,19,0,20,1
1745146307488,CLAS 120,A00,886387,Myerston Santana; Jacobo,36,0,40,4
1745146308515,COGS 9,A01,886967,Shannon; Kyle Michael,49,0,60,11
1745146309542,COGS 11,A01,886969,Staff,18,0,30,12
1745146310567,COGS 14A,A01,886971,Staff,26,0,60,34
1745146311594,COGS 14B,A01,886973,Hoffman; Drew Ellen,18,0,60,42
1745146312621,COGS 18,A01,886975,Morgan; Eric,41,0,60,19
1745146313651,COGS 20,A01,886977,Staff,6,0,8,2
1745146313651,COGS 20,A02,886978,Staff,6,0,7,1
1745146314677,COGS 100,A01,907783,Staff,6,0,30,24
1745146315708,COGS 101B,A01,886980,Staff,0,10,30,30
1745146316738,COGS 101C,A01,886982,Delgado; Tania,0,6,30,30
1745146317764,COGS 102A,A01,886984,Johnson; Christine M.,13,0,30,17
1745146318791,COGS 118B,A01,886986,Staff,0,25,60,60
1745146319818,COGS 150,A01,886988,Bergen; Benjamin,16,0,30,14
1745146320843,COGS 153,A00,886989,Delgado; Tania,0,6,30,30
1745146321870,COGS 186,A01,886991,Staff,3,0,30,27
1745146322895,COGS 187A,A01,886993,Boyle; Mary E. T.,12,0,30,18
1745146323925,COGS 189,A00,886994,Staff,13,0,30,17
1745146324955,COMM 10,A01,886996,Staff,11,0,25,14
1745146324955,COMM 10,A02,886997,Staff,21,0,25,4
1745146325987,COMM 20,A01,886999,Leuning; Grant Maurstad,33,0,40,7
1745146328041,COMM 100A,A01,887002,Staff,0,0,25,25
1745146328041,COMM 100A,A02,887003,Staff,20,0,25,5
1745146329070,COMM 100B,A01,887005,Staff,0,1,25,25
1745146330100,COMM 106D,A00,887006,Staff,22,0,40,18
1745146331128,COMM 110G,A00,887007,Whitworth-Smith; Andrew C,17,0,40,23
1745146332158,COMM 111B,A00,887008,Staff,31,0,40,9
1745146333186,COMM 113T,A00,887009,Abuelhiga; Soraya Jill,30,0,40,10
1745146333186,COMM 113T,B00,906733,Staff,40,0,40,0
1745146334215,COMM 145,A00,887010,Staff,21,0,40,19
1745146335241,COMM 146,A00,887054,Staff,31,0,40,9
1745146336267,COMM 190,A00,887012,Staff,9,0,23,14
1745146337297,CSE 8A,A50,887015,Cao; Yingjun,68,0,85,17
1745146338327,CSE 11,A01,887017,Cao; Yingjun,35,0,70,35
1745146339357,CSE 20,A01,887019,Staff,35,0,50,15
1745146340386,CSE 21,A01,887021,Braun; Oliver,81,0,100,19
1745146340386,CSE 21,B01,892583,Staff,48,0,50,2
1745146341413,CSE 30,A01,887025,Eldon; John,161,0,200,39
1745146342440,CSE 100,A01,887027,Staff,28,0,50,22
1745146342440,CSE 100,A02,887028,Staff,43,0,50,7
1745146343484,CSE 101,A01,887030,Braun; Oliver,79,0,100,21
1745146343484,CSE 101,B01,887032,Jones; Miles E,0,1,50,50
1745146343484,CSE 101,B02,887033,Jones; Miles E,13,0,50,37
1745146344511,CSE 105,A01,908084,Jones; Miles E,36,0,50,14
1745146344511,CSE 105,A02,908087,Jones; Miles E,38,0,50,12
1745146345539,CSE 135,A01,887035,Powell; Thomas Allan,8,0,50,42
1745146346568,CSE 142,A01,887037,Staff,22,0,60,38
1745146347596,CSE 142L,A01,887039,Staff,42,0,60,18
1745146348627,CSE 151A,A01,887041,Solares; Edwin A,60,0,100,40
1745146349662,CSE 175,A01,887043,Kumar; Rakesh,30,0,30,0
1745146350689,CSS 1,A01,886389,Staff,12,0,40,28
1745146351716,DSC 30,A01,908097,Liao; Soohyun Nam,54,0,75,21
1745146352743,DSC 40A,A01,908099,Shannon; Kyle Michael,37,0,50,13
1745146353768,DSC 40B,A01,908112,Staff,28,0,50,22
1745146354798,DSC 80,A01,908116,Staff,32,0,60,28
1745146355827,DSC 197,001,956863,Eldridge; Justin Matthew,9999,0,9999,0
1745146356852,ECE 5,A01,886400,Morris; Karcher William,3,0,6,3
1745146356852,ECE 5,A02,886401,Morris; Karcher William,5,0,6,1
1745146357878,ECE 148,A01,886403,Silberman; Jack,0,8,14,14
1745146358909,ECON 1,A01,887265,Crane; Meredith Helen,25,0,70,45
1745146358909,ECON 1,B01,887268,Staff,44,0,50,6
1745146359935,ECON 2,A01,887273,Crane; Meredith Helen,61,0,70,9
1745146360998,ECON 3,A01,887279,Rondina; Giacomo,44,0,70,26
1745146362023,ECON 4,A01,887282,Anderson; John Charles,0,1,10,10
1745146363050,ECON 5,A01,887285,Staff,39,0,45,6
1745146363050,ECON 5,B01,887292,Staff,43,0,45,2
1745146364078,ECON 100A,A01,887337,Newhouse; Herbert S,58,0,70,12
1745146364078,ECON 100A,B01,887349,Staff,45,0,50,5
1745146365103,ECON 100B,A01,887361,Du; Songzi,42,0,70,28
1745146366133,ECON 100C,A01,887445,Newhouse; Herbert S,61,0,70,9
1745146367158,ECON 105,A00,887488,Vespa; Emanuel Ignacio,24,0,35,11
1745146368182,ECON 109,A01,887506,Staff,29,0,35,6
1745146369218,ECON 110A,A01,887568,Alon; Titan Michael,1,0,35,34
1745146369218,ECON 110A,B01,907601,Alon; Titan Michael,27,0,35,8
1745146370248,ECON 110B,A01,887598,Levkoff; Steven B.,0,7,70,70
1745146371273,ECON 112,A00,887599,Rondina; Giacomo,20,0,35,15
1745146372302,ECON 120A,A01,887603,Dai; Yinlin,46,0,70,24
1745146373332,ECON 120C,A01,887608,Sun; Yixiao,0,0,35,35
1745146373332,ECON 120C,B01,887614,Sun; Yixiao,13,0,35,22
1745146374358,ECON 138,A00,887621,Bharadwaj; Prashant,0,18,20,20
1745146375386,ECON 171,A01,907666,Staff,27,0,35,8
1745146376412,ECON 175,A00,887626,Wu; Pak Yeung,27,0,35,8
1745146377441,ECON 190,A00,887640,Vespa; Emanuel Ignacio,26,0,35,9
1745146378488,EDS 25,A01,888197,Staff,0,0,0,0
1745146378488,EDS 25,A02,888209,Staff,0,0,0,0
1745146378488,EDS 25,A03,888210,Staff,0,0,0,0
1745146378488,EDS 25,A04,888212,Staff,0,0,0,0
1745146378488,EDS 25,A05,888213,Staff,0,0,0,0
1745146378488,EDS 25,A06,888214,Staff,0,0,0,0
1745146378488,EDS 25,A07,888235,Staff,0,0,0,0
1745146378488,EDS 25,A08,888236,Staff,0,0,0,0
1745146378488,EDS 25,A09,888240,Staff,0,0,0,0
1745146378488,EDS 25,A10,888244,Staff,0,0,0,0
1745146378488,EDS 25,B01,888273,Staff,0,0,0,0
1745146378488,EDS 25,B02,888285,Staff,0,0,0,0
1745146378488,EDS 25,B03,888423,Staff,29,0,30,1
1745146378488,EDS 25,B04,888432,Staff,0,0,0,0
1745146378488,EDS 25,B05,888433,Staff,0,0,0,0
1745146378488,EDS 25,B06,888467,Staff,0,0,0,0
1745146378488,EDS 25,B07,888468,Staff,0,0,0,0
1745146378488,EDS 25,B08,888479,Staff,0,0,0,0
1745146378488,EDS 25,B09,888484,Staff,0,0,0,0
1745146378488,EDS 25,B10,888487,Staff,0,0,0,0
1745146379515,EDS 38,A01,907700,Choi; Bailey Miyeon,30,0,30,0
1745146380543,EDS 112,A01,888601,Chapman; Thandeka K,23,0,40,17
1745146381569,EDS 115,A00,888697,Mendez; Kathrina Mendoza,17,0,30,13
1745146382597,EDS 116,A01,888893,Staff,38,0,40,2
1745146384652,EDS 124AR,A00,889133,Staff,33,0,50,17
1745146384652,EDS 124AR,B00,907471,Simon; Elizabeth A,42,0,50,8
1745146385678,EDS 124BR,A00,889134,Staff,57,0,100,43
1745146386707,EDS 125,A00,889135,Staff,26,0,30,4
1745146387735,EDS 126,A01,889138,Staff,37,0,40,3
1745146388761,EDS 164R,A01,889142,Wishard Guerra; Alison G.,38,0,50,12
1745146389790,ENG 30,A01,886396,Staff,0,0,0,0
1745146389790,ENG 30,B01,886398,Staff,0,0,0,0
1745146390817,ENVR 102,A00,906150,Montejo; Carolina,23,0,25,2
1745146391842,ETHN 103A,A00,887236,Man; Simeon S,0,5,0,0
1745146392871,ETHN 113,A00,887239,Staff,20,0,30,10
1745146393896,ETHN 116,A00,887240,Staff,20,0,25,5
1745146394921,ETHN 117,A00,887241,Choi; Esther Min,27,0,30,3
1745146395954,ETHN 118,A00,887243,Staff,24,0,30,6
1745146396981,ETHN 127,A00,887248,Cuong; Marisol,12,0,15,3
1745146398004,ETHN 139,A00,887250,Staff,8,0,10,2
1745146399033,ETHN 142,A00,887252,Staff,18,0,30,12
1745146400060,ETHN 161,A00,887253,Browne; Errol Tsekani,28,0,30,2
1745146401084,ETHN 163FR,A00,887255,Burelle; Julie Sara Veronique,4,0,5,1
1745146402111,GLBH 20,A00,889149,Elwardani; Nile Regina,15,0,42,27
1745146404163,GLBH 111,A01,889152,Burgos; Jose L.,17,0,17,0
1745146405196,GLBH 150,A00,889181,Sloane; Julia Kathryn,0,1,15,15
1745146407253,HDS 60,A01,886406,Warstadt; Melissa Fawn,76,0,80,4
1745146408279,HIAF 111,A00,889324,Gyamfi; Bright,0,4,0,0
1745146409303,HIEA 131,A00,889328,Staff,14,0,32,18
1745146410334,HIEA 144,A00,889333,Henry; Todd A.,29,0,32,3
1745146411364,HIEA 154,A00,889336,Henry; Todd A.,28,0,32,4
1745146412395,HIEU 106,A00,889339,Staff,28,0,32,4
1745146414452,HIEU 114,A00,889340,Staff,18,0,32,14
1745146415478,HIEU 135GS,A00,889342,Patterson; Patrick H.,0,0,1,22
1745146416504,HIEU 137,A00,889343,Edington; Claire Ellen,12,0,25,13
1745146417529,HIEU 148,A00,889345,Staff,16,0,32,16
1745146418554,HIEU 154,A00,889346,Biess; Frank Peter,24,0,32,8
1745146419581,HILA 102,A00,889351,Staff,13,0,32,19
1745146420612,HILD 2A,A01,889221,Lewandoski; Julia Mavis,0,5,32,32
1745146421638,HILD 7B,A01,889225,Man; Simeon S,0,7,32,32
1745146422669,HILD 7C,A01,889288,Alvarez; Luis A,0,8,32,32
1745146423697,HILD 30,A01,889323,Staff,0,1,32,32
1745146425749,HISC 119,A00,889383,Golan; Tal,22,0,32,10
1745146426779,HIUS 103,A00,889384,Man; Simeon S,10,0,32,22
1745146427807,HIUS 117,A00,919797,Kwak; Nancy,23,0,32,9
1745146428832,HIUS 142A,A00,919788,Staff,24,0,32,8
1745146430888,HIUS 149,A00,889386,Gyamfi; Bright,0,1,0,0
1745146431917,HIUS 155,A00,889387,Alvarez; Luis A,19,0,32,13
1745146432946,HUM 3,A01,886499,Caldwell; Michael Alan,24,0,50,26
1745146433972,HUM 3GS,A00,886500,Rodriguez; Bretton Sigfred,0,0,0,26
1745146435000,HUM 3R,A01,886502,Markman; Kristina,0,32,50,50
1745146436029,HUM 4,A01,886504,Crum; Matthew Stephen,28,0,50,22
1745146436029,HUM 4,B01,886506,West; Geoffrey Scott,25,0,50,25
1745146437058,HUM 4GS,A00,886507,Staff,0,0,0,13
1745146438089,HUM 5,A01,886509,Staff,35,0,50,15
1745146439116,HUM 5R,A01,886511,Zavodny; Tatiana Sophia,0,32,50,50
1745146440141,JAPN 180,A00,886407,Staff,25,0,40,15
1745146441169,LATI 50,A01,886409,Martin-Cabrera; Luis,9,0,22,13
1745146441169,LATI 50,A02,886410,Martin-Cabrera; Luis,20,0,22,2
1745146441169,LATI 50,A03,886411,Martin-Cabrera; Luis,22,0,22,0
1745146441169,LATI 50,A04,886412,Martin-Cabrera; Luis,15,0,22,7
1745146442237,LAWS 101,A00,907664,Staff,36,0,60,24
1745146443267,LIAB 1A,A00,889388,Saab; Dima,19,0,20,1
1745146444292,LIAB 1AX,A00,889389,El Cheddadi; Youniss,19,0,20,1
1745146445318,LIFR 1C,A00,889391,Van Moer; Vinciane G,9,0,20,11
1745146446358,LIFR 1CX,A00,889392,Van Moer; Vinciane G,8,0,20,12
1745146447385,LIFR 1D,A00,889393,Van Moer; Vinciane G,11,0,20,9
1745146448411,LIFR 1DX,A00,889394,Van Moer; Vinciane G,11,0,20,9
1745146449436,LIGN 7,A00,886923,Staff,30,0,50,20
1745146450466,LIGN 17,A00,886924,Kehler; Andrew Scott,133,0,150,17
1745146451492,LTAM 110,A00,889395,Staff,17,0,30,13
1745146452517,LTCH 101,A00,889397,Staff,22,0,25,3
1745146453550,LTCS 130,A00,889398,Staff,23,0,25,2
1745146454579,LTEA 138,A00,889399,Staff,25,0,40,15
1745146455605,LTEN 149,A00,889400,Wesling; Megan E.,6,0,25,19
1745146456636,LTEN 169,A00,889401,Staff,24,0,25,1
1745146457663,LTEN 180,A00,889402,Staff,12,0,15,3
1745146458686,LTEN 181,A00,889403,Staff,23,0,25,2
1745146459715,LTWL 100,A00,889404,Myerston Santana; Jacobo,8,0,25,17
1745146460741,LTWL 180GS,A00,889405,Staff,6,0,20,14
1745146461768,LTWL 181,A00,889406,Staff,19,0,25,6
1745146462798,LTWL 184,A00,889475,Mukherjee; Silpa,21,0,25,4
1745146463823,LTWR 102C,A00,889486,Staff,29,0,30,1
1745146464849,LTWR 115W,A00,889491,Staff,3,0,15,12
1745146465881,MAE 8,A01,886905,Staff,0,2,0,0
1745146466911,MAE 11,A00,886906,Bandaru; Prabhakar,0,0,50,50
1745146467938,MAE 20,A00,886907,Evdokimenko; Ekaterina,50,0,70,20
1745146468966,MAE 30B,A00,886909,Ghazinejad; Maziar,28,0,45,17
1745146470000,MAE 101B,A00,886910,Saintillan; David,36,0,45,9
1745146471026,MAE 105,A00,886911,Bandaru; Prabhakar,26,0,50,24
1745146472052,MAE 107,A00,886912,Staff,22,0,60,38
1745146473083,MAE 143B,A00,886913,Bewley; Thomas R,14,0,40,26
1745146474113,MAE 148,A01,886915,Silberman; Jack,5,0,14,9
1745146475137,MAE 160,A00,886916,Evdokimenko; Ekaterina,41,0,60,19
1745146476162,MATH 3C,A01,889681,Staff,2,0,30,28
1745146477198,MATH 10A,A01,889760,Staff,28,0,30,2
1745146477198,MATH 10A,A02,889783,Staff,30,0,30,0
1745146478225,MATH 10B,A01,889785,Verstraete; Jacques Allan,0,2,30,30
1745146478225,MATH 10B,A02,889795,Verstraete; Jacques Allan,0,2,30,30
1745146478225,MATH 10B,B01,889797,Verstraete; Jacques Allan,0,0,30,30
1745146478225,MATH 10B,B02,889828,Verstraete; Jacques Allan,23,0,30,7
1745146479253,MATH 10C,A01,889849,Habib; Yousaf,18,0,30,12
1745146479253,MATH 10C,A02,889852,Habib; Yousaf,20,0,30,10
1745146479253,MATH 10C,A03,889853,Habib; Yousaf,24,0,30,6
1745146479253,MATH 10C,A04,889858,Habib; Yousaf,21,0,30,9
1745146479253,MATH 10C,B01,889861,Staff,12,0,30,18
1745146479253,MATH 10C,B02,889862,Staff,26,0,30,4
1745146479253,MATH 10C,B03,889863,Staff,28,0,30,2
1745146479253,MATH 10C,B04,889967,Staff,25,0,30,5
1745146480287,MATH 18,A01,889974,Staff,15,0,30,15
1745146480287,MATH 18,A02,889977,Staff,25,0,30,5
1745146480287,MATH 18,B01,889984,Hardiman; Liam,26,0,30,4
1745146480287,MATH 18,B02,889985,Hardiman; Liam,28,0,30,2
1745146481314,MATH 20A,A01,889990,Suk; Andrew Hoon,31,0,35,4
1745146482342,MATH 20B,A01,889993,Ohm; Ko Woon,21,0,30,9
1745146482342,MATH 20B,A02,889994,Ohm; Ko Woon,30,0,30,0
1745146482342,MATH 20B,B01,889996,Ohm; Ko Woon,25,0,30,5
1745146482342,MATH 20B,B02,889997,Ohm; Ko Woon,24,0,30,6
1745146483370,MATH 20C,A01,889999,Hammock; Frances H,22,0,30,8
1745146483370,MATH 20C,A02,890003,Hammock; Frances H,23,0,30,7
1745146483370,MATH 20C,B01,890006,Hammock; Frances H,11,0,30,19
1745146483370,MATH 20C,B02,890007,Hammock; Frances H,18,0,30,12
1745146484403,MATH 20D,A01,890011,Cheng; Hsiao-Bing,6,0,30,24
1745146484403,MATH 20D,A02,890012,Cheng; Hsiao-Bing,27,0,30,3
1745146484403,MATH 20D,B01,890016,Cheng; Hsiao-Bing,19,0,30,11
1745146484403,MATH 20D,B02,890017,Cheng; Hsiao-Bing,15,0,30,15
1745146485438,MATH 20E,A01,890026,Harel; Guershon,10,0,30,20
1745146485438,MATH 20E,A02,890029,Harel; Guershon,24,0,30,6
1745146485438,MATH 20E,B01,890033,Harel; Guershon,14,0,30,16
1745146485438,MATH 20E,B02,890101,Harel; Guershon,27,0,30,3
1745146486465,MATH 102,A01,890104,Staff,20,0,30,10
1745146486465,MATH 102,A02,890105,Staff,30,0,30,0
1745146487492,MATH 103B,A01,890116,Salehi Golsefidy; Alireza,8,0,30,22
1745146487492,MATH 103B,B01,890118,Staff,0,4,30,30
1745146488520,MATH 109,A01,890121,Aliabadi Sr.; Mohsen,6,0,30,24
1745146488520,MATH 109,B01,890124,Upadrashta; Pranav Kumar,23,0,30,7
1745146489556,MATH 120A,A01,890126,Eggers; John Dietrich,15,0,30,15
1745146490589,MATH 142B,A01,890128,Ioana; Adrian,17,0,30,13
1745146490589,MATH 142B,A02,890129,Ioana; Adrian,15,0,30,15
1745146491615,MATH 154,A01,890174,Staff,0,1,30,30
1745146491615,MATH 154,A02,890182,Staff,15,0,30,15
1745146492642,MATH 168A,A01,890197,Dumitriu; Ioana,22,0,35,13
1745146493667,MATH 170A,A01,890240,Nie; Jiawang,5,0,30,25
1745146493667,MATH 170A,A02,890241,Nie; Jiawang,18,0,30,12
1745146493667,MATH 170A,A03,890249,Nie; Jiawang,23,0,30,7
1745146494698,MATH 170B,A01,957891,Nag; Panchali,25,0,35,10
1745146496750,MATH 181A,A01,908025,Staff,0,8,35,35
1745146497781,MATH 193B,A01,890265,Staff,3,0,35,32
1745146498811,MGT 4,A01,890311,Anderson; John Charles,57,0,88,31
1745146499839,MGT 5,A00,907740,Staff,41,0,98,57
1745146500865,MGT 12,A00,890312,Lindenberger; Wade Douglas,70,0,98,28
1745146501889,MGT 16,A00,957883,Staff,84,0,98,14
1745146503944,MGT 45,A00,890314,Pecore; Joseph P.,57,0,98,41
1745146504971,MGT 71,A00,890315,Staff,6,0,98,92
1745146506000,MGT 100,A00,890316,Yavorsky; Daniel Ryan,58,0,98,40
1745146507026,MGT 103,A00,890317,Ehrich; Kristine R,77,0,98,21
1745146508053,MGT 105,A00,890356,Bates; Kenneth Walter,19,0,98,79
1745146509079,MGT 112,A00,890360,Ehrich; Kristine R,65,0,98,33
1745146510103,MGT 127R,A00,907732,Zhu; Kevin Xiaoguo,32,0,98,66
1745146511133,MGT 131B,A00,890361,Anderson; John Charles,75,0,98,23
1745146512160,MGT 137,A00,890362,Lindenberger; Wade Douglas,68,0,98,30
1745146513190,MGT 160,A00,890369,Johnson; Erik Barry,36,0,98,62
1745146515250,MGT 164,A00,890372,Zimmermann; Carsten,0,29,98,98
1745146516281,MGT 180,A00,890374,Bliss; Barbara Ann,31,0,98,67
1745146517309,MMW 15,A01,886414,Chang; Edmond Yi-Teh,0,10,28,28
1745146517309,MMW 15,A02,886415,Chang; Edmond Yi-Teh,0,10,28,28
1745146517309,MMW 15,A03,886416,Chang; Edmond Yi-Teh,0,8,28,28
1745146517309,MMW 15,A04,886417,Chang; Edmond Yi-Teh,0,8,28,28
1745146517309,MMW 15,B01,886419,Chang; Edmond Yi-Teh,0,8,28,28
1745146517309,MMW 15,B02,886420,Chang; Edmond Yi-Teh,0,9,28,28
1745146517309,MMW 15,B03,886421,Chang; Edmond Yi-Teh,0,9,28,28
1745146517309,MMW 15,B04,886422,Chang; Edmond Yi-Teh,0,9,28,28
1745146517309,MMW 15,C01,886424,Staff,0,10,28,28
1745146517309,MMW 15,C02,886425,Staff,0,10,28,28
1745146517309,MMW 15,C03,886426,Staff,0,9,28,28
1745146517309,MMW 15,C04,886427,Staff,0,9,28,28
1745146518339,MMW 15GS,A00,906910,Patterson; Patrick H.,5,0,28,23
1745146519365,MMW 122R,A01,886429,Rahimi; Babak,0,23,28,28
1745146519365,MMW 122R,A02,886430,Rahimi; Babak,0,23,28,28
1745146520393,MUS 1A,A01,890937,Staff,7,0,25,18
1745146520393,MUS 1A,A02,891035,Staff,15,0,25,10
1745146520393,MUS 1A,B00,907849,Staff,48,0,50,2
1745146520393,MUS 1A,B01,907850,Staff,25,0,25,0
1745146520393,MUS 1A,B02,907851,Staff,25,0,25,0
1745146522446,MUS 2AK,A00,957092,Ohnishi; Takae,15,0,15,0
1745146523473,MUS 4,A01,891044,Staff,6,0,25,19
1745146523473,MUS 4,A02,891045,Staff,24,0,25,1
1745146523473,MUS 4,B01,891048,Staff,20,0,25,5
1745146523473,MUS 4,B02,891050,Staff,25,0,25,0
1745146524500,MUS 5,A01,957506,Dubnov; Shlomo,4,0,25,21
1745146524500,MUS 5,A02,957622,Dubnov; Shlomo,21,0,25,4
1745146524500,MUS 5,A03,957623,Dubnov; Shlomo,23,0,25,2
1745146525533,MUS 6,A01,891053,Freitas Caetano; Marcelo,23,0,25,2
1745146525533,MUS 6,A02,891054,Freitas Caetano; Marcelo,23,0,25,2
1745146526557,MUS 7,A01,891081,Staff,0,0,25,25
1745146526557,MUS 7,A02,891082,Staff,14,0,25,11
1745146527589,MUS 8GS,A00,891118,Borgo; David Garcia,5,0,25,20
1745146528615,MUS 11,A01,891140,Staff,12,0,25,13
1745146528615,MUS 11,A02,891141,Staff,24,0,25,1
1745146529641,MUS 13,A01,891143,Staff,10,0,25,15
1745146529641,MUS 13,A02,891144,Staff,25,0,25,0
1745146530668,MUS 15,A01,891146,Staff,7,0,25,18
1745146530668,MUS 15,A02,891148,Staff,22,0,25,3
1745146530668,MUS 15,B01,891150,Staff,18,0,25,7
1745146530668,MUS 15,B02,891151,Staff,25,0,25,0
1745146531694,MUS 20,A01,891153,Staff,9,0,20,11
1745146531694,MUS 20,A02,891155,Staff,16,0,20,4
1745146532721,MUS 80,A00,891156,Staff,19,0,25,6
1745146532721,MUS 80,B00,891157,Staff,24,0,25,1
1745146533747,MUS 130,A00,891158,Ohnishi; Takae,35,0,35,0
1745146534773,MUS 150GS,A01,891160,Borgo; David Garcia,5,0,25,20
1745146535805,MUS 170,A01,891162,Freitas Caetano; Marcelo,21,0,25,4
1745146535805,MUS 170,A02,891164,Freitas Caetano; Marcelo,22,0,25,3
1745146536835,NANO 11,A00,886220,Vazquez Mena; Oscar,12,0,15,3
1745146537864,NANO 15,A01,886222,Drews; Aaron,9,0,10,1
1745146538895,NANO 104,A00,886224,Sirbuly; Donald,18,0,25,7
1745146539921,PH 40,A00,886528,Staff,29,0,40,11
1745146540952,PH 45,A01,886799,Staff,36,0,40,4
1745146541978,PH 110,A00,886802,Staff,7,0,40,33
1745146543005,PH 172,A00,906716,Staff,20,0,35,15
1745146544031,PH 191,A00,886803,Staff,23,0,40,17
1745146545061,PHIL 1,A00,889500,Staff,22,0,30,8
1745146546129,PHIL 10,A01,889549,Grush; Rick Scott,17,0,22,5
1745146546129,PHIL 10,A02,889551,Grush; Rick Scott,20,0,22,2
1745146547157,PHIL 28,A01,889559,Lamey; Andy M.,0,4,25,25
1745146547157,PHIL 28,A02,889561,Lamey; Andy M.,0,0,25,25
1745146547157,PHIL 28,A03,889572,Lamey; Andy M.,7,0,25,18
1745146548187,PHIL 35,A00,907839,Staff,32,0,33,1
1745146549213,PHIL 60,A00,889574,Staff,79,0,90,11
1745146550240,PHIL 105,A00,889579,Staff,0,1,0,0
1745146551266,PHIL 136,A00,889582,Fulkerson; Matthew Todd,27,0,45,18
1745146552293,PHIL 163,A01,889601,Staff,24,0,30,6
1745146552293,PHIL 163,B01,889606,Brandt; Reuven A,0,2,0,0
1745146553321,PHIL 164,A00,889610,Staff,20,0,30,10
1745146554347,PHIL 165,A00,889613,Staff,26,0,30,4
1745146555378,PHYS 1A,A00,886431,Staff,38,0,70,32
1745146556409,PHYS 1AL,001,886432,Tsai; Philbert S,0,0,30,30
1745146556409,PHYS 1AL,002,886436,Tsai; Philbert S,19,0,30,11
1745146557435,PHYS 1B,A00,886439,Staff,192,0,240,48
1745146558483,PHYS 1BL,001,886441,Tsai; Philbert S,0,1,30,30
1745146558483,PHYS 1BL,002,886444,Tsai; Philbert S,14,0,30,16
1745146559515,PHYS 1C,A00,896092,Arnold; Kam S,87,0,146,59
1745146560547,PHYS 1CL,001,886448,Tsai; Philbert S,0,4,30,30
1745146560547,PHYS 1CL,002,886449,Tsai; Philbert S,6,0,30,24
1745146560547,PHYS 1CL,003,886450,Tsai; Philbert S,22,0,30,8
1745146560547,PHYS 1CL,004,886451,Tsai; Philbert S,16,0,30,14
1745146561579,PHYS 2B,A01,886457,Staff,86,0,115,29
1745146562606,PHYS 2C,A01,886460,Shotwell; Brian,0,0,65,65
1745146563634,PHYS 2CL,A01,886467,Staff,0,3,28,28
1745146563634,PHYS 2CL,A02,886468,Staff,5,0,28,23
1745146564665,PHYS 2D,A01,886470,Staff,17,0,50,33
1745146565692,PHYS 4B,A01,886475,Grinstein; Benjamin,87,0,100,13
1745146566719,POLI 5,A00,891173,Desposato; Scott,17,0,25,8
1745146567750,POLI 5D,A01,891175,Staff,5,0,5,0
1745146567750,POLI 5D,B01,891178,Staff,5,0,5,0
1745146568777,POLI 11,A00,891179,Ferree; Karen E,3,0,25,22
1745146569804,POLI 12,A00,891180,Staff,21,0,30,9
1745146570834,POLI 27,A01,891182,Staff,29,0,75,46
1745146571859,POLI 30,A00,891183,Staff,0,3,30,30
1745146572890,POLI 100B,A00,891244,Staff,0,8,20,20
1745146573921,POLI 100I,A00,891247,Staff,19,0,30,11
1745146574947,POLI 104J,A00,891248,Nichter; Maysa,18,0,30,12
1745146575977,POLI 104U,A00,891250,Nichter; Maysa,9,0,30,21
1745146577002,POLI 108,A00,891253,Staff,0,0,0,4
1745146578031,POLI 110B,A00,891255,Wiens; David,22,0,25,3
1745146579057,POLI 112A,A00,891256,Wiens; David,15,0,25,10
1745146580082,POLI 114BR,A00,891261,Staff,22,0,30,8
1745146581109,POLI 117R,A00,891262,Forman; Fonna,12,0,50,38
1745146582137,POLI 118,A00,891264,Ingham; Sean,22,0,25,3
1745146583165,POLI 124A,A00,891265,Staff,19,0,20,1
1745146584195,POLI 125D,A00,891266,Nichter; Simeon C,9,0,25,16
1745146585220,POLI 126,A00,891268,Nichter; Simeon C,11,0,25,14
1745146586250,POLI 126AA,A00,891272,Staff,19,0,25,6
1745146587279,POLI 130AA,A00,891273,Staff,17,0,20,3
1745146588306,POLI 134AA,A00,891274,Staff,12,0,20,8
1745146590356,POLI 138,A00,891278,Staff,22,0,25,3
1745146591387,POLI 142K,A00,891280,Staff,17,0,25,8
1745146592414,POLI 142M,A00,891281,Gartzke; Erik,22,0,30,8
1745146593442,POLI 142P,A00,891284,Staff,21,0,30,9
1745146594466,POLI 143,A00,891285,Gartzke; Erik,17,0,30,13
1745146595492,POLI 153,A00,891286,Staff,20,0,20,0
1745146596521,POLI 170A,A00,891288,Staff,19,0,25,6
1745146597547,POLI 175,A00,891290,Staff,18,0,20,2
1745146598574,PSYC 1,A00,890674,Steiner; Eric Tomas,0,4,45,45
1745146599603,PSYC 2,A00,890676,Albright; Thomas D,25,0,35,10
1745146600630,PSYC 3,A00,890679,Staff,18,0,20,2
1745146601657,PSYC 60,A01,890684,Rickard; Timothy C.,7,0,45,38
1745146602683,PSYC 70,A01,890689,Geller; Emma Harlan,14,0,30,16
1745146603709,PSYC 100,A00,890690,Lacefield; Katharine I,0,43,180,180
1745146604738,PSYC 102,A00,890695,Staff,25,0,40,15
1745146605764,PSYC 105,A00,890699,Geller; Emma Harlan,78,0,100,22
1745146606789,PSYC 106,A00,890701,Gorman; Michael R.,15,0,30,15
1745146607821,PSYC 108,A00,890704,Adrian; Julia Anna,0,23,50,50
1745146608851,PSYC 118,A01,890712,Staff,18,0,30,12
1745146609877,PSYC 124,A00,890716,Chapman; Eddie Nathaniel,36,0,60,24
1745146610908,PSYC 131,A00,890717,Anagnostaras; Stephan,6,0,80,74
1745146611933,PSYC 137,A00,890719,Winkielman; Piotr,0,2,30,30
1745146612959,PSYC 144,A00,890721,Adrian; Julia Anna,0,3,45,45
1745146613986,PSYC 162,A00,890805,Staff,21,0,75,54
1745146615017,PSYC 169,A00,890810,Staff,0,15,30,30
1745146616042,PSYC 172,A00,890814,Gorman; Michael R.,14,0,30,16
1745146617069,PSYC 181,A00,890818,Anagnostaras; Stephan,63,0,200,137
1745146618098,PSYC 189,A00,890823,Staff,11,0,30,19
1745146619130,PSYC 191,A00,890884,Rickard; Timothy C.,0,11,35,35
1745146620156,PSYC 193,A00,890913,Staff,22,0,30,8
1745146620156,PSYC 193,B00,890914,Chapman; Eddie Nathaniel,25,0,30,5
1745146621184,PSYC 193L,A01,890918,Lowe; Angela Beth,29,0,30,1
1745146621184,PSYC 193L,B01,890921,Hurwitz; Ethan Scott,28,0,30,2
1745146621184,PSYC 193L,C01,890928,Staff,30,0,30,0
1745146622216,RELI 149,A00,886806,Rahimi; Babak,23,0,40,17
1745146623247,SE 9,A01,886814,Staff,13,0,20,7
1745146624280,SE 101B,A01,886816,Chadha; Mayank,8,0,30,22
1745146625308,SE 110B,A00,886818,Zhu; Qiang,0,16,45,45
1745146626334,SE 125,A01,886830,Staff,10,0,30,20
1745146627363,SE 130B,A01,886835,Staff,19,0,40,21
1745146628389,SE 131A,A01,886838,Krysl; Petr,37,0,55,18
1745146629415,SE 154,A00,886840,Staff,35,0,50,15
1745146630441,SE 164GS,A01,886849,Staff,13,0,20,7
1745146631467,SE 167GS,A01,886853,Staff,13,0,20,7
1745146632492,SIO 25,A01,890107,Staff,23,0,30,7
1745146633578,SIO 45,A00,890109,Cook; Geoffrey W,137,0,200,63
1745146634605,SIO 109R,A00,890110,Forman; Fonna,0,11,20,20
1745146635631,SIO 187,A01,890114,Kacev; David,21,0,40,19
1745146636658,SOCI 1,A01,890431,Thorpe; Charles Robert,21,0,30,9
1745146636658,SOCI 1,A02,890518,Thorpe; Charles Robert,30,0,30,0
1745146637684,SOCI 2,A01,957978,Staff,0,0,0,0
1745146637684,SOCI 2,A02,957979,Staff,0,3,0,0
1745146638714,SOCI 20,A01,890523,Calderon-Zaks; Michael Aar,24,0,30,6
1745146638714,SOCI 20,A02,890526,Calderon-Zaks; Michael Aar,29,0,30,1
1745146639742,SOCI 30,A01,890533,Pardo Guerra; Juan Pablo,37,0,40,3
1745146640769,SOCI 40,A01,890535,Staff,32,0,45,13
1745146641795,SOCI 104Q,A00,890559,Staff,20,0,30,10
1745146642826,SOCI 106,A00,890560,Arnal; Maud Marie Leonie,22,0,30,8
1745146643851,SOCI 110,A00,890567,Holkenbrink-Monk; Charlene,22,0,30,8
1745146644878,SOCI 112,A00,890568,Victoria Torres; Pablo,0,0,45,45
1745146645907,SOCI 115,A00,890597,Arnal; Maud Marie Leonie,33,0,45,12
1745146647961,SOCI 121,A00,890604,Pardo Guerra; Juan Pablo,40,0,45,5
1745146648985,SOCI 126,A01,890608,Staff,8,0,10,2
1745146650010,SOCI 127,A00,890609,Staff,23,0,30,7
1745146651041,SOCI 131,A00,890610,Thorpe; Charles Robert,38,0,45,7
1745146652066,SOCI 135,A00,890615,Payne; Christine Anna,19,0,45,26
1745146653091,SOCI 139,A00,890620,Staff,43,0,45,2
1745146654121,SOCI 148E,A00,890622,Calderon-Zaks; Michael Aar,39,0,45,6
1745146655146,SOCI 150,A00,890623,Kohler; Kristopher M.,36,0,45,9
1745146656171,SOCI 157,A00,890625,Jules-Rosette; Bennetta W.,18,0,20,2
1745146657201,SOCI 160,A00,890627,Payne; Christine Anna,26,0,45,19
1745146658235,SYN 1,A00,886855,Fish; Gwendolyn Anne,0,0,0,0
1745146658235,SYN 1,B00,906086,Fish; Gwendolyn Anne,0,0,0,2
1745146659262,SYN 2R,A00,886860,Staff,0,15,15,15
1745146659262,SYN 2R,B00,906106,Atkinson; Arthur Laird,0,14,15,15
1745146660301,SYN 100,A01,886866,Browne; Emily,0,29,20,20
1745146660301,SYN 100,B01,906128,Rock; Martin,0,4,20,20
1745146660301,SYN 100,C01,906140,Deavenport; James Cary,0,2,20,20
1745146660301,SYN 100,D01,907816,Deavenport; James Cary,0,3,20,20
1745146661327,TDAC 1,A00,890286,Walsh; Kim C.,11,0,20,9
1745146662359,TDAC 101,A00,890296,Basso; Beatrice,18,0,20,2
1745146663389,TDDE 131,A00,890297,Staff,47,0,50,3
1745146664420,TDDM 1,A00,890287,Weinberg; Sadie,26,0,30,4
1745146665446,TDGE 11,A00,890288,Fulton; Julia,155,0,200,45
1745146665446,TDGE 11,B00,890289,Castro; Robert Jess,188,0,200,12
1745146666473,TDGE 25,B00,957359,Walsh; Kim C.,9,0,20,11
1745146667499,TDGE 40,A01,890292,Power; Jade Yukana,28,0,30,2
1745146668531,TDGE 124,A00,890298,Havis; Allan,12,0,50,38
1745146669604,TDGE 131R,A00,890299,Burelle; Julie Sara Veronique,20,0,42,22
1745146670633,TDHT 101,A00,890300,Staff,12,0,20,8
1745146671660,TDHT 109,A01,890302,Anderson; Mysia Anyse,31,0,40,9
1745146672689,TDMV 1,A00,890293,Arcidiacono; Kristin,20,0,30,10
1745146673738,TDMV 2,A00,890294,Weinberg; Sadie,26,0,30,4
1745146674763,TDMV 3,A00,957878,Arcidiacono; Kristin,27,0,30,3
1745146676821,TDMV 138,A00,890304,Jun; Grace Shin Hae,25,0,40,15
1745146677847,TDMV 140,A00,890305,Corrales; Joseph Bernales,28,0,30,2
1745146678873,TDMV 142,A00,890307,Caligagan; Tony,30,0,40,10
1745146679901,TDMV 144,A00,890308,Camaya; Michelle Ann,26,0,30,4
1745146680930,TDPW 1,A00,890295,Stein; Deborah Isobel,5,0,20,15
1745146681957,USP 2,A01,890272,Lerner; Amy M,8,0,20,12
1745146682981,USP 3,A01,890274,Staff,21,0,30,9
1745146684007,USP 15,A01,890276,Sun; Feiyang,21,0,30,9
1745146685033,USP 25,A00,890277,Shenkman; Michael Thomas,21,0,25,4
1745146686061,USP 138,A00,890278,Staff,15,0,25,10
1745146687085,USP 143,A00,890279,Staff,30,0,70,40
1745146688112,USP 144,A00,890280,Chowdhury; Muhammed Zohir,19,0,30,11
1745146689138,USP 150,A00,890281,Boomhower; Matthew Charles,19,0,30,11
1745146690168,USP 151,A00,890282,Staff,17,0,20,3
1745146691200,USP 162,A00,890283,Andrews; Abigail Leslie,17,0,20,3
1745146692227,USP 168,A00,920477,Kwak; Nancy,2,0,5,3
1745146693252,USP 181,A00,890284,Staff,11,0,20,9
1745146694280,USP 191A,A00,890285,Staff,15,0,20,5
1745146695306,VIS 101,A00,886512,Staff,37,0,75,38
1745146696333,VIS 103,A00,886513,Cruz; Edwin Teddy,65,0,75,10
1745146697357,VIS 108,A00,886514,Staff,7,0,15,8
1745146698384,VIS 127P,A00,886515,Shen; Kuiyi,92,0,146,54
1745146699409,VIS 149,A00,886516,Yoldas; Pinar,1,0,15,14
1745146700435,VIS 164,A00,886526,Erdmann; Dean,21,0,22,1
1745146701459,VIS 194S,A00,886527,Staff,61,0,75,14
1745146702489,WCWP 10A,C00,886484,Staff,13,0,15,2
1745146703513,WCWP 10B,A00,886490,Staff,5,0,15,10
1745146703513,WCWP 10B,B00,886491,Staff,0,1,0,0
1745146703513,WCWP 10B,C00,886492,Staff,10,0,15,5
1745146704543,WCWP 100,A00,886494,Staff,0,3,15,15
1745146706688,AAS 10,A01,886199,Childs; Dennis R.,0,2,0,0
1745146707715,ANAR 104,A01,886940,Shtienberg; Gilad,27,0,30,3
1745146708742,ANAR 120,A00,886953,Staff,13,0,20,7
1745146709767,ANBI 148,A01,886955,Wilder; Linnea Lorene,32,0,40,8
1745146711814,ANSC 122,A00,886957,Staff,28,0,30,2
1745146712839,ANSC 150,A00,886958,Sloane; Julia Kathryn,6,0,15,9
1745146713870,ANSC 156,A00,886959,Jenkins; Janis A.,2,0,15,13
1745146714895,ANSC 180,A00,886960,Staff,12,0,17,5
1745146715924,ANSC 188,A00,886961,Jassal; Aftab,10,0,25,15
1745146716949,ANSC 190,A00,886962,Jassal; Aftab,14,0,25,11
1745146717979,ANSC 191,A00,886963,Staff,18,0,20,2
1745146719005,ANTH 3,A01,891689,Staff,19,0,20,1
1745146720030,ANTH 5,A00,886933,Semendeferi; Ekaterini,18,0,20,2
1745146721056,ANTH 10,A00,886934,Staff,0,8,30,30
1745146722081,ANTH 21,A01,886936,Staff,44,0,60,16
1745146723128,ANTH 23,A01,886938,Staff,94,0,100,6
1745146724157,ANTH 105,A00,886964,Stewart; Alexander B,94,0,100,6
1745146725184,ANTH 108,A00,886965,Pedersen; David,10,0,20,10
1745146726222,AWP 10,001,886147,Staff,0,0,0,0
1745146726222,AWP 10,002,886148,Staff,0,0,0,0
1745146726222,AWP 10,003,886149,Staff,0,0,0,0
1745146726222,AWP 10,004,886150,Staff,0,0,0,0
1745146726222,AWP 10,005,886151,Staff,0,0,0,0
1745146726222,AWP 10,006,886152,Staff,0,0,0,0
1745146726222,AWP 10,007,886153,Staff,0,0,0,0
1745146726222,AWP 10,008,886154,Staff,0,0,0,0
1745146726222,AWP 10,009,886155,Staff,0,0,0,0
1745146726222,AWP 10,010,886156,Staff,0,0,0,0
1745146726222,AWP 10,011,886158,Staff,0,0,0,0
1745146726222,AWP 10,012,886160,Staff,0,0,0,0
1745146726222,AWP 10,013,886161,Staff,0,0,0,0
1745146726222,AWP 10,014,886162,Staff,0,0,0,0
1745146726222,AWP 10,015,886163,Staff,0,0,0,0
1745146726222,AWP 10,016,886164,Staff,0,0,0,0
1745146726222,AWP 10,017,886165,Staff,0,0,0,0
1745146726222,AWP 10,018,886166,Staff,0,0,0,0
1745146726222,AWP 10,019,886168,Staff,0,0,0,0
1745146726222,AWP 10,020,886170,Staff,0,0,0,0
1745146726222,AWP 10,021,886172,Staff,0,0,0,0
1745146727256,AWP 10R,001,886173,Staff,0,0,0,0
1745146727256,AWP 10R,002,886174,Staff,0,1,0,0
1745146727256,AWP 10R,003,886175,Staff,0,0,0,0
1745146727256,AWP 10R,004,886176,Staff,0,0,0,0
1745146727256,AWP 10R,005,886177,Staff,0,0,0,0
1745146727256,AWP 10R,006,886178,Staff,0,0,0,0
1745146727256,AWP 10R,007,886179,Staff,0,0,0,0
1745146727256,AWP 10R,008,886181,Staff,0,0,0,0
1745146727256,AWP 10R,009,886182,Staff,0,0,0,0
1745146727256,AWP 10R,010,886183,Staff,0,0,0,0
1745146727256,AWP 10R,011,886184,Staff,0,0,0,0
1745146727256,AWP 10R,012,886185,Staff,0,0,0,0
1745146727256,AWP 10R,013,886186,Staff,0,0,0,0
1745146727256,AWP 10R,014,886187,Staff,0,0,0,0
1745146727256,AWP 10R,015,886188,Staff,0,0,0,0
1745146727256,AWP 10R,016,886189,Staff,0,0,0,0
1745146728280,AWP 102R,A00,886190,Staff,0,0,0,0
1745146728280,AWP 102R,B00,886191,Staff,0,0,0,0
1745146729306,BENG 100,A01,886193,Staff,19,0,30,11
1745146730332,BENG 122A,A01,886195,Hasty; Jeff M,20,0,30,10
1745146731362,BENG 166A,A00,886196,Sah; Robert Lie-Yuan,0,3,20,20
1745146732395,BIBC 102,A01,894320,Staff,0,2,46,46
1745146732395,BIBC 102,A02,894321,Staff,0,0,46,46
1745146732395,BIBC 102,A03,894344,Staff,21,0,46,25
1745146732395,BIBC 102,A04,894345,Staff,30,0,47,17
1745146733422,BICD 100R,A01,894365,Smith; Laurie,1,3,58,57
1745146733422,BICD 100R,A02,894366,Smith; Laurie,0,1,58,58
1745146733422,BICD 100R,A03,894367,Smith; Laurie,13,0,59,46
1745146734457,BICD 136,A01,894383,Gustafson-Brown; Cindy,16,0,50,34
1745146735490,BIEB 102,A01,894494,Butler; Shannon Rhey,67,0,130,63
1745146737558,BIEB 150,A01,894617,Wills; Christopher,0,3,13,13
1745146737558,BIEB 150,A02,894631,Wills; Christopher,0,3,13,13
1745146737558,BIEB 150,A03,894937,Wills; Christopher,0,3,13,13
1745146737558,BIEB 150,A04,894946,Wills; Christopher,0,1,11,11
1745146738584,BIEB 194,A00,906141,Kurle; Carolyn M.,14,0,20,6
1745146739611,BILD 1,A01,894154,Staff,8,0,19,11
1745146739611,BILD 1,A02,894155,Staff,15,0,19,4
1745146739611,BILD 1,A03,894160,Staff,18,0,19,1
1745146739611,BILD 1,A04,894161,Staff,16,0,18,2
1745146740639,BILD 2,A01,894168,Staff,0,0,50,50
1745146740639,BILD 2,A02,894169,Staff,0,0,50,50
1745146740639,BILD 2,A03,894179,Staff,27,0,50,23
1745146740639,BILD 2,A04,894203,Staff,42,0,50,8
1745146741669,BILD 3,A01,894213,Staff,24,0,31,7
1745146741669,BILD 3,A02,894214,Staff,28,0,31,3
1745146741669,BILD 3,A03,894235,Staff,30,0,31,1
1745146741669,BILD 3,A04,894236,Staff,29,0,32,3
1745146742696,BILD 4,A01,894253,Reuther; Keefe,12,0,24,12
1745146742696,BILD 4,A02,894258,Reuther; Keefe,19,0,24,5
1745146743729,BILD 5,A01,894276,Reuther; Keefe,40,0,50,10
1745146743729,BILD 5,A02,894277,Reuther; Keefe,48,0,50,2
1745146743729,BILD 5,A03,894290,Reuther; Keefe,47,0,50,3
1745146743729,BILD 5,A04,894291,Reuther; Keefe,50,0,50,0
1745146744756,BILD 24,A01,894297,Pirino; Giorgia,45,0,60,15
1745146745785,BIMM 100,A01,895012,Staff,0,14,0,1
1745146745785,BIMM 100,A02,895013,Staff,0,6,0,2
1745146745785,BIMM 100,A03,895014,Staff,0,7,0,0
1745146745785,BIMM 100,A04,895015,Staff,0,4,0,0
1745146746815,BIMM 101,A01,895017,McDonnell; Lisa Marie,0,2,24,24
1745146746815,BIMM 101,A02,895018,McDonnell; Lisa Marie,0,1,24,24
1745146746815,BIMM 101,B01,895020,McDonnell; Lisa Marie,0,3,24,24
1745146746815,BIMM 101,B02,895021,McDonnell; Lisa Marie,0,2,24,24
1745146747842,BIMM 110,A01,895023,Staff,7,0,25,18
1745146747842,BIMM 110,A02,895024,Staff,11,0,25,14
1745146747842,BIMM 110,A03,895025,Staff,22,0,25,3
1745146747842,BIMM 110,A04,895031,Staff,21,0,25,4
1745146748877,BIMM 120,A01,895114,Gustafson-Brown; Cindy,8,0,28,20
1745146748877,BIMM 120,A02,895126,Gustafson-Brown; Cindy,19,0,27,8
1745146749910,BIPN 100,A01,895130,Yang; Mingyu,13,0,38,25
1745146749910,BIPN 100,A02,895131,Yang; Mingyu,33,0,38,5
1745146749910,BIPN 100,A03,895132,Yang; Mingyu,33,0,38,5
1745146749910,BIPN 100,A04,895133,Yang; Mingyu,30,0,36,6
1745146750939,BIPN 120,A01,895135,Cooke; James Edward,0,2,13,13
1745146750939,BIPN 120,A02,895136,Cooke; James Edward,0,1,13,13
1745146750939,BIPN 120,A03,895137,Cooke; James Edward,0,0,13,13
1745146750939,BIPN 120,A04,895156,Cooke; James Edward,3,0,11,8
1745146751964,BIPN 134,A01,895235,Cooke; James Edward,0,2,25,25
1745146751964,BIPN 134,A02,895237,Cooke; James Edward,0,0,25,25
1745146751964,BIPN 134,A03,895240,Cooke; James Edward,12,0,25,13
1745146751964,BIPN 134,A04,895270,Cooke; James Edward,24,0,25,1
1745146752994,BIPN 189,A00,892103,Staff,0,20,9,9
1745146755051,CAT 124,A01,922009,Staff,0,1,20,20
1745146756096,CAT 125R,A00,886390,Morales; Celeste Georgianna,4,0,20,16
1745146756096,CAT 125R,B00,886391,Irwin; Matthew Joseph,0,1,20,20
1745146756096,CAT 125R,C00,886392,Smith; Lauryn Alissa,11,0,20,9
1745146756096,CAT 125R,D00,886393,Vanderschuit; Maya Alysia,6,0,20,14
1745146756096,CAT 125R,E00,886394,Marchisotto; Jennifer Anne,0,2,20,20
1745146757123,CENG 15,A01,886218,Drews; Aaron,1,0,5,4
1745146758147,CENG 113,A00,886219,Opatkiewicz; Justin Paul,16,0,25,9
1745146759177,CGS 101,A00,887044,Staff,13,0,20,7
1745146760201,CGS 105,A01,887046,Staff,16,0,25,9
1745146761226,CGS 112,A00,887047,Cuong; Marisol,12,0,15,3
1745146762254,CGS 113,A00,887048,Staff,24,0,30,6
1745146763280,CGS 120,A00,887049,Staff,12,0,17,5
1745146764307,CHEM 6A,A01,886336,Lam; Tin Yiu,44,0,50,6
1745146764307,CHEM 6A,A02,886338,Lam; Tin Yiu,43,0,50,7
1745146765339,CHEM 6B,A01,886341,Hopkins; Patrycja Anna,21,0,50,29
1745146765339,CHEM 6B,A02,886343,Hopkins; Patrycja Anna,46,0,50,4
1745146766364,CHEM 6C,A01,886346,Albizati; Kim F.,0,1,50,50
1745146766364,CHEM 6C,A02,886348,Albizati; Kim F.,38,0,50,12
1745146767390,CHEM 40A,A01,886352,Klosterman; Jeremy K,70,0,100,30
1745146768415,CHEM 40B,A01,886356,Klosterman; Jeremy K,0,4,100,100
1745146769448,CHEM 41B,A01,886360,Theodorakis; Emmanuel,30,0,50,20
1745146769448,CHEM 41B,A02,886362,Theodorakis; Emmanuel,46,0,50,4
1745146770475,CHIN 165A,A00,886382,Xu; Li,19,0,20,1
1745146771529,CLAS 120,A00,886387,Myerston Santana; Jacobo,36,0,40,4
1745146772561,COGS 9,A01,886967,Shannon; Kyle Michael,49,0,60,11
1745146773585,COGS 11,A01,886969,Staff,18,0,30,12
1745146774632,COGS 14A,A01,886971,Staff,26,0,60,34
1745146775758,COGS 14B,A01,886973,Hoffman; Drew Ellen,18,0,60,42
1745146776788,COGS 18,A01,886975,Morgan; Eric,41,0,60,19
1745146777816,COGS 20,A01,886977,Staff,6,0,8,2
1745146777816,COGS 20,A02,886978,Staff,6,0,7,1
1745146778840,COGS 100,A01,907783,Staff,6,0,30,24
1745146779865,COGS 101B,A01,886980,Staff,0,10,30,30
1745146780891,COGS 101C,A01,886982,Delgado; Tania,0,6,30,30
1745146781916,COGS 102A,A01,886984,Johnson; Christine M.,13,0,30,17
1745146782952,COGS 118B,A01,886986,Staff,0,25,60,60
1745146783978,COGS 150,A01,886988,Bergen; Benjamin,16,0,30,14
1745146785007,COGS 153,A00,886989,Delgado; Tania,0,6,30,30
1745146786032,COGS 186,A01,886991,Staff,3,0,30,27
1745146787062,COGS 187A,A01,886993,Boyle; Mary E. T.,12,0,30,18
1745146788085,COGS 189,A00,886994,Staff,13,0,30,17
1745146789113,COMM 10,A01,886996,Staff,11,0,25,14
1745146789113,COMM 10,A02,886997,Staff,21,0,25,4
1745146790138,COMM 20,A01,886999,Leuning; Grant Maurstad,33,0,40,7
1745146792187,COMM 100A,A01,887002,Staff,0,0,25,25
1745146792187,COMM 100A,A02,887003,Staff,20,0,25,5
1745146793213,COMM 100B,A01,887005,Staff,0,1,25,25
1745146794239,COMM 106D,A00,887006,Staff,22,0,40,18
1745146795263,COMM 110G,A00,887007,Whitworth-Smith; Andrew C,17,0,40,23
1745146796287,COMM 111B,A00,887008,Staff,31,0,40,9
1745146797313,COMM 113T,A00,887009,Abuelhiga; Soraya Jill,30,0,40,10
1745146797313,COMM 113T,B00,906733,Staff,40,0,40,0
1745146798341,COMM 145,A00,887010,Staff,21,0,40,19
1745146799366,COMM 146,A00,887054,Staff,31,0,40,9
1745146800416,COMM 190,A00,887012,Staff,9,0,23,14
1745146801452,CSE 8A,A50,887015,Cao; Yingjun,68,0,85,17
1745146802478,CSE 11,A01,887017,Cao; Yingjun,35,0,70,35
1745146803504,CSE 20,A01,887019,Staff,35,0,50,15
1745146804532,CSE 21,A01,887021,Braun; Oliver,81,0,100,19
1745146804532,CSE 21,B01,892583,Staff,48,0,50,2
1745146805558,CSE 30,A01,887025,Eldon; John,161,0,200,39
1745146806585,CSE 100,A01,887027,Staff,28,0,50,22
1745146806585,CSE 100,A02,887028,Staff,43,0,50,7
1745146807615,CSE 101,A01,887030,Braun; Oliver,79,0,100,21
1745146807615,CSE 101,B01,887032,Jones; Miles E,0,1,50,50
1745146807615,CSE 101,B02,887033,Jones; Miles E,13,0,50,37
1745146808641,CSE 105,A01,908084,Jones; Miles E,36,0,50,14
1745146808641,CSE 105,A02,908087,Jones; Miles E,38,0,50,12
1745146809666,CSE 135,A01,887035,Powell; Thomas Allan,8,0,50,42
1745146810694,CSE 142,A01,887037,Staff,22,0,60,38
1745146811722,CSE 142L,A01,887039,Staff,42,0,60,18
1745146812755,CSE 151A,A01,887041,Solares; Edwin A,60,0,100,40
1745146813781,CSE 175,A01,887043,Kumar; Rakesh,30,0,30,0
1745146814810,CSS 1,A01,886389,Staff,12,0,40,28
1745146815836,DSC 30,A01,908097,Liao; Soohyun Nam,54,0,75,21
1745146816871,DSC 40A,A01,908099,Shannon; Kyle Michael,37,0,50,13
1745146817898,DSC 40B,A01,908112,Staff,28,0,50,22
1745146818926,DSC 80,A01,908116,Staff,32,0,60,28
1745146819956,DSC 197,001,956863,Eldridge; Justin Matthew,9999,0,9999,0
1745146820985,ECE 5,A01,886400,Morris; Karcher William,3,0,6,3
1745146820985,ECE 5,A02,886401,Morris; Karcher William,5,0,6,1
1745146822013,ECE 148,A01,886403,Silberman; Jack,0,8,14,14
1745146823046,ECON 1,A01,887265,Crane; Meredith Helen,25,0,70,45
1745146823046,ECON 1,B01,887268,Staff,44,0,50,6
1745146824074,ECON 2,A01,887273,Crane; Meredith Helen,61,0,70,9
1745146825102,ECON 3,A01,887279,Rondina; Giacomo,44,0,70,26
1745146826128,ECON 4,A01,887282,Anderson; John Charles,0,1,10,10
1745146827154,ECON 5,A01,887285,Staff,39,0,45,6
1745146827154,ECON 5,B01,887292,Staff,43,0,45,2
1745146828184,ECON 100A,A01,887337,Newhouse; Herbert S,58,0,70,12
1745146828184,ECON 100A,B01,887349,Staff,45,0,50,5
1745146829215,ECON 100B,A01,887361,Du; Songzi,42,0,70,28
1745146830243,ECON 100C,A01,887445,Newhouse; Herbert S,61,0,70,9
1745146831268,ECON 105,A00,887488,Vespa; Emanuel Ignacio,24,0,35,11
1745146832299,ECON 109,A01,887506,Staff,29,0,35,6
1745146833340,ECON 110A,A01,887568,Alon; Titan Michael,1,0,35,34
1745146833340,ECON 110A,B01,907601,Alon; Titan Michael,27,0,35,8
1745146834369,ECON 110B,A01,887598,Levkoff; Steven B.,0,7,70,70
1745146835395,ECON 112,A00,887599,Rondina; Giacomo,20,0,35,15
1745146836421,ECON 120A,A01,887603,Dai; Yinlin,46,0,70,24
1745146837456,ECON 120C,A01,887608,Sun; Yixiao,0,0,35,35
1745146837456,ECON 120C,B01,887614,Sun; Yixiao,13,0,35,22
1745146838483,ECON 138,A00,887621,Bharadwaj; Prashant,0,18,20,20
1745146839510,ECON 171,A01,907666,Staff,27,0,35,8
1745146840537,ECON 175,A00,887626,Wu; Pak Yeung,27,0,35,8
1745146841569,ECON 190,A00,887640,Vespa; Emanuel Ignacio,26,0,35,9
1745146842609,EDS 25,A01,888197,Staff,0,0,0,0
1745146842609,EDS 25,A02,888209,Staff,0,0,0,0
1745146842609,EDS 25,A03,888210,Staff,0,0,0,0
1745146842609,EDS 25,A04,888212,Staff,0,0,0,0
1745146842609,EDS 25,A05,888213,Staff,0,0,0,0
1745146842609,EDS 25,A06,888214,Staff,0,0,0,0
1745146842609,EDS 25,A07,888235,Staff,0,0,0,0
1745146842609,EDS 25,A08,888236,Staff,0,0,0,0
1745146842609,EDS 25,A09,888240,Staff,0,0,0,0
1745146842609,EDS 25,A10,888244,Staff,0,0,0,0
1745146842609,EDS 25,B01,888273,Staff,0,0,0,0
1745146842609,EDS 25,B02,888285,Staff,0,0,0,0
1745146842609,EDS 25,B03,888423,Staff,29,0,30,1
1745146842609,EDS 25,B04,888432,Staff,0,0,0,0
1745146842609,EDS 25,B05,888433,Staff,0,0,0,0
1745146842609,EDS 25,B06,888467,Staff,0,0,0,0
1745146842609,EDS 25,B07,888468,Staff,0,0,0,0
1745146842609,EDS 25,B08,888479,Staff,0,0,0,0
1745146842609,EDS 25,B09,888484,Staff,0,0,0,0
1745146842609,EDS 25,B10,888487,Staff,0,0,0,0
1745146843641,EDS 38,A01,907700,Choi; Bailey Miyeon,30,0,30,0
1745146844670,EDS 112,A01,888601,Chapman; Thandeka K,23,0,40,17
1745146845704,EDS 115,A00,888697,Mendez; Kathrina Mendoza,17,0,30,13
1745146846731,EDS 116,A01,888893,Staff,38,0,40,2
1745146848784,EDS 124AR,A00,889133,Staff,33,0,50,17
1745146848784,EDS 124AR,B00,907471,Simon; Elizabeth A,42,0,50,8
1745146849810,EDS 124BR,A00,889134,Staff,57,0,100,43
1745146850838,EDS 125,A00,889135,Staff,26,0,30,4
1745146851867,EDS 126,A01,889138,Staff,37,0,40,3
1745146852898,EDS 164R,A01,889142,Wishard Guerra; Alison G.,38,0,50,12
1745146853924,ENG 30,A01,886396,Staff,0,0,0,0
1745146853924,ENG 30,B01,886398,Staff,0,0,0,0
1745146854956,ENVR 102,A00,906150,Montejo; Carolina,23,0,25,2
1745146855991,ETHN 103A,A00,887236,Man; Simeon S,0,5,0,0
1745146857020,ETHN 113,A00,887239,Staff,20,0,30,10
1745146858046,ETHN 116,A00,887240,Staff,20,0,25,5
1745146859074,ETHN 117,A00,887241,Choi; Esther Min,27,0,30,3
1745146860099,ETHN 118,A00,887243,Staff,24,0,30,6
1745146861126,ETHN 127,A00,887248,Cuong; Marisol,12,0,15,3
1745146862151,ETHN 139,A00,887250,Staff,8,0,10,2
1745146863178,ETHN 142,A00,887252,Staff,18,0,30,12
1745146864205,ETHN 161,A00,887253,Browne; Errol Tsekani,28,0,30,2
1745146865235,ETHN 163FR,A00,887255,Burelle; Julie Sara Veronique,4,0,5,1
1745146866263,GLBH 20,A00,889149,Elwardani; Nile Regina,15,0,42,27
1745146868322,GLBH 111,A01,889152,Burgos; Jose L.,17,0,17,0
1745146869348,GLBH 150,A00,889181,Sloane; Julia Kathryn,0,1,15,15
1745146871399,HDS 60,A01,886406,Warstadt; Melissa Fawn,76,0,80,4
1745146872430,HIAF 111,A00,889324,Gyamfi; Bright,0,4,0,0
1745146873456,HIEA 131,A00,889328,Staff,14,0,32,18
1745146874486,HIEA 144,A00,889333,Henry; Todd A.,29,0,32,3
1745146875513,HIEA 154,A00,889336,Henry; Todd A.,28,0,32,4
1745146876542,HIEU 106,A00,889339,Staff,28,0,32,4
1745146878597,HIEU 114,A00,889340,Staff,18,0,32,14
1745146879623,HIEU 135GS,A00,889342,Patterson; Patrick H.,0,0,1,22
1745146880650,HIEU 137,A00,889343,Edington; Claire Ellen,12,0,25,13
1745146881679,HIEU 148,A00,889345,Staff,16,0,32,16
1745146882723,HIEU 154,A00,889346,Biess; Frank Peter,24,0,32,8
1745146883750,HILA 102,A00,889351,Staff,13,0,32,19
1745146884775,HILD 2A,A01,889221,Lewandoski; Julia Mavis,0,5,32,32
1745146885806,HILD 7B,A01,889225,Man; Simeon S,0,7,32,32
1745146886837,HILD 7C,A01,889288,Alvarez; Luis A,0,8,32,32
1745146887864,HILD 30,A01,889323,Staff,0,1,32,32
1745146889918,HISC 119,A00,889383,Golan; Tal,22,0,32,10
1745146890948,HIUS 103,A00,889384,Man; Simeon S,10,0,32,22
1745146891974,HIUS 117,A00,919797,Kwak; Nancy,23,0,32,9
1745146892999,HIUS 142A,A00,919788,Staff,24,0,32,8
1745146895052,HIUS 149,A00,889386,Gyamfi; Bright,0,1,0,0
1745146896081,HIUS 155,A00,889387,Alvarez; Luis A,19,0,32,13
1745146897112,HUM 3,A01,886499,Caldwell; Michael Alan,24,0,50,26
1745146898139,HUM 3GS,A00,886500,Rodriguez; Bretton Sigfred,0,0,0,26
1745146899165,HUM 3R,A01,886502,Markman; Kristina,0,32,50,50
1745146900198,HUM 4,A01,886504,Crum; Matthew Stephen,28,0,50,22
1745146900198,HUM 4,B01,886506,West; Geoffrey Scott,25,0,50,25
1745146901224,HUM 4GS,A00,886507,Staff,0,0,0,13
1745146902255,HUM 5,A01,886509,Staff,35,0,50,15
1745146903282,HUM 5R,A01,886511,Zavodny; Tatiana Sophia,0,32,50,50
1745146904308,JAPN 180,A00,886407,Staff,25,0,40,15
1745146905343,LATI 50,A01,886409,Martin-Cabrera; Luis,9,0,22,13
1745146905343,LATI 50,A02,886410,Martin-Cabrera; Luis,20,0,22,2
1745146905343,LATI 50,A03,886411,Martin-Cabrera; Luis,22,0,22,0
1745146905343,LATI 50,A04,886412,Martin-Cabrera; Luis,15,0,22,7
1745146906377,LAWS 101,A00,907664,Staff,36,0,60,24
1745146907407,LIAB 1A,A00,889388,Saab; Dima,19,0,20,1
1745146908438,LIAB 1AX,A00,889389,El Cheddadi; Youniss,19,0,20,1
1745146909465,LIFR 1C,A00,889391,Van Moer; Vinciane G,9,0,20,11
1745146910496,LIFR 1CX,A00,889392,Van Moer; Vinciane G,8,0,20,12
1745146911524,LIFR 1D,A00,889393,Van Moer; Vinciane G,11,0,20,9
1745146912551,LIFR 1DX,A00,889394,Van Moer; Vinciane G,11,0,20,9
1745146913577,LIGN 7,A00,886923,Staff,30,0,50,20
1745146914604,LIGN 17,A00,886924,Kehler; Andrew Scott,133,0,150,17
1745146915636,LTAM 110,A00,889395,Staff,17,0,30,13
1745146916660,LTCH 101,A00,889397,Staff,22,0,25,3
1745146917687,LTCS 130,A00,889398,Staff,23,0,25,2
1745146918711,LTEA 138,A00,889399,Staff,25,0,40,15
1745146919738,LTEN 149,A00,889400,Wesling; Megan E.,6,0,25,19
1745146920772,LTEN 169,A00,889401,Staff,24,0,25,1
1745146921799,LTEN 180,A00,889402,Staff,12,0,15,3
1745146922826,LTEN 181,A00,889403,Staff,23,0,25,2
1745146923850,LTWL 100,A00,889404,Myerston Santana; Jacobo,8,0,25,17
1745146924885,LTWL 180GS,A00,889405,Staff,6,0,20,14
1745146925909,LTWL 181,A00,889406,Staff,19,0,25,6
1745146926936,LTWL 184,A00,889475,Mukherjee; Silpa,21,0,25,4
1745146927966,LTWR 102C,A00,889486,Staff,29,0,30,1
1745146928998,LTWR 115W,A00,889491,Staff,3,0,15,12
1745146930026,MAE 8,A01,886905,Staff,0,2,0,0
1745146931054,MAE 11,A00,886906,Bandaru; Prabhakar,0,0,50,50
1745146932085,MAE 20,A00,886907,Evdokimenko; Ekaterina,50,0,70,20
1745146933114,MAE 30B,A00,886909,Ghazinejad; Maziar,28,0,45,17
1745146934140,MAE 101B,A00,886910,Saintillan; David,36,0,45,9
1745146935166,MAE 105,A00,886911,Bandaru; Prabhakar,26,0,50,24
1745146936192,MAE 107,A00,886912,Staff,22,0,60,38
1745146937217,MAE 143B,A00,886913,Bewley; Thomas R,14,0,40,26
1745146938259,MAE 148,A01,886915,Silberman; Jack,5,0,14,9
1745146939286,MAE 160,A00,886916,Evdokimenko; Ekaterina,41,0,60,19
1745146940312,MATH 3C,A01,889681,Staff,2,0,30,28
1745146941339,MATH 10A,A01,889760,Staff,28,0,30,2
1745146941339,MATH 10A,A02,889783,Staff,30,0,30,0
1745146942369,MATH 10B,A01,889785,Verstraete; Jacques Allan,0,2,30,30
1745146942369,MATH 10B,A02,889795,Verstraete; Jacques Allan,0,2,30,30
1745146942369,MATH 10B,B01,889797,Verstraete; Jacques Allan,0,0,30,30
1745146942369,MATH 10B,B02,889828,Verstraete; Jacques Allan,23,0,30,7
1745146943395,MATH 10C,A01,889849,Habib; Yousaf,18,0,30,12
1745146943395,MATH 10C,A02,889852,Habib; Yousaf,20,0,30,10
1745146943395,MATH 10C,A03,889853,Habib; Yousaf,24,0,30,6
1745146943395,MATH 10C,A04,889858,Habib; Yousaf,21,0,30,9
1745146943395,MATH 10C,B01,889861,Staff,12,0,30,18
1745146943395,MATH 10C,B02,889862,Staff,26,0,30,4
1745146943395,MATH 10C,B03,889863,Staff,28,0,30,2
1745146943395,MATH 10C,B04,889967,Staff,25,0,30,5
1745146944426,MATH 18,A01,889974,Staff,15,0,30,15
1745146944426,MATH 18,A02,889977,Staff,25,0,30,5
1745146944426,MATH 18,B01,889984,Hardiman; Liam,26,0,30,4
1745146944426,MATH 18,B02,889985,Hardiman; Liam,28,0,30,2
1745146945453,MATH 20A,A01,889990,Suk; Andrew Hoon,31,0,35,4
1745146946482,MATH 20B,A01,889993,Ohm; Ko Woon,21,0,30,9
1745146946482,MATH 20B,A02,889994,Ohm; Ko Woon,30,0,30,0
1745146946482,MATH 20B,B01,889996,Ohm; Ko Woon,25,0,30,5
1745146946482,MATH 20B,B02,889997,Ohm; Ko Woon,24,0,30,6
1745146947530,MATH 20C,A01,889999,Hammock; Frances H,22,0,30,8
1745146947530,MATH 20C,A02,890003,Hammock; Frances H,23,0,30,7
1745146947530,MATH 20C,B01,890006,Hammock; Frances H,11,0,30,19
1745146947530,MATH 20C,B02,890007,Hammock; Frances H,18,0,30,12
1745146948557,MATH 20D,A01,890011,Cheng; Hsiao-Bing,6,0,30,24
1745146948557,MATH 20D,A02,890012,Cheng; Hsiao-Bing,27,0,30,3
1745146948557,MATH 20D,B01,890016,Cheng; Hsiao-Bing,19,0,30,11
1745146948557,MATH 20D,B02,890017,Cheng; Hsiao-Bing,15,0,30,15
1745146949586,MATH 20E,A01,890026,Harel; Guershon,10,0,30,20
1745146949586,MATH 20E,A02,890029,Harel; Guershon,24,0,30,6
1745146949586,MATH 20E,B01,890033,Harel; Guershon,14,0,30,16
1745146949586,MATH 20E,B02,890101,Harel; Guershon,27,0,30,3
1745146950613,MATH 102,A01,890104,Staff,20,0,30,10
1745146950613,MATH 102,A02,890105,Staff,30,0,30,0
1745146951640,MATH 103B,A01,890116,Salehi Golsefidy; Alireza,8,0,30,22
1745146951640,MATH 103B,B01,890118,Staff,0,4,30,30
1745146952665,MATH 109,A01,890121,Aliabadi Sr.; Mohsen,6,0,30,24
1745146952665,MATH 109,B01,890124,Upadrashta; Pranav Kumar,23,0,30,7
1745146953692,MATH 120A,A01,890126,Eggers; John Dietrich,15,0,30,15
1745146954725,MATH 142B,A01,890128,Ioana; Adrian,17,0,30,13
1745146954725,MATH 142B,A02,890129,Ioana; Adrian,15,0,30,15
1745146955761,MATH 154,A01,890174,Staff,0,1,30,30
1745146955761,MATH 154,A02,890182,Staff,15,0,30,15
1745146956789,MATH 168A,A01,890197,Dumitriu; Ioana,22,0,35,13
1745146957818,MATH 170A,A01,890240,Nie; Jiawang,5,0,30,25
1745146957818,MATH 170A,A02,890241,Nie; Jiawang,18,0,30,12
1745146957818,MATH 170A,A03,890249,Nie; Jiawang,23,0,30,7
1745146958845,MATH 170B,A01,957891,Nag; Panchali,25,0,35,10
1745146960907,MATH 181A,A01,908025,Staff,0,8,35,35
1745146961931,MATH 193B,A01,890265,Staff,3,0,35,32
1745146962959,MGT 4,A01,890311,Anderson; John Charles,57,0,88,31
1745146963986,MGT 5,A00,907740,Staff,41,0,98,57
1745146965021,MGT 12,A00,890312,Lindenberger; Wade Douglas,70,0,98,28
1745146966046,MGT 16,A00,957883,Staff,84,0,98,14
1745146968101,MGT 45,A00,890314,Pecore; Joseph P.,57,0,98,41
1745146969127,MGT 71,A00,890315,Staff,6,0,98,92
1745146970153,MGT 100,A00,890316,Yavorsky; Daniel Ryan,58,0,98,40
1745146971179,MGT 103,A00,890317,Ehrich; Kristine R,77,0,98,21
1745146972205,MGT 105,A00,890356,Bates; Kenneth Walter,19,0,98,79
1745146973231,MGT 112,A00,890360,Ehrich; Kristine R,65,0,98,33
1745146974261,MGT 127R,A00,907732,Zhu; Kevin Xiaoguo,32,0,98,66
1745146975289,MGT 131B,A00,890361,Anderson; John Charles,75,0,98,23
1745146976316,MGT 137,A00,890362,Lindenberger; Wade Douglas,68,0,98,30
1745146977343,MGT 160,A00,890369,Johnson; Erik Barry,36,0,98,62
1745146979401,MGT 164,A00,890372,Zimmermann; Carsten,0,29,98,98
1745146980427,MGT 180,A00,890374,Bliss; Barbara Ann,31,0,98,67
1745146981455,MMW 15,A01,886414,Chang; Edmond Yi-Teh,0,10,28,28
1745146981455,MMW 15,A02,886415,Chang; Edmond Yi-Teh,0,10,28,28
1745146981455,MMW 15,A03,886416,Chang; Edmond Yi-Teh,0,8,28,28
1745146981455,MMW 15,A04,886417,Chang; Edmond Yi-Teh,0,8,28,28
1745146981455,MMW 15,B01,886419,Chang; Edmond Yi-Teh,0,8,28,28
1745146981455,MMW 15,B02,886420,Chang; Edmond Yi-Teh,0,9,28,28
1745146981455,MMW 15,B03,886421,Chang; Edmond Yi-Teh,0,9,28,28
1745146981455,MMW 15,B04,886422,Chang; Edmond Yi-Teh,0,9,28,28
1745146981455,MMW 15,C01,886424,Staff,0,10,28,28
1745146981455,MMW 15,C02,886425,Staff,0,10,28,28
1745146981455,MMW 15,C03,886426,Staff,0,9,28,28
1745146981455,MMW 15,C04,886427,Staff,0,9,28,28
1745146982483,MMW 15GS,A00,906910,Patterson; Patrick H.,5,0,28,23
1745146983549,MMW 122R,A01,886429,Rahimi; Babak,0,23,28,28
1745146983549,MMW 122R,A02,886430,Rahimi; Babak,0,23,28,28
1745146984582,MUS 1A,A01,890937,Staff,7,0,25,18
1745146984582,MUS 1A,A02,891035,Staff,15,0,25,10
1745146984582,MUS 1A,B00,907849,Staff,48,0,50,2
1745146984582,MUS 1A,B01,907850,Staff,25,0,25,0
1745146984582,MUS 1A,B02,907851,Staff,25,0,25,0
1745146986640,MUS 2AK,A00,957092,Ohnishi; Takae,15,0,15,0
1745146987666,MUS 4,A01,891044,Staff,6,0,25,19
1745146987666,MUS 4,A02,891045,Staff,24,0,25,1
1745146987666,MUS 4,B01,891048,Staff,20,0,25,5
1745146987666,MUS 4,B02,891050,Staff,25,0,25,0
1745146988699,MUS 5,A01,957506,Dubnov; Shlomo,4,0,25,21
1745146988699,MUS 5,A02,957622,Dubnov; Shlomo,21,0,25,4
1745146988699,MUS 5,A03,957623,Dubnov; Shlomo,23,0,25,2
1745146989725,MUS 6,A01,891053,Freitas Caetano; Marcelo,23,0,25,2
1745146989725,MUS 6,A02,891054,Freitas Caetano; Marcelo,23,0,25,2
1745146990756,MUS 7,A01,891081,Staff,0,0,25,25
1745146990756,MUS 7,A02,891082,Staff,14,0,25,11
1745146991791,MUS 8GS,A00,891118,Borgo; David Garcia,5,0,25,20
1745146992820,MUS 11,A01,891140,Staff,12,0,25,13
1745146992820,MUS 11,A02,891141,Staff,24,0,25,1
1745146993851,MUS 13,A01,891143,Staff,10,0,25,15
1745146993851,MUS 13,A02,891144,Staff,25,0,25,0
1745146994879,MUS 15,A01,891146,Staff,7,0,25,18
1745146994879,MUS 15,A02,891148,Staff,22,0,25,3
1745146994879,MUS 15,B01,891150,Staff,18,0,25,7
1745146994879,MUS 15,B02,891151,Staff,25,0,25,0
1745146995911,MUS 20,A01,891153,Staff,9,0,20,11
1745146995911,MUS 20,A02,891155,Staff,16,0,20,4
1745146996945,MUS 80,A00,891156,Staff,19,0,25,6
1745146996945,MUS 80,B00,891157,Staff,24,0,25,1
1745146997975,MUS 130,A00,891158,Ohnishi; Takae,35,0,35,0
1745146999006,MUS 150GS,A01,891160,Borgo; David Garcia,5,0,25,20
1745147000042,MUS 170,A01,891162,Freitas Caetano; Marcelo,21,0,25,4
1745147000042,MUS 170,A02,891164,Freitas Caetano; Marcelo,22,0,25,3
1745147001072,NANO 11,A00,886220,Vazquez Mena; Oscar,12,0,15,3
1745147002100,NANO 15,A01,886222,Drews; Aaron,9,0,10,1
1745147003133,NANO 104,A00,886224,Sirbuly; Donald,18,0,25,7
1745147004163,PH 40,A00,886528,Staff,29,0,40,11
1745147005194,PH 45,A01,886799,Staff,36,0,40,4
1745147006219,PH 110,A00,886802,Staff,7,0,40,33
1745147007248,PH 172,A00,906716,Staff,20,0,35,15
1745147008277,PH 191,A00,886803,Staff,23,0,40,17
1745147009304,PHIL 1,A00,889500,Staff,22,0,30,8
1745147010339,PHIL 10,A01,889549,Grush; Rick Scott,17,0,22,5
1745147010339,PHIL 10,A02,889551,Grush; Rick Scott,20,0,22,2
1745147011367,PHIL 28,A01,889559,Lamey; Andy M.,0,4,25,25
1745147011367,PHIL 28,A02,889561,Lamey; Andy M.,0,0,25,25
1745147011367,PHIL 28,A03,889572,Lamey; Andy M.,7,0,25,18
1745147012395,PHIL 35,A00,907839,Staff,32,0,33,1
1745147013425,PHIL 60,A00,889574,Staff,79,0,90,11
1745147014455,PHIL 105,A00,889579,Staff,0,1,0,0
1745147015488,PHIL 136,A00,889582,Fulkerson; Matthew Todd,27,0,45,18
1745147016516,PHIL 163,A01,889601,Staff,24,0,30,6
1745147016516,PHIL 163,B01,889606,Brandt; Reuven A,0,2,0,0
1745147017545,PHIL 164,A00,889610,Staff,20,0,30,10
1745147018570,PHIL 165,A00,889613,Staff,26,0,30,4
1745147019603,PHYS 1A,A00,886431,Staff,38,0,70,32
1745147020635,PHYS 1AL,001,886432,Tsai; Philbert S,0,0,30,30
1745147020635,PHYS 1AL,002,886436,Tsai; Philbert S,19,0,30,11
1745147021660,PHYS 1B,A00,886439,Staff,192,0,240,48
1745147022687,PHYS 1BL,001,886441,Tsai; Philbert S,0,1,30,30
1745147022687,PHYS 1BL,002,886444,Tsai; Philbert S,14,0,30,16
1745147023713,PHYS 1C,A00,896092,Arnold; Kam S,87,0,146,59
1745147024747,PHYS 1CL,001,886448,Tsai; Philbert S,0,4,30,30
1745147024747,PHYS 1CL,002,886449,Tsai; Philbert S,6,0,30,24
1745147024747,PHYS 1CL,003,886450,Tsai; Philbert S,22,0,30,8
1745147024747,PHYS 1CL,004,886451,Tsai; Philbert S,16,0,30,14
1745147025776,PHYS 2B,A01,886457,Staff,86,0,115,29
1745147026803,PHYS 2C,A01,886460,Shotwell; Brian,0,0,65,65
1745147027833,PHYS 2CL,A01,886467,Staff,0,3,28,28
1745147027833,PHYS 2CL,A02,886468,Staff,5,0,28,23
1745147028860,PHYS 2D,A01,886470,Staff,17,0,50,33
1745147029886,PHYS 4B,A01,886475,Grinstein; Benjamin,87,0,100,13
1745147030915,POLI 5,A00,891173,Desposato; Scott,17,0,25,8
1745147031946,POLI 5D,A01,891175,Staff,5,0,5,0
1745147031946,POLI 5D,B01,891178,Staff,5,0,5,0
1745147032972,POLI 11,A00,891179,Ferree; Karen E,3,0,25,22
1745147033998,POLI 12,A00,891180,Staff,21,0,30,9
1745147035025,POLI 27,A01,891182,Staff,29,0,75,46
1745147036054,POLI 30,A00,891183,Staff,0,3,30,30
1745147037085,POLI 100B,A00,891244,Staff,0,8,20,20
1745147038116,POLI 100I,A00,891247,Staff,19,0,30,11
1745147039147,POLI 104J,A00,891248,Nichter; Maysa,18,0,30,12
1745147040178,POLI 104U,A00,891250,Nichter; Maysa,9,0,30,21
1745147041205,POLI 108,A00,891253,Staff,0,0,0,4
1745147042242,POLI 110B,A00,891255,Wiens; David,22,0,25,3
1745147043268,POLI 112A,A00,891256,Wiens; David,15,0,25,10
1745147044295,POLI 114BR,A00,891261,Staff,22,0,30,8
1745147045320,POLI 117R,A00,891262,Forman; Fonna,12,0,50,38
1745147046348,POLI 118,A00,891264,Ingham; Sean,22,0,25,3
1745147047375,POLI 124A,A00,891265,Staff,19,0,20,1
1745147048403,POLI 125D,A00,891266,Nichter; Simeon C,9,0,25,16
1745147049432,POLI 126,A00,891268,Nichter; Simeon C,11,0,25,14
1745147050459,POLI 126AA,A00,891272,Staff,19,0,25,6
1745147051483,POLI 130AA,A00,891273,Staff,17,0,20,3
1745147052511,POLI 134AA,A00,891274,Staff,12,0,20,8
1745147054565,POLI 138,A00,891278,Staff,22,0,25,3
1745147056782,POLI 142K,A00,891280,Staff,17,0,25,8
1745147057813,POLI 142M,A00,891281,Gartzke; Erik,22,0,30,8
1745147058842,POLI 142P,A00,891284,Staff,21,0,30,9
1745147059875,POLI 143,A00,891285,Gartzke; Erik,17,0,30,13
1745147060909,POLI 153,A00,891286,Staff,20,0,20,0
1745147061947,POLI 170A,A00,891288,Staff,19,0,25,6
1745147062975,POLI 175,A00,891290,Staff,18,0,20,2
1745147064006,PSYC 1,A00,890674,Steiner; Eric Tomas,0,4,45,45
1745147065036,PSYC 2,A00,890676,Albright; Thomas D,25,0,35,10
1745147066062,PSYC 3,A00,890679,Staff,18,0,20,2
1745147067086,PSYC 60,A01,890684,Rickard; Timothy C.,7,0,45,38
1745147068111,PSYC 70,A01,890689,Geller; Emma Harlan,14,0,30,16
1745147069136,PSYC 100,A00,890690,Lacefield; Katharine I,0,43,180,180
1745147070165,PSYC 102,A00,890695,Staff,25,0,40,15
1745147071189,PSYC 105,A00,890699,Geller; Emma Harlan,78,0,100,22
1745147072214,PSYC 106,A00,890701,Gorman; Michael R.,15,0,30,15
1745147073246,PSYC 108,A00,890704,Adrian; Julia Anna,0,23,50,50
1745147074275,PSYC 118,A01,890712,Staff,18,0,30,12
1745147075302,PSYC 124,A00,890716,Chapman; Eddie Nathaniel,36,0,60,24
1745147076327,PSYC 131,A00,890717,Anagnostaras; Stephan,6,0,80,74
1745147077353,PSYC 137,A00,890719,Winkielman; Piotr,0,2,30,30
1745147078383,PSYC 144,A00,890721,Adrian; Julia Anna,0,3,45,45
1745147079410,PSYC 162,A00,890805,Staff,21,0,75,54
1745147080436,PSYC 169,A00,890810,Staff,0,15,30,30
1745147081461,PSYC 172,A00,890814,Gorman; Michael R.,14,0,30,16
1745147082486,PSYC 181,A00,890818,Anagnostaras; Stephan,63,0,200,137
1745147083510,PSYC 189,A00,890823,Staff,11,0,30,19
1745147084537,PSYC 191,A00,890884,Rickard; Timothy C.,0,11,35,35
1745147085564,PSYC 193,A00,890913,Staff,22,0,30,8
1745147085564,PSYC 193,B00,890914,Chapman; Eddie Nathaniel,25,0,30,5
1745147086594,PSYC 193L,A01,890918,Lowe; Angela Beth,29,0,30,1
1745147086594,PSYC 193L,B01,890921,Hurwitz; Ethan Scott,28,0,30,2
1745147086594,PSYC 193L,C01,890928,Staff,30,0,30,0
1745147087628,RELI 149,A00,886806,Rahimi; Babak,23,0,40,17
1745147088654,SE 9,A01,886814,Staff,13,0,20,7
1745147089686,SE 101B,A01,886816,Chadha; Mayank,8,0,30,22
1745147090712,SE 110B,A00,886818,Zhu; Qiang,0,16,45,45
1745147091738,SE 125,A01,886830,Staff,10,0,30,20
1745147092766,SE 130B,A01,886835,Staff,19,0,40,21
1745147093795,SE 131A,A01,886838,Krysl; Petr,37,0,55,18
1745147094820,SE 154,A00,886840,Staff,35,0,50,15
1745147095845,SE 164GS,A01,886849,Staff,13,0,20,7
1745147096870,SE 167GS,A01,886853,Staff,13,0,20,7
1745147097899,SIO 25,A01,890107,Staff,23,0,30,7
1745147098925,SIO 45,A00,890109,Cook; Geoffrey W,137,0,200,63
1745147099954,SIO 109R,A00,890110,Forman; Fonna,0,11,20,20
1745147100980,SIO 187,A01,890114,Kacev; David,21,0,40,19
1745147102011,SOCI 1,A01,890431,Thorpe; Charles Robert,21,0,30,9
1745147102011,SOCI 1,A02,890518,Thorpe; Charles Robert,30,0,30,0
1745147103037,SOCI 2,A01,957978,Staff,0,0,0,0
1745147103037,SOCI 2,A02,957979,Staff,0,3,0,0
1745147104063,SOCI 20,A01,890523,Calderon-Zaks; Michael Aar,24,0,30,6
1745147104063,SOCI 20,A02,890526,Calderon-Zaks; Michael Aar,29,0,30,1
1745147105095,SOCI 30,A01,890533,Pardo Guerra; Juan Pablo,37,0,40,3
1745147106121,SOCI 40,A01,890535,Staff,32,0,45,13
1745147107149,SOCI 104Q,A00,890559,Staff,20,0,30,10
1745147108175,SOCI 106,A00,890560,Arnal; Maud Marie Leonie,22,0,30,8
1745147109203,SOCI 110,A00,890567,Holkenbrink-Monk; Charlene,22,0,30,8
1745147110232,SOCI 112,A00,890568,Victoria Torres; Pablo,0,0,45,45
1745147111261,SOCI 115,A00,890597,Arnal; Maud Marie Leonie,33,0,45,12
1745147113319,SOCI 121,A00,890604,Pardo Guerra; Juan Pablo,40,0,45,5
1745147114349,SOCI 126,A01,890608,Staff,8,0,10,2
1745147115374,SOCI 127,A00,890609,Staff,23,0,30,7
1745147116409,SOCI 131,A00,890610,Thorpe; Charles Robert,38,0,45,7
1745147117436,SOCI 135,A00,890615,Payne; Christine Anna,19,0,45,26
1745147118462,SOCI 139,A00,890620,Staff,43,0,45,2
1745147119494,SOCI 148E,A00,890622,Calderon-Zaks; Michael Aar,39,0,45,6
1745147120521,SOCI 150,A00,890623,Kohler; Kristopher M.,36,0,45,9
1745147121551,SOCI 157,A00,890625,Jules-Rosette; Bennetta W.,18,0,20,2
1745147122577,SOCI 160,A00,890627,Payne; Christine Anna,26,0,45,19
1745147123611,SYN 1,A00,886855,Fish; Gwendolyn Anne,0,0,0,0
1745147123611,SYN 1,B00,906086,Fish; Gwendolyn Anne,0,0,0,2
1745147124637,SYN 2R,A00,886860,Staff,0,15,15,15
1745147124637,SYN 2R,B00,906106,Atkinson; Arthur Laird,0,14,15,15
1745147125668,SYN 100,A01,886866,Browne; Emily,0,29,20,20
1745147125668,SYN 100,B01,906128,Rock; Martin,0,4,20,20
1745147125668,SYN 100,C01,906140,Deavenport; James Cary,0,2,20,20
1745147125668,SYN 100,D01,907816,Deavenport; James Cary,0,3,20,20
1745147126694,TDAC 1,A00,890286,Walsh; Kim C.,11,0,20,9
1745147127725,TDAC 101,A00,890296,Basso; Beatrice,18,0,20,2
1745147128755,TDDE 131,A00,890297,Staff,47,0,50,3
1745147129781,TDDM 1,A00,890287,Weinberg; Sadie,26,0,30,4
1745147130810,TDGE 11,A00,890288,Fulton; Julia,155,0,200,45
1745147130810,TDGE 11,B00,890289,Castro; Robert Jess,188,0,200,12
1745147131839,TDGE 25,B00,957359,Walsh; Kim C.,9,0,20,11
1745147132866,TDGE 40,A01,890292,Power; Jade Yukana,28,0,30,2
1745147133895,TDGE 124,A00,890298,Havis; Allan,12,0,50,38
1745147134922,TDGE 131R,A00,890299,Burelle; Julie Sara Veronique,20,0,42,22
1745147135947,TDHT 101,A00,890300,Staff,12,0,20,8
1745147136975,TDHT 109,A01,890302,Anderson; Mysia Anyse,31,0,40,9
1745147138002,TDMV 1,A00,890293,Arcidiacono; Kristin,20,0,30,10
1745147139027,TDMV 2,A00,890294,Weinberg; Sadie,26,0,30,4
1745147140052,TDMV 3,A00,957878,Arcidiacono; Kristin,27,0,30,3
1745147142105,TDMV 138,A00,890304,Jun; Grace Shin Hae,25,0,40,15
1745147143136,TDMV 140,A00,890305,Corrales; Joseph Bernales,28,0,30,2
1745147144162,TDMV 142,A00,890307,Caligagan; Tony,30,0,40,10
1745147145191,TDMV 144,A00,890308,Camaya; Michelle Ann,26,0,30,4
1745147146222,TDPW 1,A00,890295,Stein; Deborah Isobel,5,0,20,15
1745147147254,USP 2,A01,890272,Lerner; Amy M,8,0,20,12
1745147148280,USP 3,A01,890274,Staff,21,0,30,9
1745147149314,USP 15,A01,890276,Sun; Feiyang,21,0,30,9
1745147150341,USP 25,A00,890277,Shenkman; Michael Thomas,21,0,25,4
1745147151369,USP 138,A00,890278,Staff,15,0,25,10
1745147152395,USP 143,A00,890279,Staff,30,0,70,40
1745147153422,USP 144,A00,890280,Chowdhury; Muhammed Zohir,19,0,30,11
1745147154450,USP 150,A00,890281,Boomhower; Matthew Charles,19,0,30,11
1745147155477,USP 151,A00,890282,Staff,17,0,20,3
1745147156508,USP 162,A00,890283,Andrews; Abigail Leslie,17,0,20,3
1745147157541,USP 168,A00,920477,Kwak; Nancy,2,0,5,3
1745147158566,USP 181,A00,890284,Staff,11,0,20,9
1745147159592,USP 191A,A00,890285,Staff,15,0,20,5
1745147160622,VIS 101,A00,886512,Staff,37,0,75,38
1745147161655,VIS 103,A00,886513,Cruz; Edwin Teddy,65,0,75,10
1745147162683,VIS 108,A00,886514,Staff,7,0,15,8
1745147163716,VIS 127P,A00,886515,Shen; Kuiyi,92,0,146,54
1745147164750,VIS 149,A00,886516,Yoldas; Pinar,1,0,15,14
1745147165783,VIS 164,A00,886526,Erdmann; Dean,21,0,22,1
1745147166807,VIS 194S,A00,886527,Staff,61,0,75,14
1745147167843,WCWP 10A,C00,886484,Staff,13,0,15,2
1745147168879,WCWP 10B,A00,886490,Staff,5,0,15,10
1745147168879,WCWP 10B,B00,886491,Staff,0,1,0,0
1745147168879,WCWP 10B,C00,886492,Staff,10,0,15,5
1745147169905,WCWP 100,A00,886494,Staff,0,3,15,15
1745147172065,AAS 10,A01,886199,Childs; Dennis R.,0,2,0,0
1745147173093,ANAR 104,A01,886940,Shtienberg; Gilad,27,0,30,3
1745147174117,ANAR 120,A00,886953,Staff,13,0,20,7
1745147175143,ANBI 148,A01,886955,Wilder; Linnea Lorene,32,0,40,8
1745147177195,ANSC 122,A00,886957,Staff,28,0,30,2
1745147178223,ANSC 150,A00,886958,Sloane; Julia Kathryn,6,0,15,9
1745147179249,ANSC 156,A00,886959,Jenkins; Janis A.,2,0,15,13
1745147180275,ANSC 180,A00,886960,Staff,12,0,17,5
1745147181315,ANSC 188,A00,886961,Jassal; Aftab,10,0,25,15
1745147182340,ANSC 190,A00,886962,Jassal; Aftab,14,0,25,11
1745147183372,ANSC 191,A00,886963,Staff,18,0,20,2
1745147184397,ANTH 3,A01,891689,Staff,19,0,20,1
1745147185426,ANTH 5,A00,886933,Semendeferi; Ekaterini,18,0,20,2
1745147186452,ANTH 10,A00,886934,Staff,0,8,30,30
1745147187478,ANTH 21,A01,886936,Staff,44,0,60,16
1745147188504,ANTH 23,A01,886938,Staff,94,0,100,6
1745147189540,ANTH 105,A00,886964,Stewart; Alexander B,94,0,100,6
1745147190565,ANTH 108,A00,886965,Pedersen; David,10,0,20,10
1745147191614,AWP 10,001,886147,Staff,0,0,0,0
1745147191614,AWP 10,002,886148,Staff,0,0,0,0
1745147191614,AWP 10,003,886149,Staff,0,0,0,0
1745147191614,AWP 10,004,886150,Staff,0,0,0,0
1745147191614,AWP 10,005,886151,Staff,0,0,0,0
1745147191614,AWP 10,006,886152,Staff,0,0,0,0
1745147191614,AWP 10,007,886153,Staff,0,0,0,0
1745147191614,AWP 10,008,886154,Staff,0,0,0,0
1745147191614,AWP 10,009,886155,Staff,0,0,0,0
1745147191614,AWP 10,010,886156,Staff,0,0,0,0
1745147191614,AWP 10,011,886158,Staff,0,0,0,0
1745147191614,AWP 10,012,886160,Staff,0,0,0,0
1745147191614,AWP 10,013,886161,Staff,0,0,0,0
1745147191614,AWP 10,014,886162,Staff,0,0,0,0
1745147191614,AWP 10,015,886163,Staff,0,0,0,0
1745147191614,AWP 10,016,886164,Staff,0,0,0,0
1745147191614,AWP 10,017,886165,Staff,0,0,0,0
1745147191614,AWP 10,018,886166,Staff,0,0,0,0
1745147191614,AWP 10,019,886168,Staff,0,0,0,0
1745147191614,AWP 10,020,886170,Staff,0,0,0,0
1745147191614,AWP 10,021,886172,Staff,0,0,0,0
1745147192642,AWP 10R,001,886173,Staff,0,0,0,0
1745147192642,AWP 10R,002,886174,Staff,0,1,0,0
1745147192642,AWP 10R,003,886175,Staff,0,0,0,0
1745147192642,AWP 10R,004,886176,Staff,0,0,0,0
1745147192642,AWP 10R,005,886177,Staff,0,0,0,0
1745147192642,AWP 10R,006,886178,Staff,0,0,0,0
1745147192642,AWP 10R,007,886179,Staff,0,0,0,0
1745147192642,AWP 10R,008,886181,Staff,0,0,0,0
1745147192642,AWP 10R,009,886182,Staff,0,0,0,0
1745147192642,AWP 10R,010,886183,Staff,0,0,0,0
1745147192642,AWP 10R,011,886184,Staff,0,0,0,0
1745147192642,AWP 10R,012,886185,Staff,0,0,0,0
1745147192642,AWP 10R,013,886186,Staff,0,0,0,0
1745147192642,AWP 10R,014,886187,Staff,0,0,0,0
1745147192642,AWP 10R,015,886188,Staff,0,0,0,0
1745147192642,AWP 10R,016,886189,Staff,0,0,0,0
1745147193668,AWP 102R,A00,886190,Staff,0,0,0,0
1745147193668,AWP 102R,B00,886191,Staff,0,0,0,0
1745147194694,BENG 100,A01,886193,Staff,19,0,30,11
1745147195720,BENG 122A,A01,886195,Hasty; Jeff M,20,0,30,10
1745147196753,BENG 166A,A00,886196,Sah; Robert Lie-Yuan,0,3,20,20
1745147197779,BIBC 102,A01,894320,Staff,0,2,46,46
1745147197779,BIBC 102,A02,894321,Staff,0,0,46,46
1745147197779,BIBC 102,A03,894344,Staff,21,0,46,25
1745147197779,BIBC 102,A04,894345,Staff,30,0,47,17
1745147198805,BICD 100R,A01,894365,Smith; Laurie,1,3,58,57
1745147198805,BICD 100R,A02,894366,Smith; Laurie,0,1,58,58
1745147198805,BICD 100R,A03,894367,Smith; Laurie,13,0,59,46
1745147199833,BICD 136,A01,894383,Gustafson-Brown; Cindy,16,0,50,34
1745147200876,BIEB 102,A01,894494,Butler; Shannon Rhey,67,0,130,63
1745147202950,BIEB 150,A01,894617,Wills; Christopher,0,3,13,13
1745147202950,BIEB 150,A02,894631,Wills; Christopher,0,3,13,13
1745147202950,BIEB 150,A03,894937,Wills; Christopher,0,3,13,13
1745147202950,BIEB 150,A04,894946,Wills; Christopher,0,1,11,11
1745147203976,BIEB 194,A00,906141,Kurle; Carolyn M.,14,0,20,6
1745147205003,BILD 1,A01,894154,Staff,8,0,19,11
1745147205003,BILD 1,A02,894155,Staff,15,0,19,4
1745147205003,BILD 1,A03,894160,Staff,18,0,19,1
1745147205003,BILD 1,A04,894161,Staff,16,0,18,2
1745147206033,BILD 2,A01,894168,Staff,0,0,50,50
1745147206033,BILD 2,A02,894169,Staff,0,0,50,50
1745147206033,BILD 2,A03,894179,Staff,27,0,50,23
1745147206033,BILD 2,A04,894203,Staff,42,0,50,8
1745147207063,BILD 3,A01,894213,Staff,24,0,31,7
1745147207063,BILD 3,A02,894214,Staff,28,0,31,3
1745147207063,BILD 3,A03,894235,Staff,30,0,31,1
1745147207063,BILD 3,A04,894236,Staff,29,0,32,3
1745147208090,BILD 4,A01,894253,Reuther; Keefe,12,0,24,12
1745147208090,BILD 4,A02,894258,Reuther; Keefe,19,0,24,5
1745147209117,BILD 5,A01,894276,Reuther; Keefe,40,0,50,10
1745147209117,BILD 5,A02,894277,Reuther; Keefe,48,0,50,2
1745147209117,BILD 5,A03,894290,Reuther; Keefe,47,0,50,3
1745147209117,BILD 5,A04,894291,Reuther; Keefe,50,0,50,0
1745147210145,BILD 24,A01,894297,Pirino; Giorgia,45,0,60,15
1745147211172,BIMM 100,A01,895012,Staff,0,14,0,1
1745147211172,BIMM 100,A02,895013,Staff,0,6,0,2
1745147211172,BIMM 100,A03,895014,Staff,0,7,0,0
1745147211172,BIMM 100,A04,895015,Staff,0,4,0,0
1745147212201,BIMM 101,A01,895017,McDonnell; Lisa Marie,0,2,24,24
1745147212201,BIMM 101,A02,895018,McDonnell; Lisa Marie,0,1,24,24
1745147212201,BIMM 101,B01,895020,McDonnell; Lisa Marie,0,3,24,24
1745147212201,BIMM 101,B02,895021,McDonnell; Lisa Marie,0,2,24,24
1745147213229,BIMM 110,A01,895023,Staff,7,0,25,18
1745147213229,BIMM 110,A02,895024,Staff,11,0,25,14
1745147213229,BIMM 110,A03,895025,Staff,22,0,25,3
1745147213229,BIMM 110,A04,895031,Staff,21,0,25,4
1745147214254,BIMM 120,A01,895114,Gustafson-Brown; Cindy,8,0,28,20
1745147214254,BIMM 120,A02,895126,Gustafson-Brown; Cindy,19,0,27,8
1745147215281,BIPN 100,A01,895130,Yang; Mingyu,13,0,38,25
1745147215281,BIPN 100,A02,895131,Yang; Mingyu,33,0,38,5
1745147215281,BIPN 100,A03,895132,Yang; Mingyu,33,0,38,5
1745147215281,BIPN 100,A04,895133,Yang; Mingyu,30,0,36,6
1745147216309,BIPN 120,A01,895135,Cooke; James Edward,0,2,13,13
1745147216309,BIPN 120,A02,895136,Cooke; James Edward,0,1,13,13
1745147216309,BIPN 120,A03,895137,Cooke; James Edward,0,0,13,13
1745147216309,BIPN 120,A04,895156,Cooke; James Edward,3,0,11,8
1745147217335,BIPN 134,A01,895235,Cooke; James Edward,0,2,25,25
1745147217335,BIPN 134,A02,895237,Cooke; James Edward,0,0,25,25
1745147217335,BIPN 134,A03,895240,Cooke; James Edward,12,0,25,13
1745147217335,BIPN 134,A04,895270,Cooke; James Edward,24,0,25,1
1745147218361,BIPN 189,A00,892103,Staff,0,20,9,9
1745147220425,CAT 124,A01,922009,Staff,0,1,20,20
1745147221454,CAT 125R,A00,886390,Morales; Celeste Georgianna,4,0,20,16
1745147221454,CAT 125R,B00,886391,Irwin; Matthew Joseph,0,1,20,20
1745147221454,CAT 125R,C00,886392,Smith; Lauryn Alissa,11,0,20,9
1745147221454,CAT 125R,D00,886393,Vanderschuit; Maya Alysia,6,0,20,14
1745147221454,CAT 125R,E00,886394,Marchisotto; Jennifer Anne,0,2,20,20
1745147222482,CENG 15,A01,886218,Drews; Aaron,1,0,5,4
1745147223509,CENG 113,A00,886219,Opatkiewicz; Justin Paul,16,0,25,9
1745147224537,CGS 101,A00,887044,Staff,13,0,20,7
1745147225563,CGS 105,A01,887046,Staff,16,0,25,9
1745147226588,CGS 112,A00,887047,Cuong; Marisol,12,0,15,3
1745147227618,CGS 113,A00,887048,Staff,24,0,30,6
1745147228651,CGS 120,A00,887049,Staff,12,0,17,5
1745147229701,CHEM 6A,A01,886336,Lam; Tin Yiu,44,0,50,6
1745147229701,CHEM 6A,A02,886338,Lam; Tin Yiu,43,0,50,7
1745147230728,CHEM 6B,A01,886341,Hopkins; Patrycja Anna,21,0,50,29
1745147230728,CHEM 6B,A02,886343,Hopkins; Patrycja Anna,46,0,50,4
1745147231763,CHEM 6C,A01,886346,Albizati; Kim F.,0,1,50,50
1745147231763,CHEM 6C,A02,886348,Albizati; Kim F.,38,0,50,12
1745147232797,CHEM 40A,A01,886352,Klosterman; Jeremy K,70,0,100,30
1745147233823,CHEM 40B,A01,886356,Klosterman; Jeremy K,0,4,100,100
1745147234848,CHEM 41B,A01,886360,Theodorakis; Emmanuel,30,0,50,20
1745147234848,CHEM 41B,A02,886362,Theodorakis; Emmanuel,46,0,50,4
1745147235875,CHIN 165A,A00,886382,Xu; Li,19,0,20,1
1745147236903,CLAS 120,A00,886387,Myerston Santana; Jacobo,36,0,40,4
1745147237928,COGS 9,A01,886967,Shannon; Kyle Michael,49,0,60,11
1745147238965,COGS 11,A01,886969,Staff,18,0,30,12
1745147239989,COGS 14A,A01,886971,Staff,26,0,60,34
1745147241027,COGS 14B,A01,886973,Hoffman; Drew Ellen,18,0,60,42
1745147242065,COGS 18,A01,886975,Morgan; Eric,41,0,60,19
1745147243091,COGS 20,A01,886977,Staff,6,0,8,2
1745147243091,COGS 20,A02,886978,Staff,6,0,7,1
1745147244115,COGS 100,A01,907783,Staff,6,0,30,24
1745147245141,COGS 101B,A01,886980,Staff,0,10,30,30
1745147246173,COGS 101C,A01,886982,Delgado; Tania,0,6,30,30
1745147247200,COGS 102A,A01,886984,Johnson; Christine M.,13,0,30,17
1745147248231,COGS 118B,A01,886986,Staff,0,25,60,60
1745147249255,COGS 150,A01,886988,Bergen; Benjamin,16,0,30,14
1745147250281,COGS 153,A00,886989,Delgado; Tania,0,6,30,30
1745147251307,COGS 186,A01,886991,Staff,3,0,30,27
1745147252334,COGS 187A,A01,886993,Boyle; Mary E. T.,12,0,30,18
1745147253359,COGS 189,A00,886994,Staff,13,0,30,17
1745147254394,COMM 10,A01,886996,Staff,11,0,25,14
1745147254394,COMM 10,A02,886997,Staff,21,0,25,4
1745147255418,COMM 20,A01,886999,Leuning; Grant Maurstad,33,0,40,7
1745147257468,COMM 100A,A01,887002,Staff,0,0,25,25
1745147257468,COMM 100A,A02,887003,Staff,20,0,25,5
1745147258494,COMM 100B,A01,887005,Staff,0,1,25,25
1745147259521,COMM 106D,A00,887006,Staff,22,0,40,18
1745147260547,COMM 110G,A00,887007,Whitworth-Smith; Andrew C,17,0,40,23
1745147261573,COMM 111B,A00,887008,Staff,31,0,40,9
1745147262598,COMM 113T,A00,887009,Abuelhiga; Soraya Jill,30,0,40,10
1745147262598,COMM 113T,B00,906733,Staff,40,0,40,0
1745147263623,COMM 145,A00,887010,Staff,21,0,40,19
1745147264655,COMM 146,A00,887054,Staff,31,0,40,9
1745147265681,COMM 190,A00,887012,Staff,9,0,23,14
1745147266707,CSE 8A,A50,887015,Cao; Yingjun,68,0,85,17
1745147267739,CSE 11,A01,887017,Cao; Yingjun,35,0,70,35
1745147268766,CSE 20,A01,887019,Staff,35,0,50,15
1745147269811,CSE 21,A01,887021,Braun; Oliver,81,0,100,19
1745147269811,CSE 21,B01,892583,Staff,48,0,50,2
1745147270838,CSE 30,A01,887025,Eldon; John,161,0,200,39
1745147271865,CSE 100,A01,887027,Staff,28,0,50,22
1745147271865,CSE 100,A02,887028,Staff,43,0,50,7
1745147272891,CSE 101,A01,887030,Braun; Oliver,79,0,100,21
1745147272891,CSE 101,B01,887032,Jones; Miles E,0,1,50,50
1745147272891,CSE 101,B02,887033,Jones; Miles E,13,0,50,37
1745147273924,CSE 105,A01,908084,Jones; Miles E,36,0,50,14
1745147273924,CSE 105,A02,908087,Jones; Miles E,38,0,50,12
1745147274950,CSE 135,A01,887035,Powell; Thomas Allan,8,0,50,42
1745147275974,CSE 142,A01,887037,Staff,22,0,60,38
1745147276999,CSE 142L,A01,887039,Staff,42,0,60,18
1745147278025,CSE 151A,A01,887041,Solares; Edwin A,60,0,100,40
1745147279057,CSE 175,A01,887043,Kumar; Rakesh,30,0,30,0
1745147280082,CSS 1,A01,886389,Staff,12,0,40,28
1745147281109,DSC 30,A01,908097,Liao; Soohyun Nam,54,0,75,21
1745147282138,DSC 40A,A01,908099,Shannon; Kyle Michael,37,0,50,13
1745147283164,DSC 40B,A01,908112,Staff,28,0,50,22
1745147284195,DSC 80,A01,908116,Staff,32,0,60,28
1745147285219,DSC 197,001,956863,Eldridge; Justin Matthew,9999,0,9999,0
1745147286246,ECE 5,A01,886400,Morris; Karcher William,3,0,6,3
1745147286246,ECE 5,A02,886401,Morris; Karcher William,5,0,6,1
1745147287281,ECE 148,A01,886403,Silberman; Jack,0,8,14,14
