time,subj_course_id,sec_code,sec_id,prof,available,waitlist,total,enrolled_ct
1746566605742,AAS 10,A01,886199,Childs; Dennis R.,0,3,0,0
1746566606771,ANAR 104,A01,886940,Shtienberg; Gilad,27,0,30,3
1746566607799,ANAR 120,A00,886953,Staff,12,0,20,8
1746566608828,ANBI 148,A01,886955,Wilder; Linnea Lorene,30,0,40,10
1746566610890,ANSC 122,A00,886957,Staff,25,0,30,5
1746566611920,ANSC 150,A00,886958,Sloane; Julia Kathryn,2,0,15,13
1746566612952,ANSC 156,A00,886959,Jenkins; Janis A.,0,1,15,15
1746566613981,ANSC 180,A00,886960,Staff,11,0,17,6
1746566615011,ANSC 188,A00,886961,Jassal; Aftab,9,0,25,16
1746566616038,ANSC 190,A00,886962,Jassal; Aftab,14,0,25,11
1746566617067,ANSC 191,A00,886963,Staff,18,0,20,2
1746566618099,ANTH 3,A01,891689,Staff,17,0,20,3
1746566619128,ANTH 5,A00,886933,Semendeferi; Ekaterini,16,0,20,4
1746566620159,ANTH 10,A00,886934,Staff,0,12,30,30
1746566621192,ANTH 21,A01,886936,Staff,41,0,60,19
1746566622224,ANTH 23,A01,886938,Staff,92,0,100,8
1746566623251,ANTH 105,A00,886964,Stewart; Alexander B,84,0,100,16
1746566624282,ANTH 108,A00,886965,Pedersen; David,9,0,20,11
1746566625313,AWP 10,001,886147,Staff,0,0,0,0
1746566625313,AWP 10,002,886148,Staff,0,0,0,0
1746566625313,AWP 10,003,886149,Staff,0,0,0,0
1746566625313,AWP 10,004,886150,Staff,0,0,0,0
1746566625313,AWP 10,005,886151,Staff,0,0,0,0
1746566625313,AWP 10,006,886152,Staff,0,0,0,0
1746566625313,AWP 10,007,886153,Staff,0,0,0,0
1746566625313,AWP 10,008,886154,Staff,0,0,0,0
1746566625313,AWP 10,009,886155,Staff,0,0,0,0
1746566625313,AWP 10,010,886156,Staff,0,0,0,0
1746566625313,AWP 10,011,886158,Staff,0,0,0,0
1746566625313,AWP 10,012,886160,Staff,0,0,0,0
1746566625313,AWP 10,013,886161,Staff,0,0,0,0
1746566625313,AWP 10,014,886162,Staff,0,0,0,0
1746566625313,AWP 10,015,886163,Staff,0,0,0,0
1746566625313,AWP 10,016,886164,Staff,0,0,0,0
1746566625313,AWP 10,017,886165,Staff,0,0,0,0
1746566625313,AWP 10,018,886166,Staff,0,0,0,0
1746566625313,AWP 10,019,886168,Staff,0,0,0,0
1746566625313,AWP 10,020,886170,Staff,0,0,0,0
1746566625313,AWP 10,021,886172,Staff,0,0,0,0
1746566626346,AWP 10R,001,886173,Staff,0,1,0,0
1746566626346,AWP 10R,002,886174,Staff,0,1,0,0
1746566626346,AWP 10R,003,886175,Staff,0,0,0,0
1746566626346,AWP 10R,004,886176,Staff,0,0,0,0
1746566626346,AWP 10R,005,886177,Staff,0,0,0,0
1746566626346,AWP 10R,006,886178,Staff,0,0,0,0
1746566626346,AWP 10R,007,886179,Staff,0,0,0,0
1746566626346,AWP 10R,008,886181,Staff,0,0,0,0
1746566626346,AWP 10R,009,886182,Staff,0,0,0,0
1746566626346,AWP 10R,010,886183,Staff,0,0,0,0
1746566626346,AWP 10R,011,886184,Staff,0,0,0,0
1746566626346,AWP 10R,012,886185,Staff,0,0,0,0
1746566626346,AWP 10R,013,886186,Staff,0,0,0,0
1746566626346,AWP 10R,014,886187,Staff,0,0,0,0
1746566626346,AWP 10R,015,886188,Staff,0,0,0,0
1746566626346,AWP 10R,016,886189,Staff,0,0,0,0
1746566626346,AWP 10R,017,960532,Staff,0,0,0,0
1746566626346,AWP 10R,018,960533,Staff,0,0,0,0
1746566626346,AWP 10R,019,960534,Staff,0,0,0,0
1746566626346,AWP 10R,020,960538,Staff,0,0,0,0
1746566626346,AWP 10R,021,960540,Staff,0,0,0,0
1746566626346,AWP 10R,022,960541,Staff,0,0,0,0
1746566626346,AWP 10R,023,960542,Staff,0,0,0,0
1746566626346,AWP 10R,024,960544,Staff,0,0,0,0
1746566626346,AWP 10R,025,960545,Staff,0,0,0,0
1746566626346,AWP 10R,026,960548,Staff,0,0,0,0
1746566627378,AWP 102R,A00,886190,Staff,0,0,0,0
1746566627378,AWP 102R,B00,886191,Staff,0,0,0,0
1746566628407,BENG 100,A01,886193,Staff,17,0,30,13
1746566629434,BENG 122A,A01,886195,Hasty; Jeff M,13,0,30,17
1746566630462,BENG 166A,A00,886196,Sah; Robert Lie-Yuan,0,2,30,30
1746566631491,BENG 190,A00,958050,Khojah; Reem I,20,0,25,5
1746566632524,BIBC 102,A01,894320,Staff,0,0,46,46
1746566632524,BIBC 102,A02,894321,Staff,0,0,46,46
1746566632524,BIBC 102,A03,894344,Staff,7,0,46,39
1746566632524,BIBC 102,A04,894345,Staff,26,0,47,21
1746566633577,BICD 100R,A01,894365,Smith; Laurie,0,3,58,58
1746566633577,BICD 100R,A02,894366,Smith; Laurie,0,5,58,58
1746566633577,BICD 100R,A03,894367,Smith; Laurie,0,0,59,59
1746566633577,BICD 100R,A04,959869,Smith; Laurie,40,0,59,19
1746566634609,BICD 136,A01,894383,Gustafson-Brown; Cindy,14,0,50,36
1746566635642,BIEB 102,A01,894494,Butler; Shannon Rhey,51,0,130,79
1746566637704,BIEB 150,A01,894617,Wills; Christopher,3,0,20,17
1746566637704,BIEB 150,A02,894631,Wills; Christopher,3,0,20,17
1746566637704,BIEB 150,A03,894937,Wills; Christopher,3,0,20,17
1746566637704,BIEB 150,A04,894946,Wills; Christopher,5,0,20,15
1746566638733,BIEB 194,A00,906141,Kurle; Carolyn M.,6,0,20,14
1746566639760,BILD 1,A01,894154,Staff,3,0,19,16
1746566639760,BILD 1,A02,894155,Staff,14,0,19,5
1746566639760,BILD 1,A03,894160,Staff,13,0,19,6
1746566639760,BILD 1,A04,894161,Staff,15,0,18,3
1746566640788,BILD 2,A01,894168,Staff,0,0,50,50
1746566640788,BILD 2,A02,894169,Staff,0,0,50,50
1746566640788,BILD 2,A03,894179,Staff,0,0,50,50
1746566640788,BILD 2,A04,894203,Staff,25,0,50,25
1746566641814,BILD 3,A01,894213,Staff,22,0,31,9
1746566641814,BILD 3,A02,894214,Staff,26,0,31,5
1746566641814,BILD 3,A03,894235,Staff,28,0,31,3
1746566641814,BILD 3,A04,894236,Staff,28,0,32,4
1746566642848,BILD 4,A01,894253,Reuther; Keefe,6,0,24,18
1746566642848,BILD 4,A02,894258,Reuther; Keefe,16,0,24,8
1746566643873,BILD 5,A01,894276,Reuther; Keefe,35,0,50,15
1746566643873,BILD 5,A02,894277,Reuther; Keefe,45,0,50,5
1746566643873,BILD 5,A03,894290,Reuther; Keefe,44,0,50,6
1746566643873,BILD 5,A04,894291,Reuther; Keefe,48,0,50,2
1746566644902,BILD 24,A01,894297,Pirino; Giorgia,40,0,60,20
1746566645936,BIMM 100,B01,958915,Staff,71,0,100,29
1746566646966,BIMM 101,A01,895017,McDonnell; Lisa Marie,0,5,24,24
1746566646966,BIMM 101,A02,895018,McDonnell; Lisa Marie,0,5,24,24
1746566646966,BIMM 101,B01,895020,McDonnell; Lisa Marie,0,6,24,24
1746566646966,BIMM 101,B02,895021,McDonnell; Lisa Marie,0,4,24,24
1746566647994,BIMM 110,A01,895023,Staff,1,0,25,24
1746566647994,BIMM 110,A02,895024,Staff,9,0,25,16
1746566647994,BIMM 110,A03,895025,Staff,18,0,25,7
1746566647994,BIMM 110,A04,895031,Staff,20,0,25,5
1746566649020,BIMM 120,A01,895114,Gustafson-Brown; Cindy,14,0,28,14
1746566649020,BIMM 120,A02,895126,Gustafson-Brown; Cindy,21,0,27,6
1746566650050,BIPN 100,A01,895130,Yang; Mingyu,1,0,38,37
1746566650050,BIPN 100,A02,895131,Yang; Mingyu,32,0,38,6
1746566650050,BIPN 100,A03,895132,Yang; Mingyu,32,0,38,6
1746566650050,BIPN 100,A04,895133,Yang; Mingyu,27,0,36,9
1746566651081,BIPN 120,A01,895135,Cooke; James Edward,0,3,13,13
1746566651081,BIPN 120,A02,895136,Cooke; James Edward,0,1,13,13
1746566651081,BIPN 120,A03,895137,Cooke; James Edward,0,3,13,13
1746566651081,BIPN 120,A04,895156,Cooke; James Edward,0,2,11,11
1746566652110,BIPN 134,A01,895235,Cooke; James Edward,0,2,25,25
1746566652110,BIPN 134,A02,895237,Cooke; James Edward,0,0,25,25
1746566652110,BIPN 134,A03,895240,Cooke; James Edward,3,0,25,22
1746566652110,BIPN 134,A04,895270,Cooke; James Edward,20,0,25,5
1746566653137,BIPN 189,A00,892103,Staff,0,13,14,14
1746566655200,BISP 194,A00,958008,Staff,0,2,0,0
1746566656227,CAT 124,A01,922009,Staff,0,5,20,20
1746566657268,CAT 125R,A00,886390,Morales; Celeste Georgianna,0,2,20,20
1746566657268,CAT 125R,B00,886391,Irwin; Matthew Joseph,0,4,20,20
1746566657268,CAT 125R,C00,886392,Smith; Lauryn Alissa,0,2,20,20
1746566657268,CAT 125R,D00,886393,Vanderschuit; Maya Alysia,0,3,20,20
1746566657268,CAT 125R,E00,886394,Marchisotto; Jennifer Anne,0,3,20,20
1746566658304,CENG 15,A01,886218,Drews; Aaron,3,0,8,5
1746566659335,CENG 113,A00,886219,Opatkiewicz; Justin Paul,15,0,25,10
1746566660370,CGS 101,A00,887044,Staff,7,0,20,13
1746566661395,CGS 105,A01,887046,Staff,14,0,25,11
1746566662425,CGS 112,A00,887047,Cuong; Marisol,12,0,15,3
1746566663451,CGS 113,A00,887048,Staff,23,0,30,7
1746566664477,CGS 120,A00,887049,Staff,10,0,17,7
1746566665508,CHEM 6A,A01,886336,Lam; Tin Yiu,38,0,50,12
1746566665508,CHEM 6A,A02,886338,Lam; Tin Yiu,37,0,50,13
1746566666538,CHEM 6B,A01,886341,Hopkins; Patrycja Anna,16,0,50,34
1746566666538,CHEM 6B,A02,886343,Hopkins; Patrycja Anna,42,0,50,8
1746566667563,CHEM 6C,A01,886346,Albizati; Kim F.,0,2,50,50
1746566667563,CHEM 6C,A02,886348,Albizati; Kim F.,23,0,50,27
1746566668590,CHEM 40A,A01,886352,Klosterman; Jeremy K,65,0,100,35
1746566669617,CHEM 40B,A01,886356,Klosterman; Jeremy K,0,23,100,100
1746566670648,CHEM 41B,A01,886360,Theodorakis; Emmanuel,25,0,50,25
1746566670648,CHEM 41B,A02,886362,Theodorakis; Emmanuel,47,0,50,3
1746566671673,CHIN 165A,A00,886382,Xu; Li,18,0,20,2
1746566672703,CLAS 120,A00,886387,Myerston Santana; Jacobo,33,0,40,7
1746566673737,COGS 9,A01,886967,Shannon; Kyle Michael,42,0,60,18
1746566674767,COGS 11,A01,886969,Staff,10,0,30,20
1746566675795,COGS 14A,A01,886971,Staff,6,0,60,54
1746566676823,COGS 14B,A01,886973,Hoffman; Drew Ellen,4,0,60,56
1746566677857,COGS 18,A01,886975,Morgan; Eric,35,0,60,25
1746566678886,COGS 20,A01,886977,Staff,4,0,8,4
1746566678886,COGS 20,A02,886978,Staff,5,0,7,2
1746566679913,COGS 100,A01,907783,Staff,1,2,30,29
1746566680940,COGS 101B,A01,886980,Staff,0,3,48,48
1746566681967,COGS 101C,A01,886982,Delgado; Tania,0,5,44,44
1746566682997,COGS 102A,A01,886984,Johnson; Christine M.,4,0,30,26
1746566684027,COGS 118B,A01,886986,Staff,1,3,88,87
1746566685060,COGS 150,A01,886988,Bergen; Benjamin,22,0,50,28
1746566686089,COGS 153,A00,886989,Delgado; Tania,0,2,41,41
1746566687121,COGS 186,A01,886991,Staff,0,0,32,32
1746566688147,COGS 187A,A01,886993,Boyle; Mary E. T.,7,0,30,23
1746566689180,COGS 189,A00,886994,Staff,0,1,30,30
1746566690211,COMM 10,A01,886996,Staff,0,0,20,21
1746566690211,COMM 10,A02,886997,Staff,12,0,20,8
1746566690211,COMM 10,A03,959845,Staff,19,0,20,1
1746566691240,COMM 20,A01,886999,Leuning; Grant Maurstad,24,0,40,16
1746566693295,COMM 100A,A01,887002,Staff,0,0,20,25
1746566693295,COMM 100A,A02,887003,Staff,6,0,20,14
1746566694322,COMM 100B,A01,887005,Staff,0,8,20,24
1746566695349,COMM 106D,A00,887006,Staff,13,0,40,27
1746566696383,COMM 110G,A00,887007,Whitworth-Smith; Andrew C,12,0,40,28
1746566697412,COMM 111B,A00,887008,Staff,31,0,40,9
1746566698439,COMM 113T,A00,887009,Abuelhiga; Soraya Jill,28,0,40,12
1746566698439,COMM 113T,B00,906733,Staff,40,0,40,0
1746566699475,COMM 145,A00,887010,Staff,12,0,40,28
1746566700501,COMM 146,A00,887054,Staff,31,0,40,9
1746566701527,COMM 190,A00,887012,Staff,8,0,23,15
1746566702555,CSE 8A,A50,887015,Cao; Yingjun,57,0,85,28
1746566703586,CSE 11,A01,887017,Cao; Yingjun,12,0,70,58
1746566704619,CSE 20,A01,887019,Staff,30,0,50,20
1746566705647,CSE 21,A01,887021,Staff,78,0,100,22
1746566705647,CSE 21,B01,892583,Braun; Oliver,45,0,50,5
1746566706681,CSE 30,A01,887025,Eldon; John,143,0,200,57
1746566707709,CSE 100,A01,887027,Staff,26,0,50,24
1746566707709,CSE 100,A02,887028,Staff,42,0,50,8
1746566708742,CSE 101,A01,887030,Braun; Oliver,74,0,100,26
1746566708742,CSE 101,B01,887032,Jones; Miles E,0,3,50,50
1746566708742,CSE 101,B02,887033,Jones; Miles E,0,2,50,50
1746566709768,CSE 105,A01,908084,Jones; Miles E,32,0,50,18
1746566709768,CSE 105,A02,908087,Jones; Miles E,32,0,50,18
1746566710803,CSE 135,A01,887035,Powell; Thomas Allan,0,5,50,50
1746566711841,CSE 142,A01,887037,Staff,8,0,60,52
1746566712869,CSE 142L,A01,887039,Staff,34,0,60,26
1746566726096,CSE 151A,A01,887041,Solares; Edwin A,47,0,100,53
1746566727126,CSE 175,A01,887043,Kumar; Rakesh,30,0,30,0
1746566728156,CSS 1,A01,886389,Staff,1,1,40,39
1746566729188,DSC 30,A01,908097,Liao; Soohyun Nam,47,0,75,28
1746566730214,DSC 40A,A01,908099,Shannon; Kyle Michael,30,0,50,20
1746566731245,DSC 40B,A01,908112,Staff,15,0,50,35
1746566732274,DSC 80,A01,908116,Staff,19,0,60,41
1746566733303,DSC 197,001,956863,Eldridge; Justin Matthew,9999,0,9999,0
1746566734332,ECE 5,A01,886400,Morris; Karcher William,1,0,6,5
1746566734332,ECE 5,A02,886401,Morris; Karcher William,3,0,6,3
1746566735361,ECE 148,A01,886403,Silberman; Jack,0,14,14,14
1746566748947,ECON 1,A01,887265,Crane; Meredith Helen,12,0,70,58
1746566748947,ECON 1,B01,887268,Staff,43,0,50,7
1746566749983,ECON 2,A01,887273,Crane; Meredith Helen,55,0,70,15
1746566751009,ECON 3,A01,887279,Rondina; Giacomo,32,0,70,38
1746566752042,ECON 4,A01,887282,Anderson; John Charles,0,2,10,10
1746566753069,ECON 5,A01,887285,Staff,34,0,45,11
1746566753069,ECON 5,B01,887292,Staff,41,0,45,4
1746566754095,ECON 100A,A01,887337,Newhouse; Herbert S,54,0,70,16
1746566754095,ECON 100A,B01,887349,Staff,45,0,50,5
1746566755122,ECON 100B,A01,887361,Du; Songzi,29,0,70,41
1746566756151,ECON 100C,A01,887445,Newhouse; Herbert S,59,0,70,11
1746566757181,ECON 105,A00,887488,Vespa; Emanuel Ignacio,23,0,35,12
1746566758206,ECON 109,A01,887506,Shishkin; Denis,28,0,35,7
1746566760643,ECON 110A,A01,887568,Alon; Titan Michael,0,3,35,35
1746566760643,ECON 110A,B01,907601,Alon; Titan Michael,20,0,35,15
1746566761674,ECON 110B,A01,887598,Levkoff; Steven B.,0,24,70,70
1746566762699,ECON 112,A00,887599,Rondina; Giacomo,19,0,35,16
1746566763727,ECON 120A,A01,887603,Dai; Yinlin,35,0,70,35
1746566764754,ECON 120C,A01,887608,Sun; Yixiao,0,1,35,35
1746566764754,ECON 120C,B01,887614,Sun; Yixiao,0,0,35,35
1746566765785,ECON 138,A00,887621,Bharadwaj; Prashant,0,21,20,20
1746566766816,ECON 144,A00,958007,Squires; Dale E,13,0,35,22
1746566767842,ECON 171,A01,907666,Staff,18,0,35,17
1746566768871,ECON 175,A00,887626,Wu; Pak Yeung,23,0,35,12
1746566769900,ECON 190,A00,887640,Vespa; Emanuel Ignacio,23,0,35,12
1746566770930,EDS 25,A01,888197,Staff,0,0,0,0
1746566770930,EDS 25,A02,888209,Staff,0,0,0,0
1746566770930,EDS 25,A03,888210,Staff,0,0,0,0
1746566770930,EDS 25,A04,888212,Staff,0,0,0,0
1746566770930,EDS 25,A05,888213,Staff,0,0,0,0
1746566770930,EDS 25,A06,888214,Staff,0,0,0,0
1746566770930,EDS 25,A07,888235,Staff,0,2,0,0
1746566770930,EDS 25,A08,888236,Staff,0,0,0,0
1746566770930,EDS 25,A09,888240,Staff,0,0,0,0
1746566770930,EDS 25,A10,888244,Staff,0,0,0,0
1746566770930,EDS 25,B01,888273,Staff,0,0,0,0
1746566770930,EDS 25,B02,888285,Staff,0,0,0,0
1746566770930,EDS 25,B03,888423,Staff,0,0,0,1
1746566770930,EDS 25,B04,888432,Staff,0,0,0,0
1746566770930,EDS 25,B05,888433,Staff,0,0,0,0
1746566770930,EDS 25,B06,888467,Staff,0,0,0,0
1746566770930,EDS 25,B07,888468,Staff,0,0,0,0
1746566770930,EDS 25,B08,888479,Staff,0,0,0,0
1746566770930,EDS 25,B09,888484,Staff,0,0,0,0
1746566770930,EDS 25,B10,888487,Staff,0,0,0,0
1746566771956,EDS 38,A01,907700,Choi; Bailey Miyeon,30,0,30,0
1746566772988,EDS 112,A01,888601,Chapman; Thandeka K,12,0,40,28
1746566774015,EDS 115,A00,888697,Mendez; Kathrina Mendoza,10,0,30,20
1746566775044,EDS 116,A01,888893,Staff,35,0,40,5
1746566777100,EDS 124AR,A00,889133,Staff,28,0,50,22
1746566777100,EDS 124AR,B00,907471,Simon; Elizabeth A,37,0,50,13
1746566778127,EDS 124BR,A00,889134,Simon; Elizabeth A,44,0,100,56
1746566779156,EDS 125,A00,889135,Staff,25,0,30,5
1746566780186,EDS 126,A01,889138,Staff,36,0,40,4
1746566781212,EDS 164R,A01,889142,Wishard Guerra; Alison G.,33,0,50,17
1746566782242,ENG 30,A01,886396,Staff,0,0,0,0
1746566782242,ENG 30,B01,886398,Staff,0,0,0,0
1746566783274,ENVR 102,A00,906150,Montejo; Carolina,23,0,25,2
1746566784306,ETHN 103A,A00,887236,Man; Simeon S,0,3,0,0
1746566785333,ETHN 113,A00,887239,Staff,16,0,30,14
1746566786361,ETHN 116,A00,887240,Staff,16,0,25,9
1746566788773,ETHN 117,A00,887241,Choi; Esther Min,28,0,30,2
1746566789800,ETHN 118,A00,887243,Staff,24,0,30,6
1746566790828,ETHN 127,A00,887248,Cuong; Marisol,11,0,15,4
1746566791858,ETHN 139,A00,887250,Staff,7,0,10,3
1746566792887,ETHN 142,A00,887252,Staff,10,0,30,20
1746566793913,ETHN 161,A00,887253,Browne; Errol Tsekani,24,0,30,6
1746566794939,ETHN 163FR,A00,887255,Burelle; Julie Sara Veronique,0,0,5,5
1746566795968,GLBH 20,A00,889149,Elwardani; Nile Regina,8,0,42,34
1746566798029,GLBH 111,A01,889152,Burgos; Jose L.,17,0,17,0
1746566799054,GLBH 150,A00,889181,Sloane; Julia Kathryn,0,5,15,15
1746566801105,HDS 60,A01,886406,Warstadt; Melissa Fawn,73,0,80,7
1746566802134,HIAF 111,A00,889324,Gyamfi; Bright,25,0,32,7
1746566803162,HIEA 131,A00,889328,Staff,15,0,32,17
1746566804192,HIEA 144,A00,889333,Henry; Todd A.,26,0,32,6
1746566805218,HIEA 154,A00,889336,Henry; Todd A.,24,0,32,8
1746566806250,HIEU 106,A00,889339,Staff,22,0,32,10
1746566808304,HIEU 114,A00,889340,Staff,3,0,32,29
1746566809334,HIEU 135GS,A00,889342,Patterson; Patrick H.,0,0,1,24
1746566810359,HIEU 137,A00,889343,Edington; Claire Ellen,10,0,25,15
1746566811387,HIEU 148,A00,889345,Staff,14,0,32,18
1746566812427,HIEU 154,A00,889346,Biess; Frank Peter,21,0,32,11
1746566813452,HILA 102,A00,889351,Staff,12,0,32,20
1746566814479,HILD 2A,A01,889221,Lewandoski; Julia Mavis,1,10,32,31
1746566815505,HILD 7B,A01,889225,Man; Simeon S,0,12,32,32
1746566816538,HILD 7C,A01,889288,Alvarez; Luis A,0,14,32,32
1746566817564,HILD 30,A01,889323,Staff,0,5,32,32
1746566819617,HISC 119,A00,889383,Golan; Tal,19,0,32,13
1746566820642,HIUS 103,A00,889384,Man; Simeon S,0,0,32,32
1746566821669,HIUS 117,A00,919797,Kwak; Nancy,18,0,32,14
1746566822696,HIUS 142A,A00,919788,Staff,22,0,32,10
1746566824748,HIUS 149,A00,889386,Gyamfi; Bright,26,0,32,6
1746566825776,HIUS 155,A00,889387,Alvarez; Luis A,14,0,32,18
1746566826802,HUM 3,A01,886499,Caldwell; Michael Alan,19,0,50,31
1746566827829,HUM 3GS,A00,886500,Rodriguez; Bretton Sigfred,0,0,0,28
1746566828859,HUM 3R,A01,886502,Markman; Kristina,0,36,50,50
1746566829886,HUM 4,A01,886504,Crum; Matthew Stephen,24,0,50,26
1746566829886,HUM 4,B01,886506,West; Geoffrey Scott,17,0,50,33
1746566830916,HUM 4GS,A00,886507,Staff,0,0,0,19
1746566831946,HUM 5,A01,886509,Staff,32,0,50,18
1746566832973,HUM 5R,A01,886511,Zavodny; Tatiana Sophia,0,39,50,50
1746566834000,JAPN 180,A00,886407,Staff,17,0,40,23
1746566835033,LATI 50,A01,886409,Martin-Cabrera; Luis,4,0,22,18
1746566835033,LATI 50,A02,886410,Martin-Cabrera; Luis,19,0,22,3
1746566835033,LATI 50,A03,886411,Martin-Cabrera; Luis,21,0,22,1
1746566835033,LATI 50,A04,886412,Martin-Cabrera; Luis,9,0,22,13
1746566836062,LAWS 101,A00,907664,Staff,28,0,60,32
1746566837113,LIAB 1A,A00,889388,Saab; Dima,17,0,20,3
1746566838138,LIAB 1AX,A00,889389,El Cheddadi; Youniss,18,0,20,2
1746566839167,LIFR 1C,A00,889391,Van Moer; Vinciane G,8,0,20,12
1746566840195,LIFR 1CX,A00,889392,Van Moer; Vinciane G,7,0,20,13
1746566841222,LIFR 1D,A00,889393,Van Moer; Vinciane G,7,0,20,13
1746566842252,LIFR 1DX,A00,889394,Van Moer; Vinciane G,8,0,20,12
1746566843277,LIGN 7,A00,886923,Staff,24,0,50,26
1746566844303,LIGN 17,A00,886924,Kehler; Andrew Scott,125,0,150,25
1746566845340,LTAM 110,A00,889395,Staff,15,0,30,15
1746566846369,LTAM 110GS,A00,958010,Rodriguez; Bretton Sigfred,0,0,0,28
1746566847398,LTCH 101,A00,889397,Staff,23,0,25,2
1746566848425,LTCS 130,A00,889398,Staff,23,0,25,2
1746566849455,LTEA 138,A00,889399,Staff,24,0,40,16
1746566850481,LTEN 149,A00,889400,Wesling; Megan E.,0,3,25,25
1746566851509,LTEN 169,A00,889401,Staff,20,0,25,5
1746566852536,LTEN 180,A00,889402,Staff,10,0,15,5
1746566853560,LTEN 181,A00,889403,Staff,21,0,25,4
1746566854586,LTWL 100,A00,889404,Myerston Santana; Jacobo,2,0,25,23
1746566855615,LTWL 180GS,A00,889405,Staff,0,0,20,20
1746566856643,LTWL 181,A00,889406,Staff,16,0,25,9
1746566857670,LTWL 184,A00,889475,Mukherjee; Silpa,22,0,25,3
1746566858695,LTWR 102C,A00,889486,Staff,29,0,30,1
1746566859723,LTWR 115W,A00,889491,Staff,0,2,15,15
1746566860750,MAE 8,A01,886905,Staff,0,2,0,0
1746566861776,MAE 11,A00,886906,Bandaru; Prabhakar,0,7,50,50
1746566862808,MAE 20,A00,886907,Evdokimenko; Ekaterina,43,0,70,27
1746566863837,MAE 30B,A00,886909,Ghazinejad; Maziar,26,0,45,19
1746566864863,MAE 101B,A00,886910,Saintillan; David,29,0,45,16
1746566865891,MAE 105,A00,886911,Bandaru; Prabhakar,18,0,50,32
1746566866925,MAE 107,B00,958024,Staff,8,0,50,42
1746566867952,MAE 143B,A00,886913,Bewley; Thomas R,6,0,40,34
1746566868980,MAE 148,A01,886915,Silberman; Jack,0,3,14,14
1746566870008,MAE 160,A00,886916,Evdokimenko; Ekaterina,32,0,60,28
1746566871036,MATH 3C,A01,889681,Staff,0,2,30,30
1746566871036,MATH 3C,A02,960048,Staff,24,0,30,6
1746566872062,MATH 10A,A01,889760,Staff,26,0,30,4
1746566872062,MATH 10A,A02,889783,Staff,29,0,30,1
1746566873090,MATH 10B,A01,889785,Verstraete; Jacques Allan,2,0,35,33
1746566873090,MATH 10B,A02,889795,Verstraete; Jacques Allan,4,0,35,31
1746566873090,MATH 10B,B01,889797,Verstraete; Jacques Allan,3,0,35,32
1746566873090,MATH 10B,B02,889828,Verstraete; Jacques Allan,3,0,35,32
1746566874117,MATH 10C,A01,889849,Habib; Yousaf,7,0,30,23
1746566874117,MATH 10C,A02,889852,Habib; Yousaf,14,0,30,16
1746566874117,MATH 10C,A03,889853,Habib; Yousaf,22,0,30,8
1746566874117,MATH 10C,A04,889858,Habib; Yousaf,20,0,30,10
1746566874117,MATH 10C,B01,889861,Staff,1,0,30,29
1746566874117,MATH 10C,B02,889862,Staff,24,0,30,6
1746566874117,MATH 10C,B03,889863,Staff,27,0,30,3
1746566874117,MATH 10C,B04,889967,Staff,23,0,30,7
1746566875143,MATH 18,A01,889974,Staff,7,0,30,23
1746566875143,MATH 18,A02,889977,Staff,20,0,30,10
1746566875143,MATH 18,B01,889984,Hardiman; Liam,21,0,30,9
1746566875143,MATH 18,B02,889985,Hardiman; Liam,25,0,30,5
1746566876169,MATH 20A,A01,889990,Suk; Andrew Hoon,30,0,35,5
1746566877194,MATH 20B,A01,889993,Ohm; Ko Woon,22,0,30,8
1746566877194,MATH 20B,A02,889994,Ohm; Ko Woon,30,0,30,0
1746566877194,MATH 20B,B01,889996,Ohm; Ko Woon,21,0,30,9
1746566877194,MATH 20B,B02,889997,Ohm; Ko Woon,23,0,30,7
1746566878224,MATH 20C,A01,889999,Hammock; Frances H,17,0,30,13
1746566878224,MATH 20C,A02,890003,Hammock; Frances H,23,0,30,7
1746566878224,MATH 20C,B01,890006,Hammock; Frances H,3,0,30,27
1746566878224,MATH 20C,B02,890007,Hammock; Frances H,12,0,30,18
1746566879258,MATH 20D,A01,890011,Cheng; Hsiao-Bing,1,1,30,29
1746566879258,MATH 20D,A02,890012,Cheng; Hsiao-Bing,14,0,30,16
1746566879258,MATH 20D,B01,890016,Cheng; Hsiao-Bing,13,0,30,17
1746566879258,MATH 20D,B02,890017,Cheng; Hsiao-Bing,13,0,30,17
1746566880284,MATH 20E,A01,890026,Harel; Guershon,1,0,30,29
1746566880284,MATH 20E,A02,890029,Harel; Guershon,23,0,30,7
1746566880284,MATH 20E,B01,890033,Harel; Guershon,7,0,30,23
1746566880284,MATH 20E,B02,890101,Harel; Guershon,21,0,30,9
1746566881311,MATH 102,A01,890104,Staff,17,0,30,13
1746566881311,MATH 102,A02,890105,Staff,27,0,30,3
1746566882343,MATH 103B,A01,890116,Salehi Golsefidy; Alireza,3,0,30,27
1746566882343,MATH 103B,B01,890118,Staff,0,3,34,34
1746566883373,MATH 109,A01,890121,Aliabadi Sr.; Mohsen,1,0,30,29
1746566883373,MATH 109,B01,890124,Upadrashta; Pranav Kumar,18,0,30,12
1746566884401,MATH 120A,A01,890126,Eggers; John Dietrich,13,0,30,17
1746566885427,MATH 142B,A01,890128,Ioana; Adrian,19,0,30,11
1746566885427,MATH 142B,A02,890129,Ioana; Adrian,13,0,30,17
1746566886458,MATH 154,A01,890174,Staff,0,0,30,30
1746566886458,MATH 154,A02,890182,Staff,0,0,30,30
1746566887485,MATH 168A,A01,890197,Dumitriu; Ioana,21,0,35,14
1746566888511,MATH 170A,A01,890240,Nie; Jiawang,1,0,30,29
1746566888511,MATH 170A,A02,890241,Nie; Jiawang,11,0,30,19
1746566888511,MATH 170A,A03,890249,Nie; Jiawang,23,0,30,7
1746566889541,MATH 170B,A01,957891,Nag; Panchali,13,0,35,22
1746566891595,MATH 181A,A01,908025,Staff,0,4,35,35
1746566891595,MATH 181A,A02,960115,Staff,27,0,35,8
1746566892619,MATH 181B,A01,959874,Staff,25,0,30,5
1746566893649,MATH 193B,A01,890265,Staff,0,4,35,35
1746566894676,MGT 4,A01,890311,Anderson; John Charles,42,0,88,46
1746566895703,MGT 5,A00,907740,Staff,13,0,98,85
1746566896734,MGT 12,A00,890312,Lindenberger; Wade Douglas,67,0,98,31
1746566897762,MGT 16,A00,957883,Staff,78,0,98,20
1746566899819,MGT 45,A00,890314,Pecore; Joseph P.,46,0,98,52
1746566900847,MGT 71,A00,890315,Staff,0,11,98,98
1746566901873,MGT 100,A00,890316,Yavorsky; Daniel Ryan,44,0,98,54
1746566902903,MGT 103,A00,890317,Ehrich; Kristine R,73,0,98,25
1746566903927,MGT 105,A00,890356,Bates; Kenneth Walter,0,8,98,98
1746566904952,MGT 112,A00,890360,Ehrich; Kristine R,55,0,98,43
1746566905978,MGT 127R,A00,907732,Zhu; Kevin Xiaoguo,23,0,98,75
1746566907011,MGT 131B,A00,890361,Anderson; John Charles,60,0,98,38
1746566908041,MGT 137,A00,890362,Lindenberger; Wade Douglas,65,0,98,33
1746566909069,MGT 160,A00,890369,Johnson; Erik Barry,9,0,98,89
1746566911175,MGT 164,A00,890372,Zimmermann; Carsten,0,40,98,98
1746566912200,MGT 180,A00,890374,Bliss; Barbara Ann,12,0,98,86
1746566913226,MMW 15,A01,886414,Chang; Edmond Yi-Teh,0,12,28,28
1746566913226,MMW 15,A02,886415,Chang; Edmond Yi-Teh,0,8,28,28
1746566913226,MMW 15,A03,886416,Chang; Edmond Yi-Teh,0,8,28,28
1746566913226,MMW 15,A04,886417,Chang; Edmond Yi-Teh,0,8,28,28
1746566913226,MMW 15,B01,886419,Chang; Edmond Yi-Teh,0,7,28,28
1746566913226,MMW 15,B02,886420,Chang; Edmond Yi-Teh,0,8,28,28
1746566913226,MMW 15,B03,886421,Chang; Edmond Yi-Teh,0,7,28,28
1746566913226,MMW 15,B04,886422,Chang; Edmond Yi-Teh,0,8,28,28
1746566913226,MMW 15,C01,886424,Staff,0,9,28,28
1746566913226,MMW 15,C02,886425,Staff,0,8,28,28
1746566913226,MMW 15,C03,886426,Staff,0,8,28,28
1746566913226,MMW 15,C04,886427,Staff,0,8,28,28
1746566913226,MMW 15,C05,958038,Staff,0,8,28,28
1746566913226,MMW 15,C06,958039,Staff,1,8,28,27
1746566914253,MMW 15GS,A00,906910,Patterson; Patrick H.,4,0,28,24
1746566915284,MMW 122R,A01,886429,Rahimi; Babak,0,13,28,28
1746566915284,MMW 122R,A02,886430,Rahimi; Babak,0,12,28,28
1746566915284,MMW 122R,A03,958040,Rahimi; Babak,0,11,28,28
1746566916314,MUS 1A,A01,890937,Staff,2,0,25,23
1746566916314,MUS 1A,A02,891035,Staff,6,0,25,19
1746566916314,MUS 1A,C01,958912,Staff,24,0,25,1
1746566916314,MUS 1A,C02,958913,Staff,25,0,25,0
1746566918363,MUS 2AK,A00,957092,Ohnishi; Takae,15,0,15,0
1746566919394,MUS 4,A01,891044,Staff,2,0,25,23
1746566919394,MUS 4,A02,891045,Staff,23,0,25,2
1746566919394,MUS 4,B01,891048,Staff,17,0,25,8
1746566919394,MUS 4,B02,891050,Staff,25,0,25,0
1746566920419,MUS 5,A01,957506,Dubnov; Shlomo,0,0,25,25
1746566920419,MUS 5,A02,957622,Dubnov; Shlomo,13,0,25,12
1746566920419,MUS 5,A03,957623,Dubnov; Shlomo,20,0,25,5
1746566921446,MUS 6,A01,891053,Freitas Caetano; Marcelo,24,0,25,1
1746566921446,MUS 6,A02,891054,Freitas Caetano; Marcelo,23,0,25,2
1746566922475,MUS 7,A01,891081,Staff,0,0,25,25
1746566922475,MUS 7,A02,891082,Staff,3,0,25,22
1746566923509,MUS 8GS,A00,891118,Borgo; David Garcia,1,0,25,24
1746566924533,MUS 11,A01,891140,Staff,9,0,25,16
1746566924533,MUS 11,A02,891141,Staff,22,0,25,3
1746566925563,MUS 13,A01,891143,Staff,8,0,25,17
1746566925563,MUS 13,A02,891144,Staff,24,0,25,1
1746566926594,MUS 15,A01,891146,Staff,9,0,25,16
1746566926594,MUS 15,A02,891148,Staff,21,0,25,4
1746566926594,MUS 15,B01,891150,Staff,18,0,25,7
1746566926594,MUS 15,B02,891151,Staff,25,0,25,0
1746566927645,MUS 20,A01,891153,Staff,5,0,20,15
1746566927645,MUS 20,A02,891155,Staff,14,0,20,6
1746566928673,MUS 80,A00,891156,Staff,19,0,25,6
1746566928673,MUS 80,B00,891157,Staff,23,0,25,2
1746566929705,MUS 130,A00,891158,Ohnishi; Takae,35,0,35,0
1746566930730,MUS 150GS,A01,891160,Borgo; David Garcia,1,0,25,24
1746566931759,MUS 170,A01,891162,Freitas Caetano; Marcelo,20,0,25,5
1746566931759,MUS 170,A02,891164,Freitas Caetano; Marcelo,21,0,25,4
1746566932789,NANO 11,A00,886220,Vazquez Mena; Oscar,13,0,15,2
1746566933821,NANO 15,A01,886222,Drews; Aaron,4,0,7,3
1746566934847,NANO 104,A00,886224,Sirbuly; Donald,17,0,25,8
1746566935873,PH 40,A00,886528,Staff,23,0,40,17
1746566936901,PH 45,A01,886799,Staff,35,0,40,5
1746566937927,PH 110,A00,886802,Staff,0,7,40,40
1746566938952,PH 172,A00,906716,Staff,19,0,35,16
1746566939978,PH 191,A00,886803,Staff,6,0,40,34
1746566941007,PHIL 1,A00,889500,Staff,20,0,30,10
1746566942033,PHIL 10,A01,889549,Grush; Rick Scott,15,0,22,7
1746566942033,PHIL 10,A02,889551,Grush; Rick Scott,22,0,22,0
1746566943060,PHIL 28,A01,889559,Lamey; Andy M.,0,2,31,31
1746566943060,PHIL 28,A02,889561,Lamey; Andy M.,0,1,30,30
1746566943060,PHIL 28,A03,889572,Lamey; Andy M.,0,1,30,30
1746566944085,PHIL 35,A00,907839,Staff,13,0,15,2
1746566945113,PHIL 60,A00,889574,Staff,73,0,90,17
1746566946140,PHIL 101,A00,958004,Staff,12,0,15,3
1746566948198,PHIL 136,A00,889582,Fulkerson; Matthew Todd,26,0,45,19
1746566949223,PHIL 163,A01,889601,Staff,21,0,30,9
1746566949223,PHIL 163,B01,889606,Brandt; Reuven A,0,3,0,0
1746566950250,PHIL 164,A00,889610,Staff,16,0,30,14
1746566951281,PHIL 165,A00,889613,Staff,22,0,30,8
1746566952306,PHYS 1A,A00,886431,Staff,26,0,70,44
1746566953335,PHYS 1AL,001,886432,Tsai; Philbert S,0,2,30,30
1746566953335,PHYS 1AL,002,886436,Tsai; Philbert S,11,0,30,19
1746566954364,PHYS 1B,A00,886439,Staff,185,0,240,55
1746566955390,PHYS 1BL,001,886441,Tsai; Philbert S,0,4,30,30
1746566955390,PHYS 1BL,002,886444,Tsai; Philbert S,2,0,30,28
1746566956418,PHYS 1C,A00,896092,Arnold; Kam S,78,0,146,68
1746566957443,PHYS 1CL,001,886448,Tsai; Philbert S,0,0,30,30
1746566957443,PHYS 1CL,002,886449,Tsai; Philbert S,1,0,30,29
1746566957443,PHYS 1CL,003,886450,Tsai; Philbert S,16,0,30,14
1746566957443,PHYS 1CL,004,886451,Tsai; Philbert S,15,0,30,15
1746566958468,PHYS 2B,A01,886457,Staff,68,0,115,47
1746566959497,PHYS 2C,A01,886460,Shotwell; Brian,0,9,65,65
1746566960522,PHYS 2CL,A01,886467,Staff,0,4,28,28
1746566960522,PHYS 2CL,A02,886468,Staff,0,3,28,28
1746566961554,PHYS 2D,A01,886470,Staff,10,0,50,40
1746566962578,PHYS 4B,A01,886475,Grinstein; Benjamin,22,0,40,18
1746566963607,POLI 5,A00,891173,Desposato; Scott,7,0,25,18
1746566964633,POLI 5D,A01,891175,Staff,5,0,5,0
1746566964633,POLI 5D,B01,891178,Staff,5,0,5,0
1746566965661,POLI 11,A00,891179,Ferree; Karen E,2,0,35,33
1746566966685,POLI 12,A00,891180,Staff,16,0,30,14
1746566967708,POLI 27,A01,891182,Staff,12,0,75,63
1746566968737,POLI 30,A00,891183,Staff,8,0,50,42
1746566969765,POLI 100B,A00,891244,Staff,5,1,35,30
1746566970791,POLI 100I,A00,891247,Staff,7,0,30,23
1746566971821,POLI 104J,A00,891248,Nichter; Maysa,14,0,30,16
1746566972851,POLI 104U,A00,891250,Nichter; Maysa,2,0,30,28
1746566974907,POLI 110B,A00,891255,Wiens; David,20,0,25,5
1746566975933,POLI 112A,A00,891256,Wiens; David,6,0,25,19
1746566976963,POLI 114BR,A00,891261,Staff,19,0,30,11
1746566977991,POLI 117R,A00,891262,Forman; Fonna,0,6,50,50
1746566979016,POLI 118,A00,891264,Ingham; Sean,17,0,25,8
1746566980041,POLI 124A,A00,891265,Staff,18,0,20,2
1746566981065,POLI 125D,A00,891266,Nichter; Simeon C,2,0,25,23
1746566982096,POLI 126,A00,891268,Nichter; Simeon C,7,0,25,18
1746566983126,POLI 126AA,A00,891272,Staff,16,0,25,9
1746566984155,POLI 130AA,A00,891273,Staff,15,0,20,5
1746566985181,POLI 134AA,A00,891274,Staff,4,0,20,16
1746566987238,POLI 138,A00,891278,Staff,21,0,25,4
1746566988263,POLI 142K,A00,891280,Staff,10,0,25,15
1746566989296,POLI 142M,A00,891281,Gartzke; Erik,16,0,30,14
1746566990327,POLI 142P,A00,891284,Staff,20,0,30,10
1746566991357,POLI 143,A00,891285,Gartzke; Erik,12,0,30,18
1746566992385,POLI 153,A00,891286,Staff,19,0,20,1
1746566994439,POLI 175,A00,891290,Staff,15,0,20,5
1746566995471,PSYC 1,A00,890674,Steiner; Eric Tomas,0,11,45,45
1746566996499,PSYC 2,A00,890676,Albright; Thomas D,21,0,35,14
1746566997527,PSYC 3,A00,890679,Staff,17,0,20,3
1746566998551,PSYC 6,A00,959858,Staff,20,0,20,0
1746566999582,PSYC 60,A01,890684,Rickard; Timothy C.,0,5,45,45
1746567000614,PSYC 70,A01,890689,Geller; Emma Harlan,7,0,30,23
1746567001639,PSYC 71,A01,959860,Staff,21,0,25,4
1746567002671,PSYC 100,A00,890690,Lacefield; Katharine I,0,50,180,180
1746567003698,PSYC 102,A00,890695,Staff,18,0,40,22
1746567004725,PSYC 105,A00,890699,Geller; Emma Harlan,70,0,100,30
1746567005754,PSYC 106,A00,890701,Gorman; Michael R.,6,0,30,24
1746567006784,PSYC 108,A00,890704,Adrian; Julia Anna,0,28,50,50
1746567007814,PSYC 118,A01,890712,Staff,11,0,30,19
1746567008841,PSYC 124,A00,890716,Chapman; Eddie Nathaniel,25,0,60,35
1746567009867,PSYC 131,A00,890717,Anagnostaras; Stephan,0,8,80,80
1746567010893,PSYC 137,A00,890719,Winkielman; Piotr,0,11,30,30
1746567011918,PSYC 144,A00,890721,Adrian; Julia Anna,0,9,45,45
1746567012943,PSYC 162,A00,890805,Staff,0,0,75,75
1746567013971,PSYC 169,A00,890810,Staff,0,14,30,30
1746567015002,PSYC 172,A00,890814,Gorman; Michael R.,9,0,30,21
1746567016032,PSYC 181,A00,890818,Anagnostaras; Stephan,9,0,200,191
1746567017060,PSYC 184,A00,959861,Staff,168,0,175,7
1746567018084,PSYC 189,A00,890823,Staff,0,1,30,30
1746567019110,PSYC 191,A00,890884,Rickard; Timothy C.,0,11,35,35
1746567020136,PSYC 193,A00,890913,Staff,19,0,30,11
1746567020136,PSYC 193,B00,890914,Chapman; Eddie Nathaniel,24,0,30,6
1746567021162,PSYC 193L,A01,890918,Lowe; Angela Beth,20,0,30,10
1746567021162,PSYC 193L,B01,890921,Hurwitz; Ethan Scott,20,0,30,10
1746567021162,PSYC 193L,C01,890928,Staff,30,0,30,0
1746567022185,RELI 149,A00,886806,Rahimi; Babak,23,0,40,17
1746567023211,SE 9,A01,886814,Staff,7,0,20,13
1746567024240,SE 101B,A01,886816,Chadha; Mayank,4,0,35,31
1746567025272,SE 110B,A00,886818,Zhu; Qiang,4,0,75,71
1746567026295,SE 125,A01,886830,Staff,10,0,30,20
1746567027320,SE 130B,A01,886835,Staff,14,0,40,26
1746567028345,SE 131A,A01,886838,Krysl; Petr,34,0,55,21
1746567029372,SE 154,A00,886840,Staff,29,0,50,21
1746567030402,SE 164GS,A01,886849,Staff,6,0,20,14
1746567031432,SE 167GS,A01,886853,Staff,6,0,20,14
1746567032461,SIO 25,A01,890107,Staff,19,0,30,11
1746567033489,SIO 45,A00,890109,Cook; Geoffrey W,117,0,200,83
1746567034516,SIO 109R,A00,890110,Forman; Fonna,0,16,20,20
1746567035545,SIO 187,A01,890114,Kacev; David,15,0,40,25
1746567036574,SOCI 1,A01,890431,Thorpe; Charles Robert,15,0,30,15
1746567036574,SOCI 1,A02,890518,Thorpe; Charles Robert,30,0,30,0
1746567037604,SOCI 2,A01,957978,Staff,25,0,25,0
1746567037604,SOCI 2,A02,957979,Staff,23,0,25,2
1746567038629,SOCI 20,A01,890523,Calderon-Zaks; Michael Aar,22,0,30,8
1746567038629,SOCI 20,A02,890526,Calderon-Zaks; Michael Aar,29,0,30,1
1746567039654,SOCI 30,A01,890533,Pardo Guerra; Juan Pablo,37,0,40,3
1746567040685,SOCI 40,A01,890535,Staff,27,0,45,18
1746567041710,SOCI 104Q,A00,890559,Staff,18,0,30,12
1746567042739,SOCI 106,A00,890560,Arnal; Maud Marie Leonie,20,0,30,10
1746567043770,SOCI 110,A00,890567,Holkenbrink-Monk; Charlene,19,0,30,11
1746567044799,SOCI 112,A00,890568,Victoria Torres; Pablo,2,0,55,53
1746567045825,SOCI 115,A00,890597,Arnal; Maud Marie Leonie,28,0,45,17
1746567047877,SOCI 121,A00,890604,Pardo Guerra; Juan Pablo,38,0,45,7
1746567048907,SOCI 126,A01,890608,Staff,8,0,10,2
1746567049937,SOCI 127,A00,890609,Staff,18,0,30,12
1746567050963,SOCI 131,A00,890610,Thorpe; Charles Robert,37,0,45,8
1746567051989,SOCI 135,A00,890615,Payne; Christine Anna,13,0,45,32
1746567053015,SOCI 139,A00,890620,Staff,38,0,45,7
1746567054043,SOCI 148E,A00,890622,Calderon-Zaks; Michael Aar,36,0,45,9
1746567055074,SOCI 150,A00,890623,Kohler; Kristopher M.,31,0,45,14
1746567056099,SOCI 157,A00,890625,Jules-Rosette; Bennetta W.,18,0,20,2
1746567057126,SOCI 160,A00,890627,Payne; Christine Anna,21,0,45,24
1746567058155,SYN 1,A00,886855,Fish; Gwendolyn Anne,0,0,0,0
1746567058155,SYN 1,B00,906086,Fish; Gwendolyn Anne,0,2,0,2
1746567059200,SYN 2R,A00,886860,Staff,0,17,15,15
1746567059200,SYN 2R,B00,906106,Atkinson; Arthur Laird,0,16,15,15
1746567060229,SYN 100,A01,886866,Browne; Emily,0,28,20,20
1746567060229,SYN 100,B01,906128,Rock; Martin,0,5,20,20
1746567060229,SYN 100,C01,906140,Deavenport; James Cary,0,3,20,20
1746567060229,SYN 100,D01,907816,Deavenport; James Cary,0,5,20,20
1746567061253,TDAC 1,A00,890286,Walsh; Kim C.,8,0,20,12
1746567062286,TDAC 101,A00,890296,Basso; Beatrice,15,0,20,5
1746567063318,TDDE 131,A00,890297,Staff,47,0,50,3
1746567064349,TDDM 1,A00,890287,Weinberg; Sadie,25,0,30,5
1746567065385,TDGE 11,A00,890288,Fulton; Julia,137,0,200,63
1746567065385,TDGE 11,B00,890289,Castro; Robert Jess,184,0,200,16
1746567066413,TDGE 25,B00,957359,Walsh; Kim C.,4,0,20,16
1746567067442,TDGE 40,A01,890292,Power; Jade Yukana,27,0,30,3
1746567068473,TDGE 124,A00,890298,Havis; Allan,0,1,50,50
1746567069499,TDGE 131R,A00,890299,Burelle; Julie Sara Veronique,15,0,42,27
1746567070525,TDHT 101,A00,890300,Staff,10,0,20,10
1746567071553,TDHT 109,A01,890302,Anderson; Mysia Anyse,31,0,40,9
1746567072578,TDMV 1,A00,890293,Arcidiacono; Kristin,18,0,30,12
1746567073609,TDMV 2,A00,890294,Weinberg; Sadie,23,0,30,7
1746567074633,TDMV 3,A00,957878,Arcidiacono; Kristin,28,0,30,2
1746567076690,TDMV 138,A00,890304,Jun; Grace Shin Hae,25,0,40,15
1746567077724,TDMV 140,A00,890305,Corrales; Joseph Bernales,25,0,30,5
1746567078752,TDMV 142,A00,890307,Caligagan; Tony,32,0,40,8
1746567079779,TDMV 144,A00,890308,Camaya; Michelle Ann,25,0,30,5
1746567080807,TDPW 1,A00,890295,Stein; Deborah Isobel,3,0,20,17
1746567081832,USP 2,A01,890272,Lerner; Amy M,6,0,20,14
1746567082865,USP 3,A01,890274,Staff,12,0,30,18
1746567083899,USP 15,A01,890276,Sun; Feiyang,16,0,30,14
1746567084930,USP 25,A00,890277,Shenkman; Michael Thomas,19,0,25,6
1746567085960,USP 138,A00,890278,Staff,14,0,25,11
1746567086987,USP 143,A00,890279,Staff,22,0,70,48
1746567088016,USP 144,A00,890280,Chowdhury; Muhammed Zohir,16,0,30,14
1746567089046,USP 150,A00,890281,Boomhower; Matthew Charles,4,0,30,26
1746567090074,USP 151,A00,890282,Staff,16,0,20,4
1746567091103,USP 162,A00,890283,Andrews; Abigail Leslie,16,0,20,4
1746567092132,USP 168,A00,920477,Kwak; Nancy,0,0,5,5
1746567093159,USP 181,A00,890284,Staff,3,0,20,17
1746567094188,USP 191A,A00,890285,Staff,12,0,20,8
1746567095213,VIS 101,A00,886512,Staff,26,0,75,49
1746567096241,VIS 103,A00,886513,Cruz; Edwin Teddy,61,0,75,14
1746567097274,VIS 108,A00,886514,Staff,3,0,15,12
1746567098298,VIS 127P,A00,886515,Shen; Kuiyi,80,0,146,66
1746567099327,VIS 149,A00,886516,Yoldas; Pinar,0,0,15,15
1746567100358,VIS 164,A00,886526,Erdmann; Dean,19,0,22,3
1746567101387,VIS 194S,A00,886527,Staff,61,0,75,14
1746567102416,WCWP 10A,C00,886484,Martiniuk; Jill,12,0,15,3
1746567103441,WCWP 10B,A00,886490,Uriarte; Emma,0,0,15,15
1746567103441,WCWP 10B,B00,886491,Dhir; Simrita,10,0,15,5
1746567103441,WCWP 10B,C00,886492,Ornelas; Tricia,0,0,15,15
1746567104469,WCWP 100,A00,886494,Young; Mark T,0,6,15,15
1746567106585,AAS 10,A01,886199,Childs; Dennis R.,0,3,0,0
1746567107613,ANAR 104,A01,886940,Shtienberg; Gilad,27,0,30,3
1746567108641,ANAR 120,A00,886953,Staff,12,0,20,8
1746567109665,ANBI 148,A01,886955,Wilder; Linnea Lorene,30,0,40,10
1746567111721,ANSC 122,A00,886957,Staff,25,0,30,5
1746567112750,ANSC 150,A00,886958,Sloane; Julia Kathryn,2,0,15,13
1746567113775,ANSC 156,A00,886959,Jenkins; Janis A.,0,1,15,15
1746567114800,ANSC 180,A00,886960,Staff,11,0,17,6
1746567115829,ANSC 188,A00,886961,Jassal; Aftab,9,0,25,16
1746567116854,ANSC 190,A00,886962,Jassal; Aftab,14,0,25,11
1746567117879,ANSC 191,A00,886963,Staff,18,0,20,2
1746567118910,ANTH 3,A01,891689,Staff,17,0,20,3
1746567119937,ANTH 5,A00,886933,Semendeferi; Ekaterini,16,0,20,4
1746567120975,ANTH 10,A00,886934,Staff,0,12,30,30
1746567122003,ANTH 21,A01,886936,Staff,41,0,60,19
1746567123028,ANTH 23,A01,886938,Staff,92,0,100,8
1746567124056,ANTH 105,A00,886964,Stewart; Alexander B,84,0,100,16
1746567125082,ANTH 108,A00,886965,Pedersen; David,9,0,20,11
1746567126118,AWP 10,001,886147,Staff,0,0,0,0
1746567126118,AWP 10,002,886148,Staff,0,0,0,0
1746567126118,AWP 10,003,886149,Staff,0,0,0,0
1746567126118,AWP 10,004,886150,Staff,0,0,0,0
1746567126118,AWP 10,005,886151,Staff,0,0,0,0
1746567126118,AWP 10,006,886152,Staff,0,0,0,0
1746567126118,AWP 10,007,886153,Staff,0,0,0,0
1746567126118,AWP 10,008,886154,Staff,0,0,0,0
1746567126118,AWP 10,009,886155,Staff,0,0,0,0
1746567126118,AWP 10,010,886156,Staff,0,0,0,0
1746567126118,AWP 10,011,886158,Staff,0,0,0,0
1746567126118,AWP 10,012,886160,Staff,0,0,0,0
1746567126118,AWP 10,013,886161,Staff,0,0,0,0
1746567126118,AWP 10,014,886162,Staff,0,0,0,0
1746567126118,AWP 10,015,886163,Staff,0,0,0,0
1746567126118,AWP 10,016,886164,Staff,0,0,0,0
1746567126118,AWP 10,017,886165,Staff,0,0,0,0
1746567126118,AWP 10,018,886166,Staff,0,0,0,0
1746567126118,AWP 10,019,886168,Staff,0,0,0,0
1746567126118,AWP 10,020,886170,Staff,0,0,0,0
1746567126118,AWP 10,021,886172,Staff,0,0,0,0
1746567127153,AWP 10R,001,886173,Staff,0,1,0,0
1746567127153,AWP 10R,002,886174,Staff,0,1,0,0
1746567127153,AWP 10R,003,886175,Staff,0,0,0,0
1746567127153,AWP 10R,004,886176,Staff,0,0,0,0
1746567127153,AWP 10R,005,886177,Staff,0,0,0,0
1746567127153,AWP 10R,006,886178,Staff,0,0,0,0
1746567127153,AWP 10R,007,886179,Staff,0,0,0,0
1746567127153,AWP 10R,008,886181,Staff,0,0,0,0
1746567127153,AWP 10R,009,886182,Staff,0,0,0,0
1746567127153,AWP 10R,010,886183,Staff,0,0,0,0
1746567127153,AWP 10R,011,886184,Staff,0,0,0,0
1746567127153,AWP 10R,012,886185,Staff,0,0,0,0
1746567127153,AWP 10R,013,886186,Staff,0,0,0,0
1746567127153,AWP 10R,014,886187,Staff,0,0,0,0
1746567127153,AWP 10R,015,886188,Staff,0,0,0,0
1746567127153,AWP 10R,016,886189,Staff,0,0,0,0
1746567127153,AWP 10R,017,960532,Staff,0,0,0,0
1746567127153,AWP 10R,018,960533,Staff,0,0,0,0
1746567127153,AWP 10R,019,960534,Staff,0,0,0,0
1746567127153,AWP 10R,020,960538,Staff,0,0,0,0
1746567127153,AWP 10R,021,960540,Staff,0,0,0,0
1746567127153,AWP 10R,022,960541,Staff,0,0,0,0
1746567127153,AWP 10R,023,960542,Staff,0,0,0,0
1746567127153,AWP 10R,024,960544,Staff,0,0,0,0
1746567127153,AWP 10R,025,960545,Staff,0,0,0,0
1746567127153,AWP 10R,026,960548,Staff,0,0,0,0
1746567128177,AWP 102R,A00,886190,Staff,0,0,0,0
1746567128177,AWP 102R,B00,886191,Staff,0,0,0,0
1746567129205,BENG 100,A01,886193,Staff,17,0,30,13
1746567130231,BENG 122A,A01,886195,Hasty; Jeff M,13,0,30,17
1746567131257,BENG 166A,A00,886196,Sah; Robert Lie-Yuan,0,2,30,30
1746567132287,BENG 190,A00,958050,Khojah; Reem I,20,0,25,5
1746567133321,BIBC 102,A01,894320,Staff,0,0,46,46
1746567133321,BIBC 102,A02,894321,Staff,0,0,46,46
1746567133321,BIBC 102,A03,894344,Staff,7,0,46,39
1746567133321,BIBC 102,A04,894345,Staff,26,0,47,21
1746567134351,BICD 100R,A01,894365,Smith; Laurie,0,3,58,58
1746567134351,BICD 100R,A02,894366,Smith; Laurie,0,5,58,58
1746567134351,BICD 100R,A03,894367,Smith; Laurie,0,0,59,59
1746567134351,BICD 100R,A04,959869,Smith; Laurie,40,0,59,19
1746567135377,BICD 136,A01,894383,Gustafson-Brown; Cindy,14,0,50,36
1746567136402,BIEB 102,A01,894494,Butler; Shannon Rhey,51,0,130,79
1746567138461,BIEB 150,A01,894617,Wills; Christopher,3,0,20,17
1746567138461,BIEB 150,A02,894631,Wills; Christopher,3,0,20,17
1746567138461,BIEB 150,A03,894937,Wills; Christopher,3,0,20,17
1746567138461,BIEB 150,A04,894946,Wills; Christopher,5,0,20,15
1746567139493,BIEB 194,A00,906141,Kurle; Carolyn M.,6,0,20,14
1746567140523,BILD 1,A01,894154,Staff,3,0,19,16
1746567140523,BILD 1,A02,894155,Staff,14,0,19,5
1746567140523,BILD 1,A03,894160,Staff,13,0,19,6
1746567140523,BILD 1,A04,894161,Staff,15,0,18,3
1746567141552,BILD 2,A01,894168,Staff,0,0,50,50
1746567141552,BILD 2,A02,894169,Staff,0,0,50,50
1746567141552,BILD 2,A03,894179,Staff,0,0,50,50
1746567141552,BILD 2,A04,894203,Staff,25,0,50,25
1746567142582,BILD 3,A01,894213,Staff,22,0,31,9
1746567142582,BILD 3,A02,894214,Staff,26,0,31,5
1746567142582,BILD 3,A03,894235,Staff,28,0,31,3
1746567142582,BILD 3,A04,894236,Staff,28,0,32,4
1746567143612,BILD 4,A01,894253,Reuther; Keefe,6,0,24,18
1746567143612,BILD 4,A02,894258,Reuther; Keefe,16,0,24,8
1746567144644,BILD 5,A01,894276,Reuther; Keefe,35,0,50,15
1746567144644,BILD 5,A02,894277,Reuther; Keefe,45,0,50,5
1746567144644,BILD 5,A03,894290,Reuther; Keefe,44,0,50,6
1746567144644,BILD 5,A04,894291,Reuther; Keefe,48,0,50,2
1746567145673,BILD 24,A01,894297,Pirino; Giorgia,40,0,60,20
1746567146702,BIMM 100,B01,958915,Staff,71,0,100,29
1746567147727,BIMM 101,A01,895017,McDonnell; Lisa Marie,0,5,24,24
1746567147727,BIMM 101,A02,895018,McDonnell; Lisa Marie,0,5,24,24
1746567147727,BIMM 101,B01,895020,McDonnell; Lisa Marie,0,6,24,24
1746567147727,BIMM 101,B02,895021,McDonnell; Lisa Marie,0,4,24,24
1746567148755,BIMM 110,A01,895023,Staff,1,0,25,24
1746567148755,BIMM 110,A02,895024,Staff,9,0,25,16
1746567148755,BIMM 110,A03,895025,Staff,18,0,25,7
1746567148755,BIMM 110,A04,895031,Staff,20,0,25,5
1746567149782,BIMM 120,A01,895114,Gustafson-Brown; Cindy,14,0,28,14
1746567149782,BIMM 120,A02,895126,Gustafson-Brown; Cindy,21,0,27,6
1746567150809,BIPN 100,A01,895130,Yang; Mingyu,1,0,38,37
1746567150809,BIPN 100,A02,895131,Yang; Mingyu,32,0,38,6
1746567150809,BIPN 100,A03,895132,Yang; Mingyu,32,0,38,6
1746567150809,BIPN 100,A04,895133,Yang; Mingyu,27,0,36,9
1746567151835,BIPN 120,A01,895135,Cooke; James Edward,0,3,13,13
1746567151835,BIPN 120,A02,895136,Cooke; James Edward,0,1,13,13
1746567151835,BIPN 120,A03,895137,Cooke; James Edward,0,3,13,13
1746567151835,BIPN 120,A04,895156,Cooke; James Edward,0,2,11,11
1746567152865,BIPN 134,A01,895235,Cooke; James Edward,0,2,25,25
1746567152865,BIPN 134,A02,895237,Cooke; James Edward,0,0,25,25
1746567152865,BIPN 134,A03,895240,Cooke; James Edward,3,0,25,22
1746567152865,BIPN 134,A04,895270,Cooke; James Edward,20,0,25,5
1746567153891,BIPN 189,A00,892103,Staff,0,13,14,14
1746567155944,BISP 194,A00,958008,Staff,0,2,0,0
1746567156968,CAT 124,A01,922009,Staff,0,5,20,20
1746567158000,CAT 125R,A00,886390,Morales; Celeste Georgianna,0,2,20,20
1746567158000,CAT 125R,B00,886391,Irwin; Matthew Joseph,0,4,20,20
1746567158000,CAT 125R,C00,886392,Smith; Lauryn Alissa,0,2,20,20
1746567158000,CAT 125R,D00,886393,Vanderschuit; Maya Alysia,0,3,20,20
1746567158000,CAT 125R,E00,886394,Marchisotto; Jennifer Anne,0,3,20,20
1746567159026,CENG 15,A01,886218,Drews; Aaron,3,0,8,5
1746567160055,CENG 113,A00,886219,Opatkiewicz; Justin Paul,15,0,25,10
1746567161081,CGS 101,A00,887044,Staff,7,0,20,13
1746567162106,CGS 105,A01,887046,Staff,14,0,25,11
1746567163131,CGS 112,A00,887047,Cuong; Marisol,12,0,15,3
1746567164156,CGS 113,A00,887048,Staff,23,0,30,7
1746567165185,CGS 120,A00,887049,Staff,10,0,17,7
1746567166210,CHEM 6A,A01,886336,Lam; Tin Yiu,38,0,50,12
1746567166210,CHEM 6A,A02,886338,Lam; Tin Yiu,37,0,50,13
1746567167235,CHEM 6B,A01,886341,Hopkins; Patrycja Anna,16,0,50,34
1746567167235,CHEM 6B,A02,886343,Hopkins; Patrycja Anna,42,0,50,8
1746567168261,CHEM 6C,A01,886346,Albizati; Kim F.,0,2,50,50
1746567168261,CHEM 6C,A02,886348,Albizati; Kim F.,23,0,50,27
1746567169304,CHEM 40A,A01,886352,Klosterman; Jeremy K,65,0,100,35
1746567170334,CHEM 40B,A01,886356,Klosterman; Jeremy K,0,23,100,100
1746567171361,CHEM 41B,A01,886360,Theodorakis; Emmanuel,25,0,50,25
1746567171361,CHEM 41B,A02,886362,Theodorakis; Emmanuel,47,0,50,3
1746567172386,CHIN 165A,A00,886382,Xu; Li,18,0,20,2
1746567173412,CLAS 120,A00,886387,Myerston Santana; Jacobo,33,0,40,7
1746567174442,COGS 9,A01,886967,Shannon; Kyle Michael,42,0,60,18
1746567175466,COGS 11,A01,886969,Staff,10,0,30,20
1746567176495,COGS 14A,A01,886971,Staff,6,0,60,54
1746567177519,COGS 14B,A01,886973,Hoffman; Drew Ellen,4,0,60,56
1746567178548,COGS 18,A01,886975,Morgan; Eric,35,0,60,25
1746567179574,COGS 20,A01,886977,Staff,4,0,8,4
1746567179574,COGS 20,A02,886978,Staff,5,0,7,2
1746567180599,COGS 100,A01,907783,Staff,1,2,30,29
1746567181626,COGS 101B,A01,886980,Staff,0,3,48,48
1746567182652,COGS 101C,A01,886982,Delgado; Tania,0,5,44,44
1746567183678,COGS 102A,A01,886984,Johnson; Christine M.,4,0,30,26
1746567184704,COGS 118B,A01,886986,Staff,1,3,88,87
1746567185729,COGS 150,A01,886988,Bergen; Benjamin,22,0,50,28
1746567186753,COGS 153,A00,886989,Delgado; Tania,0,2,41,41
1746567187778,COGS 186,A01,886991,Staff,0,0,32,32
1746567188808,COGS 187A,A01,886993,Boyle; Mary E. T.,7,0,30,23
1746567189831,COGS 189,A00,886994,Staff,0,1,30,30
1746567190858,COMM 10,A01,886996,Staff,0,0,20,21
1746567190858,COMM 10,A02,886997,Staff,12,0,20,8
1746567190858,COMM 10,A03,959845,Staff,19,0,20,1
1746567191888,COMM 20,A01,886999,Leuning; Grant Maurstad,24,0,40,16
1746567193939,COMM 100A,A01,887002,Staff,0,0,20,25
1746567193939,COMM 100A,A02,887003,Staff,6,0,20,14
1746567194965,COMM 100B,A01,887005,Staff,0,8,20,24
1746567196009,COMM 106D,A00,887006,Staff,13,0,40,27
1746567197036,COMM 110G,A00,887007,Whitworth-Smith; Andrew C,12,0,40,28
1746567198062,COMM 111B,A00,887008,Staff,31,0,40,9
1746567199088,COMM 113T,A00,887009,Abuelhiga; Soraya Jill,28,0,40,12
1746567199088,COMM 113T,B00,906733,Staff,40,0,40,0
1746567200118,COMM 145,A00,887010,Staff,12,0,40,28
1746567201142,COMM 146,A00,887054,Staff,31,0,40,9
1746567202170,COMM 190,A00,887012,Staff,8,0,23,15
1746567203195,CSE 8A,A50,887015,Cao; Yingjun,57,0,85,28
1746567204218,CSE 11,A01,887017,Cao; Yingjun,12,0,70,58
1746567205248,CSE 20,A01,887019,Staff,30,0,50,20
1746567206274,CSE 21,A01,887021,Staff,78,0,100,22
1746567206274,CSE 21,B01,892583,Braun; Oliver,45,0,50,5
1746567207298,CSE 30,A01,887025,Eldon; John,143,0,200,57
1746567208327,CSE 100,A01,887027,Staff,26,0,50,24
1746567208327,CSE 100,A02,887028,Staff,42,0,50,8
1746567209358,CSE 101,A01,887030,Braun; Oliver,74,0,100,26
1746567209358,CSE 101,B01,887032,Jones; Miles E,0,3,50,50
1746567209358,CSE 101,B02,887033,Jones; Miles E,0,2,50,50
1746567210383,CSE 105,A01,908084,Jones; Miles E,32,0,50,18
1746567210383,CSE 105,A02,908087,Jones; Miles E,32,0,50,18
1746567211407,CSE 135,A01,887035,Powell; Thomas Allan,0,5,50,50
1746567212436,CSE 142,A01,887037,Staff,8,0,60,52
1746567213461,CSE 142L,A01,887039,Staff,34,0,60,26
1746567214485,CSE 151A,A01,887041,Solares; Edwin A,47,0,100,53
1746567215516,CSE 175,A01,887043,Kumar; Rakesh,30,0,30,0
1746567216544,CSS 1,A01,886389,Staff,1,1,40,39
1746567217568,DSC 30,A01,908097,Liao; Soohyun Nam,47,0,75,28
1746567218595,DSC 40A,A01,908099,Shannon; Kyle Michael,30,0,50,20
1746567219623,DSC 40B,A01,908112,Staff,15,0,50,35
1746567220649,DSC 80,A01,908116,Staff,19,0,60,41
1746567221682,DSC 197,001,956863,Eldridge; Justin Matthew,9999,0,9999,0
1746567222711,ECE 5,A01,886400,Morris; Karcher William,1,0,6,5
1746567222711,ECE 5,A02,886401,Morris; Karcher William,3,0,6,3
1746567223737,ECE 148,A01,886403,Silberman; Jack,0,14,14,14
1746567224764,ECON 1,A01,887265,Crane; Meredith Helen,12,0,70,58
1746567224764,ECON 1,B01,887268,Staff,43,0,50,7
1746567225791,ECON 2,A01,887273,Crane; Meredith Helen,55,0,70,15
1746567226821,ECON 3,A01,887279,Rondina; Giacomo,32,0,70,38
1746567227847,ECON 4,A01,887282,Anderson; John Charles,0,2,10,10
1746567228872,ECON 5,A01,887285,Staff,34,0,45,11
1746567228872,ECON 5,B01,887292,Staff,41,0,45,4
1746567229899,ECON 100A,A01,887337,Newhouse; Herbert S,54,0,70,16
1746567229899,ECON 100A,B01,887349,Staff,45,0,50,5
1746567230924,ECON 100B,A01,887361,Du; Songzi,29,0,70,41
1746567231956,ECON 100C,A01,887445,Newhouse; Herbert S,59,0,70,11
1746567232983,ECON 105,A00,887488,Vespa; Emanuel Ignacio,23,0,35,12
1746567234008,ECON 109,A01,887506,Shishkin; Denis,28,0,35,7
1746567235040,ECON 110A,A01,887568,Alon; Titan Michael,0,3,35,35
1746567235040,ECON 110A,B01,907601,Alon; Titan Michael,20,0,35,15
1746567236068,ECON 110B,A01,887598,Levkoff; Steven B.,0,24,70,70
1746567237094,ECON 112,A00,887599,Rondina; Giacomo,19,0,35,16
1746567238154,ECON 120A,A01,887603,Dai; Yinlin,35,0,70,35
1746567239181,ECON 120C,A01,887608,Sun; Yixiao,0,1,35,35
1746567239181,ECON 120C,B01,887614,Sun; Yixiao,0,0,35,35
1746567240210,ECON 138,A00,887621,Bharadwaj; Prashant,0,21,20,20
1746567241238,ECON 144,A00,958007,Squires; Dale E,13,0,35,22
1746567242270,ECON 171,A01,907666,Staff,18,0,35,17
1746567243302,ECON 175,A00,887626,Wu; Pak Yeung,23,0,35,12
1746567244328,ECON 190,A00,887640,Vespa; Emanuel Ignacio,23,0,35,12
1746567245366,EDS 25,A01,888197,Staff,0,0,0,0
1746567245366,EDS 25,A02,888209,Staff,0,0,0,0
1746567245366,EDS 25,A03,888210,Staff,0,0,0,0
1746567245366,EDS 25,A04,888212,Staff,0,0,0,0
1746567245366,EDS 25,A05,888213,Staff,0,0,0,0
1746567245366,EDS 25,A06,888214,Staff,0,0,0,0
1746567245366,EDS 25,A07,888235,Staff,0,2,0,0
1746567245366,EDS 25,A08,888236,Staff,0,0,0,0
1746567245366,EDS 25,A09,888240,Staff,0,0,0,0
1746567245366,EDS 25,A10,888244,Staff,0,0,0,0
1746567245366,EDS 25,B01,888273,Staff,0,0,0,0
1746567245366,EDS 25,B02,888285,Staff,0,0,0,0
1746567245366,EDS 25,B03,888423,Staff,0,0,0,1
1746567245366,EDS 25,B04,888432,Staff,0,0,0,0
1746567245366,EDS 25,B05,888433,Staff,0,0,0,0
1746567245366,EDS 25,B06,888467,Staff,0,0,0,0
1746567245366,EDS 25,B07,888468,Staff,0,0,0,0
1746567245366,EDS 25,B08,888479,Staff,0,0,0,0
1746567245366,EDS 25,B09,888484,Staff,0,0,0,0
1746567245366,EDS 25,B10,888487,Staff,0,0,0,0
1746567246393,EDS 38,A01,907700,Choi; Bailey Miyeon,30,0,30,0
1746567247429,EDS 112,A01,888601,Chapman; Thandeka K,12,0,40,28
1746567248455,EDS 115,A00,888697,Mendez; Kathrina Mendoza,10,0,30,20
1746567249481,EDS 116,A01,888893,Staff,35,0,40,5
1746567251534,EDS 124AR,A00,889133,Staff,29,0,50,21
1746567251534,EDS 124AR,B00,907471,Simon; Elizabeth A,36,0,50,14
1746567252563,EDS 124BR,A00,889134,Simon; Elizabeth A,43,0,100,57
1746567253590,EDS 125,A00,889135,Staff,25,0,30,5
1746567254616,EDS 126,A01,889138,Staff,36,0,40,4
1746567255641,EDS 164R,A01,889142,Wishard Guerra; Alison G.,33,0,50,17
1746567256667,ENG 30,A01,886396,Staff,0,0,0,0
1746567256667,ENG 30,B01,886398,Staff,0,0,0,0
1746567257692,ENVR 102,A00,906150,Montejo; Carolina,23,0,25,2
1746567258718,ETHN 103A,A00,887236,Man; Simeon S,0,3,0,0
1746567259747,ETHN 113,A00,887239,Staff,16,0,30,14
1746567260772,ETHN 116,A00,887240,Staff,16,0,25,9
1746567261797,ETHN 117,A00,887241,Choi; Esther Min,28,0,30,2
1746567262822,ETHN 118,A00,887243,Staff,24,0,30,6
1746567263852,ETHN 127,A00,887248,Cuong; Marisol,11,0,15,4
1746567264881,ETHN 139,A00,887250,Staff,7,0,10,3
1746567265909,ETHN 142,A00,887252,Staff,10,0,30,20
1746567266934,ETHN 161,A00,887253,Browne; Errol Tsekani,24,0,30,6
1746567267959,ETHN 163FR,A00,887255,Burelle; Julie Sara Veronique,0,0,5,5
1746567268984,GLBH 20,A00,889149,Elwardani; Nile Regina,8,0,42,34
1746567271041,GLBH 111,A01,889152,Burgos; Jose L.,17,0,17,0
1746567272070,GLBH 150,A00,889181,Sloane; Julia Kathryn,0,5,15,15
1746567274121,HDS 60,A01,886406,Warstadt; Melissa Fawn,73,0,80,7
1746567275146,HIAF 111,A00,889324,Gyamfi; Bright,25,0,32,7
1746567276173,HIEA 131,A00,889328,Staff,15,0,32,17
1746567277202,HIEA 144,A00,889333,Henry; Todd A.,26,0,32,6
1746567278233,HIEA 154,A00,889336,Henry; Todd A.,24,0,32,8
1746567279260,HIEU 106,A00,889339,Staff,22,0,32,10
1746567281310,HIEU 114,A00,889340,Staff,3,0,32,29
1746567282338,HIEU 135GS,A00,889342,Patterson; Patrick H.,0,0,1,24
1746567283365,HIEU 137,A00,889343,Edington; Claire Ellen,10,0,25,15
1746567284394,HIEU 148,A00,889345,Staff,14,0,32,18
1746567285421,HIEU 154,A00,889346,Biess; Frank Peter,21,0,32,11
1746567286446,HILA 102,A00,889351,Staff,12,0,32,20
1746567287477,HILD 2A,A01,889221,Lewandoski; Julia Mavis,1,10,32,31
1746567288507,HILD 7B,A01,889225,Man; Simeon S,0,12,32,32
1746567289536,HILD 7C,A01,889288,Alvarez; Luis A,0,14,32,32
1746567290566,HILD 30,A01,889323,Staff,0,5,32,32
1746567292621,HISC 119,A00,889383,Golan; Tal,19,0,32,13
1746567293647,HIUS 103,A00,889384,Man; Simeon S,0,0,32,32
1746567294672,HIUS 117,A00,919797,Kwak; Nancy,19,0,32,13
1746567295701,HIUS 142A,A00,919788,Staff,22,0,32,10
1746567297758,HIUS 149,A00,889386,Gyamfi; Bright,26,0,32,6
1746567298787,HIUS 155,A00,889387,Alvarez; Luis A,14,0,32,18
1746567299816,HUM 3,A01,886499,Caldwell; Michael Alan,19,0,50,31
1746567300841,HUM 3GS,A00,886500,Rodriguez; Bretton Sigfred,0,0,0,28
1746567301869,HUM 3R,A01,886502,Markman; Kristina,0,36,50,50
1746567302894,HUM 4,A01,886504,Crum; Matthew Stephen,24,0,50,26
1746567302894,HUM 4,B01,886506,West; Geoffrey Scott,17,0,50,33
1746567303925,HUM 4GS,A00,886507,Staff,0,0,0,19
1746567304953,HUM 5,A01,886509,Staff,32,0,50,18
1746567305984,HUM 5R,A01,886511,Zavodny; Tatiana Sophia,0,39,50,50
1746567307013,JAPN 180,A00,886407,Staff,16,0,40,24
1746567308042,LATI 50,A01,886409,Martin-Cabrera; Luis,4,0,22,18
1746567308042,LATI 50,A02,886410,Martin-Cabrera; Luis,19,0,22,3
1746567308042,LATI 50,A03,886411,Martin-Cabrera; Luis,21,0,22,1
1746567308042,LATI 50,A04,886412,Martin-Cabrera; Luis,9,0,22,13
1746567309067,LAWS 101,A00,907664,Staff,28,0,60,32
1746567310096,LIAB 1A,A00,889388,Saab; Dima,17,0,20,3
1746567311123,LIAB 1AX,A00,889389,El Cheddadi; Youniss,18,0,20,2
1746567312149,LIFR 1C,A00,889391,Van Moer; Vinciane G,8,0,20,12
1746567313176,LIFR 1CX,A00,889392,Van Moer; Vinciane G,7,0,20,13
1746567314202,LIFR 1D,A00,889393,Van Moer; Vinciane G,7,0,20,13
1746567315233,LIFR 1DX,A00,889394,Van Moer; Vinciane G,8,0,20,12
1746567316266,LIGN 7,A00,886923,Staff,24,0,50,26
1746567317297,LIGN 17,A00,886924,Kehler; Andrew Scott,125,0,150,25
1746567318324,LTAM 110,A00,889395,Staff,15,0,30,15
1746567319351,LTAM 110GS,A00,958010,Rodriguez; Bretton Sigfred,0,0,0,28
1746567320382,LTCH 101,A00,889397,Staff,23,0,25,2
1746567321410,LTCS 130,A00,889398,Staff,23,0,25,2
1746567322435,LTEA 138,A00,889399,Staff,24,0,40,16
1746567323476,LTEN 149,A00,889400,Wesling; Megan E.,0,3,25,25
1746567324501,LTEN 169,A00,889401,Staff,20,0,25,5
1746567325533,LTEN 180,A00,889402,Staff,10,0,15,5
1746567326564,LTEN 181,A00,889403,Staff,21,0,25,4
1746567327588,LTWL 100,A00,889404,Myerston Santana; Jacobo,2,0,25,23
1746567328616,LTWL 180GS,A00,889405,Staff,0,0,20,20
1746567329642,LTWL 181,A00,889406,Staff,16,0,25,9
1746567330671,LTWL 184,A00,889475,Mukherjee; Silpa,22,0,25,3
1746567331703,LTWR 102C,A00,889486,Staff,29,0,30,1
1746567332731,LTWR 115W,A00,889491,Staff,0,2,15,15
1746567333758,MAE 8,A01,886905,Staff,0,2,0,0
1746567334785,MAE 11,A00,886906,Bandaru; Prabhakar,0,7,50,50
1746567335814,MAE 20,A00,886907,Evdokimenko; Ekaterina,43,0,70,27
1746567336842,MAE 30B,A00,886909,Ghazinejad; Maziar,26,0,45,19
1746567337868,MAE 101B,A00,886910,Saintillan; David,29,0,45,16
1746567338898,MAE 105,A00,886911,Bandaru; Prabhakar,18,0,50,32
1746567339926,MAE 107,B00,958024,Staff,8,0,50,42
1746567340958,MAE 143B,A00,886913,Bewley; Thomas R,6,0,40,34
1746567341990,MAE 148,A01,886915,Silberman; Jack,0,3,14,14
1746567343015,MAE 160,A00,886916,Evdokimenko; Ekaterina,31,0,60,29
1746567344043,MATH 3C,A01,889681,Staff,0,2,30,30
1746567344043,MATH 3C,A02,960048,Staff,24,0,30,6
1746567345071,MATH 10A,A01,889760,Staff,26,0,30,4
1746567345071,MATH 10A,A02,889783,Staff,29,0,30,1
1746567346096,MATH 10B,A01,889785,Verstraete; Jacques Allan,2,0,35,33
1746567346096,MATH 10B,A02,889795,Verstraete; Jacques Allan,4,0,35,31
1746567346096,MATH 10B,B01,889797,Verstraete; Jacques Allan,3,0,35,32
1746567346096,MATH 10B,B02,889828,Verstraete; Jacques Allan,3,0,35,32
1746567347130,MATH 10C,A01,889849,Habib; Yousaf,7,0,30,23
1746567347130,MATH 10C,A02,889852,Habib; Yousaf,14,0,30,16
1746567347130,MATH 10C,A03,889853,Habib; Yousaf,22,0,30,8
1746567347130,MATH 10C,A04,889858,Habib; Yousaf,20,0,30,10
1746567347130,MATH 10C,B01,889861,Staff,1,0,30,29
1746567347130,MATH 10C,B02,889862,Staff,24,0,30,6
1746567347130,MATH 10C,B03,889863,Staff,27,0,30,3
1746567347130,MATH 10C,B04,889967,Staff,23,0,30,7
1746567348161,MATH 18,A01,889974,Staff,7,0,30,23
1746567348161,MATH 18,A02,889977,Staff,20,0,30,10
1746567348161,MATH 18,B01,889984,Hardiman; Liam,21,0,30,9
1746567348161,MATH 18,B02,889985,Hardiman; Liam,25,0,30,5
1746567349186,MATH 20A,A01,889990,Suk; Andrew Hoon,30,0,35,5
1746567350216,MATH 20B,A01,889993,Ohm; Ko Woon,22,0,30,8
1746567350216,MATH 20B,A02,889994,Ohm; Ko Woon,30,0,30,0
1746567350216,MATH 20B,B01,889996,Ohm; Ko Woon,21,0,30,9
1746567350216,MATH 20B,B02,889997,Ohm; Ko Woon,23,0,30,7
1746567351243,MATH 20C,A01,889999,Hammock; Frances H,17,0,30,13
1746567351243,MATH 20C,A02,890003,Hammock; Frances H,23,0,30,7
1746567351243,MATH 20C,B01,890006,Hammock; Frances H,3,0,30,27
1746567351243,MATH 20C,B02,890007,Hammock; Frances H,12,0,30,18
1746567352271,MATH 20D,A01,890011,Cheng; Hsiao-Bing,1,1,30,29
1746567352271,MATH 20D,A02,890012,Cheng; Hsiao-Bing,14,0,30,16
1746567352271,MATH 20D,B01,890016,Cheng; Hsiao-Bing,13,0,30,17
1746567352271,MATH 20D,B02,890017,Cheng; Hsiao-Bing,13,0,30,17
1746567353301,MATH 20E,A01,890026,Harel; Guershon,1,0,30,29
1746567353301,MATH 20E,A02,890029,Harel; Guershon,23,0,30,7
1746567353301,MATH 20E,B01,890033,Harel; Guershon,7,0,30,23
1746567353301,MATH 20E,B02,890101,Harel; Guershon,21,0,30,9
1746567354325,MATH 102,A01,890104,Staff,17,0,30,13
1746567354325,MATH 102,A02,890105,Staff,27,0,30,3
1746567355354,MATH 103B,A01,890116,Salehi Golsefidy; Alireza,3,0,30,27
1746567355354,MATH 103B,B01,890118,Staff,0,3,34,34
1746567356381,MATH 109,A01,890121,Aliabadi Sr.; Mohsen,1,0,30,29
1746567356381,MATH 109,B01,890124,Upadrashta; Pranav Kumar,18,0,30,12
1746567357407,MATH 120A,A01,890126,Eggers; John Dietrich,13,0,30,17
1746567358435,MATH 142B,A01,890128,Ioana; Adrian,19,0,30,11
1746567358435,MATH 142B,A02,890129,Ioana; Adrian,13,0,30,17
1746567359486,MATH 154,A01,890174,Staff,0,0,30,30
1746567359486,MATH 154,A02,890182,Staff,0,0,30,30
1746567360512,MATH 168A,A01,890197,Dumitriu; Ioana,21,0,35,14
1746567361538,MATH 170A,A01,890240,Nie; Jiawang,1,0,30,29
1746567361538,MATH 170A,A02,890241,Nie; Jiawang,11,0,30,19
1746567361538,MATH 170A,A03,890249,Nie; Jiawang,23,0,30,7
1746567362562,MATH 170B,A01,957891,Nag; Panchali,13,0,35,22
1746567364614,MATH 181A,A01,908025,Staff,0,4,35,35
1746567364614,MATH 181A,A02,960115,Staff,27,0,35,8
1746567365640,MATH 181B,A01,959874,Staff,25,0,30,5
1746567366670,MATH 193B,A01,890265,Staff,0,4,35,35
1746567367697,MGT 4,A01,890311,Anderson; John Charles,42,0,88,46
1746567368723,MGT 5,A00,907740,Staff,13,0,98,85
1746567369754,MGT 12,A00,890312,Lindenberger; Wade Douglas,67,0,98,31
1746567370779,MGT 16,A00,957883,Staff,78,0,98,20
1746567372835,MGT 45,A00,890314,Pecore; Joseph P.,46,0,98,52
1746567373864,MGT 71,A00,890315,Staff,0,11,98,98
1746567374894,MGT 100,A00,890316,Yavorsky; Daniel Ryan,44,0,98,54
1746567375920,MGT 103,A00,890317,Ehrich; Kristine R,73,0,98,25
1746567376949,MGT 105,A00,890356,Bates; Kenneth Walter,0,8,98,98
1746567377975,MGT 112,A00,890360,Ehrich; Kristine R,55,0,98,43
1746567379002,MGT 127R,A00,907732,Zhu; Kevin Xiaoguo,23,0,98,75
1746567380029,MGT 131B,A00,890361,Anderson; John Charles,60,0,98,38
1746567381056,MGT 137,A00,890362,Lindenberger; Wade Douglas,65,0,98,33
1746567382082,MGT 160,A00,890369,Johnson; Erik Barry,9,0,98,89
1746567384141,MGT 164,A00,890372,Zimmermann; Carsten,0,40,98,98
1746567385168,MGT 180,A00,890374,Bliss; Barbara Ann,12,0,98,86
1746567386200,MMW 15,A01,886414,Chang; Edmond Yi-Teh,0,12,28,28
1746567386200,MMW 15,A02,886415,Chang; Edmond Yi-Teh,0,8,28,28
1746567386200,MMW 15,A03,886416,Chang; Edmond Yi-Teh,0,8,28,28
1746567386200,MMW 15,A04,886417,Chang; Edmond Yi-Teh,0,8,28,28
1746567386200,MMW 15,B01,886419,Chang; Edmond Yi-Teh,0,7,28,28
1746567386200,MMW 15,B02,886420,Chang; Edmond Yi-Teh,0,8,28,28
1746567386200,MMW 15,B03,886421,Chang; Edmond Yi-Teh,0,7,28,28
1746567386200,MMW 15,B04,886422,Chang; Edmond Yi-Teh,0,8,28,28
1746567386200,MMW 15,C01,886424,Staff,0,9,28,28
1746567386200,MMW 15,C02,886425,Staff,0,8,28,28
1746567386200,MMW 15,C03,886426,Staff,0,8,28,28
1746567386200,MMW 15,C04,886427,Staff,0,8,28,28
1746567386200,MMW 15,C05,958038,Staff,0,8,28,28
1746567386200,MMW 15,C06,958039,Staff,1,8,28,27
1746567387225,MMW 15GS,A00,906910,Patterson; Patrick H.,4,0,28,24
1746567388249,MMW 122R,A01,886429,Rahimi; Babak,0,13,28,28
1746567388249,MMW 122R,A02,886430,Rahimi; Babak,0,12,28,28
1746567388249,MMW 122R,A03,958040,Rahimi; Babak,0,11,28,28
1746567389277,MUS 1A,A01,890937,Staff,2,0,25,23
1746567389277,MUS 1A,A02,891035,Staff,6,0,25,19
1746567389277,MUS 1A,C01,958912,Staff,24,0,25,1
1746567389277,MUS 1A,C02,958913,Staff,25,0,25,0
1746567391330,MUS 2AK,A00,957092,Ohnishi; Takae,15,0,15,0
1746567392356,MUS 4,A01,891044,Staff,2,0,25,23
1746567392356,MUS 4,A02,891045,Staff,23,0,25,2
1746567392356,MUS 4,B01,891048,Staff,17,0,25,8
1746567392356,MUS 4,B02,891050,Staff,25,0,25,0
1746567393381,MUS 5,A01,957506,Dubnov; Shlomo,0,0,25,25
1746567393381,MUS 5,A02,957622,Dubnov; Shlomo,13,0,25,12
1746567393381,MUS 5,A03,957623,Dubnov; Shlomo,20,0,25,5
1746567394411,MUS 6,A01,891053,Freitas Caetano; Marcelo,24,0,25,1
1746567394411,MUS 6,A02,891054,Freitas Caetano; Marcelo,23,0,25,2
1746567395440,MUS 7,A01,891081,Staff,0,0,25,25
1746567395440,MUS 7,A02,891082,Staff,3,0,25,22
1746567396464,MUS 8GS,A00,891118,Borgo; David Garcia,1,0,25,24
1746567397496,MUS 11,A01,891140,Staff,9,0,25,16
1746567397496,MUS 11,A02,891141,Staff,22,0,25,3
1746567398526,MUS 13,A01,891143,Staff,8,0,25,17
1746567398526,MUS 13,A02,891144,Staff,24,0,25,1
1746567399556,MUS 15,A01,891146,Staff,9,0,25,16
1746567399556,MUS 15,A02,891148,Staff,21,0,25,4
1746567399556,MUS 15,B01,891150,Staff,18,0,25,7
1746567399556,MUS 15,B02,891151,Staff,25,0,25,0
1746567400583,MUS 20,A01,891153,Staff,5,0,20,15
1746567400583,MUS 20,A02,891155,Staff,14,0,20,6
1746567401611,MUS 80,A00,891156,Staff,19,0,25,6
1746567401611,MUS 80,B00,891157,Staff,23,0,25,2
1746567402636,MUS 130,A00,891158,Ohnishi; Takae,35,0,35,0
1746567403666,MUS 150GS,A01,891160,Borgo; David Garcia,1,0,25,24
1746567404696,MUS 170,A01,891162,Freitas Caetano; Marcelo,20,0,25,5
1746567404696,MUS 170,A02,891164,Freitas Caetano; Marcelo,21,0,25,4
1746567405722,NANO 11,A00,886220,Vazquez Mena; Oscar,13,0,15,2
1746567406754,NANO 15,A01,886222,Drews; Aaron,4,0,7,3
1746567407779,NANO 104,A00,886224,Sirbuly; Donald,17,0,25,8
1746567408804,PH 40,A00,886528,Staff,23,0,40,17
1746567409830,PH 45,A01,886799,Staff,35,0,40,5
1746567410857,PH 110,A00,886802,Staff,0,7,40,40
1746567411883,PH 172,A00,906716,Staff,19,0,35,16
1746567412911,PH 191,A00,886803,Staff,6,0,40,34
1746567413943,PHIL 1,A00,889500,Staff,20,0,30,10
1746567414972,PHIL 10,A01,889549,Grush; Rick Scott,15,0,22,7
1746567414972,PHIL 10,A02,889551,Grush; Rick Scott,22,0,22,0
1746567415999,PHIL 28,A01,889559,Lamey; Andy M.,0,2,31,31
1746567415999,PHIL 28,A02,889561,Lamey; Andy M.,0,1,30,30
1746567415999,PHIL 28,A03,889572,Lamey; Andy M.,0,1,30,30
1746567417026,PHIL 35,A00,907839,Staff,13,0,15,2
1746567418051,PHIL 60,A00,889574,Staff,73,0,90,17
1746567419080,PHIL 101,A00,958004,Staff,12,0,15,3
1746567421136,PHIL 136,A00,889582,Fulkerson; Matthew Todd,26,0,45,19
1746567422164,PHIL 163,A01,889601,Staff,21,0,30,9
1746567422164,PHIL 163,B01,889606,Brandt; Reuven A,0,3,0,0
1746567423192,PHIL 164,A00,889610,Staff,16,0,30,14
1746567424218,PHIL 165,A00,889613,Staff,22,0,30,8
1746567425285,PHYS 1A,A00,886431,Staff,26,0,70,44
1746567426311,PHYS 1AL,001,886432,Tsai; Philbert S,0,2,30,30
1746567426311,PHYS 1AL,002,886436,Tsai; Philbert S,11,0,30,19
1746567427338,PHYS 1B,A00,886439,Staff,185,0,240,55
1746567428364,PHYS 1BL,001,886441,Tsai; Philbert S,0,4,30,30
1746567428364,PHYS 1BL,002,886444,Tsai; Philbert S,2,0,30,28
1746567429392,PHYS 1C,A00,896092,Arnold; Kam S,78,0,146,68
1746567430417,PHYS 1CL,001,886448,Tsai; Philbert S,0,0,30,30
1746567430417,PHYS 1CL,002,886449,Tsai; Philbert S,1,0,30,29
1746567430417,PHYS 1CL,003,886450,Tsai; Philbert S,16,0,30,14
1746567430417,PHYS 1CL,004,886451,Tsai; Philbert S,15,0,30,15
1746567431644,PHYS 2B,A01,886457,Staff,68,0,115,47
1746567432671,PHYS 2C,A01,886460,Shotwell; Brian,0,9,65,65
1746567433695,PHYS 2CL,A01,886467,Staff,0,4,28,28
1746567433695,PHYS 2CL,A02,886468,Staff,0,3,28,28
1746567434720,PHYS 2D,A01,886470,Staff,10,0,50,40
1746567435745,PHYS 4B,A01,886475,Grinstein; Benjamin,22,0,40,18
1746567436771,POLI 5,A00,891173,Desposato; Scott,7,0,25,18
1746567437799,POLI 5D,A01,891175,Staff,5,0,5,0
1746567437799,POLI 5D,B01,891178,Staff,5,0,5,0
1746567438823,POLI 11,A00,891179,Ferree; Karen E,2,0,35,33
1746567439852,POLI 12,A00,891180,Staff,16,0,30,14
1746567440877,POLI 27,A01,891182,Staff,12,0,75,63
1746567441904,POLI 30,A00,891183,Staff,8,0,50,42
1746567442929,POLI 100B,A00,891244,Staff,5,1,35,30
1746567443954,POLI 100I,A00,891247,Staff,7,0,30,23
1746567444980,POLI 104J,A00,891248,Nichter; Maysa,14,0,30,16
1746567446006,POLI 104U,A00,891250,Nichter; Maysa,2,0,30,28
1746567448057,POLI 110B,A00,891255,Wiens; David,20,0,25,5
1746567449086,POLI 112A,A00,891256,Wiens; David,6,0,25,19
1746567450114,POLI 114BR,A00,891261,Staff,19,0,30,11
1746567451139,POLI 117R,A00,891262,Forman; Fonna,0,6,50,50
1746567452164,POLI 118,A00,891264,Ingham; Sean,17,0,25,8
1746567453190,POLI 124A,A00,891265,Staff,18,0,20,2
1746567454216,POLI 125D,A00,891266,Nichter; Simeon C,2,0,25,23
1746567455240,POLI 126,A00,891268,Nichter; Simeon C,7,0,25,18
1746567456266,POLI 126AA,A00,891272,Staff,16,0,25,9
1746567457292,POLI 130AA,A00,891273,Staff,15,0,20,5
1746567458319,POLI 134AA,A00,891274,Staff,4,0,20,16
1746567460371,POLI 138,A00,891278,Staff,21,0,25,4
1746567461434,POLI 142K,A00,891280,Staff,10,0,25,15
1746567462459,POLI 142M,A00,891281,Gartzke; Erik,16,0,30,14
1746567463484,POLI 142P,A00,891284,Staff,20,0,30,10
1746567464510,POLI 143,A00,891285,Gartzke; Erik,12,0,30,18
1746567465537,POLI 153,A00,891286,Staff,19,0,20,1
1746567467591,POLI 175,A00,891290,Staff,15,0,20,5
1746567468617,PSYC 1,A00,890674,Steiner; Eric Tomas,0,11,45,45
1746567469643,PSYC 2,A00,890676,Albright; Thomas D,21,0,35,14
1746567470669,PSYC 3,A00,890679,Staff,17,0,20,3
1746567471696,PSYC 6,A00,959858,Staff,20,0,20,0
1746567472727,PSYC 60,A01,890684,Rickard; Timothy C.,0,5,45,45
1746567473756,PSYC 70,A01,890689,Geller; Emma Harlan,7,0,30,23
1746567474781,PSYC 71,A01,959860,Staff,21,0,25,4
1746567475807,PSYC 100,A00,890690,Lacefield; Katharine I,0,50,180,180
1746567476833,PSYC 102,A00,890695,Staff,18,0,40,22
1746567477858,PSYC 105,A00,890699,Geller; Emma Harlan,70,0,100,30
1746567478883,PSYC 106,A00,890701,Gorman; Michael R.,6,0,30,24
1746567479914,PSYC 108,A00,890704,Adrian; Julia Anna,0,28,50,50
1746567480942,PSYC 118,A01,890712,Staff,11,0,30,19
1746567481970,PSYC 124,A00,890716,Chapman; Eddie Nathaniel,25,0,60,35
1746567482998,PSYC 131,A00,890717,Anagnostaras; Stephan,0,8,80,80
1746567484026,PSYC 137,A00,890719,Winkielman; Piotr,0,11,30,30
1746567485055,PSYC 144,A00,890721,Adrian; Julia Anna,0,9,45,45
1746567486081,PSYC 162,A00,890805,Staff,0,0,75,75
1746567487110,PSYC 169,A00,890810,Staff,0,14,30,30
1746567488139,PSYC 172,A00,890814,Gorman; Michael R.,9,0,30,21
1746567489167,PSYC 181,A00,890818,Anagnostaras; Stephan,9,0,200,191
1746567490193,PSYC 184,A00,959861,Staff,168,0,175,7
1746567491221,PSYC 189,A00,890823,Staff,0,2,30,30
1746567492250,PSYC 191,A00,890884,Rickard; Timothy C.,0,11,35,35
1746567493278,PSYC 193,A00,890913,Staff,19,0,30,11
1746567493278,PSYC 193,B00,890914,Chapman; Eddie Nathaniel,24,0,30,6
1746567494303,PSYC 193L,A01,890918,Lowe; Angela Beth,20,0,30,10
1746567494303,PSYC 193L,B01,890921,Hurwitz; Ethan Scott,20,0,30,10
1746567494303,PSYC 193L,C01,890928,Staff,30,0,30,0
1746567495333,RELI 149,A00,886806,Rahimi; Babak,23,0,40,17
1746567496371,SE 9,A01,886814,Staff,7,0,20,13
1746567497398,SE 101B,A01,886816,Chadha; Mayank,4,0,35,31
1746567498424,SE 110B,A00,886818,Zhu; Qiang,4,0,75,71
1746567499450,SE 125,A01,886830,Staff,10,0,30,20
1746567500479,SE 130B,A01,886835,Staff,14,0,40,26
1746567501506,SE 131A,A01,886838,Krysl; Petr,34,0,55,21
1746567502531,SE 154,A00,886840,Staff,29,0,50,21
1746567503556,SE 164GS,A01,886849,Staff,6,0,20,14
1746567504581,SE 167GS,A01,886853,Staff,6,0,20,14
1746567505607,SIO 25,A01,890107,Staff,19,0,30,11
1746567506632,SIO 45,A00,890109,Cook; Geoffrey W,117,0,200,83
1746567507658,SIO 109R,A00,890110,Forman; Fonna,0,16,20,20
1746567508687,SIO 187,A01,890114,Kacev; David,15,0,40,25
1746567509715,SOCI 1,A01,890431,Thorpe; Charles Robert,15,0,30,15
1746567509715,SOCI 1,A02,890518,Thorpe; Charles Robert,30,0,30,0
1746567510741,SOCI 2,A01,957978,Staff,25,0,25,0
1746567510741,SOCI 2,A02,957979,Staff,23,0,25,2
1746567511771,SOCI 20,A01,890523,Calderon-Zaks; Michael Aar,22,0,30,8
1746567511771,SOCI 20,A02,890526,Calderon-Zaks; Michael Aar,29,0,30,1
1746567512797,SOCI 30,A01,890533,Pardo Guerra; Juan Pablo,37,0,40,3
1746567513821,SOCI 40,A01,890535,Staff,27,0,45,18
1746567514849,SOCI 104Q,A00,890559,Staff,18,0,30,12
1746567515875,SOCI 106,A00,890560,Arnal; Maud Marie Leonie,20,0,30,10
1746567516902,SOCI 110,A00,890567,Holkenbrink-Monk; Charlene,19,0,30,11
1746567517927,SOCI 112,A00,890568,Victoria Torres; Pablo,2,0,55,53
1746567518953,SOCI 115,A00,890597,Arnal; Maud Marie Leonie,28,0,45,17
1746567521005,SOCI 121,A00,890604,Pardo Guerra; Juan Pablo,38,0,45,7
1746567522030,SOCI 126,A01,890608,Staff,8,0,10,2
1746567523057,SOCI 127,A00,890609,Staff,18,0,30,12
1746567524082,SOCI 131,A00,890610,Thorpe; Charles Robert,37,0,45,8
1746567525107,SOCI 135,A00,890615,Payne; Christine Anna,13,0,45,32
1746567526131,SOCI 139,A00,890620,Staff,38,0,45,7
1746567527161,SOCI 148E,A00,890622,Calderon-Zaks; Michael Aar,36,0,45,9
1746567528189,SOCI 150,A00,890623,Kohler; Kristopher M.,31,0,45,14
1746567529216,SOCI 157,A00,890625,Jules-Rosette; Bennetta W.,18,0,20,2
1746567530246,SOCI 160,A00,890627,Payne; Christine Anna,21,0,45,24
1746567531275,SYN 1,A00,886855,Fish; Gwendolyn Anne,0,0,0,0
1746567531275,SYN 1,B00,906086,Fish; Gwendolyn Anne,0,2,0,2
1746567532301,SYN 2R,A00,886860,Staff,0,17,15,15
1746567532301,SYN 2R,B00,906106,Atkinson; Arthur Laird,0,16,15,15
1746567533328,SYN 100,A01,886866,Browne; Emily,0,28,20,20
1746567533328,SYN 100,B01,906128,Rock; Martin,0,5,20,20
1746567533328,SYN 100,C01,906140,Deavenport; James Cary,0,3,20,20
1746567533328,SYN 100,D01,907816,Deavenport; James Cary,0,5,20,20
1746567534353,TDAC 1,A00,890286,Walsh; Kim C.,8,0,20,12
1746567535379,TDAC 101,A00,890296,Basso; Beatrice,15,0,20,5
1746567536406,TDDE 131,A00,890297,Staff,47,0,50,3
1746567537432,TDDM 1,A00,890287,Weinberg; Sadie,25,0,30,5
1746567538458,TDGE 11,A00,890288,Fulton; Julia,137,0,200,63
1746567538458,TDGE 11,B00,890289,Castro; Robert Jess,184,0,200,16
1746567539486,TDGE 25,B00,957359,Walsh; Kim C.,4,0,20,16
1746567540517,TDGE 40,A01,890292,Power; Jade Yukana,27,0,30,3
1746567541552,TDGE 124,A00,890298,Havis; Allan,0,1,50,50
1746567542577,TDGE 131R,A00,890299,Burelle; Julie Sara Veronique,15,0,42,27
1746567543606,TDHT 101,A00,890300,Staff,10,0,20,10
1746567544629,TDHT 109,A01,890302,Anderson; Mysia Anyse,31,0,40,9
1746567545656,TDMV 1,A00,890293,Arcidiacono; Kristin,18,0,30,12
1746567546681,TDMV 2,A00,890294,Weinberg; Sadie,23,0,30,7
1746567547708,TDMV 3,A00,957878,Arcidiacono; Kristin,28,0,30,2
1746567549769,TDMV 138,A00,890304,Jun; Grace Shin Hae,25,0,40,15
1746567550796,TDMV 140,A00,890305,Corrales; Joseph Bernales,25,0,30,5
1746567551937,TDMV 142,A00,890307,Caligagan; Tony,32,0,40,8
1746567552963,TDMV 144,A00,890308,Camaya; Michelle Ann,25,0,30,5
1746567553989,TDPW 1,A00,890295,Stein; Deborah Isobel,3,0,20,17
1746567555017,USP 2,A01,890272,Lerner; Amy M,6,0,20,14
1746567556042,USP 3,A01,890274,Staff,12,0,30,18
1746567557068,USP 15,A01,890276,Sun; Feiyang,16,0,30,14
1746567558095,USP 25,A00,890277,Shenkman; Michael Thomas,19,0,25,6
1746567559120,USP 138,A00,890278,Staff,14,0,25,11
1746567560150,USP 143,A00,890279,Staff,22,0,70,48
1746567561173,USP 144,A00,890280,Chowdhury; Muhammed Zohir,16,0,30,14
1746567562203,USP 150,A00,890281,Boomhower; Matthew Charles,4,0,30,26
1746567563232,USP 151,A00,890282,Staff,16,0,20,4
1746567564257,USP 162,A00,890283,Andrews; Abigail Leslie,16,0,20,4
1746567565285,USP 168,A00,920477,Kwak; Nancy,0,0,5,5
1746567566314,USP 181,A00,890284,Staff,3,0,20,17
1746567567343,USP 191A,A00,890285,Staff,12,0,20,8
1746567568368,VIS 101,A00,886512,Staff,26,0,75,49
1746567569396,VIS 103,A00,886513,Cruz; Edwin Teddy,61,0,75,14
1746567570422,VIS 108,A00,886514,Staff,3,0,15,12
1746567571452,VIS 127P,A00,886515,Shen; Kuiyi,80,0,146,66
1746567572477,VIS 149,A00,886516,Yoldas; Pinar,0,0,15,15
1746567573504,VIS 164,A00,886526,Erdmann; Dean,19,0,22,3
1746567574530,VIS 194S,A00,886527,Staff,61,0,75,14
1746567575559,WCWP 10A,C00,886484,Martiniuk; Jill,12,0,15,3
1746567576589,WCWP 10B,A00,886490,Uriarte; Emma,0,0,15,15
1746567576589,WCWP 10B,B00,886491,Dhir; Simrita,10,0,15,5
1746567576589,WCWP 10B,C00,886492,Ornelas; Tricia,0,0,15,15
1746567577618,WCWP 100,A00,886494,Young; Mark T,0,6,15,15
1746567579719,AAS 10,A01,886199,Childs; Dennis R.,0,3,0,0
1746567580749,ANAR 104,A01,886940,Shtienberg; Gilad,27,0,30,3
1746567581774,ANAR 120,A00,886953,Staff,12,0,20,8
1746567582800,ANBI 148,A01,886955,Wilder; Linnea Lorene,30,0,40,10
1746567584852,ANSC 122,A00,886957,Staff,25,0,30,5
1746567585881,ANSC 150,A00,886958,Sloane; Julia Kathryn,2,0,15,13
1746567586909,ANSC 156,A00,886959,Jenkins; Janis A.,0,1,15,15
1746567587936,ANSC 180,A00,886960,Staff,11,0,17,6
1746567588962,ANSC 188,A00,886961,Jassal; Aftab,9,0,25,16
1746567589987,ANSC 190,A00,886962,Jassal; Aftab,14,0,25,11
1746567591015,ANSC 191,A00,886963,Staff,18,0,20,2
1746567592039,ANTH 3,A01,891689,Staff,17,0,20,3
1746567593068,ANTH 5,A00,886933,Semendeferi; Ekaterini,16,0,20,4
1746567594092,ANTH 10,A00,886934,Staff,0,12,30,30
1746567595122,ANTH 21,A01,886936,Staff,41,0,60,19
1746567596146,ANTH 23,A01,886938,Staff,92,0,100,8
1746567597175,ANTH 105,A00,886964,Stewart; Alexander B,84,0,100,16
1746567598201,ANTH 108,A00,886965,Pedersen; David,9,0,20,11
1746567599237,AWP 10,001,886147,Staff,0,0,0,0
1746567599237,AWP 10,002,886148,Staff,0,0,0,0
1746567599237,AWP 10,003,886149,Staff,0,0,0,0
1746567599237,AWP 10,004,886150,Staff,0,0,0,0
1746567599237,AWP 10,005,886151,Staff,0,0,0,0
1746567599237,AWP 10,006,886152,Staff,0,0,0,0
1746567599237,AWP 10,007,886153,Staff,0,0,0,0
1746567599237,AWP 10,008,886154,Staff,0,0,0,0
1746567599237,AWP 10,009,886155,Staff,0,0,0,0
1746567599237,AWP 10,010,886156,Staff,0,0,0,0
1746567599237,AWP 10,011,886158,Staff,0,0,0,0
1746567599237,AWP 10,012,886160,Staff,0,0,0,0
1746567599237,AWP 10,013,886161,Staff,0,0,0,0
1746567599237,AWP 10,014,886162,Staff,0,0,0,0
1746567599237,AWP 10,015,886163,Staff,0,0,0,0
1746567599237,AWP 10,016,886164,Staff,0,0,0,0
1746567599237,AWP 10,017,886165,Staff,0,0,0,0
1746567599237,AWP 10,018,886166,Staff,0,0,0,0
1746567599237,AWP 10,019,886168,Staff,0,0,0,0
1746567599237,AWP 10,020,886170,Staff,0,0,0,0
1746567599237,AWP 10,021,886172,Staff,0,0,0,0
1746567600269,AWP 10R,001,886173,Staff,0,1,0,0
1746567600269,AWP 10R,002,886174,Staff,0,1,0,0
1746567600269,AWP 10R,003,886175,Staff,0,0,0,0
1746567600269,AWP 10R,004,886176,Staff,0,0,0,0
1746567600269,AWP 10R,005,886177,Staff,0,0,0,0
1746567600269,AWP 10R,006,886178,Staff,0,0,0,0
1746567600269,AWP 10R,007,886179,Staff,0,0,0,0
1746567600269,AWP 10R,008,886181,Staff,0,0,0,0
1746567600269,AWP 10R,009,886182,Staff,0,0,0,0
1746567600269,AWP 10R,010,886183,Staff,0,0,0,0
1746567600269,AWP 10R,011,886184,Staff,0,0,0,0
1746567600269,AWP 10R,012,886185,Staff,0,0,0,0
1746567600269,AWP 10R,013,886186,Staff,0,0,0,0
1746567600269,AWP 10R,014,886187,Staff,0,0,0,0
1746567600269,AWP 10R,015,886188,Staff,0,0,0,0
1746567600269,AWP 10R,016,886189,Staff,0,0,0,0
1746567600269,AWP 10R,017,960532,Staff,0,0,0,0
1746567600269,AWP 10R,018,960533,Staff,0,0,0,0
1746567600269,AWP 10R,019,960534,Staff,0,0,0,0
1746567600269,AWP 10R,020,960538,Staff,0,0,0,0
1746567600269,AWP 10R,021,960540,Staff,0,0,0,0
1746567600269,AWP 10R,022,960541,Staff,0,0,0,0
1746567600269,AWP 10R,023,960542,Staff,0,0,0,0
1746567600269,AWP 10R,024,960544,Staff,0,0,0,0
1746567600269,AWP 10R,025,960545,Staff,0,0,0,0
1746567600269,AWP 10R,026,960548,Staff,0,0,0,0
1746567601299,AWP 102R,A00,886190,Staff,0,0,0,0
1746567601299,AWP 102R,B00,886191,Staff,0,0,0,0
1746567602326,BENG 100,A01,886193,Staff,17,0,30,13
1746567603354,BENG 122A,A01,886195,Hasty; Jeff M,13,0,30,17
1746567604380,BENG 166A,A00,886196,Sah; Robert Lie-Yuan,0,2,30,30
1746567605421,BENG 190,A00,958050,Khojah; Reem I,20,0,25,5
1746567606448,BIBC 102,A01,894320,Staff,0,0,46,46
1746567606448,BIBC 102,A02,894321,Staff,0,0,46,46
1746567606448,BIBC 102,A03,894344,Staff,7,0,46,39
1746567606448,BIBC 102,A04,894345,Staff,26,0,47,21
1746567607474,BICD 100R,A01,894365,Smith; Laurie,0,3,58,58
1746567607474,BICD 100R,A02,894366,Smith; Laurie,0,5,58,58
1746567607474,BICD 100R,A03,894367,Smith; Laurie,0,0,59,59
1746567607474,BICD 100R,A04,959869,Smith; Laurie,40,0,59,19
1746567608504,BICD 136,A01,894383,Gustafson-Brown; Cindy,14,0,50,36
1746567609530,BIEB 102,A01,894494,Butler; Shannon Rhey,51,0,130,79
1746567611590,BIEB 150,A01,894617,Wills; Christopher,3,0,20,17
1746567611590,BIEB 150,A02,894631,Wills; Christopher,3,0,20,17
1746567611590,BIEB 150,A03,894937,Wills; Christopher,3,0,20,17
1746567611590,BIEB 150,A04,894946,Wills; Christopher,5,0,20,15
1746567612618,BIEB 194,A00,906141,Kurle; Carolyn M.,6,0,20,14
1746567613646,BILD 1,A01,894154,Staff,3,0,19,16
1746567613646,BILD 1,A02,894155,Staff,14,0,19,5
1746567613646,BILD 1,A03,894160,Staff,13,0,19,6
1746567613646,BILD 1,A04,894161,Staff,15,0,18,3
1746567614675,BILD 2,A01,894168,Staff,0,0,50,50
1746567614675,BILD 2,A02,894169,Staff,0,0,50,50
1746567614675,BILD 2,A03,894179,Staff,0,0,50,50
1746567614675,BILD 2,A04,894203,Staff,25,0,50,25
1746567615704,BILD 3,A01,894213,Staff,22,0,31,9
1746567615704,BILD 3,A02,894214,Staff,26,0,31,5
1746567615704,BILD 3,A03,894235,Staff,28,0,31,3
1746567615704,BILD 3,A04,894236,Staff,28,0,32,4
1746567616730,BILD 4,A01,894253,Reuther; Keefe,6,0,24,18
1746567616730,BILD 4,A02,894258,Reuther; Keefe,16,0,24,8
1746567617755,BILD 5,A01,894276,Reuther; Keefe,35,0,50,15
1746567617755,BILD 5,A02,894277,Reuther; Keefe,45,0,50,5
1746567617755,BILD 5,A03,894290,Reuther; Keefe,44,0,50,6
1746567617755,BILD 5,A04,894291,Reuther; Keefe,48,0,50,2
1746567618778,BILD 24,A01,894297,Pirino; Giorgia,40,0,60,20
1746567619804,BIMM 100,B01,958915,Staff,71,0,100,29
1746567620831,BIMM 101,A01,895017,McDonnell; Lisa Marie,0,5,24,24
1746567620831,BIMM 101,A02,895018,McDonnell; Lisa Marie,0,5,24,24
1746567620831,BIMM 101,B01,895020,McDonnell; Lisa Marie,0,6,24,24
1746567620831,BIMM 101,B02,895021,McDonnell; Lisa Marie,0,4,24,24
1746567621865,BIMM 110,A01,895023,Staff,1,0,25,24
1746567621865,BIMM 110,A02,895024,Staff,9,0,25,16
1746567621865,BIMM 110,A03,895025,Staff,18,0,25,7
1746567621865,BIMM 110,A04,895031,Staff,20,0,25,5
1746567622898,BIMM 120,A01,895114,Gustafson-Brown; Cindy,14,0,28,14
1746567622898,BIMM 120,A02,895126,Gustafson-Brown; Cindy,21,0,27,6
1746567623924,BIPN 100,A01,895130,Yang; Mingyu,1,0,38,37
1746567623924,BIPN 100,A02,895131,Yang; Mingyu,32,0,38,6
1746567623924,BIPN 100,A03,895132,Yang; Mingyu,32,0,38,6
1746567623924,BIPN 100,A04,895133,Yang; Mingyu,27,0,36,9
1746567624949,BIPN 120,A01,895135,Cooke; James Edward,0,3,13,13
1746567624949,BIPN 120,A02,895136,Cooke; James Edward,0,1,13,13
1746567624949,BIPN 120,A03,895137,Cooke; James Edward,0,3,13,13
1746567624949,BIPN 120,A04,895156,Cooke; James Edward,0,2,11,11
1746567625974,BIPN 134,A01,895235,Cooke; James Edward,0,2,25,25
1746567625974,BIPN 134,A02,895237,Cooke; James Edward,0,0,25,25
1746567625974,BIPN 134,A03,895240,Cooke; James Edward,3,0,25,22
1746567625974,BIPN 134,A04,895270,Cooke; James Edward,20,0,25,5
1746567627005,BIPN 189,A00,892103,Staff,0,14,14,14
1746567629060,BISP 194,A00,958008,Staff,0,2,0,0
1746567630087,CAT 124,A01,922009,Staff,0,5,20,20
1746567631112,CAT 125R,A00,886390,Morales; Celeste Georgianna,0,2,20,20
1746567631112,CAT 125R,B00,886391,Irwin; Matthew Joseph,0,4,20,20
1746567631112,CAT 125R,C00,886392,Smith; Lauryn Alissa,0,2,20,20
1746567631112,CAT 125R,D00,886393,Vanderschuit; Maya Alysia,0,3,20,20
1746567631112,CAT 125R,E00,886394,Marchisotto; Jennifer Anne,0,3,20,20
1746567632142,CENG 15,A01,886218,Drews; Aaron,3,0,8,5
1746567633172,CENG 113,A00,886219,Opatkiewicz; Justin Paul,15,0,25,10
1746567634201,CGS 101,A00,887044,Staff,7,0,20,13
1746567635229,CGS 105,A01,887046,Staff,14,0,25,11
1746567636257,CGS 112,A00,887047,Cuong; Marisol,12,0,15,3
1746567637287,CGS 113,A00,887048,Staff,23,0,30,7
1746567638312,CGS 120,A00,887049,Staff,10,0,17,7
1746567639342,CHEM 6A,A01,886336,Lam; Tin Yiu,38,0,50,12
1746567639342,CHEM 6A,A02,886338,Lam; Tin Yiu,37,0,50,13
1746567640370,CHEM 6B,A01,886341,Hopkins; Patrycja Anna,16,0,50,34
1746567640370,CHEM 6B,A02,886343,Hopkins; Patrycja Anna,42,0,50,8
1746567641397,CHEM 6C,A01,886346,Albizati; Kim F.,0,2,50,50
1746567641397,CHEM 6C,A02,886348,Albizati; Kim F.,23,0,50,27
1746567642422,CHEM 40A,A01,886352,Klosterman; Jeremy K,65,0,100,35
1746567643447,CHEM 40B,A01,886356,Klosterman; Jeremy K,0,23,100,100
1746567644472,CHEM 41B,A01,886360,Theodorakis; Emmanuel,25,0,50,25
1746567644472,CHEM 41B,A02,886362,Theodorakis; Emmanuel,47,0,50,3
1746567645501,CHIN 165A,A00,886382,Xu; Li,18,0,20,2
1746567646527,CLAS 120,A00,886387,Myerston Santana; Jacobo,33,0,40,7
1746567647553,COGS 9,A01,886967,Shannon; Kyle Michael,42,0,60,18
1746567648578,COGS 11,A01,886969,Staff,10,0,30,20
1746567649604,COGS 14A,A01,886971,Staff,6,0,60,54
1746567650631,COGS 14B,A01,886973,Hoffman; Drew Ellen,4,0,60,56
1746567651657,COGS 18,A01,886975,Morgan; Eric,35,0,60,25
1746567652682,COGS 20,A01,886977,Staff,4,0,8,4
1746567652682,COGS 20,A02,886978,Staff,5,0,7,2
1746567653708,COGS 100,A01,907783,Staff,1,2,30,29
1746567654738,COGS 101B,A01,886980,Staff,0,3,48,48
1746567655768,COGS 101C,A01,886982,Delgado; Tania,0,5,44,44
1746567656793,COGS 102A,A01,886984,Johnson; Christine M.,4,0,30,26
1746567657819,COGS 118B,A01,886986,Staff,1,3,88,87
1746567658849,COGS 150,A01,886988,Bergen; Benjamin,22,0,50,28
1746567659874,COGS 153,A00,886989,Delgado; Tania,0,2,41,41
1746567660902,COGS 186,A01,886991,Staff,0,0,32,32
1746567661928,COGS 187A,A01,886993,Boyle; Mary E. T.,7,0,30,23
1746567662957,COGS 189,A00,886994,Staff,0,1,30,30
1746567663982,COMM 10,A01,886996,Staff,0,0,20,21
1746567663982,COMM 10,A02,886997,Staff,12,0,20,8
1746567663982,COMM 10,A03,959845,Staff,19,0,20,1
1746567665013,COMM 20,A01,886999,Leuning; Grant Maurstad,24,0,40,16
1746567667065,COMM 100A,A01,887002,Staff,0,0,20,25
1746567667065,COMM 100A,A02,887003,Staff,6,0,20,14
1746567668095,COMM 100B,A01,887005,Staff,0,8,20,24
1746567669123,COMM 106D,A00,887006,Staff,13,0,40,27
1746567670148,COMM 110G,A00,887007,Whitworth-Smith; Andrew C,12,0,40,28
1746567671173,COMM 111B,A00,887008,Staff,31,0,40,9
1746567672201,COMM 113T,A00,887009,Abuelhiga; Soraya Jill,28,0,40,12
1746567672201,COMM 113T,B00,906733,Staff,40,0,40,0
1746567673247,COMM 145,A00,887010,Staff,12,0,40,28
1746567674273,COMM 146,A00,887054,Staff,31,0,40,9
1746567675303,COMM 190,A00,887012,Staff,8,0,23,15
1746567676327,CSE 8A,A50,887015,Cao; Yingjun,57,0,85,28
1746567677354,CSE 11,A01,887017,Cao; Yingjun,12,0,70,58
1746567678380,CSE 20,A01,887019,Staff,30,0,50,20
1746567679405,CSE 21,A01,887021,Staff,78,0,100,22
1746567679405,CSE 21,B01,892583,Braun; Oliver,45,0,50,5
1746567680430,CSE 30,A01,887025,Eldon; John,143,0,200,57
1746567681460,CSE 100,A01,887027,Staff,26,0,50,24
1746567681460,CSE 100,A02,887028,Staff,42,0,50,8
1746567682489,CSE 101,A01,887030,Braun; Oliver,74,0,100,26
1746567682489,CSE 101,B01,887032,Jones; Miles E,0,3,50,50
1746567682489,CSE 101,B02,887033,Jones; Miles E,0,2,50,50
1746567683517,CSE 105,A01,908084,Jones; Miles E,32,0,50,18
1746567683517,CSE 105,A02,908087,Jones; Miles E,32,0,50,18
1746567684543,CSE 135,A01,887035,Powell; Thomas Allan,0,5,50,50
1746567685571,CSE 142,A01,887037,Staff,8,0,60,52
1746567686598,CSE 142L,A01,887039,Staff,34,0,60,26
1746567687623,CSE 151A,A01,887041,Solares; Edwin A,47,0,100,53
1746567688649,CSE 175,A01,887043,Kumar; Rakesh,30,0,30,0
1746567689675,CSS 1,A01,886389,Staff,1,1,40,39
1746567690705,DSC 30,A01,908097,Liao; Soohyun Nam,47,0,75,28
1746567691729,DSC 40A,A01,908099,Shannon; Kyle Michael,30,0,50,20
1746567692755,DSC 40B,A01,908112,Staff,15,0,50,35
1746567693783,DSC 80,A01,908116,Staff,19,0,60,41
1746567694808,DSC 197,001,956863,Eldridge; Justin Matthew,9999,0,9999,0
1746567695832,ECE 5,A01,886400,Morris; Karcher William,1,0,6,5
1746567695832,ECE 5,A02,886401,Morris; Karcher William,3,0,6,3
1746567696856,ECE 148,A01,886403,Silberman; Jack,0,14,14,14
1746567697881,ECON 1,A01,887265,Crane; Meredith Helen,12,0,70,58
1746567697881,ECON 1,B01,887268,Staff,43,0,50,7
1746567698910,ECON 2,A01,887273,Crane; Meredith Helen,55,0,70,15
1746567699937,ECON 3,A01,887279,Rondina; Giacomo,32,0,70,38
1746567700968,ECON 4,A01,887282,Anderson; John Charles,0,2,10,10
1746567701993,ECON 5,A01,887285,Staff,34,0,45,11
1746567701993,ECON 5,B01,887292,Staff,41,0,45,4
1746567703027,ECON 100A,A01,887337,Newhouse; Herbert S,54,0,70,16
1746567703027,ECON 100A,B01,887349,Staff,45,0,50,5
1746567704056,ECON 100B,A01,887361,Du; Songzi,29,0,70,41
1746567705083,ECON 100C,A01,887445,Newhouse; Herbert S,59,0,70,11
1746567706110,ECON 105,A00,887488,Vespa; Emanuel Ignacio,23,0,35,12
1746567707141,ECON 109,A01,887506,Shishkin; Denis,28,0,35,7
1746567708171,ECON 110A,A01,887568,Alon; Titan Michael,0,3,35,35
1746567708171,ECON 110A,B01,907601,Alon; Titan Michael,20,0,35,15
1746567709200,ECON 110B,A01,887598,Levkoff; Steven B.,0,24,70,70
1746567710225,ECON 112,A00,887599,Rondina; Giacomo,19,0,35,16
1746567711249,ECON 120A,A01,887603,Dai; Yinlin,35,0,70,35
1746567712274,ECON 120C,A01,887608,Sun; Yixiao,0,1,35,35
1746567712274,ECON 120C,B01,887614,Sun; Yixiao,0,0,35,35
1746567713299,ECON 138,A00,887621,Bharadwaj; Prashant,0,21,20,20
1746567714324,ECON 144,A00,958007,Squires; Dale E,12,0,35,23
1746567715348,ECON 171,A01,907666,Staff,17,0,35,18
1746567716377,ECON 175,A00,887626,Wu; Pak Yeung,22,0,35,13
1746567717401,ECON 190,A00,887640,Vespa; Emanuel Ignacio,23,0,35,12
1746567718429,EDS 25,A01,888197,Staff,0,0,0,0
1746567718429,EDS 25,A02,888209,Staff,0,0,0,0
1746567718429,EDS 25,A03,888210,Staff,0,0,0,0
1746567718429,EDS 25,A04,888212,Staff,0,0,0,0
1746567718429,EDS 25,A05,888213,Staff,0,0,0,0
1746567718429,EDS 25,A06,888214,Staff,0,0,0,0
1746567718429,EDS 25,A07,888235,Staff,0,2,0,0
1746567718429,EDS 25,A08,888236,Staff,0,0,0,0
1746567718429,EDS 25,A09,888240,Staff,0,0,0,0
1746567718429,EDS 25,A10,888244,Staff,0,0,0,0
1746567718429,EDS 25,B01,888273,Staff,0,0,0,0
1746567718429,EDS 25,B02,888285,Staff,0,0,0,0
1746567718429,EDS 25,B03,888423,Staff,0,0,0,1
1746567718429,EDS 25,B04,888432,Staff,0,0,0,0
1746567718429,EDS 25,B05,888433,Staff,0,0,0,0
1746567718429,EDS 25,B06,888467,Staff,0,0,0,0
1746567718429,EDS 25,B07,888468,Staff,0,0,0,0
1746567718429,EDS 25,B08,888479,Staff,0,0,0,0
1746567718429,EDS 25,B09,888484,Staff,0,0,0,0
1746567718429,EDS 25,B10,888487,Staff,0,0,0,0
1746567719455,EDS 38,A01,907700,Choi; Bailey Miyeon,30,0,30,0
1746567720479,EDS 112,A01,888601,Chapman; Thandeka K,12,0,40,28
1746567721504,EDS 115,A00,888697,Mendez; Kathrina Mendoza,10,0,30,20
1746567722532,EDS 116,A01,888893,Staff,34,0,40,6
1746567724585,EDS 124AR,A00,889133,Staff,28,0,50,22
1746567724585,EDS 124AR,B00,907471,Simon; Elizabeth A,36,0,50,14
1746567725615,EDS 124BR,A00,889134,Simon; Elizabeth A,44,0,100,56
1746567726642,EDS 125,A00,889135,Staff,25,0,30,5
1746567727669,EDS 126,A01,889138,Staff,36,0,40,4
1746567728697,EDS 164R,A01,889142,Wishard Guerra; Alison G.,33,0,50,17
1746567729724,ENG 30,A01,886396,Staff,0,0,0,0
1746567729724,ENG 30,B01,886398,Staff,0,0,0,0
1746567730754,ENVR 102,A00,906150,Montejo; Carolina,23,0,25,2
1746567731782,ETHN 103A,A00,887236,Man; Simeon S,0,3,0,0
1746567732808,ETHN 113,A00,887239,Staff,16,0,30,14
1746567733836,ETHN 116,A00,887240,Staff,16,0,25,9
1746567734864,ETHN 117,A00,887241,Choi; Esther Min,28,0,30,2
1746567735893,ETHN 118,A00,887243,Staff,24,0,30,6
1746567736923,ETHN 127,A00,887248,Cuong; Marisol,11,0,15,4
1746567737945,ETHN 139,A00,887250,Staff,7,0,10,3
1746567738974,ETHN 142,A00,887252,Staff,10,0,30,20
1746567740005,ETHN 161,A00,887253,Browne; Errol Tsekani,24,0,30,6
1746567741029,ETHN 163FR,A00,887255,Burelle; Julie Sara Veronique,0,0,5,5
1746567742054,GLBH 20,A00,889149,Elwardani; Nile Regina,8,0,42,34
1746567744106,GLBH 111,A01,889152,Burgos; Jose L.,17,0,17,0
1746567745131,GLBH 150,A00,889181,Sloane; Julia Kathryn,0,5,15,15
1746567747188,HDS 60,A01,886406,Warstadt; Melissa Fawn,73,0,80,7
1746567748212,HIAF 111,A00,889324,Gyamfi; Bright,25,0,32,7
1746567749238,HIEA 131,A00,889328,Staff,15,0,32,17
1746567750265,HIEA 144,A00,889333,Henry; Todd A.,26,0,32,6
1746567751293,HIEA 154,A00,889336,Henry; Todd A.,24,0,32,8
1746567752320,HIEU 106,A00,889339,Staff,22,0,32,10
1746567754375,HIEU 114,A00,889340,Staff,3,0,32,29
1746567755402,HIEU 135GS,A00,889342,Patterson; Patrick H.,0,0,1,24
1746567756430,HIEU 137,A00,889343,Edington; Claire Ellen,10,0,25,15
1746567757454,HIEU 148,A00,889345,Staff,14,0,32,18
1746567758480,HIEU 154,A00,889346,Biess; Frank Peter,21,0,32,11
1746567759511,HILA 102,A00,889351,Staff,12,0,32,20
1746567760540,HILD 2A,A01,889221,Lewandoski; Julia Mavis,1,10,32,31
1746567761565,HILD 7B,A01,889225,Man; Simeon S,0,12,32,32
1746567762589,HILD 7C,A01,889288,Alvarez; Luis A,0,14,32,32
1746567763618,HILD 30,A01,889323,Staff,0,5,32,32
1746567765668,HISC 119,A00,889383,Golan; Tal,19,0,32,13
1746567766693,HIUS 103,A00,889384,Man; Simeon S,0,0,32,32
1746567767721,HIUS 117,A00,919797,Kwak; Nancy,19,0,32,13
1746567768745,HIUS 142A,A00,919788,Staff,22,0,32,10
1746567770798,HIUS 149,A00,889386,Gyamfi; Bright,26,0,32,6
1746567771825,HIUS 155,A00,889387,Alvarez; Luis A,14,0,32,18
1746567772850,HUM 3,A01,886499,Caldwell; Michael Alan,19,0,50,31
1746567773878,HUM 3GS,A00,886500,Rodriguez; Bretton Sigfred,0,0,0,28
1746567774908,HUM 3R,A01,886502,Markman; Kristina,0,36,50,50
1746567775938,HUM 4,A01,886504,Crum; Matthew Stephen,24,0,50,26
1746567775938,HUM 4,B01,886506,West; Geoffrey Scott,17,0,50,33
1746567776964,HUM 4GS,A00,886507,Staff,0,0,0,19
1746567777990,HUM 5,A01,886509,Staff,32,0,50,18
1746567779015,HUM 5R,A01,886511,Zavodny; Tatiana Sophia,0,39,50,50
1746567780046,JAPN 180,A00,886407,Staff,16,0,40,24
1746567781076,LATI 50,A01,886409,Martin-Cabrera; Luis,4,0,22,18
1746567781076,LATI 50,A02,886410,Martin-Cabrera; Luis,19,0,22,3
1746567781076,LATI 50,A03,886411,Martin-Cabrera; Luis,21,0,22,1
1746567781076,LATI 50,A04,886412,Martin-Cabrera; Luis,9,0,22,13
1746567782103,LAWS 101,A00,907664,Staff,28,0,60,32
1746567783129,LIAB 1A,A00,889388,Saab; Dima,17,0,20,3
1746567784160,LIAB 1AX,A00,889389,El Cheddadi; Youniss,18,0,20,2
1746567785190,LIFR 1C,A00,889391,Van Moer; Vinciane G,8,0,20,12
1746567786218,LIFR 1CX,A00,889392,Van Moer; Vinciane G,7,0,20,13
1746567787243,LIFR 1D,A00,889393,Van Moer; Vinciane G,7,0,20,13
1746567788272,LIFR 1DX,A00,889394,Van Moer; Vinciane G,8,0,20,12
1746567789297,LIGN 7,A00,886923,Staff,24,0,50,26
1746567790323,LIGN 17,A00,886924,Kehler; Andrew Scott,125,0,150,25
1746567791351,LTAM 110,A00,889395,Staff,15,0,30,15
1746567792376,LTAM 110GS,A00,958010,Rodriguez; Bretton Sigfred,0,0,0,28
1746567793404,LTCH 101,A00,889397,Staff,23,0,25,2
1746567794429,LTCS 130,A00,889398,Staff,23,0,25,2
1746567795455,LTEA 138,A00,889399,Staff,24,0,40,16
1746567796481,LTEN 149,A00,889400,Wesling; Megan E.,0,3,25,25
1746567797509,LTEN 169,A00,889401,Staff,20,0,25,5
1746567798535,LTEN 180,A00,889402,Staff,10,0,15,5
1746567799562,LTEN 181,A00,889403,Staff,21,0,25,4
1746567800589,LTWL 100,A00,889404,Myerston Santana; Jacobo,2,0,25,23
1746567801617,LTWL 180GS,A00,889405,Staff,0,0,20,20
1746567802645,LTWL 181,A00,889406,Staff,16,0,25,9
1746567803670,LTWL 184,A00,889475,Mukherjee; Silpa,22,0,25,3
1746567804696,LTWR 102C,A00,889486,Staff,29,0,30,1
1746567805722,LTWR 115W,A00,889491,Staff,0,2,15,15
1746567806748,MAE 8,A01,886905,Staff,0,2,0,0
1746567807773,MAE 11,A00,886906,Bandaru; Prabhakar,0,7,50,50
1746567808800,MAE 20,A00,886907,Evdokimenko; Ekaterina,43,0,70,27
1746567809826,MAE 30B,A00,886909,Ghazinejad; Maziar,26,0,45,19
1746567810851,MAE 101B,A00,886910,Saintillan; David,29,0,45,16
1746567811877,MAE 105,A00,886911,Bandaru; Prabhakar,18,0,50,32
1746567812903,MAE 107,B00,958024,Staff,8,0,50,42
1746567813931,MAE 143B,A00,886913,Bewley; Thomas R,6,0,40,34
1746567814958,MAE 148,A01,886915,Silberman; Jack,0,3,14,14
1746567815988,MAE 160,A00,886916,Evdokimenko; Ekaterina,31,0,60,29
1746567817012,MATH 3C,A01,889681,Staff,0,2,30,30
1746567817012,MATH 3C,A02,960048,Staff,24,0,30,6
1746567818040,MATH 10A,A01,889760,Staff,26,0,30,4
1746567818040,MATH 10A,A02,889783,Staff,29,0,30,1
1746567819065,MATH 10B,A01,889785,Verstraete; Jacques Allan,2,0,35,33
1746567819065,MATH 10B,A02,889795,Verstraete; Jacques Allan,4,0,35,31
1746567819065,MATH 10B,B01,889797,Verstraete; Jacques Allan,3,0,35,32
1746567819065,MATH 10B,B02,889828,Verstraete; Jacques Allan,3,0,35,32
1746567820093,MATH 10C,A01,889849,Habib; Yousaf,7,0,30,23
1746567820093,MATH 10C,A02,889852,Habib; Yousaf,14,0,30,16
1746567820093,MATH 10C,A03,889853,Habib; Yousaf,22,0,30,8
1746567820093,MATH 10C,A04,889858,Habib; Yousaf,20,0,30,10
1746567820093,MATH 10C,B01,889861,Staff,1,0,30,29
1746567820093,MATH 10C,B02,889862,Staff,24,0,30,6
1746567820093,MATH 10C,B03,889863,Staff,27,0,30,3
1746567820093,MATH 10C,B04,889967,Staff,23,0,30,7
1746567821120,MATH 18,A01,889974,Staff,7,0,30,23
1746567821120,MATH 18,A02,889977,Staff,20,0,30,10
1746567821120,MATH 18,B01,889984,Hardiman; Liam,21,0,30,9
1746567821120,MATH 18,B02,889985,Hardiman; Liam,25,0,30,5
1746567822144,MATH 20A,A01,889990,Suk; Andrew Hoon,30,0,35,5
1746567823170,MATH 20B,A01,889993,Ohm; Ko Woon,22,0,30,8
1746567823170,MATH 20B,A02,889994,Ohm; Ko Woon,30,0,30,0
1746567823170,MATH 20B,B01,889996,Ohm; Ko Woon,21,0,30,9
1746567823170,MATH 20B,B02,889997,Ohm; Ko Woon,23,0,30,7
1746567824195,MATH 20C,A01,889999,Hammock; Frances H,17,0,30,13
1746567824195,MATH 20C,A02,890003,Hammock; Frances H,23,0,30,7
1746567824195,MATH 20C,B01,890006,Hammock; Frances H,3,0,30,27
1746567824195,MATH 20C,B02,890007,Hammock; Frances H,12,0,30,18
1746567825230,MATH 20D,A01,890011,Cheng; Hsiao-Bing,1,1,30,29
1746567825230,MATH 20D,A02,890012,Cheng; Hsiao-Bing,14,0,30,16
1746567825230,MATH 20D,B01,890016,Cheng; Hsiao-Bing,13,0,30,17
1746567825230,MATH 20D,B02,890017,Cheng; Hsiao-Bing,13,0,30,17
1746567826259,MATH 20E,A01,890026,Harel; Guershon,1,0,30,29
1746567826259,MATH 20E,A02,890029,Harel; Guershon,23,0,30,7
1746567826259,MATH 20E,B01,890033,Harel; Guershon,7,0,30,23
1746567826259,MATH 20E,B02,890101,Harel; Guershon,21,0,30,9
1746567827287,MATH 102,A01,890104,Staff,17,0,30,13
1746567827287,MATH 102,A02,890105,Staff,27,0,30,3
1746567828312,MATH 103B,A01,890116,Salehi Golsefidy; Alireza,3,0,30,27
1746567828312,MATH 103B,B01,890118,Staff,0,3,34,34
1746567829337,MATH 109,A01,890121,Aliabadi Sr.; Mohsen,1,0,30,29
1746567829337,MATH 109,B01,890124,Upadrashta; Pranav Kumar,18,0,30,12
1746567830363,MATH 120A,A01,890126,Eggers; John Dietrich,13,0,30,17
1746567831391,MATH 142B,A01,890128,Ioana; Adrian,19,0,30,11
1746567831391,MATH 142B,A02,890129,Ioana; Adrian,13,0,30,17
1746567832418,MATH 154,A01,890174,Staff,0,0,30,30
1746567832418,MATH 154,A02,890182,Staff,0,0,30,30
1746567833446,MATH 168A,A01,890197,Dumitriu; Ioana,21,0,35,14
1746567834472,MATH 170A,A01,890240,Nie; Jiawang,1,0,30,29
1746567834472,MATH 170A,A02,890241,Nie; Jiawang,11,0,30,19
1746567834472,MATH 170A,A03,890249,Nie; Jiawang,23,0,30,7
1746567835499,MATH 170B,A01,957891,Nag; Panchali,13,0,35,22
1746567837551,MATH 181A,A01,908025,Staff,0,4,35,35
1746567837551,MATH 181A,A02,960115,Staff,27,0,35,8
1746567838576,MATH 181B,A01,959874,Staff,25,0,30,5
1746567839601,MATH 193B,A01,890265,Staff,0,4,35,35
1746567840631,MGT 4,A01,890311,Anderson; John Charles,42,0,88,46
1746567841657,MGT 5,A00,907740,Staff,13,0,98,85
1746567842686,MGT 12,A00,890312,Lindenberger; Wade Douglas,67,0,98,31
1746567843710,MGT 16,A00,957883,Staff,78,0,98,20
1746567845764,MGT 45,A00,890314,Pecore; Joseph P.,46,0,98,52
1746567846791,MGT 71,A00,890315,Staff,0,11,98,98
1746567847815,MGT 100,A00,890316,Yavorsky; Daniel Ryan,44,0,98,54
1746567848842,MGT 103,A00,890317,Ehrich; Kristine R,73,0,98,25
1746567849870,MGT 105,A00,890356,Bates; Kenneth Walter,0,8,98,98
1746567850896,MGT 112,A00,890360,Ehrich; Kristine R,55,0,98,43
1746567851922,MGT 127R,A00,907732,Zhu; Kevin Xiaoguo,23,0,98,75
1746567852946,MGT 131B,A00,890361,Anderson; John Charles,60,0,98,38
1746567853971,MGT 137,A00,890362,Lindenberger; Wade Douglas,65,0,98,33
1746567854997,MGT 160,A00,890369,Johnson; Erik Barry,9,0,98,89
1746567857052,MGT 164,A00,890372,Zimmermann; Carsten,0,40,98,98
1746567858132,MGT 180,A00,890374,Bliss; Barbara Ann,12,0,98,86
1746567859162,MMW 15,A01,886414,Chang; Edmond Yi-Teh,0,12,28,28
1746567859162,MMW 15,A02,886415,Chang; Edmond Yi-Teh,0,8,28,28
1746567859162,MMW 15,A03,886416,Chang; Edmond Yi-Teh,0,8,28,28
1746567859162,MMW 15,A04,886417,Chang; Edmond Yi-Teh,0,8,28,28
1746567859162,MMW 15,B01,886419,Chang; Edmond Yi-Teh,0,7,28,28
1746567859162,MMW 15,B02,886420,Chang; Edmond Yi-Teh,0,8,28,28
1746567859162,MMW 15,B03,886421,Chang; Edmond Yi-Teh,0,7,28,28
1746567859162,MMW 15,B04,886422,Chang; Edmond Yi-Teh,0,8,28,28
1746567859162,MMW 15,C01,886424,Staff,0,9,28,28
1746567859162,MMW 15,C02,886425,Staff,0,8,28,28
1746567859162,MMW 15,C03,886426,Staff,0,8,28,28
1746567859162,MMW 15,C04,886427,Staff,0,8,28,28
1746567859162,MMW 15,C05,958038,Staff,0,8,28,28
1746567859162,MMW 15,C06,958039,Staff,1,8,28,27
1746567860187,MMW 15GS,A00,906910,Patterson; Patrick H.,4,0,28,24
1746567861213,MMW 122R,A01,886429,Rahimi; Babak,0,13,28,28
1746567861213,MMW 122R,A02,886430,Rahimi; Babak,0,12,28,28
1746567861213,MMW 122R,A03,958040,Rahimi; Babak,0,11,28,28
1746567862244,MUS 1A,A01,890937,Staff,2,0,25,23
1746567862244,MUS 1A,A02,891035,Staff,6,0,25,19
1746567862244,MUS 1A,C01,958912,Staff,24,0,25,1
1746567862244,MUS 1A,C02,958913,Staff,25,0,25,0
1746567864299,MUS 2AK,A00,957092,Ohnishi; Takae,15,0,15,0
1746567865325,MUS 4,A01,891044,Staff,2,0,25,23
1746567865325,MUS 4,A02,891045,Staff,23,0,25,2
1746567865325,MUS 4,B01,891048,Staff,17,0,25,8
1746567865325,MUS 4,B02,891050,Staff,25,0,25,0
1746567866354,MUS 5,A01,957506,Dubnov; Shlomo,0,0,25,25
1746567866354,MUS 5,A02,957622,Dubnov; Shlomo,13,0,25,12
1746567866354,MUS 5,A03,957623,Dubnov; Shlomo,20,0,25,5
1746567867383,MUS 6,A01,891053,Freitas Caetano; Marcelo,24,0,25,1
1746567867383,MUS 6,A02,891054,Freitas Caetano; Marcelo,23,0,25,2
1746567868407,MUS 7,A01,891081,Staff,0,0,25,25
1746567868407,MUS 7,A02,891082,Staff,3,0,25,22
1746567869437,MUS 8GS,A00,891118,Borgo; David Garcia,1,0,25,24
1746567870463,MUS 11,A01,891140,Staff,9,0,25,16
1746567870463,MUS 11,A02,891141,Staff,22,0,25,3
1746567871487,MUS 13,A01,891143,Staff,8,0,25,17
1746567871487,MUS 13,A02,891144,Staff,24,0,25,1
1746567872514,MUS 15,A01,891146,Staff,9,0,25,16
1746567872514,MUS 15,A02,891148,Staff,21,0,25,4
1746567872514,MUS 15,B01,891150,Staff,18,0,25,7
1746567872514,MUS 15,B02,891151,Staff,25,0,25,0
1746567873542,MUS 20,A01,891153,Staff,5,0,20,15
1746567873542,MUS 20,A02,891155,Staff,14,0,20,6
1746567874567,MUS 80,A00,891156,Staff,19,0,25,6
1746567874567,MUS 80,B00,891157,Staff,23,0,25,2
1746567875595,MUS 130,A00,891158,Ohnishi; Takae,35,0,35,0
1746567876619,MUS 150GS,A01,891160,Borgo; David Garcia,1,0,25,24
1746567877646,MUS 170,A01,891162,Freitas Caetano; Marcelo,20,0,25,5
1746567877646,MUS 170,A02,891164,Freitas Caetano; Marcelo,21,0,25,4
1746567878670,NANO 11,A00,886220,Vazquez Mena; Oscar,13,0,15,2
1746567879695,NANO 15,A01,886222,Drews; Aaron,4,0,7,3
1746567880719,NANO 104,A00,886224,Sirbuly; Donald,17,0,25,8
1746567881745,PH 40,A00,886528,Staff,23,0,40,17
1746567882770,PH 45,A01,886799,Staff,35,0,40,5
1746567883794,PH 110,A00,886802,Staff,0,7,40,40
1746567884821,PH 172,A00,906716,Staff,19,0,35,16
1746567885845,PH 191,A00,886803,Staff,6,0,40,34
1746567886873,PHIL 1,A00,889500,Staff,20,0,30,10
1746567887899,PHIL 10,A01,889549,Grush; Rick Scott,15,0,22,7
1746567887899,PHIL 10,A02,889551,Grush; Rick Scott,22,0,22,0
1746567888924,PHIL 28,A01,889559,Lamey; Andy M.,0,2,31,31
1746567888924,PHIL 28,A02,889561,Lamey; Andy M.,0,1,30,30
1746567888924,PHIL 28,A03,889572,Lamey; Andy M.,0,1,30,30
1746567889948,PHIL 35,A00,907839,Staff,13,0,15,2
1746567890976,PHIL 60,A00,889574,Staff,73,0,90,17
1746567892001,PHIL 101,A00,958004,Staff,12,0,15,3
1746567894080,PHIL 136,A00,889582,Fulkerson; Matthew Todd,26,0,45,19
1746567895110,PHIL 163,A01,889601,Staff,21,0,30,9
1746567895110,PHIL 163,B01,889606,Brandt; Reuven A,0,3,0,0
1746567896134,PHIL 164,A00,889610,Staff,16,0,30,14
1746567897159,PHIL 165,A00,889613,Staff,22,0,30,8
1746567898187,PHYS 1A,A00,886431,Staff,26,0,70,44
1746567899215,PHYS 1AL,001,886432,Tsai; Philbert S,0,2,30,30
1746567899215,PHYS 1AL,002,886436,Tsai; Philbert S,11,0,30,19
1746567900241,PHYS 1B,A00,886439,Staff,185,0,240,55
1746567901270,PHYS 1BL,001,886441,Tsai; Philbert S,0,4,30,30
1746567901270,PHYS 1BL,002,886444,Tsai; Philbert S,2,0,30,28
1746567902296,PHYS 1C,A00,896092,Arnold; Kam S,78,0,146,68
1746567903321,PHYS 1CL,001,886448,Tsai; Philbert S,0,0,30,30
1746567903321,PHYS 1CL,002,886449,Tsai; Philbert S,1,0,30,29
1746567903321,PHYS 1CL,003,886450,Tsai; Philbert S,16,0,30,14
1746567903321,PHYS 1CL,004,886451,Tsai; Philbert S,15,0,30,15
1746567904346,PHYS 2B,A01,886457,Staff,68,0,115,47
1746567905376,PHYS 2C,A01,886460,Shotwell; Brian,0,9,65,65
1746567906400,PHYS 2CL,A01,886467,Staff,0,4,28,28
1746567906400,PHYS 2CL,A02,886468,Staff,0,3,28,28
1746567907430,PHYS 2D,A01,886470,Staff,10,0,50,40
1746567908456,PHYS 4B,A01,886475,Grinstein; Benjamin,22,0,40,18
1746567909485,POLI 5,A00,891173,Desposato; Scott,7,0,25,18
1746567910511,POLI 5D,A01,891175,Staff,5,0,5,0
1746567910511,POLI 5D,B01,891178,Staff,5,0,5,0
1746567911534,POLI 11,A00,891179,Ferree; Karen E,2,0,35,33
1746567912561,POLI 12,A00,891180,Staff,16,0,30,14
1746567913585,POLI 27,A01,891182,Staff,12,0,75,63
1746567914610,POLI 30,A00,891183,Staff,8,0,50,42
1746567915637,POLI 100B,A00,891244,Staff,5,1,35,30
1746567916661,POLI 100I,A00,891247,Staff,7,0,30,23
1746567917691,POLI 104J,A00,891248,Nichter; Maysa,14,0,30,16
1746567918717,POLI 104U,A00,891250,Nichter; Maysa,2,0,30,28
1746567920884,POLI 110B,A00,891255,Wiens; David,20,0,25,5
1746567921910,POLI 112A,A00,891256,Wiens; David,6,0,25,19
1746567922940,POLI 114BR,A00,891261,Staff,19,0,30,11
1746567923965,POLI 117R,A00,891262,Forman; Fonna,0,6,50,50
1746567924994,POLI 118,A00,891264,Ingham; Sean,17,0,25,8
1746567926021,POLI 124A,A00,891265,Staff,18,0,20,2
1746567927048,POLI 125D,A00,891266,Nichter; Simeon C,2,0,25,23
1746567928075,POLI 126,A00,891268,Nichter; Simeon C,7,0,25,18
1746567929102,POLI 126AA,A00,891272,Staff,16,0,25,9
1746567930129,POLI 130AA,A00,891273,Staff,15,0,20,5
1746567931155,POLI 134AA,A00,891274,Staff,4,0,20,16
1746567933220,POLI 138,A00,891278,Staff,21,0,25,4
1746567934245,POLI 142K,A00,891280,Staff,10,0,25,15
1746567935274,POLI 142M,A00,891281,Gartzke; Erik,16,0,30,14
1746567936298,POLI 142P,A00,891284,Staff,20,0,30,10
1746567937321,POLI 143,A00,891285,Gartzke; Erik,12,0,30,18
1746567938347,POLI 153,A00,891286,Staff,19,0,20,1
1746567940397,POLI 175,A00,891290,Staff,15,0,20,5
1746567941429,PSYC 1,A00,890674,Steiner; Eric Tomas,0,11,45,45
1746567942460,PSYC 2,A00,890676,Albright; Thomas D,21,0,35,14
1746567943484,PSYC 3,A00,890679,Staff,17,0,20,3
1746567944518,PSYC 6,A00,959858,Staff,20,0,20,0
1746567945543,PSYC 60,A01,890684,Rickard; Timothy C.,0,5,45,45
1746567946569,PSYC 70,A01,890689,Geller; Emma Harlan,7,0,30,23
1746567947595,PSYC 71,A01,959860,Staff,21,0,25,4
1746567948622,PSYC 100,A00,890690,Lacefield; Katharine I,0,50,180,180
1746567949650,PSYC 102,A00,890695,Staff,18,0,40,22
1746567950679,PSYC 105,A00,890699,Geller; Emma Harlan,70,0,100,30
1746567951705,PSYC 106,A00,890701,Gorman; Michael R.,6,0,30,24
1746567952730,PSYC 108,A00,890704,Adrian; Julia Anna,0,28,50,50
1746567953755,PSYC 118,A01,890712,Staff,11,0,30,19
1746567954781,PSYC 124,A00,890716,Chapman; Eddie Nathaniel,25,0,60,35
1746567955811,PSYC 131,A00,890717,Anagnostaras; Stephan,0,8,80,80
1746567956839,PSYC 137,A00,890719,Winkielman; Piotr,0,11,30,30
1746567957865,PSYC 144,A00,890721,Adrian; Julia Anna,0,9,45,45
1746567958894,PSYC 162,A00,890805,Staff,0,0,75,75
1746567959917,PSYC 169,A00,890810,Staff,0,14,30,30
1746567960941,PSYC 172,A00,890814,Gorman; Michael R.,9,0,30,21
1746567961968,PSYC 181,A00,890818,Anagnostaras; Stephan,9,0,200,191
1746567962998,PSYC 184,A00,959861,Staff,168,0,175,7
1746567964026,PSYC 189,A00,890823,Staff,0,2,30,30
1746567965051,PSYC 191,A00,890884,Rickard; Timothy C.,0,12,35,35
1746567966081,PSYC 193,A00,890913,Staff,19,0,30,11
1746567966081,PSYC 193,B00,890914,Chapman; Eddie Nathaniel,24,0,30,6
1746567967111,PSYC 193L,A01,890918,Lowe; Angela Beth,20,0,30,10
1746567967111,PSYC 193L,B01,890921,Hurwitz; Ethan Scott,20,0,30,10
1746567967111,PSYC 193L,C01,890928,Staff,30,0,30,0
1746567968136,RELI 149,A00,886806,Rahimi; Babak,23,0,40,17
1746567969160,SE 9,A01,886814,Staff,7,0,20,13
1746567970184,SE 101B,A01,886816,Chadha; Mayank,4,0,35,31
1746567971211,SE 110B,A00,886818,Zhu; Qiang,4,0,75,71
1746567972239,SE 125,A01,886830,Staff,10,0,30,20
1746567973269,SE 130B,A01,886835,Staff,14,0,40,26
1746567974294,SE 131A,A01,886838,Krysl; Petr,34,0,55,21
1746567975318,SE 154,A00,886840,Staff,29,0,50,21
1746567976344,SE 164GS,A01,886849,Staff,6,0,20,14
1746567977370,SE 167GS,A01,886853,Staff,6,0,20,14
1746567978397,SIO 25,A01,890107,Staff,19,0,30,11
1746567979427,SIO 45,A00,890109,Cook; Geoffrey W,117,0,200,83
1746567980453,SIO 109R,A00,890110,Forman; Fonna,0,16,20,20
1746567981486,SIO 187,A01,890114,Kacev; David,15,0,40,25
1746567982514,SOCI 1,A01,890431,Thorpe; Charles Robert,15,0,30,15
1746567982514,SOCI 1,A02,890518,Thorpe; Charles Robert,30,0,30,0
1746567983541,SOCI 2,A01,957978,Staff,25,0,25,0
1746567983541,SOCI 2,A02,957979,Staff,23,0,25,2
1746567984567,SOCI 20,A01,890523,Calderon-Zaks; Michael Aar,22,0,30,8
1746567984567,SOCI 20,A02,890526,Calderon-Zaks; Michael Aar,29,0,30,1
1746567985596,SOCI 30,A01,890533,Pardo Guerra; Juan Pablo,37,0,40,3
1746567986625,SOCI 40,A01,890535,Staff,27,0,45,18
1746567987656,SOCI 104Q,A00,890559,Staff,18,0,30,12
1746567988683,SOCI 106,A00,890560,Arnal; Maud Marie Leonie,20,0,30,10
1746567989710,SOCI 110,A00,890567,Holkenbrink-Monk; Charlene,19,0,30,11
1746567990739,SOCI 112,A00,890568,Victoria Torres; Pablo,2,0,55,53
1746567991767,SOCI 115,A00,890597,Arnal; Maud Marie Leonie,28,0,45,17
1746567993821,SOCI 121,A00,890604,Pardo Guerra; Juan Pablo,38,0,45,7
1746567994844,SOCI 126,A01,890608,Staff,8,0,10,2
1746567995869,SOCI 127,A00,890609,Staff,18,0,30,12
1746567996897,SOCI 131,A00,890610,Thorpe; Charles Robert,37,0,45,8
1746567997922,SOCI 135,A00,890615,Payne; Christine Anna,13,0,45,32
1746567998949,SOCI 139,A00,890620,Staff,38,0,45,7
1746567999977,SOCI 148E,A00,890622,Calderon-Zaks; Michael Aar,36,0,45,9
1746568001001,SOCI 150,A00,890623,Kohler; Kristopher M.,31,0,45,14
1746568002031,SOCI 157,A00,890625,Jules-Rosette; Bennetta W.,18,0,20,2
1746568003057,SOCI 160,A00,890627,Payne; Christine Anna,21,0,45,24
1746568004089,SYN 1,A00,886855,Fish; Gwendolyn Anne,0,0,0,0
1746568004089,SYN 1,B00,906086,Fish; Gwendolyn Anne,0,2,0,2
1746568005113,SYN 2R,A00,886860,Staff,0,17,15,15
1746568005113,SYN 2R,B00,906106,Atkinson; Arthur Laird,0,16,15,15
1746568006140,SYN 100,A01,886866,Browne; Emily,0,28,20,20
1746568006140,SYN 100,B01,906128,Rock; Martin,0,5,20,20
1746568006140,SYN 100,C01,906140,Deavenport; James Cary,0,3,20,20
1746568006140,SYN 100,D01,907816,Deavenport; James Cary,0,5,20,20
1746568007165,TDAC 1,A00,890286,Walsh; Kim C.,8,0,20,12
1746568008195,TDAC 101,A00,890296,Basso; Beatrice,15,0,20,5
1746568009222,TDDE 131,A00,890297,Staff,47,0,50,3
1746568010247,TDDM 1,A00,890287,Weinberg; Sadie,25,0,30,5
1746568011275,TDGE 11,A00,890288,Fulton; Julia,137,0,200,63
1746568011275,TDGE 11,B00,890289,Castro; Robert Jess,184,0,200,16
1746568012304,TDGE 25,B00,957359,Walsh; Kim C.,4,0,20,16
1746568013334,TDGE 40,A01,890292,Power; Jade Yukana,27,0,30,3
1746568014359,TDGE 124,A00,890298,Havis; Allan,0,1,50,50
1746568015387,TDGE 131R,A00,890299,Burelle; Julie Sara Veronique,15,0,42,27
1746568016411,TDHT 101,A00,890300,Staff,10,0,20,10
1746568017443,TDHT 109,A01,890302,Anderson; Mysia Anyse,31,0,40,9
1746568018466,TDMV 1,A00,890293,Arcidiacono; Kristin,18,0,30,12
1746568019494,TDMV 2,A00,890294,Weinberg; Sadie,23,0,30,7
1746568020524,TDMV 3,A00,957878,Arcidiacono; Kristin,28,0,30,2
1746568022578,TDMV 138,A00,890304,Jun; Grace Shin Hae,25,0,40,15
1746568023601,TDMV 140,A00,890305,Corrales; Joseph Bernales,25,0,30,5
1746568024630,TDMV 142,A00,890307,Caligagan; Tony,32,0,40,8
1746568025656,TDMV 144,A00,890308,Camaya; Michelle Ann,25,0,30,5
1746568026681,TDPW 1,A00,890295,Stein; Deborah Isobel,3,0,20,17
1746568027707,USP 2,A01,890272,Lerner; Amy M,6,0,20,14
1746568028733,USP 3,A01,890274,Staff,12,0,30,18
1746568029762,USP 15,A01,890276,Sun; Feiyang,16,0,30,14
1746568030790,USP 25,A00,890277,Shenkman; Michael Thomas,19,0,25,6
1746568031818,USP 138,A00,890278,Staff,14,0,25,11
1746568032845,USP 143,A00,890279,Staff,22,0,70,48
1746568033873,USP 144,A00,890280,Chowdhury; Muhammed Zohir,16,0,30,14
1746568034896,USP 150,A00,890281,Boomhower; Matthew Charles,4,0,30,26
1746568035921,USP 151,A00,890282,Staff,16,0,20,4
1746568036947,USP 162,A00,890283,Andrews; Abigail Leslie,16,0,20,4
1746568037973,USP 168,A00,920477,Kwak; Nancy,0,0,5,5
1746568039000,USP 181,A00,890284,Staff,3,0,20,17
1746568040044,USP 191A,A00,890285,Staff,12,0,20,8
1746568041069,VIS 101,A00,886512,Staff,26,0,75,49
1746568042098,VIS 103,A00,886513,Cruz; Edwin Teddy,61,0,75,14
1746568043125,VIS 108,A00,886514,Staff,3,0,15,12
1746568044153,VIS 127P,A00,886515,Shen; Kuiyi,80,0,146,66
1746568045177,VIS 149,A00,886516,Yoldas; Pinar,0,0,15,15
1746568046203,VIS 164,A00,886526,Erdmann; Dean,19,0,22,3
1746568047230,VIS 194S,A00,886527,Staff,61,0,75,14
1746568048255,WCWP 10A,C00,886484,Martiniuk; Jill,12,0,15,3
1746568049285,WCWP 10B,A00,886490,Uriarte; Emma,0,0,15,15
1746568049285,WCWP 10B,B00,886491,Dhir; Simrita,10,0,15,5
1746568049285,WCWP 10B,C00,886492,Ornelas; Tricia,0,0,15,15
1746568050331,WCWP 100,A00,886494,Young; Mark T,0,6,15,15
1746568052432,AAS 10,A01,886199,Childs; Dennis R.,0,3,0,0
1746568053460,ANAR 104,A01,886940,Shtienberg; Gilad,27,0,30,3
1746568054483,ANAR 120,A00,886953,Staff,12,0,20,8
1746568055507,ANBI 148,A01,886955,Wilder; Linnea Lorene,30,0,40,10
1746568057561,ANSC 122,A00,886957,Staff,25,0,30,5
1746568058587,ANSC 150,A00,886958,Sloane; Julia Kathryn,2,0,15,13
1746568059615,ANSC 156,A00,886959,Jenkins; Janis A.,0,1,15,15
1746568060640,ANSC 180,A00,886960,Staff,11,0,17,6
1746568061667,ANSC 188,A00,886961,Jassal; Aftab,9,0,25,16
1746568062696,ANSC 190,A00,886962,Jassal; Aftab,14,0,25,11
1746568063722,ANSC 191,A00,886963,Staff,18,0,20,2
1746568064748,ANTH 3,A01,891689,Staff,17,0,20,3
1746568065773,ANTH 5,A00,886933,Semendeferi; Ekaterini,16,0,20,4
1746568066798,ANTH 10,A00,886934,Staff,0,12,30,30
1746568067822,ANTH 21,A01,886936,Staff,41,0,60,19
1746568068847,ANTH 23,A01,886938,Staff,92,0,100,8
1746568069876,ANTH 105,A00,886964,Stewart; Alexander B,84,0,100,16
1746568070901,ANTH 108,A00,886965,Pedersen; David,9,0,20,11
1746568071930,AWP 10,001,886147,Staff,0,0,0,0
1746568071930,AWP 10,002,886148,Staff,0,0,0,0
1746568071930,AWP 10,003,886149,Staff,0,0,0,0
1746568071930,AWP 10,004,886150,Staff,0,0,0,0
1746568071930,AWP 10,005,886151,Staff,0,0,0,0
1746568071930,AWP 10,006,886152,Staff,0,0,0,0
1746568071930,AWP 10,007,886153,Staff,0,0,0,0
1746568071930,AWP 10,008,886154,Staff,0,0,0,0
1746568071930,AWP 10,009,886155,Staff,0,0,0,0
1746568071930,AWP 10,010,886156,Staff,0,0,0,0
1746568071930,AWP 10,011,886158,Staff,0,0,0,0
1746568071930,AWP 10,012,886160,Staff,0,0,0,0
1746568071930,AWP 10,013,886161,Staff,0,0,0,0
1746568071930,AWP 10,014,886162,Staff,0,0,0,0
1746568071930,AWP 10,015,886163,Staff,0,0,0,0
1746568071930,AWP 10,016,886164,Staff,0,0,0,0
1746568071930,AWP 10,017,886165,Staff,0,0,0,0
1746568071930,AWP 10,018,886166,Staff,0,0,0,0
1746568071930,AWP 10,019,886168,Staff,0,0,0,0
1746568071930,AWP 10,020,886170,Staff,0,0,0,0
1746568071930,AWP 10,021,886172,Staff,0,0,0,0
1746568072957,AWP 10R,001,886173,Staff,0,1,0,0
1746568072957,AWP 10R,002,886174,Staff,0,1,0,0
1746568072957,AWP 10R,003,886175,Staff,0,0,0,0
1746568072957,AWP 10R,004,886176,Staff,0,0,0,0
1746568072957,AWP 10R,005,886177,Staff,0,0,0,0
1746568072957,AWP 10R,006,886178,Staff,0,0,0,0
1746568072957,AWP 10R,007,886179,Staff,0,0,0,0
1746568072957,AWP 10R,008,886181,Staff,0,0,0,0
1746568072957,AWP 10R,009,886182,Staff,0,0,0,0
1746568072957,AWP 10R,010,886183,Staff,0,0,0,0
1746568072957,AWP 10R,011,886184,Staff,0,0,0,0
1746568072957,AWP 10R,012,886185,Staff,0,0,0,0
1746568072957,AWP 10R,013,886186,Staff,0,0,0,0
1746568072957,AWP 10R,014,886187,Staff,0,0,0,0
1746568072957,AWP 10R,015,886188,Staff,0,0,0,0
1746568072957,AWP 10R,016,886189,Staff,0,0,0,0
1746568072957,AWP 10R,017,960532,Staff,0,0,0,0
1746568072957,AWP 10R,018,960533,Staff,0,0,0,0
1746568072957,AWP 10R,019,960534,Staff,0,0,0,0
1746568072957,AWP 10R,020,960538,Staff,0,0,0,0
1746568072957,AWP 10R,021,960540,Staff,0,0,0,0
1746568072957,AWP 10R,022,960541,Staff,0,0,0,0
1746568072957,AWP 10R,023,960542,Staff,0,0,0,0
1746568072957,AWP 10R,024,960544,Staff,0,0,0,0
1746568072957,AWP 10R,025,960545,Staff,0,0,0,0
1746568072957,AWP 10R,026,960548,Staff,0,0,0,0
1746568074183,AWP 102R,A00,886190,Staff,0,0,0,0
1746568074183,AWP 102R,B00,886191,Staff,0,0,0,0
1746568075211,BENG 100,A01,886193,Staff,17,0,30,13
1746568076235,BENG 122A,A01,886195,Hasty; Jeff M,13,0,30,17
1746568077262,BENG 166A,A00,886196,Sah; Robert Lie-Yuan,0,2,30,30
1746568078288,BENG 190,A00,958050,Khojah; Reem I,20,0,25,5
1746568079314,BIBC 102,A01,894320,Staff,0,0,46,46
1746568079314,BIBC 102,A02,894321,Staff,0,0,46,46
1746568079314,BIBC 102,A03,894344,Staff,7,0,46,39
1746568079314,BIBC 102,A04,894345,Staff,26,0,47,21
1746568080348,BICD 100R,A01,894365,Smith; Laurie,0,3,58,58
1746568080348,BICD 100R,A02,894366,Smith; Laurie,0,5,58,58
1746568080348,BICD 100R,A03,894367,Smith; Laurie,0,0,59,59
1746568080348,BICD 100R,A04,959869,Smith; Laurie,40,0,59,19
1746568081372,BICD 136,A01,894383,Gustafson-Brown; Cindy,14,0,50,36
1746568082416,BIEB 102,A01,894494,Butler; Shannon Rhey,51,0,130,79
1746568084468,BIEB 150,A01,894617,Wills; Christopher,3,0,20,17
1746568084468,BIEB 150,A02,894631,Wills; Christopher,3,0,20,17
1746568084468,BIEB 150,A03,894937,Wills; Christopher,3,0,20,17
1746568084468,BIEB 150,A04,894946,Wills; Christopher,5,0,20,15
1746568085497,BIEB 194,A00,906141,Kurle; Carolyn M.,6,0,20,14
1746568086524,BILD 1,A01,894154,Staff,3,0,19,16
1746568086524,BILD 1,A02,894155,Staff,14,0,19,5
1746568086524,BILD 1,A03,894160,Staff,13,0,19,6
1746568086524,BILD 1,A04,894161,Staff,15,0,18,3
1746568087553,BILD 2,A01,894168,Staff,0,0,50,50
1746568087553,BILD 2,A02,894169,Staff,0,0,50,50
1746568087553,BILD 2,A03,894179,Staff,0,0,50,50
1746568087553,BILD 2,A04,894203,Staff,25,0,50,25
1746568088578,BILD 3,A01,894213,Staff,22,0,31,9
1746568088578,BILD 3,A02,894214,Staff,26,0,31,5
1746568088578,BILD 3,A03,894235,Staff,28,0,31,3
1746568088578,BILD 3,A04,894236,Staff,28,0,32,4
1746568089607,BILD 4,A01,894253,Reuther; Keefe,6,0,24,18
1746568089607,BILD 4,A02,894258,Reuther; Keefe,16,0,24,8
1746568090634,BILD 5,A01,894276,Reuther; Keefe,35,0,50,15
1746568090634,BILD 5,A02,894277,Reuther; Keefe,45,0,50,5
1746568090634,BILD 5,A03,894290,Reuther; Keefe,44,0,50,6
1746568090634,BILD 5,A04,894291,Reuther; Keefe,48,0,50,2
1746568091660,BILD 24,A01,894297,Pirino; Giorgia,40,0,60,20
1746568092685,BIMM 100,B01,958915,Staff,71,0,100,29
1746568093710,BIMM 101,A01,895017,McDonnell; Lisa Marie,0,5,24,24
1746568093710,BIMM 101,A02,895018,McDonnell; Lisa Marie,0,5,24,24
1746568093710,BIMM 101,B01,895020,McDonnell; Lisa Marie,0,6,24,24
1746568093710,BIMM 101,B02,895021,McDonnell; Lisa Marie,0,4,24,24
1746568094737,BIMM 110,A01,895023,Staff,1,0,25,24
1746568094737,BIMM 110,A02,895024,Staff,9,0,25,16
1746568094737,BIMM 110,A03,895025,Staff,18,0,25,7
1746568094737,BIMM 110,A04,895031,Staff,20,0,25,5
1746568095764,BIMM 120,A01,895114,Gustafson-Brown; Cindy,14,0,28,14
1746568095764,BIMM 120,A02,895126,Gustafson-Brown; Cindy,21,0,27,6
1746568096789,BIPN 100,A01,895130,Yang; Mingyu,1,0,38,37
1746568096789,BIPN 100,A02,895131,Yang; Mingyu,32,0,38,6
1746568096789,BIPN 100,A03,895132,Yang; Mingyu,32,0,38,6
1746568096789,BIPN 100,A04,895133,Yang; Mingyu,27,0,36,9
1746568097819,BIPN 120,A01,895135,Cooke; James Edward,0,3,13,13
1746568097819,BIPN 120,A02,895136,Cooke; James Edward,0,1,13,13
1746568097819,BIPN 120,A03,895137,Cooke; James Edward,0,3,13,13
1746568097819,BIPN 120,A04,895156,Cooke; James Edward,0,2,11,11
1746568098844,BIPN 134,A01,895235,Cooke; James Edward,0,2,25,25
1746568098844,BIPN 134,A02,895237,Cooke; James Edward,0,0,25,25
1746568098844,BIPN 134,A03,895240,Cooke; James Edward,3,0,25,22
1746568098844,BIPN 134,A04,895270,Cooke; James Edward,20,0,25,5
1746568099874,BIPN 189,A00,892103,Staff,0,14,14,14
1746568101924,BISP 194,A00,958008,Staff,0,2,0,0
1746568102952,CAT 124,A01,922009,Staff,0,5,20,20
1746568103986,CAT 125R,A00,886390,Morales; Celeste Georgianna,0,2,20,20
1746568103986,CAT 125R,B00,886391,Irwin; Matthew Joseph,0,4,20,20
1746568103986,CAT 125R,C00,886392,Smith; Lauryn Alissa,0,2,20,20
1746568103986,CAT 125R,D00,886393,Vanderschuit; Maya Alysia,0,3,20,20
1746568103986,CAT 125R,E00,886394,Marchisotto; Jennifer Anne,0,3,20,20
1746568105012,CENG 15,A01,886218,Drews; Aaron,3,0,8,5
1746568106041,CENG 113,A00,886219,Opatkiewicz; Justin Paul,15,0,25,10
1746568107068,CGS 101,A00,887044,Staff,7,0,20,13
1746568108094,CGS 105,A01,887046,Staff,14,0,25,11
1746568109124,CGS 112,A00,887047,Cuong; Marisol,12,0,15,3
1746568110151,CGS 113,A00,887048,Staff,23,0,30,7
1746568111181,CGS 120,A00,887049,Staff,10,0,17,7
1746568112215,CHEM 6A,A01,886336,Lam; Tin Yiu,38,0,50,12
1746568112215,CHEM 6A,A02,886338,Lam; Tin Yiu,37,0,50,13
1746568113241,CHEM 6B,A01,886341,Hopkins; Patrycja Anna,16,0,50,34
1746568113241,CHEM 6B,A02,886343,Hopkins; Patrycja Anna,42,0,50,8
1746568114269,CHEM 6C,A01,886346,Albizati; Kim F.,0,2,50,50
1746568114269,CHEM 6C,A02,886348,Albizati; Kim F.,23,0,50,27
1746568115300,CHEM 40A,A01,886352,Klosterman; Jeremy K,65,0,100,35
1746568116326,CHEM 40B,A01,886356,Klosterman; Jeremy K,0,23,100,100
1746568117352,CHEM 41B,A01,886360,Theodorakis; Emmanuel,25,0,50,25
1746568117352,CHEM 41B,A02,886362,Theodorakis; Emmanuel,47,0,50,3
1746568118379,CHIN 165A,A00,886382,Xu; Li,18,0,20,2
1746568119409,CLAS 120,A00,886387,Myerston Santana; Jacobo,33,0,40,7
1746568120433,COGS 9,A01,886967,Shannon; Kyle Michael,42,0,60,18
1746568121460,COGS 11,A01,886969,Staff,10,0,30,20
1746568122486,COGS 14A,A01,886971,Staff,6,0,60,54
1746568123515,COGS 14B,A01,886973,Hoffman; Drew Ellen,4,0,60,56
1746568124540,COGS 18,A01,886975,Morgan; Eric,35,0,60,25
1746568125569,COGS 20,A01,886977,Staff,4,0,8,4
1746568125569,COGS 20,A02,886978,Staff,5,0,7,2
1746568126595,COGS 100,A01,907783,Staff,1,2,30,29
1746568127623,COGS 101B,A01,886980,Staff,0,3,48,48
1746568128652,COGS 101C,A01,886982,Delgado; Tania,0,5,44,44
1746568129676,COGS 102A,A01,886984,Johnson; Christine M.,4,0,30,26
1746568130702,COGS 118B,A01,886986,Staff,1,3,88,87
1746568131731,COGS 150,A01,886988,Bergen; Benjamin,22,0,50,28
1746568132756,COGS 153,A00,886989,Delgado; Tania,0,2,41,41
1746568133783,COGS 186,A01,886991,Staff,0,0,32,32
1746568134809,COGS 187A,A01,886993,Boyle; Mary E. T.,7,0,30,23
1746568135834,COGS 189,A00,886994,Staff,0,1,30,30
1746568136864,COMM 10,A01,886996,Staff,0,0,20,21
1746568136864,COMM 10,A02,886997,Staff,12,0,20,8
1746568136864,COMM 10,A03,959845,Staff,19,0,20,1
1746568137893,COMM 20,A01,886999,Leuning; Grant Maurstad,24,0,40,16
1746568139944,COMM 100A,A01,887002,Staff,0,0,20,25
1746568139944,COMM 100A,A02,887003,Staff,6,0,20,14
1746568140972,COMM 100B,A01,887005,Staff,0,8,20,24
1746568141997,COMM 106D,A00,887006,Staff,13,0,40,27
1746568143022,COMM 110G,A00,887007,Whitworth-Smith; Andrew C,12,0,40,28
1746568144046,COMM 111B,A00,887008,Staff,31,0,40,9
1746568145077,COMM 113T,A00,887009,Abuelhiga; Soraya Jill,28,0,40,12
1746568145077,COMM 113T,B00,906733,Staff,40,0,40,0
1746568146103,COMM 145,A00,887010,Staff,12,0,40,28
1746568147130,COMM 146,A00,887054,Staff,31,0,40,9
1746568148158,COMM 190,A00,887012,Staff,8,0,23,15
1746568149184,CSE 8A,A50,887015,Cao; Yingjun,57,0,85,28
1746568150209,CSE 11,A01,887017,Cao; Yingjun,12,0,70,58
1746568151240,CSE 20,A01,887019,Staff,30,0,50,20
1746568152265,CSE 21,A01,887021,Staff,78,0,100,22
1746568152265,CSE 21,B01,892583,Braun; Oliver,45,0,50,5
1746568153292,CSE 30,A01,887025,Eldon; John,143,0,200,57
1746568154322,CSE 100,A01,887027,Staff,26,0,50,24
1746568154322,CSE 100,A02,887028,Staff,42,0,50,8
1746568155347,CSE 101,A01,887030,Braun; Oliver,74,0,100,26
1746568155347,CSE 101,B01,887032,Jones; Miles E,0,3,50,50
1746568155347,CSE 101,B02,887033,Jones; Miles E,0,2,50,50
1746568156375,CSE 105,A01,908084,Jones; Miles E,32,0,50,18
1746568156375,CSE 105,A02,908087,Jones; Miles E,31,0,50,19
1746568157403,CSE 135,A01,887035,Powell; Thomas Allan,0,5,50,50
1746568158427,CSE 142,A01,887037,Staff,8,0,60,52
1746568159453,CSE 142L,A01,887039,Staff,34,0,60,26
1746568160479,CSE 151A,A01,887041,Solares; Edwin A,47,0,100,53
1746568161505,CSE 175,A01,887043,Kumar; Rakesh,30,0,30,0
1746568162534,CSS 1,A01,886389,Staff,1,1,40,39
1746568163563,DSC 30,A01,908097,Liao; Soohyun Nam,47,0,75,28
1746568164588,DSC 40A,A01,908099,Shannon; Kyle Michael,30,0,50,20
1746568165615,DSC 40B,A01,908112,Staff,15,0,50,35
1746568166639,DSC 80,A01,908116,Staff,19,0,60,41
1746568167667,DSC 197,001,956863,Eldridge; Justin Matthew,9999,0,9999,0
1746568168694,ECE 5,A01,886400,Morris; Karcher William,1,0,6,5
1746568168694,ECE 5,A02,886401,Morris; Karcher William,3,0,6,3
1746568169722,ECE 148,A01,886403,Silberman; Jack,0,14,14,14
1746568170748,ECON 1,A01,887265,Crane; Meredith Helen,12,0,70,58
1746568170748,ECON 1,B01,887268,Staff,43,0,50,7
1746568171777,ECON 2,A01,887273,Crane; Meredith Helen,55,0,70,15
1746568172801,ECON 3,A01,887279,Rondina; Giacomo,32,0,70,38
1746568173829,ECON 4,A01,887282,Anderson; John Charles,0,2,10,10
1746568174855,ECON 5,A01,887285,Staff,34,0,45,11
1746568174855,ECON 5,B01,887292,Staff,41,0,45,4
1746568175881,ECON 100A,A01,887337,Newhouse; Herbert S,54,0,70,16
1746568175881,ECON 100A,B01,887349,Staff,45,0,50,5
1746568176910,ECON 100B,A01,887361,Du; Songzi,29,0,70,41
1746568177936,ECON 100C,A01,887445,Newhouse; Herbert S,59,0,70,11
1746568178961,ECON 105,A00,887488,Vespa; Emanuel Ignacio,23,0,35,12
1746568179991,ECON 109,A01,887506,Shishkin; Denis,28,0,35,7
1746568181016,ECON 110A,A01,887568,Alon; Titan Michael,0,3,35,35
1746568181016,ECON 110A,B01,907601,Alon; Titan Michael,20,0,35,15
1746568182045,ECON 110B,A01,887598,Levkoff; Steven B.,0,24,70,70
1746568183072,ECON 112,A00,887599,Rondina; Giacomo,19,0,35,16
1746568184102,ECON 120A,A01,887603,Dai; Yinlin,35,0,70,35
1746568185127,ECON 120C,A01,887608,Sun; Yixiao,0,1,35,35
1746568185127,ECON 120C,B01,887614,Sun; Yixiao,0,0,35,35
1746568186158,ECON 138,A00,887621,Bharadwaj; Prashant,0,21,20,20
1746568187186,ECON 144,A00,958007,Squires; Dale E,12,0,35,23
1746568188211,ECON 171,A01,907666,Staff,17,0,35,18
1746568189235,ECON 175,A00,887626,Wu; Pak Yeung,22,0,35,13
1746568190260,ECON 190,A00,887640,Vespa; Emanuel Ignacio,23,0,35,12
1746568191293,EDS 25,A01,888197,Staff,0,0,0,0
1746568191293,EDS 25,A02,888209,Staff,0,0,0,0
1746568191293,EDS 25,A03,888210,Staff,0,0,0,0
1746568191293,EDS 25,A04,888212,Staff,0,0,0,0
1746568191293,EDS 25,A05,888213,Staff,0,0,0,0
1746568191293,EDS 25,A06,888214,Staff,0,0,0,0
1746568191293,EDS 25,A07,888235,Staff,0,2,0,0
1746568191293,EDS 25,A08,888236,Staff,0,0,0,0
1746568191293,EDS 25,A09,888240,Staff,0,0,0,0
1746568191293,EDS 25,A10,888244,Staff,0,0,0,0
1746568191293,EDS 25,B01,888273,Staff,0,0,0,0
1746568191293,EDS 25,B02,888285,Staff,0,0,0,0
1746568191293,EDS 25,B03,888423,Staff,0,0,0,1
1746568191293,EDS 25,B04,888432,Staff,0,0,0,0
1746568191293,EDS 25,B05,888433,Staff,0,0,0,0
1746568191293,EDS 25,B06,888467,Staff,0,0,0,0
1746568191293,EDS 25,B07,888468,Staff,0,0,0,0
1746568191293,EDS 25,B08,888479,Staff,0,0,0,0
1746568191293,EDS 25,B09,888484,Staff,0,0,0,0
1746568191293,EDS 25,B10,888487,Staff,0,0,0,0
1746568192317,EDS 38,A01,907700,Choi; Bailey Miyeon,30,0,30,0
1746568193346,EDS 112,A01,888601,Chapman; Thandeka K,12,0,40,28
1746568194374,EDS 115,A00,888697,Mendez; Kathrina Mendoza,10,0,30,20
1746568195398,EDS 116,A01,888893,Staff,34,0,40,6
1746568197519,EDS 124AR,A00,889133,Staff,28,0,50,22
1746568197519,EDS 124AR,B00,907471,Simon; Elizabeth A,36,0,50,14
1746568198544,EDS 124BR,A00,889134,Simon; Elizabeth A,44,0,100,56
1746568199568,EDS 125,A00,889135,Staff,25,0,30,5
1746568200596,EDS 126,A01,889138,Staff,36,0,40,4
1746568201625,EDS 164R,A01,889142,Wishard Guerra; Alison G.,33,0,50,17
1746568202654,ENG 30,A01,886396,Staff,0,0,0,0
1746568202654,ENG 30,B01,886398,Staff,0,0,0,0
1746568203683,ENVR 102,A00,906150,Montejo; Carolina,23,0,25,2
1746568204708,ETHN 103A,A00,887236,Man; Simeon S,0,3,0,0
1746568205731,ETHN 113,A00,887239,Staff,16,0,30,14
1746568206757,ETHN 116,A00,887240,Staff,16,0,25,9
1746568207786,ETHN 117,A00,887241,Choi; Esther Min,28,0,30,2
1746568208811,ETHN 118,A00,887243,Staff,24,0,30,6
1746568209840,ETHN 127,A00,887248,Cuong; Marisol,11,0,15,4
1746568210865,ETHN 139,A00,887250,Staff,7,0,10,3
1746568211894,ETHN 142,A00,887252,Staff,10,0,30,20
1746568212924,ETHN 161,A00,887253,Browne; Errol Tsekani,24,0,30,6
1746568213952,ETHN 163FR,A00,887255,Burelle; Julie Sara Veronique,0,0,5,5
1746568214977,GLBH 20,A00,889149,Elwardani; Nile Regina,8,0,42,34
1746568217029,GLBH 111,A01,889152,Burgos; Jose L.,17,0,17,0
1746568218056,GLBH 150,A00,889181,Sloane; Julia Kathryn,0,5,15,15
1746568220114,HDS 60,A01,886406,Warstadt; Melissa Fawn,73,0,80,7
1746568221142,HIAF 111,A00,889324,Gyamfi; Bright,25,0,32,7
1746568222166,HIEA 131,A00,889328,Staff,15,0,32,17
1746568223192,HIEA 144,A00,889333,Henry; Todd A.,26,0,32,6
1746568224217,HIEA 154,A00,889336,Henry; Todd A.,24,0,32,8
1746568225242,HIEU 106,A00,889339,Staff,22,0,32,10
1746568227295,HIEU 114,A00,889340,Staff,3,0,32,29
1746568228324,HIEU 135GS,A00,889342,Patterson; Patrick H.,0,0,1,24
1746568229358,HIEU 137,A00,889343,Edington; Claire Ellen,10,0,25,15
1746568230383,HIEU 148,A00,889345,Staff,14,0,32,18
1746568231407,HIEU 154,A00,889346,Biess; Frank Peter,21,0,32,11
1746568232431,HILA 102,A00,889351,Staff,12,0,32,20
1746568233458,HILD 2A,A01,889221,Lewandoski; Julia Mavis,1,10,32,31
1746568234486,HILD 7B,A01,889225,Man; Simeon S,0,12,32,32
1746568235511,HILD 7C,A01,889288,Alvarez; Luis A,0,14,32,32
1746568236540,HILD 30,A01,889323,Staff,0,5,32,32
1746568238596,HISC 119,A00,889383,Golan; Tal,19,0,32,13
1746568239620,HIUS 103,A00,889384,Man; Simeon S,0,0,32,32
1746568240645,HIUS 117,A00,919797,Kwak; Nancy,19,0,32,13
1746568241670,HIUS 142A,A00,919788,Staff,22,0,32,10
1746568243718,HIUS 149,A00,889386,Gyamfi; Bright,26,0,32,6
1746568244743,HIUS 155,A00,889387,Alvarez; Luis A,14,0,32,18
1746568245773,HUM 3,A01,886499,Caldwell; Michael Alan,19,0,50,31
1746568246797,HUM 3GS,A00,886500,Rodriguez; Bretton Sigfred,0,0,0,28
1746568247826,HUM 3R,A01,886502,Markman; Kristina,0,36,50,50
1746568248855,HUM 4,A01,886504,Crum; Matthew Stephen,24,0,50,26
1746568248855,HUM 4,B01,886506,West; Geoffrey Scott,17,0,50,33
1746568249879,HUM 4GS,A00,886507,Staff,0,0,0,19
1746568250904,HUM 5,A01,886509,Staff,32,0,50,18
1746568251931,HUM 5R,A01,886511,Zavodny; Tatiana Sophia,0,39,50,50
1746568252954,JAPN 180,A00,886407,Staff,16,0,40,24
1746568253980,LATI 50,A01,886409,Martin-Cabrera; Luis,4,0,22,18
1746568253980,LATI 50,A02,886410,Martin-Cabrera; Luis,19,0,22,3
1746568253980,LATI 50,A03,886411,Martin-Cabrera; Luis,21,0,22,1
1746568253980,LATI 50,A04,886412,Martin-Cabrera; Luis,9,0,22,13
1746568255005,LAWS 101,A00,907664,Staff,28,0,60,32
1746568256032,LIAB 1A,A00,889388,Saab; Dima,17,0,20,3
1746568257057,LIAB 1AX,A00,889389,El Cheddadi; Youniss,18,0,20,2
1746568258083,LIFR 1C,A00,889391,Van Moer; Vinciane G,8,0,20,12
1746568259108,LIFR 1CX,A00,889392,Van Moer; Vinciane G,7,0,20,13
1746568260134,LIFR 1D,A00,889393,Van Moer; Vinciane G,7,0,20,13
1746568261161,LIFR 1DX,A00,889394,Van Moer; Vinciane G,8,0,20,12
1746568262186,LIGN 7,A00,886923,Staff,24,0,50,26
1746568263211,LIGN 17,A00,886924,Kehler; Andrew Scott,125,0,150,25
1746568264234,LTAM 110,A00,889395,Staff,15,0,30,15
1746568265260,LTAM 110GS,A00,958010,Rodriguez; Bretton Sigfred,0,0,0,28
1746568266285,LTCH 101,A00,889397,Staff,23,0,25,2
1746568267310,LTCS 130,A00,889398,Staff,23,0,25,2
1746568268334,LTEA 138,A00,889399,Staff,24,0,40,16
1746568269362,LTEN 149,A00,889400,Wesling; Megan E.,0,3,25,25
1746568270387,LTEN 169,A00,889401,Staff,20,0,25,5
1746568271413,LTEN 180,A00,889402,Staff,10,0,15,5
1746568272439,LTEN 181,A00,889403,Staff,21,0,25,4
1746568273466,LTWL 100,A00,889404,Myerston Santana; Jacobo,2,0,25,23
1746568274491,LTWL 180GS,A00,889405,Staff,0,0,20,20
1746568275516,LTWL 181,A00,889406,Staff,16,0,25,9
1746568276545,LTWL 184,A00,889475,Mukherjee; Silpa,22,0,25,3
1746568277572,LTWR 102C,A00,889486,Staff,29,0,30,1
1746568278600,LTWR 115W,A00,889491,Staff,0,2,15,15
1746568279626,MAE 8,A01,886905,Staff,0,2,0,0
1746568280651,MAE 11,A00,886906,Bandaru; Prabhakar,0,7,50,50
1746568281677,MAE 20,A00,886907,Evdokimenko; Ekaterina,43,0,70,27
1746568282704,MAE 30B,A00,886909,Ghazinejad; Maziar,26,0,45,19
1746568283729,MAE 101B,A00,886910,Saintillan; David,29,0,45,16
1746568284753,MAE 105,A00,886911,Bandaru; Prabhakar,18,0,50,32
1746568285780,MAE 107,B00,958024,Staff,8,0,50,42
1746568286809,MAE 143B,A00,886913,Bewley; Thomas R,6,0,40,34
1746568287834,MAE 148,A01,886915,Silberman; Jack,0,3,14,14
1746568288859,MAE 160,A00,886916,Evdokimenko; Ekaterina,31,0,60,29
1746568289889,MATH 3C,A01,889681,Staff,0,2,30,30
1746568289889,MATH 3C,A02,960048,Staff,24,0,30,6
1746568290917,MATH 10A,A01,889760,Staff,26,0,30,4
1746568290917,MATH 10A,A02,889783,Staff,29,0,30,1
1746568291943,MATH 10B,A01,889785,Verstraete; Jacques Allan,2,0,35,33
1746568291943,MATH 10B,A02,889795,Verstraete; Jacques Allan,4,0,35,31
1746568291943,MATH 10B,B01,889797,Verstraete; Jacques Allan,3,0,35,32
1746568291943,MATH 10B,B02,889828,Verstraete; Jacques Allan,3,0,35,32
1746568292968,MATH 10C,A01,889849,Habib; Yousaf,7,0,30,23
1746568292968,MATH 10C,A02,889852,Habib; Yousaf,14,0,30,16
1746568292968,MATH 10C,A03,889853,Habib; Yousaf,22,0,30,8
1746568292968,MATH 10C,A04,889858,Habib; Yousaf,20,0,30,10
1746568292968,MATH 10C,B01,889861,Staff,1,0,30,29
1746568292968,MATH 10C,B02,889862,Staff,24,0,30,6
1746568292968,MATH 10C,B03,889863,Staff,27,0,30,3
1746568292968,MATH 10C,B04,889967,Staff,23,0,30,7
1746568293993,MATH 18,A01,889974,Staff,7,0,30,23
1746568293993,MATH 18,A02,889977,Staff,20,0,30,10
1746568293993,MATH 18,B01,889984,Hardiman; Liam,21,0,30,9
1746568293993,MATH 18,B02,889985,Hardiman; Liam,25,0,30,5
1746568295025,MATH 20A,A01,889990,Suk; Andrew Hoon,30,0,35,5
1746568296053,MATH 20B,A01,889993,Ohm; Ko Woon,22,0,30,8
1746568296053,MATH 20B,A02,889994,Ohm; Ko Woon,30,0,30,0
1746568296053,MATH 20B,B01,889996,Ohm; Ko Woon,21,0,30,9
1746568296053,MATH 20B,B02,889997,Ohm; Ko Woon,23,0,30,7
1746568297083,MATH 20C,A01,889999,Hammock; Frances H,17,0,30,13
1746568297083,MATH 20C,A02,890003,Hammock; Frances H,23,0,30,7
1746568297083,MATH 20C,B01,890006,Hammock; Frances H,3,0,30,27
1746568297083,MATH 20C,B02,890007,Hammock; Frances H,12,0,30,18
1746568298109,MATH 20D,A01,890011,Cheng; Hsiao-Bing,1,1,30,29
1746568298109,MATH 20D,A02,890012,Cheng; Hsiao-Bing,14,0,30,16
1746568298109,MATH 20D,B01,890016,Cheng; Hsiao-Bing,13,0,30,17
1746568298109,MATH 20D,B02,890017,Cheng; Hsiao-Bing,13,0,30,17
1746568299140,MATH 20E,A01,890026,Harel; Guershon,1,0,30,29
1746568299140,MATH 20E,A02,890029,Harel; Guershon,23,0,30,7
1746568299140,MATH 20E,B01,890033,Harel; Guershon,7,0,30,23
1746568299140,MATH 20E,B02,890101,Harel; Guershon,21,0,30,9
1746568300169,MATH 102,A01,890104,Staff,17,0,30,13
1746568300169,MATH 102,A02,890105,Staff,27,0,30,3
1746568301200,MATH 103B,A01,890116,Salehi Golsefidy; Alireza,3,0,30,27
1746568301200,MATH 103B,B01,890118,Staff,0,3,34,34
1746568302227,MATH 109,A01,890121,Aliabadi Sr.; Mohsen,1,0,30,29
1746568302227,MATH 109,B01,890124,Upadrashta; Pranav Kumar,18,0,30,12
1746568303251,MATH 120A,A01,890126,Eggers; John Dietrich,13,0,30,17
1746568304276,MATH 142B,A01,890128,Ioana; Adrian,19,0,30,11
1746568304276,MATH 142B,A02,890129,Ioana; Adrian,13,0,30,17
1746568305301,MATH 154,A01,890174,Staff,0,0,30,30
1746568305301,MATH 154,A02,890182,Staff,0,0,30,30
1746568306329,MATH 168A,A01,890197,Dumitriu; Ioana,21,0,35,14
1746568307359,MATH 170A,A01,890240,Nie; Jiawang,1,0,30,29
1746568307359,MATH 170A,A02,890241,Nie; Jiawang,11,0,30,19
1746568307359,MATH 170A,A03,890249,Nie; Jiawang,23,0,30,7
1746568308383,MATH 170B,A01,957891,Nag; Panchali,13,0,35,22
1746568310441,MATH 181A,A01,908025,Staff,0,4,35,35
1746568310441,MATH 181A,A02,960115,Staff,27,0,35,8
1746568311468,MATH 181B,A01,959874,Staff,25,0,30,5
1746568312493,MATH 193B,A01,890265,Staff,0,4,35,35
1746568313524,MGT 4,A01,890311,Anderson; John Charles,42,0,88,46
1746568314550,MGT 5,A00,907740,Staff,13,0,98,85
1746568315577,MGT 12,A00,890312,Lindenberger; Wade Douglas,67,0,98,31
1746568316603,MGT 16,A00,957883,Staff,78,0,98,20
1746568318660,MGT 45,A00,890314,Pecore; Joseph P.,46,0,98,52
1746568319689,MGT 71,A00,890315,Staff,0,11,98,98
1746568320717,MGT 100,A00,890316,Yavorsky; Daniel Ryan,44,0,98,54
1746568321743,MGT 103,A00,890317,Ehrich; Kristine R,73,0,98,25
1746568322771,MGT 105,A00,890356,Bates; Kenneth Walter,0,8,98,98
1746568323797,MGT 112,A00,890360,Ehrich; Kristine R,55,0,98,43
1746568324822,MGT 127R,A00,907732,Zhu; Kevin Xiaoguo,23,0,98,75
1746568325846,MGT 131B,A00,890361,Anderson; John Charles,60,0,98,38
1746568326872,MGT 137,A00,890362,Lindenberger; Wade Douglas,65,0,98,33
1746568327904,MGT 160,A00,890369,Johnson; Erik Barry,9,0,98,89
1746568329956,MGT 164,A00,890372,Zimmermann; Carsten,0,40,98,98
1746568330982,MGT 180,A00,890374,Bliss; Barbara Ann,12,0,98,86
1746568332007,MMW 15,A01,886414,Chang; Edmond Yi-Teh,0,12,28,28
1746568332007,MMW 15,A02,886415,Chang; Edmond Yi-Teh,0,8,28,28
1746568332007,MMW 15,A03,886416,Chang; Edmond Yi-Teh,0,8,28,28
1746568332007,MMW 15,A04,886417,Chang; Edmond Yi-Teh,0,8,28,28
1746568332007,MMW 15,B01,886419,Chang; Edmond Yi-Teh,0,7,28,28
1746568332007,MMW 15,B02,886420,Chang; Edmond Yi-Teh,0,8,28,28
1746568332007,MMW 15,B03,886421,Chang; Edmond Yi-Teh,0,7,28,28
1746568332007,MMW 15,B04,886422,Chang; Edmond Yi-Teh,0,8,28,28
1746568332007,MMW 15,C01,886424,Staff,0,9,28,28
1746568332007,MMW 15,C02,886425,Staff,0,8,28,28
1746568332007,MMW 15,C03,886426,Staff,0,8,28,28
1746568332007,MMW 15,C04,886427,Staff,0,8,28,28
1746568332007,MMW 15,C05,958038,Staff,0,8,28,28
1746568332007,MMW 15,C06,958039,Staff,1,8,28,27
1746568333034,MMW 15GS,A00,906910,Patterson; Patrick H.,4,0,28,24
1746568334060,MMW 122R,A01,886429,Rahimi; Babak,0,13,28,28
1746568334060,MMW 122R,A02,886430,Rahimi; Babak,0,12,28,28
1746568334060,MMW 122R,A03,958040,Rahimi; Babak,0,11,28,28
1746568335090,MUS 1A,A01,890937,Staff,2,0,25,23
1746568335090,MUS 1A,A02,891035,Staff,6,0,25,19
1746568335090,MUS 1A,C01,958912,Staff,24,0,25,1
1746568335090,MUS 1A,C02,958913,Staff,25,0,25,0
1746568337141,MUS 2AK,A00,957092,Ohnishi; Takae,15,0,15,0
1746568338168,MUS 4,A01,891044,Staff,2,0,25,23
1746568338168,MUS 4,A02,891045,Staff,23,0,25,2
1746568338168,MUS 4,B01,891048,Staff,17,0,25,8
1746568338168,MUS 4,B02,891050,Staff,25,0,25,0
1746568339197,MUS 5,A01,957506,Dubnov; Shlomo,0,0,25,25
1746568339197,MUS 5,A02,957622,Dubnov; Shlomo,13,0,25,12
1746568339197,MUS 5,A03,957623,Dubnov; Shlomo,20,0,25,5
1746568340222,MUS 6,A01,891053,Freitas Caetano; Marcelo,24,0,25,1
1746568340222,MUS 6,A02,891054,Freitas Caetano; Marcelo,23,0,25,2
1746568341248,MUS 7,A01,891081,Staff,0,0,25,25
1746568341248,MUS 7,A02,891082,Staff,3,0,25,22
1746568342273,MUS 8GS,A00,891118,Borgo; David Garcia,1,0,25,24
1746568343299,MUS 11,A01,891140,Staff,9,0,25,16
1746568343299,MUS 11,A02,891141,Staff,22,0,25,3
1746568344325,MUS 13,A01,891143,Staff,8,0,25,17
1746568344325,MUS 13,A02,891144,Staff,24,0,25,1
1746568345355,MUS 15,A01,891146,Staff,9,0,25,16
1746568345355,MUS 15,A02,891148,Staff,21,0,25,4
1746568345355,MUS 15,B01,891150,Staff,18,0,25,7
1746568345355,MUS 15,B02,891151,Staff,25,0,25,0
1746568346380,MUS 20,A01,891153,Staff,5,0,20,15
1746568346380,MUS 20,A02,891155,Staff,14,0,20,6
1746568347410,MUS 80,A00,891156,Staff,19,0,25,6
1746568347410,MUS 80,B00,891157,Staff,23,0,25,2
1746568348435,MUS 130,A00,891158,Ohnishi; Takae,35,0,35,0
1746568349461,MUS 150GS,A01,891160,Borgo; David Garcia,1,0,25,24
1746568350485,MUS 170,A01,891162,Freitas Caetano; Marcelo,20,0,25,5
1746568350485,MUS 170,A02,891164,Freitas Caetano; Marcelo,21,0,25,4
1746568351511,NANO 11,A00,886220,Vazquez Mena; Oscar,13,0,15,2
1746568352537,NANO 15,A01,886222,Drews; Aaron,4,0,7,3
1746568353564,NANO 104,A00,886224,Sirbuly; Donald,17,0,25,8
1746568354588,PH 40,A00,886528,Staff,23,0,40,17
1746568355638,PH 45,A01,886799,Staff,35,0,40,5
1746568356668,PH 110,A00,886802,Staff,0,7,40,40
1746568357697,PH 172,A00,906716,Staff,19,0,35,16
1746568358722,PH 191,A00,886803,Staff,6,0,40,34
1746568359747,PHIL 1,A00,889500,Staff,20,0,30,10
1746568360773,PHIL 10,A01,889549,Grush; Rick Scott,15,0,22,7
1746568360773,PHIL 10,A02,889551,Grush; Rick Scott,22,0,22,0
1746568361803,PHIL 28,A01,889559,Lamey; Andy M.,0,2,31,31
1746568361803,PHIL 28,A02,889561,Lamey; Andy M.,0,1,30,30
1746568361803,PHIL 28,A03,889572,Lamey; Andy M.,0,1,30,30
1746568362829,PHIL 35,A00,907839,Staff,13,0,15,2
1746568363859,PHIL 60,A00,889574,Staff,73,0,90,17
1746568364886,PHIL 101,A00,958004,Staff,12,0,15,3
1746568366939,PHIL 136,A00,889582,Fulkerson; Matthew Todd,26,0,45,19
1746568367965,PHIL 163,A01,889601,Staff,21,0,30,9
1746568367965,PHIL 163,B01,889606,Brandt; Reuven A,0,3,0,0
1746568368991,PHIL 164,A00,889610,Staff,16,0,30,14
1746568370022,PHIL 165,A00,889613,Staff,22,0,30,8
1746568371048,PHYS 1A,A00,886431,Staff,26,0,70,44
1746568372072,PHYS 1AL,001,886432,Tsai; Philbert S,0,2,30,30
1746568372072,PHYS 1AL,002,886436,Tsai; Philbert S,11,0,30,19
1746568373104,PHYS 1B,A00,886439,Staff,185,0,240,55
1746568374129,PHYS 1BL,001,886441,Tsai; Philbert S,0,4,30,30
1746568374129,PHYS 1BL,002,886444,Tsai; Philbert S,2,0,30,28
1746568375153,PHYS 1C,A00,896092,Arnold; Kam S,78,0,146,68
1746568376178,PHYS 1CL,001,886448,Tsai; Philbert S,0,0,30,30
1746568376178,PHYS 1CL,002,886449,Tsai; Philbert S,1,0,30,29
1746568376178,PHYS 1CL,003,886450,Tsai; Philbert S,16,0,30,14
1746568376178,PHYS 1CL,004,886451,Tsai; Philbert S,15,0,30,15
1746568377204,PHYS 2B,A01,886457,Staff,68,0,115,47
1746568378228,PHYS 2C,A01,886460,Shotwell; Brian,0,9,65,65
1746568379254,PHYS 2CL,A01,886467,Staff,0,4,28,28
1746568379254,PHYS 2CL,A02,886468,Staff,0,3,28,28
1746568380285,PHYS 2D,A01,886470,Staff,10,0,50,40
1746568381310,PHYS 4B,A01,886475,Grinstein; Benjamin,22,0,40,18
1746568382335,POLI 5,A00,891173,Desposato; Scott,7,0,25,18
1746568383360,POLI 5D,A01,891175,Staff,5,0,5,0
1746568383360,POLI 5D,B01,891178,Staff,5,0,5,0
1746568384386,POLI 11,A00,891179,Ferree; Karen E,2,0,35,33
1746568385409,POLI 12,A00,891180,Staff,16,0,30,14
1746568386438,POLI 27,A01,891182,Staff,12,0,75,63
1746568387462,POLI 30,A00,891183,Staff,8,0,50,42
1746568388486,POLI 100B,A00,891244,Staff,5,1,35,30
1746568389511,POLI 100I,A00,891247,Staff,7,0,30,23
1746568390536,POLI 104J,A00,891248,Nichter; Maysa,14,0,30,16
1746568391564,POLI 104U,A00,891250,Nichter; Maysa,2,0,30,28
1746568393616,POLI 110B,A00,891255,Wiens; David,20,0,25,5
1746568394640,POLI 112A,A00,891256,Wiens; David,6,0,25,19
1746568395666,POLI 114BR,A00,891261,Staff,19,0,30,11
1746568396691,POLI 117R,A00,891262,Forman; Fonna,0,6,50,50
1746568397720,POLI 118,A00,891264,Ingham; Sean,17,0,25,8
1746568398748,POLI 124A,A00,891265,Staff,18,0,20,2
1746568399773,POLI 125D,A00,891266,Nichter; Simeon C,2,0,25,23
1746568400801,POLI 126,A00,891268,Nichter; Simeon C,7,0,25,18
1746568401826,POLI 126AA,A00,891272,Staff,16,0,25,9
1746568402853,POLI 130AA,A00,891273,Staff,15,0,20,5
1746568403877,POLI 134AA,A00,891274,Staff,4,0,20,16
1746568405932,POLI 138,A00,891278,Staff,21,0,25,4
1746568406957,POLI 142K,A00,891280,Staff,10,0,25,15
1746568407981,POLI 142M,A00,891281,Gartzke; Erik,16,0,30,14
1746568409008,POLI 142P,A00,891284,Staff,20,0,30,10
1746568410033,POLI 143,A00,891285,Gartzke; Erik,12,0,30,18
1746568411062,POLI 153,A00,891286,Staff,19,0,20,1
1746568413115,POLI 175,A00,891290,Staff,15,0,20,5
1746568414140,PSYC 1,A00,890674,Steiner; Eric Tomas,0,11,45,45
1746568415168,PSYC 2,A00,890676,Albright; Thomas D,21,0,35,14
1746568416197,PSYC 3,A00,890679,Staff,17,0,20,3
1746568417224,PSYC 6,A00,959858,Staff,20,0,20,0
1746568418251,PSYC 60,A01,890684,Rickard; Timothy C.,0,5,45,45
1746568419279,PSYC 70,A01,890689,Geller; Emma Harlan,7,0,30,23
1746568420307,PSYC 71,A01,959860,Staff,21,0,25,4
1746568421331,PSYC 100,A00,890690,Lacefield; Katharine I,0,50,180,180
1746568422360,PSYC 102,A00,890695,Staff,18,0,40,22
1746568423387,PSYC 105,A00,890699,Geller; Emma Harlan,70,0,100,30
1746568424411,PSYC 106,A00,890701,Gorman; Michael R.,6,0,30,24
1746568425435,PSYC 108,A00,890704,Adrian; Julia Anna,0,28,50,50
1746568426463,PSYC 118,A01,890712,Staff,11,0,30,19
1746568427491,PSYC 124,A00,890716,Chapman; Eddie Nathaniel,25,0,60,35
1746568428520,PSYC 131,A00,890717,Anagnostaras; Stephan,0,8,80,80
1746568429547,PSYC 137,A00,890719,Winkielman; Piotr,0,11,30,30
1746568430576,PSYC 144,A00,890721,Adrian; Julia Anna,0,9,45,45
1746568431601,PSYC 162,A00,890805,Staff,0,0,75,75
1746568432629,PSYC 169,A00,890810,Staff,0,14,30,30
1746568433654,PSYC 172,A00,890814,Gorman; Michael R.,9,0,30,21
1746568434678,PSYC 181,A00,890818,Anagnostaras; Stephan,9,0,200,191
1746568435704,PSYC 184,A00,959861,Staff,168,0,175,7
1746568436729,PSYC 189,A00,890823,Staff,0,2,30,30
1746568437758,PSYC 191,A00,890884,Rickard; Timothy C.,0,12,35,35
1746568438785,PSYC 193,A00,890913,Staff,19,0,30,11
1746568438785,PSYC 193,B00,890914,Chapman; Eddie Nathaniel,24,0,30,6
1746568439812,PSYC 193L,A01,890918,Lowe; Angela Beth,20,0,30,10
1746568439812,PSYC 193L,B01,890921,Hurwitz; Ethan Scott,20,0,30,10
1746568439812,PSYC 193L,C01,890928,Staff,30,0,30,0
1746568440841,RELI 149,A00,886806,Rahimi; Babak,23,0,40,17
1746568441870,SE 9,A01,886814,Staff,7,0,20,13
1746568442898,SE 101B,A01,886816,Chadha; Mayank,4,0,35,31
1746568443926,SE 110B,A00,886818,Zhu; Qiang,4,0,75,71
1746568444951,SE 125,A01,886830,Staff,10,0,30,20
1746568445980,SE 130B,A01,886835,Staff,14,0,40,26
1746568447005,SE 131A,A01,886838,Krysl; Petr,34,0,55,21
1746568448032,SE 154,A00,886840,Staff,29,0,50,21
1746568449059,SE 164GS,A01,886849,Staff,6,0,20,14
1746568450085,SE 167GS,A01,886853,Staff,6,0,20,14
1746568451114,SIO 25,A01,890107,Staff,19,0,30,11
1746568452143,SIO 45,A00,890109,Cook; Geoffrey W,117,0,200,83
1746568453167,SIO 109R,A00,890110,Forman; Fonna,0,16,20,20
1746568454192,SIO 187,A01,890114,Kacev; David,15,0,40,25
1746568455221,SOCI 1,A01,890431,Thorpe; Charles Robert,15,0,30,15
1746568455221,SOCI 1,A02,890518,Thorpe; Charles Robert,30,0,30,0
1746568456246,SOCI 2,A01,957978,Staff,25,0,25,0
1746568456246,SOCI 2,A02,957979,Staff,23,0,25,2
1746568457272,SOCI 20,A01,890523,Calderon-Zaks; Michael Aar,22,0,30,8
1746568457272,SOCI 20,A02,890526,Calderon-Zaks; Michael Aar,29,0,30,1
1746568458297,SOCI 30,A01,890533,Pardo Guerra; Juan Pablo,37,0,40,3
1746568459323,SOCI 40,A01,890535,Staff,27,0,45,18
1746568460360,SOCI 104Q,A00,890559,Staff,18,0,30,12
1746568461385,SOCI 106,A00,890560,Arnal; Maud Marie Leonie,20,0,30,10
1746568462419,SOCI 110,A00,890567,Holkenbrink-Monk; Charlene,19,0,30,11
1746568463448,SOCI 112,A00,890568,Victoria Torres; Pablo,2,0,55,53
1746568464473,SOCI 115,A00,890597,Arnal; Maud Marie Leonie,28,0,45,17
1746568466522,SOCI 121,A00,890604,Pardo Guerra; Juan Pablo,38,0,45,7
1746568467548,SOCI 126,A01,890608,Staff,8,0,10,2
1746568468573,SOCI 127,A00,890609,Staff,18,0,30,12
1746568469602,SOCI 131,A00,890610,Thorpe; Charles Robert,37,0,45,8
1746568470626,SOCI 135,A00,890615,Payne; Christine Anna,13,0,45,32
1746568471651,SOCI 139,A00,890620,Staff,38,0,45,7
1746568472677,SOCI 148E,A00,890622,Calderon-Zaks; Michael Aar,36,0,45,9
1746568473706,SOCI 150,A00,890623,Kohler; Kristopher M.,31,0,45,14
1746568474731,SOCI 157,A00,890625,Jules-Rosette; Bennetta W.,18,0,20,2
1746568475756,SOCI 160,A00,890627,Payne; Christine Anna,21,0,45,24
1746568476781,SYN 1,A00,886855,Fish; Gwendolyn Anne,0,0,0,0
1746568476781,SYN 1,B00,906086,Fish; Gwendolyn Anne,0,2,0,2
1746568477812,SYN 2R,A00,886860,Staff,0,17,15,15
1746568477812,SYN 2R,B00,906106,Atkinson; Arthur Laird,0,16,15,15
1746568478846,SYN 100,A01,886866,Browne; Emily,0,28,20,20
1746568478846,SYN 100,B01,906128,Rock; Martin,0,5,20,20
1746568478846,SYN 100,C01,906140,Deavenport; James Cary,0,3,20,20
1746568478846,SYN 100,D01,907816,Deavenport; James Cary,0,5,20,20
1746568479872,TDAC 1,A00,890286,Walsh; Kim C.,8,0,20,12
1746568480897,TDAC 101,A00,890296,Basso; Beatrice,15,0,20,5
1746568481924,TDDE 131,A00,890297,Staff,47,0,50,3
1746568482951,TDDM 1,A00,890287,Weinberg; Sadie,25,0,30,5
1746568483976,TDGE 11,A00,890288,Fulton; Julia,137,0,200,63
1746568483976,TDGE 11,B00,890289,Castro; Robert Jess,184,0,200,16
1746568485006,TDGE 25,B00,957359,Walsh; Kim C.,4,0,20,16
1746568486034,TDGE 40,A01,890292,Power; Jade Yukana,27,0,30,3
1746568487062,TDGE 124,A00,890298,Havis; Allan,0,1,50,50
1746568488087,TDGE 131R,A00,890299,Burelle; Julie Sara Veronique,15,0,42,27
1746568489112,TDHT 101,A00,890300,Staff,10,0,20,10
1746568490139,TDHT 109,A01,890302,Anderson; Mysia Anyse,31,0,40,9
1746568491167,TDMV 1,A00,890293,Arcidiacono; Kristin,18,0,30,12
1746568492196,TDMV 2,A00,890294,Weinberg; Sadie,23,0,30,7
1746568493225,TDMV 3,A00,957878,Arcidiacono; Kristin,28,0,30,2
1746568495280,TDMV 138,A00,890304,Jun; Grace Shin Hae,25,0,40,15
1746568496305,TDMV 140,A00,890305,Corrales; Joseph Bernales,25,0,30,5
1746568497330,TDMV 142,A00,890307,Caligagan; Tony,32,0,40,8
1746568498358,TDMV 144,A00,890308,Camaya; Michelle Ann,25,0,30,5
1746568499385,TDPW 1,A00,890295,Stein; Deborah Isobel,3,0,20,17
1746568500447,USP 2,A01,890272,Lerner; Amy M,6,0,20,14
1746568501474,USP 3,A01,890274,Staff,12,0,30,18
1746568502499,USP 15,A01,890276,Sun; Feiyang,16,0,30,14
1746568503530,USP 25,A00,890277,Shenkman; Michael Thomas,19,0,25,6
1746568504558,USP 138,A00,890278,Staff,14,0,25,11
1746568505585,USP 143,A00,890279,Staff,22,0,70,48
1746568506610,USP 144,A00,890280,Chowdhury; Muhammed Zohir,16,0,30,14
1746568507639,USP 150,A00,890281,Boomhower; Matthew Charles,4,0,30,26
1746568508664,USP 151,A00,890282,Staff,16,0,20,4
1746568509690,USP 162,A00,890283,Andrews; Abigail Leslie,16,0,20,4
1746568510717,USP 168,A00,920477,Kwak; Nancy,0,0,5,5
1746568511746,USP 181,A00,890284,Staff,3,0,20,17
1746568512774,USP 191A,A00,890285,Staff,12,0,20,8
1746568513800,VIS 101,A00,886512,Staff,26,0,75,49
1746568514825,VIS 103,A00,886513,Cruz; Edwin Teddy,61,0,75,14
1746568515852,VIS 108,A00,886514,Staff,3,0,15,12
1746568516878,VIS 127P,A00,886515,Shen; Kuiyi,80,0,146,66
1746568517903,VIS 149,A00,886516,Yoldas; Pinar,0,0,15,15
1746568518933,VIS 164,A00,886526,Erdmann; Dean,19,0,22,3
1746568519960,VIS 194S,A00,886527,Staff,61,0,75,14
1746568520985,WCWP 10A,C00,886484,Martiniuk; Jill,12,0,15,3
1746568522010,WCWP 10B,A00,886490,Uriarte; Emma,0,0,15,15
1746568522010,WCWP 10B,B00,886491,Dhir; Simrita,10,0,15,5
1746568522010,WCWP 10B,C00,886492,Ornelas; Tricia,0,0,15,15
1746568523034,WCWP 100,A00,886494,Young; Mark T,0,6,15,15
1746568525132,AAS 10,A01,886199,Childs; Dennis R.,0,3,0,0
1746568526157,ANAR 104,A01,886940,Shtienberg; Gilad,27,0,30,3
1746568527184,ANAR 120,A00,886953,Staff,12,0,20,8
1746568528210,ANBI 148,A01,886955,Wilder; Linnea Lorene,30,0,40,10
1746568530259,ANSC 122,A00,886957,Staff,25,0,30,5
1746568531287,ANSC 150,A00,886958,Sloane; Julia Kathryn,2,0,15,13
1746568532312,ANSC 156,A00,886959,Jenkins; Janis A.,0,1,15,15
1746568533336,ANSC 180,A00,886960,Staff,11,0,17,6
1746568534361,ANSC 188,A00,886961,Jassal; Aftab,9,0,25,16
1746568535390,ANSC 190,A00,886962,Jassal; Aftab,14,0,25,11
1746568536414,ANSC 191,A00,886963,Staff,18,0,20,2
1746568537439,ANTH 3,A01,891689,Staff,17,0,20,3
1746568538468,ANTH 5,A00,886933,Semendeferi; Ekaterini,16,0,20,4
1746568539491,ANTH 10,A00,886934,Staff,0,12,30,30
1746568540517,ANTH 21,A01,886936,Staff,41,0,60,19
1746568541541,ANTH 23,A01,886938,Staff,92,0,100,8
1746568542567,ANTH 105,A00,886964,Stewart; Alexander B,84,0,100,16
1746568543594,ANTH 108,A00,886965,Pedersen; David,9,0,20,11
1746568544631,AWP 10,001,886147,Staff,0,0,0,0
1746568544631,AWP 10,002,886148,Staff,0,0,0,0
1746568544631,AWP 10,003,886149,Staff,0,0,0,0
1746568544631,AWP 10,004,886150,Staff,0,0,0,0
1746568544631,AWP 10,005,886151,Staff,0,0,0,0
1746568544631,AWP 10,006,886152,Staff,0,0,0,0
1746568544631,AWP 10,007,886153,Staff,0,0,0,0
1746568544631,AWP 10,008,886154,Staff,0,0,0,0
1746568544631,AWP 10,009,886155,Staff,0,0,0,0
1746568544631,AWP 10,010,886156,Staff,0,0,0,0
1746568544631,AWP 10,011,886158,Staff,0,0,0,0
1746568544631,AWP 10,012,886160,Staff,0,0,0,0
1746568544631,AWP 10,013,886161,Staff,0,0,0,0
1746568544631,AWP 10,014,886162,Staff,0,0,0,0
1746568544631,AWP 10,015,886163,Staff,0,0,0,0
1746568544631,AWP 10,016,886164,Staff,0,0,0,0
1746568544631,AWP 10,017,886165,Staff,0,0,0,0
1746568544631,AWP 10,018,886166,Staff,0,0,0,0
1746568544631,AWP 10,019,886168,Staff,0,0,0,0
1746568544631,AWP 10,020,886170,Staff,0,0,0,0
1746568544631,AWP 10,021,886172,Staff,0,0,0,0
1746568545662,AWP 10R,001,886173,Staff,0,1,0,0
1746568545662,AWP 10R,002,886174,Staff,0,1,0,0
1746568545662,AWP 10R,003,886175,Staff,0,0,0,0
1746568545662,AWP 10R,004,886176,Staff,0,0,0,0
1746568545662,AWP 10R,005,886177,Staff,0,0,0,0
1746568545662,AWP 10R,006,886178,Staff,0,0,0,0
1746568545662,AWP 10R,007,886179,Staff,0,0,0,0
1746568545662,AWP 10R,008,886181,Staff,0,0,0,0
1746568545662,AWP 10R,009,886182,Staff,0,0,0,0
1746568545662,AWP 10R,010,886183,Staff,0,0,0,0
1746568545662,AWP 10R,011,886184,Staff,0,0,0,0
1746568545662,AWP 10R,012,886185,Staff,0,0,0,0
1746568545662,AWP 10R,013,886186,Staff,0,0,0,0
1746568545662,AWP 10R,014,886187,Staff,0,0,0,0
1746568545662,AWP 10R,015,886188,Staff,0,0,0,0
1746568545662,AWP 10R,016,886189,Staff,0,0,0,0
1746568545662,AWP 10R,017,960532,Staff,0,0,0,0
1746568545662,AWP 10R,018,960533,Staff,0,0,0,0
1746568545662,AWP 10R,019,960534,Staff,0,0,0,0
1746568545662,AWP 10R,020,960538,Staff,0,0,0,0
1746568545662,AWP 10R,021,960540,Staff,0,0,0,0
1746568545662,AWP 10R,022,960541,Staff,0,0,0,0
1746568545662,AWP 10R,023,960542,Staff,0,0,0,0
1746568545662,AWP 10R,024,960544,Staff,0,0,0,0
1746568545662,AWP 10R,025,960545,Staff,0,0,0,0
1746568545662,AWP 10R,026,960548,Staff,0,0,0,0
1746568546687,AWP 102R,A00,886190,Staff,0,0,0,0
1746568546687,AWP 102R,B00,886191,Staff,0,0,0,0
1746568547711,BENG 100,A01,886193,Staff,17,0,30,13
1746568548737,BENG 122A,A01,886195,Hasty; Jeff M,13,0,30,17
1746568549763,BENG 166A,A00,886196,Sah; Robert Lie-Yuan,0,2,30,30
1746568550787,BENG 190,A00,958050,Khojah; Reem I,20,0,25,5
1746568551815,BIBC 102,A01,894320,Staff,0,0,46,46
1746568551815,BIBC 102,A02,894321,Staff,0,0,46,46
1746568551815,BIBC 102,A03,894344,Staff,7,0,46,39
1746568551815,BIBC 102,A04,894345,Staff,27,0,47,20
1746568552841,BICD 100R,A01,894365,Smith; Laurie,0,3,58,58
1746568552841,BICD 100R,A02,894366,Smith; Laurie,0,5,58,58
1746568552841,BICD 100R,A03,894367,Smith; Laurie,0,0,59,59
1746568552841,BICD 100R,A04,959869,Smith; Laurie,40,0,59,19
1746568553866,BICD 136,A01,894383,Gustafson-Brown; Cindy,14,0,50,36
1746568554892,BIEB 102,A01,894494,Butler; Shannon Rhey,51,0,130,79
1746568556945,BIEB 150,A01,894617,Wills; Christopher,3,0,20,17
1746568556945,BIEB 150,A02,894631,Wills; Christopher,3,0,20,17
1746568556945,BIEB 150,A03,894937,Wills; Christopher,3,0,20,17
1746568556945,BIEB 150,A04,894946,Wills; Christopher,5,0,20,15
1746568557969,BIEB 194,A00,906141,Kurle; Carolyn M.,6,0,20,14
1746568558994,BILD 1,A01,894154,Staff,3,0,19,16
1746568558994,BILD 1,A02,894155,Staff,14,0,19,5
1746568558994,BILD 1,A03,894160,Staff,13,0,19,6
1746568558994,BILD 1,A04,894161,Staff,15,0,18,3
1746568560026,BILD 2,A01,894168,Staff,0,0,50,50
1746568560026,BILD 2,A02,894169,Staff,0,0,50,50
1746568560026,BILD 2,A03,894179,Staff,0,0,50,50
1746568560026,BILD 2,A04,894203,Staff,25,0,50,25
1746568561050,BILD 3,A01,894213,Staff,22,0,31,9
1746568561050,BILD 3,A02,894214,Staff,26,0,31,5
1746568561050,BILD 3,A03,894235,Staff,28,0,31,3
1746568561050,BILD 3,A04,894236,Staff,28,0,32,4
1746568562075,BILD 4,A01,894253,Reuther; Keefe,6,0,24,18
1746568562075,BILD 4,A02,894258,Reuther; Keefe,16,0,24,8
1746568563107,BILD 5,A01,894276,Reuther; Keefe,35,0,50,15
1746568563107,BILD 5,A02,894277,Reuther; Keefe,45,0,50,5
1746568563107,BILD 5,A03,894290,Reuther; Keefe,44,0,50,6
1746568563107,BILD 5,A04,894291,Reuther; Keefe,48,0,50,2
1746568564135,BILD 24,A01,894297,Pirino; Giorgia,40,0,60,20
1746568565159,BIMM 100,B01,958915,Staff,71,0,100,29
1746568566190,BIMM 101,A01,895017,McDonnell; Lisa Marie,0,5,24,24
1746568566190,BIMM 101,A02,895018,McDonnell; Lisa Marie,0,5,24,24
1746568566190,BIMM 101,B01,895020,McDonnell; Lisa Marie,0,6,24,24
1746568566190,BIMM 101,B02,895021,McDonnell; Lisa Marie,0,4,24,24
1746568567214,BIMM 110,A01,895023,Staff,1,0,25,24
1746568567214,BIMM 110,A02,895024,Staff,9,0,25,16
1746568567214,BIMM 110,A03,895025,Staff,18,0,25,7
1746568567214,BIMM 110,A04,895031,Staff,20,0,25,5
1746568568243,BIMM 120,A01,895114,Gustafson-Brown; Cindy,14,0,28,14
1746568568243,BIMM 120,A02,895126,Gustafson-Brown; Cindy,21,0,27,6
1746568569274,BIPN 100,A01,895130,Yang; Mingyu,1,0,38,37
1746568569274,BIPN 100,A02,895131,Yang; Mingyu,32,0,38,6
1746568569274,BIPN 100,A03,895132,Yang; Mingyu,32,0,38,6
1746568569274,BIPN 100,A04,895133,Yang; Mingyu,27,0,36,9
1746568570304,BIPN 120,A01,895135,Cooke; James Edward,0,3,13,13
1746568570304,BIPN 120,A02,895136,Cooke; James Edward,0,1,13,13
1746568570304,BIPN 120,A03,895137,Cooke; James Edward,0,3,13,13
1746568570304,BIPN 120,A04,895156,Cooke; James Edward,0,2,11,11
1746568571330,BIPN 134,A01,895235,Cooke; James Edward,0,2,25,25
1746568571330,BIPN 134,A02,895237,Cooke; James Edward,0,0,25,25
1746568571330,BIPN 134,A03,895240,Cooke; James Edward,3,0,25,22
1746568571330,BIPN 134,A04,895270,Cooke; James Edward,20,0,25,5
1746568572360,BIPN 189,A00,892103,Staff,0,14,14,14
1746568574412,BISP 194,A00,958008,Staff,0,2,0,0
1746568575437,CAT 124,A01,922009,Staff,0,5,20,20
1746568576463,CAT 125R,A00,886390,Morales; Celeste Georgianna,0,2,20,20
1746568576463,CAT 125R,B00,886391,Irwin; Matthew Joseph,0,4,20,20
1746568576463,CAT 125R,C00,886392,Smith; Lauryn Alissa,0,2,20,20
1746568576463,CAT 125R,D00,886393,Vanderschuit; Maya Alysia,0,3,20,20
1746568576463,CAT 125R,E00,886394,Marchisotto; Jennifer Anne,0,3,20,20
1746568577491,CENG 15,A01,886218,Drews; Aaron,3,0,8,5
1746568578520,CENG 113,A00,886219,Opatkiewicz; Justin Paul,15,0,25,10
1746568579547,CGS 101,A00,887044,Staff,7,0,20,13
1746568580575,CGS 105,A01,887046,Staff,14,0,25,11
1746568581605,CGS 112,A00,887047,Cuong; Marisol,12,0,15,3
1746568582632,CGS 113,A00,887048,Staff,23,0,30,7
1746568583660,CGS 120,A00,887049,Staff,10,0,17,7
1746568584684,CHEM 6A,A01,886336,Lam; Tin Yiu,38,0,50,12
1746568584684,CHEM 6A,A02,886338,Lam; Tin Yiu,37,0,50,13
1746568585716,CHEM 6B,A01,886341,Hopkins; Patrycja Anna,16,0,50,34
1746568585716,CHEM 6B,A02,886343,Hopkins; Patrycja Anna,42,0,50,8
1746568586748,CHEM 6C,A01,886346,Albizati; Kim F.,0,2,50,50
1746568586748,CHEM 6C,A02,886348,Albizati; Kim F.,23,0,50,27
1746568587776,CHEM 40A,A01,886352,Klosterman; Jeremy K,65,0,100,35
1746568588802,CHEM 40B,A01,886356,Klosterman; Jeremy K,0,23,100,100
1746568589831,CHEM 41B,A01,886360,Theodorakis; Emmanuel,25,0,50,25
1746568589831,CHEM 41B,A02,886362,Theodorakis; Emmanuel,47,0,50,3
1746568590857,CHIN 165A,A00,886382,Xu; Li,18,0,20,2
1746568591882,CLAS 120,A00,886387,Myerston Santana; Jacobo,33,0,40,7
1746568592908,COGS 9,A01,886967,Shannon; Kyle Michael,42,0,60,18
1746568593937,COGS 11,A01,886969,Staff,10,0,30,20
1746568594965,COGS 14A,A01,886971,Staff,6,0,60,54
1746568595995,COGS 14B,A01,886973,Hoffman; Drew Ellen,4,0,60,56
1746568597022,COGS 18,A01,886975,Morgan; Eric,35,0,60,25
1746568598050,COGS 20,A01,886977,Staff,4,0,8,4
1746568598050,COGS 20,A02,886978,Staff,5,0,7,2
1746568599079,COGS 100,A01,907783,Staff,1,2,30,29
1746568600108,COGS 101B,A01,886980,Staff,0,3,48,48
1746568601133,COGS 101C,A01,886982,Delgado; Tania,0,5,44,44
1746568602162,COGS 102A,A01,886984,Johnson; Christine M.,4,0,30,26
1746568603190,COGS 118B,A01,886986,Staff,1,3,88,87
1746568604215,COGS 150,A01,886988,Bergen; Benjamin,22,0,50,28
1746568605242,COGS 153,A00,886989,Delgado; Tania,0,2,41,41
1746568606270,COGS 186,A01,886991,Staff,0,0,32,32
1746568607296,COGS 187A,A01,886993,Boyle; Mary E. T.,7,0,30,23
1746568608323,COGS 189,A00,886994,Staff,0,1,30,30
1746568609349,COMM 10,A01,886996,Staff,0,0,20,21
1746568609349,COMM 10,A02,886997,Staff,12,0,20,8
1746568609349,COMM 10,A03,959845,Staff,19,0,20,1
1746568610377,COMM 20,A01,886999,Leuning; Grant Maurstad,24,0,40,16
1746568612426,COMM 100A,A01,887002,Staff,0,0,20,25
1746568612426,COMM 100A,A02,887003,Staff,6,0,20,14
1746568613452,COMM 100B,A01,887005,Staff,0,8,20,24
1746568614475,COMM 106D,A00,887006,Staff,13,0,40,27
1746568615501,COMM 110G,A00,887007,Whitworth-Smith; Andrew C,12,0,40,28
1746568616525,COMM 111B,A00,887008,Staff,31,0,40,9
1746568617553,COMM 113T,A00,887009,Abuelhiga; Soraya Jill,28,0,40,12
1746568617553,COMM 113T,B00,906733,Staff,40,0,40,0
1746568618579,COMM 145,A00,887010,Staff,12,0,40,28
1746568619608,COMM 146,A00,887054,Staff,31,0,40,9
1746568620636,COMM 190,A00,887012,Staff,8,0,23,15
1746568621661,CSE 8A,A50,887015,Cao; Yingjun,57,0,85,28
1746568622687,CSE 11,A01,887017,Cao; Yingjun,12,0,70,58
1746568623711,CSE 20,A01,887019,Staff,30,0,50,20
1746568624737,CSE 21,A01,887021,Staff,78,0,100,22
1746568624737,CSE 21,B01,892583,Braun; Oliver,45,0,50,5
1746568625761,CSE 30,A01,887025,Eldon; John,143,0,200,57
1746568626789,CSE 100,A01,887027,Staff,26,0,50,24
1746568626789,CSE 100,A02,887028,Staff,42,0,50,8
1746568627819,CSE 101,A01,887030,Braun; Oliver,74,0,100,26
1746568627819,CSE 101,B01,887032,Jones; Miles E,0,3,50,50
1746568627819,CSE 101,B02,887033,Jones; Miles E,0,2,50,50
1746568628846,CSE 105,A01,908084,Jones; Miles E,32,0,50,18
1746568628846,CSE 105,A02,908087,Jones; Miles E,31,0,50,19
1746568629873,CSE 135,A01,887035,Powell; Thomas Allan,0,5,50,50
1746568630898,CSE 142,A01,887037,Staff,8,0,60,52
1746568631923,CSE 142L,A01,887039,Staff,34,0,60,26
1746568632948,CSE 151A,A01,887041,Solares; Edwin A,47,0,100,53
1746568633974,CSE 175,A01,887043,Kumar; Rakesh,30,0,30,0
1746568635007,CSS 1,A01,886389,Staff,1,1,40,39
1746568636032,DSC 30,A01,908097,Liao; Soohyun Nam,47,0,75,28
1746568637060,DSC 40A,A01,908099,Shannon; Kyle Michael,30,0,50,20
1746568638088,DSC 40B,A01,908112,Staff,15,0,50,35
1746568639113,DSC 80,A01,908116,Staff,19,0,60,41
1746568640142,DSC 197,001,956863,Eldridge; Justin Matthew,9999,0,9999,0
1746568641165,ECE 5,A01,886400,Morris; Karcher William,1,0,6,5
1746568641165,ECE 5,A02,886401,Morris; Karcher William,3,0,6,3
1746568642190,ECE 148,A01,886403,Silberman; Jack,0,14,14,14
1746568643215,ECON 1,A01,887265,Crane; Meredith Helen,12,0,70,58
1746568643215,ECON 1,B01,887268,Staff,43,0,50,7
1746568644244,ECON 2,A01,887273,Crane; Meredith Helen,55,0,70,15
1746568645273,ECON 3,A01,887279,Rondina; Giacomo,32,0,70,38
1746568646298,ECON 4,A01,887282,Anderson; John Charles,0,2,10,10
1746568647326,ECON 5,A01,887285,Staff,34,0,45,11
1746568647326,ECON 5,B01,887292,Staff,41,0,45,4
1746568648357,ECON 100A,A01,887337,Newhouse; Herbert S,54,0,70,16
1746568648357,ECON 100A,B01,887349,Staff,45,0,50,5
1746568649381,ECON 100B,A01,887361,Du; Songzi,29,0,70,41
1746568650412,ECON 100C,A01,887445,Newhouse; Herbert S,59,0,70,11
1746568651439,ECON 105,A00,887488,Vespa; Emanuel Ignacio,23,0,35,12
1746568652463,ECON 109,A01,887506,Shishkin; Denis,28,0,35,7
1746568653488,ECON 110A,A01,887568,Alon; Titan Michael,0,3,35,35
1746568653488,ECON 110A,B01,907601,Alon; Titan Michael,20,0,35,15
1746568654512,ECON 110B,A01,887598,Levkoff; Steven B.,0,24,70,70
1746568655537,ECON 112,A00,887599,Rondina; Giacomo,19,0,35,16
1746568656563,ECON 120A,A01,887603,Dai; Yinlin,35,0,70,35
1746568657590,ECON 120C,A01,887608,Sun; Yixiao,0,1,35,35
1746568657590,ECON 120C,B01,887614,Sun; Yixiao,0,0,35,35
1746568658614,ECON 138,A00,887621,Bharadwaj; Prashant,0,21,20,20
1746568659639,ECON 144,A00,958007,Squires; Dale E,12,0,35,23
1746568660664,ECON 171,A01,907666,Staff,18,0,35,17
1746568661689,ECON 175,A00,887626,Wu; Pak Yeung,22,0,35,13
1746568662715,ECON 190,A00,887640,Vespa; Emanuel Ignacio,22,0,35,13
1746568663744,EDS 25,A01,888197,Staff,0,0,0,0
1746568663744,EDS 25,A02,888209,Staff,0,0,0,0
1746568663744,EDS 25,A03,888210,Staff,0,0,0,0
1746568663744,EDS 25,A04,888212,Staff,0,0,0,0
1746568663744,EDS 25,A05,888213,Staff,0,0,0,0
1746568663744,EDS 25,A06,888214,Staff,0,0,0,0
1746568663744,EDS 25,A07,888235,Staff,0,2,0,0
1746568663744,EDS 25,A08,888236,Staff,0,0,0,0
1746568663744,EDS 25,A09,888240,Staff,0,0,0,0
1746568663744,EDS 25,A10,888244,Staff,0,0,0,0
1746568663744,EDS 25,B01,888273,Staff,0,0,0,0
1746568663744,EDS 25,B02,888285,Staff,0,0,0,0
1746568663744,EDS 25,B03,888423,Staff,0,0,0,1
1746568663744,EDS 25,B04,888432,Staff,0,0,0,0
1746568663744,EDS 25,B05,888433,Staff,0,0,0,0
1746568663744,EDS 25,B06,888467,Staff,0,0,0,0
1746568663744,EDS 25,B07,888468,Staff,0,0,0,0
1746568663744,EDS 25,B08,888479,Staff,0,0,0,0
1746568663744,EDS 25,B09,888484,Staff,0,0,0,0
1746568663744,EDS 25,B10,888487,Staff,0,0,0,0
1746568664773,EDS 38,A01,907700,Choi; Bailey Miyeon,30,0,30,0
1746568665802,EDS 112,A01,888601,Chapman; Thandeka K,12,0,40,28
1746568666827,EDS 115,A00,888697,Mendez; Kathrina Mendoza,10,0,30,20
1746568667855,EDS 116,A01,888893,Staff,34,0,40,6
1746568669908,EDS 124AR,A00,889133,Staff,28,0,50,22
1746568669908,EDS 124AR,B00,907471,Simon; Elizabeth A,36,0,50,14
1746568670936,EDS 124BR,A00,889134,Simon; Elizabeth A,44,0,100,56
1746568671962,EDS 125,A00,889135,Staff,25,0,30,5
1746568672986,EDS 126,A01,889138,Staff,36,0,40,4
1746568674012,EDS 164R,A01,889142,Wishard Guerra; Alison G.,33,0,50,17
1746568675036,ENG 30,A01,886396,Staff,0,0,0,0
1746568675036,ENG 30,B01,886398,Staff,0,0,0,0
1746568676062,ENVR 102,A00,906150,Montejo; Carolina,23,0,25,2
1746568677091,ETHN 103A,A00,887236,Man; Simeon S,0,3,0,0
1746568678118,ETHN 113,A00,887239,Staff,16,0,30,14
1746568679143,ETHN 116,A00,887240,Staff,16,0,25,9
1746568680169,ETHN 117,A00,887241,Choi; Esther Min,28,0,30,2
1746568681192,ETHN 118,A00,887243,Staff,24,0,30,6
1746568682218,ETHN 127,A00,887248,Cuong; Marisol,11,0,15,4
1746568683244,ETHN 139,A00,887250,Staff,7,0,10,3
1746568684268,ETHN 142,A00,887252,Staff,10,0,30,20
1746568685296,ETHN 161,A00,887253,Browne; Errol Tsekani,24,0,30,6
1746568686323,ETHN 163FR,A00,887255,Burelle; Julie Sara Veronique,0,0,5,5
1746568687352,GLBH 20,A00,889149,Elwardani; Nile Regina,8,0,42,34
1746568689402,GLBH 111,A01,889152,Burgos; Jose L.,17,0,17,0
1746568690425,GLBH 150,A00,889181,Sloane; Julia Kathryn,0,5,15,15
1746568692482,HDS 60,A01,886406,Warstadt; Melissa Fawn,73,0,80,7
1746568693512,HIAF 111,A00,889324,Gyamfi; Bright,25,0,32,7
1746568694540,HIEA 131,A00,889328,Staff,15,0,32,17
1746568695564,HIEA 144,A00,889333,Henry; Todd A.,26,0,32,6
1746568696591,HIEA 154,A00,889336,Henry; Todd A.,24,0,32,8
1746568697615,HIEU 106,A00,889339,Staff,22,0,32,10
1746568699666,HIEU 114,A00,889340,Staff,3,0,32,29
1746568700689,HIEU 135GS,A00,889342,Patterson; Patrick H.,0,0,1,24
1746568701715,HIEU 137,A00,889343,Edington; Claire Ellen,10,0,25,15
1746568702740,HIEU 148,A00,889345,Staff,14,0,32,18
1746568703769,HIEU 154,A00,889346,Biess; Frank Peter,21,0,32,11
1746568704793,HILA 102,A00,889351,Staff,12,0,32,20
1746568705824,HILD 2A,A01,889221,Lewandoski; Julia Mavis,1,10,32,31
1746568706854,HILD 7B,A01,889225,Man; Simeon S,0,12,32,32
1746568707884,HILD 7C,A01,889288,Alvarez; Luis A,0,14,32,32
1746568708909,HILD 30,A01,889323,Staff,0,5,32,32
1746568710961,HISC 119,A00,889383,Golan; Tal,19,0,32,13
1746568711985,HIUS 103,A00,889384,Man; Simeon S,0,0,32,32
1746568713012,HIUS 117,A00,919797,Kwak; Nancy,19,0,32,13
1746568714039,HIUS 142A,A00,919788,Staff,22,0,32,10
1746568716093,HIUS 149,A00,889386,Gyamfi; Bright,26,0,32,6
1746568717116,HIUS 155,A00,889387,Alvarez; Luis A,14,0,32,18
1746568718141,HUM 3,A01,886499,Caldwell; Michael Alan,19,0,50,31
1746568719168,HUM 3GS,A00,886500,Rodriguez; Bretton Sigfred,0,0,0,28
1746568720192,HUM 3R,A01,886502,Markman; Kristina,0,36,50,50
1746568721222,HUM 4,A01,886504,Crum; Matthew Stephen,24,0,50,26
1746568721222,HUM 4,B01,886506,West; Geoffrey Scott,17,0,50,33
1746568722250,HUM 4GS,A00,886507,Staff,0,0,0,19
1746568723274,HUM 5,A01,886509,Staff,32,0,50,18
1746568724303,HUM 5R,A01,886511,Zavodny; Tatiana Sophia,0,39,50,50
1746568725332,JAPN 180,A00,886407,Staff,16,0,40,24
1746568726362,LATI 50,A01,886409,Martin-Cabrera; Luis,4,0,22,18
1746568726362,LATI 50,A02,886410,Martin-Cabrera; Luis,19,0,22,3
1746568726362,LATI 50,A03,886411,Martin-Cabrera; Luis,21,0,22,1
1746568726362,LATI 50,A04,886412,Martin-Cabrera; Luis,9,0,22,13
1746568727390,LAWS 101,A00,907664,Staff,28,0,60,32
1746568728424,LIAB 1A,A00,889388,Saab; Dima,17,0,20,3
1746568729450,LIAB 1AX,A00,889389,El Cheddadi; Youniss,18,0,20,2
1746568730480,LIFR 1C,A00,889391,Van Moer; Vinciane G,8,0,20,12
1746568731506,LIFR 1CX,A00,889392,Van Moer; Vinciane G,7,0,20,13
1746568732532,LIFR 1D,A00,889393,Van Moer; Vinciane G,7,0,20,13
1746568733567,LIFR 1DX,A00,889394,Van Moer; Vinciane G,8,0,20,12
1746568734593,LIGN 7,A00,886923,Staff,24,0,50,26
1746568735619,LIGN 17,A00,886924,Kehler; Andrew Scott,125,0,150,25
1746568736644,LTAM 110,A00,889395,Staff,15,0,30,15
1746568737668,LTAM 110GS,A00,958010,Rodriguez; Bretton Sigfred,0,0,0,28
1746568738690,LTCH 101,A00,889397,Staff,23,0,25,2
1746568739716,LTCS 130,A00,889398,Staff,23,0,25,2
1746568740743,LTEA 138,A00,889399,Staff,24,0,40,16
1746568741770,LTEN 149,A00,889400,Wesling; Megan E.,0,3,25,25
1746568742794,LTEN 169,A00,889401,Staff,20,0,25,5
1746568743821,LTEN 180,A00,889402,Staff,10,0,15,5
1746568744845,LTEN 181,A00,889403,Staff,21,0,25,4
1746568745873,LTWL 100,A00,889404,Myerston Santana; Jacobo,2,0,25,23
1746568746898,LTWL 180GS,A00,889405,Staff,0,0,20,20
1746568747924,LTWL 181,A00,889406,Staff,16,0,25,9
1746568748948,LTWL 184,A00,889475,Mukherjee; Silpa,22,0,25,3
1746568749978,LTWR 102C,A00,889486,Staff,29,0,30,1
1746568751002,LTWR 115W,A00,889491,Staff,0,2,15,15
1746568752028,MAE 8,A01,886905,Staff,0,2,0,0
1746568753052,MAE 11,A00,886906,Bandaru; Prabhakar,0,7,50,50
1746568754077,MAE 20,A00,886907,Evdokimenko; Ekaterina,43,0,70,27
1746568755102,MAE 30B,A00,886909,Ghazinejad; Maziar,26,0,45,19
1746568756127,MAE 101B,A00,886910,Saintillan; David,29,0,45,16
1746568757157,MAE 105,A00,886911,Bandaru; Prabhakar,18,0,50,32
1746568758185,MAE 107,B00,958024,Staff,8,0,50,42
1746568759216,MAE 143B,A00,886913,Bewley; Thomas R,6,0,40,34
1746568762807,MAE 148,A01,886915,Silberman; Jack,0,3,14,14
1746568763834,MAE 160,A00,886916,Evdokimenko; Ekaterina,31,0,60,29
1746568764860,MATH 3C,A01,889681,Staff,0,2,30,30
1746568764860,MATH 3C,A02,960048,Staff,24,0,30,6
1746568765884,MATH 10A,A01,889760,Staff,26,0,30,4
1746568765884,MATH 10A,A02,889783,Staff,29,0,30,1
1746568766916,MATH 10B,A01,889785,Verstraete; Jacques Allan,2,0,35,33
1746568766916,MATH 10B,A02,889795,Verstraete; Jacques Allan,4,0,35,31
1746568766916,MATH 10B,B01,889797,Verstraete; Jacques Allan,3,0,35,32
1746568766916,MATH 10B,B02,889828,Verstraete; Jacques Allan,3,0,35,32
1746568767943,MATH 10C,A01,889849,Habib; Yousaf,7,0,30,23
1746568767943,MATH 10C,A02,889852,Habib; Yousaf,14,0,30,16
1746568767943,MATH 10C,A03,889853,Habib; Yousaf,22,0,30,8
1746568767943,MATH 10C,A04,889858,Habib; Yousaf,20,0,30,10
1746568767943,MATH 10C,B01,889861,Staff,1,0,30,29
1746568767943,MATH 10C,B02,889862,Staff,24,0,30,6
1746568767943,MATH 10C,B03,889863,Staff,27,0,30,3
1746568767943,MATH 10C,B04,889967,Staff,23,0,30,7
1746568768969,MATH 18,A01,889974,Staff,7,0,30,23
1746568768969,MATH 18,A02,889977,Staff,20,0,30,10
1746568768969,MATH 18,B01,889984,Hardiman; Liam,21,0,30,9
1746568768969,MATH 18,B02,889985,Hardiman; Liam,25,0,30,5
1746568769994,MATH 20A,A01,889990,Suk; Andrew Hoon,30,0,35,5
1746568771022,MATH 20B,A01,889993,Ohm; Ko Woon,22,0,30,8
1746568771022,MATH 20B,A02,889994,Ohm; Ko Woon,30,0,30,0
1746568771022,MATH 20B,B01,889996,Ohm; Ko Woon,21,0,30,9
1746568771022,MATH 20B,B02,889997,Ohm; Ko Woon,23,0,30,7
1746568772047,MATH 20C,A01,889999,Hammock; Frances H,17,0,30,13
1746568772047,MATH 20C,A02,890003,Hammock; Frances H,23,0,30,7
1746568772047,MATH 20C,B01,890006,Hammock; Frances H,3,0,30,27
1746568772047,MATH 20C,B02,890007,Hammock; Frances H,12,0,30,18
1746568773078,MATH 20D,A01,890011,Cheng; Hsiao-Bing,1,1,30,29
1746568773078,MATH 20D,A02,890012,Cheng; Hsiao-Bing,14,0,30,16
1746568773078,MATH 20D,B01,890016,Cheng; Hsiao-Bing,13,0,30,17
1746568773078,MATH 20D,B02,890017,Cheng; Hsiao-Bing,13,0,30,17
1746568774103,MATH 20E,A01,890026,Harel; Guershon,1,0,30,29
1746568774103,MATH 20E,A02,890029,Harel; Guershon,23,0,30,7
1746568774103,MATH 20E,B01,890033,Harel; Guershon,7,0,30,23
1746568774103,MATH 20E,B02,890101,Harel; Guershon,21,0,30,9
1746568775134,MATH 102,A01,890104,Staff,17,0,30,13
1746568775134,MATH 102,A02,890105,Staff,27,0,30,3
1746568776158,MATH 103B,A01,890116,Salehi Golsefidy; Alireza,3,0,30,27
1746568776158,MATH 103B,B01,890118,Staff,0,3,34,34
1746568777184,MATH 109,A01,890121,Aliabadi Sr.; Mohsen,1,0,30,29
1746568777184,MATH 109,B01,890124,Upadrashta; Pranav Kumar,18,0,30,12
1746568778211,MATH 120A,A01,890126,Eggers; John Dietrich,13,0,30,17
1746568779239,MATH 142B,A01,890128,Ioana; Adrian,19,0,30,11
1746568779239,MATH 142B,A02,890129,Ioana; Adrian,13,0,30,17
1746568780266,MATH 154,A01,890174,Staff,0,0,30,30
1746568780266,MATH 154,A02,890182,Staff,0,0,30,30
1746568781297,MATH 168A,A01,890197,Dumitriu; Ioana,21,0,35,14
1746568782326,MATH 170A,A01,890240,Nie; Jiawang,1,0,30,29
1746568782326,MATH 170A,A02,890241,Nie; Jiawang,11,0,30,19
1746568782326,MATH 170A,A03,890249,Nie; Jiawang,23,0,30,7
1746568783351,MATH 170B,A01,957891,Nag; Panchali,13,0,35,22
1746568785405,MATH 181A,A01,908025,Staff,0,4,35,35
1746568785405,MATH 181A,A02,960115,Staff,27,0,35,8
1746568786429,MATH 181B,A01,959874,Staff,25,0,30,5
1746568787454,MATH 193B,A01,890265,Staff,0,4,35,35
1746568788482,MGT 4,A01,890311,Anderson; John Charles,42,0,88,46
1746568789512,MGT 5,A00,907740,Staff,13,0,98,85
1746568790537,MGT 12,A00,890312,Lindenberger; Wade Douglas,67,0,98,31
1746568791572,MGT 16,A00,957883,Staff,78,0,98,20
1746568793627,MGT 45,A00,890314,Pecore; Joseph P.,46,0,98,52
1746568794655,MGT 71,A00,890315,Staff,0,11,98,98
1746568795682,MGT 100,A00,890316,Yavorsky; Daniel Ryan,44,0,98,54
1746568796709,MGT 103,A00,890317,Ehrich; Kristine R,73,0,98,25
1746568797733,MGT 105,A00,890356,Bates; Kenneth Walter,0,8,98,98
1746568798758,MGT 112,A00,890360,Ehrich; Kristine R,55,0,98,43
1746568799785,MGT 127R,A00,907732,Zhu; Kevin Xiaoguo,23,0,98,75
1746568800813,MGT 131B,A00,890361,Anderson; John Charles,60,0,98,38
1746568801840,MGT 137,A00,890362,Lindenberger; Wade Douglas,65,0,98,33
1746568802866,MGT 160,A00,890369,Johnson; Erik Barry,9,0,98,89
1746568804928,MGT 164,A00,890372,Zimmermann; Carsten,0,40,98,98
1746568805956,MGT 180,A00,890374,Bliss; Barbara Ann,12,0,98,86
1746568806981,MMW 15,A01,886414,Chang; Edmond Yi-Teh,0,12,28,28
1746568806981,MMW 15,A02,886415,Chang; Edmond Yi-Teh,0,8,28,28
1746568806981,MMW 15,A03,886416,Chang; Edmond Yi-Teh,0,8,28,28
1746568806981,MMW 15,A04,886417,Chang; Edmond Yi-Teh,0,8,28,28
1746568806981,MMW 15,B01,886419,Chang; Edmond Yi-Teh,0,7,28,28
1746568806981,MMW 15,B02,886420,Chang; Edmond Yi-Teh,0,8,28,28
1746568806981,MMW 15,B03,886421,Chang; Edmond Yi-Teh,0,7,28,28
1746568806981,MMW 15,B04,886422,Chang; Edmond Yi-Teh,0,8,28,28
1746568806981,MMW 15,C01,886424,Staff,0,9,28,28
1746568806981,MMW 15,C02,886425,Staff,0,8,28,28
1746568806981,MMW 15,C03,886426,Staff,0,8,28,28
1746568806981,MMW 15,C04,886427,Staff,0,8,28,28
1746568806981,MMW 15,C05,958038,Staff,0,8,28,28
1746568806981,MMW 15,C06,958039,Staff,1,8,28,27
1746568808005,MMW 15GS,A00,906910,Patterson; Patrick H.,4,0,28,24
1746568809029,MMW 122R,A01,886429,Rahimi; Babak,0,13,28,28
1746568809029,MMW 122R,A02,886430,Rahimi; Babak,0,12,28,28
1746568809029,MMW 122R,A03,958040,Rahimi; Babak,0,11,28,28
1746568810056,MUS 1A,A01,890937,Staff,2,0,25,23
1746568810056,MUS 1A,A02,891035,Staff,6,0,25,19
1746568810056,MUS 1A,C01,958912,Staff,24,0,25,1
1746568810056,MUS 1A,C02,958913,Staff,25,0,25,0
1746568812111,MUS 2AK,A00,957092,Ohnishi; Takae,15,0,15,0
1746568813145,MUS 4,A01,891044,Staff,2,0,25,23
1746568813145,MUS 4,A02,891045,Staff,23,0,25,2
1746568813145,MUS 4,B01,891048,Staff,17,0,25,8
1746568813145,MUS 4,B02,891050,Staff,25,0,25,0
1746568814173,MUS 5,A01,957506,Dubnov; Shlomo,0,0,25,25
1746568814173,MUS 5,A02,957622,Dubnov; Shlomo,13,0,25,12
1746568814173,MUS 5,A03,957623,Dubnov; Shlomo,20,0,25,5
1746568815200,MUS 6,A01,891053,Freitas Caetano; Marcelo,24,0,25,1
1746568815200,MUS 6,A02,891054,Freitas Caetano; Marcelo,23,0,25,2
1746568816224,MUS 7,A01,891081,Staff,0,0,25,25
1746568816224,MUS 7,A02,891082,Staff,3,0,25,22
1746568817248,MUS 8GS,A00,891118,Borgo; David Garcia,1,0,25,24
1746568818274,MUS 11,A01,891140,Staff,9,0,25,16
1746568818274,MUS 11,A02,891141,Staff,22,0,25,3
1746568819297,MUS 13,A01,891143,Staff,8,0,25,17
1746568819297,MUS 13,A02,891144,Staff,24,0,25,1
1746568820328,MUS 15,A01,891146,Staff,9,0,25,16
1746568820328,MUS 15,A02,891148,Staff,21,0,25,4
1746568820328,MUS 15,B01,891150,Staff,18,0,25,7
1746568820328,MUS 15,B02,891151,Staff,25,0,25,0
1746568821351,MUS 20,A01,891153,Staff,5,0,20,15
1746568821351,MUS 20,A02,891155,Staff,14,0,20,6
1746568822379,MUS 80,A00,891156,Staff,19,0,25,6
1746568822379,MUS 80,B00,891157,Staff,23,0,25,2
1746568823404,MUS 130,A00,891158,Ohnishi; Takae,35,0,35,0
1746568824430,MUS 150GS,A01,891160,Borgo; David Garcia,1,0,25,24
1746568825460,MUS 170,A01,891162,Freitas Caetano; Marcelo,20,0,25,5
1746568825460,MUS 170,A02,891164,Freitas Caetano; Marcelo,21,0,25,4
1746568826488,NANO 11,A00,886220,Vazquez Mena; Oscar,13,0,15,2
1746568827516,NANO 15,A01,886222,Drews; Aaron,4,0,7,3
1746568828755,NANO 104,A00,886224,Sirbuly; Donald,17,0,25,8
1746568829781,PH 40,A00,886528,Staff,23,0,40,17
1746568830809,PH 45,A01,886799,Staff,35,0,40,5
1746568831834,PH 110,A00,886802,Staff,0,7,40,40
1746568832859,PH 172,A00,906716,Staff,19,0,35,16
1746568833888,PH 191,A00,886803,Staff,6,0,40,34
1746568834934,PHIL 1,A00,889500,Staff,20,0,30,10
1746568835960,PHIL 10,A01,889549,Grush; Rick Scott,15,0,22,7
1746568835960,PHIL 10,A02,889551,Grush; Rick Scott,22,0,22,0
1746568836986,PHIL 28,A01,889559,Lamey; Andy M.,0,2,31,31
1746568836986,PHIL 28,A02,889561,Lamey; Andy M.,0,1,30,30
1746568836986,PHIL 28,A03,889572,Lamey; Andy M.,0,1,30,30
1746568838013,PHIL 35,A00,907839,Staff,13,0,15,2
1746568839042,PHIL 60,A00,889574,Staff,73,0,90,17
1746568840287,PHIL 101,A00,958004,Staff,12,0,15,3
1746568842341,PHIL 136,A00,889582,Fulkerson; Matthew Todd,26,0,45,19
1746568843369,PHIL 163,A01,889601,Staff,21,0,30,9
1746568843369,PHIL 163,B01,889606,Brandt; Reuven A,0,3,0,0
1746568844393,PHIL 164,A00,889610,Staff,16,0,30,14
1746568845419,PHIL 165,A00,889613,Staff,22,0,30,8
1746568846443,PHYS 1A,A00,886431,Staff,26,0,70,44
1746568847472,PHYS 1AL,001,886432,Tsai; Philbert S,0,2,30,30
1746568847472,PHYS 1AL,002,886436,Tsai; Philbert S,11,0,30,19
1746568848503,PHYS 1B,A00,886439,Staff,185,0,240,55
1746568849528,PHYS 1BL,001,886441,Tsai; Philbert S,0,4,30,30
1746568849528,PHYS 1BL,002,886444,Tsai; Philbert S,2,0,30,28
1746568850552,PHYS 1C,A00,896092,Arnold; Kam S,78,0,146,68
1746568851581,PHYS 1CL,001,886448,Tsai; Philbert S,0,0,30,30
1746568851581,PHYS 1CL,002,886449,Tsai; Philbert S,1,0,30,29
1746568851581,PHYS 1CL,003,886450,Tsai; Philbert S,16,0,30,14
1746568851581,PHYS 1CL,004,886451,Tsai; Philbert S,15,0,30,15
1746568852609,PHYS 2B,A01,886457,Staff,68,0,115,47
1746568853639,PHYS 2C,A01,886460,Shotwell; Brian,0,9,65,65
1746568854663,PHYS 2CL,A01,886467,Staff,0,4,28,28
1746568854663,PHYS 2CL,A02,886468,Staff,0,3,28,28
1746568855689,PHYS 2D,A01,886470,Staff,10,0,50,40
1746568856714,PHYS 4B,A01,886475,Grinstein; Benjamin,22,0,40,18
1746568857743,POLI 5,A00,891173,Desposato; Scott,7,0,25,18
1746568858769,POLI 5D,A01,891175,Staff,5,0,5,0
1746568858769,POLI 5D,B01,891178,Staff,5,0,5,0
1746568859793,POLI 11,A00,891179,Ferree; Karen E,2,0,35,33
1746568860818,POLI 12,A00,891180,Staff,16,0,30,14
1746568861848,POLI 27,A01,891182,Staff,12,0,75,63
1746568862877,POLI 30,A00,891183,Staff,8,0,50,42
1746568863906,POLI 100B,A00,891244,Staff,5,1,35,30
1746568864931,POLI 100I,A00,891247,Staff,7,0,30,23
1746568865959,POLI 104J,A00,891248,Nichter; Maysa,14,0,30,16
1746568866985,POLI 104U,A00,891250,Nichter; Maysa,2,0,30,28
1746568869109,POLI 110B,A00,891255,Wiens; David,20,0,25,5
1746568870138,POLI 112A,A00,891256,Wiens; David,6,0,25,19
1746568871163,POLI 114BR,A00,891261,Staff,19,0,30,11
1746568872189,POLI 117R,A00,891262,Forman; Fonna,0,6,50,50
1746568873219,POLI 118,A00,891264,Ingham; Sean,17,0,25,8
1746568874245,POLI 124A,A00,891265,Staff,18,0,20,2
1746568875273,POLI 125D,A00,891266,Nichter; Simeon C,2,0,25,23
1746568876298,POLI 126,A00,891268,Nichter; Simeon C,7,0,25,18
1746568877323,POLI 126AA,A00,891272,Staff,16,0,25,9
1746568878347,POLI 130AA,A00,891273,Staff,15,0,20,5
1746568879371,POLI 134AA,A00,891274,Staff,4,0,20,16
1746568881426,POLI 138,A00,891278,Staff,21,0,25,4
1746568882452,POLI 142K,A00,891280,Staff,10,0,25,15
1746568883481,POLI 142M,A00,891281,Gartzke; Erik,16,0,30,14
1746568884505,POLI 142P,A00,891284,Staff,20,0,30,10
1746568885529,POLI 143,A00,891285,Gartzke; Erik,12,0,30,18
1746568886554,POLI 153,A00,891286,Staff,19,0,20,1
1746568888606,POLI 175,A00,891290,Staff,15,0,20,5
1746568889631,PSYC 1,A00,890674,Steiner; Eric Tomas,0,11,45,45
1746568890660,PSYC 2,A00,890676,Albright; Thomas D,21,0,35,14
1746568891685,PSYC 3,A00,890679,Staff,17,0,20,3
1746568892711,PSYC 6,A00,959858,Staff,20,0,20,0
1746568893741,PSYC 60,A01,890684,Rickard; Timothy C.,0,5,45,45
1746568894771,PSYC 70,A01,890689,Geller; Emma Harlan,7,0,30,23
1746568895795,PSYC 71,A01,959860,Staff,21,0,25,4
1746568896825,PSYC 100,A00,890690,Lacefield; Katharine I,0,50,180,180
1746568897850,PSYC 102,A00,890695,Staff,18,0,40,22
1746568898874,PSYC 105,A00,890699,Geller; Emma Harlan,70,0,100,30
1746568899904,PSYC 106,A00,890701,Gorman; Michael R.,6,0,30,24
1746568900932,PSYC 108,A00,890704,Adrian; Julia Anna,0,28,50,50
1746568901959,PSYC 118,A01,890712,Staff,11,0,30,19
1746568902989,PSYC 124,A00,890716,Chapman; Eddie Nathaniel,25,0,60,35
1746568904017,PSYC 131,A00,890717,Anagnostaras; Stephan,0,8,80,80
1746568905048,PSYC 137,A00,890719,Winkielman; Piotr,0,11,30,30
1746568906073,PSYC 144,A00,890721,Adrian; Julia Anna,0,9,45,45
1746568907101,PSYC 162,A00,890805,Staff,0,0,75,75
1746568908128,PSYC 169,A00,890810,Staff,0,14,30,30
1746568909156,PSYC 172,A00,890814,Gorman; Michael R.,9,0,30,21
1746568910181,PSYC 181,A00,890818,Anagnostaras; Stephan,9,0,200,191
1746568911207,PSYC 184,A00,959861,Staff,168,0,175,7
1746568912234,PSYC 189,A00,890823,Staff,0,2,30,30
1746568913262,PSYC 191,A00,890884,Rickard; Timothy C.,0,12,35,35
1746568914291,PSYC 193,A00,890913,Staff,19,0,30,11
1746568914291,PSYC 193,B00,890914,Chapman; Eddie Nathaniel,24,0,30,6
1746568915320,PSYC 193L,A01,890918,Lowe; Angela Beth,20,0,30,10
1746568915320,PSYC 193L,B01,890921,Hurwitz; Ethan Scott,20,0,30,10
1746568915320,PSYC 193L,C01,890928,Staff,30,0,30,0
1746568916347,RELI 149,A00,886806,Rahimi; Babak,23,0,40,17
1746568917377,SE 9,A01,886814,Staff,7,0,20,13
1746568918402,SE 101B,A01,886816,Chadha; Mayank,4,0,35,31
1746568919431,SE 110B,A00,886818,Zhu; Qiang,4,0,75,71
1746568920456,SE 125,A01,886830,Staff,10,0,30,20
1746568921480,SE 130B,A01,886835,Staff,14,0,40,26
1746568922510,SE 131A,A01,886838,Krysl; Petr,34,0,55,21
1746568923538,SE 154,A00,886840,Staff,29,0,50,21
1746568924568,SE 164GS,A01,886849,Staff,6,0,20,14
1746568925595,SE 167GS,A01,886853,Staff,6,0,20,14
1746568926624,SIO 25,A01,890107,Staff,19,0,30,11
1746568927648,SIO 45,A00,890109,Cook; Geoffrey W,117,0,200,83
1746568928674,SIO 109R,A00,890110,Forman; Fonna,0,16,20,20
1746568929698,SIO 187,A01,890114,Kacev; David,15,0,40,25
1746568930733,SOCI 1,A01,890431,Thorpe; Charles Robert,15,0,30,15
1746568930733,SOCI 1,A02,890518,Thorpe; Charles Robert,30,0,30,0
1746568931759,SOCI 2,A01,957978,Staff,25,0,25,0
1746568931759,SOCI 2,A02,957979,Staff,23,0,25,2
1746568932789,SOCI 20,A01,890523,Calderon-Zaks; Michael Aar,22,0,30,8
1746568932789,SOCI 20,A02,890526,Calderon-Zaks; Michael Aar,29,0,30,1
1746568933813,SOCI 30,A01,890533,Pardo Guerra; Juan Pablo,37,0,40,3
1746568934838,SOCI 40,A01,890535,Staff,27,0,45,18
1746568935863,SOCI 104Q,A00,890559,Staff,18,0,30,12
1746568936889,SOCI 106,A00,890560,Arnal; Maud Marie Leonie,20,0,30,10
1746568937917,SOCI 110,A00,890567,Holkenbrink-Monk; Charlene,19,0,30,11
1746568938947,SOCI 112,A00,890568,Victoria Torres; Pablo,2,0,55,53
1746568939983,SOCI 115,A00,890597,Arnal; Maud Marie Leonie,28,0,45,17
1746568942037,SOCI 121,A00,890604,Pardo Guerra; Juan Pablo,38,0,45,7
1746568943065,SOCI 126,A01,890608,Staff,8,0,10,2
1746568944090,SOCI 127,A00,890609,Staff,18,0,30,12
1746568945117,SOCI 131,A00,890610,Thorpe; Charles Robert,37,0,45,8
1746568946142,SOCI 135,A00,890615,Payne; Christine Anna,13,0,45,32
1746568947167,SOCI 139,A00,890620,Staff,38,0,45,7
1746568948193,SOCI 148E,A00,890622,Calderon-Zaks; Michael Aar,36,0,45,9
1746568949224,SOCI 150,A00,890623,Kohler; Kristopher M.,31,0,45,14
1746568950251,SOCI 157,A00,890625,Jules-Rosette; Bennetta W.,18,0,20,2
1746568951276,SOCI 160,A00,890627,Payne; Christine Anna,21,0,45,24
1746568952302,SYN 1,A00,886855,Fish; Gwendolyn Anne,0,0,0,0
1746568952302,SYN 1,B00,906086,Fish; Gwendolyn Anne,0,2,0,2
1746568953329,SYN 2R,A00,886860,Staff,0,17,15,15
1746568953329,SYN 2R,B00,906106,Atkinson; Arthur Laird,0,16,15,15
1746568954364,SYN 100,A01,886866,Browne; Emily,0,28,20,20
1746568954364,SYN 100,B01,906128,Rock; Martin,0,5,20,20
1746568954364,SYN 100,C01,906140,Deavenport; James Cary,0,3,20,20
1746568954364,SYN 100,D01,907816,Deavenport; James Cary,0,5,20,20
1746568955389,TDAC 1,A00,890286,Walsh; Kim C.,8,0,20,12
1746568956419,TDAC 101,A00,890296,Basso; Beatrice,15,0,20,5
1746568957444,TDDE 131,A00,890297,Staff,47,0,50,3
1746568958589,TDDM 1,A00,890287,Weinberg; Sadie,25,0,30,5
1746568959620,TDGE 11,A00,890288,Fulton; Julia,137,0,200,63
1746568959620,TDGE 11,B00,890289,Castro; Robert Jess,184,0,200,16
1746568960669,TDGE 25,B00,957359,Walsh; Kim C.,4,0,20,16
1746568961698,TDGE 40,A01,890292,Power; Jade Yukana,27,0,30,3
1746568962723,TDGE 124,A00,890298,Havis; Allan,0,1,50,50
1746568963748,TDGE 131R,A00,890299,Burelle; Julie Sara Veronique,15,0,42,27
1746568964773,TDHT 101,A00,890300,Staff,10,0,20,10
1746568965800,TDHT 109,A01,890302,Anderson; Mysia Anyse,31,0,40,9
1746568966825,TDMV 1,A00,890293,Arcidiacono; Kristin,18,0,30,12
1746568967850,TDMV 2,A00,890294,Weinberg; Sadie,23,0,30,7
1746568968875,TDMV 3,A00,957878,Arcidiacono; Kristin,28,0,30,2
1746568970942,TDMV 138,A00,890304,Jun; Grace Shin Hae,25,0,40,15
1746568972025,TDMV 140,A00,890305,Corrales; Joseph Bernales,25,0,30,5
1746568973053,TDMV 142,A00,890307,Caligagan; Tony,32,0,40,8
1746568974080,TDMV 144,A00,890308,Camaya; Michelle Ann,25,0,30,5
1746568975105,TDPW 1,A00,890295,Stein; Deborah Isobel,3,0,20,17
1746568976134,USP 2,A01,890272,Lerner; Amy M,6,0,20,14
1746568977161,USP 3,A01,890274,Staff,12,0,30,18
1746568978189,USP 15,A01,890276,Sun; Feiyang,16,0,30,14
1746568979234,USP 25,A00,890277,Shenkman; Michael Thomas,19,0,25,6
1746568980260,USP 138,A00,890278,Staff,14,0,25,11
1746568981284,USP 143,A00,890279,Staff,22,0,70,48
1746568982312,USP 144,A00,890280,Chowdhury; Muhammed Zohir,16,0,30,14
1746568983338,USP 150,A00,890281,Boomhower; Matthew Charles,4,0,30,26
1746568984368,USP 151,A00,890282,Staff,16,0,20,4
1746568985394,USP 162,A00,890283,Andrews; Abigail Leslie,16,0,20,4
1746568986422,USP 168,A00,920477,Kwak; Nancy,0,0,5,5
1746568987451,USP 181,A00,890284,Staff,3,0,20,17
1746568988480,USP 191A,A00,890285,Staff,12,0,20,8
1746568989508,VIS 101,A00,886512,Staff,26,0,75,49
1746568990539,VIS 103,A00,886513,Cruz; Edwin Teddy,61,0,75,14
1746568991565,VIS 108,A00,886514,Staff,3,0,15,12
1746568992592,VIS 127P,A00,886515,Shen; Kuiyi,80,0,146,66
1746568993620,VIS 149,A00,886516,Yoldas; Pinar,0,0,15,15
1746568994647,VIS 164,A00,886526,Erdmann; Dean,19,0,22,3
1746568995672,VIS 194S,A00,886527,Staff,61,0,75,14
1746568996698,WCWP 10A,C00,886484,Martiniuk; Jill,12,0,15,3
1746568997725,WCWP 10B,A00,886490,Uriarte; Emma,0,0,15,15
1746568997725,WCWP 10B,B00,886491,Dhir; Simrita,10,0,15,5
1746568997725,WCWP 10B,C00,886492,Ornelas; Tricia,0,0,15,15
1746568998750,WCWP 100,A00,886494,Young; Mark T,0,6,15,15
1746569000891,AAS 10,A01,886199,Childs; Dennis R.,0,3,0,0
1746569001921,ANAR 104,A01,886940,Shtienberg; Gilad,27,0,30,3
1746569002946,ANAR 120,A00,886953,Staff,12,0,20,8
1746569003974,ANBI 148,A01,886955,Wilder; Linnea Lorene,30,0,40,10
1746569006028,ANSC 122,A00,886957,Staff,25,0,30,5
1746569007056,ANSC 150,A00,886958,Sloane; Julia Kathryn,2,0,15,13
1746569008083,ANSC 156,A00,886959,Jenkins; Janis A.,0,1,15,15
1746569009112,ANSC 180,A00,886960,Staff,11,0,17,6
1746569010140,ANSC 188,A00,886961,Jassal; Aftab,9,0,25,16
1746569011168,ANSC 190,A00,886962,Jassal; Aftab,14,0,25,11
1746569012198,ANSC 191,A00,886963,Staff,18,0,20,2
1746569013224,ANTH 3,A01,891689,Staff,17,0,20,3
1746569014249,ANTH 5,A00,886933,Semendeferi; Ekaterini,16,0,20,4
1746569015277,ANTH 10,A00,886934,Staff,0,12,30,30
1746569016306,ANTH 21,A01,886936,Staff,41,0,60,19
1746569017335,ANTH 23,A01,886938,Staff,92,0,100,8
1746569018360,ANTH 105,A00,886964,Stewart; Alexander B,84,0,100,16
1746569019384,ANTH 108,A00,886965,Pedersen; David,9,0,20,11
1746569020421,AWP 10,001,886147,Staff,0,0,0,0
1746569020421,AWP 10,002,886148,Staff,0,0,0,0
1746569020421,AWP 10,003,886149,Staff,0,0,0,0
1746569020421,AWP 10,004,886150,Staff,0,0,0,0
1746569020421,AWP 10,005,886151,Staff,0,0,0,0
1746569020421,AWP 10,006,886152,Staff,0,0,0,0
1746569020421,AWP 10,007,886153,Staff,0,0,0,0
1746569020421,AWP 10,008,886154,Staff,0,0,0,0
1746569020421,AWP 10,009,886155,Staff,0,0,0,0
1746569020421,AWP 10,010,886156,Staff,0,0,0,0
1746569020421,AWP 10,011,886158,Staff,0,0,0,0
1746569020421,AWP 10,012,886160,Staff,0,0,0,0
1746569020421,AWP 10,013,886161,Staff,0,0,0,0
1746569020421,AWP 10,014,886162,Staff,0,0,0,0
1746569020421,AWP 10,015,886163,Staff,0,0,0,0
1746569020421,AWP 10,016,886164,Staff,0,0,0,0
1746569020421,AWP 10,017,886165,Staff,0,0,0,0
1746569020421,AWP 10,018,886166,Staff,0,0,0,0
1746569020421,AWP 10,019,886168,Staff,0,0,0,0
1746569020421,AWP 10,020,886170,Staff,0,0,0,0
1746569020421,AWP 10,021,886172,Staff,0,0,0,0
1746569021459,AWP 10R,001,886173,Staff,0,1,0,0
1746569021459,AWP 10R,002,886174,Staff,0,1,0,0
1746569021459,AWP 10R,003,886175,Staff,0,0,0,0
1746569021459,AWP 10R,004,886176,Staff,0,0,0,0
1746569021459,AWP 10R,005,886177,Staff,0,0,0,0
1746569021459,AWP 10R,006,886178,Staff,0,0,0,0
1746569021459,AWP 10R,007,886179,Staff,0,0,0,0
1746569021459,AWP 10R,008,886181,Staff,0,0,0,0
1746569021459,AWP 10R,009,886182,Staff,0,0,0,0
1746569021459,AWP 10R,010,886183,Staff,0,0,0,0
1746569021459,AWP 10R,011,886184,Staff,0,0,0,0
1746569021459,AWP 10R,012,886185,Staff,0,0,0,0
1746569021459,AWP 10R,013,886186,Staff,0,0,0,0
1746569021459,AWP 10R,014,886187,Staff,0,0,0,0
1746569021459,AWP 10R,015,886188,Staff,0,0,0,0
1746569021459,AWP 10R,016,886189,Staff,0,0,0,0
1746569021459,AWP 10R,017,960532,Staff,0,0,0,0
1746569021459,AWP 10R,018,960533,Staff,0,0,0,0
1746569021459,AWP 10R,019,960534,Staff,0,0,0,0
1746569021459,AWP 10R,020,960538,Staff,0,0,0,0
1746569021459,AWP 10R,021,960540,Staff,0,0,0,0
1746569021459,AWP 10R,022,960541,Staff,0,0,0,0
1746569021459,AWP 10R,023,960542,Staff,0,0,0,0
1746569021459,AWP 10R,024,960544,Staff,0,0,0,0
1746569021459,AWP 10R,025,960545,Staff,0,0,0,0
1746569021459,AWP 10R,026,960548,Staff,0,0,0,0
1746569022484,AWP 102R,A00,886190,Staff,0,0,0,0
1746569022484,AWP 102R,B00,886191,Staff,0,0,0,0
1746569023509,BENG 100,A01,886193,Staff,17,0,30,13
1746569024538,BENG 122A,A01,886195,Hasty; Jeff M,13,0,30,17
1746569025564,BENG 166A,A00,886196,Sah; Robert Lie-Yuan,0,2,30,30
1746569026592,BENG 190,A00,958050,Khojah; Reem I,20,0,25,5
1746569027621,BIBC 102,A01,894320,Staff,0,0,46,46
1746569027621,BIBC 102,A02,894321,Staff,0,0,46,46
1746569027621,BIBC 102,A03,894344,Staff,7,0,46,39
1746569027621,BIBC 102,A04,894345,Staff,27,0,47,20
1746569028651,BICD 100R,A01,894365,Smith; Laurie,0,3,58,58
1746569028651,BICD 100R,A02,894366,Smith; Laurie,0,5,58,58
1746569028651,BICD 100R,A03,894367,Smith; Laurie,0,0,59,59
1746569028651,BICD 100R,A04,959869,Smith; Laurie,40,0,59,19
1746569029682,BICD 136,A01,894383,Gustafson-Brown; Cindy,14,0,50,36
1746569030707,BIEB 102,A01,894494,Butler; Shannon Rhey,51,0,130,79
1746569032762,BIEB 150,A01,894617,Wills; Christopher,3,0,20,17
1746569032762,BIEB 150,A02,894631,Wills; Christopher,3,0,20,17
1746569032762,BIEB 150,A03,894937,Wills; Christopher,3,0,20,17
1746569032762,BIEB 150,A04,894946,Wills; Christopher,5,0,20,15
1746569033799,BIEB 194,A00,906141,Kurle; Carolyn M.,6,0,20,14
1746569034826,BILD 1,A01,894154,Staff,3,0,19,16
1746569034826,BILD 1,A02,894155,Staff,14,0,19,5
1746569034826,BILD 1,A03,894160,Staff,13,0,19,6
1746569034826,BILD 1,A04,894161,Staff,15,0,18,3
1746569035853,BILD 2,A01,894168,Staff,0,0,50,50
1746569035853,BILD 2,A02,894169,Staff,0,0,50,50
1746569035853,BILD 2,A03,894179,Staff,0,0,50,50
1746569035853,BILD 2,A04,894203,Staff,25,0,50,25
1746569036879,BILD 3,A01,894213,Staff,22,0,31,9
1746569036879,BILD 3,A02,894214,Staff,26,0,31,5
1746569036879,BILD 3,A03,894235,Staff,28,0,31,3
1746569036879,BILD 3,A04,894236,Staff,28,0,32,4
1746569037908,BILD 4,A01,894253,Reuther; Keefe,6,0,24,18
1746569037908,BILD 4,A02,894258,Reuther; Keefe,16,0,24,8
1746569038932,BILD 5,A01,894276,Reuther; Keefe,35,0,50,15
1746569038932,BILD 5,A02,894277,Reuther; Keefe,45,0,50,5
1746569038932,BILD 5,A03,894290,Reuther; Keefe,44,0,50,6
1746569038932,BILD 5,A04,894291,Reuther; Keefe,48,0,50,2
1746569039961,BILD 24,A01,894297,Pirino; Giorgia,40,0,60,20
1746569040990,BIMM 100,B01,958915,Staff,71,0,100,29
1746569042016,BIMM 101,A01,895017,McDonnell; Lisa Marie,0,5,24,24
1746569042016,BIMM 101,A02,895018,McDonnell; Lisa Marie,0,5,24,24
1746569042016,BIMM 101,B01,895020,McDonnell; Lisa Marie,0,6,24,24
1746569042016,BIMM 101,B02,895021,McDonnell; Lisa Marie,0,4,24,24
1746569043046,BIMM 110,A01,895023,Staff,1,0,25,24
1746569043046,BIMM 110,A02,895024,Staff,9,0,25,16
1746569043046,BIMM 110,A03,895025,Staff,18,0,25,7
1746569043046,BIMM 110,A04,895031,Staff,20,0,25,5
1746569044072,BIMM 120,A01,895114,Gustafson-Brown; Cindy,14,0,28,14
1746569044072,BIMM 120,A02,895126,Gustafson-Brown; Cindy,21,0,27,6
1746569045102,BIPN 100,A01,895130,Yang; Mingyu,0,0,38,38
1746569045102,BIPN 100,A02,895131,Yang; Mingyu,32,0,38,6
1746569045102,BIPN 100,A03,895132,Yang; Mingyu,32,0,38,6
1746569045102,BIPN 100,A04,895133,Yang; Mingyu,27,0,36,9
1746569046129,BIPN 120,A01,895135,Cooke; James Edward,0,3,13,13
1746569046129,BIPN 120,A02,895136,Cooke; James Edward,0,1,13,13
1746569046129,BIPN 120,A03,895137,Cooke; James Edward,0,3,13,13
1746569046129,BIPN 120,A04,895156,Cooke; James Edward,0,2,11,11
1746569047154,BIPN 134,A01,895235,Cooke; James Edward,0,2,25,25
1746569047154,BIPN 134,A02,895237,Cooke; James Edward,0,0,25,25
1746569047154,BIPN 134,A03,895240,Cooke; James Edward,3,0,25,22
1746569047154,BIPN 134,A04,895270,Cooke; James Edward,20,0,25,5
1746569048179,BIPN 189,A00,892103,Staff,0,14,14,14
1746569050233,BISP 194,A00,958008,Staff,0,2,0,0
1746569051262,CAT 124,A01,922009,Staff,0,5,20,20
1746569052291,CAT 125R,A00,886390,Morales; Celeste Georgianna,0,2,20,20
1746569052291,CAT 125R,B00,886391,Irwin; Matthew Joseph,0,4,20,20
1746569052291,CAT 125R,C00,886392,Smith; Lauryn Alissa,0,2,20,20
1746569052291,CAT 125R,D00,886393,Vanderschuit; Maya Alysia,0,3,20,20
1746569052291,CAT 125R,E00,886394,Marchisotto; Jennifer Anne,0,3,20,20
1746569053315,CENG 15,A01,886218,Drews; Aaron,3,0,8,5
1746569054346,CENG 113,A00,886219,Opatkiewicz; Justin Paul,15,0,25,10
1746569055370,CGS 101,A00,887044,Staff,7,0,20,13
1746569056403,CGS 105,A01,887046,Staff,14,0,25,11
1746569057428,CGS 112,A00,887047,Cuong; Marisol,12,0,15,3
1746569058456,CGS 113,A00,887048,Staff,23,0,30,7
1746569059486,CGS 120,A00,887049,Staff,10,0,17,7
1746569060511,CHEM 6A,A01,886336,Lam; Tin Yiu,38,0,50,12
1746569060511,CHEM 6A,A02,886338,Lam; Tin Yiu,37,0,50,13
1746569061537,CHEM 6B,A01,886341,Hopkins; Patrycja Anna,16,0,50,34
1746569061537,CHEM 6B,A02,886343,Hopkins; Patrycja Anna,42,0,50,8
1746569062563,CHEM 6C,A01,886346,Albizati; Kim F.,0,2,50,50
1746569062563,CHEM 6C,A02,886348,Albizati; Kim F.,23,0,50,27
1746569063588,CHEM 40A,A01,886352,Klosterman; Jeremy K,65,0,100,35
1746569064618,CHEM 40B,A01,886356,Klosterman; Jeremy K,0,23,100,100
1746569065643,CHEM 41B,A01,886360,Theodorakis; Emmanuel,25,0,50,25
1746569065643,CHEM 41B,A02,886362,Theodorakis; Emmanuel,47,0,50,3
1746569066668,CHIN 165A,A00,886382,Xu; Li,18,0,20,2
1746569067697,CLAS 120,A00,886387,Myerston Santana; Jacobo,33,0,40,7
1746569068721,COGS 9,A01,886967,Shannon; Kyle Michael,42,0,60,18
1746569069749,COGS 11,A01,886969,Staff,10,0,30,20
1746569070777,COGS 14A,A01,886971,Staff,6,0,60,54
1746569071805,COGS 14B,A01,886973,Hoffman; Drew Ellen,4,0,60,56
1746569072831,COGS 18,A01,886975,Morgan; Eric,35,0,60,25
1746569073856,COGS 20,A01,886977,Staff,4,0,8,4
1746569073856,COGS 20,A02,886978,Staff,5,0,7,2
1746569074884,COGS 100,A01,907783,Staff,1,2,30,29
1746569075950,COGS 101B,A01,886980,Staff,0,3,48,48
1746569076980,COGS 101C,A01,886982,Delgado; Tania,0,5,44,44
1746569078005,COGS 102A,A01,886984,Johnson; Christine M.,4,0,30,26
1746569079036,COGS 118B,A01,886986,Staff,1,3,88,87
1746569080062,COGS 150,A01,886988,Bergen; Benjamin,22,0,50,28
1746569081091,COGS 153,A00,886989,Delgado; Tania,0,2,41,41
1746569082117,COGS 186,A01,886991,Staff,0,0,32,32
1746569083145,COGS 187A,A01,886993,Boyle; Mary E. T.,7,0,30,23
1746569084172,COGS 189,A00,886994,Staff,0,1,30,30
1746569085203,COMM 10,A01,886996,Staff,0,0,20,21
1746569085203,COMM 10,A02,886997,Staff,12,0,20,8
1746569085203,COMM 10,A03,959845,Staff,19,0,20,1
1746569086229,COMM 20,A01,886999,Leuning; Grant Maurstad,24,0,40,16
1746569088278,COMM 100A,A01,887002,Staff,0,0,20,25
1746569088278,COMM 100A,A02,887003,Staff,6,0,20,14
1746569089309,COMM 100B,A01,887005,Staff,0,8,20,24
1746569090338,COMM 106D,A00,887006,Staff,13,0,40,27
1746569091364,COMM 110G,A00,887007,Whitworth-Smith; Andrew C,12,0,40,28
1746569092390,COMM 111B,A00,887008,Staff,31,0,40,9
1746569093416,COMM 113T,A00,887009,Abuelhiga; Soraya Jill,28,0,40,12
1746569093416,COMM 113T,B00,906733,Staff,40,0,40,0
1746569094442,COMM 145,A00,887010,Staff,12,0,40,28
1746569095467,COMM 146,A00,887054,Staff,31,0,40,9
1746569096491,COMM 190,A00,887012,Staff,8,0,23,15
1746569097523,CSE 8A,A50,887015,Cao; Yingjun,57,0,85,28
1746569098552,CSE 11,A01,887017,Cao; Yingjun,12,0,70,58
1746569099581,CSE 20,A01,887019,Staff,30,0,50,20
1746569100606,CSE 21,A01,887021,Staff,78,0,100,22
1746569100606,CSE 21,B01,892583,Braun; Oliver,45,0,50,5
1746569101637,CSE 30,A01,887025,Eldon; John,143,0,200,57
1746569102669,CSE 100,A01,887027,Staff,26,0,50,24
1746569102669,CSE 100,A02,887028,Staff,42,0,50,8
1746569103695,CSE 101,A01,887030,Braun; Oliver,74,0,100,26
1746569103695,CSE 101,B01,887032,Jones; Miles E,0,3,50,50
1746569103695,CSE 101,B02,887033,Jones; Miles E,0,2,50,50
1746569104723,CSE 105,A01,908084,Jones; Miles E,32,0,50,18
1746569104723,CSE 105,A02,908087,Jones; Miles E,31,0,50,19
1746569105755,CSE 135,A01,887035,Powell; Thomas Allan,0,5,50,50
1746569106786,CSE 142,A01,887037,Staff,8,0,60,52
1746569107811,CSE 142L,A01,887039,Staff,34,0,60,26
1746569108836,CSE 151A,A01,887041,Solares; Edwin A,47,0,100,53
1746569109862,CSE 175,A01,887043,Kumar; Rakesh,30,0,30,0
1746569110887,CSS 1,A01,886389,Staff,1,1,40,39
1746569111917,DSC 30,A01,908097,Liao; Soohyun Nam,47,0,75,28
1746569112942,DSC 40A,A01,908099,Shannon; Kyle Michael,30,0,50,20
1746569113966,DSC 40B,A01,908112,Staff,15,0,50,35
1746569114991,DSC 80,A01,908116,Staff,19,0,60,41
1746569116014,DSC 197,001,956863,Eldridge; Justin Matthew,9999,0,9999,0
1746569117044,ECE 5,A01,886400,Morris; Karcher William,1,0,6,5
1746569117044,ECE 5,A02,886401,Morris; Karcher William,3,0,6,3
1746569118073,ECE 148,A01,886403,Silberman; Jack,0,14,14,14
1746569119115,ECON 1,A01,887265,Crane; Meredith Helen,12,0,70,58
1746569119115,ECON 1,B01,887268,Staff,43,0,50,7
1746569120144,ECON 2,A01,887273,Crane; Meredith Helen,55,0,70,15
1746569121170,ECON 3,A01,887279,Rondina; Giacomo,32,0,70,38
1746569122200,ECON 4,A01,887282,Anderson; John Charles,0,2,10,10
1746569123227,ECON 5,A01,887285,Staff,34,0,45,11
1746569123227,ECON 5,B01,887292,Staff,41,0,45,4
1746569124252,ECON 100A,A01,887337,Newhouse; Herbert S,54,0,70,16
1746569124252,ECON 100A,B01,887349,Staff,45,0,50,5
1746569125281,ECON 100B,A01,887361,Du; Songzi,29,0,70,41
1746569126306,ECON 100C,A01,887445,Newhouse; Herbert S,59,0,70,11
1746569127331,ECON 105,A00,887488,Vespa; Emanuel Ignacio,23,0,35,12
1746569128356,ECON 109,A01,887506,Shishkin; Denis,28,0,35,7
1746569129384,ECON 110A,A01,887568,Alon; Titan Michael,0,3,35,35
1746569129384,ECON 110A,B01,907601,Alon; Titan Michael,20,0,35,15
1746569130414,ECON 110B,A01,887598,Levkoff; Steven B.,0,24,70,70
1746569131437,ECON 112,A00,887599,Rondina; Giacomo,19,0,35,16
1746569132465,ECON 120A,A01,887603,Dai; Yinlin,35,0,70,35
1746569133492,ECON 120C,A01,887608,Sun; Yixiao,0,1,35,35
1746569133492,ECON 120C,B01,887614,Sun; Yixiao,0,0,35,35
1746569134517,ECON 138,A00,887621,Bharadwaj; Prashant,0,21,20,20
1746569135542,ECON 144,A00,958007,Squires; Dale E,12,0,35,23
1746569136566,ECON 171,A01,907666,Staff,18,0,35,17
1746569137593,ECON 175,A00,887626,Wu; Pak Yeung,22,0,35,13
1746569138619,ECON 190,A00,887640,Vespa; Emanuel Ignacio,22,0,35,13
1746569139651,EDS 25,A01,888197,Staff,0,0,0,0
1746569139651,EDS 25,A02,888209,Staff,0,0,0,0
1746569139651,EDS 25,A03,888210,Staff,0,0,0,0
1746569139651,EDS 25,A04,888212,Staff,0,0,0,0
1746569139651,EDS 25,A05,888213,Staff,0,0,0,0
1746569139651,EDS 25,A06,888214,Staff,0,0,0,0
1746569139651,EDS 25,A07,888235,Staff,0,2,0,0
1746569139651,EDS 25,A08,888236,Staff,0,0,0,0
1746569139651,EDS 25,A09,888240,Staff,0,0,0,0
1746569139651,EDS 25,A10,888244,Staff,0,0,0,0
1746569139651,EDS 25,B01,888273,Staff,0,0,0,0
1746569139651,EDS 25,B02,888285,Staff,0,0,0,0
1746569139651,EDS 25,B03,888423,Staff,0,0,0,1
1746569139651,EDS 25,B04,888432,Staff,0,0,0,0
1746569139651,EDS 25,B05,888433,Staff,0,0,0,0
1746569139651,EDS 25,B06,888467,Staff,0,0,0,0
1746569139651,EDS 25,B07,888468,Staff,0,0,0,0
1746569139651,EDS 25,B08,888479,Staff,0,0,0,0
1746569139651,EDS 25,B09,888484,Staff,0,0,0,0
1746569139651,EDS 25,B10,888487,Staff,0,0,0,0
1746569140677,EDS 38,A01,907700,Choi; Bailey Miyeon,30,0,30,0
1746569141702,EDS 112,A01,888601,Chapman; Thandeka K,12,0,40,28
1746569142731,EDS 115,A00,888697,Mendez; Kathrina Mendoza,10,0,30,20
1746569143757,EDS 116,A01,888893,Staff,34,0,40,6
1746569145813,EDS 124AR,A00,889133,Staff,28,0,50,22
1746569145813,EDS 124AR,B00,907471,Simon; Elizabeth A,37,0,50,13
1746569146841,EDS 124BR,A00,889134,Simon; Elizabeth A,44,0,100,56
1746569147870,EDS 125,A00,889135,Staff,25,0,30,5
1746569148900,EDS 126,A01,889138,Staff,36,0,40,4
1746569149927,EDS 164R,A01,889142,Wishard Guerra; Alison G.,33,0,50,17
1746569150952,ENG 30,A01,886396,Staff,0,0,0,0
1746569150952,ENG 30,B01,886398,Staff,0,0,0,0
1746569151983,ENVR 102,A00,906150,Montejo; Carolina,23,0,25,2
1746569153011,ETHN 103A,A00,887236,Man; Simeon S,0,3,0,0
1746569154040,ETHN 113,A00,887239,Staff,16,0,30,14
1746569155066,ETHN 116,A00,887240,Staff,16,0,25,9
1746569156095,ETHN 117,A00,887241,Choi; Esther Min,28,0,30,2
1746569157121,ETHN 118,A00,887243,Staff,24,0,30,6
1746569158150,ETHN 127,A00,887248,Cuong; Marisol,11,0,15,4
1746569159176,ETHN 139,A00,887250,Staff,7,0,10,3
1746569160202,ETHN 142,A00,887252,Staff,10,0,30,20
1746569161232,ETHN 161,A00,887253,Browne; Errol Tsekani,24,0,30,6
1746569162259,ETHN 163FR,A00,887255,Burelle; Julie Sara Veronique,0,0,5,5
1746569163287,GLBH 20,A00,889149,Elwardani; Nile Regina,8,0,42,34
1746569165336,GLBH 111,A01,889152,Burgos; Jose L.,17,0,17,0
1746569166362,GLBH 150,A00,889181,Sloane; Julia Kathryn,0,5,15,15
1746569168414,HDS 60,A01,886406,Warstadt; Melissa Fawn,73,0,80,7
1746569169442,HIAF 111,A00,889324,Gyamfi; Bright,25,0,32,7
1746569170468,HIEA 131,A00,889328,Staff,15,0,32,17
1746569171494,HIEA 144,A00,889333,Henry; Todd A.,26,0,32,6
1746569172524,HIEA 154,A00,889336,Henry; Todd A.,24,0,32,8
1746569173551,HIEU 106,A00,889339,Staff,22,0,32,10
1746569175602,HIEU 114,A00,889340,Staff,3,0,32,29
1746569176627,HIEU 135GS,A00,889342,Patterson; Patrick H.,0,0,1,24
1746569177656,HIEU 137,A00,889343,Edington; Claire Ellen,10,0,25,15
1746569178681,HIEU 148,A00,889345,Staff,14,0,32,18
1746569179710,HIEU 154,A00,889346,Biess; Frank Peter,21,0,32,11
1746569180737,HILA 102,A00,889351,Staff,12,0,32,20
1746569181761,HILD 2A,A01,889221,Lewandoski; Julia Mavis,1,10,32,31
1746569182788,HILD 7B,A01,889225,Man; Simeon S,0,12,32,32
1746569183817,HILD 7C,A01,889288,Alvarez; Luis A,0,14,32,32
1746569184847,HILD 30,A01,889323,Staff,0,5,32,32
1746569186901,HISC 119,A00,889383,Golan; Tal,19,0,32,13
1746569187931,HIUS 103,A00,889384,Man; Simeon S,0,0,32,32
1746569188959,HIUS 117,A00,919797,Kwak; Nancy,19,0,32,13
1746569189987,HIUS 142A,A00,919788,Staff,22,0,32,10
1746569192037,HIUS 149,A00,889386,Gyamfi; Bright,26,0,32,6
1746569193101,HIUS 155,A00,889387,Alvarez; Luis A,15,0,32,17
1746569194127,HUM 3,A01,886499,Caldwell; Michael Alan,19,0,50,31
1746569195158,HUM 3GS,A00,886500,Rodriguez; Bretton Sigfred,0,0,0,28
1746569196187,HUM 3R,A01,886502,Markman; Kristina,0,36,50,50
1746569197214,HUM 4,A01,886504,Crum; Matthew Stephen,24,0,50,26
1746569197214,HUM 4,B01,886506,West; Geoffrey Scott,17,0,50,33
1746569198241,HUM 4GS,A00,886507,Staff,0,0,0,19
1746569199268,HUM 5,A01,886509,Staff,32,0,50,18
1746569200316,HUM 5R,A01,886511,Zavodny; Tatiana Sophia,0,39,50,50
1746569201342,JAPN 180,A00,886407,Staff,16,0,40,24
1746569202369,LATI 50,A01,886409,Martin-Cabrera; Luis,4,0,22,18
1746569202369,LATI 50,A02,886410,Martin-Cabrera; Luis,19,0,22,3
1746569202369,LATI 50,A03,886411,Martin-Cabrera; Luis,21,0,22,1
1746569202369,LATI 50,A04,886412,Martin-Cabrera; Luis,9,0,22,13
1746569203394,LAWS 101,A00,907664,Staff,28,0,60,32
1746569204422,LIAB 1A,A00,889388,Saab; Dima,17,0,20,3
1746569205447,LIAB 1AX,A00,889389,El Cheddadi; Youniss,18,0,20,2
1746569206474,LIFR 1C,A00,889391,Van Moer; Vinciane G,8,0,20,12
1746569207500,LIFR 1CX,A00,889392,Van Moer; Vinciane G,7,0,20,13
1746569208525,LIFR 1D,A00,889393,Van Moer; Vinciane G,7,0,20,13
1746569209554,LIFR 1DX,A00,889394,Van Moer; Vinciane G,8,0,20,12
1746569210578,LIGN 7,A00,886923,Staff,24,0,50,26
1746569211604,LIGN 17,A00,886924,Kehler; Andrew Scott,125,0,150,25
1746569212630,LTAM 110,A00,889395,Staff,15,0,30,15
1746569213655,LTAM 110GS,A00,958010,Rodriguez; Bretton Sigfred,0,0,0,28
1746569214679,LTCH 101,A00,889397,Staff,23,0,25,2
1746569215706,LTCS 130,A00,889398,Staff,23,0,25,2
1746569216733,LTEA 138,A00,889399,Staff,24,0,40,16
1746569217759,LTEN 149,A00,889400,Wesling; Megan E.,0,3,25,25
1746569218787,LTEN 169,A00,889401,Staff,20,0,25,5
1746569219812,LTEN 180,A00,889402,Staff,10,0,15,5
1746569220840,LTEN 181,A00,889403,Staff,21,0,25,4
1746569221870,LTWL 100,A00,889404,Myerston Santana; Jacobo,2,0,25,23
1746569222897,LTWL 180GS,A00,889405,Staff,0,0,20,20
1746569223924,LTWL 181,A00,889406,Staff,16,0,25,9
1746569224952,LTWL 184,A00,889475,Mukherjee; Silpa,22,0,25,3
1746569225976,LTWR 102C,A00,889486,Staff,29,0,30,1
1746569227004,LTWR 115W,A00,889491,Staff,0,2,15,15
1746569228031,MAE 8,A01,886905,Staff,0,2,0,0
1746569229056,MAE 11,A00,886906,Bandaru; Prabhakar,0,7,50,50
1746569230081,MAE 20,A00,886907,Evdokimenko; Ekaterina,43,0,70,27
1746569231111,MAE 30B,A00,886909,Ghazinejad; Maziar,26,0,45,19
1746569232140,MAE 101B,A00,886910,Saintillan; David,29,0,45,16
1746569233169,MAE 105,A00,886911,Bandaru; Prabhakar,18,0,50,32
1746569234198,MAE 107,B00,958024,Staff,8,0,50,42
1746569235224,MAE 143B,A00,886913,Bewley; Thomas R,6,0,40,34
1746569236250,MAE 148,A01,886915,Silberman; Jack,0,3,14,14
1746569237275,MAE 160,A00,886916,Evdokimenko; Ekaterina,31,0,60,29
1746569238302,MATH 3C,A01,889681,Staff,0,2,30,30
1746569238302,MATH 3C,A02,960048,Staff,24,0,30,6
1746569239330,MATH 10A,A01,889760,Staff,26,0,30,4
1746569239330,MATH 10A,A02,889783,Staff,29,0,30,1
1746569240361,MATH 10B,A01,889785,Verstraete; Jacques Allan,2,0,35,33
1746569240361,MATH 10B,A02,889795,Verstraete; Jacques Allan,4,0,35,31
1746569240361,MATH 10B,B01,889797,Verstraete; Jacques Allan,3,0,35,32
1746569240361,MATH 10B,B02,889828,Verstraete; Jacques Allan,3,0,35,32
1746569241392,MATH 10C,A01,889849,Habib; Yousaf,7,0,30,23
1746569241392,MATH 10C,A02,889852,Habib; Yousaf,14,0,30,16
1746569241392,MATH 10C,A03,889853,Habib; Yousaf,22,0,30,8
1746569241392,MATH 10C,A04,889858,Habib; Yousaf,20,0,30,10
1746569241392,MATH 10C,B01,889861,Staff,1,0,30,29
1746569241392,MATH 10C,B02,889862,Staff,24,0,30,6
1746569241392,MATH 10C,B03,889863,Staff,27,0,30,3
1746569241392,MATH 10C,B04,889967,Staff,23,0,30,7
1746569242419,MATH 18,A01,889974,Staff,7,0,30,23
1746569242419,MATH 18,A02,889977,Staff,20,0,30,10
1746569242419,MATH 18,B01,889984,Hardiman; Liam,21,0,30,9
1746569242419,MATH 18,B02,889985,Hardiman; Liam,25,0,30,5
1746569243445,MATH 20A,A01,889990,Suk; Andrew Hoon,30,0,35,5
1746569244470,MATH 20B,A01,889993,Ohm; Ko Woon,22,0,30,8
1746569244470,MATH 20B,A02,889994,Ohm; Ko Woon,30,0,30,0
1746569244470,MATH 20B,B01,889996,Ohm; Ko Woon,21,0,30,9
1746569244470,MATH 20B,B02,889997,Ohm; Ko Woon,23,0,30,7
1746569245499,MATH 20C,A01,889999,Hammock; Frances H,17,0,30,13
1746569245499,MATH 20C,A02,890003,Hammock; Frances H,23,0,30,7
1746569245499,MATH 20C,B01,890006,Hammock; Frances H,3,0,30,27
1746569245499,MATH 20C,B02,890007,Hammock; Frances H,12,0,30,18
1746569246527,MATH 20D,A01,890011,Cheng; Hsiao-Bing,1,1,30,29
1746569246527,MATH 20D,A02,890012,Cheng; Hsiao-Bing,14,0,30,16
1746569246527,MATH 20D,B01,890016,Cheng; Hsiao-Bing,13,0,30,17
1746569246527,MATH 20D,B02,890017,Cheng; Hsiao-Bing,13,0,30,17
1746569247553,MATH 20E,A01,890026,Harel; Guershon,1,0,30,29
1746569247553,MATH 20E,A02,890029,Harel; Guershon,23,0,30,7
1746569247553,MATH 20E,B01,890033,Harel; Guershon,7,0,30,23
1746569247553,MATH 20E,B02,890101,Harel; Guershon,21,0,30,9
1746569248579,MATH 102,A01,890104,Staff,17,0,30,13
1746569248579,MATH 102,A02,890105,Staff,27,0,30,3
1746569249610,MATH 103B,A01,890116,Salehi Golsefidy; Alireza,3,0,30,27
1746569249610,MATH 103B,B01,890118,Staff,0,3,34,34
1746569250640,MATH 109,A01,890121,Aliabadi Sr.; Mohsen,1,0,30,29
1746569250640,MATH 109,B01,890124,Upadrashta; Pranav Kumar,18,0,30,12
1746569251664,MATH 120A,A01,890126,Eggers; John Dietrich,13,0,30,17
1746569252694,MATH 142B,A01,890128,Ioana; Adrian,19,0,30,11
1746569252694,MATH 142B,A02,890129,Ioana; Adrian,13,0,30,17
1746569253719,MATH 154,A01,890174,Staff,0,0,30,30
1746569253719,MATH 154,A02,890182,Staff,0,0,30,30
1746569254747,MATH 168A,A01,890197,Dumitriu; Ioana,21,0,35,14
1746569255772,MATH 170A,A01,890240,Nie; Jiawang,1,0,30,29
1746569255772,MATH 170A,A02,890241,Nie; Jiawang,11,0,30,19
1746569255772,MATH 170A,A03,890249,Nie; Jiawang,23,0,30,7
1746569256803,MATH 170B,A01,957891,Nag; Panchali,13,0,35,22
1746569258855,MATH 181A,A01,908025,Staff,0,4,35,35
1746569258855,MATH 181A,A02,960115,Staff,27,0,35,8
1746569259880,MATH 181B,A01,959874,Staff,25,0,30,5
1746569261111,MATH 193B,A01,890265,Staff,0,4,35,35
1746569262137,MGT 4,A01,890311,Anderson; John Charles,42,0,88,46
1746569263165,MGT 5,A00,907740,Staff,13,0,98,85
1746569264191,MGT 12,A00,890312,Lindenberger; Wade Douglas,67,0,98,31
1746569265225,MGT 16,A00,957883,Staff,78,0,98,20
1746569267281,MGT 45,A00,890314,Pecore; Joseph P.,46,0,98,52
1746569268308,MGT 71,A00,890315,Staff,0,11,98,98
1746569269333,MGT 100,A00,890316,Yavorsky; Daniel Ryan,44,0,98,54
1746569270359,MGT 103,A00,890317,Ehrich; Kristine R,73,0,98,25
1746569271385,MGT 105,A00,890356,Bates; Kenneth Walter,0,8,98,98
1746569272423,MGT 112,A00,890360,Ehrich; Kristine R,55,0,98,43
1746569273448,MGT 127R,A00,907732,Zhu; Kevin Xiaoguo,23,0,98,75
1746569274474,MGT 131B,A00,890361,Anderson; John Charles,60,0,98,38
1746569275500,MGT 137,A00,890362,Lindenberger; Wade Douglas,65,0,98,33
1746569276526,MGT 160,A00,890369,Johnson; Erik Barry,9,0,98,89
1746569278578,MGT 164,A00,890372,Zimmermann; Carsten,0,40,98,98
1746569279603,MGT 180,A00,890374,Bliss; Barbara Ann,12,0,98,86
1746569280630,MMW 15,A01,886414,Chang; Edmond Yi-Teh,0,12,28,28
1746569280630,MMW 15,A02,886415,Chang; Edmond Yi-Teh,0,8,28,28
1746569280630,MMW 15,A03,886416,Chang; Edmond Yi-Teh,0,8,28,28
1746569280630,MMW 15,A04,886417,Chang; Edmond Yi-Teh,0,8,28,28
1746569280630,MMW 15,B01,886419,Chang; Edmond Yi-Teh,0,7,28,28
1746569280630,MMW 15,B02,886420,Chang; Edmond Yi-Teh,0,8,28,28
1746569280630,MMW 15,B03,886421,Chang; Edmond Yi-Teh,0,7,28,28
1746569280630,MMW 15,B04,886422,Chang; Edmond Yi-Teh,0,8,28,28
1746569280630,MMW 15,C01,886424,Staff,0,9,28,28
1746569280630,MMW 15,C02,886425,Staff,0,8,28,28
1746569280630,MMW 15,C03,886426,Staff,0,8,28,28
1746569280630,MMW 15,C04,886427,Staff,0,8,28,28
1746569280630,MMW 15,C05,958038,Staff,0,8,28,28
1746569280630,MMW 15,C06,958039,Staff,1,8,28,27
1746569281658,MMW 15GS,A00,906910,Patterson; Patrick H.,4,0,28,24
1746569282701,MMW 122R,A01,886429,Rahimi; Babak,0,13,28,28
1746569282701,MMW 122R,A02,886430,Rahimi; Babak,0,12,28,28
1746569282701,MMW 122R,A03,958040,Rahimi; Babak,0,11,28,28
1746569283732,MUS 1A,A01,890937,Staff,2,0,25,23
1746569283732,MUS 1A,A02,891035,Staff,6,0,25,19
1746569283732,MUS 1A,C01,958912,Staff,24,0,25,1
1746569283732,MUS 1A,C02,958913,Staff,25,0,25,0
1746569285793,MUS 2AK,A00,957092,Ohnishi; Takae,15,0,15,0
1746569286818,MUS 4,A01,891044,Staff,2,0,25,23
1746569286818,MUS 4,A02,891045,Staff,23,0,25,2
1746569286818,MUS 4,B01,891048,Staff,17,0,25,8
1746569286818,MUS 4,B02,891050,Staff,25,0,25,0
1746569287848,MUS 5,A01,957506,Dubnov; Shlomo,0,0,25,25
1746569287848,MUS 5,A02,957622,Dubnov; Shlomo,13,0,25,12
1746569287848,MUS 5,A03,957623,Dubnov; Shlomo,20,0,25,5
1746569288875,MUS 6,A01,891053,Freitas Caetano; Marcelo,24,0,25,1
1746569288875,MUS 6,A02,891054,Freitas Caetano; Marcelo,23,0,25,2
1746569289905,MUS 7,A01,891081,Staff,0,0,25,25
1746569289905,MUS 7,A02,891082,Staff,3,0,25,22
1746569290929,MUS 8GS,A00,891118,Borgo; David Garcia,1,0,25,24
1746569291958,MUS 11,A01,891140,Staff,9,0,25,16
1746569291958,MUS 11,A02,891141,Staff,22,0,25,3
1746569292987,MUS 13,A01,891143,Staff,8,0,25,17
1746569292987,MUS 13,A02,891144,Staff,24,0,25,1
1746569294017,MUS 15,A01,891146,Staff,9,0,25,16
1746569294017,MUS 15,A02,891148,Staff,21,0,25,4
1746569294017,MUS 15,B01,891150,Staff,18,0,25,7
1746569294017,MUS 15,B02,891151,Staff,25,0,25,0
1746569295045,MUS 20,A01,891153,Staff,5,0,20,15
1746569295045,MUS 20,A02,891155,Staff,14,0,20,6
1746569296069,MUS 80,A00,891156,Staff,19,0,25,6
1746569296069,MUS 80,B00,891157,Staff,23,0,25,2
1746569297136,MUS 130,A00,891158,Ohnishi; Takae,35,0,35,0
1746569298168,MUS 150GS,A01,891160,Borgo; David Garcia,1,0,25,24
1746569299196,MUS 170,A01,891162,Freitas Caetano; Marcelo,20,0,25,5
1746569299196,MUS 170,A02,891164,Freitas Caetano; Marcelo,21,0,25,4
1746569300229,NANO 11,A00,886220,Vazquez Mena; Oscar,13,0,15,2
1746569301255,NANO 15,A01,886222,Drews; Aaron,4,0,7,3
1746569302279,NANO 104,A00,886224,Sirbuly; Donald,17,0,25,8
1746569303309,PH 40,A00,886528,Staff,23,0,40,17
1746569304337,PH 45,A01,886799,Staff,35,0,40,5
1746569305366,PH 110,A00,886802,Staff,0,7,40,40
1746569306395,PH 172,A00,906716,Staff,19,0,35,16
1746569307421,PH 191,A00,886803,Staff,6,0,40,34
1746569308446,PHIL 1,A00,889500,Staff,20,0,30,10
1746569309473,PHIL 10,A01,889549,Grush; Rick Scott,15,0,22,7
1746569309473,PHIL 10,A02,889551,Grush; Rick Scott,22,0,22,0
1746569310498,PHIL 28,A01,889559,Lamey; Andy M.,0,2,31,31
1746569310498,PHIL 28,A02,889561,Lamey; Andy M.,0,1,30,30
1746569310498,PHIL 28,A03,889572,Lamey; Andy M.,0,1,30,30
1746569311525,PHIL 35,A00,907839,Staff,13,0,15,2
1746569312552,PHIL 60,A00,889574,Staff,73,0,90,17
1746569313582,PHIL 101,A00,958004,Staff,12,0,15,3
1746569315634,PHIL 136,A00,889582,Fulkerson; Matthew Todd,26,0,45,19
1746569316669,PHIL 163,A01,889601,Staff,21,0,30,9
1746569316669,PHIL 163,B01,889606,Brandt; Reuven A,0,3,0,0
1746569317699,PHIL 164,A00,889610,Staff,16,0,30,14
1746569318724,PHIL 165,A00,889613,Staff,22,0,30,8
1746569319750,PHYS 1A,A00,886431,Staff,26,0,70,44
1746569320780,PHYS 1AL,001,886432,Tsai; Philbert S,0,2,30,30
1746569320780,PHYS 1AL,002,886436,Tsai; Philbert S,11,0,30,19
1746569321805,PHYS 1B,A00,886439,Staff,185,0,240,55
1746569322829,PHYS 1BL,001,886441,Tsai; Philbert S,0,4,30,30
1746569322829,PHYS 1BL,002,886444,Tsai; Philbert S,2,0,30,28
1746569323858,PHYS 1C,A00,896092,Arnold; Kam S,78,0,146,68
1746569324885,PHYS 1CL,001,886448,Tsai; Philbert S,0,0,30,30
1746569324885,PHYS 1CL,002,886449,Tsai; Philbert S,1,0,30,29
1746569324885,PHYS 1CL,003,886450,Tsai; Philbert S,16,0,30,14
1746569324885,PHYS 1CL,004,886451,Tsai; Philbert S,15,0,30,15
1746569325911,PHYS 2B,A01,886457,Staff,68,0,115,47
1746569326937,PHYS 2C,A01,886460,Shotwell; Brian,0,9,65,65
1746569327962,PHYS 2CL,A01,886467,Staff,0,4,28,28
1746569327962,PHYS 2CL,A02,886468,Staff,0,3,28,28
1746569328989,PHYS 2D,A01,886470,Staff,10,0,50,40
1746569330017,PHYS 4B,A01,886475,Grinstein; Benjamin,22,0,40,18
1746569331044,POLI 5,A00,891173,Desposato; Scott,7,0,25,18
1746569332071,POLI 5D,A01,891175,Staff,5,0,5,0
1746569332071,POLI 5D,B01,891178,Staff,5,0,5,0
1746569333096,POLI 11,A00,891179,Ferree; Karen E,2,0,35,33
1746569334126,POLI 12,A00,891180,Staff,16,0,30,14
1746569335151,POLI 27,A01,891182,Staff,12,0,75,63
1746569336181,POLI 30,A00,891183,Staff,8,0,50,42
1746569337209,POLI 100B,A00,891244,Staff,5,1,35,30
1746569338239,POLI 100I,A00,891247,Staff,7,0,30,23
1746569339265,POLI 104J,A00,891248,Nichter; Maysa,14,0,30,16
1746569340293,POLI 104U,A00,891250,Nichter; Maysa,2,0,30,28
1746569342346,POLI 110B,A00,891255,Wiens; David,20,0,25,5
1746569343378,POLI 112A,A00,891256,Wiens; David,6,0,25,19
1746569344402,POLI 114BR,A00,891261,Staff,19,0,30,11
1746569345429,POLI 117R,A00,891262,Forman; Fonna,0,6,50,50
1746569346458,POLI 118,A00,891264,Ingham; Sean,17,0,25,8
1746569347484,POLI 124A,A00,891265,Staff,18,0,20,2
1746569348509,POLI 125D,A00,891266,Nichter; Simeon C,2,0,25,23
1746569349537,POLI 126,A00,891268,Nichter; Simeon C,7,0,25,18
1746569350564,POLI 126AA,A00,891272,Staff,16,0,25,9
1746569351590,POLI 130AA,A00,891273,Staff,15,0,20,5
1746569352619,POLI 134AA,A00,891274,Staff,4,0,20,16
1746569354673,POLI 138,A00,891278,Staff,21,0,25,4
1746569355698,POLI 142K,A00,891280,Staff,10,0,25,15
1746569356727,POLI 142M,A00,891281,Gartzke; Erik,16,0,30,14
1746569357753,POLI 142P,A00,891284,Staff,20,0,30,10
1746569358778,POLI 143,A00,891285,Gartzke; Erik,12,0,30,18
1746569359806,POLI 153,A00,891286,Staff,19,0,20,1
1746569361861,POLI 175,A00,891290,Staff,15,0,20,5
1746569362886,PSYC 1,A00,890674,Steiner; Eric Tomas,0,11,45,45
1746569363912,PSYC 2,A00,890676,Albright; Thomas D,21,0,35,14
1746569364936,PSYC 3,A00,890679,Staff,17,0,20,3
1746569365963,PSYC 6,A00,959858,Staff,20,0,20,0
1746569366992,PSYC 60,A01,890684,Rickard; Timothy C.,0,5,45,45
1746569368018,PSYC 70,A01,890689,Geller; Emma Harlan,7,0,30,23
1746569369042,PSYC 71,A01,959860,Staff,21,0,25,4
1746569370068,PSYC 100,A00,890690,Lacefield; Katharine I,0,50,180,180
1746569371097,PSYC 102,A00,890695,Staff,18,0,40,22
1746569372126,PSYC 105,A00,890699,Geller; Emma Harlan,70,0,100,30
1746569373154,PSYC 106,A00,890701,Gorman; Michael R.,6,0,30,24
1746569374180,PSYC 108,A00,890704,Adrian; Julia Anna,0,28,50,50
1746569375208,PSYC 118,A01,890712,Staff,11,0,30,19
1746569376234,PSYC 124,A00,890716,Chapman; Eddie Nathaniel,25,0,60,35
1746569377258,PSYC 131,A00,890717,Anagnostaras; Stephan,0,8,80,80
1746569378285,PSYC 137,A00,890719,Winkielman; Piotr,0,11,30,30
1746569379315,PSYC 144,A00,890721,Adrian; Julia Anna,0,9,45,45
1746569380344,PSYC 162,A00,890805,Staff,0,0,75,75
1746569381368,PSYC 169,A00,890810,Staff,0,14,30,30
1746569382396,PSYC 172,A00,890814,Gorman; Michael R.,9,0,30,21
1746569383425,PSYC 181,A00,890818,Anagnostaras; Stephan,9,0,200,191
1746569384452,PSYC 184,A00,959861,Staff,168,0,175,7
1746569385477,PSYC 189,A00,890823,Staff,0,2,30,30
1746569386505,PSYC 191,A00,890884,Rickard; Timothy C.,0,12,35,35
1746569387531,PSYC 193,A00,890913,Staff,19,0,30,11
1746569387531,PSYC 193,B00,890914,Chapman; Eddie Nathaniel,24,0,30,6
1746569388561,PSYC 193L,A01,890918,Lowe; Angela Beth,20,0,30,10
1746569388561,PSYC 193L,B01,890921,Hurwitz; Ethan Scott,20,0,30,10
1746569388561,PSYC 193L,C01,890928,Staff,30,0,30,0
1746569389587,RELI 149,A00,886806,Rahimi; Babak,23,0,40,17
1746569390614,SE 9,A01,886814,Staff,7,0,20,13
1746569391638,SE 101B,A01,886816,Chadha; Mayank,4,0,35,31
1746569392663,SE 110B,A00,886818,Zhu; Qiang,4,0,75,71
1746569393695,SE 125,A01,886830,Staff,10,0,30,20
1746569394724,SE 130B,A01,886835,Staff,14,0,40,26
1746569395755,SE 131A,A01,886838,Krysl; Petr,34,0,55,21
1746569396781,SE 154,A00,886840,Staff,29,0,50,21
1746569397805,SE 164GS,A01,886849,Staff,6,0,20,14
1746569398833,SE 167GS,A01,886853,Staff,6,0,20,14
1746569399858,SIO 25,A01,890107,Staff,19,0,30,11
1746569400925,SIO 45,A00,890109,Cook; Geoffrey W,117,0,200,83
1746569401952,SIO 109R,A00,890110,Forman; Fonna,0,16,20,20
1746569402981,SIO 187,A01,890114,Kacev; David,15,0,40,25
1746569404011,SOCI 1,A01,890431,Thorpe; Charles Robert,15,0,30,15
1746569404011,SOCI 1,A02,890518,Thorpe; Charles Robert,30,0,30,0
1746569405040,SOCI 2,A01,957978,Staff,25,0,25,0
1746569405040,SOCI 2,A02,957979,Staff,23,0,25,2
1746569406066,SOCI 20,A01,890523,Calderon-Zaks; Michael Aar,22,0,30,8
1746569406066,SOCI 20,A02,890526,Calderon-Zaks; Michael Aar,29,0,30,1
1746569407094,SOCI 30,A01,890533,Pardo Guerra; Juan Pablo,37,0,40,3
1746569408119,SOCI 40,A01,890535,Staff,27,0,45,18
1746569409144,SOCI 104Q,A00,890559,Staff,18,0,30,12
1746569410174,SOCI 106,A00,890560,Arnal; Maud Marie Leonie,20,0,30,10
1746569411200,SOCI 110,A00,890567,Holkenbrink-Monk; Charlene,19,0,30,11
1746569412231,SOCI 112,A00,890568,Victoria Torres; Pablo,2,0,55,53
1746569413258,SOCI 115,A00,890597,Arnal; Maud Marie Leonie,28,0,45,17
1746569415311,SOCI 121,A00,890604,Pardo Guerra; Juan Pablo,38,0,45,7
1746569416338,SOCI 126,A01,890608,Staff,8,0,10,2
1746569417368,SOCI 127,A00,890609,Staff,18,0,30,12
1746569418398,SOCI 131,A00,890610,Thorpe; Charles Robert,37,0,45,8
1746569419423,SOCI 135,A00,890615,Payne; Christine Anna,13,0,45,32
1746569420452,SOCI 139,A00,890620,Staff,38,0,45,7
1746569421476,SOCI 148E,A00,890622,Calderon-Zaks; Michael Aar,36,0,45,9
1746569422505,SOCI 150,A00,890623,Kohler; Kristopher M.,31,0,45,14
1746569423532,SOCI 157,A00,890625,Jules-Rosette; Bennetta W.,18,0,20,2
1746569424563,SOCI 160,A00,890627,Payne; Christine Anna,21,0,45,24
1746569425592,SYN 1,A00,886855,Fish; Gwendolyn Anne,0,0,0,0
1746569425592,SYN 1,B00,906086,Fish; Gwendolyn Anne,0,2,0,2
1746569426620,SYN 2R,A00,886860,Staff,0,17,15,15
1746569426620,SYN 2R,B00,906106,Atkinson; Arthur Laird,0,16,15,15
1746569428263,SYN 100,A01,886866,Browne; Emily,0,28,20,20
1746569428263,SYN 100,B01,906128,Rock; Martin,0,5,20,20
1746569428263,SYN 100,C01,906140,Deavenport; James Cary,0,3,20,20
1746569428263,SYN 100,D01,907816,Deavenport; James Cary,0,5,20,20
1746569429288,TDAC 1,A00,890286,Walsh; Kim C.,8,0,20,12
1746569430313,TDAC 101,A00,890296,Basso; Beatrice,15,0,20,5
1746569431341,TDDE 131,A00,890297,Staff,47,0,50,3
1746569432366,TDDM 1,A00,890287,Weinberg; Sadie,25,0,30,5
1746569433398,TDGE 11,A00,890288,Fulton; Julia,137,0,200,63
1746569433398,TDGE 11,B00,890289,Castro; Robert Jess,184,0,200,16
1746569434423,TDGE 25,B00,957359,Walsh; Kim C.,4,0,20,16
1746569435454,TDGE 40,A01,890292,Power; Jade Yukana,27,0,30,3
1746569436479,TDGE 124,A00,890298,Havis; Allan,0,1,50,50
1746569437507,TDGE 131R,A00,890299,Burelle; Julie Sara Veronique,15,0,42,27
1746569438535,TDHT 101,A00,890300,Staff,10,0,20,10
1746569439561,TDHT 109,A01,890302,Anderson; Mysia Anyse,31,0,40,9
1746569440586,TDMV 1,A00,890293,Arcidiacono; Kristin,18,0,30,12
1746569441615,TDMV 2,A00,890294,Weinberg; Sadie,23,0,30,7
1746569442642,TDMV 3,A00,957878,Arcidiacono; Kristin,28,0,30,2
1746569444694,TDMV 138,A00,890304,Jun; Grace Shin Hae,25,0,40,15
1746569445721,TDMV 140,A00,890305,Corrales; Joseph Bernales,25,0,30,5
1746569446752,TDMV 142,A00,890307,Caligagan; Tony,32,0,40,8
1746569447777,TDMV 144,A00,890308,Camaya; Michelle Ann,25,0,30,5
1746569448803,TDPW 1,A00,890295,Stein; Deborah Isobel,3,0,20,17
1746569449830,USP 2,A01,890272,Lerner; Amy M,6,0,20,14
1746569450859,USP 3,A01,890274,Staff,12,0,30,18
1746569451885,USP 15,A01,890276,Sun; Feiyang,16,0,30,14
1746569452912,USP 25,A00,890277,Shenkman; Michael Thomas,19,0,25,6
1746569453938,USP 138,A00,890278,Staff,14,0,25,11
1746569454967,USP 143,A00,890279,Staff,22,0,70,48
1746569455996,USP 144,A00,890280,Chowdhury; Muhammed Zohir,16,0,30,14
1746569457023,USP 150,A00,890281,Boomhower; Matthew Charles,4,0,30,26
1746569458052,USP 151,A00,890282,Staff,16,0,20,4
1746569459081,USP 162,A00,890283,Andrews; Abigail Leslie,16,0,20,4
1746569460108,USP 168,A00,920477,Kwak; Nancy,0,0,5,5
1746569461176,USP 181,A00,890284,Staff,3,0,20,17
1746569462212,USP 191A,A00,890285,Staff,12,0,20,8
1746569463238,VIS 101,A00,886512,Staff,26,0,75,49
1746569464267,VIS 103,A00,886513,Cruz; Edwin Teddy,61,0,75,14
1746569465296,VIS 108,A00,886514,Staff,3,0,15,12
1746569466321,VIS 127P,A00,886515,Shen; Kuiyi,80,0,146,66
1746569467349,VIS 149,A00,886516,Yoldas; Pinar,0,0,15,15
1746569468376,VIS 164,A00,886526,Erdmann; Dean,19,0,22,3
1746569469401,VIS 194S,A00,886527,Staff,61,0,75,14
1746569470431,WCWP 10A,C00,886484,Martiniuk; Jill,12,0,15,3
1746569471460,WCWP 10B,A00,886490,Uriarte; Emma,0,0,15,15
1746569471460,WCWP 10B,B00,886491,Dhir; Simrita,10,0,15,5
1746569471460,WCWP 10B,C00,886492,Ornelas; Tricia,0,0,15,15
1746569472491,WCWP 100,A00,886494,Young; Mark T,0,6,15,15
1746569474593,AAS 10,A01,886199,Childs; Dennis R.,0,3,0,0
1746569475621,ANAR 104,A01,886940,Shtienberg; Gilad,27,0,30,3
1746569476650,ANAR 120,A00,886953,Staff,12,0,20,8
1746569477675,ANBI 148,A01,886955,Wilder; Linnea Lorene,30,0,40,10
1746569479726,ANSC 122,A00,886957,Staff,25,0,30,5
1746569480751,ANSC 150,A00,886958,Sloane; Julia Kathryn,2,0,15,13
1746569481779,ANSC 156,A00,886959,Jenkins; Janis A.,0,1,15,15
1746569482804,ANSC 180,A00,886960,Staff,11,0,17,6
1746569483833,ANSC 188,A00,886961,Jassal; Aftab,9,0,25,16
1746569484861,ANSC 190,A00,886962,Jassal; Aftab,14,0,25,11
1746569485885,ANSC 191,A00,886963,Staff,18,0,20,2
1746569486912,ANTH 3,A01,891689,Staff,17,0,20,3
1746569487940,ANTH 5,A00,886933,Semendeferi; Ekaterini,16,0,20,4
1746569488972,ANTH 10,A00,886934,Staff,0,12,30,30
1746569489996,ANTH 21,A01,886936,Staff,41,0,60,19
1746569491022,ANTH 23,A01,886938,Staff,92,0,100,8
1746569492049,ANTH 105,A00,886964,Stewart; Alexander B,84,0,100,16
1746569493078,ANTH 108,A00,886965,Pedersen; David,9,0,20,11
1746569494109,AWP 10,001,886147,Staff,0,0,0,0
1746569494109,AWP 10,002,886148,Staff,0,0,0,0
1746569494109,AWP 10,003,886149,Staff,0,0,0,0
1746569494109,AWP 10,004,886150,Staff,0,0,0,0
1746569494109,AWP 10,005,886151,Staff,0,0,0,0
1746569494109,AWP 10,006,886152,Staff,0,0,0,0
1746569494109,AWP 10,007,886153,Staff,0,0,0,0
1746569494109,AWP 10,008,886154,Staff,0,0,0,0
1746569494109,AWP 10,009,886155,Staff,0,0,0,0
1746569494109,AWP 10,010,886156,Staff,0,0,0,0
1746569494109,AWP 10,011,886158,Staff,0,0,0,0
1746569494109,AWP 10,012,886160,Staff,0,0,0,0
1746569494109,AWP 10,013,886161,Staff,0,0,0,0
1746569494109,AWP 10,014,886162,Staff,0,0,0,0
1746569494109,AWP 10,015,886163,Staff,0,0,0,0
1746569494109,AWP 10,016,886164,Staff,0,0,0,0
1746569494109,AWP 10,017,886165,Staff,0,0,0,0
1746569494109,AWP 10,018,886166,Staff,0,0,0,0
1746569494109,AWP 10,019,886168,Staff,0,0,0,0
1746569494109,AWP 10,020,886170,Staff,0,0,0,0
1746569494109,AWP 10,021,886172,Staff,0,0,0,0
1746569495135,AWP 10R,001,886173,Staff,0,1,0,0
1746569495135,AWP 10R,002,886174,Staff,0,1,0,0
1746569495135,AWP 10R,003,886175,Staff,0,0,0,0
1746569495135,AWP 10R,004,886176,Staff,0,0,0,0
1746569495135,AWP 10R,005,886177,Staff,0,0,0,0
1746569495135,AWP 10R,006,886178,Staff,0,0,0,0
1746569495135,AWP 10R,007,886179,Staff,0,0,0,0
1746569495135,AWP 10R,008,886181,Staff,0,0,0,0
1746569495135,AWP 10R,009,886182,Staff,0,0,0,0
1746569495135,AWP 10R,010,886183,Staff,0,0,0,0
1746569495135,AWP 10R,011,886184,Staff,0,0,0,0
1746569495135,AWP 10R,012,886185,Staff,0,0,0,0
1746569495135,AWP 10R,013,886186,Staff,0,0,0,0
1746569495135,AWP 10R,014,886187,Staff,0,0,0,0
1746569495135,AWP 10R,015,886188,Staff,0,0,0,0
1746569495135,AWP 10R,016,886189,Staff,0,0,0,0
1746569495135,AWP 10R,017,960532,Staff,0,0,0,0
1746569495135,AWP 10R,018,960533,Staff,0,0,0,0
1746569495135,AWP 10R,019,960534,Staff,0,0,0,0
1746569495135,AWP 10R,020,960538,Staff,0,0,0,0
1746569495135,AWP 10R,021,960540,Staff,0,0,0,0
1746569495135,AWP 10R,022,960541,Staff,0,0,0,0
1746569495135,AWP 10R,023,960542,Staff,0,0,0,0
1746569495135,AWP 10R,024,960544,Staff,0,0,0,0
1746569495135,AWP 10R,025,960545,Staff,0,0,0,0
1746569495135,AWP 10R,026,960548,Staff,0,0,0,0
1746569496163,AWP 102R,A00,886190,Staff,0,0,0,0
1746569496163,AWP 102R,B00,886191,Staff,0,0,0,0
1746569497189,BENG 100,A01,886193,Staff,17,0,30,13
1746569498219,BENG 122A,A01,886195,Hasty; Jeff M,13,0,30,17
1746569499250,BENG 166A,A00,886196,Sah; Robert Lie-Yuan,0,2,30,30
1746569500278,BENG 190,A00,958050,Khojah; Reem I,20,0,25,5
1746569501306,BIBC 102,A01,894320,Staff,0,0,46,46
1746569501306,BIBC 102,A02,894321,Staff,0,0,46,46
1746569501306,BIBC 102,A03,894344,Staff,7,0,46,39
1746569501306,BIBC 102,A04,894345,Staff,27,0,47,20
1746569502335,BICD 100R,A01,894365,Smith; Laurie,0,3,58,58
1746569502335,BICD 100R,A02,894366,Smith; Laurie,0,5,58,58
1746569502335,BICD 100R,A03,894367,Smith; Laurie,0,0,59,59
1746569502335,BICD 100R,A04,959869,Smith; Laurie,40,0,59,19
1746569503362,BICD 136,A01,894383,Gustafson-Brown; Cindy,14,0,50,36
1746569504387,BIEB 102,A01,894494,Butler; Shannon Rhey,51,0,130,79
1746569506441,BIEB 150,A01,894617,Wills; Christopher,3,0,20,17
1746569506441,BIEB 150,A02,894631,Wills; Christopher,3,0,20,17
1746569506441,BIEB 150,A03,894937,Wills; Christopher,3,0,20,17
1746569506441,BIEB 150,A04,894946,Wills; Christopher,5,0,20,15
1746569507466,BIEB 194,A00,906141,Kurle; Carolyn M.,6,0,20,14
1746569508492,BILD 1,A01,894154,Staff,3,0,19,16
1746569508492,BILD 1,A02,894155,Staff,14,0,19,5
1746569508492,BILD 1,A03,894160,Staff,13,0,19,6
1746569508492,BILD 1,A04,894161,Staff,15,0,18,3
1746569509521,BILD 2,A01,894168,Staff,0,0,50,50
1746569509521,BILD 2,A02,894169,Staff,0,0,50,50
1746569509521,BILD 2,A03,894179,Staff,0,0,50,50
1746569509521,BILD 2,A04,894203,Staff,24,0,50,26
1746569510550,BILD 3,A01,894213,Staff,22,0,31,9
1746569510550,BILD 3,A02,894214,Staff,26,0,31,5
1746569510550,BILD 3,A03,894235,Staff,28,0,31,3
1746569510550,BILD 3,A04,894236,Staff,28,0,32,4
1746569511586,BILD 4,A01,894253,Reuther; Keefe,6,0,24,18
1746569511586,BILD 4,A02,894258,Reuther; Keefe,16,0,24,8
1746569512618,BILD 5,A01,894276,Reuther; Keefe,35,0,50,15
1746569512618,BILD 5,A02,894277,Reuther; Keefe,45,0,50,5
1746569512618,BILD 5,A03,894290,Reuther; Keefe,44,0,50,6
1746569512618,BILD 5,A04,894291,Reuther; Keefe,48,0,50,2
1746569513645,BILD 24,A01,894297,Pirino; Giorgia,40,0,60,20
1746569514671,BIMM 100,B01,958915,Staff,71,0,100,29
1746569515701,BIMM 101,A01,895017,McDonnell; Lisa Marie,0,5,24,24
1746569515701,BIMM 101,A02,895018,McDonnell; Lisa Marie,0,5,24,24
1746569515701,BIMM 101,B01,895020,McDonnell; Lisa Marie,0,6,24,24
1746569515701,BIMM 101,B02,895021,McDonnell; Lisa Marie,0,4,24,24
1746569516729,BIMM 110,A01,895023,Staff,1,0,25,24
1746569516729,BIMM 110,A02,895024,Staff,9,0,25,16
1746569516729,BIMM 110,A03,895025,Staff,18,0,25,7
1746569516729,BIMM 110,A04,895031,Staff,20,0,25,5
1746569517758,BIMM 120,A01,895114,Gustafson-Brown; Cindy,14,0,28,14
1746569517758,BIMM 120,A02,895126,Gustafson-Brown; Cindy,21,0,27,6
1746569518782,BIPN 100,A01,895130,Yang; Mingyu,0,0,38,38
1746569518782,BIPN 100,A02,895131,Yang; Mingyu,32,0,38,6
1746569518782,BIPN 100,A03,895132,Yang; Mingyu,32,0,38,6
1746569518782,BIPN 100,A04,895133,Yang; Mingyu,27,0,36,9
1746569519808,BIPN 120,A01,895135,Cooke; James Edward,0,3,13,13
1746569519808,BIPN 120,A02,895136,Cooke; James Edward,0,1,13,13
1746569519808,BIPN 120,A03,895137,Cooke; James Edward,0,3,13,13
1746569519808,BIPN 120,A04,895156,Cooke; James Edward,0,2,11,11
1746569520838,BIPN 134,A01,895235,Cooke; James Edward,0,2,25,25
1746569520838,BIPN 134,A02,895237,Cooke; James Edward,0,0,25,25
1746569520838,BIPN 134,A03,895240,Cooke; James Edward,3,0,25,22
1746569520838,BIPN 134,A04,895270,Cooke; James Edward,20,0,25,5
1746569521866,BIPN 189,A00,892103,Staff,0,14,14,14
1746569523915,BISP 194,A00,958008,Staff,0,2,0,0
1746569524941,CAT 124,A01,922009,Staff,0,5,20,20
1746569525970,CAT 125R,A00,886390,Morales; Celeste Georgianna,0,2,20,20
1746569525970,CAT 125R,B00,886391,Irwin; Matthew Joseph,0,4,20,20
1746569525970,CAT 125R,C00,886392,Smith; Lauryn Alissa,0,2,20,20
1746569525970,CAT 125R,D00,886393,Vanderschuit; Maya Alysia,0,3,20,20
1746569525970,CAT 125R,E00,886394,Marchisotto; Jennifer Anne,0,3,20,20
1746569526997,CENG 15,A01,886218,Drews; Aaron,3,0,8,5
1746569528022,CENG 113,A00,886219,Opatkiewicz; Justin Paul,15,0,25,10
1746569529046,CGS 101,A00,887044,Staff,7,0,20,13
1746569530072,CGS 105,A01,887046,Staff,14,0,25,11
1746569531100,CGS 112,A00,887047,Cuong; Marisol,12,0,15,3
1746569532125,CGS 113,A00,887048,Staff,23,0,30,7
1746569533149,CGS 120,A00,887049,Staff,10,0,17,7
1746569534175,CHEM 6A,A01,886336,Lam; Tin Yiu,38,0,50,12
1746569534175,CHEM 6A,A02,886338,Lam; Tin Yiu,37,0,50,13
1746569535202,CHEM 6B,A01,886341,Hopkins; Patrycja Anna,16,0,50,34
1746569535202,CHEM 6B,A02,886343,Hopkins; Patrycja Anna,42,0,50,8
1746569536228,CHEM 6C,A01,886346,Albizati; Kim F.,0,2,50,50
1746569536228,CHEM 6C,A02,886348,Albizati; Kim F.,23,0,50,27
1746569537253,CHEM 40A,A01,886352,Klosterman; Jeremy K,65,0,100,35
1746569538279,CHEM 40B,A01,886356,Klosterman; Jeremy K,0,23,100,100
1746569539305,CHEM 41B,A01,886360,Theodorakis; Emmanuel,25,0,50,25
1746569539305,CHEM 41B,A02,886362,Theodorakis; Emmanuel,47,0,50,3
1746569540333,CHIN 165A,A00,886382,Xu; Li,18,0,20,2
1746569541361,CLAS 120,A00,886387,Myerston Santana; Jacobo,33,0,40,7
1746569542401,COGS 9,A01,886967,Shannon; Kyle Michael,42,0,60,18
1746569543427,COGS 11,A01,886969,Staff,10,0,30,20
1746569544452,COGS 14A,A01,886971,Staff,6,0,60,54
1746569545480,COGS 14B,A01,886973,Hoffman; Drew Ellen,4,0,60,56
1746569546510,COGS 18,A01,886975,Morgan; Eric,35,0,60,25
1746569547538,COGS 20,A01,886977,Staff,4,0,8,4
1746569547538,COGS 20,A02,886978,Staff,5,0,7,2
1746569548564,COGS 100,A01,907783,Staff,1,2,30,29
1746569549592,COGS 101B,A01,886980,Staff,0,3,48,48
1746569550617,COGS 101C,A01,886982,Delgado; Tania,0,5,44,44
1746569551645,COGS 102A,A01,886984,Johnson; Christine M.,4,0,30,26
1746569552673,COGS 118B,A01,886986,Staff,1,3,88,87
1746569553701,COGS 150,A01,886988,Bergen; Benjamin,22,0,50,28
1746569554726,COGS 153,A00,886989,Delgado; Tania,0,2,41,41
1746569555752,COGS 186,A01,886991,Staff,0,0,32,32
1746569556781,COGS 187A,A01,886993,Boyle; Mary E. T.,7,0,30,23
1746569557808,COGS 189,A00,886994,Staff,0,1,30,30
1746569558833,COMM 10,A01,886996,Staff,0,0,20,21
1746569558833,COMM 10,A02,886997,Staff,12,0,20,8
1746569558833,COMM 10,A03,959845,Staff,19,0,20,1
1746569559860,COMM 20,A01,886999,Leuning; Grant Maurstad,24,0,40,16
1746569561912,COMM 100A,A01,887002,Staff,0,0,20,25
1746569561912,COMM 100A,A02,887003,Staff,6,0,20,14
1746569562938,COMM 100B,A01,887005,Staff,0,8,20,24
1746569563961,COMM 106D,A00,887006,Staff,13,0,40,27
1746569564988,COMM 110G,A00,887007,Whitworth-Smith; Andrew C,12,0,40,28
1746569566012,COMM 111B,A00,887008,Staff,31,0,40,9
1746569567039,COMM 113T,A00,887009,Abuelhiga; Soraya Jill,28,0,40,12
1746569567039,COMM 113T,B00,906733,Staff,40,0,40,0
1746569568064,COMM 145,A00,887010,Staff,12,0,40,28
1746569569089,COMM 146,A00,887054,Staff,31,0,40,9
1746569570123,COMM 190,A00,887012,Staff,8,0,23,15
1746569571148,CSE 8A,A50,887015,Cao; Yingjun,57,0,85,28
1746569572173,CSE 11,A01,887017,Cao; Yingjun,12,0,70,58
1746569573200,CSE 20,A01,887019,Staff,30,0,50,20
1746569574228,CSE 21,A01,887021,Staff,78,0,100,22
1746569574228,CSE 21,B01,892583,Braun; Oliver,45,0,50,5
1746569575253,CSE 30,A01,887025,Eldon; John,143,0,200,57
1746569576278,CSE 100,A01,887027,Staff,26,0,50,24
1746569576278,CSE 100,A02,887028,Staff,42,0,50,8
1746569577303,CSE 101,A01,887030,Braun; Oliver,74,0,100,26
1746569577303,CSE 101,B01,887032,Jones; Miles E,0,3,50,50
1746569577303,CSE 101,B02,887033,Jones; Miles E,0,2,50,50
1746569578328,CSE 105,A01,908084,Jones; Miles E,32,0,50,18
1746569578328,CSE 105,A02,908087,Jones; Miles E,31,0,50,19
1746569579356,CSE 135,A01,887035,Powell; Thomas Allan,0,5,50,50
1746569580383,CSE 142,A01,887037,Staff,8,0,60,52
1746569581406,CSE 142L,A01,887039,Staff,34,0,60,26
1746569582447,CSE 151A,A01,887041,Solares; Edwin A,47,0,100,53
1746569583474,CSE 175,A01,887043,Kumar; Rakesh,30,0,30,0
1746569584498,CSS 1,A01,886389,Staff,1,1,40,39
1746569585524,DSC 30,A01,908097,Liao; Soohyun Nam,47,0,75,28
1746569586552,DSC 40A,A01,908099,Shannon; Kyle Michael,30,0,50,20
1746569587578,DSC 40B,A01,908112,Staff,15,0,50,35
1746569588604,DSC 80,A01,908116,Staff,19,0,60,41
1746569589629,DSC 197,001,956863,Eldridge; Justin Matthew,9999,0,9999,0
1746569590656,ECE 5,A01,886400,Morris; Karcher William,1,0,6,5
1746569590656,ECE 5,A02,886401,Morris; Karcher William,3,0,6,3
1746569591681,ECE 148,A01,886403,Silberman; Jack,0,14,14,14
1746569592707,ECON 1,A01,887265,Crane; Meredith Helen,12,0,70,58
1746569592707,ECON 1,B01,887268,Staff,43,0,50,7
1746569593737,ECON 2,A01,887273,Crane; Meredith Helen,55,0,70,15
1746569594793,ECON 3,A01,887279,Rondina; Giacomo,32,0,70,38
1746569595818,ECON 4,A01,887282,Anderson; John Charles,0,2,10,10
1746569596847,ECON 5,A01,887285,Staff,34,0,45,11
1746569596847,ECON 5,B01,887292,Staff,41,0,45,4
1746569597873,ECON 100A,A01,887337,Newhouse; Herbert S,54,0,70,16
1746569597873,ECON 100A,B01,887349,Staff,45,0,50,5
1746569598898,ECON 100B,A01,887361,Du; Songzi,29,0,70,41
1746569599924,ECON 100C,A01,887445,Newhouse; Herbert S,59,0,70,11
1746569600952,ECON 105,A00,887488,Vespa; Emanuel Ignacio,23,0,35,12
1746569601976,ECON 109,A01,887506,Shishkin; Denis,28,0,35,7
1746569603006,ECON 110A,A01,887568,Alon; Titan Michael,0,3,35,35
1746569603006,ECON 110A,B01,907601,Alon; Titan Michael,20,0,35,15
1746569604032,ECON 110B,A01,887598,Levkoff; Steven B.,0,24,70,70
1746569605057,ECON 112,A00,887599,Rondina; Giacomo,19,0,35,16
1746569606081,ECON 120A,A01,887603,Dai; Yinlin,35,0,70,35
1746569607107,ECON 120C,A01,887608,Sun; Yixiao,0,1,35,35
1746569607107,ECON 120C,B01,887614,Sun; Yixiao,0,0,35,35
1746569608131,ECON 138,A00,887621,Bharadwaj; Prashant,0,21,20,20
1746569609157,ECON 144,A00,958007,Squires; Dale E,12,0,35,23
1746569610186,ECON 171,A01,907666,Staff,18,0,35,17
1746569611211,ECON 175,A00,887626,Wu; Pak Yeung,22,0,35,13
1746569612239,ECON 190,A00,887640,Vespa; Emanuel Ignacio,22,0,35,13
1746569613271,EDS 25,A01,888197,Staff,0,0,0,0
1746569613271,EDS 25,A02,888209,Staff,0,0,0,0
1746569613271,EDS 25,A03,888210,Staff,0,0,0,0
1746569613271,EDS 25,A04,888212,Staff,0,0,0,0
1746569613271,EDS 25,A05,888213,Staff,0,0,0,0
1746569613271,EDS 25,A06,888214,Staff,0,0,0,0
1746569613271,EDS 25,A07,888235,Staff,0,2,0,0
1746569613271,EDS 25,A08,888236,Staff,0,0,0,0
1746569613271,EDS 25,A09,888240,Staff,0,0,0,0
1746569613271,EDS 25,A10,888244,Staff,0,0,0,0
1746569613271,EDS 25,B01,888273,Staff,0,0,0,0
1746569613271,EDS 25,B02,888285,Staff,0,0,0,0
1746569613271,EDS 25,B03,888423,Staff,0,0,0,1
1746569613271,EDS 25,B04,888432,Staff,0,0,0,0
1746569613271,EDS 25,B05,888433,Staff,0,0,0,0
1746569613271,EDS 25,B06,888467,Staff,0,0,0,0
1746569613271,EDS 25,B07,888468,Staff,0,0,0,0
1746569613271,EDS 25,B08,888479,Staff,0,0,0,0
1746569613271,EDS 25,B09,888484,Staff,0,0,0,0
1746569613271,EDS 25,B10,888487,Staff,0,0,0,0
1746569614297,EDS 38,A01,907700,Choi; Bailey Miyeon,30,0,30,0
1746569615324,EDS 112,A01,888601,Chapman; Thandeka K,12,0,40,28
1746569616358,EDS 115,A00,888697,Mendez; Kathrina Mendoza,10,0,30,20
1746569617381,EDS 116,A01,888893,Staff,34,0,40,6
1746569619435,EDS 124AR,A00,889133,Staff,29,0,50,21
1746569619435,EDS 124AR,B00,907471,Simon; Elizabeth A,37,0,50,13
1746569620461,EDS 124BR,A00,889134,Simon; Elizabeth A,44,0,100,56
1746569621489,EDS 125,A00,889135,Staff,25,0,30,5
1746569622519,EDS 126,A01,889138,Staff,36,0,40,4
1746569623545,EDS 164R,A01,889142,Wishard Guerra; Alison G.,33,0,50,17
1746569624573,ENG 30,A01,886396,Staff,0,0,0,0
1746569624573,ENG 30,B01,886398,Staff,0,0,0,0
1746569625599,ENVR 102,A00,906150,Montejo; Carolina,23,0,25,2
1746569626628,ETHN 103A,A00,887236,Man; Simeon S,0,3,0,0
1746569627654,ETHN 113,A00,887239,Staff,16,0,30,14
1746569628683,ETHN 116,A00,887240,Staff,16,0,25,9
1746569629711,ETHN 117,A00,887241,Choi; Esther Min,28,0,30,2
1746569630735,ETHN 118,A00,887243,Staff,24,0,30,6
1746569631759,ETHN 127,A00,887248,Cuong; Marisol,11,0,15,4
1746569632783,ETHN 139,A00,887250,Staff,7,0,10,3
1746569633811,ETHN 142,A00,887252,Staff,10,0,30,20
1746569634835,ETHN 161,A00,887253,Browne; Errol Tsekani,24,0,30,6
1746569635861,ETHN 163FR,A00,887255,Burelle; Julie Sara Veronique,0,0,5,5
1746569636886,GLBH 20,A00,889149,Elwardani; Nile Regina,8,0,42,34
1746569638936,GLBH 111,A01,889152,Burgos; Jose L.,17,0,17,0
1746569639970,GLBH 150,A00,889181,Sloane; Julia Kathryn,0,5,15,15
1746569642022,HDS 60,A01,886406,Warstadt; Melissa Fawn,73,0,80,7
1746569643045,HIAF 111,A00,889324,Gyamfi; Bright,25,0,32,7
1746569644073,HIEA 131,A00,889328,Staff,15,0,32,17
1746569645103,HIEA 144,A00,889333,Henry; Todd A.,26,0,32,6
1746569646133,HIEA 154,A00,889336,Henry; Todd A.,24,0,32,8
1746569647157,HIEU 106,A00,889339,Staff,22,0,32,10
1746569649221,HIEU 114,A00,889340,Staff,4,0,32,28
1746569650246,HIEU 135GS,A00,889342,Patterson; Patrick H.,0,0,1,24
1746569651289,HIEU 137,A00,889343,Edington; Claire Ellen,10,0,25,15
1746569652315,HIEU 148,A00,889345,Staff,14,0,32,18
1746569653340,HIEU 154,A00,889346,Biess; Frank Peter,21,0,32,11
1746569654367,HILA 102,A00,889351,Staff,12,0,32,20
1746569655398,HILD 2A,A01,889221,Lewandoski; Julia Mavis,1,10,32,31
1746569656426,HILD 7B,A01,889225,Man; Simeon S,0,12,32,32
1746569657451,HILD 7C,A01,889288,Alvarez; Luis A,0,14,32,32
1746569658478,HILD 30,A01,889323,Staff,0,5,32,32
1746569660533,HISC 119,A00,889383,Golan; Tal,19,0,32,13
1746569661558,HIUS 103,A00,889384,Man; Simeon S,0,0,32,32
1746569662585,HIUS 117,A00,919797,Kwak; Nancy,19,0,32,13
1746569663611,HIUS 142A,A00,919788,Staff,22,0,32,10
1746569665666,HIUS 149,A00,889386,Gyamfi; Bright,26,0,32,6
1746569666693,HIUS 155,A00,889387,Alvarez; Luis A,15,0,32,17
1746569667719,HUM 3,A01,886499,Caldwell; Michael Alan,19,0,50,31
1746569668745,HUM 3GS,A00,886500,Rodriguez; Bretton Sigfred,0,0,0,28
1746569669774,HUM 3R,A01,886502,Markman; Kristina,0,36,50,50
1746569670803,HUM 4,A01,886504,Crum; Matthew Stephen,24,0,50,26
1746569670803,HUM 4,B01,886506,West; Geoffrey Scott,17,0,50,33
1746569671831,HUM 4GS,A00,886507,Staff,0,0,0,19
1746569672857,HUM 5,A01,886509,Staff,32,0,50,18
1746569673886,HUM 5R,A01,886511,Zavodny; Tatiana Sophia,0,39,50,50
1746569674910,JAPN 180,A00,886407,Staff,16,0,40,24
1746569675935,LATI 50,A01,886409,Martin-Cabrera; Luis,4,0,22,18
1746569675935,LATI 50,A02,886410,Martin-Cabrera; Luis,19,0,22,3
1746569675935,LATI 50,A03,886411,Martin-Cabrera; Luis,21,0,22,1
1746569675935,LATI 50,A04,886412,Martin-Cabrera; Luis,9,0,22,13
1746569676964,LAWS 101,A00,907664,Staff,28,0,60,32
1746569677988,LIAB 1A,A00,889388,Saab; Dima,17,0,20,3
1746569679013,LIAB 1AX,A00,889389,El Cheddadi; Youniss,18,0,20,2
1746569680043,LIFR 1C,A00,889391,Van Moer; Vinciane G,8,0,20,12
1746569681085,LIFR 1CX,A00,889392,Van Moer; Vinciane G,7,0,20,13
1746569682112,LIFR 1D,A00,889393,Van Moer; Vinciane G,7,0,20,13
1746569683196,LIFR 1DX,A00,889394,Van Moer; Vinciane G,8,0,20,12
1746569684220,LIGN 7,A00,886923,Staff,24,0,50,26
1746569685246,LIGN 17,A00,886924,Kehler; Andrew Scott,125,0,150,25
1746569686276,LTAM 110,A00,889395,Staff,15,0,30,15
1746569687302,LTAM 110GS,A00,958010,Rodriguez; Bretton Sigfred,0,0,0,28
1746569688328,LTCH 101,A00,889397,Staff,23,0,25,2
1746569689355,LTCS 130,A00,889398,Staff,23,0,25,2
1746569690385,LTEA 138,A00,889399,Staff,24,0,40,16
1746569691414,LTEN 149,A00,889400,Wesling; Megan E.,0,3,25,25
1746569692439,LTEN 169,A00,889401,Staff,20,0,25,5
1746569693467,LTEN 180,A00,889402,Staff,10,0,15,5
1746569694492,LTEN 181,A00,889403,Staff,21,0,25,4
1746569695517,LTWL 100,A00,889404,Myerston Santana; Jacobo,2,0,25,23
1746569696545,LTWL 180GS,A00,889405,Staff,0,0,20,20
1746569697573,LTWL 181,A00,889406,Staff,16,0,25,9
1746569698597,LTWL 184,A00,889475,Mukherjee; Silpa,22,0,25,3
1746569699626,LTWR 102C,A00,889486,Staff,29,0,30,1
1746569700649,LTWR 115W,A00,889491,Staff,0,2,15,15
1746569701680,MAE 8,A01,886905,Staff,0,2,0,0
1746569702704,MAE 11,A00,886906,Bandaru; Prabhakar,0,7,50,50
1746569703732,MAE 20,A00,886907,Evdokimenko; Ekaterina,43,0,70,27
1746569704757,MAE 30B,A00,886909,Ghazinejad; Maziar,26,0,45,19
1746569705787,MAE 101B,A00,886910,Saintillan; David,29,0,45,16
1746569706819,MAE 105,A00,886911,Bandaru; Prabhakar,18,0,50,32
1746569707845,MAE 107,B00,958024,Staff,8,0,50,42
1746569708874,MAE 143B,A00,886913,Bewley; Thomas R,6,0,40,34
1746569709900,MAE 148,A01,886915,Silberman; Jack,0,3,14,14
1746569710931,MAE 160,A00,886916,Evdokimenko; Ekaterina,31,0,60,29
1746569711957,MATH 3C,A01,889681,Staff,0,2,30,30
1746569711957,MATH 3C,A02,960048,Staff,24,0,30,6
1746569712981,MATH 10A,A01,889760,Staff,26,0,30,4
1746569712981,MATH 10A,A02,889783,Staff,29,0,30,1
1746569714009,MATH 10B,A01,889785,Verstraete; Jacques Allan,2,0,35,33
1746569714009,MATH 10B,A02,889795,Verstraete; Jacques Allan,4,0,35,31
1746569714009,MATH 10B,B01,889797,Verstraete; Jacques Allan,3,0,35,32
1746569714009,MATH 10B,B02,889828,Verstraete; Jacques Allan,3,0,35,32
1746569715036,MATH 10C,A01,889849,Habib; Yousaf,7,0,30,23
1746569715036,MATH 10C,A02,889852,Habib; Yousaf,14,0,30,16
1746569715036,MATH 10C,A03,889853,Habib; Yousaf,22,0,30,8
1746569715036,MATH 10C,A04,889858,Habib; Yousaf,20,0,30,10
1746569715036,MATH 10C,B01,889861,Staff,1,0,30,29
1746569715036,MATH 10C,B02,889862,Staff,24,0,30,6
1746569715036,MATH 10C,B03,889863,Staff,27,0,30,3
1746569715036,MATH 10C,B04,889967,Staff,23,0,30,7
1746569716067,MATH 18,A01,889974,Staff,7,0,30,23
1746569716067,MATH 18,A02,889977,Staff,20,0,30,10
1746569716067,MATH 18,B01,889984,Hardiman; Liam,21,0,30,9
1746569716067,MATH 18,B02,889985,Hardiman; Liam,25,0,30,5
1746569717092,MATH 20A,A01,889990,Suk; Andrew Hoon,30,0,35,5
1746569718118,MATH 20B,A01,889993,Ohm; Ko Woon,22,0,30,8
1746569718118,MATH 20B,A02,889994,Ohm; Ko Woon,30,0,30,0
1746569718118,MATH 20B,B01,889996,Ohm; Ko Woon,22,0,30,8
1746569718118,MATH 20B,B02,889997,Ohm; Ko Woon,23,0,30,7
1746569719143,MATH 20C,A01,889999,Hammock; Frances H,17,0,30,13
1746569719143,MATH 20C,A02,890003,Hammock; Frances H,23,0,30,7
1746569719143,MATH 20C,B01,890006,Hammock; Frances H,3,0,30,27
1746569719143,MATH 20C,B02,890007,Hammock; Frances H,12,0,30,18
1746569720168,MATH 20D,A01,890011,Cheng; Hsiao-Bing,1,1,30,29
1746569720168,MATH 20D,A02,890012,Cheng; Hsiao-Bing,14,0,30,16
1746569720168,MATH 20D,B01,890016,Cheng; Hsiao-Bing,13,0,30,17
1746569720168,MATH 20D,B02,890017,Cheng; Hsiao-Bing,13,0,30,17
1746569721194,MATH 20E,A01,890026,Harel; Guershon,1,0,30,29
1746569721194,MATH 20E,A02,890029,Harel; Guershon,23,0,30,7
1746569721194,MATH 20E,B01,890033,Harel; Guershon,7,0,30,23
1746569721194,MATH 20E,B02,890101,Harel; Guershon,21,0,30,9
1746569722223,MATH 102,A01,890104,Staff,17,0,30,13
1746569722223,MATH 102,A02,890105,Staff,27,0,30,3
1746569723247,MATH 103B,A01,890116,Salehi Golsefidy; Alireza,3,0,30,27
1746569723247,MATH 103B,B01,890118,Staff,0,3,34,34
1746569724275,MATH 109,A01,890121,Aliabadi Sr.; Mohsen,1,0,30,29
1746569724275,MATH 109,B01,890124,Upadrashta; Pranav Kumar,18,0,30,12
1746569725302,MATH 120A,A01,890126,Eggers; John Dietrich,13,0,30,17
1746569726328,MATH 142B,A01,890128,Ioana; Adrian,19,0,30,11
1746569726328,MATH 142B,A02,890129,Ioana; Adrian,13,0,30,17
1746569727353,MATH 154,A01,890174,Staff,0,0,30,30
1746569727353,MATH 154,A02,890182,Staff,0,0,30,30
1746569728380,MATH 168A,A01,890197,Dumitriu; Ioana,21,0,35,14
1746569729409,MATH 170A,A01,890240,Nie; Jiawang,1,0,30,29
1746569729409,MATH 170A,A02,890241,Nie; Jiawang,11,0,30,19
1746569729409,MATH 170A,A03,890249,Nie; Jiawang,23,0,30,7
1746569730433,MATH 170B,A01,957891,Nag; Panchali,13,0,35,22
1746569732486,MATH 181A,A01,908025,Staff,0,4,35,35
1746569732486,MATH 181A,A02,960115,Staff,27,0,35,8
1746569733511,MATH 181B,A01,959874,Staff,25,0,30,5
1746569734536,MATH 193B,A01,890265,Staff,0,4,35,35
1746569735559,MGT 4,A01,890311,Anderson; John Charles,42,0,88,46
1746569736589,MGT 5,A00,907740,Staff,13,0,98,85
1746569737615,MGT 12,A00,890312,Lindenberger; Wade Douglas,67,0,98,31
1746569738639,MGT 16,A00,957883,Staff,78,0,98,20
1746569740693,MGT 45,A00,890314,Pecore; Joseph P.,46,0,98,52
1746569741720,MGT 71,A00,890315,Staff,0,11,98,98
1746569742746,MGT 100,A00,890316,Yavorsky; Daniel Ryan,44,0,98,54
1746569743772,MGT 103,A00,890317,Ehrich; Kristine R,73,0,98,25
1746569744800,MGT 105,A00,890356,Bates; Kenneth Walter,0,8,98,98
1746569745830,MGT 112,A00,890360,Ehrich; Kristine R,55,0,98,43
1746569746854,MGT 127R,A00,907732,Zhu; Kevin Xiaoguo,23,0,98,75
1746569747879,MGT 131B,A00,890361,Anderson; John Charles,60,0,98,38
1746569748904,MGT 137,A00,890362,Lindenberger; Wade Douglas,65,0,98,33
1746569749931,MGT 160,A00,890369,Johnson; Erik Barry,9,0,98,89
1746569751987,MGT 164,A00,890372,Zimmermann; Carsten,0,40,98,98
1746569753012,MGT 180,A00,890374,Bliss; Barbara Ann,12,0,98,86
1746569754039,MMW 15,A01,886414,Chang; Edmond Yi-Teh,0,12,28,28
1746569754039,MMW 15,A02,886415,Chang; Edmond Yi-Teh,0,8,28,28
1746569754039,MMW 15,A03,886416,Chang; Edmond Yi-Teh,0,8,28,28
1746569754039,MMW 15,A04,886417,Chang; Edmond Yi-Teh,0,8,28,28
1746569754039,MMW 15,B01,886419,Chang; Edmond Yi-Teh,0,7,28,28
1746569754039,MMW 15,B02,886420,Chang; Edmond Yi-Teh,0,8,28,28
1746569754039,MMW 15,B03,886421,Chang; Edmond Yi-Teh,0,7,28,28
1746569754039,MMW 15,B04,886422,Chang; Edmond Yi-Teh,0,8,28,28
1746569754039,MMW 15,C01,886424,Staff,0,9,28,28
1746569754039,MMW 15,C02,886425,Staff,0,8,28,28
1746569754039,MMW 15,C03,886426,Staff,0,8,28,28
1746569754039,MMW 15,C04,886427,Staff,0,8,28,28
1746569754039,MMW 15,C05,958038,Staff,0,8,28,28
1746569754039,MMW 15,C06,958039,Staff,1,8,28,27
1746569755064,MMW 15GS,A00,906910,Patterson; Patrick H.,4,0,28,24
1746569756094,MMW 122R,A01,886429,Rahimi; Babak,0,13,28,28
1746569756094,MMW 122R,A02,886430,Rahimi; Babak,0,12,28,28
1746569756094,MMW 122R,A03,958040,Rahimi; Babak,0,11,28,28
1746569757120,MUS 1A,A01,890937,Staff,2,0,25,23
1746569757120,MUS 1A,A02,891035,Staff,6,0,25,19
1746569757120,MUS 1A,C01,958912,Staff,24,0,25,1
1746569757120,MUS 1A,C02,958913,Staff,25,0,25,0
1746569759197,MUS 2AK,A00,957092,Ohnishi; Takae,15,0,15,0
1746569760228,MUS 4,A01,891044,Staff,2,0,25,23
1746569760228,MUS 4,A02,891045,Staff,23,0,25,2
1746569760228,MUS 4,B01,891048,Staff,17,0,25,8
1746569760228,MUS 4,B02,891050,Staff,25,0,25,0
1746569761257,MUS 5,A01,957506,Dubnov; Shlomo,0,0,25,25
1746569761257,MUS 5,A02,957622,Dubnov; Shlomo,13,0,25,12
1746569761257,MUS 5,A03,957623,Dubnov; Shlomo,20,0,25,5
1746569762288,MUS 6,A01,891053,Freitas Caetano; Marcelo,24,0,25,1
1746569762288,MUS 6,A02,891054,Freitas Caetano; Marcelo,23,0,25,2
1746569763314,MUS 7,A01,891081,Staff,0,0,25,25
1746569763314,MUS 7,A02,891082,Staff,3,0,25,22
1746569764339,MUS 8GS,A00,891118,Borgo; David Garcia,1,0,25,24
1746569765364,MUS 11,A01,891140,Staff,9,0,25,16
1746569765364,MUS 11,A02,891141,Staff,22,0,25,3
1746569766390,MUS 13,A01,891143,Staff,8,0,25,17
1746569766390,MUS 13,A02,891144,Staff,24,0,25,1
1746569767414,MUS 15,A01,891146,Staff,9,0,25,16
1746569767414,MUS 15,A02,891148,Staff,21,0,25,4
1746569767414,MUS 15,B01,891150,Staff,18,0,25,7
1746569767414,MUS 15,B02,891151,Staff,25,0,25,0
1746569768440,MUS 20,A01,891153,Staff,5,0,20,15
1746569768440,MUS 20,A02,891155,Staff,14,0,20,6
1746569769465,MUS 80,A00,891156,Staff,19,0,25,6
1746569769465,MUS 80,B00,891157,Staff,23,0,25,2
1746569770489,MUS 130,A00,891158,Ohnishi; Takae,35,0,35,0
1746569771519,MUS 150GS,A01,891160,Borgo; David Garcia,1,0,25,24
1746569772544,MUS 170,A01,891162,Freitas Caetano; Marcelo,20,0,25,5
1746569772544,MUS 170,A02,891164,Freitas Caetano; Marcelo,21,0,25,4
1746569773576,NANO 11,A00,886220,Vazquez Mena; Oscar,13,0,15,2
1746569774606,NANO 15,A01,886222,Drews; Aaron,4,0,7,3
1746569775633,NANO 104,A00,886224,Sirbuly; Donald,17,0,25,8
1746569776658,PH 40,A00,886528,Staff,23,0,40,17
1746569777683,PH 45,A01,886799,Staff,35,0,40,5
1746569778710,PH 110,A00,886802,Staff,0,7,40,40
1746569779738,PH 172,A00,906716,Staff,19,0,35,16
1746569780762,PH 191,A00,886803,Staff,6,0,40,34
1746569781787,PHIL 1,A00,889500,Staff,20,0,30,10
1746569782812,PHIL 10,A01,889549,Grush; Rick Scott,15,0,22,7
1746569782812,PHIL 10,A02,889551,Grush; Rick Scott,22,0,22,0
1746569783840,PHIL 28,A01,889559,Lamey; Andy M.,0,2,31,31
1746569783840,PHIL 28,A02,889561,Lamey; Andy M.,0,1,30,30
1746569783840,PHIL 28,A03,889572,Lamey; Andy M.,0,1,30,30
1746569784868,PHIL 35,A00,907839,Staff,13,0,15,2
1746569785895,PHIL 60,A00,889574,Staff,73,0,90,17
1746569786923,PHIL 101,A00,958004,Staff,12,0,15,3
1746569788972,PHIL 136,A00,889582,Fulkerson; Matthew Todd,26,0,45,19
1746569790000,PHIL 163,A01,889601,Staff,21,0,30,9
1746569790000,PHIL 163,B01,889606,Brandt; Reuven A,0,3,0,0
1746569791026,PHIL 164,A00,889610,Staff,16,0,30,14
1746569792054,PHIL 165,A00,889613,Staff,22,0,30,8
1746569793082,PHYS 1A,A00,886431,Staff,26,0,70,44
1746569794107,PHYS 1AL,001,886432,Tsai; Philbert S,0,2,30,30
1746569794107,PHYS 1AL,002,886436,Tsai; Philbert S,11,0,30,19
1746569795132,PHYS 1B,A00,886439,Staff,185,0,240,55
1746569796158,PHYS 1BL,001,886441,Tsai; Philbert S,0,4,30,30
1746569796158,PHYS 1BL,002,886444,Tsai; Philbert S,2,0,30,28
1746569797188,PHYS 1C,A00,896092,Arnold; Kam S,78,0,146,68
1746569798213,PHYS 1CL,001,886448,Tsai; Philbert S,0,0,30,30
1746569798213,PHYS 1CL,002,886449,Tsai; Philbert S,1,0,30,29
1746569798213,PHYS 1CL,003,886450,Tsai; Philbert S,16,0,30,14
1746569798213,PHYS 1CL,004,886451,Tsai; Philbert S,15,0,30,15
1746569799242,PHYS 2B,A01,886457,Staff,68,0,115,47
1746569800271,PHYS 2C,A01,886460,Shotwell; Brian,0,9,65,65
1746569801302,PHYS 2CL,A01,886467,Staff,0,4,28,28
1746569801302,PHYS 2CL,A02,886468,Staff,0,3,28,28
1746569802328,PHYS 2D,A01,886470,Staff,10,0,50,40
1746569803353,PHYS 4B,A01,886475,Grinstein; Benjamin,22,0,40,18
1746569804379,POLI 5,A00,891173,Desposato; Scott,7,0,25,18
1746569805406,POLI 5D,A01,891175,Staff,5,0,5,0
1746569805406,POLI 5D,B01,891178,Staff,5,0,5,0
1746569806438,POLI 11,A00,891179,Ferree; Karen E,2,0,35,33
1746569807466,POLI 12,A00,891180,Staff,16,0,30,14
1746569808494,POLI 27,A01,891182,Staff,12,0,75,63
1746569809518,POLI 30,A00,891183,Staff,8,0,50,42
1746569810543,POLI 100B,A00,891244,Staff,5,1,35,30
1746569811569,POLI 100I,A00,891247,Staff,7,0,30,23
1746569812597,POLI 104J,A00,891248,Nichter; Maysa,14,0,30,16
1746569813624,POLI 104U,A00,891250,Nichter; Maysa,2,0,30,28
1746569815681,POLI 110B,A00,891255,Wiens; David,20,0,25,5
1746569816710,POLI 112A,A00,891256,Wiens; David,6,0,25,19
1746569817739,POLI 114BR,A00,891261,Staff,19,0,30,11
1746569818766,POLI 117R,A00,891262,Forman; Fonna,0,6,50,50
1746569819793,POLI 118,A00,891264,Ingham; Sean,17,0,25,8
1746569820817,POLI 124A,A00,891265,Staff,18,0,20,2
1746569821845,POLI 125D,A00,891266,Nichter; Simeon C,2,0,25,23
1746569822870,POLI 126,A00,891268,Nichter; Simeon C,7,0,25,18
1746569823900,POLI 126AA,A00,891272,Staff,16,0,25,9
1746569824929,POLI 130AA,A00,891273,Staff,15,0,20,5
1746569825965,POLI 134AA,A00,891274,Staff,4,0,20,16
1746569828018,POLI 138,A00,891278,Staff,21,0,25,4
1746569829044,POLI 142K,A00,891280,Staff,10,0,25,15
1746569830073,POLI 142M,A00,891281,Gartzke; Erik,16,0,30,14
1746569831098,POLI 142P,A00,891284,Staff,20,0,30,10
1746569832123,POLI 143,A00,891285,Gartzke; Erik,12,0,30,18
1746569833152,POLI 153,A00,891286,Staff,19,0,20,1
1746569835203,POLI 175,A00,891290,Staff,15,0,20,5
1746569836233,PSYC 1,A00,890674,Steiner; Eric Tomas,0,11,45,45
1746569837264,PSYC 2,A00,890676,Albright; Thomas D,21,0,35,14
1746569838289,PSYC 3,A00,890679,Staff,17,0,20,3
1746569839313,PSYC 6,A00,959858,Staff,20,0,20,0
1746569840339,PSYC 60,A01,890684,Rickard; Timothy C.,0,5,45,45
1746569841368,PSYC 70,A01,890689,Geller; Emma Harlan,7,0,30,23
1746569842410,PSYC 71,A01,959860,Staff,21,0,25,4
1746569843436,PSYC 100,A00,890690,Lacefield; Katharine I,0,50,180,180
1746569844460,PSYC 102,A00,890695,Staff,18,0,40,22
1746569845488,PSYC 105,A00,890699,Geller; Emma Harlan,70,0,100,30
1746569846519,PSYC 106,A00,890701,Gorman; Michael R.,6,0,30,24
1746569847544,PSYC 108,A00,890704,Adrian; Julia Anna,0,28,50,50
1746569848573,PSYC 118,A01,890712,Staff,11,0,30,19
1746569849604,PSYC 124,A00,890716,Chapman; Eddie Nathaniel,25,0,60,35
1746569850628,PSYC 131,A00,890717,Anagnostaras; Stephan,0,8,80,80
1746569851652,PSYC 137,A00,890719,Winkielman; Piotr,0,11,30,30
1746569852677,PSYC 144,A00,890721,Adrian; Julia Anna,0,9,45,45
1746569853702,PSYC 162,A00,890805,Staff,0,0,75,75
1746569854727,PSYC 169,A00,890810,Staff,0,14,30,30
1746569855757,PSYC 172,A00,890814,Gorman; Michael R.,9,0,30,21
1746569856786,PSYC 181,A00,890818,Anagnostaras; Stephan,9,0,200,191
1746569857815,PSYC 184,A00,959861,Staff,168,0,175,7
1746569858838,PSYC 189,A00,890823,Staff,0,2,30,30
1746569859863,PSYC 191,A00,890884,Rickard; Timothy C.,0,12,35,35
1746569860894,PSYC 193,A00,890913,Staff,19,0,30,11
1746569860894,PSYC 193,B00,890914,Chapman; Eddie Nathaniel,24,0,30,6
1746569861925,PSYC 193L,A01,890918,Lowe; Angela Beth,20,0,30,10
1746569861925,PSYC 193L,B01,890921,Hurwitz; Ethan Scott,20,0,30,10
1746569861925,PSYC 193L,C01,890928,Staff,30,0,30,0
1746569862948,RELI 149,A00,886806,Rahimi; Babak,23,0,40,17
1746569863981,SE 9,A01,886814,Staff,7,0,20,13
1746569865009,SE 101B,A01,886816,Chadha; Mayank,4,0,35,31
1746569866033,SE 110B,A00,886818,Zhu; Qiang,4,0,75,71
1746569867062,SE 125,A01,886830,Staff,10,0,30,20
1746569868092,SE 130B,A01,886835,Staff,14,0,40,26
1746569869119,SE 131A,A01,886838,Krysl; Petr,34,0,55,21
1746569870145,SE 154,A00,886840,Staff,29,0,50,21
1746569871169,SE 164GS,A01,886849,Staff,6,0,20,14
1746569872195,SE 167GS,A01,886853,Staff,6,0,20,14
1746569873222,SIO 25,A01,890107,Staff,19,0,30,11
1746569874250,SIO 45,A00,890109,Cook; Geoffrey W,117,0,200,83
1746569875281,SIO 109R,A00,890110,Forman; Fonna,0,16,20,20
1746569876308,SIO 187,A01,890114,Kacev; David,15,0,40,25
1746569877336,SOCI 1,A01,890431,Thorpe; Charles Robert,15,0,30,15
1746569877336,SOCI 1,A02,890518,Thorpe; Charles Robert,30,0,30,0
1746569878359,SOCI 2,A01,957978,Staff,25,0,25,0
1746569878359,SOCI 2,A02,957979,Staff,23,0,25,2
1746569879385,SOCI 20,A01,890523,Calderon-Zaks; Michael Aar,22,0,30,8
1746569879385,SOCI 20,A02,890526,Calderon-Zaks; Michael Aar,29,0,30,1
1746569880414,SOCI 30,A01,890533,Pardo Guerra; Juan Pablo,37,0,40,3
1746569881441,SOCI 40,A01,890535,Staff,27,0,45,18
1746569882470,SOCI 104Q,A00,890559,Staff,18,0,30,12
1746569883498,SOCI 106,A00,890560,Arnal; Maud Marie Leonie,20,0,30,10
1746569884527,SOCI 110,A00,890567,Holkenbrink-Monk; Charlene,19,0,30,11
1746569885557,SOCI 112,A00,890568,Victoria Torres; Pablo,2,0,55,53
1746569886584,SOCI 115,A00,890597,Arnal; Maud Marie Leonie,28,0,45,17
1746569888640,SOCI 121,A00,890604,Pardo Guerra; Juan Pablo,38,0,45,7
1746569889669,SOCI 126,A01,890608,Staff,8,0,10,2
1746569890695,SOCI 127,A00,890609,Staff,18,0,30,12
1746569891719,SOCI 131,A00,890610,Thorpe; Charles Robert,37,0,45,8
1746569892745,SOCI 135,A00,890615,Payne; Christine Anna,13,0,45,32
1746569893776,SOCI 139,A00,890620,Staff,38,0,45,7
1746569894800,SOCI 148E,A00,890622,Calderon-Zaks; Michael Aar,36,0,45,9
1746569895830,SOCI 150,A00,890623,Kohler; Kristopher M.,31,0,45,14
1746569896860,SOCI 157,A00,890625,Jules-Rosette; Bennetta W.,18,0,20,2
1746569897888,SOCI 160,A00,890627,Payne; Christine Anna,21,0,45,24
1746569898938,SYN 1,A00,886855,Fish; Gwendolyn Anne,0,0,0,0
1746569898938,SYN 1,B00,906086,Fish; Gwendolyn Anne,0,2,0,2
1746569899965,SYN 2R,A00,886860,Staff,0,17,15,15
1746569899965,SYN 2R,B00,906106,Atkinson; Arthur Laird,0,16,15,15
1746569900998,SYN 100,A01,886866,Browne; Emily,0,28,20,20
1746569900998,SYN 100,B01,906128,Rock; Martin,0,5,20,20
1746569900998,SYN 100,C01,906140,Deavenport; James Cary,0,3,20,20
1746569900998,SYN 100,D01,907816,Deavenport; James Cary,0,5,20,20
1746569902024,TDAC 1,A00,890286,Walsh; Kim C.,8,0,20,12
1746569903050,TDAC 101,A00,890296,Basso; Beatrice,15,0,20,5
1746569904075,TDDE 131,A00,890297,Staff,47,0,50,3
1746569905104,TDDM 1,A00,890287,Weinberg; Sadie,25,0,30,5
1746569906130,TDGE 11,A00,890288,Fulton; Julia,137,0,200,63
1746569906130,TDGE 11,B00,890289,Castro; Robert Jess,184,0,200,16
1746569907157,TDGE 25,B00,957359,Walsh; Kim C.,4,0,20,16
1746569908187,TDGE 40,A01,890292,Power; Jade Yukana,27,0,30,3
1746569909215,TDGE 124,A00,890298,Havis; Allan,0,1,50,50
1746569910245,TDGE 131R,A00,890299,Burelle; Julie Sara Veronique,15,0,42,27
1746569911271,TDHT 101,A00,890300,Staff,10,0,20,10
1746569912296,TDHT 109,A01,890302,Anderson; Mysia Anyse,31,0,40,9
1746569913321,TDMV 1,A00,890293,Arcidiacono; Kristin,18,0,30,12
1746569914345,TDMV 2,A00,890294,Weinberg; Sadie,23,0,30,7
1746569915371,TDMV 3,A00,957878,Arcidiacono; Kristin,28,0,30,2
1746569917422,TDMV 138,A00,890304,Jun; Grace Shin Hae,25,0,40,15
1746569918447,TDMV 140,A00,890305,Corrales; Joseph Bernales,25,0,30,5
1746569919472,TDMV 142,A00,890307,Caligagan; Tony,32,0,40,8
1746569920496,TDMV 144,A00,890308,Camaya; Michelle Ann,25,0,30,5
1746569921537,TDPW 1,A00,890295,Stein; Deborah Isobel,3,0,20,17
1746569922564,USP 2,A01,890272,Lerner; Amy M,6,0,20,14
1746569923591,USP 3,A01,890274,Staff,12,0,30,18
1746569924617,USP 15,A01,890276,Sun; Feiyang,16,0,30,14
1746569925643,USP 25,A00,890277,Shenkman; Michael Thomas,19,0,25,6
1746569926669,USP 138,A00,890278,Staff,14,0,25,11
1746569927697,USP 143,A00,890279,Staff,22,0,70,48
1746569928726,USP 144,A00,890280,Chowdhury; Muhammed Zohir,16,0,30,14
1746569929752,USP 150,A00,890281,Boomhower; Matthew Charles,4,0,30,26
1746569930781,USP 151,A00,890282,Staff,16,0,20,4
1746569931805,USP 162,A00,890283,Andrews; Abigail Leslie,16,0,20,4
1746569932829,USP 168,A00,920477,Kwak; Nancy,0,0,5,5
1746569933868,USP 181,A00,890284,Staff,3,0,20,17
1746569934897,USP 191A,A00,890285,Staff,12,0,20,8
1746569935923,VIS 101,A00,886512,Staff,26,0,75,49
1746569936947,VIS 103,A00,886513,Cruz; Edwin Teddy,61,0,75,14
1746569937972,VIS 108,A00,886514,Staff,3,0,15,12
1746569939006,VIS 127P,A00,886515,Shen; Kuiyi,80,0,146,66
1746569940032,VIS 149,A00,886516,Yoldas; Pinar,0,0,15,15
1746569941056,VIS 164,A00,886526,Erdmann; Dean,19,0,22,3
1746569942083,VIS 194S,A00,886527,Staff,61,0,75,14
1746569943112,WCWP 10A,C00,886484,Martiniuk; Jill,12,0,15,3
1746569944145,WCWP 10B,A00,886490,Uriarte; Emma,0,0,15,15
1746569944145,WCWP 10B,B00,886491,Dhir; Simrita,10,0,15,5
1746569944145,WCWP 10B,C00,886492,Ornelas; Tricia,0,0,15,15
1746569945170,WCWP 100,A00,886494,Young; Mark T,0,6,15,15
1746569947292,AAS 10,A01,886199,Childs; Dennis R.,0,3,0,0
1746569948319,ANAR 104,A01,886940,Shtienberg; Gilad,27,0,30,3
1746569949347,ANAR 120,A00,886953,Staff,12,0,20,8
1746569950373,ANBI 148,A01,886955,Wilder; Linnea Lorene,30,0,40,10
1746569952424,ANSC 122,A00,886957,Staff,25,0,30,5
1746569953450,ANSC 150,A00,886958,Sloane; Julia Kathryn,2,0,15,13
1746569954475,ANSC 156,A00,886959,Jenkins; Janis A.,0,1,15,15
1746569955503,ANSC 180,A00,886960,Staff,11,0,17,6
1746569956527,ANSC 188,A00,886961,Jassal; Aftab,9,0,25,16
1746569957552,ANSC 190,A00,886962,Jassal; Aftab,14,0,25,11
1746569958579,ANSC 191,A00,886963,Staff,18,0,20,2
1746569959605,ANTH 3,A01,891689,Staff,17,0,20,3
1746569960630,ANTH 5,A00,886933,Semendeferi; Ekaterini,16,0,20,4
1746569961658,ANTH 10,A00,886934,Staff,0,12,30,30
1746569962681,ANTH 21,A01,886936,Staff,41,0,60,19
1746569963706,ANTH 23,A01,886938,Staff,92,0,100,8
1746569964734,ANTH 105,A00,886964,Stewart; Alexander B,84,0,100,16
1746569965759,ANTH 108,A00,886965,Pedersen; David,9,0,20,11
1746569966785,AWP 10,001,886147,Staff,0,0,0,0
1746569966785,AWP 10,002,886148,Staff,0,0,0,0
1746569966785,AWP 10,003,886149,Staff,0,0,0,0
1746569966785,AWP 10,004,886150,Staff,0,0,0,0
1746569966785,AWP 10,005,886151,Staff,0,0,0,0
1746569966785,AWP 10,006,886152,Staff,0,0,0,0
1746569966785,AWP 10,007,886153,Staff,0,0,0,0
1746569966785,AWP 10,008,886154,Staff,0,0,0,0
1746569966785,AWP 10,009,886155,Staff,0,0,0,0
1746569966785,AWP 10,010,886156,Staff,0,0,0,0
1746569966785,AWP 10,011,886158,Staff,0,0,0,0
1746569966785,AWP 10,012,886160,Staff,0,0,0,0
1746569966785,AWP 10,013,886161,Staff,0,0,0,0
1746569966785,AWP 10,014,886162,Staff,0,0,0,0
1746569966785,AWP 10,015,886163,Staff,0,0,0,0
1746569966785,AWP 10,016,886164,Staff,0,0,0,0
1746569966785,AWP 10,017,886165,Staff,0,0,0,0
1746569966785,AWP 10,018,886166,Staff,0,0,0,0
1746569966785,AWP 10,019,886168,Staff,0,0,0,0
1746569966785,AWP 10,020,886170,Staff,0,0,0,0
1746569966785,AWP 10,021,886172,Staff,0,0,0,0
1746569967828,AWP 10R,001,886173,Staff,0,1,0,0
1746569967828,AWP 10R,002,886174,Staff,0,1,0,0
1746569967828,AWP 10R,003,886175,Staff,0,0,0,0
1746569967828,AWP 10R,004,886176,Staff,0,0,0,0
1746569967828,AWP 10R,005,886177,Staff,0,0,0,0
1746569967828,AWP 10R,006,886178,Staff,0,0,0,0
1746569967828,AWP 10R,007,886179,Staff,0,0,0,0
1746569967828,AWP 10R,008,886181,Staff,0,0,0,0
1746569967828,AWP 10R,009,886182,Staff,0,0,0,0
1746569967828,AWP 10R,010,886183,Staff,0,0,0,0
1746569967828,AWP 10R,011,886184,Staff,0,0,0,0
1746569967828,AWP 10R,012,886185,Staff,0,0,0,0
1746569967828,AWP 10R,013,886186,Staff,0,0,0,0
1746569967828,AWP 10R,014,886187,Staff,0,0,0,0
1746569967828,AWP 10R,015,886188,Staff,0,0,0,0
1746569967828,AWP 10R,016,886189,Staff,0,0,0,0
1746569967828,AWP 10R,017,960532,Staff,0,0,0,0
1746569967828,AWP 10R,018,960533,Staff,0,0,0,0
1746569967828,AWP 10R,019,960534,Staff,0,0,0,0
1746569967828,AWP 10R,020,960538,Staff,0,0,0,0
1746569967828,AWP 10R,021,960540,Staff,0,0,0,0
1746569967828,AWP 10R,022,960541,Staff,0,0,0,0
1746569967828,AWP 10R,023,960542,Staff,0,0,0,0
1746569967828,AWP 10R,024,960544,Staff,0,0,0,0
1746569967828,AWP 10R,025,960545,Staff,0,0,0,0
1746569967828,AWP 10R,026,960548,Staff,0,0,0,0
1746569968855,AWP 102R,A00,886190,Staff,0,0,0,0
1746569968855,AWP 102R,B00,886191,Staff,0,0,0,0
1746569969879,BENG 100,A01,886193,Staff,17,0,30,13
1746569970904,BENG 122A,A01,886195,Hasty; Jeff M,13,0,30,17
1746569971929,BENG 166A,A00,886196,Sah; Robert Lie-Yuan,0,2,30,30
1746569972953,BENG 190,A00,958050,Khojah; Reem I,20,0,25,5
1746569973979,BIBC 102,A01,894320,Staff,0,0,46,46
1746569973979,BIBC 102,A02,894321,Staff,0,0,46,46
1746569973979,BIBC 102,A03,894344,Staff,7,0,46,39
1746569973979,BIBC 102,A04,894345,Staff,27,0,47,20
1746569975007,BICD 100R,A01,894365,Smith; Laurie,0,3,58,58
1746569975007,BICD 100R,A02,894366,Smith; Laurie,0,5,58,58
1746569975007,BICD 100R,A03,894367,Smith; Laurie,0,0,59,59
1746569975007,BICD 100R,A04,959869,Smith; Laurie,40,0,59,19
1746569976034,BICD 136,A01,894383,Gustafson-Brown; Cindy,14,0,50,36
1746569977063,BIEB 102,A01,894494,Butler; Shannon Rhey,51,0,130,79
1746569979121,BIEB 150,A01,894617,Wills; Christopher,3,0,20,17
1746569979121,BIEB 150,A02,894631,Wills; Christopher,3,0,20,17
1746569979121,BIEB 150,A03,894937,Wills; Christopher,3,0,20,17
1746569979121,BIEB 150,A04,894946,Wills; Christopher,5,0,20,15
1746569980147,BIEB 194,A00,906141,Kurle; Carolyn M.,6,0,20,14
1746569981173,BILD 1,A01,894154,Staff,3,0,19,16
1746569981173,BILD 1,A02,894155,Staff,14,0,19,5
1746569981173,BILD 1,A03,894160,Staff,13,0,19,6
1746569981173,BILD 1,A04,894161,Staff,15,0,18,3
1746569982197,BILD 2,A01,894168,Staff,0,0,50,50
1746569982197,BILD 2,A02,894169,Staff,0,0,50,50
1746569982197,BILD 2,A03,894179,Staff,0,0,50,50
1746569982197,BILD 2,A04,894203,Staff,24,0,50,26
1746569983222,BILD 3,A01,894213,Staff,22,0,31,9
1746569983222,BILD 3,A02,894214,Staff,26,0,31,5
1746569983222,BILD 3,A03,894235,Staff,28,0,31,3
1746569983222,BILD 3,A04,894236,Staff,28,0,32,4
1746569984248,BILD 4,A01,894253,Reuther; Keefe,6,0,24,18
1746569984248,BILD 4,A02,894258,Reuther; Keefe,16,0,24,8
1746569985282,BILD 5,A01,894276,Reuther; Keefe,35,0,50,15
1746569985282,BILD 5,A02,894277,Reuther; Keefe,45,0,50,5
1746569985282,BILD 5,A03,894290,Reuther; Keefe,44,0,50,6
1746569985282,BILD 5,A04,894291,Reuther; Keefe,48,0,50,2
1746569986311,BILD 24,A01,894297,Pirino; Giorgia,40,0,60,20
1746569987339,BIMM 100,B01,958915,Staff,71,0,100,29
1746569988363,BIMM 101,A01,895017,McDonnell; Lisa Marie,0,5,24,24
1746569988363,BIMM 101,A02,895018,McDonnell; Lisa Marie,0,5,24,24
1746569988363,BIMM 101,B01,895020,McDonnell; Lisa Marie,0,6,24,24
1746569988363,BIMM 101,B02,895021,McDonnell; Lisa Marie,0,4,24,24
1746569989391,BIMM 110,A01,895023,Staff,1,0,25,24
1746569989391,BIMM 110,A02,895024,Staff,9,0,25,16
1746569989391,BIMM 110,A03,895025,Staff,18,0,25,7
1746569989391,BIMM 110,A04,895031,Staff,20,0,25,5
1746569990416,BIMM 120,A01,895114,Gustafson-Brown; Cindy,14,0,28,14
1746569990416,BIMM 120,A02,895126,Gustafson-Brown; Cindy,21,0,27,6
1746569991441,BIPN 100,A01,895130,Yang; Mingyu,0,0,38,38
1746569991441,BIPN 100,A02,895131,Yang; Mingyu,32,0,38,6
1746569991441,BIPN 100,A03,895132,Yang; Mingyu,32,0,38,6
1746569991441,BIPN 100,A04,895133,Yang; Mingyu,27,0,36,9
1746569992471,BIPN 120,A01,895135,Cooke; James Edward,0,3,13,13
1746569992471,BIPN 120,A02,895136,Cooke; James Edward,0,1,13,13
1746569992471,BIPN 120,A03,895137,Cooke; James Edward,0,3,13,13
1746569992471,BIPN 120,A04,895156,Cooke; James Edward,0,2,11,11
1746569993496,BIPN 134,A01,895235,Cooke; James Edward,0,2,25,25
1746569993496,BIPN 134,A02,895237,Cooke; James Edward,0,0,25,25
1746569993496,BIPN 134,A03,895240,Cooke; James Edward,3,0,25,22
1746569993496,BIPN 134,A04,895270,Cooke; James Edward,20,0,25,5
1746569994522,BIPN 189,A00,892103,Staff,0,14,14,14
1746569996572,BISP 194,A00,958008,Staff,0,2,0,0
1746569997597,CAT 124,A01,922009,Staff,0,5,20,20
1746569998624,CAT 125R,A00,886390,Morales; Celeste Georgianna,0,2,20,20
1746569998624,CAT 125R,B00,886391,Irwin; Matthew Joseph,0,4,20,20
1746569998624,CAT 125R,C00,886392,Smith; Lauryn Alissa,0,2,20,20
1746569998624,CAT 125R,D00,886393,Vanderschuit; Maya Alysia,0,3,20,20
1746569998624,CAT 125R,E00,886394,Marchisotto; Jennifer Anne,0,3,20,20
1746569999652,CENG 15,A01,886218,Drews; Aaron,3,0,8,5
1746570000682,CENG 113,A00,886219,Opatkiewicz; Justin Paul,15,0,25,10
1746570001706,CGS 101,A00,887044,Staff,7,0,20,13
1746570002736,CGS 105,A01,887046,Staff,14,0,25,11
1746570003765,CGS 112,A00,887047,Cuong; Marisol,12,0,15,3
1746570004790,CGS 113,A00,887048,Staff,23,0,30,7
1746570005816,CGS 120,A00,887049,Staff,10,0,17,7
1746570006841,CHEM 6A,A01,886336,Lam; Tin Yiu,38,0,50,12
1746570006841,CHEM 6A,A02,886338,Lam; Tin Yiu,37,0,50,13
1746570007868,CHEM 6B,A01,886341,Hopkins; Patrycja Anna,16,0,50,34
1746570007868,CHEM 6B,A02,886343,Hopkins; Patrycja Anna,42,0,50,8
1746570008892,CHEM 6C,A01,886346,Albizati; Kim F.,0,2,50,50
1746570008892,CHEM 6C,A02,886348,Albizati; Kim F.,23,0,50,27
1746570009923,CHEM 40A,A01,886352,Klosterman; Jeremy K,65,0,100,35
1746570010950,CHEM 40B,A01,886356,Klosterman; Jeremy K,0,23,100,100
1746570011975,CHEM 41B,A01,886360,Theodorakis; Emmanuel,25,0,50,25
1746570011975,CHEM 41B,A02,886362,Theodorakis; Emmanuel,47,0,50,3
1746570013000,CHIN 165A,A00,886382,Xu; Li,18,0,20,2
1746570014029,CLAS 120,A00,886387,Myerston Santana; Jacobo,33,0,40,7
1746570015054,COGS 9,A01,886967,Shannon; Kyle Michael,42,0,60,18
1746570016082,COGS 11,A01,886969,Staff,10,0,30,20
1746570017110,COGS 14A,A01,886971,Staff,6,0,60,54
1746570018135,COGS 14B,A01,886973,Hoffman; Drew Ellen,4,0,60,56
1746570019163,COGS 18,A01,886975,Morgan; Eric,35,0,60,25
1746570020192,COGS 20,A01,886977,Staff,4,0,8,4
1746570020192,COGS 20,A02,886978,Staff,5,0,7,2
1746570021218,COGS 100,A01,907783,Staff,1,2,30,29
1746570022243,COGS 101B,A01,886980,Staff,0,3,48,48
1746570023269,COGS 101C,A01,886982,Delgado; Tania,0,5,44,44
1746570024298,COGS 102A,A01,886984,Johnson; Christine M.,4,0,30,26
1746570025332,COGS 118B,A01,886986,Staff,1,3,88,87
1746570026357,COGS 150,A01,886988,Bergen; Benjamin,22,0,50,28
1746570027381,COGS 153,A00,886989,Delgado; Tania,0,2,41,41
1746570028407,COGS 186,A01,886991,Staff,0,0,32,32
1746570029434,COGS 187A,A01,886993,Boyle; Mary E. T.,7,0,30,23
1746570030459,COGS 189,A00,886994,Staff,0,1,30,30
1746570031485,COMM 10,A01,886996,Staff,0,0,20,21
1746570031485,COMM 10,A02,886997,Staff,12,0,20,8
1746570031485,COMM 10,A03,959845,Staff,19,0,20,1
1746570032512,COMM 20,A01,886999,Leuning; Grant Maurstad,24,0,40,16
1746570034564,COMM 100A,A01,887002,Staff,0,0,20,25
1746570034564,COMM 100A,A02,887003,Staff,6,0,20,14
1746570035592,COMM 100B,A01,887005,Staff,0,8,20,24
1746570036620,COMM 106D,A00,887006,Staff,13,0,40,27
1746570037650,COMM 110G,A00,887007,Whitworth-Smith; Andrew C,12,0,40,28
1746570038677,COMM 111B,A00,887008,Staff,31,0,40,9
1746570039706,COMM 113T,A00,887009,Abuelhiga; Soraya Jill,28,0,40,12
1746570039706,COMM 113T,B00,906733,Staff,40,0,40,0
1746570040734,COMM 145,A00,887010,Staff,12,0,40,28
1746570041760,COMM 146,A00,887054,Staff,31,0,40,9
1746570042785,COMM 190,A00,887012,Staff,8,0,23,15
1746570043810,CSE 8A,A50,887015,Cao; Yingjun,57,0,85,28
1746570044835,CSE 11,A01,887017,Cao; Yingjun,12,0,70,58
1746570045862,CSE 20,A01,887019,Staff,30,0,50,20
1746570046889,CSE 21,A01,887021,Staff,78,0,100,22
1746570046889,CSE 21,B01,892583,Braun; Oliver,45,0,50,5
1746570047915,CSE 30,A01,887025,Eldon; John,143,0,200,57
1746570048943,CSE 100,A01,887027,Staff,26,0,50,24
1746570048943,CSE 100,A02,887028,Staff,42,0,50,8
1746570049969,CSE 101,A01,887030,Braun; Oliver,74,0,100,26
1746570049969,CSE 101,B01,887032,Jones; Miles E,0,3,50,50
1746570049969,CSE 101,B02,887033,Jones; Miles E,0,2,50,50
1746570050997,CSE 105,A01,908084,Jones; Miles E,32,0,50,18
1746570050997,CSE 105,A02,908087,Jones; Miles E,31,0,50,19
1746570052025,CSE 135,A01,887035,Powell; Thomas Allan,0,5,50,50
1746570053049,CSE 142,A01,887037,Staff,8,0,60,52
1746570054074,CSE 142L,A01,887039,Staff,34,0,60,26
1746570055101,CSE 151A,A01,887041,Solares; Edwin A,47,0,100,53
1746570056127,CSE 175,A01,887043,Kumar; Rakesh,30,0,30,0
1746570057152,CSS 1,A01,886389,Staff,1,1,40,39
1746570058182,DSC 30,A01,908097,Liao; Soohyun Nam,47,0,75,28
1746570059211,DSC 40A,A01,908099,Shannon; Kyle Michael,30,0,50,20
1746570060240,DSC 40B,A01,908112,Staff,15,0,50,35
1746570061270,DSC 80,A01,908116,Staff,19,0,60,41
1746570062297,DSC 197,001,956863,Eldridge; Justin Matthew,9999,0,9999,0
1746570063325,ECE 5,A01,886400,Morris; Karcher William,1,0,6,5
1746570063325,ECE 5,A02,886401,Morris; Karcher William,3,0,6,3
1746570064354,ECE 148,A01,886403,Silberman; Jack,0,14,14,14
1746570065385,ECON 1,A01,887265,Crane; Meredith Helen,12,0,70,58
1746570065385,ECON 1,B01,887268,Staff,43,0,50,7
1746570066410,ECON 2,A01,887273,Crane; Meredith Helen,55,0,70,15
1746570067437,ECON 3,A01,887279,Rondina; Giacomo,32,0,70,38
1746570068466,ECON 4,A01,887282,Anderson; John Charles,0,2,10,10
1746570069493,ECON 5,A01,887285,Staff,34,0,45,11
1746570069493,ECON 5,B01,887292,Staff,41,0,45,4
1746570070519,ECON 100A,A01,887337,Newhouse; Herbert S,54,0,70,16
1746570070519,ECON 100A,B01,887349,Staff,45,0,50,5
1746570071546,ECON 100B,A01,887361,Du; Songzi,29,0,70,41
1746570072571,ECON 100C,A01,887445,Newhouse; Herbert S,59,0,70,11
1746570073599,ECON 105,A00,887488,Vespa; Emanuel Ignacio,23,0,35,12
1746570074626,ECON 109,A01,887506,Shishkin; Denis,28,0,35,7
1746570075654,ECON 110A,A01,887568,Alon; Titan Michael,0,3,35,35
1746570075654,ECON 110A,B01,907601,Alon; Titan Michael,20,0,35,15
1746570076679,ECON 110B,A01,887598,Levkoff; Steven B.,0,24,70,70
1746570077704,ECON 112,A00,887599,Rondina; Giacomo,19,0,35,16
1746570078732,ECON 120A,A01,887603,Dai; Yinlin,35,0,70,35
1746570079760,ECON 120C,A01,887608,Sun; Yixiao,0,1,35,35
1746570079760,ECON 120C,B01,887614,Sun; Yixiao,0,0,35,35
1746570080785,ECON 138,A00,887621,Bharadwaj; Prashant,0,21,20,20
1746570081810,ECON 144,A00,958007,Squires; Dale E,12,0,35,23
1746570082838,ECON 171,A01,907666,Staff,18,0,35,17
1746570083863,ECON 175,A00,887626,Wu; Pak Yeung,22,0,35,13
1746570084887,ECON 190,A00,887640,Vespa; Emanuel Ignacio,22,0,35,13
1746570085914,EDS 25,A01,888197,Staff,0,0,0,0
1746570085914,EDS 25,A02,888209,Staff,0,0,0,0
1746570085914,EDS 25,A03,888210,Staff,0,0,0,0
1746570085914,EDS 25,A04,888212,Staff,0,0,0,0
1746570085914,EDS 25,A05,888213,Staff,0,0,0,0
1746570085914,EDS 25,A06,888214,Staff,0,0,0,0
1746570085914,EDS 25,A07,888235,Staff,0,2,0,0
1746570085914,EDS 25,A08,888236,Staff,0,0,0,0
1746570085914,EDS 25,A09,888240,Staff,0,0,0,0
1746570085914,EDS 25,A10,888244,Staff,0,0,0,0
1746570085914,EDS 25,B01,888273,Staff,0,0,0,0
1746570085914,EDS 25,B02,888285,Staff,0,0,0,0
1746570085914,EDS 25,B03,888423,Staff,0,0,0,1
1746570085914,EDS 25,B04,888432,Staff,0,0,0,0
1746570085914,EDS 25,B05,888433,Staff,0,0,0,0
1746570085914,EDS 25,B06,888467,Staff,0,0,0,0
1746570085914,EDS 25,B07,888468,Staff,0,0,0,0
1746570085914,EDS 25,B08,888479,Staff,0,0,0,0
1746570085914,EDS 25,B09,888484,Staff,0,0,0,0
1746570085914,EDS 25,B10,888487,Staff,0,0,0,0
1746570086938,EDS 38,A01,907700,Choi; Bailey Miyeon,30,0,30,0
1746570087966,EDS 112,A01,888601,Chapman; Thandeka K,12,0,40,28
1746570088991,EDS 115,A00,888697,Mendez; Kathrina Mendoza,10,0,30,20
1746570090019,EDS 116,A01,888893,Staff,34,0,40,6
1746570092071,EDS 124AR,A00,889133,Staff,29,0,50,21
1746570092071,EDS 124AR,B00,907471,Simon; Elizabeth A,37,0,50,13
1746570093100,EDS 124BR,A00,889134,Simon; Elizabeth A,44,0,100,56
1746570094126,EDS 125,A00,889135,Staff,25,0,30,5
1746570095152,EDS 126,A01,889138,Staff,35,0,40,5
1746570096179,EDS 164R,A01,889142,Wishard Guerra; Alison G.,33,0,50,17
1746570097210,ENG 30,A01,886396,Staff,0,0,0,0
1746570097210,ENG 30,B01,886398,Staff,0,0,0,0
1746570098237,ENVR 102,A00,906150,Montejo; Carolina,23,0,25,2
1746570099262,ETHN 103A,A00,887236,Man; Simeon S,0,3,0,0
1746570100290,ETHN 113,A00,887239,Staff,16,0,30,14
1746570101315,ETHN 116,A00,887240,Staff,16,0,25,9
1746570102340,ETHN 117,A00,887241,Choi; Esther Min,28,0,30,2
1746570103365,ETHN 118,A00,887243,Staff,24,0,30,6
1746570104390,ETHN 127,A00,887248,Cuong; Marisol,11,0,15,4
1746570105416,ETHN 139,A00,887250,Staff,7,0,10,3
1746570106441,ETHN 142,A00,887252,Staff,10,0,30,20
1746570107470,ETHN 161,A00,887253,Browne; Errol Tsekani,24,0,30,6
1746570108495,ETHN 163FR,A00,887255,Burelle; Julie Sara Veronique,0,0,5,5
1746570109523,GLBH 20,A00,889149,Elwardani; Nile Regina,8,0,42,34
1746570111577,GLBH 111,A01,889152,Burgos; Jose L.,17,0,17,0
1746570112603,GLBH 150,A00,889181,Sloane; Julia Kathryn,0,5,15,15
1746570114660,HDS 60,A01,886406,Warstadt; Melissa Fawn,73,0,80,7
1746570115689,HIAF 111,A00,889324,Gyamfi; Bright,25,0,32,7
1746570116715,HIEA 131,A00,889328,Staff,15,0,32,17
1746570117741,HIEA 144,A00,889333,Henry; Todd A.,26,0,32,6
1746570118769,HIEA 154,A00,889336,Henry; Todd A.,24,0,32,8
1746570119798,HIEU 106,A00,889339,Staff,22,0,32,10
1746570121849,HIEU 114,A00,889340,Staff,4,0,32,28
1746570122875,HIEU 135GS,A00,889342,Patterson; Patrick H.,0,0,1,24
1746570123898,HIEU 137,A00,889343,Edington; Claire Ellen,10,0,25,15
1746570124925,HIEU 148,A00,889345,Staff,14,0,32,18
1746570125952,HIEU 154,A00,889346,Biess; Frank Peter,21,0,32,11
1746570126978,HILA 102,A00,889351,Staff,12,0,32,20
1746570128006,HILD 2A,A01,889221,Lewandoski; Julia Mavis,1,10,32,31
1746570129032,HILD 7B,A01,889225,Man; Simeon S,0,12,32,32
1746570130056,HILD 7C,A01,889288,Alvarez; Luis A,0,14,32,32
1746570131084,HILD 30,A01,889323,Staff,0,5,32,32
1746570133137,HISC 119,A00,889383,Golan; Tal,19,0,32,13
1746570134165,HIUS 103,A00,889384,Man; Simeon S,0,0,32,32
1746570135190,HIUS 117,A00,919797,Kwak; Nancy,19,0,32,13
1746570136214,HIUS 142A,A00,919788,Staff,22,0,32,10
1746570138267,HIUS 149,A00,889386,Gyamfi; Bright,26,0,32,6
1746570139292,HIUS 155,A00,889387,Alvarez; Luis A,15,0,32,17
1746570140318,HUM 3,A01,886499,Caldwell; Michael Alan,19,0,50,31
1746570141343,HUM 3GS,A00,886500,Rodriguez; Bretton Sigfred,0,0,0,28
1746570142370,HUM 3R,A01,886502,Markman; Kristina,0,36,50,50
1746570143401,HUM 4,A01,886504,Crum; Matthew Stephen,24,0,50,26
1746570143401,HUM 4,B01,886506,West; Geoffrey Scott,17,0,50,33
1746570144429,HUM 4GS,A00,886507,Staff,0,0,0,19
1746570145453,HUM 5,A01,886509,Staff,32,0,50,18
1746570146482,HUM 5R,A01,886511,Zavodny; Tatiana Sophia,0,39,50,50
1746570147509,JAPN 180,A00,886407,Staff,16,0,40,24
1746570148538,LATI 50,A01,886409,Martin-Cabrera; Luis,4,0,22,18
1746570148538,LATI 50,A02,886410,Martin-Cabrera; Luis,19,0,22,3
1746570148538,LATI 50,A03,886411,Martin-Cabrera; Luis,21,0,22,1
1746570148538,LATI 50,A04,886412,Martin-Cabrera; Luis,9,0,22,13
1746570149568,LAWS 101,A00,907664,Staff,28,0,60,32
1746570150596,LIAB 1A,A00,889388,Saab; Dima,17,0,20,3
1746570151626,LIAB 1AX,A00,889389,El Cheddadi; Youniss,18,0,20,2
1746570152652,LIFR 1C,A00,889391,Van Moer; Vinciane G,8,0,20,12
1746570153681,LIFR 1CX,A00,889392,Van Moer; Vinciane G,7,0,20,13
1746570154705,LIFR 1D,A00,889393,Van Moer; Vinciane G,7,0,20,13
1746570155729,LIFR 1DX,A00,889394,Van Moer; Vinciane G,8,0,20,12
1746570156758,LIGN 7,A00,886923,Staff,24,0,50,26
1746570157783,LIGN 17,A00,886924,Kehler; Andrew Scott,125,0,150,25
1746570158813,LTAM 110,A00,889395,Staff,15,0,30,15
1746570159839,LTAM 110GS,A00,958010,Rodriguez; Bretton Sigfred,0,0,0,28
1746570160867,LTCH 101,A00,889397,Staff,23,0,25,2
1746570161892,LTCS 130,A00,889398,Staff,23,0,25,2
1746570162921,LTEA 138,A00,889399,Staff,24,0,40,16
1746570163950,LTEN 149,A00,889400,Wesling; Megan E.,0,3,25,25
1746570164976,LTEN 169,A00,889401,Staff,20,0,25,5
1746570166042,LTEN 180,A00,889402,Staff,10,0,15,5
1746570167066,LTEN 181,A00,889403,Staff,21,0,25,4
1746570168091,LTWL 100,A00,889404,Myerston Santana; Jacobo,2,0,25,23
1746570169114,LTWL 180GS,A00,889405,Staff,0,0,20,20
1746570170139,LTWL 181,A00,889406,Staff,16,0,25,9
1746570171167,LTWL 184,A00,889475,Mukherjee; Silpa,22,0,25,3
1746570172194,LTWR 102C,A00,889486,Staff,29,0,30,1
1746570173221,LTWR 115W,A00,889491,Staff,0,2,15,15
1746570174249,MAE 8,A01,886905,Staff,0,2,0,0
1746570175277,MAE 11,A00,886906,Bandaru; Prabhakar,0,7,50,50
1746570176302,MAE 20,A00,886907,Evdokimenko; Ekaterina,43,0,70,27
1746570177326,MAE 30B,A00,886909,Ghazinejad; Maziar,26,0,45,19
1746570178351,MAE 101B,A00,886910,Saintillan; David,29,0,45,16
1746570179375,MAE 105,A00,886911,Bandaru; Prabhakar,18,0,50,32
1746570180405,MAE 107,B00,958024,Staff,8,0,50,42
1746570181431,MAE 143B,A00,886913,Bewley; Thomas R,6,0,40,34
1746570182462,MAE 148,A01,886915,Silberman; Jack,0,3,14,14
1746570183491,MAE 160,A00,886916,Evdokimenko; Ekaterina,31,0,60,29
1746570184519,MATH 3C,A01,889681,Staff,0,2,30,30
1746570184519,MATH 3C,A02,960048,Staff,24,0,30,6
1746570185544,MATH 10A,A01,889760,Staff,26,0,30,4
1746570185544,MATH 10A,A02,889783,Staff,29,0,30,1
1746570186570,MATH 10B,A01,889785,Verstraete; Jacques Allan,2,0,35,33
1746570186570,MATH 10B,A02,889795,Verstraete; Jacques Allan,4,0,35,31
1746570186570,MATH 10B,B01,889797,Verstraete; Jacques Allan,3,0,35,32
1746570186570,MATH 10B,B02,889828,Verstraete; Jacques Allan,3,0,35,32
1746570187594,MATH 10C,A01,889849,Habib; Yousaf,7,0,30,23
1746570187594,MATH 10C,A02,889852,Habib; Yousaf,14,0,30,16
1746570187594,MATH 10C,A03,889853,Habib; Yousaf,22,0,30,8
1746570187594,MATH 10C,A04,889858,Habib; Yousaf,20,0,30,10
1746570187594,MATH 10C,B01,889861,Staff,1,0,30,29
1746570187594,MATH 10C,B02,889862,Staff,24,0,30,6
1746570187594,MATH 10C,B03,889863,Staff,27,0,30,3
1746570187594,MATH 10C,B04,889967,Staff,23,0,30,7
1746570188625,MATH 18,A01,889974,Staff,7,0,30,23
1746570188625,MATH 18,A02,889977,Staff,20,0,30,10
1746570188625,MATH 18,B01,889984,Hardiman; Liam,21,0,30,9
1746570188625,MATH 18,B02,889985,Hardiman; Liam,25,0,30,5
1746570189650,MATH 20A,A01,889990,Suk; Andrew Hoon,30,0,35,5
1746570190680,MATH 20B,A01,889993,Ohm; Ko Woon,22,0,30,8
1746570190680,MATH 20B,A02,889994,Ohm; Ko Woon,30,0,30,0
1746570190680,MATH 20B,B01,889996,Ohm; Ko Woon,22,0,30,8
1746570190680,MATH 20B,B02,889997,Ohm; Ko Woon,23,0,30,7
1746570191717,MATH 20C,A01,889999,Hammock; Frances H,17,0,30,13
1746570191717,MATH 20C,A02,890003,Hammock; Frances H,23,0,30,7
1746570191717,MATH 20C,B01,890006,Hammock; Frances H,3,0,30,27
1746570191717,MATH 20C,B02,890007,Hammock; Frances H,12,0,30,18
1746570192746,MATH 20D,A01,890011,Cheng; Hsiao-Bing,1,1,30,29
1746570192746,MATH 20D,A02,890012,Cheng; Hsiao-Bing,14,0,30,16
1746570192746,MATH 20D,B01,890016,Cheng; Hsiao-Bing,13,0,30,17
1746570192746,MATH 20D,B02,890017,Cheng; Hsiao-Bing,13,0,30,17
1746570193778,MATH 20E,A01,890026,Harel; Guershon,1,0,30,29
1746570193778,MATH 20E,A02,890029,Harel; Guershon,23,0,30,7
1746570193778,MATH 20E,B01,890033,Harel; Guershon,7,0,30,23
1746570193778,MATH 20E,B02,890101,Harel; Guershon,21,0,30,9
1746570194805,MATH 102,A01,890104,Staff,17,0,30,13
1746570194805,MATH 102,A02,890105,Staff,27,0,30,3
1746570195835,MATH 103B,A01,890116,Salehi Golsefidy; Alireza,3,0,30,27
1746570195835,MATH 103B,B01,890118,Staff,0,3,34,34
1746570196865,MATH 109,A01,890121,Aliabadi Sr.; Mohsen,1,0,30,29
1746570196865,MATH 109,B01,890124,Upadrashta; Pranav Kumar,18,0,30,12
1746570197894,MATH 120A,A01,890126,Eggers; John Dietrich,13,0,30,17
1746570198919,MATH 142B,A01,890128,Ioana; Adrian,19,0,30,11
1746570198919,MATH 142B,A02,890129,Ioana; Adrian,13,0,30,17
1746570199949,MATH 154,A01,890174,Staff,0,0,30,30
1746570199949,MATH 154,A02,890182,Staff,0,0,30,30
1746570200974,MATH 168A,A01,890197,Dumitriu; Ioana,21,0,35,14
1746570202000,MATH 170A,A01,890240,Nie; Jiawang,1,0,30,29
1746570202000,MATH 170A,A02,890241,Nie; Jiawang,11,0,30,19
1746570202000,MATH 170A,A03,890249,Nie; Jiawang,23,0,30,7
1746570203030,MATH 170B,A01,957891,Nag; Panchali,13,0,35,22
1746570205082,MATH 181A,A01,908025,Staff,0,4,35,35
1746570205082,MATH 181A,A02,960115,Staff,27,0,35,8
1746570206107,MATH 181B,A01,959874,Staff,25,0,30,5
1746570207132,MATH 193B,A01,890265,Staff,0,4,35,35
1746570208159,MGT 4,A01,890311,Anderson; John Charles,42,0,88,46
1746570209184,MGT 5,A00,907740,Staff,13,0,98,85
1746570210213,MGT 12,A00,890312,Lindenberger; Wade Douglas,67,0,98,31
1746570211241,MGT 16,A00,957883,Staff,78,0,98,20
1746570213293,MGT 45,A00,890314,Pecore; Joseph P.,46,0,98,52
1746570214316,MGT 71,A00,890315,Staff,0,11,98,98
1746570215341,MGT 100,A00,890316,Yavorsky; Daniel Ryan,44,0,98,54
1746570216365,MGT 103,A00,890317,Ehrich; Kristine R,73,0,98,25
1746570217393,MGT 105,A00,890356,Bates; Kenneth Walter,0,8,98,98
1746570218444,MGT 112,A00,890360,Ehrich; Kristine R,55,0,98,43
1746570219470,MGT 127R,A00,907732,Zhu; Kevin Xiaoguo,23,0,98,75
1746570220499,MGT 131B,A00,890361,Anderson; John Charles,60,0,98,38
1746570221526,MGT 137,A00,890362,Lindenberger; Wade Douglas,65,0,98,33
1746570222554,MGT 160,A00,890369,Johnson; Erik Barry,9,0,98,89
1746570224607,MGT 164,A00,890372,Zimmermann; Carsten,0,40,98,98
1746570225630,MGT 180,A00,890374,Bliss; Barbara Ann,12,0,98,86
1746570226657,MMW 15,A01,886414,Chang; Edmond Yi-Teh,0,12,28,28
1746570226657,MMW 15,A02,886415,Chang; Edmond Yi-Teh,0,8,28,28
1746570226657,MMW 15,A03,886416,Chang; Edmond Yi-Teh,0,8,28,28
1746570226657,MMW 15,A04,886417,Chang; Edmond Yi-Teh,0,8,28,28
1746570226657,MMW 15,B01,886419,Chang; Edmond Yi-Teh,0,7,28,28
1746570226657,MMW 15,B02,886420,Chang; Edmond Yi-Teh,0,8,28,28
1746570226657,MMW 15,B03,886421,Chang; Edmond Yi-Teh,0,7,28,28
1746570226657,MMW 15,B04,886422,Chang; Edmond Yi-Teh,0,8,28,28
1746570226657,MMW 15,C01,886424,Staff,0,9,28,28
1746570226657,MMW 15,C02,886425,Staff,0,8,28,28
1746570226657,MMW 15,C03,886426,Staff,0,8,28,28
1746570226657,MMW 15,C04,886427,Staff,0,8,28,28
1746570226657,MMW 15,C05,958038,Staff,0,8,28,28
1746570226657,MMW 15,C06,958039,Staff,1,8,28,27
1746570227685,MMW 15GS,A00,906910,Patterson; Patrick H.,4,0,28,24
1746570228712,MMW 122R,A01,886429,Rahimi; Babak,0,13,28,28
1746570228712,MMW 122R,A02,886430,Rahimi; Babak,0,12,28,28
1746570228712,MMW 122R,A03,958040,Rahimi; Babak,0,11,28,28
1746570229744,MUS 1A,A01,890937,Staff,2,0,25,23
1746570229744,MUS 1A,A02,891035,Staff,6,0,25,19
1746570229744,MUS 1A,C01,958912,Staff,24,0,25,1
1746570229744,MUS 1A,C02,958913,Staff,25,0,25,0
1746570231834,MUS 2AK,A00,957092,Ohnishi; Takae,15,0,15,0
1746570232864,MUS 4,A01,891044,Staff,2,0,25,23
1746570232864,MUS 4,A02,891045,Staff,23,0,25,2
1746570232864,MUS 4,B01,891048,Staff,17,0,25,8
1746570232864,MUS 4,B02,891050,Staff,25,0,25,0
1746570233895,MUS 5,A01,957506,Dubnov; Shlomo,0,0,25,25
1746570233895,MUS 5,A02,957622,Dubnov; Shlomo,13,0,25,12
1746570233895,MUS 5,A03,957623,Dubnov; Shlomo,20,0,25,5
1746570234925,MUS 6,A01,891053,Freitas Caetano; Marcelo,24,0,25,1
1746570234925,MUS 6,A02,891054,Freitas Caetano; Marcelo,23,0,25,2
1746570235950,MUS 7,A01,891081,Staff,0,0,25,25
1746570235950,MUS 7,A02,891082,Staff,3,0,25,22
1746570236973,MUS 8GS,A00,891118,Borgo; David Garcia,1,0,25,24
1746570238001,MUS 11,A01,891140,Staff,9,0,25,16
1746570238001,MUS 11,A02,891141,Staff,22,0,25,3
1746570239030,MUS 13,A01,891143,Staff,8,0,25,17
1746570239030,MUS 13,A02,891144,Staff,24,0,25,1
1746570240058,MUS 15,A01,891146,Staff,9,0,25,16
1746570240058,MUS 15,A02,891148,Staff,21,0,25,4
1746570240058,MUS 15,B01,891150,Staff,18,0,25,7
1746570240058,MUS 15,B02,891151,Staff,25,0,25,0
1746570241087,MUS 20,A01,891153,Staff,5,0,20,15
1746570241087,MUS 20,A02,891155,Staff,14,0,20,6
1746570242112,MUS 80,A00,891156,Staff,19,0,25,6
1746570242112,MUS 80,B00,891157,Staff,23,0,25,2
1746570243141,MUS 130,A00,891158,Ohnishi; Takae,35,0,35,0
1746570244168,MUS 150GS,A01,891160,Borgo; David Garcia,1,0,25,24
1746570245193,MUS 170,A01,891162,Freitas Caetano; Marcelo,20,0,25,5
1746570245193,MUS 170,A02,891164,Freitas Caetano; Marcelo,21,0,25,4
1746570246221,NANO 11,A00,886220,Vazquez Mena; Oscar,13,0,15,2
1746570247255,NANO 15,A01,886222,Drews; Aaron,4,0,7,3
1746570248281,NANO 104,A00,886224,Sirbuly; Donald,17,0,25,8
1746570249307,PH 40,A00,886528,Staff,23,0,40,17
1746570250346,PH 45,A01,886799,Staff,35,0,40,5
1746570251374,PH 110,A00,886802,Staff,0,7,40,40
1746570252401,PH 172,A00,906716,Staff,19,0,35,16
1746570253428,PH 191,A00,886803,Staff,6,0,40,34
1746570254456,PHIL 1,A00,889500,Staff,20,0,30,10
1746570255488,PHIL 10,A01,889549,Grush; Rick Scott,15,0,22,7
1746570255488,PHIL 10,A02,889551,Grush; Rick Scott,22,0,22,0
1746570256514,PHIL 28,A01,889559,Lamey; Andy M.,0,2,31,31
1746570256514,PHIL 28,A02,889561,Lamey; Andy M.,0,1,30,30
1746570256514,PHIL 28,A03,889572,Lamey; Andy M.,0,1,30,30
1746570257543,PHIL 35,A00,907839,Staff,13,0,15,2
1746570258574,PHIL 60,A00,889574,Staff,73,0,90,17
1746570259598,PHIL 101,A00,958004,Staff,12,0,15,3
1746570261651,PHIL 136,A00,889582,Fulkerson; Matthew Todd,26,0,45,19
1746570262781,PHIL 163,A01,889601,Staff,21,0,30,9
1746570262781,PHIL 163,B01,889606,Brandt; Reuven A,0,3,0,0
1746570263809,PHIL 164,A00,889610,Staff,16,0,30,14
1746570264836,PHIL 165,A00,889613,Staff,22,0,30,8
1746570265862,PHYS 1A,A00,886431,Staff,26,0,70,44
1746570266886,PHYS 1AL,001,886432,Tsai; Philbert S,0,2,30,30
1746570266886,PHYS 1AL,002,886436,Tsai; Philbert S,11,0,30,19
1746570267914,PHYS 1B,A00,886439,Staff,185,0,240,55
1746570268938,PHYS 1BL,001,886441,Tsai; Philbert S,0,4,30,30
1746570268938,PHYS 1BL,002,886444,Tsai; Philbert S,2,0,30,28
1746570270020,PHYS 1C,A00,896092,Arnold; Kam S,78,0,146,68
1746570271049,PHYS 1CL,001,886448,Tsai; Philbert S,0,0,30,30
1746570271049,PHYS 1CL,002,886449,Tsai; Philbert S,1,0,30,29
1746570271049,PHYS 1CL,003,886450,Tsai; Philbert S,16,0,30,14
1746570271049,PHYS 1CL,004,886451,Tsai; Philbert S,15,0,30,15
1746570272073,PHYS 2B,A01,886457,Staff,68,0,115,47
1746570273097,PHYS 2C,A01,886460,Shotwell; Brian,0,9,65,65
1746570274132,PHYS 2CL,A01,886467,Staff,0,4,28,28
1746570274132,PHYS 2CL,A02,886468,Staff,0,3,28,28
1746570275156,PHYS 2D,A01,886470,Staff,10,0,50,40
1746570276186,PHYS 4B,A01,886475,Grinstein; Benjamin,22,0,40,18
1746570277330,POLI 5,A00,891173,Desposato; Scott,7,0,25,18
1746570278353,POLI 5D,A01,891175,Staff,5,0,5,0
1746570278353,POLI 5D,B01,891178,Staff,5,0,5,0
1746570279381,POLI 11,A00,891179,Ferree; Karen E,2,0,35,33
1746570280442,POLI 12,A00,891180,Staff,16,0,30,14
1746570281470,POLI 27,A01,891182,Staff,12,0,75,63
1746570282494,POLI 30,A00,891183,Staff,8,0,50,42
1746570283522,POLI 100B,A00,891244,Staff,5,1,35,30
1746570284545,POLI 100I,A00,891247,Staff,7,0,30,23
1746570285652,POLI 104J,A00,891248,Nichter; Maysa,14,0,30,16
1746570286685,POLI 104U,A00,891250,Nichter; Maysa,2,0,30,28
1746570288743,POLI 110B,A00,891255,Wiens; David,20,0,25,5
1746570289767,POLI 112A,A00,891256,Wiens; David,6,0,25,19
1746570290797,POLI 114BR,A00,891261,Staff,19,0,30,11
1746570291822,POLI 117R,A00,891262,Forman; Fonna,0,6,50,50
1746570292852,POLI 118,A00,891264,Ingham; Sean,17,0,25,8
1746570293882,POLI 124A,A00,891265,Staff,18,0,20,2
1746570294908,POLI 125D,A00,891266,Nichter; Simeon C,2,0,25,23
1746570295939,POLI 126,A00,891268,Nichter; Simeon C,7,0,25,18
1746570296968,POLI 126AA,A00,891272,Staff,16,0,25,9
1746570297996,POLI 130AA,A00,891273,Staff,15,0,20,5
1746570299093,POLI 134AA,A00,891274,Staff,4,0,20,16
1746570301238,POLI 138,A00,891278,Staff,21,0,25,4
1746570302266,POLI 142K,A00,891280,Staff,10,0,25,15
1746570303307,POLI 142M,A00,891281,Gartzke; Erik,16,0,30,14
1746570304331,POLI 142P,A00,891284,Staff,20,0,30,10
1746570305358,POLI 143,A00,891285,Gartzke; Erik,12,0,30,18
1746570306384,POLI 153,A00,891286,Staff,19,0,20,1
1746570308434,POLI 175,A00,891290,Staff,15,0,20,5
1746570309459,PSYC 1,A00,890674,Steiner; Eric Tomas,0,11,45,45
1746570310487,PSYC 2,A00,890676,Albright; Thomas D,21,0,35,14
1746570311605,PSYC 3,A00,890679,Staff,17,0,20,3
1746570312761,PSYC 6,A00,959858,Staff,20,0,20,0
1746570313787,PSYC 60,A01,890684,Rickard; Timothy C.,0,5,45,45
1746570314816,PSYC 70,A01,890689,Geller; Emma Harlan,7,0,30,23
1746570315845,PSYC 71,A01,959860,Staff,21,0,25,4
1746570316872,PSYC 100,A00,890690,Lacefield; Katharine I,0,50,180,180
1746570317907,PSYC 102,A00,890695,Staff,18,0,40,22
1746570318934,PSYC 105,A00,890699,Geller; Emma Harlan,70,0,100,30
1746570319962,PSYC 106,A00,890701,Gorman; Michael R.,6,0,30,24
1746570320988,PSYC 108,A00,890704,Adrian; Julia Anna,0,28,50,50
1746570322020,PSYC 118,A01,890712,Staff,11,0,30,19
1746570323047,PSYC 124,A00,890716,Chapman; Eddie Nathaniel,25,0,60,35
1746570324075,PSYC 131,A00,890717,Anagnostaras; Stephan,0,8,80,80
1746570325102,PSYC 137,A00,890719,Winkielman; Piotr,0,11,30,30
1746570326133,PSYC 144,A00,890721,Adrian; Julia Anna,0,9,45,45
1746570327159,PSYC 162,A00,890805,Staff,0,0,75,75
1746570328183,PSYC 169,A00,890810,Staff,0,14,30,30
1746570329212,PSYC 172,A00,890814,Gorman; Michael R.,9,0,30,21
1746570330273,PSYC 181,A00,890818,Anagnostaras; Stephan,9,0,200,191
1746570331303,PSYC 184,A00,959861,Staff,168,0,175,7
1746570332328,PSYC 189,A00,890823,Staff,0,2,30,30
1746570333361,PSYC 191,A00,890884,Rickard; Timothy C.,0,12,35,35
1746570334453,PSYC 193,A00,890913,Staff,19,0,30,11
1746570334453,PSYC 193,B00,890914,Chapman; Eddie Nathaniel,24,0,30,6
1746570335482,PSYC 193L,A01,890918,Lowe; Angela Beth,20,0,30,10
1746570335482,PSYC 193L,B01,890921,Hurwitz; Ethan Scott,20,0,30,10
1746570335482,PSYC 193L,C01,890928,Staff,30,0,30,0
1746570336508,RELI 149,A00,886806,Rahimi; Babak,23,0,40,17
1746570337534,SE 9,A01,886814,Staff,7,0,20,13
1746570338562,SE 101B,A01,886816,Chadha; Mayank,4,0,35,31
1746570339587,SE 110B,A00,886818,Zhu; Qiang,4,0,75,71
1746570340715,SE 125,A01,886830,Staff,10,0,30,20
1746570341741,SE 130B,A01,886835,Staff,14,0,40,26
1746570342768,SE 131A,A01,886838,Krysl; Petr,34,0,55,21
1746570343793,SE 154,A00,886840,Staff,29,0,50,21
1746570344890,SE 164GS,A01,886849,Staff,6,0,20,14
1746570345917,SE 167GS,A01,886853,Staff,6,0,20,14
1746570346942,SIO 25,A01,890107,Staff,19,0,30,11
1746570347967,SIO 45,A00,890109,Cook; Geoffrey W,117,0,200,83
1746570348993,SIO 109R,A00,890110,Forman; Fonna,0,16,20,20
1746570350021,SIO 187,A01,890114,Kacev; David,15,0,40,25
1746570351045,SOCI 1,A01,890431,Thorpe; Charles Robert,15,0,30,15
1746570351045,SOCI 1,A02,890518,Thorpe; Charles Robert,30,0,30,0
1746570352070,SOCI 2,A01,957978,Staff,25,0,25,0
1746570352070,SOCI 2,A02,957979,Staff,23,0,25,2
1746570353095,SOCI 20,A01,890523,Calderon-Zaks; Michael Aar,22,0,30,8
1746570353095,SOCI 20,A02,890526,Calderon-Zaks; Michael Aar,29,0,30,1
1746570354123,SOCI 30,A01,890533,Pardo Guerra; Juan Pablo,37,0,40,3
1746570355154,SOCI 40,A01,890535,Staff,27,0,45,18
1746570356182,SOCI 104Q,A00,890559,Staff,18,0,30,12
1746570357207,SOCI 106,A00,890560,Arnal; Maud Marie Leonie,20,0,30,10
1746570358234,SOCI 110,A00,890567,Holkenbrink-Monk; Charlene,19,0,30,11
1746570359258,SOCI 112,A00,890568,Victoria Torres; Pablo,2,0,55,53
1746570360286,SOCI 115,A00,890597,Arnal; Maud Marie Leonie,28,0,45,17
1746570362339,SOCI 121,A00,890604,Pardo Guerra; Juan Pablo,38,0,45,7
1746570363365,SOCI 126,A01,890608,Staff,8,0,10,2
1746570364406,SOCI 127,A00,890609,Staff,18,0,30,12
1746570365434,SOCI 131,A00,890610,Thorpe; Charles Robert,37,0,45,8
1746570366463,SOCI 135,A00,890615,Payne; Christine Anna,13,0,45,32
1746570367492,SOCI 139,A00,890620,Staff,38,0,45,7
1746570368518,SOCI 148E,A00,890622,Calderon-Zaks; Michael Aar,36,0,45,9
1746570369544,SOCI 150,A00,890623,Kohler; Kristopher M.,31,0,45,14
1746570370572,SOCI 157,A00,890625,Jules-Rosette; Bennetta W.,18,0,20,2
1746570371597,SOCI 160,A00,890627,Payne; Christine Anna,21,0,45,24
1746570372625,SYN 1,A00,886855,Fish; Gwendolyn Anne,0,0,0,0
1746570372625,SYN 1,B00,906086,Fish; Gwendolyn Anne,0,2,0,2
1746570373652,SYN 2R,A00,886860,Staff,0,17,15,15
1746570373652,SYN 2R,B00,906106,Atkinson; Arthur Laird,0,16,15,15
1746570374680,SYN 100,A01,886866,Browne; Emily,0,28,20,20
1746570374680,SYN 100,B01,906128,Rock; Martin,0,5,20,20
1746570374680,SYN 100,C01,906140,Deavenport; James Cary,0,3,20,20
1746570374680,SYN 100,D01,907816,Deavenport; James Cary,0,5,20,20
1746570375708,TDAC 1,A00,890286,Walsh; Kim C.,8,0,20,12
1746570376735,TDAC 101,A00,890296,Basso; Beatrice,15,0,20,5
1746570377761,TDDE 131,A00,890297,Staff,47,0,50,3
1746570378793,TDDM 1,A00,890287,Weinberg; Sadie,25,0,30,5
1746570379824,TDGE 11,A00,890288,Fulton; Julia,137,0,200,63
1746570379824,TDGE 11,B00,890289,Castro; Robert Jess,184,0,200,16
1746570380848,TDGE 25,B00,957359,Walsh; Kim C.,4,0,20,16
1746570381879,TDGE 40,A01,890292,Power; Jade Yukana,27,0,30,3
1746570382904,TDGE 124,A00,890298,Havis; Allan,0,1,50,50
1746570383932,TDGE 131R,A00,890299,Burelle; Julie Sara Veronique,15,0,42,27
1746570384956,TDHT 101,A00,890300,Staff,10,0,20,10
1746570385985,TDHT 109,A01,890302,Anderson; Mysia Anyse,31,0,40,9
1746570387012,TDMV 1,A00,890293,Arcidiacono; Kristin,18,0,30,12
1746570388037,TDMV 2,A00,890294,Weinberg; Sadie,23,0,30,7
1746570389062,TDMV 3,A00,957878,Arcidiacono; Kristin,28,0,30,2
1746570391111,TDMV 138,A00,890304,Jun; Grace Shin Hae,25,0,40,15
1746570392138,TDMV 140,A00,890305,Corrales; Joseph Bernales,25,0,30,5
1746570393162,TDMV 142,A00,890307,Caligagan; Tony,32,0,40,8
1746570394190,TDMV 144,A00,890308,Camaya; Michelle Ann,25,0,30,5
1746570395213,TDPW 1,A00,890295,Stein; Deborah Isobel,3,0,20,17
1746570396238,USP 2,A01,890272,Lerner; Amy M,6,0,20,14
1746570397263,USP 3,A01,890274,Staff,12,0,30,18
1746570398294,USP 15,A01,890276,Sun; Feiyang,16,0,30,14
1746570399346,USP 25,A00,890277,Shenkman; Michael Thomas,19,0,25,6
1746570400369,USP 138,A00,890278,Staff,14,0,25,11
1746570401452,USP 143,A00,890279,Staff,22,0,70,48
1746570402479,USP 144,A00,890280,Chowdhury; Muhammed Zohir,16,0,30,14
1746570403502,USP 150,A00,890281,Boomhower; Matthew Charles,4,0,30,26
1746570404527,USP 151,A00,890282,Staff,16,0,20,4
1746570405554,USP 162,A00,890283,Andrews; Abigail Leslie,16,0,20,4
1746570406580,USP 168,A00,920477,Kwak; Nancy,0,0,5,5
1746570407606,USP 181,A00,890284,Staff,3,0,20,17
1746570408633,USP 191A,A00,890285,Staff,12,0,20,8
1746570409659,VIS 101,A00,886512,Staff,26,0,75,49
1746570410684,VIS 103,A00,886513,Cruz; Edwin Teddy,61,0,75,14
1746570411712,VIS 108,A00,886514,Staff,3,0,15,12
1746570412736,VIS 127P,A00,886515,Shen; Kuiyi,80,0,146,66
1746570413760,VIS 149,A00,886516,Yoldas; Pinar,0,0,15,15
1746570414787,VIS 164,A00,886526,Erdmann; Dean,19,0,22,3
1746570415812,VIS 194S,A00,886527,Staff,61,0,75,14
1746570416841,WCWP 10A,C00,886484,Martiniuk; Jill,12,0,15,3
1746570417868,WCWP 10B,A00,886490,Uriarte; Emma,0,0,15,15
1746570417868,WCWP 10B,B00,886491,Dhir; Simrita,9,0,15,6
1746570417868,WCWP 10B,C00,886492,Ornelas; Tricia,0,0,15,15
1746570418892,WCWP 100,A00,886494,Young; Mark T,0,6,15,15
1746570420993,AAS 10,A01,886199,Childs; Dennis R.,0,3,0,0
1746570422022,ANAR 104,A01,886940,Shtienberg; Gilad,27,0,30,3
1746570423046,ANAR 120,A00,886953,Staff,12,0,20,8
1746570424074,ANBI 148,A01,886955,Wilder; Linnea Lorene,30,0,40,10
1746570426129,ANSC 122,A00,886957,Staff,25,0,30,5
1746570427156,ANSC 150,A00,886958,Sloane; Julia Kathryn,2,0,15,13
1746570428182,ANSC 156,A00,886959,Jenkins; Janis A.,0,1,15,15
1746570429209,ANSC 180,A00,886960,Staff,11,0,17,6
1746570430238,ANSC 188,A00,886961,Jassal; Aftab,9,0,25,16
1746570431263,ANSC 190,A00,886962,Jassal; Aftab,14,0,25,11
1746570432290,ANSC 191,A00,886963,Staff,18,0,20,2
1746570433314,ANTH 3,A01,891689,Staff,17,0,20,3
1746570434343,ANTH 5,A00,886933,Semendeferi; Ekaterini,16,0,20,4
1746570435367,ANTH 10,A00,886934,Staff,0,12,30,30
1746570436393,ANTH 21,A01,886936,Staff,41,0,60,19
1746570437420,ANTH 23,A01,886938,Staff,92,0,100,8
1746570438448,ANTH 105,A00,886964,Stewart; Alexander B,84,0,100,16
1746570439477,ANTH 108,A00,886965,Pedersen; David,9,0,20,11
1746570440505,AWP 10,001,886147,Staff,0,0,0,0
1746570440505,AWP 10,002,886148,Staff,0,0,0,0
1746570440505,AWP 10,003,886149,Staff,0,0,0,0
1746570440505,AWP 10,004,886150,Staff,0,0,0,0
1746570440505,AWP 10,005,886151,Staff,0,0,0,0
1746570440505,AWP 10,006,886152,Staff,0,0,0,0
1746570440505,AWP 10,007,886153,Staff,0,0,0,0
1746570440505,AWP 10,008,886154,Staff,0,0,0,0
1746570440505,AWP 10,009,886155,Staff,0,0,0,0
1746570440505,AWP 10,010,886156,Staff,0,0,0,0
1746570440505,AWP 10,011,886158,Staff,0,0,0,0
1746570440505,AWP 10,012,886160,Staff,0,0,0,0
1746570440505,AWP 10,013,886161,Staff,0,0,0,0
1746570440505,AWP 10,014,886162,Staff,0,0,0,0
1746570440505,AWP 10,015,886163,Staff,0,0,0,0
1746570440505,AWP 10,016,886164,Staff,0,0,0,0
1746570440505,AWP 10,017,886165,Staff,0,0,0,0
1746570440505,AWP 10,018,886166,Staff,0,0,0,0
1746570440505,AWP 10,019,886168,Staff,0,0,0,0
1746570440505,AWP 10,020,886170,Staff,0,0,0,0
1746570440505,AWP 10,021,886172,Staff,0,0,0,0
1746570441545,AWP 10R,001,886173,Staff,0,1,0,0
1746570441545,AWP 10R,002,886174,Staff,0,1,0,0
1746570441545,AWP 10R,003,886175,Staff,0,0,0,0
1746570441545,AWP 10R,004,886176,Staff,0,0,0,0
1746570441545,AWP 10R,005,886177,Staff,0,0,0,0
1746570441545,AWP 10R,006,886178,Staff,0,0,0,0
1746570441545,AWP 10R,007,886179,Staff,0,0,0,0
1746570441545,AWP 10R,008,886181,Staff,0,0,0,0
1746570441545,AWP 10R,009,886182,Staff,0,0,0,0
1746570441545,AWP 10R,010,886183,Staff,0,0,0,0
1746570441545,AWP 10R,011,886184,Staff,0,0,0,0
1746570441545,AWP 10R,012,886185,Staff,0,0,0,0
1746570441545,AWP 10R,013,886186,Staff,0,0,0,0
1746570441545,AWP 10R,014,886187,Staff,0,0,0,0
1746570441545,AWP 10R,015,886188,Staff,0,0,0,0
1746570441545,AWP 10R,016,886189,Staff,0,0,0,0
1746570441545,AWP 10R,017,960532,Staff,0,0,0,0
1746570441545,AWP 10R,018,960533,Staff,0,0,0,0
1746570441545,AWP 10R,019,960534,Staff,0,0,0,0
1746570441545,AWP 10R,020,960538,Staff,0,0,0,0
1746570441545,AWP 10R,021,960540,Staff,0,0,0,0
1746570441545,AWP 10R,022,960541,Staff,0,0,0,0
1746570441545,AWP 10R,023,960542,Staff,0,0,0,0
1746570441545,AWP 10R,024,960544,Staff,0,0,0,0
1746570441545,AWP 10R,025,960545,Staff,0,0,0,0
1746570441545,AWP 10R,026,960548,Staff,0,0,0,0
1746570442573,AWP 102R,A00,886190,Staff,0,0,0,0
1746570442573,AWP 102R,B00,886191,Staff,0,0,0,0
1746570443598,BENG 100,A01,886193,Staff,17,0,30,13
1746570444625,BENG 122A,A01,886195,Hasty; Jeff M,13,0,30,17
1746570445652,BENG 166A,A00,886196,Sah; Robert Lie-Yuan,0,2,30,30
1746570446678,BENG 190,A00,958050,Khojah; Reem I,20,0,25,5
1746570447707,BIBC 102,A01,894320,Staff,0,0,46,46
1746570447707,BIBC 102,A02,894321,Staff,0,0,46,46
1746570447707,BIBC 102,A03,894344,Staff,7,0,46,39
1746570447707,BIBC 102,A04,894345,Staff,27,0,47,20
1746570448737,BICD 100R,A01,894365,Smith; Laurie,0,3,58,58
1746570448737,BICD 100R,A02,894366,Smith; Laurie,0,5,58,58
1746570448737,BICD 100R,A03,894367,Smith; Laurie,0,0,59,59
1746570448737,BICD 100R,A04,959869,Smith; Laurie,39,0,59,20
1746570449768,BICD 136,A01,894383,Gustafson-Brown; Cindy,14,0,50,36
1746570450795,BIEB 102,A01,894494,Butler; Shannon Rhey,51,0,130,79
1746570452851,BIEB 150,A01,894617,Wills; Christopher,3,0,20,17
1746570452851,BIEB 150,A02,894631,Wills; Christopher,3,0,20,17
1746570452851,BIEB 150,A03,894937,Wills; Christopher,3,0,20,17
1746570452851,BIEB 150,A04,894946,Wills; Christopher,5,0,20,15
1746570453879,BIEB 194,A00,906141,Kurle; Carolyn M.,6,0,20,14
1746570454910,BILD 1,A01,894154,Staff,3,0,19,16
1746570454910,BILD 1,A02,894155,Staff,14,0,19,5
1746570454910,BILD 1,A03,894160,Staff,13,0,19,6
1746570454910,BILD 1,A04,894161,Staff,15,0,18,3
1746570455941,BILD 2,A01,894168,Staff,0,0,50,50
1746570455941,BILD 2,A02,894169,Staff,0,0,50,50
1746570455941,BILD 2,A03,894179,Staff,0,0,50,50
1746570455941,BILD 2,A04,894203,Staff,24,0,50,26
1746570456967,BILD 3,A01,894213,Staff,22,0,31,9
1746570456967,BILD 3,A02,894214,Staff,26,0,31,5
1746570456967,BILD 3,A03,894235,Staff,28,0,31,3
1746570456967,BILD 3,A04,894236,Staff,28,0,32,4
1746570457999,BILD 4,A01,894253,Reuther; Keefe,6,0,24,18
1746570457999,BILD 4,A02,894258,Reuther; Keefe,16,0,24,8
1746570459025,BILD 5,A01,894276,Reuther; Keefe,35,0,50,15
1746570459025,BILD 5,A02,894277,Reuther; Keefe,45,0,50,5
1746570459025,BILD 5,A03,894290,Reuther; Keefe,44,0,50,6
1746570459025,BILD 5,A04,894291,Reuther; Keefe,48,0,50,2
1746570460059,BILD 24,A01,894297,Pirino; Giorgia,40,0,60,20
1746570461089,BIMM 100,B01,958915,Staff,71,0,100,29
1746570462117,BIMM 101,A01,895017,McDonnell; Lisa Marie,0,5,24,24
1746570462117,BIMM 101,A02,895018,McDonnell; Lisa Marie,0,5,24,24
1746570462117,BIMM 101,B01,895020,McDonnell; Lisa Marie,0,6,24,24
1746570462117,BIMM 101,B02,895021,McDonnell; Lisa Marie,0,4,24,24
1746570463147,BIMM 110,A01,895023,Staff,1,0,25,24
1746570463147,BIMM 110,A02,895024,Staff,9,0,25,16
1746570463147,BIMM 110,A03,895025,Staff,18,0,25,7
1746570463147,BIMM 110,A04,895031,Staff,20,0,25,5
1746570464176,BIMM 120,A01,895114,Gustafson-Brown; Cindy,14,0,28,14
1746570464176,BIMM 120,A02,895126,Gustafson-Brown; Cindy,21,0,27,6
1746570465205,BIPN 100,A01,895130,Yang; Mingyu,0,0,38,38
1746570465205,BIPN 100,A02,895131,Yang; Mingyu,32,0,38,6
1746570465205,BIPN 100,A03,895132,Yang; Mingyu,32,0,38,6
1746570465205,BIPN 100,A04,895133,Yang; Mingyu,27,0,36,9
1746570466239,BIPN 120,A01,895135,Cooke; James Edward,0,3,13,13
1746570466239,BIPN 120,A02,895136,Cooke; James Edward,0,1,13,13
1746570466239,BIPN 120,A03,895137,Cooke; James Edward,0,3,13,13
1746570466239,BIPN 120,A04,895156,Cooke; James Edward,0,2,11,11
1746570467268,BIPN 134,A01,895235,Cooke; James Edward,0,2,25,25
1746570467268,BIPN 134,A02,895237,Cooke; James Edward,0,0,25,25
1746570467268,BIPN 134,A03,895240,Cooke; James Edward,3,0,25,22
1746570467268,BIPN 134,A04,895270,Cooke; James Edward,20,0,25,5
1746570468293,BIPN 189,A00,892103,Staff,0,14,14,14
1746570470346,BISP 194,A00,958008,Staff,0,2,0,0
1746570471373,CAT 124,A01,922009,Staff,0,5,20,20
1746570472405,CAT 125R,A00,886390,Morales; Celeste Georgianna,0,2,20,20
1746570472405,CAT 125R,B00,886391,Irwin; Matthew Joseph,0,4,20,20
1746570472405,CAT 125R,C00,886392,Smith; Lauryn Alissa,0,2,20,20
1746570472405,CAT 125R,D00,886393,Vanderschuit; Maya Alysia,0,3,20,20
1746570472405,CAT 125R,E00,886394,Marchisotto; Jennifer Anne,0,3,20,20
1746570473432,CENG 15,A01,886218,Drews; Aaron,3,0,8,5
1746570474459,CENG 113,A00,886219,Opatkiewicz; Justin Paul,15,0,25,10
1746570475486,CGS 101,A00,887044,Staff,7,0,20,13
1746570476516,CGS 105,A01,887046,Staff,14,0,25,11
1746570477545,CGS 112,A00,887047,Cuong; Marisol,12,0,15,3
1746570478572,CGS 113,A00,887048,Staff,23,0,30,7
1746570479599,CGS 120,A00,887049,Staff,10,0,17,7
1746570480628,CHEM 6A,A01,886336,Lam; Tin Yiu,38,0,50,12
1746570480628,CHEM 6A,A02,886338,Lam; Tin Yiu,37,0,50,13
1746570481656,CHEM 6B,A01,886341,Hopkins; Patrycja Anna,16,0,50,34
1746570481656,CHEM 6B,A02,886343,Hopkins; Patrycja Anna,42,0,50,8
1746570482689,CHEM 6C,A01,886346,Albizati; Kim F.,0,2,50,50
1746570482689,CHEM 6C,A02,886348,Albizati; Kim F.,23,0,50,27
1746570483718,CHEM 40A,A01,886352,Klosterman; Jeremy K,65,0,100,35
1746570484747,CHEM 40B,A01,886356,Klosterman; Jeremy K,0,23,100,100
1746570485774,CHEM 41B,A01,886360,Theodorakis; Emmanuel,25,0,50,25
1746570485774,CHEM 41B,A02,886362,Theodorakis; Emmanuel,47,0,50,3
1746570486805,CHIN 165A,A00,886382,Xu; Li,18,0,20,2
1746570487836,CLAS 120,A00,886387,Myerston Santana; Jacobo,33,0,40,7
1746570488863,COGS 9,A01,886967,Shannon; Kyle Michael,42,0,60,18
1746570489895,COGS 11,A01,886969,Staff,10,0,30,20
1746570490921,COGS 14A,A01,886971,Staff,6,0,60,54
1746570491947,COGS 14B,A01,886973,Hoffman; Drew Ellen,4,0,60,56
1746570492973,COGS 18,A01,886975,Morgan; Eric,35,0,60,25
1746570494004,COGS 20,A01,886977,Staff,4,0,8,4
1746570494004,COGS 20,A02,886978,Staff,5,0,7,2
1746570495031,COGS 100,A01,907783,Staff,1,2,30,29
1746570496060,COGS 101B,A01,886980,Staff,0,3,48,48
1746570497086,COGS 101C,A01,886982,Delgado; Tania,0,5,44,44
1746570498115,COGS 102A,A01,886984,Johnson; Christine M.,4,0,30,26
1746570499141,COGS 118B,A01,886986,Staff,1,3,88,87
1746570500168,COGS 150,A01,886988,Bergen; Benjamin,22,0,50,28
1746570501195,COGS 153,A00,886989,Delgado; Tania,0,2,41,41
1746570502222,COGS 186,A01,886991,Staff,0,0,32,32
1746570503248,COGS 187A,A01,886993,Boyle; Mary E. T.,7,0,30,23
1746570504275,COGS 189,A00,886994,Staff,0,1,30,30
1746570505343,COMM 10,A01,886996,Staff,0,0,20,21
1746570505343,COMM 10,A02,886997,Staff,12,0,20,8
1746570505343,COMM 10,A03,959845,Staff,19,0,20,1
1746570506374,COMM 20,A01,886999,Leuning; Grant Maurstad,24,0,40,16
1746570508426,COMM 100A,A01,887002,Staff,0,0,20,25
1746570508426,COMM 100A,A02,887003,Staff,6,0,20,14
1746570509455,COMM 100B,A01,887005,Staff,0,8,20,24
1746570510481,COMM 106D,A00,887006,Staff,13,0,40,27
1746570511512,COMM 110G,A00,887007,Whitworth-Smith; Andrew C,12,0,40,28
1746570512539,COMM 111B,A00,887008,Staff,31,0,40,9
1746570513568,COMM 113T,A00,887009,Abuelhiga; Soraya Jill,28,0,40,12
1746570513568,COMM 113T,B00,906733,Staff,40,0,40,0
1746570514594,COMM 145,A00,887010,Staff,12,0,40,28
1746570515621,COMM 146,A00,887054,Staff,31,0,40,9
1746570516646,COMM 190,A00,887012,Staff,8,0,23,15
1746570517674,CSE 8A,A50,887015,Cao; Yingjun,57,0,85,28
1746570518701,CSE 11,A01,887017,Cao; Yingjun,12,0,70,58
1746570519729,CSE 20,A01,887019,Staff,30,0,50,20
1746570520758,CSE 21,A01,887021,Staff,78,0,100,22
1746570520758,CSE 21,B01,892583,Braun; Oliver,45,0,50,5
1746570521785,CSE 30,A01,887025,Eldon; John,143,0,200,57
1746570522815,CSE 100,A01,887027,Staff,26,0,50,24
1746570522815,CSE 100,A02,887028,Staff,42,0,50,8
1746570523841,CSE 101,A01,887030,Braun; Oliver,74,0,100,26
1746570523841,CSE 101,B01,887032,Jones; Miles E,0,3,50,50
1746570523841,CSE 101,B02,887033,Jones; Miles E,0,2,50,50
1746570524871,CSE 105,A01,908084,Jones; Miles E,32,0,50,18
1746570524871,CSE 105,A02,908087,Jones; Miles E,31,0,50,19
1746570525897,CSE 135,A01,887035,Powell; Thomas Allan,0,5,50,50
1746570526927,CSE 142,A01,887037,Staff,8,0,60,52
1746570527955,CSE 142L,A01,887039,Staff,34,0,60,26
1746570528986,CSE 151A,A01,887041,Solares; Edwin A,47,0,100,53
1746570530013,CSE 175,A01,887043,Kumar; Rakesh,30,0,30,0
1746570531038,CSS 1,A01,886389,Staff,1,1,40,39
1746570532068,DSC 30,A01,908097,Liao; Soohyun Nam,47,0,75,28
1746570533093,DSC 40A,A01,908099,Shannon; Kyle Michael,30,0,50,20
1746570534119,DSC 40B,A01,908112,Staff,15,0,50,35
1746570535147,DSC 80,A01,908116,Staff,19,0,60,41
1746570536172,DSC 197,001,956863,Eldridge; Justin Matthew,9999,0,9999,0
1746570537197,ECE 5,A01,886400,Morris; Karcher William,1,0,6,5
1746570537197,ECE 5,A02,886401,Morris; Karcher William,3,0,6,3
1746570538226,ECE 148,A01,886403,Silberman; Jack,0,14,14,14
1746570539256,ECON 1,A01,887265,Crane; Meredith Helen,12,0,70,58
1746570539256,ECON 1,B01,887268,Staff,43,0,50,7
1746570540285,ECON 2,A01,887273,Crane; Meredith Helen,55,0,70,15
1746570541314,ECON 3,A01,887279,Rondina; Giacomo,32,0,70,38
1746570542343,ECON 4,A01,887282,Anderson; John Charles,0,2,10,10
1746570543372,ECON 5,A01,887285,Staff,34,0,45,11
1746570543372,ECON 5,B01,887292,Staff,41,0,45,4
1746570544400,ECON 100A,A01,887337,Newhouse; Herbert S,54,0,70,16
1746570544400,ECON 100A,B01,887349,Staff,45,0,50,5
1746570545430,ECON 100B,A01,887361,Du; Songzi,29,0,70,41
1746570546457,ECON 100C,A01,887445,Newhouse; Herbert S,59,0,70,11
1746570547484,ECON 105,A00,887488,Vespa; Emanuel Ignacio,23,0,35,12
1746570548509,ECON 109,A01,887506,Shishkin; Denis,28,0,35,7
1746570549538,ECON 110A,A01,887568,Alon; Titan Michael,0,3,35,35
1746570549538,ECON 110A,B01,907601,Alon; Titan Michael,20,0,35,15
1746570550563,ECON 110B,A01,887598,Levkoff; Steven B.,0,24,70,70
1746570551589,ECON 112,A00,887599,Rondina; Giacomo,19,0,35,16
1746570552620,ECON 120A,A01,887603,Dai; Yinlin,35,0,70,35
1746570553649,ECON 120C,A01,887608,Sun; Yixiao,0,1,35,35
1746570553649,ECON 120C,B01,887614,Sun; Yixiao,0,0,35,35
1746570554675,ECON 138,A00,887621,Bharadwaj; Prashant,0,21,20,20
1746570555703,ECON 144,A00,958007,Squires; Dale E,12,0,35,23
1746570556731,ECON 171,A01,907666,Staff,18,0,35,17
1746570557760,ECON 175,A00,887626,Wu; Pak Yeung,22,0,35,13
1746570558784,ECON 190,A00,887640,Vespa; Emanuel Ignacio,22,0,35,13
1746570559811,EDS 25,A01,888197,Staff,0,0,0,0
1746570559811,EDS 25,A02,888209,Staff,0,0,0,0
1746570559811,EDS 25,A03,888210,Staff,0,0,0,0
1746570559811,EDS 25,A04,888212,Staff,0,0,0,0
1746570559811,EDS 25,A05,888213,Staff,0,0,0,0
1746570559811,EDS 25,A06,888214,Staff,0,0,0,0
1746570559811,EDS 25,A07,888235,Staff,0,2,0,0
1746570559811,EDS 25,A08,888236,Staff,0,0,0,0
1746570559811,EDS 25,A09,888240,Staff,0,0,0,0
1746570559811,EDS 25,A10,888244,Staff,0,0,0,0
1746570559811,EDS 25,B01,888273,Staff,0,0,0,0
1746570559811,EDS 25,B02,888285,Staff,0,0,0,0
1746570559811,EDS 25,B03,888423,Staff,0,0,0,1
1746570559811,EDS 25,B04,888432,Staff,0,0,0,0
1746570559811,EDS 25,B05,888433,Staff,0,0,0,0
1746570559811,EDS 25,B06,888467,Staff,0,0,0,0
1746570559811,EDS 25,B07,888468,Staff,0,0,0,0
1746570559811,EDS 25,B08,888479,Staff,0,0,0,0
1746570559811,EDS 25,B09,888484,Staff,0,0,0,0
1746570559811,EDS 25,B10,888487,Staff,0,0,0,0
1746570560841,EDS 38,A01,907700,Choi; Bailey Miyeon,30,0,30,0
1746570561870,EDS 112,A01,888601,Chapman; Thandeka K,12,0,40,28
1746570562902,EDS 115,A00,888697,Mendez; Kathrina Mendoza,10,0,30,20
1746570563930,EDS 116,A01,888893,Staff,34,0,40,6
1746570565984,EDS 124AR,A00,889133,Staff,29,0,50,21
1746570565984,EDS 124AR,B00,907471,Simon; Elizabeth A,37,0,50,13
1746570567009,EDS 124BR,A00,889134,Simon; Elizabeth A,44,0,100,56
1746570568034,EDS 125,A00,889135,Staff,25,0,30,5
1746570569059,EDS 126,A01,889138,Staff,35,0,40,5
1746570570085,EDS 164R,A01,889142,Wishard Guerra; Alison G.,33,0,50,17
1746570571111,ENG 30,A01,886396,Staff,0,0,0,0
1746570571111,ENG 30,B01,886398,Staff,0,0,0,0
1746570572141,ENVR 102,A00,906150,Montejo; Carolina,23,0,25,2
1746570573166,ETHN 103A,A00,887236,Man; Simeon S,0,3,0,0
1746570574193,ETHN 113,A00,887239,Staff,16,0,30,14
1746570575221,ETHN 116,A00,887240,Staff,16,0,25,9
1746570576250,ETHN 117,A00,887241,Choi; Esther Min,28,0,30,2
1746570577275,ETHN 118,A00,887243,Staff,24,0,30,6
1746570578305,ETHN 127,A00,887248,Cuong; Marisol,11,0,15,4
1746570579333,ETHN 139,A00,887250,Staff,7,0,10,3
1746570580360,ETHN 142,A00,887252,Staff,10,0,30,20
1746570581389,ETHN 161,A00,887253,Browne; Errol Tsekani,24,0,30,6
1746570582417,ETHN 163FR,A00,887255,Burelle; Julie Sara Veronique,0,0,5,5
1746570583442,GLBH 20,A00,889149,Elwardani; Nile Regina,8,0,42,34
1746570585494,GLBH 111,A01,889152,Burgos; Jose L.,17,0,17,0
1746570586523,GLBH 150,A00,889181,Sloane; Julia Kathryn,0,5,15,15
1746570588577,HDS 60,A01,886406,Warstadt; Melissa Fawn,73,0,80,7
1746570589603,HIAF 111,A00,889324,Gyamfi; Bright,25,0,32,7
1746570590629,HIEA 131,A00,889328,Staff,15,0,32,17
1746570591656,HIEA 144,A00,889333,Henry; Todd A.,26,0,32,6
1746570592682,HIEA 154,A00,889336,Henry; Todd A.,24,0,32,8
1746570593711,HIEU 106,A00,889339,Staff,22,0,32,10
1746570595763,HIEU 114,A00,889340,Staff,4,0,32,28
1746570596793,HIEU 135GS,A00,889342,Patterson; Patrick H.,0,0,1,24
1746570597821,HIEU 137,A00,889343,Edington; Claire Ellen,10,0,25,15
1746570598847,HIEU 148,A00,889345,Staff,14,0,32,18
1746570599874,HIEU 154,A00,889346,Biess; Frank Peter,21,0,32,11
1746570600898,HILA 102,A00,889351,Staff,12,0,32,20
1746570601930,HILD 2A,A01,889221,Lewandoski; Julia Mavis,1,10,32,31
1746570602955,HILD 7B,A01,889225,Man; Simeon S,0,12,32,32
1746570603980,HILD 7C,A01,889288,Alvarez; Luis A,0,14,32,32
1746570605008,HILD 30,A01,889323,Staff,0,5,32,32
1746570607058,HISC 119,A00,889383,Golan; Tal,19,0,32,13
1746570608086,HIUS 103,A00,889384,Man; Simeon S,0,0,32,32
1746570609169,HIUS 117,A00,919797,Kwak; Nancy,19,0,32,13
1746570610197,HIUS 142A,A00,919788,Staff,22,0,32,10
1746570612247,HIUS 149,A00,889386,Gyamfi; Bright,26,0,32,6
1746570613273,HIUS 155,A00,889387,Alvarez; Luis A,15,0,32,17
1746570614298,HUM 3,A01,886499,Caldwell; Michael Alan,19,0,50,31
1746570615323,HUM 3GS,A00,886500,Rodriguez; Bretton Sigfred,0,0,0,28
1746570616350,HUM 3R,A01,886502,Markman; Kristina,0,36,50,50
1746570617374,HUM 4,A01,886504,Crum; Matthew Stephen,24,0,50,26
1746570617374,HUM 4,B01,886506,West; Geoffrey Scott,17,0,50,33
1746570618399,HUM 4GS,A00,886507,Staff,0,0,0,19
1746570619426,HUM 5,A01,886509,Staff,32,0,50,18
1746570620456,HUM 5R,A01,886511,Zavodny; Tatiana Sophia,0,39,50,50
1746570621486,JAPN 180,A00,886407,Staff,16,0,40,24
1746570622513,LATI 50,A01,886409,Martin-Cabrera; Luis,4,0,22,18
1746570622513,LATI 50,A02,886410,Martin-Cabrera; Luis,19,0,22,3
1746570622513,LATI 50,A03,886411,Martin-Cabrera; Luis,21,0,22,1
1746570622513,LATI 50,A04,886412,Martin-Cabrera; Luis,9,0,22,13
1746570623540,LAWS 101,A00,907664,Staff,28,0,60,32
1746570624568,LIAB 1A,A00,889388,Saab; Dima,17,0,20,3
1746570625597,LIAB 1AX,A00,889389,El Cheddadi; Youniss,18,0,20,2
1746570626623,LIFR 1C,A00,889391,Van Moer; Vinciane G,8,0,20,12
1746570627649,LIFR 1CX,A00,889392,Van Moer; Vinciane G,7,0,20,13
1746570628678,LIFR 1D,A00,889393,Van Moer; Vinciane G,7,0,20,13
1746570629744,LIFR 1DX,A00,889394,Van Moer; Vinciane G,8,0,20,12
1746570630774,LIGN 7,A00,886923,Staff,24,0,50,26
1746570631802,LIGN 17,A00,886924,Kehler; Andrew Scott,125,0,150,25
1746570632831,LTAM 110,A00,889395,Staff,15,0,30,15
1746570633860,LTAM 110GS,A00,958010,Rodriguez; Bretton Sigfred,0,0,0,28
1746570634885,LTCH 101,A00,889397,Staff,23,0,25,2
1746570635909,LTCS 130,A00,889398,Staff,23,0,25,2
1746570636953,LTEA 138,A00,889399,Staff,24,0,40,16
1746570637982,LTEN 149,A00,889400,Wesling; Megan E.,0,3,25,25
1746570639007,LTEN 169,A00,889401,Staff,20,0,25,5
1746570640032,LTEN 180,A00,889402,Staff,10,0,15,5
1746570641062,LTEN 181,A00,889403,Staff,21,0,25,4
1746570642088,LTWL 100,A00,889404,Myerston Santana; Jacobo,2,0,25,23
1746570643113,LTWL 180GS,A00,889405,Staff,0,0,20,20
1746570644138,LTWL 181,A00,889406,Staff,16,0,25,9
1746570645163,LTWL 184,A00,889475,Mukherjee; Silpa,22,0,25,3
1746570646189,LTWR 102C,A00,889486,Staff,29,0,30,1
1746570647214,LTWR 115W,A00,889491,Staff,0,2,15,15
1746570648240,MAE 8,A01,886905,Staff,0,2,0,0
1746570649270,MAE 11,A00,886906,Bandaru; Prabhakar,0,7,50,50
1746570650299,MAE 20,A00,886907,Evdokimenko; Ekaterina,43,0,70,27
1746570651324,MAE 30B,A00,886909,Ghazinejad; Maziar,26,0,45,19
1746570652349,MAE 101B,A00,886910,Saintillan; David,29,0,45,16
1746570653373,MAE 105,A00,886911,Bandaru; Prabhakar,18,0,50,32
1746570654403,MAE 107,B00,958024,Staff,8,0,50,42
1746570655432,MAE 143B,A00,886913,Bewley; Thomas R,6,0,40,34
1746570656457,MAE 148,A01,886915,Silberman; Jack,0,3,14,14
1746570657486,MAE 160,A00,886916,Evdokimenko; Ekaterina,31,0,60,29
1746570658515,MATH 3C,A01,889681,Staff,0,2,30,30
1746570658515,MATH 3C,A02,960048,Staff,24,0,30,6
1746570659550,MATH 10A,A01,889760,Staff,26,0,30,4
1746570659550,MATH 10A,A02,889783,Staff,29,0,30,1
1746570660580,MATH 10B,A01,889785,Verstraete; Jacques Allan,2,0,35,33
1746570660580,MATH 10B,A02,889795,Verstraete; Jacques Allan,4,0,35,31
1746570660580,MATH 10B,B01,889797,Verstraete; Jacques Allan,3,0,35,32
1746570660580,MATH 10B,B02,889828,Verstraete; Jacques Allan,3,0,35,32
1746570661618,MATH 10C,A01,889849,Habib; Yousaf,7,0,30,23
1746570661618,MATH 10C,A02,889852,Habib; Yousaf,14,0,30,16
1746570661618,MATH 10C,A03,889853,Habib; Yousaf,22,0,30,8
1746570661618,MATH 10C,A04,889858,Habib; Yousaf,20,0,30,10
1746570661618,MATH 10C,B01,889861,Staff,1,0,30,29
1746570661618,MATH 10C,B02,889862,Staff,24,0,30,6
1746570661618,MATH 10C,B03,889863,Staff,27,0,30,3
1746570661618,MATH 10C,B04,889967,Staff,23,0,30,7
1746570662649,MATH 18,A01,889974,Staff,7,0,30,23
1746570662649,MATH 18,A02,889977,Staff,20,0,30,10
1746570662649,MATH 18,B01,889984,Hardiman; Liam,21,0,30,9
1746570662649,MATH 18,B02,889985,Hardiman; Liam,25,0,30,5
1746570663677,MATH 20A,A01,889990,Suk; Andrew Hoon,30,0,35,5
1746570664708,MATH 20B,A01,889993,Ohm; Ko Woon,22,0,30,8
1746570664708,MATH 20B,A02,889994,Ohm; Ko Woon,30,0,30,0
1746570664708,MATH 20B,B01,889996,Ohm; Ko Woon,22,0,30,8
1746570664708,MATH 20B,B02,889997,Ohm; Ko Woon,23,0,30,7
1746570665739,MATH 20C,A01,889999,Hammock; Frances H,17,0,30,13
1746570665739,MATH 20C,A02,890003,Hammock; Frances H,23,0,30,7
1746570665739,MATH 20C,B01,890006,Hammock; Frances H,3,0,30,27
1746570665739,MATH 20C,B02,890007,Hammock; Frances H,12,0,30,18
1746570666765,MATH 20D,A01,890011,Cheng; Hsiao-Bing,1,1,30,29
1746570666765,MATH 20D,A02,890012,Cheng; Hsiao-Bing,14,0,30,16
1746570666765,MATH 20D,B01,890016,Cheng; Hsiao-Bing,13,0,30,17
1746570666765,MATH 20D,B02,890017,Cheng; Hsiao-Bing,13,0,30,17
1746570667790,MATH 20E,A01,890026,Harel; Guershon,1,0,30,29
1746570667790,MATH 20E,A02,890029,Harel; Guershon,23,0,30,7
1746570667790,MATH 20E,B01,890033,Harel; Guershon,7,0,30,23
1746570667790,MATH 20E,B02,890101,Harel; Guershon,21,0,30,9
1746570668814,MATH 102,A01,890104,Staff,17,0,30,13
1746570668814,MATH 102,A02,890105,Staff,27,0,30,3
1746570669843,MATH 103B,A01,890116,Salehi Golsefidy; Alireza,3,0,30,27
1746570669843,MATH 103B,B01,890118,Staff,0,3,34,34
1746570670875,MATH 109,A01,890121,Aliabadi Sr.; Mohsen,1,0,30,29
1746570670875,MATH 109,B01,890124,Upadrashta; Pranav Kumar,18,0,30,12
1746570671904,MATH 120A,A01,890126,Eggers; John Dietrich,13,0,30,17
1746570672933,MATH 142B,A01,890128,Ioana; Adrian,19,0,30,11
1746570672933,MATH 142B,A02,890129,Ioana; Adrian,13,0,30,17
1746570673962,MATH 154,A01,890174,Staff,0,0,30,30
1746570673962,MATH 154,A02,890182,Staff,0,0,30,30
1746570674988,MATH 168A,A01,890197,Dumitriu; Ioana,21,0,35,14
1746570676013,MATH 170A,A01,890240,Nie; Jiawang,1,0,30,29
1746570676013,MATH 170A,A02,890241,Nie; Jiawang,11,0,30,19
1746570676013,MATH 170A,A03,890249,Nie; Jiawang,23,0,30,7
1746570677040,MATH 170B,A01,957891,Nag; Panchali,13,0,35,22
1746570679094,MATH 181A,A01,908025,Staff,0,4,35,35
1746570679094,MATH 181A,A02,960115,Staff,27,0,35,8
1746570680120,MATH 181B,A01,959874,Staff,25,0,30,5
1746570681147,MATH 193B,A01,890265,Staff,0,4,35,35
1746570682172,MGT 4,A01,890311,Anderson; John Charles,42,0,88,46
1746570683202,MGT 5,A00,907740,Staff,13,0,98,85
1746570684231,MGT 12,A00,890312,Lindenberger; Wade Douglas,67,0,98,31
1746570685256,MGT 16,A00,957883,Staff,78,0,98,20
1746570687306,MGT 45,A00,890314,Pecore; Joseph P.,46,0,98,52
1746570688331,MGT 71,A00,890315,Staff,0,11,98,98
1746570689359,MGT 100,A00,890316,Yavorsky; Daniel Ryan,44,0,98,54
1746570690388,MGT 103,A00,890317,Ehrich; Kristine R,73,0,98,25
1746570691415,MGT 105,A00,890356,Bates; Kenneth Walter,0,8,98,98
1746570692445,MGT 112,A00,890360,Ehrich; Kristine R,55,0,98,43
1746570693471,MGT 127R,A00,907732,Zhu; Kevin Xiaoguo,23,0,98,75
1746570694537,MGT 131B,A00,890361,Anderson; John Charles,60,0,98,38
1746570695566,MGT 137,A00,890362,Lindenberger; Wade Douglas,65,0,98,33
1746570696592,MGT 160,A00,890369,Johnson; Erik Barry,9,0,98,89
1746570698650,MGT 164,A00,890372,Zimmermann; Carsten,0,40,98,98
1746570699675,MGT 180,A00,890374,Bliss; Barbara Ann,12,0,98,86
1746570700702,MMW 15,A01,886414,Chang; Edmond Yi-Teh,0,12,28,28
1746570700702,MMW 15,A02,886415,Chang; Edmond Yi-Teh,0,8,28,28
1746570700702,MMW 15,A03,886416,Chang; Edmond Yi-Teh,0,8,28,28
1746570700702,MMW 15,A04,886417,Chang; Edmond Yi-Teh,0,8,28,28
1746570700702,MMW 15,B01,886419,Chang; Edmond Yi-Teh,0,7,28,28
1746570700702,MMW 15,B02,886420,Chang; Edmond Yi-Teh,0,8,28,28
1746570700702,MMW 15,B03,886421,Chang; Edmond Yi-Teh,0,7,28,28
1746570700702,MMW 15,B04,886422,Chang; Edmond Yi-Teh,0,8,28,28
1746570700702,MMW 15,C01,886424,Staff,0,9,28,28
1746570700702,MMW 15,C02,886425,Staff,0,8,28,28
1746570700702,MMW 15,C03,886426,Staff,0,8,28,28
1746570700702,MMW 15,C04,886427,Staff,0,8,28,28
1746570700702,MMW 15,C05,958038,Staff,0,8,28,28
1746570700702,MMW 15,C06,958039,Staff,1,8,28,27
1746570701728,MMW 15GS,A00,906910,Patterson; Patrick H.,4,0,28,24
1746570702758,MMW 122R,A01,886429,Rahimi; Babak,0,13,28,28
1746570702758,MMW 122R,A02,886430,Rahimi; Babak,0,12,28,28
1746570702758,MMW 122R,A03,958040,Rahimi; Babak,0,11,28,28
1746570703789,MUS 1A,A01,890937,Staff,2,0,25,23
1746570703789,MUS 1A,A02,891035,Staff,6,0,25,19
1746570703789,MUS 1A,C01,958912,Staff,24,0,25,1
1746570703789,MUS 1A,C02,958913,Staff,25,0,25,0
1746570705839,MUS 2AK,A00,957092,Ohnishi; Takae,15,0,15,0
1746570706866,MUS 4,A01,891044,Staff,2,0,25,23
1746570706866,MUS 4,A02,891045,Staff,23,0,25,2
1746570706866,MUS 4,B01,891048,Staff,17,0,25,8
1746570706866,MUS 4,B02,891050,Staff,25,0,25,0
1746570707890,MUS 5,A01,957506,Dubnov; Shlomo,0,0,25,25
1746570707890,MUS 5,A02,957622,Dubnov; Shlomo,13,0,25,12
1746570707890,MUS 5,A03,957623,Dubnov; Shlomo,20,0,25,5
1746570708920,MUS 6,A01,891053,Freitas Caetano; Marcelo,24,0,25,1
1746570708920,MUS 6,A02,891054,Freitas Caetano; Marcelo,23,0,25,2
1746570709943,MUS 7,A01,891081,Staff,0,0,25,25
1746570709943,MUS 7,A02,891082,Staff,3,0,25,22
1746570710972,MUS 8GS,A00,891118,Borgo; David Garcia,1,0,25,24
1746570711999,MUS 11,A01,891140,Staff,9,0,25,16
1746570711999,MUS 11,A02,891141,Staff,22,0,25,3
1746570713024,MUS 13,A01,891143,Staff,8,0,25,17
1746570713024,MUS 13,A02,891144,Staff,24,0,25,1
1746570714054,MUS 15,A01,891146,Staff,9,0,25,16
1746570714054,MUS 15,A02,891148,Staff,21,0,25,4
1746570714054,MUS 15,B01,891150,Staff,18,0,25,7
1746570714054,MUS 15,B02,891151,Staff,25,0,25,0
1746570715080,MUS 20,A01,891153,Staff,5,0,20,15
1746570715080,MUS 20,A02,891155,Staff,14,0,20,6
1746570716105,MUS 80,A00,891156,Staff,19,0,25,6
1746570716105,MUS 80,B00,891157,Staff,23,0,25,2
1746570717135,MUS 130,A00,891158,Ohnishi; Takae,35,0,35,0
1746570718161,MUS 150GS,A01,891160,Borgo; David Garcia,1,0,25,24
1746570719186,MUS 170,A01,891162,Freitas Caetano; Marcelo,20,0,25,5
1746570719186,MUS 170,A02,891164,Freitas Caetano; Marcelo,21,0,25,4
1746570720214,NANO 11,A00,886220,Vazquez Mena; Oscar,13,0,15,2
1746570721239,NANO 15,A01,886222,Drews; Aaron,4,0,7,3
1746570722265,NANO 104,A00,886224,Sirbuly; Donald,17,0,25,8
1746570723292,PH 40,A00,886528,Staff,23,0,40,17
1746570724317,PH 45,A01,886799,Staff,35,0,40,5
1746570725347,PH 110,A00,886802,Staff,0,7,40,40
1746570726375,PH 172,A00,906716,Staff,19,0,35,16
1746570727399,PH 191,A00,886803,Staff,6,0,40,34
1746570728426,PHIL 1,A00,889500,Staff,20,0,30,10
1746570729466,PHIL 10,A01,889549,Grush; Rick Scott,15,0,22,7
1746570729466,PHIL 10,A02,889551,Grush; Rick Scott,22,0,22,0
1746570730494,PHIL 28,A01,889559,Lamey; Andy M.,0,2,31,31
1746570730494,PHIL 28,A02,889561,Lamey; Andy M.,0,1,30,30
1746570730494,PHIL 28,A03,889572,Lamey; Andy M.,0,1,30,30
1746570731519,PHIL 35,A00,907839,Staff,13,0,15,2
1746570732544,PHIL 60,A00,889574,Staff,73,0,90,17
1746570733569,PHIL 101,A00,958004,Staff,12,0,15,3
1746570735626,PHIL 136,A00,889582,Fulkerson; Matthew Todd,26,0,45,19
1746570736650,PHIL 163,A01,889601,Staff,21,0,30,9
1746570736650,PHIL 163,B01,889606,Brandt; Reuven A,0,3,0,0
1746570737679,PHIL 164,A00,889610,Staff,16,0,30,14
1746570738703,PHIL 165,A00,889613,Staff,22,0,30,8
1746570739729,PHYS 1A,A00,886431,Staff,26,0,70,44
1746570740758,PHYS 1AL,001,886432,Tsai; Philbert S,0,2,30,30
1746570740758,PHYS 1AL,002,886436,Tsai; Philbert S,11,0,30,19
1746570741784,PHYS 1B,A00,886439,Staff,185,0,240,55
1746570742810,PHYS 1BL,001,886441,Tsai; Philbert S,0,4,30,30
1746570742810,PHYS 1BL,002,886444,Tsai; Philbert S,2,0,30,28
1746570743834,PHYS 1C,A00,896092,Arnold; Kam S,78,0,146,68
1746570744859,PHYS 1CL,001,886448,Tsai; Philbert S,0,0,30,30
1746570744859,PHYS 1CL,002,886449,Tsai; Philbert S,1,0,30,29
1746570744859,PHYS 1CL,003,886450,Tsai; Philbert S,16,0,30,14
1746570744859,PHYS 1CL,004,886451,Tsai; Philbert S,15,0,30,15
1746570745889,PHYS 2B,A01,886457,Staff,68,0,115,47
1746570746915,PHYS 2C,A01,886460,Shotwell; Brian,0,9,65,65
1746570747941,PHYS 2CL,A01,886467,Staff,0,4,28,28
1746570747941,PHYS 2CL,A02,886468,Staff,0,3,28,28
1746570748965,PHYS 2D,A01,886470,Staff,10,0,50,40
1746570749991,PHYS 4B,A01,886475,Grinstein; Benjamin,22,0,40,18
1746570751019,POLI 5,A00,891173,Desposato; Scott,7,0,25,18
1746570752043,POLI 5D,A01,891175,Staff,5,0,5,0
1746570752043,POLI 5D,B01,891178,Staff,5,0,5,0
1746570753071,POLI 11,A00,891179,Ferree; Karen E,2,0,35,33
1746570754097,POLI 12,A00,891180,Staff,16,0,30,14
1746570755122,POLI 27,A01,891182,Staff,12,0,75,63
1746570756147,POLI 30,A00,891183,Staff,8,0,50,42
1746570757172,POLI 100B,A00,891244,Staff,5,1,35,30
1746570758200,POLI 100I,A00,891247,Staff,7,0,30,23
1746570759228,POLI 104J,A00,891248,Nichter; Maysa,14,0,30,16
1746570760254,POLI 104U,A00,891250,Nichter; Maysa,2,0,30,28
1746570762309,POLI 110B,A00,891255,Wiens; David,19,0,25,6
1746570763339,POLI 112A,A00,891256,Wiens; David,6,0,25,19
1746570764364,POLI 114BR,A00,891261,Staff,19,0,30,11
1746570765389,POLI 117R,A00,891262,Forman; Fonna,0,6,50,50
1746570766417,POLI 118,A00,891264,Ingham; Sean,17,0,25,8
1746570767442,POLI 124A,A00,891265,Staff,18,0,20,2
1746570768469,POLI 125D,A00,891266,Nichter; Simeon C,2,0,25,23
1746570769494,POLI 126,A00,891268,Nichter; Simeon C,7,0,25,18
1746570770519,POLI 126AA,A00,891272,Staff,16,0,25,9
1746570771546,POLI 130AA,A00,891273,Staff,15,0,20,5
1746570772573,POLI 134AA,A00,891274,Staff,4,0,20,16
1746570774623,POLI 138,A00,891278,Staff,21,0,25,4
1746570775654,POLI 142K,A00,891280,Staff,10,0,25,15
1746570776679,POLI 142M,A00,891281,Gartzke; Erik,16,0,30,14
1746570777709,POLI 142P,A00,891284,Staff,20,0,30,10
1746570778737,POLI 143,A00,891285,Gartzke; Erik,12,0,30,18
1746570779767,POLI 153,A00,891286,Staff,19,0,20,1
1746570781825,POLI 175,A00,891290,Staff,15,0,20,5
1746570782849,PSYC 1,A00,890674,Steiner; Eric Tomas,0,11,45,45
1746570783877,PSYC 2,A00,890676,Albright; Thomas D,21,0,35,14
1746570784904,PSYC 3,A00,890679,Staff,17,0,20,3
1746570785933,PSYC 6,A00,959858,Staff,20,0,20,0
1746570786965,PSYC 60,A01,890684,Rickard; Timothy C.,0,5,45,45
1746570787992,PSYC 70,A01,890689,Geller; Emma Harlan,7,0,30,23
1746570789018,PSYC 71,A01,959860,Staff,21,0,25,4
1746570790046,PSYC 100,A00,890690,Lacefield; Katharine I,0,50,180,180
1746570791072,PSYC 102,A00,890695,Staff,18,0,40,22
1746570792098,PSYC 105,A00,890699,Geller; Emma Harlan,70,0,100,30
1746570793125,PSYC 106,A00,890701,Gorman; Michael R.,6,0,30,24
1746570794152,PSYC 108,A00,890704,Adrian; Julia Anna,0,28,50,50
1746570795178,PSYC 118,A01,890712,Staff,11,0,30,19
1746570796202,PSYC 124,A00,890716,Chapman; Eddie Nathaniel,25,0,60,35
1746570797232,PSYC 131,A00,890717,Anagnostaras; Stephan,0,8,80,80
1746570798261,PSYC 137,A00,890719,Winkielman; Piotr,0,11,30,30
1746570799287,PSYC 144,A00,890721,Adrian; Julia Anna,0,9,45,45
1746570800312,PSYC 162,A00,890805,Staff,0,0,75,75
1746570801341,PSYC 169,A00,890810,Staff,0,14,30,30
1746570802365,PSYC 172,A00,890814,Gorman; Michael R.,9,0,30,21
1746570803389,PSYC 181,A00,890818,Anagnostaras; Stephan,9,0,200,191
1746570804419,PSYC 184,A00,959861,Staff,168,0,175,7
1746570805448,PSYC 189,A00,890823,Staff,0,2,30,30
1746570806479,PSYC 191,A00,890884,Rickard; Timothy C.,0,12,35,35
1746570807509,PSYC 193,A00,890913,Staff,19,0,30,11
1746570807509,PSYC 193,B00,890914,Chapman; Eddie Nathaniel,24,0,30,6
1746570808536,PSYC 193L,A01,890918,Lowe; Angela Beth,20,0,30,10
1746570808536,PSYC 193L,B01,890921,Hurwitz; Ethan Scott,20,0,30,10
1746570808536,PSYC 193L,C01,890928,Staff,30,0,30,0
1746570809562,RELI 149,A00,886806,Rahimi; Babak,23,0,40,17
1746570810588,SE 9,A01,886814,Staff,7,0,20,13
1746570811615,SE 101B,A01,886816,Chadha; Mayank,4,0,35,31
1746570812644,SE 110B,A00,886818,Zhu; Qiang,4,0,75,71
1746570813674,SE 125,A01,886830,Staff,10,0,30,20
1746570814699,SE 130B,A01,886835,Staff,14,0,40,26
1746570815727,SE 131A,A01,886838,Krysl; Petr,34,0,55,21
1746570816755,SE 154,A00,886840,Staff,29,0,50,21
1746570817782,SE 164GS,A01,886849,Staff,6,0,20,14
1746570818806,SE 167GS,A01,886853,Staff,6,0,20,14
1746570819829,SIO 25,A01,890107,Staff,19,0,30,11
1746570820859,SIO 45,A00,890109,Cook; Geoffrey W,117,0,200,83
1746570821884,SIO 109R,A00,890110,Forman; Fonna,0,16,20,20
1746570822909,SIO 187,A01,890114,Kacev; David,15,0,40,25
1746570823934,SOCI 1,A01,890431,Thorpe; Charles Robert,15,0,30,15
1746570823934,SOCI 1,A02,890518,Thorpe; Charles Robert,30,0,30,0
1746570824965,SOCI 2,A01,957978,Staff,25,0,25,0
1746570824965,SOCI 2,A02,957979,Staff,23,0,25,2
1746570825996,SOCI 20,A01,890523,Calderon-Zaks; Michael Aar,21,0,30,9
1746570825996,SOCI 20,A02,890526,Calderon-Zaks; Michael Aar,29,0,30,1
1746570827029,SOCI 30,A01,890533,Pardo Guerra; Juan Pablo,37,0,40,3
1746570828055,SOCI 40,A01,890535,Staff,27,0,45,18
1746570829082,SOCI 104Q,A00,890559,Staff,18,0,30,12
1746570830107,SOCI 106,A00,890560,Arnal; Maud Marie Leonie,20,0,30,10
1746570831138,SOCI 110,A00,890567,Holkenbrink-Monk; Charlene,19,0,30,11
1746570832166,SOCI 112,A00,890568,Victoria Torres; Pablo,2,0,55,53
1746570833190,SOCI 115,A00,890597,Arnal; Maud Marie Leonie,28,0,45,17
1746570835245,SOCI 121,A00,890604,Pardo Guerra; Juan Pablo,38,0,45,7
1746570836270,SOCI 126,A01,890608,Staff,8,0,10,2
1746570837297,SOCI 127,A00,890609,Staff,18,0,30,12
1746570838327,SOCI 131,A00,890610,Thorpe; Charles Robert,37,0,45,8
1746570839353,SOCI 135,A00,890615,Payne; Christine Anna,13,0,45,32
1746570840386,SOCI 139,A00,890620,Staff,38,0,45,7
1746570841412,SOCI 148E,A00,890622,Calderon-Zaks; Michael Aar,36,0,45,9
1746570842437,SOCI 150,A00,890623,Kohler; Kristopher M.,31,0,45,14
1746570843463,SOCI 157,A00,890625,Jules-Rosette; Bennetta W.,18,0,20,2
1746570844487,SOCI 160,A00,890627,Payne; Christine Anna,21,0,45,24
1746570845513,SYN 1,A00,886855,Fish; Gwendolyn Anne,0,0,0,0
1746570845513,SYN 1,B00,906086,Fish; Gwendolyn Anne,0,2,0,2
1746570846540,SYN 2R,A00,886860,Staff,0,17,15,15
1746570846540,SYN 2R,B00,906106,Atkinson; Arthur Laird,0,16,15,15
1746570847577,SYN 100,A01,886866,Browne; Emily,0,28,20,20
1746570847577,SYN 100,B01,906128,Rock; Martin,0,5,20,20
1746570847577,SYN 100,C01,906140,Deavenport; James Cary,0,3,20,20
1746570847577,SYN 100,D01,907816,Deavenport; James Cary,0,5,20,20
1746570848603,TDAC 1,A00,890286,Walsh; Kim C.,8,0,20,12
1746570849632,TDAC 101,A00,890296,Basso; Beatrice,15,0,20,5
1746570850660,TDDE 131,A00,890297,Staff,47,0,50,3
1746570851686,TDDM 1,A00,890287,Weinberg; Sadie,25,0,30,5
1746570852710,TDGE 11,A00,890288,Fulton; Julia,137,0,200,63
1746570852710,TDGE 11,B00,890289,Castro; Robert Jess,184,0,200,16
1746570853737,TDGE 25,B00,957359,Walsh; Kim C.,4,0,20,16
1746570854762,TDGE 40,A01,890292,Power; Jade Yukana,27,0,30,3
1746570855787,TDGE 124,A00,890298,Havis; Allan,0,1,50,50
1746570856815,TDGE 131R,A00,890299,Burelle; Julie Sara Veronique,15,0,42,27
1746570857846,TDHT 101,A00,890300,Staff,10,0,20,10
1746570858876,TDHT 109,A01,890302,Anderson; Mysia Anyse,31,0,40,9
1746570859922,TDMV 1,A00,890293,Arcidiacono; Kristin,18,0,30,12
1746570860948,TDMV 2,A00,890294,Weinberg; Sadie,23,0,30,7
1746570861977,TDMV 3,A00,957878,Arcidiacono; Kristin,28,0,30,2
1746570864027,TDMV 138,A00,890304,Jun; Grace Shin Hae,25,0,40,15
1746570865056,TDMV 140,A00,890305,Corrales; Joseph Bernales,25,0,30,5
1746570866085,TDMV 142,A00,890307,Caligagan; Tony,32,0,40,8
1746570867110,TDMV 144,A00,890308,Camaya; Michelle Ann,25,0,30,5
1746570868133,TDPW 1,A00,890295,Stein; Deborah Isobel,3,0,20,17
1746570869159,USP 2,A01,890272,Lerner; Amy M,6,0,20,14
1746570870182,USP 3,A01,890274,Staff,12,0,30,18
1746570871211,USP 15,A01,890276,Sun; Feiyang,16,0,30,14
1746570872239,USP 25,A00,890277,Shenkman; Michael Thomas,19,0,25,6
1746570873265,USP 138,A00,890278,Staff,14,0,25,11
1746570874293,USP 143,A00,890279,Staff,22,0,70,48
1746570875322,USP 144,A00,890280,Chowdhury; Muhammed Zohir,16,0,30,14
1746570876347,USP 150,A00,890281,Boomhower; Matthew Charles,4,0,30,26
1746570877375,USP 151,A00,890282,Staff,16,0,20,4
1746570878400,USP 162,A00,890283,Andrews; Abigail Leslie,16,0,20,4
1746570879424,USP 168,A00,920477,Kwak; Nancy,0,0,5,5
1746570880450,USP 181,A00,890284,Staff,3,0,20,17
1746570881476,USP 191A,A00,890285,Staff,12,0,20,8
1746570882503,VIS 101,A00,886512,Staff,26,0,75,49
1746570883528,VIS 103,A00,886513,Cruz; Edwin Teddy,61,0,75,14
1746570884553,VIS 108,A00,886514,Staff,3,0,15,12
1746570885578,VIS 127P,A00,886515,Shen; Kuiyi,80,0,146,66
1746570886604,VIS 149,A00,886516,Yoldas; Pinar,0,0,15,15
1746570887630,VIS 164,A00,886526,Erdmann; Dean,19,0,22,3
1746570888659,VIS 194S,A00,886527,Staff,61,0,75,14
1746570889685,WCWP 10A,C00,886484,Martiniuk; Jill,12,0,15,3
1746570890712,WCWP 10B,A00,886490,Uriarte; Emma,0,0,15,15
1746570890712,WCWP 10B,B00,886491,Dhir; Simrita,9,0,15,6
1746570890712,WCWP 10B,C00,886492,Ornelas; Tricia,0,0,15,15
1746570891744,WCWP 100,A00,886494,Young; Mark T,0,6,15,15
1746570893837,AAS 10,A01,886199,Childs; Dennis R.,0,3,0,0
1746570894865,ANAR 104,A01,886940,Shtienberg; Gilad,27,0,30,3
1746570895891,ANAR 120,A00,886953,Staff,12,0,20,8
1746570896918,ANBI 148,A01,886955,Wilder; Linnea Lorene,30,0,40,10
1746570898971,ANSC 122,A00,886957,Staff,25,0,30,5
1746570900002,ANSC 150,A00,886958,Sloane; Julia Kathryn,2,0,15,13
1746570901026,ANSC 156,A00,886959,Jenkins; Janis A.,0,1,15,15
1746570902054,ANSC 180,A00,886960,Staff,11,0,17,6
1746570903084,ANSC 188,A00,886961,Jassal; Aftab,9,0,25,16
1746570904115,ANSC 190,A00,886962,Jassal; Aftab,14,0,25,11
1746570905145,ANSC 191,A00,886963,Staff,18,0,20,2
1746570906174,ANTH 3,A01,891689,Staff,17,0,20,3
1746570907199,ANTH 5,A00,886933,Semendeferi; Ekaterini,16,0,20,4
1746570908228,ANTH 10,A00,886934,Staff,0,12,30,30
1746570909252,ANTH 21,A01,886936,Staff,41,0,60,19
1746570910279,ANTH 23,A01,886938,Staff,92,0,100,8
1746570911304,ANTH 105,A00,886964,Stewart; Alexander B,84,0,100,16
1746570912333,ANTH 108,A00,886965,Pedersen; David,9,0,20,11
1746570913371,AWP 10,001,886147,Staff,0,0,0,0
1746570913371,AWP 10,002,886148,Staff,0,0,0,0
1746570913371,AWP 10,003,886149,Staff,0,0,0,0
1746570913371,AWP 10,004,886150,Staff,0,0,0,0
1746570913371,AWP 10,005,886151,Staff,0,0,0,0
1746570913371,AWP 10,006,886152,Staff,0,0,0,0
1746570913371,AWP 10,007,886153,Staff,0,0,0,0
1746570913371,AWP 10,008,886154,Staff,0,0,0,0
1746570913371,AWP 10,009,886155,Staff,0,0,0,0
1746570913371,AWP 10,010,886156,Staff,0,0,0,0
1746570913371,AWP 10,011,886158,Staff,0,0,0,0
1746570913371,AWP 10,012,886160,Staff,0,0,0,0
1746570913371,AWP 10,013,886161,Staff,0,0,0,0
1746570913371,AWP 10,014,886162,Staff,0,0,0,0
1746570913371,AWP 10,015,886163,Staff,0,0,0,0
1746570913371,AWP 10,016,886164,Staff,0,0,0,0
1746570913371,AWP 10,017,886165,Staff,0,0,0,0
1746570913371,AWP 10,018,886166,Staff,0,0,0,0
1746570913371,AWP 10,019,886168,Staff,0,0,0,0
1746570913371,AWP 10,020,886170,Staff,0,0,0,0
1746570913371,AWP 10,021,886172,Staff,0,0,0,0
1746570914401,AWP 10R,001,886173,Staff,0,1,0,0
1746570914401,AWP 10R,002,886174,Staff,0,1,0,0
1746570914401,AWP 10R,003,886175,Staff,0,0,0,0
1746570914401,AWP 10R,004,886176,Staff,0,0,0,0
1746570914401,AWP 10R,005,886177,Staff,0,0,0,0
1746570914401,AWP 10R,006,886178,Staff,0,0,0,0
1746570914401,AWP 10R,007,886179,Staff,0,0,0,0
1746570914401,AWP 10R,008,886181,Staff,0,0,0,0
1746570914401,AWP 10R,009,886182,Staff,0,0,0,0
1746570914401,AWP 10R,010,886183,Staff,0,0,0,0
1746570914401,AWP 10R,011,886184,Staff,0,0,0,0
1746570914401,AWP 10R,012,886185,Staff,0,0,0,0
1746570914401,AWP 10R,013,886186,Staff,0,0,0,0
1746570914401,AWP 10R,014,886187,Staff,0,0,0,0
1746570914401,AWP 10R,015,886188,Staff,0,0,0,0
1746570914401,AWP 10R,016,886189,Staff,0,0,0,0
1746570914401,AWP 10R,017,960532,Staff,0,0,0,0
1746570914401,AWP 10R,018,960533,Staff,0,0,0,0
1746570914401,AWP 10R,019,960534,Staff,0,0,0,0
1746570914401,AWP 10R,020,960538,Staff,0,0,0,0
1746570914401,AWP 10R,021,960540,Staff,0,0,0,0
1746570914401,AWP 10R,022,960541,Staff,0,0,0,0
1746570914401,AWP 10R,023,960542,Staff,0,0,0,0
1746570914401,AWP 10R,024,960544,Staff,0,0,0,0
1746570914401,AWP 10R,025,960545,Staff,0,0,0,0
1746570914401,AWP 10R,026,960548,Staff,0,0,0,0
1746570915426,AWP 102R,A00,886190,Staff,0,0,0,0
1746570915426,AWP 102R,B00,886191,Staff,0,0,0,0
1746570916449,BENG 100,A01,886193,Staff,17,0,30,13
1746570917474,BENG 122A,A01,886195,Hasty; Jeff M,13,0,30,17
1746570918502,BENG 166A,A00,886196,Sah; Robert Lie-Yuan,0,2,30,30
1746570919530,BENG 190,A00,958050,Khojah; Reem I,20,0,25,5
1746570920558,BIBC 102,A01,894320,Staff,0,0,46,46
1746570920558,BIBC 102,A02,894321,Staff,0,0,46,46
1746570920558,BIBC 102,A03,894344,Staff,7,0,46,39
1746570920558,BIBC 102,A04,894345,Staff,27,0,47,20
1746570921582,BICD 100R,A01,894365,Smith; Laurie,0,3,58,58
1746570921582,BICD 100R,A02,894366,Smith; Laurie,0,5,58,58
1746570921582,BICD 100R,A03,894367,Smith; Laurie,0,0,59,59
1746570921582,BICD 100R,A04,959869,Smith; Laurie,40,0,59,19
1746570922612,BICD 136,A01,894383,Gustafson-Brown; Cindy,14,0,50,36
1746570923640,BIEB 102,A01,894494,Butler; Shannon Rhey,51,0,130,79
1746570925689,BIEB 150,A01,894617,Wills; Christopher,3,0,20,17
1746570925689,BIEB 150,A02,894631,Wills; Christopher,3,0,20,17
1746570925689,BIEB 150,A03,894937,Wills; Christopher,3,0,20,17
1746570925689,BIEB 150,A04,894946,Wills; Christopher,5,0,20,15
1746570926712,BIEB 194,A00,906141,Kurle; Carolyn M.,6,0,20,14
1746570927737,BILD 1,A01,894154,Staff,3,0,19,16
1746570927737,BILD 1,A02,894155,Staff,14,0,19,5
1746570927737,BILD 1,A03,894160,Staff,13,0,19,6
1746570927737,BILD 1,A04,894161,Staff,15,0,18,3
1746570928764,BILD 2,A01,894168,Staff,0,0,50,50
1746570928764,BILD 2,A02,894169,Staff,0,0,50,50
1746570928764,BILD 2,A03,894179,Staff,0,0,50,50
1746570928764,BILD 2,A04,894203,Staff,24,0,50,26
1746570929793,BILD 3,A01,894213,Staff,22,0,31,9
1746570929793,BILD 3,A02,894214,Staff,26,0,31,5
1746570929793,BILD 3,A03,894235,Staff,28,0,31,3
1746570929793,BILD 3,A04,894236,Staff,28,0,32,4
1746570930820,BILD 4,A01,894253,Reuther; Keefe,6,0,24,18
1746570930820,BILD 4,A02,894258,Reuther; Keefe,16,0,24,8
1746570931847,BILD 5,A01,894276,Reuther; Keefe,35,0,50,15
1746570931847,BILD 5,A02,894277,Reuther; Keefe,45,0,50,5
1746570931847,BILD 5,A03,894290,Reuther; Keefe,44,0,50,6
1746570931847,BILD 5,A04,894291,Reuther; Keefe,48,0,50,2
1746570932881,BILD 24,A01,894297,Pirino; Giorgia,40,0,60,20
1746570933908,BIMM 100,B01,958915,Staff,71,0,100,29
1746570934935,BIMM 101,A01,895017,McDonnell; Lisa Marie,0,5,24,24
1746570934935,BIMM 101,A02,895018,McDonnell; Lisa Marie,0,5,24,24
1746570934935,BIMM 101,B01,895020,McDonnell; Lisa Marie,0,6,24,24
1746570934935,BIMM 101,B02,895021,McDonnell; Lisa Marie,0,4,24,24
1746570935965,BIMM 110,A01,895023,Staff,1,0,25,24
1746570935965,BIMM 110,A02,895024,Staff,9,0,25,16
1746570935965,BIMM 110,A03,895025,Staff,18,0,25,7
1746570935965,BIMM 110,A04,895031,Staff,20,0,25,5
1746570936995,BIMM 120,A01,895114,Gustafson-Brown; Cindy,14,0,28,14
1746570936995,BIMM 120,A02,895126,Gustafson-Brown; Cindy,21,0,27,6
1746570938025,BIPN 100,A01,895130,Yang; Mingyu,0,0,38,38
1746570938025,BIPN 100,A02,895131,Yang; Mingyu,32,0,38,6
1746570938025,BIPN 100,A03,895132,Yang; Mingyu,32,0,38,6
1746570938025,BIPN 100,A04,895133,Yang; Mingyu,27,0,36,9
1746570939051,BIPN 120,A01,895135,Cooke; James Edward,0,3,13,13
1746570939051,BIPN 120,A02,895136,Cooke; James Edward,0,1,13,13
1746570939051,BIPN 120,A03,895137,Cooke; James Edward,0,3,13,13
1746570939051,BIPN 120,A04,895156,Cooke; James Edward,0,2,11,11
1746570940082,BIPN 134,A01,895235,Cooke; James Edward,0,2,25,25
1746570940082,BIPN 134,A02,895237,Cooke; James Edward,0,0,25,25
1746570940082,BIPN 134,A03,895240,Cooke; James Edward,3,0,25,22
1746570940082,BIPN 134,A04,895270,Cooke; James Edward,20,0,25,5
1746570941110,BIPN 189,A00,892103,Staff,0,14,14,14
1746570943165,BISP 194,A00,958008,Staff,0,2,0,0
1746570944189,CAT 124,A01,922009,Staff,0,5,20,20
1746570945221,CAT 125R,A00,886390,Morales; Celeste Georgianna,0,2,20,20
1746570945221,CAT 125R,B00,886391,Irwin; Matthew Joseph,0,4,20,20
1746570945221,CAT 125R,C00,886392,Smith; Lauryn Alissa,0,2,20,20
1746570945221,CAT 125R,D00,886393,Vanderschuit; Maya Alysia,0,3,20,20
1746570945221,CAT 125R,E00,886394,Marchisotto; Jennifer Anne,0,3,20,20
1746570946247,CENG 15,A01,886218,Drews; Aaron,3,0,8,5
1746570947272,CENG 113,A00,886219,Opatkiewicz; Justin Paul,15,0,25,10
1746570948299,CGS 101,A00,887044,Staff,7,0,20,13
1746570949326,CGS 105,A01,887046,Staff,14,0,25,11
1746570950356,CGS 112,A00,887047,Cuong; Marisol,12,0,15,3
1746570951385,CGS 113,A00,887048,Staff,23,0,30,7
1746570952428,CGS 120,A00,887049,Staff,10,0,17,7
1746570953458,CHEM 6A,A01,886336,Lam; Tin Yiu,38,0,50,12
1746570953458,CHEM 6A,A02,886338,Lam; Tin Yiu,37,0,50,13
1746570954482,CHEM 6B,A01,886341,Hopkins; Patrycja Anna,16,0,50,34
1746570954482,CHEM 6B,A02,886343,Hopkins; Patrycja Anna,42,0,50,8
1746570955509,CHEM 6C,A01,886346,Albizati; Kim F.,0,2,50,50
1746570955509,CHEM 6C,A02,886348,Albizati; Kim F.,23,0,50,27
1746570956536,CHEM 40A,A01,886352,Klosterman; Jeremy K,65,0,100,35
1746570957561,CHEM 40B,A01,886356,Klosterman; Jeremy K,0,23,100,100
1746570958586,CHEM 41B,A01,886360,Theodorakis; Emmanuel,25,0,50,25
1746570958586,CHEM 41B,A02,886362,Theodorakis; Emmanuel,47,0,50,3
1746570959611,CHIN 165A,A00,886382,Xu; Li,18,0,20,2
1746570960637,CLAS 120,A00,886387,Myerston Santana; Jacobo,33,0,40,7
1746570961668,COGS 9,A01,886967,Shannon; Kyle Michael,42,0,60,18
1746570962693,COGS 11,A01,886969,Staff,10,0,30,20
1746570963718,COGS 14A,A01,886971,Staff,6,0,60,54
1746570964744,COGS 14B,A01,886973,Hoffman; Drew Ellen,4,0,60,56
1746570965774,COGS 18,A01,886975,Morgan; Eric,35,0,60,25
1746570966801,COGS 20,A01,886977,Staff,4,0,8,4
1746570966801,COGS 20,A02,886978,Staff,5,0,7,2
1746570967826,COGS 100,A01,907783,Staff,1,2,30,29
1746570968850,COGS 101B,A01,886980,Staff,0,3,48,48
1746570969877,COGS 101C,A01,886982,Delgado; Tania,0,5,44,44
1746570970906,COGS 102A,A01,886984,Johnson; Christine M.,4,0,30,26
1746570971933,COGS 118B,A01,886986,Staff,1,3,88,87
1746570972957,COGS 150,A01,886988,Bergen; Benjamin,22,0,50,28
1746570973984,COGS 153,A00,886989,Delgado; Tania,0,2,41,41
1746570975010,COGS 186,A01,886991,Staff,0,0,32,32
1746570976037,COGS 187A,A01,886993,Boyle; Mary E. T.,7,0,30,23
1746570977064,COGS 189,A00,886994,Staff,0,1,30,30
1746570978093,COMM 10,A01,886996,Staff,0,0,20,21
1746570978093,COMM 10,A02,886997,Staff,12,0,20,8
1746570978093,COMM 10,A03,959845,Staff,19,0,20,1
1746570979121,COMM 20,A01,886999,Leuning; Grant Maurstad,24,0,40,16
1746570981177,COMM 100A,A01,887002,Staff,0,0,20,25
1746570981177,COMM 100A,A02,887003,Staff,6,0,20,14
1746570982202,COMM 100B,A01,887005,Staff,0,8,20,24
1746570983228,COMM 106D,A00,887006,Staff,13,0,40,27
1746570984258,COMM 110G,A00,887007,Whitworth-Smith; Andrew C,12,0,40,28
1746570985287,COMM 111B,A00,887008,Staff,31,0,40,9
1746570986312,COMM 113T,A00,887009,Abuelhiga; Soraya Jill,28,0,40,12
1746570986312,COMM 113T,B00,906733,Staff,40,0,40,0
1746570987341,COMM 145,A00,887010,Staff,12,0,40,28
1746570988366,COMM 146,A00,887054,Staff,31,0,40,9
1746570989391,COMM 190,A00,887012,Staff,8,0,23,15
1746570990418,CSE 8A,A50,887015,Cao; Yingjun,57,0,85,28
1746570991447,CSE 11,A01,887017,Cao; Yingjun,12,0,70,58
1746570992474,CSE 20,A01,887019,Staff,30,0,50,20
1746570993499,CSE 21,A01,887021,Staff,78,0,100,22
1746570993499,CSE 21,B01,892583,Braun; Oliver,45,0,50,5
1746570994525,CSE 30,A01,887025,Eldon; John,143,0,200,57
1746570995551,CSE 100,A01,887027,Staff,26,0,50,24
1746570995551,CSE 100,A02,887028,Staff,42,0,50,8
1746570996576,CSE 101,A01,887030,Braun; Oliver,74,0,100,26
1746570996576,CSE 101,B01,887032,Jones; Miles E,0,3,50,50
1746570996576,CSE 101,B02,887033,Jones; Miles E,0,2,50,50
1746570997605,CSE 105,A01,908084,Jones; Miles E,32,0,50,18
1746570997605,CSE 105,A02,908087,Jones; Miles E,31,0,50,19
1746570998632,CSE 135,A01,887035,Powell; Thomas Allan,0,5,50,50
1746570999656,CSE 142,A01,887037,Staff,8,0,60,52
1746571000683,CSE 142L,A01,887039,Staff,34,0,60,26
1746571001710,CSE 151A,A01,887041,Solares; Edwin A,47,0,100,53
1746571002735,CSE 175,A01,887043,Kumar; Rakesh,30,0,30,0
1746571003763,CSS 1,A01,886389,Staff,1,1,40,39
1746571004793,DSC 30,A01,908097,Liao; Soohyun Nam,47,0,75,28
1746571005823,DSC 40A,A01,908099,Shannon; Kyle Michael,30,0,50,20
1746571006849,DSC 40B,A01,908112,Staff,15,0,50,35
1746571007876,DSC 80,A01,908116,Staff,19,0,60,41
1746571008900,DSC 197,001,956863,Eldridge; Justin Matthew,9999,0,9999,0
1746571009930,ECE 5,A01,886400,Morris; Karcher William,1,0,6,5
1746571009930,ECE 5,A02,886401,Morris; Karcher William,3,0,6,3
1746571010956,ECE 148,A01,886403,Silberman; Jack,0,14,14,14
1746571011982,ECON 1,A01,887265,Crane; Meredith Helen,12,0,70,58
1746571011982,ECON 1,B01,887268,Staff,43,0,50,7
1746571013007,ECON 2,A01,887273,Crane; Meredith Helen,55,0,70,15
1746571014033,ECON 3,A01,887279,Rondina; Giacomo,32,0,70,38
1746571015098,ECON 4,A01,887282,Anderson; John Charles,0,2,10,10
1746571016123,ECON 5,A01,887285,Staff,34,0,45,11
1746571016123,ECON 5,B01,887292,Staff,41,0,45,4
1746571017153,ECON 100A,A01,887337,Newhouse; Herbert S,54,0,70,16
1746571017153,ECON 100A,B01,887349,Staff,45,0,50,5
1746571018177,ECON 100B,A01,887361,Du; Songzi,29,0,70,41
1746571019204,ECON 100C,A01,887445,Newhouse; Herbert S,59,0,70,11
1746571020233,ECON 105,A00,887488,Vespa; Emanuel Ignacio,23,0,35,12
1746571021258,ECON 109,A01,887506,Shishkin; Denis,28,0,35,7
1746571022284,ECON 110A,A01,887568,Alon; Titan Michael,0,3,35,35
1746571022284,ECON 110A,B01,907601,Alon; Titan Michael,20,0,35,15
1746571023313,ECON 110B,A01,887598,Levkoff; Steven B.,0,24,70,70
1746571024339,ECON 112,A00,887599,Rondina; Giacomo,19,0,35,16
1746571025369,ECON 120A,A01,887603,Dai; Yinlin,35,0,70,35
1746571026395,ECON 120C,A01,887608,Sun; Yixiao,0,1,35,35
1746571026395,ECON 120C,B01,887614,Sun; Yixiao,0,0,35,35
1746571027420,ECON 138,A00,887621,Bharadwaj; Prashant,0,21,20,20
1746571028445,ECON 144,A00,958007,Squires; Dale E,12,0,35,23
1746571029471,ECON 171,A01,907666,Staff,18,0,35,17
1746571030496,ECON 175,A00,887626,Wu; Pak Yeung,22,0,35,13
1746571031527,ECON 190,A00,887640,Vespa; Emanuel Ignacio,22,0,35,13
1746571032557,EDS 25,A01,888197,Staff,0,0,0,0
1746571032557,EDS 25,A02,888209,Staff,0,0,0,0
1746571032557,EDS 25,A03,888210,Staff,0,0,0,0
1746571032557,EDS 25,A04,888212,Staff,0,0,0,0
1746571032557,EDS 25,A05,888213,Staff,0,0,0,0
1746571032557,EDS 25,A06,888214,Staff,0,0,0,0
1746571032557,EDS 25,A07,888235,Staff,0,2,0,0
1746571032557,EDS 25,A08,888236,Staff,0,0,0,0
1746571032557,EDS 25,A09,888240,Staff,0,0,0,0
1746571032557,EDS 25,A10,888244,Staff,0,0,0,0
1746571032557,EDS 25,B01,888273,Staff,0,0,0,0
1746571032557,EDS 25,B02,888285,Staff,0,0,0,0
1746571032557,EDS 25,B03,888423,Staff,0,0,0,1
1746571032557,EDS 25,B04,888432,Staff,0,0,0,0
1746571032557,EDS 25,B05,888433,Staff,0,0,0,0
1746571032557,EDS 25,B06,888467,Staff,0,0,0,0
1746571032557,EDS 25,B07,888468,Staff,0,0,0,0
1746571032557,EDS 25,B08,888479,Staff,0,0,0,0
1746571032557,EDS 25,B09,888484,Staff,0,0,0,0
1746571032557,EDS 25,B10,888487,Staff,0,0,0,0
1746571033581,EDS 38,A01,907700,Choi; Bailey Miyeon,30,0,30,0
1746571034609,EDS 112,A01,888601,Chapman; Thandeka K,12,0,40,28
1746571035634,EDS 115,A00,888697,Mendez; Kathrina Mendoza,10,0,30,20
1746571036660,EDS 116,A01,888893,Staff,34,0,40,6
1746571038717,EDS 124AR,A00,889133,Staff,29,0,50,21
1746571038717,EDS 124AR,B00,907471,Simon; Elizabeth A,37,0,50,13
1746571039741,EDS 124BR,A00,889134,Simon; Elizabeth A,44,0,100,56
1746571040766,EDS 125,A00,889135,Staff,25,0,30,5
1746571041795,EDS 126,A01,889138,Staff,35,0,40,5
1746571042821,EDS 164R,A01,889142,Wishard Guerra; Alison G.,33,0,50,17
1746571043848,ENG 30,A01,886396,Staff,0,0,0,0
1746571043848,ENG 30,B01,886398,Staff,0,0,0,0
1746571044879,ENVR 102,A00,906150,Montejo; Carolina,23,0,25,2
1746571045904,ETHN 103A,A00,887236,Man; Simeon S,0,3,0,0
1746571046932,ETHN 113,A00,887239,Staff,16,0,30,14
1746571047957,ETHN 116,A00,887240,Staff,16,0,25,9
1746571048983,ETHN 117,A00,887241,Choi; Esther Min,28,0,30,2
1746571050006,ETHN 118,A00,887243,Staff,24,0,30,6
1746571051031,ETHN 127,A00,887248,Cuong; Marisol,11,0,15,4
1746571052056,ETHN 139,A00,887250,Staff,7,0,10,3
1746571053083,ETHN 142,A00,887252,Staff,10,0,30,20
1746571054108,ETHN 161,A00,887253,Browne; Errol Tsekani,24,0,30,6
1746571055137,ETHN 163FR,A00,887255,Burelle; Julie Sara Veronique,0,0,5,5
1746571056163,GLBH 20,A00,889149,Elwardani; Nile Regina,8,0,42,34
1746571058217,GLBH 111,A01,889152,Burgos; Jose L.,17,0,17,0
1746571059246,GLBH 150,A00,889181,Sloane; Julia Kathryn,0,5,15,15
1746571061301,HDS 60,A01,886406,Warstadt; Melissa Fawn,73,0,80,7
1746571062327,HIAF 111,A00,889324,Gyamfi; Bright,25,0,32,7
1746571063351,HIEA 131,A00,889328,Staff,15,0,32,17
1746571064379,HIEA 144,A00,889333,Henry; Todd A.,26,0,32,6
1746571065409,HIEA 154,A00,889336,Henry; Todd A.,24,0,32,8
1746571066438,HIEU 106,A00,889339,Staff,22,0,32,10
1746571068494,HIEU 114,A00,889340,Staff,4,0,32,28
1746571069521,HIEU 135GS,A00,889342,Patterson; Patrick H.,0,0,1,24
1746571070550,HIEU 137,A00,889343,Edington; Claire Ellen,10,0,25,15
1746571071576,HIEU 148,A00,889345,Staff,14,0,32,18
1746571072601,HIEU 154,A00,889346,Biess; Frank Peter,21,0,32,11
1746571073627,HILA 102,A00,889351,Staff,12,0,32,20
1746571074653,HILD 2A,A01,889221,Lewandoski; Julia Mavis,1,10,32,31
1746571075679,HILD 7B,A01,889225,Man; Simeon S,0,12,32,32
1746571076704,HILD 7C,A01,889288,Alvarez; Luis A,0,14,32,32
1746571077729,HILD 30,A01,889323,Staff,0,5,32,32
1746571079781,HISC 119,A00,889383,Golan; Tal,19,0,32,13
1746571080808,HIUS 103,A00,889384,Man; Simeon S,0,0,32,32
1746571081832,HIUS 117,A00,919797,Kwak; Nancy,19,0,32,13
1746571082860,HIUS 142A,A00,919788,Staff,22,0,32,10
1746571084914,HIUS 149,A00,889386,Gyamfi; Bright,26,0,32,6
1746571085939,HIUS 155,A00,889387,Alvarez; Luis A,15,0,32,17
1746571086965,HUM 3,A01,886499,Caldwell; Michael Alan,19,0,50,31
1746571087991,HUM 3GS,A00,886500,Rodriguez; Bretton Sigfred,0,0,0,28
1746571089017,HUM 3R,A01,886502,Markman; Kristina,0,36,50,50
1746571090042,HUM 4,A01,886504,Crum; Matthew Stephen,24,0,50,26
1746571090042,HUM 4,B01,886506,West; Geoffrey Scott,17,0,50,33
1746571091068,HUM 4GS,A00,886507,Staff,0,0,0,19
1746571092093,HUM 5,A01,886509,Staff,32,0,50,18
1746571093119,HUM 5R,A01,886511,Zavodny; Tatiana Sophia,0,39,50,50
1746571094148,JAPN 180,A00,886407,Staff,16,0,40,24
1746571095174,LATI 50,A01,886409,Martin-Cabrera; Luis,4,0,22,18
1746571095174,LATI 50,A02,886410,Martin-Cabrera; Luis,19,0,22,3
1746571095174,LATI 50,A03,886411,Martin-Cabrera; Luis,21,0,22,1
1746571095174,LATI 50,A04,886412,Martin-Cabrera; Luis,9,0,22,13
1746571096198,LAWS 101,A00,907664,Staff,28,0,60,32
1746571097223,LIAB 1A,A00,889388,Saab; Dima,17,0,20,3
1746571098250,LIAB 1AX,A00,889389,El Cheddadi; Youniss,18,0,20,2
1746571099274,LIFR 1C,A00,889391,Van Moer; Vinciane G,8,0,20,12
1746571100298,LIFR 1CX,A00,889392,Van Moer; Vinciane G,7,0,20,13
1746571101323,LIFR 1D,A00,889393,Van Moer; Vinciane G,7,0,20,13
1746571102355,LIFR 1DX,A00,889394,Van Moer; Vinciane G,8,0,20,12
1746571103380,LIGN 7,A00,886923,Staff,24,0,50,26
1746571104407,LIGN 17,A00,886924,Kehler; Andrew Scott,125,0,150,25
1746571105431,LTAM 110,A00,889395,Staff,15,0,30,15
1746571106458,LTAM 110GS,A00,958010,Rodriguez; Bretton Sigfred,0,0,0,28
1746571107483,LTCH 101,A00,889397,Staff,23,0,25,2
1746571108510,LTCS 130,A00,889398,Staff,23,0,25,2
1746571109537,LTEA 138,A00,889399,Staff,24,0,40,16
1746571110564,LTEN 149,A00,889400,Wesling; Megan E.,0,3,25,25
1746571111590,LTEN 169,A00,889401,Staff,20,0,25,5
1746571112617,LTEN 180,A00,889402,Staff,10,0,15,5
1746571113642,LTEN 181,A00,889403,Staff,21,0,25,4
1746571114669,LTWL 100,A00,889404,Myerston Santana; Jacobo,2,0,25,23
1746571115696,LTWL 180GS,A00,889405,Staff,0,0,20,20
1746571116723,LTWL 181,A00,889406,Staff,16,0,25,9
1746571117749,LTWL 184,A00,889475,Mukherjee; Silpa,22,0,25,3
1746571118828,LTWR 102C,A00,889486,Staff,29,0,30,1
1746571119856,LTWR 115W,A00,889491,Staff,0,2,15,15
1746571120881,MAE 8,A01,886905,Staff,0,2,0,0
1746571121909,MAE 11,A00,886906,Bandaru; Prabhakar,0,7,50,50
1746571122939,MAE 20,A00,886907,Evdokimenko; Ekaterina,43,0,70,27
1746571123964,MAE 30B,A00,886909,Ghazinejad; Maziar,26,0,45,19
1746571124990,MAE 101B,A00,886910,Saintillan; David,29,0,45,16
1746571126020,MAE 105,A00,886911,Bandaru; Prabhakar,18,0,50,32
1746571127052,MAE 107,B00,958024,Staff,8,0,50,42
1746571128078,MAE 143B,A00,886913,Bewley; Thomas R,5,0,40,35
1746571129103,MAE 148,A01,886915,Silberman; Jack,0,3,14,14
1746571130131,MAE 160,A00,886916,Evdokimenko; Ekaterina,31,0,60,29
1746571131160,MATH 3C,A01,889681,Staff,0,2,30,30
1746571131160,MATH 3C,A02,960048,Staff,24,0,30,6
1746571132186,MATH 10A,A01,889760,Staff,26,0,30,4
1746571132186,MATH 10A,A02,889783,Staff,29,0,30,1
1746571133211,MATH 10B,A01,889785,Verstraete; Jacques Allan,2,0,35,33
1746571133211,MATH 10B,A02,889795,Verstraete; Jacques Allan,4,0,35,31
1746571133211,MATH 10B,B01,889797,Verstraete; Jacques Allan,3,0,35,32
1746571133211,MATH 10B,B02,889828,Verstraete; Jacques Allan,3,0,35,32
1746571134238,MATH 10C,A01,889849,Habib; Yousaf,7,0,30,23
1746571134238,MATH 10C,A02,889852,Habib; Yousaf,14,0,30,16
1746571134238,MATH 10C,A03,889853,Habib; Yousaf,22,0,30,8
1746571134238,MATH 10C,A04,889858,Habib; Yousaf,20,0,30,10
1746571134238,MATH 10C,B01,889861,Staff,1,0,30,29
1746571134238,MATH 10C,B02,889862,Staff,24,0,30,6
1746571134238,MATH 10C,B03,889863,Staff,27,0,30,3
1746571134238,MATH 10C,B04,889967,Staff,23,0,30,7
1746571135264,MATH 18,A01,889974,Staff,7,0,30,23
1746571135264,MATH 18,A02,889977,Staff,20,0,30,10
1746571135264,MATH 18,B01,889984,Hardiman; Liam,21,0,30,9
1746571135264,MATH 18,B02,889985,Hardiman; Liam,25,0,30,5
1746571136294,MATH 20A,A01,889990,Suk; Andrew Hoon,30,0,35,5
1746571137319,MATH 20B,A01,889993,Ohm; Ko Woon,22,0,30,8
1746571137319,MATH 20B,A02,889994,Ohm; Ko Woon,30,0,30,0
1746571137319,MATH 20B,B01,889996,Ohm; Ko Woon,22,0,30,8
1746571137319,MATH 20B,B02,889997,Ohm; Ko Woon,23,0,30,7
1746571138345,MATH 20C,A01,889999,Hammock; Frances H,17,0,30,13
1746571138345,MATH 20C,A02,890003,Hammock; Frances H,23,0,30,7
1746571138345,MATH 20C,B01,890006,Hammock; Frances H,3,0,30,27
1746571138345,MATH 20C,B02,890007,Hammock; Frances H,12,0,30,18
1746571139372,MATH 20D,A01,890011,Cheng; Hsiao-Bing,1,1,30,29
1746571139372,MATH 20D,A02,890012,Cheng; Hsiao-Bing,14,0,30,16
1746571139372,MATH 20D,B01,890016,Cheng; Hsiao-Bing,13,0,30,17
1746571139372,MATH 20D,B02,890017,Cheng; Hsiao-Bing,13,0,30,17
1746571140405,MATH 20E,A01,890026,Harel; Guershon,1,0,30,29
1746571140405,MATH 20E,A02,890029,Harel; Guershon,23,0,30,7
1746571140405,MATH 20E,B01,890033,Harel; Guershon,7,0,30,23
1746571140405,MATH 20E,B02,890101,Harel; Guershon,21,0,30,9
1746571141436,MATH 102,A01,890104,Staff,17,0,30,13
1746571141436,MATH 102,A02,890105,Staff,27,0,30,3
1746571142466,MATH 103B,A01,890116,Salehi Golsefidy; Alireza,3,0,30,27
1746571142466,MATH 103B,B01,890118,Staff,0,3,34,34
1746571143496,MATH 109,A01,890121,Aliabadi Sr.; Mohsen,1,0,30,29
1746571143496,MATH 109,B01,890124,Upadrashta; Pranav Kumar,18,0,30,12
1746571144522,MATH 120A,A01,890126,Eggers; John Dietrich,13,0,30,17
1746571145550,MATH 142B,A01,890128,Ioana; Adrian,19,0,30,11
1746571145550,MATH 142B,A02,890129,Ioana; Adrian,13,0,30,17
1746571146576,MATH 154,A01,890174,Staff,0,0,30,30
1746571146576,MATH 154,A02,890182,Staff,0,0,30,30
1746571147601,MATH 168A,A01,890197,Dumitriu; Ioana,21,0,35,14
1746571148632,MATH 170A,A01,890240,Nie; Jiawang,1,0,30,29
1746571148632,MATH 170A,A02,890241,Nie; Jiawang,11,0,30,19
1746571148632,MATH 170A,A03,890249,Nie; Jiawang,23,0,30,7
1746571149662,MATH 170B,A01,957891,Nag; Panchali,13,0,35,22
1746571151714,MATH 181A,A01,908025,Staff,0,4,35,35
1746571151714,MATH 181A,A02,960115,Staff,27,0,35,8
1746571152739,MATH 181B,A01,959874,Staff,25,0,30,5
1746571153765,MATH 193B,A01,890265,Staff,0,4,35,35
1746571154790,MGT 4,A01,890311,Anderson; John Charles,42,0,88,46
1746571155819,MGT 5,A00,907740,Staff,13,0,98,85
1746571156844,MGT 12,A00,890312,Lindenberger; Wade Douglas,67,0,98,31
1746571157869,MGT 16,A00,957883,Staff,78,0,98,20
1746571159926,MGT 45,A00,890314,Pecore; Joseph P.,46,0,98,52
1746571160953,MGT 71,A00,890315,Staff,0,11,98,98
1746571161980,MGT 100,A00,890316,Yavorsky; Daniel Ryan,44,0,98,54
1746571163007,MGT 103,A00,890317,Ehrich; Kristine R,73,0,98,25
1746571164036,MGT 105,A00,890356,Bates; Kenneth Walter,0,8,98,98
1746571165065,MGT 112,A00,890360,Ehrich; Kristine R,55,0,98,43
1746571166091,MGT 127R,A00,907732,Zhu; Kevin Xiaoguo,23,0,98,75
1746571167120,MGT 131B,A00,890361,Anderson; John Charles,60,0,98,38
1746571168149,MGT 137,A00,890362,Lindenberger; Wade Douglas,65,0,98,33
1746571169176,MGT 160,A00,890369,Johnson; Erik Barry,9,0,98,89
1746571171231,MGT 164,A00,890372,Zimmermann; Carsten,0,40,98,98
1746571172258,MGT 180,A00,890374,Bliss; Barbara Ann,12,0,98,86
1746571173285,MMW 15,A01,886414,Chang; Edmond Yi-Teh,0,12,28,28
1746571173285,MMW 15,A02,886415,Chang; Edmond Yi-Teh,0,8,28,28
1746571173285,MMW 15,A03,886416,Chang; Edmond Yi-Teh,0,8,28,28
1746571173285,MMW 15,A04,886417,Chang; Edmond Yi-Teh,0,8,28,28
1746571173285,MMW 15,B01,886419,Chang; Edmond Yi-Teh,0,7,28,28
1746571173285,MMW 15,B02,886420,Chang; Edmond Yi-Teh,0,8,28,28
1746571173285,MMW 15,B03,886421,Chang; Edmond Yi-Teh,0,7,28,28
1746571173285,MMW 15,B04,886422,Chang; Edmond Yi-Teh,0,8,28,28
1746571173285,MMW 15,C01,886424,Staff,0,9,28,28
1746571173285,MMW 15,C02,886425,Staff,0,8,28,28
1746571173285,MMW 15,C03,886426,Staff,0,8,28,28
1746571173285,MMW 15,C04,886427,Staff,0,8,28,28
1746571173285,MMW 15,C05,958038,Staff,0,8,28,28
1746571173285,MMW 15,C06,958039,Staff,1,8,28,27
1746571174314,MMW 15GS,A00,906910,Patterson; Patrick H.,4,0,28,24
1746571175343,MMW 122R,A01,886429,Rahimi; Babak,0,13,28,28
1746571175343,MMW 122R,A02,886430,Rahimi; Babak,0,12,28,28
1746571175343,MMW 122R,A03,958040,Rahimi; Babak,0,11,28,28
1746571176372,MUS 1A,A01,890937,Staff,2,0,25,23
1746571176372,MUS 1A,A02,891035,Staff,6,0,25,19
1746571176372,MUS 1A,C01,958912,Staff,24,0,25,1
1746571176372,MUS 1A,C02,958913,Staff,25,0,25,0
1746571178427,MUS 2AK,A00,957092,Ohnishi; Takae,15,0,15,0
1746571179452,MUS 4,A01,891044,Staff,1,0,25,24
1746571179452,MUS 4,A02,891045,Staff,23,0,25,2
1746571179452,MUS 4,B01,891048,Staff,17,0,25,8
1746571179452,MUS 4,B02,891050,Staff,25,0,25,0
1746571180476,MUS 5,A01,957506,Dubnov; Shlomo,0,0,25,25
1746571180476,MUS 5,A02,957622,Dubnov; Shlomo,13,0,25,12
1746571180476,MUS 5,A03,957623,Dubnov; Shlomo,20,0,25,5
1746571181505,MUS 6,A01,891053,Freitas Caetano; Marcelo,24,0,25,1
1746571181505,MUS 6,A02,891054,Freitas Caetano; Marcelo,23,0,25,2
1746571182531,MUS 7,A01,891081,Staff,0,0,25,25
1746571182531,MUS 7,A02,891082,Staff,3,0,25,22
1746571183556,MUS 8GS,A00,891118,Borgo; David Garcia,1,0,25,24
1746571184584,MUS 11,A01,891140,Staff,9,0,25,16
1746571184584,MUS 11,A02,891141,Staff,22,0,25,3
1746571185610,MUS 13,A01,891143,Staff,8,0,25,17
1746571185610,MUS 13,A02,891144,Staff,24,0,25,1
1746571186635,MUS 15,A01,891146,Staff,9,0,25,16
1746571186635,MUS 15,A02,891148,Staff,21,0,25,4
1746571186635,MUS 15,B01,891150,Staff,18,0,25,7
1746571186635,MUS 15,B02,891151,Staff,25,0,25,0
1746571187660,MUS 20,A01,891153,Staff,5,0,20,15
1746571187660,MUS 20,A02,891155,Staff,14,0,20,6
1746571188686,MUS 80,A00,891156,Staff,19,0,25,6
1746571188686,MUS 80,B00,891157,Staff,23,0,25,2
1746571189711,MUS 130,A00,891158,Ohnishi; Takae,35,0,35,0
1746571190737,MUS 150GS,A01,891160,Borgo; David Garcia,1,0,25,24
1746571191762,MUS 170,A01,891162,Freitas Caetano; Marcelo,20,0,25,5
1746571191762,MUS 170,A02,891164,Freitas Caetano; Marcelo,21,0,25,4
1746571192787,NANO 11,A00,886220,Vazquez Mena; Oscar,13,0,15,2
1746571193812,NANO 15,A01,886222,Drews; Aaron,4,0,7,3
1746571194837,NANO 104,A00,886224,Sirbuly; Donald,17,0,25,8
1746571195867,PH 40,A00,886528,Staff,23,0,40,17
1746571196893,PH 45,A01,886799,Staff,35,0,40,5
1746571197918,PH 110,A00,886802,Staff,0,7,40,40
1746571198942,PH 172,A00,906716,Staff,19,0,35,16
1746571199968,PH 191,A00,886803,Staff,6,0,40,34
1746571200995,PHIL 1,A00,889500,Staff,20,0,30,10
1746571202033,PHIL 10,A01,889549,Grush; Rick Scott,15,0,22,7
1746571202033,PHIL 10,A02,889551,Grush; Rick Scott,22,0,22,0
1746571203065,PHIL 28,A01,889559,Lamey; Andy M.,0,2,31,31
1746571203065,PHIL 28,A02,889561,Lamey; Andy M.,0,1,30,30
1746571203065,PHIL 28,A03,889572,Lamey; Andy M.,0,1,30,30
1746571204093,PHIL 35,A00,907839,Staff,13,0,15,2
1746571205120,PHIL 60,A00,889574,Staff,73,0,90,17
1746571206150,PHIL 101,A00,958004,Staff,12,0,15,3
1746571208202,PHIL 136,A00,889582,Fulkerson; Matthew Todd,26,0,45,19
1746571209230,PHIL 163,A01,889601,Staff,21,0,30,9
1746571209230,PHIL 163,B01,889606,Brandt; Reuven A,0,3,0,0
1746571210255,PHIL 164,A00,889610,Staff,16,0,30,14
1746571211282,PHIL 165,A00,889613,Staff,22,0,30,8
1746571212308,PHYS 1A,A00,886431,Staff,26,0,70,44
1746571213336,PHYS 1AL,001,886432,Tsai; Philbert S,0,2,30,30
1746571213336,PHYS 1AL,002,886436,Tsai; Philbert S,11,0,30,19
1746571214361,PHYS 1B,A00,886439,Staff,185,0,240,55
1746571215387,PHYS 1BL,001,886441,Tsai; Philbert S,0,4,30,30
1746571215387,PHYS 1BL,002,886444,Tsai; Philbert S,2,0,30,28
1746571216412,PHYS 1C,A00,896092,Arnold; Kam S,78,0,146,68
1746571217443,PHYS 1CL,001,886448,Tsai; Philbert S,0,0,30,30
1746571217443,PHYS 1CL,002,886449,Tsai; Philbert S,1,0,30,29
1746571217443,PHYS 1CL,003,886450,Tsai; Philbert S,16,0,30,14
1746571217443,PHYS 1CL,004,886451,Tsai; Philbert S,15,0,30,15
1746571218467,PHYS 2B,A01,886457,Staff,68,0,115,47
1746571219495,PHYS 2C,A01,886460,Shotwell; Brian,0,9,65,65
1746571220524,PHYS 2CL,A01,886467,Staff,0,4,28,28
1746571220524,PHYS 2CL,A02,886468,Staff,0,3,28,28
1746571221555,PHYS 2D,A01,886470,Staff,10,0,50,40
1746571222622,PHYS 4B,A01,886475,Grinstein; Benjamin,22,0,40,18
1746571223651,POLI 5,A00,891173,Desposato; Scott,7,0,25,18
1746571224676,POLI 5D,A01,891175,Staff,5,0,5,0
1746571224676,POLI 5D,B01,891178,Staff,5,0,5,0
1746571225702,POLI 11,A00,891179,Ferree; Karen E,2,0,35,33
1746571226731,POLI 12,A00,891180,Staff,16,0,30,14
1746571227762,POLI 27,A01,891182,Staff,12,0,75,63
1746571228788,POLI 30,A00,891183,Staff,8,0,50,42
1746571229816,POLI 100B,A00,891244,Staff,5,1,35,30
1746571230846,POLI 100I,A00,891247,Staff,7,0,30,23
1746571231869,POLI 104J,A00,891248,Nichter; Maysa,14,0,30,16
1746571232894,POLI 104U,A00,891250,Nichter; Maysa,2,0,30,28
1746571234948,POLI 110B,A00,891255,Wiens; David,19,0,25,6
1746571235973,POLI 112A,A00,891256,Wiens; David,6,0,25,19
1746571236999,POLI 114BR,A00,891261,Staff,19,0,30,11
1746571238023,POLI 117R,A00,891262,Forman; Fonna,0,6,50,50
1746571239048,POLI 118,A00,891264,Ingham; Sean,17,0,25,8
1746571240077,POLI 124A,A00,891265,Staff,18,0,20,2
1746571241106,POLI 125D,A00,891266,Nichter; Simeon C,2,0,25,23
1746571242139,POLI 126,A00,891268,Nichter; Simeon C,7,0,25,18
1746571243167,POLI 126AA,A00,891272,Staff,16,0,25,9
1746571244197,POLI 130AA,A00,891273,Staff,15,0,20,5
1746571245222,POLI 134AA,A00,891274,Staff,4,0,20,16
1746571247277,POLI 138,A00,891278,Staff,21,0,25,4
1746571248301,POLI 142K,A00,891280,Staff,10,0,25,15
1746571249330,POLI 142M,A00,891281,Gartzke; Erik,16,0,30,14
1746571250357,POLI 142P,A00,891284,Staff,20,0,30,10
1746571251384,POLI 143,A00,891285,Gartzke; Erik,12,0,30,18
1746571252408,POLI 153,A00,891286,Staff,19,0,20,1
1746571254476,POLI 175,A00,891290,Staff,15,0,20,5
1746571255501,PSYC 1,A00,890674,Steiner; Eric Tomas,0,11,45,45
1746571256530,PSYC 2,A00,890676,Albright; Thomas D,21,0,35,14
1746571257558,PSYC 3,A00,890679,Staff,17,0,20,3
1746571258584,PSYC 6,A00,959858,Staff,20,0,20,0
1746571259613,PSYC 60,A01,890684,Rickard; Timothy C.,0,5,45,45
1746571260643,PSYC 70,A01,890689,Geller; Emma Harlan,7,0,30,23
1746571261669,PSYC 71,A01,959860,Staff,21,0,25,4
1746571262706,PSYC 100,A00,890690,Lacefield; Katharine I,0,50,180,180
1746571263730,PSYC 102,A00,890695,Staff,18,0,40,22
1746571264759,PSYC 105,A00,890699,Geller; Emma Harlan,70,0,100,30
1746571265783,PSYC 106,A00,890701,Gorman; Michael R.,6,0,30,24
1746571266809,PSYC 108,A00,890704,Adrian; Julia Anna,0,28,50,50
1746571267836,PSYC 118,A01,890712,Staff,11,0,30,19
1746571268866,PSYC 124,A00,890716,Chapman; Eddie Nathaniel,25,0,60,35
1746571269894,PSYC 131,A00,890717,Anagnostaras; Stephan,0,8,80,80
1746571270919,PSYC 137,A00,890719,Winkielman; Piotr,0,11,30,30
1746571271945,PSYC 144,A00,890721,Adrian; Julia Anna,0,9,45,45
1746571272971,PSYC 162,A00,890805,Staff,0,0,75,75
1746571273999,PSYC 169,A00,890810,Staff,0,14,30,30
1746571275025,PSYC 172,A00,890814,Gorman; Michael R.,9,0,30,21
1746571276050,PSYC 181,A00,890818,Anagnostaras; Stephan,9,0,200,191
1746571277077,PSYC 184,A00,959861,Staff,168,0,175,7
1746571278102,PSYC 189,A00,890823,Staff,0,2,30,30
1746571279127,PSYC 191,A00,890884,Rickard; Timothy C.,0,12,35,35
1746571280156,PSYC 193,A00,890913,Staff,19,0,30,11
1746571280156,PSYC 193,B00,890914,Chapman; Eddie Nathaniel,24,0,30,6
1746571281183,PSYC 193L,A01,890918,Lowe; Angela Beth,20,0,30,10
1746571281183,PSYC 193L,B01,890921,Hurwitz; Ethan Scott,20,0,30,10
1746571281183,PSYC 193L,C01,890928,Staff,30,0,30,0
1746571282208,RELI 149,A00,886806,Rahimi; Babak,23,0,40,17
1746571283233,SE 9,A01,886814,Staff,7,0,20,13
1746571284259,SE 101B,A01,886816,Chadha; Mayank,4,0,35,31
1746571285285,SE 110B,A00,886818,Zhu; Qiang,4,0,75,71
1746571286312,SE 125,A01,886830,Staff,10,0,30,20
1746571287343,SE 130B,A01,886835,Staff,14,0,40,26
1746571288368,SE 131A,A01,886838,Krysl; Petr,34,0,55,21
1746571289393,SE 154,A00,886840,Staff,29,0,50,21
1746571290421,SE 164GS,A01,886849,Staff,6,0,20,14
1746571291446,SE 167GS,A01,886853,Staff,6,0,20,14
1746571292476,SIO 25,A01,890107,Staff,19,0,30,11
1746571293504,SIO 45,A00,890109,Cook; Geoffrey W,117,0,200,83
1746571294534,SIO 109R,A00,890110,Forman; Fonna,0,16,20,20
1746571295561,SIO 187,A01,890114,Kacev; David,15,0,40,25
1746571296588,SOCI 1,A01,890431,Thorpe; Charles Robert,15,0,30,15
1746571296588,SOCI 1,A02,890518,Thorpe; Charles Robert,30,0,30,0
1746571297614,SOCI 2,A01,957978,Staff,25,0,25,0
1746571297614,SOCI 2,A02,957979,Staff,23,0,25,2
1746571298644,SOCI 20,A01,890523,Calderon-Zaks; Michael Aar,21,0,30,9
1746571298644,SOCI 20,A02,890526,Calderon-Zaks; Michael Aar,29,0,30,1
1746571299669,SOCI 30,A01,890533,Pardo Guerra; Juan Pablo,37,0,40,3
1746571300695,SOCI 40,A01,890535,Staff,27,0,45,18
1746571301720,SOCI 104Q,A00,890559,Staff,18,0,30,12
1746571302768,SOCI 106,A00,890560,Arnal; Maud Marie Leonie,20,0,30,10
1746571303792,SOCI 110,A00,890567,Holkenbrink-Monk; Charlene,19,0,30,11
1746571304817,SOCI 112,A00,890568,Victoria Torres; Pablo,2,0,55,53
1746571305847,SOCI 115,A00,890597,Arnal; Maud Marie Leonie,28,0,45,17
1746571307898,SOCI 121,A00,890604,Pardo Guerra; Juan Pablo,38,0,45,7
1746571308928,SOCI 126,A01,890608,Staff,8,0,10,2
1746571309958,SOCI 127,A00,890609,Staff,18,0,30,12
1746571310983,SOCI 131,A00,890610,Thorpe; Charles Robert,37,0,45,8
1746571312010,SOCI 135,A00,890615,Payne; Christine Anna,13,0,45,32
1746571313040,SOCI 139,A00,890620,Staff,38,0,45,7
1746571314066,SOCI 148E,A00,890622,Calderon-Zaks; Michael Aar,36,0,45,9
1746571315090,SOCI 150,A00,890623,Kohler; Kristopher M.,31,0,45,14
1746571316116,SOCI 157,A00,890625,Jules-Rosette; Bennetta W.,18,0,20,2
1746571317143,SOCI 160,A00,890627,Payne; Christine Anna,21,0,45,24
1746571318168,SYN 1,A00,886855,Fish; Gwendolyn Anne,0,0,0,0
1746571318168,SYN 1,B00,906086,Fish; Gwendolyn Anne,0,2,0,2
1746571319197,SYN 2R,A00,886860,Staff,0,17,15,15
1746571319197,SYN 2R,B00,906106,Atkinson; Arthur Laird,0,16,15,15
1746571320225,SYN 100,A01,886866,Browne; Emily,0,28,20,20
1746571320225,SYN 100,B01,906128,Rock; Martin,0,5,20,20
1746571320225,SYN 100,C01,906140,Deavenport; James Cary,0,3,20,20
1746571320225,SYN 100,D01,907816,Deavenport; James Cary,0,5,20,20
1746571321249,TDAC 1,A00,890286,Walsh; Kim C.,8,0,20,12
1746571322275,TDAC 101,A00,890296,Basso; Beatrice,15,0,20,5
1746571323301,TDDE 131,A00,890297,Staff,47,0,50,3
1746571324330,TDDM 1,A00,890287,Weinberg; Sadie,25,0,30,5
1746571325355,TDGE 11,A00,890288,Fulton; Julia,137,0,200,63
1746571325355,TDGE 11,B00,890289,Castro; Robert Jess,184,0,200,16
1746571326436,TDGE 25,B00,957359,Walsh; Kim C.,4,0,20,16
1746571327461,TDGE 40,A01,890292,Power; Jade Yukana,27,0,30,3
1746571328490,TDGE 124,A00,890298,Havis; Allan,0,1,50,50
1746571329519,TDGE 131R,A00,890299,Burelle; Julie Sara Veronique,15,0,42,27
1746571330548,TDHT 101,A00,890300,Staff,10,0,20,10
1746571331574,TDHT 109,A01,890302,Anderson; Mysia Anyse,31,0,40,9
1746571332599,TDMV 1,A00,890293,Arcidiacono; Kristin,18,0,30,12
1746571333627,TDMV 2,A00,890294,Weinberg; Sadie,23,0,30,7
1746571334657,TDMV 3,A00,957878,Arcidiacono; Kristin,28,0,30,2
1746571336713,TDMV 138,A00,890304,Jun; Grace Shin Hae,25,0,40,15
1746571337739,TDMV 140,A00,890305,Corrales; Joseph Bernales,25,0,30,5
1746571338771,TDMV 142,A00,890307,Caligagan; Tony,32,0,40,8
1746571339800,TDMV 144,A00,890308,Camaya; Michelle Ann,25,0,30,5
1746571340828,TDPW 1,A00,890295,Stein; Deborah Isobel,3,0,20,17
1746571341854,USP 2,A01,890272,Lerner; Amy M,6,0,20,14
1746571342884,USP 3,A01,890274,Staff,12,0,30,18
1746571343910,USP 15,A01,890276,Sun; Feiyang,16,0,30,14
1746571344935,USP 25,A00,890277,Shenkman; Michael Thomas,19,0,25,6
1746571345961,USP 138,A00,890278,Staff,14,0,25,11
1746571346986,USP 143,A00,890279,Staff,22,0,70,48
1746571348013,USP 144,A00,890280,Chowdhury; Muhammed Zohir,16,0,30,14
1746571349037,USP 150,A00,890281,Boomhower; Matthew Charles,4,0,30,26
1746571350062,USP 151,A00,890282,Staff,16,0,20,4
1746571351088,USP 162,A00,890283,Andrews; Abigail Leslie,16,0,20,4
1746571352116,USP 168,A00,920477,Kwak; Nancy,0,0,5,5
1746571353145,USP 181,A00,890284,Staff,3,0,20,17
1746571354173,USP 191A,A00,890285,Staff,12,0,20,8
1746571355201,VIS 101,A00,886512,Staff,26,0,75,49
1746571356225,VIS 103,A00,886513,Cruz; Edwin Teddy,61,0,75,14
1746571357256,VIS 108,A00,886514,Staff,3,0,15,12
1746571358282,VIS 127P,A00,886515,Shen; Kuiyi,80,0,146,66
1746571359307,VIS 149,A00,886516,Yoldas; Pinar,0,0,15,15
1746571360332,VIS 164,A00,886526,Erdmann; Dean,19,0,22,3
1746571361355,VIS 194S,A00,886527,Staff,61,0,75,14
1746571362387,WCWP 10A,C00,886484,Martiniuk; Jill,12,0,15,3
1746571363415,WCWP 10B,A00,886490,Uriarte; Emma,0,0,15,15
1746571363415,WCWP 10B,B00,886491,Dhir; Simrita,9,0,15,6
1746571363415,WCWP 10B,C00,886492,Ornelas; Tricia,0,0,15,15
1746571364444,WCWP 100,A00,886494,Young; Mark T,0,6,15,15
1746571366558,AAS 10,A01,886199,Childs; Dennis R.,0,3,0,0
1746571367586,ANAR 104,A01,886940,Shtienberg; Gilad,27,0,30,3
1746571368611,ANAR 120,A00,886953,Staff,12,0,20,8
1746571369635,ANBI 148,A01,886955,Wilder; Linnea Lorene,30,0,40,10
1746571371690,ANSC 122,A00,886957,Staff,25,0,30,5
1746571372715,ANSC 150,A00,886958,Sloane; Julia Kathryn,2,0,15,13
1746571373741,ANSC 156,A00,886959,Jenkins; Janis A.,0,1,15,15
1746571374767,ANSC 180,A00,886960,Staff,11,0,17,6
1746571375798,ANSC 188,A00,886961,Jassal; Aftab,9,0,25,16
1746571376826,ANSC 190,A00,886962,Jassal; Aftab,14,0,25,11
1746571377851,ANSC 191,A00,886963,Staff,18,0,20,2
1746571378879,ANTH 3,A01,891689,Staff,17,0,20,3
1746571379908,ANTH 5,A00,886933,Semendeferi; Ekaterini,16,0,20,4
1746571380933,ANTH 10,A00,886934,Staff,0,12,30,30
1746571381958,ANTH 21,A01,886936,Staff,41,0,60,19
1746571382986,ANTH 23,A01,886938,Staff,92,0,100,8
1746571384010,ANTH 105,A00,886964,Stewart; Alexander B,84,0,100,16
1746571385038,ANTH 108,A00,886965,Pedersen; David,9,0,20,11
1746571386072,AWP 10,001,886147,Staff,0,0,0,0
1746571386072,AWP 10,002,886148,Staff,0,0,0,0
1746571386072,AWP 10,003,886149,Staff,0,0,0,0
1746571386072,AWP 10,004,886150,Staff,0,0,0,0
1746571386072,AWP 10,005,886151,Staff,0,0,0,0
1746571386072,AWP 10,006,886152,Staff,0,0,0,0
1746571386072,AWP 10,007,886153,Staff,0,0,0,0
1746571386072,AWP 10,008,886154,Staff,0,0,0,0
1746571386072,AWP 10,009,886155,Staff,0,0,0,0
1746571386072,AWP 10,010,886156,Staff,0,0,0,0
1746571386072,AWP 10,011,886158,Staff,0,0,0,0
1746571386072,AWP 10,012,886160,Staff,0,0,0,0
1746571386072,AWP 10,013,886161,Staff,0,0,0,0
1746571386072,AWP 10,014,886162,Staff,0,0,0,0
1746571386072,AWP 10,015,886163,Staff,0,0,0,0
1746571386072,AWP 10,016,886164,Staff,0,0,0,0
1746571386072,AWP 10,017,886165,Staff,0,0,0,0
1746571386072,AWP 10,018,886166,Staff,0,0,0,0
1746571386072,AWP 10,019,886168,Staff,0,0,0,0
1746571386072,AWP 10,020,886170,Staff,0,0,0,0
1746571386072,AWP 10,021,886172,Staff,0,0,0,0
1746571387101,AWP 10R,001,886173,Staff,0,1,0,0
1746571387101,AWP 10R,002,886174,Staff,0,1,0,0
1746571387101,AWP 10R,003,886175,Staff,0,0,0,0
1746571387101,AWP 10R,004,886176,Staff,0,0,0,0
1746571387101,AWP 10R,005,886177,Staff,0,0,0,0
1746571387101,AWP 10R,006,886178,Staff,0,0,0,0
1746571387101,AWP 10R,007,886179,Staff,0,0,0,0
1746571387101,AWP 10R,008,886181,Staff,0,0,0,0
1746571387101,AWP 10R,009,886182,Staff,0,0,0,0
1746571387101,AWP 10R,010,886183,Staff,0,0,0,0
1746571387101,AWP 10R,011,886184,Staff,0,0,0,0
1746571387101,AWP 10R,012,886185,Staff,0,0,0,0
1746571387101,AWP 10R,013,886186,Staff,0,0,0,0
1746571387101,AWP 10R,014,886187,Staff,0,0,0,0
1746571387101,AWP 10R,015,886188,Staff,0,0,0,0
1746571387101,AWP 10R,016,886189,Staff,0,0,0,0
1746571387101,AWP 10R,017,960532,Staff,0,0,0,0
1746571387101,AWP 10R,018,960533,Staff,0,0,0,0
1746571387101,AWP 10R,019,960534,Staff,0,0,0,0
1746571387101,AWP 10R,020,960538,Staff,0,0,0,0
1746571387101,AWP 10R,021,960540,Staff,0,0,0,0
1746571387101,AWP 10R,022,960541,Staff,0,0,0,0
1746571387101,AWP 10R,023,960542,Staff,0,0,0,0
1746571387101,AWP 10R,024,960544,Staff,0,0,0,0
1746571387101,AWP 10R,025,960545,Staff,0,0,0,0
1746571387101,AWP 10R,026,960548,Staff,0,0,0,0
1746571388129,AWP 102R,A00,886190,Staff,0,0,0,0
1746571388129,AWP 102R,B00,886191,Staff,0,0,0,0
1746571389155,BENG 100,A01,886193,Staff,17,0,30,13
1746571390182,BENG 122A,A01,886195,Hasty; Jeff M,13,0,30,17
1746571391209,BENG 166A,A00,886196,Sah; Robert Lie-Yuan,0,2,30,30
1746571392235,BENG 190,A00,958050,Khojah; Reem I,20,0,25,5
1746571393259,BIBC 102,A01,894320,Staff,0,0,46,46
1746571393259,BIBC 102,A02,894321,Staff,0,0,46,46
1746571393259,BIBC 102,A03,894344,Staff,7,0,46,39
1746571393259,BIBC 102,A04,894345,Staff,27,0,47,20
1746571394286,BICD 100R,A01,894365,Smith; Laurie,0,3,58,58
1746571394286,BICD 100R,A02,894366,Smith; Laurie,0,5,58,58
1746571394286,BICD 100R,A03,894367,Smith; Laurie,0,0,59,59
1746571394286,BICD 100R,A04,959869,Smith; Laurie,40,0,59,19
1746571395310,BICD 136,A01,894383,Gustafson-Brown; Cindy,14,0,50,36
1746571396338,BIEB 102,A01,894494,Butler; Shannon Rhey,51,0,130,79
1746571398390,BIEB 150,A01,894617,Wills; Christopher,3,0,20,17
1746571398390,BIEB 150,A02,894631,Wills; Christopher,3,0,20,17
1746571398390,BIEB 150,A03,894937,Wills; Christopher,3,0,20,17
1746571398390,BIEB 150,A04,894946,Wills; Christopher,5,0,20,15
1746571399415,BIEB 194,A00,906141,Kurle; Carolyn M.,6,0,20,14
1746571400442,BILD 1,A01,894154,Staff,3,0,19,16
1746571400442,BILD 1,A02,894155,Staff,14,0,19,5
1746571400442,BILD 1,A03,894160,Staff,13,0,19,6
1746571400442,BILD 1,A04,894161,Staff,15,0,18,3
1746571401467,BILD 2,A01,894168,Staff,0,0,50,50
1746571401467,BILD 2,A02,894169,Staff,0,0,50,50
1746571401467,BILD 2,A03,894179,Staff,0,0,50,50
1746571401467,BILD 2,A04,894203,Staff,24,0,50,26
1746571402496,BILD 3,A01,894213,Staff,22,0,31,9
1746571402496,BILD 3,A02,894214,Staff,26,0,31,5
1746571402496,BILD 3,A03,894235,Staff,28,0,31,3
1746571402496,BILD 3,A04,894236,Staff,28,0,32,4
1746571403524,BILD 4,A01,894253,Reuther; Keefe,6,0,24,18
1746571403524,BILD 4,A02,894258,Reuther; Keefe,16,0,24,8
1746571404554,BILD 5,A01,894276,Reuther; Keefe,35,0,50,15
1746571404554,BILD 5,A02,894277,Reuther; Keefe,45,0,50,5
1746571404554,BILD 5,A03,894290,Reuther; Keefe,44,0,50,6
1746571404554,BILD 5,A04,894291,Reuther; Keefe,48,0,50,2
1746571405580,BILD 24,A01,894297,Pirino; Giorgia,40,0,60,20
1746571406606,BIMM 100,B01,958915,Staff,71,0,100,29
1746571407631,BIMM 101,A01,895017,McDonnell; Lisa Marie,0,5,24,24
1746571407631,BIMM 101,A02,895018,McDonnell; Lisa Marie,0,5,24,24
1746571407631,BIMM 101,B01,895020,McDonnell; Lisa Marie,0,6,24,24
1746571407631,BIMM 101,B02,895021,McDonnell; Lisa Marie,0,4,24,24
1746571408661,BIMM 110,A01,895023,Staff,1,0,25,24
1746571408661,BIMM 110,A02,895024,Staff,9,0,25,16
1746571408661,BIMM 110,A03,895025,Staff,18,0,25,7
1746571408661,BIMM 110,A04,895031,Staff,20,0,25,5
1746571409690,BIMM 120,A01,895114,Gustafson-Brown; Cindy,14,0,28,14
1746571409690,BIMM 120,A02,895126,Gustafson-Brown; Cindy,21,0,27,6
1746571410719,BIPN 100,A01,895130,Yang; Mingyu,0,0,38,38
1746571410719,BIPN 100,A02,895131,Yang; Mingyu,32,0,38,6
1746571410719,BIPN 100,A03,895132,Yang; Mingyu,32,0,38,6
1746571410719,BIPN 100,A04,895133,Yang; Mingyu,27,0,36,9
1746571411748,BIPN 120,A01,895135,Cooke; James Edward,0,3,13,13
1746571411748,BIPN 120,A02,895136,Cooke; James Edward,0,1,13,13
1746571411748,BIPN 120,A03,895137,Cooke; James Edward,0,3,13,13
1746571411748,BIPN 120,A04,895156,Cooke; James Edward,0,2,11,11
1746571412774,BIPN 134,A01,895235,Cooke; James Edward,0,2,25,25
1746571412774,BIPN 134,A02,895237,Cooke; James Edward,0,0,25,25
1746571412774,BIPN 134,A03,895240,Cooke; James Edward,3,0,25,22
1746571412774,BIPN 134,A04,895270,Cooke; James Edward,20,0,25,5
1746571413799,BIPN 189,A00,892103,Staff,0,14,14,14
1746571415851,BISP 194,A00,958008,Staff,0,2,0,0
1746571416876,CAT 124,A01,922009,Staff,0,5,20,20
1746571417905,CAT 125R,A00,886390,Morales; Celeste Georgianna,0,2,20,20
1746571417905,CAT 125R,B00,886391,Irwin; Matthew Joseph,0,4,20,20
1746571417905,CAT 125R,C00,886392,Smith; Lauryn Alissa,0,2,20,20
1746571417905,CAT 125R,D00,886393,Vanderschuit; Maya Alysia,0,3,20,20
1746571417905,CAT 125R,E00,886394,Marchisotto; Jennifer Anne,0,3,20,20
1746571418930,CENG 15,A01,886218,Drews; Aaron,3,0,8,5
1746571419956,CENG 113,A00,886219,Opatkiewicz; Justin Paul,15,0,25,10
1746571420983,CGS 101,A00,887044,Staff,7,0,20,13
1746571422010,CGS 105,A01,887046,Staff,14,0,25,11
1746571423036,CGS 112,A00,887047,Cuong; Marisol,12,0,15,3
1746571424064,CGS 113,A00,887048,Staff,23,0,30,7
1746571425094,CGS 120,A00,887049,Staff,10,0,17,7
1746571426123,CHEM 6A,A01,886336,Lam; Tin Yiu,38,0,50,12
1746571426123,CHEM 6A,A02,886338,Lam; Tin Yiu,37,0,50,13
1746571427151,CHEM 6B,A01,886341,Hopkins; Patrycja Anna,16,0,50,34
1746571427151,CHEM 6B,A02,886343,Hopkins; Patrycja Anna,42,0,50,8
1746571428181,CHEM 6C,A01,886346,Albizati; Kim F.,0,2,50,50
1746571428181,CHEM 6C,A02,886348,Albizati; Kim F.,23,0,50,27
1746571429207,CHEM 40A,A01,886352,Klosterman; Jeremy K,65,0,100,35
1746571430233,CHEM 40B,A01,886356,Klosterman; Jeremy K,0,23,100,100
1746571431262,CHEM 41B,A01,886360,Theodorakis; Emmanuel,25,0,50,25
1746571431262,CHEM 41B,A02,886362,Theodorakis; Emmanuel,47,0,50,3
1746571432287,CHIN 165A,A00,886382,Xu; Li,18,0,20,2
1746571433314,CLAS 120,A00,886387,Myerston Santana; Jacobo,33,0,40,7
1746571434341,COGS 9,A01,886967,Shannon; Kyle Michael,42,0,60,18
1746571435367,COGS 11,A01,886969,Staff,10,0,30,20
1746571436392,COGS 14A,A01,886971,Staff,6,0,60,54
1746571437420,COGS 14B,A01,886973,Hoffman; Drew Ellen,4,0,60,56
1746571438445,COGS 18,A01,886975,Morgan; Eric,35,0,60,25
1746571439471,COGS 20,A01,886977,Staff,4,0,8,4
1746571439471,COGS 20,A02,886978,Staff,5,0,7,2
1746571440500,COGS 100,A01,907783,Staff,1,2,30,29
1746571441526,COGS 101B,A01,886980,Staff,0,3,48,48
1746571442555,COGS 101C,A01,886982,Delgado; Tania,0,5,44,44
1746571443580,COGS 102A,A01,886984,Johnson; Christine M.,4,0,30,26
1746571444605,COGS 118B,A01,886986,Staff,1,3,88,87
1746571445633,COGS 150,A01,886988,Bergen; Benjamin,22,0,50,28
1746571446659,COGS 153,A00,886989,Delgado; Tania,0,2,41,41
1746571447687,COGS 186,A01,886991,Staff,0,0,32,32
1746571448712,COGS 187A,A01,886993,Boyle; Mary E. T.,7,0,30,23
1746571449740,COGS 189,A00,886994,Staff,0,1,30,30
1746571450765,COMM 10,A01,886996,Staff,0,0,20,21
1746571450765,COMM 10,A02,886997,Staff,12,0,20,8
1746571450765,COMM 10,A03,959845,Staff,19,0,20,1
1746571451790,COMM 20,A01,886999,Leuning; Grant Maurstad,24,0,40,16
1746571453842,COMM 100A,A01,887002,Staff,0,0,20,25
1746571453842,COMM 100A,A02,887003,Staff,6,0,20,14
1746571454866,COMM 100B,A01,887005,Staff,0,8,20,24
1746571455894,COMM 106D,A00,887006,Staff,13,0,40,27
1746571456921,COMM 110G,A00,887007,Whitworth-Smith; Andrew C,12,0,40,28
1746571457945,COMM 111B,A00,887008,Staff,31,0,40,9
1746571458971,COMM 113T,A00,887009,Abuelhiga; Soraya Jill,28,0,40,12
1746571458971,COMM 113T,B00,906733,Staff,40,0,40,0
1746571460005,COMM 145,A00,887010,Staff,12,0,40,28
1746571461029,COMM 146,A00,887054,Staff,31,0,40,9
1746571462057,COMM 190,A00,887012,Staff,8,0,23,15
1746571463086,CSE 8A,A50,887015,Cao; Yingjun,57,0,85,28
1746571464111,CSE 11,A01,887017,Cao; Yingjun,12,0,70,58
1746571465135,CSE 20,A01,887019,Staff,30,0,50,20
1746571466160,CSE 21,A01,887021,Staff,78,0,100,22
1746571466160,CSE 21,B01,892583,Braun; Oliver,45,0,50,5
1746571467185,CSE 30,A01,887025,Eldon; John,143,0,200,57
1746571468213,CSE 100,A01,887027,Staff,26,0,50,24
1746571468213,CSE 100,A02,887028,Staff,42,0,50,8
1746571469240,CSE 101,A01,887030,Braun; Oliver,74,0,100,26
1746571469240,CSE 101,B01,887032,Jones; Miles E,0,3,50,50
1746571469240,CSE 101,B02,887033,Jones; Miles E,0,2,50,50
1746571470269,CSE 105,A01,908084,Jones; Miles E,32,0,50,18
1746571470269,CSE 105,A02,908087,Jones; Miles E,31,0,50,19
1746571471297,CSE 135,A01,887035,Powell; Thomas Allan,0,5,50,50
1746571472325,CSE 142,A01,887037,Staff,8,0,60,52
1746571473350,CSE 142L,A01,887039,Staff,34,0,60,26
1746571474376,CSE 151A,A01,887041,Solares; Edwin A,47,0,100,53
1746571475404,CSE 175,A01,887043,Kumar; Rakesh,30,0,30,0
1746571476429,CSS 1,A01,886389,Staff,1,1,40,39
1746571477457,DSC 30,A01,908097,Liao; Soohyun Nam,47,0,75,28
1746571478488,DSC 40A,A01,908099,Shannon; Kyle Michael,30,0,50,20
1746571479518,DSC 40B,A01,908112,Staff,15,0,50,35
1746571480544,DSC 80,A01,908116,Staff,19,0,60,41
1746571481570,DSC 197,001,956863,Eldridge; Justin Matthew,9999,0,9999,0
1746571482595,ECE 5,A01,886400,Morris; Karcher William,1,0,6,5
1746571482595,ECE 5,A02,886401,Morris; Karcher William,3,0,6,3
1746571483621,ECE 148,A01,886403,Silberman; Jack,0,14,14,14
1746571484646,ECON 1,A01,887265,Crane; Meredith Helen,12,0,70,58
1746571484646,ECON 1,B01,887268,Staff,43,0,50,7
1746571485672,ECON 2,A01,887273,Crane; Meredith Helen,55,0,70,15
1746571486695,ECON 3,A01,887279,Rondina; Giacomo,32,0,70,38
1746571487725,ECON 4,A01,887282,Anderson; John Charles,0,2,10,10
1746571488753,ECON 5,A01,887285,Staff,34,0,45,11
1746571488753,ECON 5,B01,887292,Staff,41,0,45,4
1746571489780,ECON 100A,A01,887337,Newhouse; Herbert S,54,0,70,16
1746571489780,ECON 100A,B01,887349,Staff,45,0,50,5
1746571490809,ECON 100B,A01,887361,Du; Songzi,29,0,70,41
1746571491836,ECON 100C,A01,887445,Newhouse; Herbert S,59,0,70,11
1746571492863,ECON 105,A00,887488,Vespa; Emanuel Ignacio,23,0,35,12
1746571493893,ECON 109,A01,887506,Shishkin; Denis,28,0,35,7
1746571494922,ECON 110A,A01,887568,Alon; Titan Michael,0,3,35,35
1746571494922,ECON 110A,B01,907601,Alon; Titan Michael,20,0,35,15
1746571495946,ECON 110B,A01,887598,Levkoff; Steven B.,0,24,70,70
1746571496975,ECON 112,A00,887599,Rondina; Giacomo,19,0,35,16
1746571498002,ECON 120A,A01,887603,Dai; Yinlin,35,0,70,35
1746571499029,ECON 120C,A01,887608,Sun; Yixiao,0,1,35,35
1746571499029,ECON 120C,B01,887614,Sun; Yixiao,0,0,35,35
1746571500091,ECON 138,A00,887621,Bharadwaj; Prashant,0,21,20,20
1746571501121,ECON 144,A00,958007,Squires; Dale E,12,0,35,23
1746571502145,ECON 171,A01,907666,Staff,18,0,35,17
1746571503172,ECON 175,A00,887626,Wu; Pak Yeung,22,0,35,13
1746571504198,ECON 190,A00,887640,Vespa; Emanuel Ignacio,22,0,35,13
1746571505232,EDS 25,A01,888197,Staff,0,0,0,0
1746571505232,EDS 25,A02,888209,Staff,0,0,0,0
1746571505232,EDS 25,A03,888210,Staff,0,0,0,0
1746571505232,EDS 25,A04,888212,Staff,0,0,0,0
1746571505232,EDS 25,A05,888213,Staff,0,0,0,0
1746571505232,EDS 25,A06,888214,Staff,0,0,0,0
1746571505232,EDS 25,A07,888235,Staff,0,2,0,0
1746571505232,EDS 25,A08,888236,Staff,0,0,0,0
1746571505232,EDS 25,A09,888240,Staff,0,0,0,0
1746571505232,EDS 25,A10,888244,Staff,0,0,0,0
1746571505232,EDS 25,B01,888273,Staff,0,0,0,0
1746571505232,EDS 25,B02,888285,Staff,0,0,0,0
1746571505232,EDS 25,B03,888423,Staff,0,0,0,1
1746571505232,EDS 25,B04,888432,Staff,0,0,0,0
1746571505232,EDS 25,B05,888433,Staff,0,0,0,0
1746571505232,EDS 25,B06,888467,Staff,0,0,0,0
1746571505232,EDS 25,B07,888468,Staff,0,0,0,0
1746571505232,EDS 25,B08,888479,Staff,0,0,0,0
1746571505232,EDS 25,B09,888484,Staff,0,0,0,0
1746571505232,EDS 25,B10,888487,Staff,0,0,0,0
1746571506263,EDS 38,A01,907700,Choi; Bailey Miyeon,30,0,30,0
1746571507294,EDS 112,A01,888601,Chapman; Thandeka K,12,0,40,28
1746571508321,EDS 115,A00,888697,Mendez; Kathrina Mendoza,10,0,30,20
1746571509345,EDS 116,A01,888893,Staff,34,0,40,6
1746571511401,EDS 124AR,A00,889133,Staff,29,0,50,21
1746571511401,EDS 124AR,B00,907471,Simon; Elizabeth A,37,0,50,13
1746571512427,EDS 124BR,A00,889134,Simon; Elizabeth A,44,0,100,56
1746571513457,EDS 125,A00,889135,Staff,25,0,30,5
1746571514481,EDS 126,A01,889138,Staff,35,0,40,5
1746571515506,EDS 164R,A01,889142,Wishard Guerra; Alison G.,33,0,50,17
1746571516535,ENG 30,A01,886396,Staff,0,0,0,0
1746571516535,ENG 30,B01,886398,Staff,0,0,0,0
1746571517561,ENVR 102,A00,906150,Montejo; Carolina,23,0,25,2
1746571518585,ETHN 103A,A00,887236,Man; Simeon S,0,3,0,0
1746571519610,ETHN 113,A00,887239,Staff,16,0,30,14
1746571520634,ETHN 116,A00,887240,Staff,16,0,25,9
1746571521665,ETHN 117,A00,887241,Choi; Esther Min,28,0,30,2
1746571522690,ETHN 118,A00,887243,Staff,24,0,30,6
1746571523720,ETHN 127,A00,887248,Cuong; Marisol,11,0,15,4
1746571524754,ETHN 139,A00,887250,Staff,7,0,10,3
1746571525781,ETHN 142,A00,887252,Staff,10,0,30,20
1746571526811,ETHN 161,A00,887253,Browne; Errol Tsekani,24,0,30,6
1746571527837,ETHN 163FR,A00,887255,Burelle; Julie Sara Veronique,0,0,5,5
1746571528862,GLBH 20,A00,889149,Elwardani; Nile Regina,8,0,42,34
1746571530925,GLBH 111,A01,889152,Burgos; Jose L.,17,0,17,0
1746571531949,GLBH 150,A00,889181,Sloane; Julia Kathryn,0,5,15,15
1746571534002,HDS 60,A01,886406,Warstadt; Melissa Fawn,73,0,80,7
1746571535031,HIAF 111,A00,889324,Gyamfi; Bright,25,0,32,7
1746571536060,HIEA 131,A00,889328,Staff,15,0,32,17
1746571537085,HIEA 144,A00,889333,Henry; Todd A.,26,0,32,6
1746571538110,HIEA 154,A00,889336,Henry; Todd A.,24,0,32,8
1746571539136,HIEU 106,A00,889339,Staff,22,0,32,10
1746571541189,HIEU 114,A00,889340,Staff,4,0,32,28
1746571542213,HIEU 135GS,A00,889342,Patterson; Patrick H.,0,0,1,24
1746571543241,HIEU 137,A00,889343,Edington; Claire Ellen,10,0,25,15
1746571544270,HIEU 148,A00,889345,Staff,14,0,32,18
1746571545295,HIEU 154,A00,889346,Biess; Frank Peter,21,0,32,11
1746571546322,HILA 102,A00,889351,Staff,12,0,32,20
1746571547347,HILD 2A,A01,889221,Lewandoski; Julia Mavis,1,10,32,31
1746571548373,HILD 7B,A01,889225,Man; Simeon S,0,12,32,32
1746571549401,HILD 7C,A01,889288,Alvarez; Luis A,0,14,32,32
1746571550431,HILD 30,A01,889323,Staff,0,5,32,32
1746571552479,HISC 119,A00,889383,Golan; Tal,19,0,32,13
1746571553504,HIUS 103,A00,889384,Man; Simeon S,0,0,32,32
1746571554532,HIUS 117,A00,919797,Kwak; Nancy,19,0,32,13
1746571555557,HIUS 142A,A00,919788,Staff,22,0,32,10
1746571557610,HIUS 149,A00,889386,Gyamfi; Bright,26,0,32,6
1746571558637,HIUS 155,A00,889387,Alvarez; Luis A,15,0,32,17
1746571559662,HUM 3,A01,886499,Caldwell; Michael Alan,19,0,50,31
1746571560687,HUM 3GS,A00,886500,Rodriguez; Bretton Sigfred,0,0,0,28
1746571561713,HUM 3R,A01,886502,Markman; Kristina,0,36,50,50
1746571562744,HUM 4,A01,886504,Crum; Matthew Stephen,24,0,50,26
1746571562744,HUM 4,B01,886506,West; Geoffrey Scott,17,0,50,33
1746571563770,HUM 4GS,A00,886507,Staff,0,0,0,19
1746571564799,HUM 5,A01,886509,Staff,32,0,50,18
1746571565829,HUM 5R,A01,886511,Zavodny; Tatiana Sophia,0,39,50,50
1746571566857,JAPN 180,A00,886407,Staff,16,0,40,24
1746571567888,LATI 50,A01,886409,Martin-Cabrera; Luis,4,0,22,18
1746571567888,LATI 50,A02,886410,Martin-Cabrera; Luis,19,0,22,3
1746571567888,LATI 50,A03,886411,Martin-Cabrera; Luis,21,0,22,1
1746571567888,LATI 50,A04,886412,Martin-Cabrera; Luis,9,0,22,13
1746571568912,LAWS 101,A00,907664,Staff,28,0,60,32
1746571569942,LIAB 1A,A00,889388,Saab; Dima,17,0,20,3
1746571570967,LIAB 1AX,A00,889389,El Cheddadi; Youniss,18,0,20,2
1746571571993,LIFR 1C,A00,889391,Van Moer; Vinciane G,8,0,20,12
1746571573022,LIFR 1CX,A00,889392,Van Moer; Vinciane G,7,0,20,13
1746571574047,LIFR 1D,A00,889393,Van Moer; Vinciane G,7,0,20,13
1746571575071,LIFR 1DX,A00,889394,Van Moer; Vinciane G,8,0,20,12
1746571576097,LIGN 7,A00,886923,Staff,24,0,50,26
1746571577127,LIGN 17,A00,886924,Kehler; Andrew Scott,125,0,150,25
1746571578152,LTAM 110,A00,889395,Staff,15,0,30,15
1746571579182,LTAM 110GS,A00,958010,Rodriguez; Bretton Sigfred,0,0,0,28
1746571580212,LTCH 101,A00,889397,Staff,23,0,25,2
1746571581239,LTCS 130,A00,889398,Staff,23,0,25,2
1746571582266,LTEA 138,A00,889399,Staff,24,0,40,16
1746571583293,LTEN 149,A00,889400,Wesling; Megan E.,0,3,25,25
1746571584321,LTEN 169,A00,889401,Staff,20,0,25,5
1746571585347,LTEN 180,A00,889402,Staff,10,0,15,5
1746571586371,LTEN 181,A00,889403,Staff,21,0,25,4
1746571587398,LTWL 100,A00,889404,Myerston Santana; Jacobo,2,0,25,23
1746571588424,LTWL 180GS,A00,889405,Staff,0,0,20,20
1746571589451,LTWL 181,A00,889406,Staff,16,0,25,9
1746571590480,LTWL 184,A00,889475,Mukherjee; Silpa,22,0,25,3
1746571591505,LTWR 102C,A00,889486,Staff,29,0,30,1
1746571592532,LTWR 115W,A00,889491,Staff,0,2,15,15
1746571593558,MAE 8,A01,886905,Staff,0,2,0,0
1746571594586,MAE 11,A00,886906,Bandaru; Prabhakar,0,7,50,50
1746571595611,MAE 20,A00,886907,Evdokimenko; Ekaterina,43,0,70,27
1746571596637,MAE 30B,A00,886909,Ghazinejad; Maziar,26,0,45,19
1746571597669,MAE 101B,A00,886910,Saintillan; David,29,0,45,16
1746571598695,MAE 105,A00,886911,Bandaru; Prabhakar,18,0,50,32
1746571599724,MAE 107,B00,958024,Staff,8,0,50,42
1746571600754,MAE 143B,A00,886913,Bewley; Thomas R,5,0,40,35
1746571601784,MAE 148,A01,886915,Silberman; Jack,0,3,14,14
1746571602809,MAE 160,A00,886916,Evdokimenko; Ekaterina,31,0,60,29
1746571603837,MATH 3C,A01,889681,Staff,0,2,30,30
1746571603837,MATH 3C,A02,960048,Staff,24,0,30,6
1746571604865,MATH 10A,A01,889760,Staff,26,0,30,4
1746571604865,MATH 10A,A02,889783,Staff,29,0,30,1
1746571605892,MATH 10B,A01,889785,Verstraete; Jacques Allan,2,0,35,33
1746571605892,MATH 10B,A02,889795,Verstraete; Jacques Allan,4,0,35,31
1746571605892,MATH 10B,B01,889797,Verstraete; Jacques Allan,3,0,35,32
1746571605892,MATH 10B,B02,889828,Verstraete; Jacques Allan,3,0,35,32
1746571606919,MATH 10C,A01,889849,Habib; Yousaf,7,0,30,23
1746571606919,MATH 10C,A02,889852,Habib; Yousaf,14,0,30,16
1746571606919,MATH 10C,A03,889853,Habib; Yousaf,22,0,30,8
1746571606919,MATH 10C,A04,889858,Habib; Yousaf,20,0,30,10
1746571606919,MATH 10C,B01,889861,Staff,1,0,30,29
1746571606919,MATH 10C,B02,889862,Staff,24,0,30,6
1746571606919,MATH 10C,B03,889863,Staff,27,0,30,3
1746571606919,MATH 10C,B04,889967,Staff,23,0,30,7
1746571607947,MATH 18,A01,889974,Staff,7,0,30,23
1746571607947,MATH 18,A02,889977,Staff,20,0,30,10
1746571607947,MATH 18,B01,889984,Hardiman; Liam,21,0,30,9
1746571607947,MATH 18,B02,889985,Hardiman; Liam,25,0,30,5
1746571608976,MATH 20A,A01,889990,Suk; Andrew Hoon,30,0,35,5
1746571610006,MATH 20B,A01,889993,Ohm; Ko Woon,22,0,30,8
1746571610006,MATH 20B,A02,889994,Ohm; Ko Woon,30,0,30,0
1746571610006,MATH 20B,B01,889996,Ohm; Ko Woon,22,0,30,8
1746571610006,MATH 20B,B02,889997,Ohm; Ko Woon,23,0,30,7
1746571611070,MATH 20C,A01,889999,Hammock; Frances H,17,0,30,13
1746571611070,MATH 20C,A02,890003,Hammock; Frances H,23,0,30,7
1746571611070,MATH 20C,B01,890006,Hammock; Frances H,3,0,30,27
1746571611070,MATH 20C,B02,890007,Hammock; Frances H,12,0,30,18
1746571612100,MATH 20D,A01,890011,Cheng; Hsiao-Bing,1,1,30,29
1746571612100,MATH 20D,A02,890012,Cheng; Hsiao-Bing,14,0,30,16
1746571612100,MATH 20D,B01,890016,Cheng; Hsiao-Bing,13,0,30,17
1746571612100,MATH 20D,B02,890017,Cheng; Hsiao-Bing,13,0,30,17
1746571613127,MATH 20E,A01,890026,Harel; Guershon,1,0,30,29
1746571613127,MATH 20E,A02,890029,Harel; Guershon,23,0,30,7
1746571613127,MATH 20E,B01,890033,Harel; Guershon,7,0,30,23
1746571613127,MATH 20E,B02,890101,Harel; Guershon,21,0,30,9
1746571614152,MATH 102,A01,890104,Staff,17,0,30,13
1746571614152,MATH 102,A02,890105,Staff,27,0,30,3
1746571615179,MATH 103B,A01,890116,Salehi Golsefidy; Alireza,3,0,30,27
1746571615179,MATH 103B,B01,890118,Staff,0,3,34,34
1746571616204,MATH 109,A01,890121,Aliabadi Sr.; Mohsen,1,0,30,29
1746571616204,MATH 109,B01,890124,Upadrashta; Pranav Kumar,18,0,30,12
1746571617232,MATH 120A,A01,890126,Eggers; John Dietrich,13,0,30,17
1746571618260,MATH 142B,A01,890128,Ioana; Adrian,19,0,30,11
1746571618260,MATH 142B,A02,890129,Ioana; Adrian,13,0,30,17
1746571619286,MATH 154,A01,890174,Staff,0,0,30,30
1746571619286,MATH 154,A02,890182,Staff,0,0,30,30
1746571620318,MATH 168A,A01,890197,Dumitriu; Ioana,21,0,35,14
1746571621348,MATH 170A,A01,890240,Nie; Jiawang,1,0,30,29
1746571621348,MATH 170A,A02,890241,Nie; Jiawang,11,0,30,19
1746571621348,MATH 170A,A03,890249,Nie; Jiawang,23,0,30,7
1746571622377,MATH 170B,A01,957891,Nag; Panchali,13,0,35,22
1746571624431,MATH 181A,A01,908025,Staff,0,4,35,35
1746571624431,MATH 181A,A02,960115,Staff,27,0,35,8
1746571625459,MATH 181B,A01,959874,Staff,25,0,30,5
1746571626487,MATH 193B,A01,890265,Staff,0,4,35,35
1746571627518,MGT 4,A01,890311,Anderson; John Charles,42,0,88,46
1746571628544,MGT 5,A00,907740,Staff,13,0,98,85
1746571629575,MGT 12,A00,890312,Lindenberger; Wade Douglas,67,0,98,31
1746571630600,MGT 16,A00,957883,Staff,78,0,98,20
1746571632651,MGT 45,A00,890314,Pecore; Joseph P.,46,0,98,52
1746571633675,MGT 71,A00,890315,Staff,0,11,98,98
1746571634700,MGT 100,A00,890316,Yavorsky; Daniel Ryan,44,0,98,54
1746571635725,MGT 103,A00,890317,Ehrich; Kristine R,73,0,98,25
1746571636750,MGT 105,A00,890356,Bates; Kenneth Walter,0,8,98,98
1746571637778,MGT 112,A00,890360,Ehrich; Kristine R,55,0,98,43
1746571638806,MGT 127R,A00,907732,Zhu; Kevin Xiaoguo,23,0,98,75
1746571639831,MGT 131B,A00,890361,Anderson; John Charles,60,0,98,38
1746571640860,MGT 137,A00,890362,Lindenberger; Wade Douglas,65,0,98,33
1746571641886,MGT 160,A00,890369,Johnson; Erik Barry,9,0,98,89
1746571643938,MGT 164,A00,890372,Zimmermann; Carsten,0,40,98,98
1746571644966,MGT 180,A00,890374,Bliss; Barbara Ann,12,0,98,86
1746571645992,MMW 15,A01,886414,Chang; Edmond Yi-Teh,0,12,28,28
1746571645992,MMW 15,A02,886415,Chang; Edmond Yi-Teh,0,8,28,28
1746571645992,MMW 15,A03,886416,Chang; Edmond Yi-Teh,0,8,28,28
1746571645992,MMW 15,A04,886417,Chang; Edmond Yi-Teh,0,8,28,28
1746571645992,MMW 15,B01,886419,Chang; Edmond Yi-Teh,0,7,28,28
1746571645992,MMW 15,B02,886420,Chang; Edmond Yi-Teh,0,8,28,28
1746571645992,MMW 15,B03,886421,Chang; Edmond Yi-Teh,0,7,28,28
1746571645992,MMW 15,B04,886422,Chang; Edmond Yi-Teh,0,8,28,28
1746571645992,MMW 15,C01,886424,Staff,0,9,28,28
1746571645992,MMW 15,C02,886425,Staff,0,8,28,28
1746571645992,MMW 15,C03,886426,Staff,0,8,28,28
1746571645992,MMW 15,C04,886427,Staff,0,8,28,28
1746571645992,MMW 15,C05,958038,Staff,0,8,28,28
1746571645992,MMW 15,C06,958039,Staff,1,8,28,27
1746571647018,MMW 15GS,A00,906910,Patterson; Patrick H.,4,0,28,24
1746571648042,MMW 122R,A01,886429,Rahimi; Babak,0,13,28,28
1746571648042,MMW 122R,A02,886430,Rahimi; Babak,0,12,28,28
1746571648042,MMW 122R,A03,958040,Rahimi; Babak,0,11,28,28
1746571649067,MUS 1A,A01,890937,Staff,2,0,25,23
1746571649067,MUS 1A,A02,891035,Staff,6,0,25,19
1746571649067,MUS 1A,C01,958912,Staff,24,0,25,1
1746571649067,MUS 1A,C02,958913,Staff,25,0,25,0
1746571651118,MUS 2AK,A00,957092,Ohnishi; Takae,15,0,15,0
1746571652149,MUS 4,A01,891044,Staff,1,0,25,24
1746571652149,MUS 4,A02,891045,Staff,23,0,25,2
1746571652149,MUS 4,B01,891048,Staff,17,0,25,8
1746571652149,MUS 4,B02,891050,Staff,25,0,25,0
1746571653176,MUS 5,A01,957506,Dubnov; Shlomo,0,0,25,25
1746571653176,MUS 5,A02,957622,Dubnov; Shlomo,13,0,25,12
1746571653176,MUS 5,A03,957623,Dubnov; Shlomo,20,0,25,5
1746571654209,MUS 6,A01,891053,Freitas Caetano; Marcelo,24,0,25,1
1746571654209,MUS 6,A02,891054,Freitas Caetano; Marcelo,23,0,25,2
1746571655237,MUS 7,A01,891081,Staff,0,0,25,25
1746571655237,MUS 7,A02,891082,Staff,3,0,25,22
1746571656260,MUS 8GS,A00,891118,Borgo; David Garcia,1,0,25,24
1746571657286,MUS 11,A01,891140,Staff,9,0,25,16
1746571657286,MUS 11,A02,891141,Staff,22,0,25,3
1746571658313,MUS 13,A01,891143,Staff,8,0,25,17
1746571658313,MUS 13,A02,891144,Staff,24,0,25,1
1746571659339,MUS 15,A01,891146,Staff,9,0,25,16
1746571659339,MUS 15,A02,891148,Staff,21,0,25,4
1746571659339,MUS 15,B01,891150,Staff,18,0,25,7
1746571659339,MUS 15,B02,891151,Staff,25,0,25,0
1746571660368,MUS 20,A01,891153,Staff,5,0,20,15
1746571660368,MUS 20,A02,891155,Staff,14,0,20,6
1746571661396,MUS 80,A00,891156,Staff,19,0,25,6
1746571661396,MUS 80,B00,891157,Staff,23,0,25,2
1746571662421,MUS 130,A00,891158,Ohnishi; Takae,35,0,35,0
1746571663445,MUS 150GS,A01,891160,Borgo; David Garcia,1,0,25,24
1746571664474,MUS 170,A01,891162,Freitas Caetano; Marcelo,20,0,25,5
1746571664474,MUS 170,A02,891164,Freitas Caetano; Marcelo,21,0,25,4
1746571665502,NANO 11,A00,886220,Vazquez Mena; Oscar,13,0,15,2
1746571666535,NANO 15,A01,886222,Drews; Aaron,4,0,7,3
1746571667561,NANO 104,A00,886224,Sirbuly; Donald,17,0,25,8
1746571668585,PH 40,A00,886528,Staff,23,0,40,17
1746571669611,PH 45,A01,886799,Staff,35,0,40,5
1746571670635,PH 110,A00,886802,Staff,0,7,40,40
1746571671659,PH 172,A00,906716,Staff,19,0,35,16
1746571672686,PH 191,A00,886803,Staff,6,0,40,34
1746571673713,PHIL 1,A00,889500,Staff,20,0,30,10
1746571674740,PHIL 10,A01,889549,Grush; Rick Scott,15,0,22,7
1746571674740,PHIL 10,A02,889551,Grush; Rick Scott,22,0,22,0
1746571675771,PHIL 28,A01,889559,Lamey; Andy M.,0,2,31,31
1746571675771,PHIL 28,A02,889561,Lamey; Andy M.,0,1,30,30
1746571675771,PHIL 28,A03,889572,Lamey; Andy M.,0,1,30,30
1746571676797,PHIL 35,A00,907839,Staff,13,0,15,2
1746571677823,PHIL 60,A00,889574,Staff,73,0,90,17
1746571678850,PHIL 101,A00,958004,Staff,12,0,15,3
1746571680901,PHIL 136,A00,889582,Fulkerson; Matthew Todd,26,0,45,19
1746571681931,PHIL 163,A01,889601,Staff,21,0,30,9
1746571681931,PHIL 163,B01,889606,Brandt; Reuven A,0,3,0,0
1746571682955,PHIL 164,A00,889610,Staff,16,0,30,14
1746571683985,PHIL 165,A00,889613,Staff,22,0,30,8
1746571685010,PHYS 1A,A00,886431,Staff,26,0,70,44
1746571686034,PHYS 1AL,001,886432,Tsai; Philbert S,0,2,30,30
1746571686034,PHYS 1AL,002,886436,Tsai; Philbert S,11,0,30,19
1746571687059,PHYS 1B,A00,886439,Staff,185,0,240,55
1746571688086,PHYS 1BL,001,886441,Tsai; Philbert S,0,4,30,30
1746571688086,PHYS 1BL,002,886444,Tsai; Philbert S,2,0,30,28
1746571689112,PHYS 1C,A00,896092,Arnold; Kam S,78,0,146,68
1746571690139,PHYS 1CL,001,886448,Tsai; Philbert S,0,0,30,30
1746571690139,PHYS 1CL,002,886449,Tsai; Philbert S,1,0,30,29
1746571690139,PHYS 1CL,003,886450,Tsai; Philbert S,16,0,30,14
1746571690139,PHYS 1CL,004,886451,Tsai; Philbert S,15,0,30,15
1746571691165,PHYS 2B,A01,886457,Staff,68,0,115,47
1746571692190,PHYS 2C,A01,886460,Shotwell; Brian,0,9,65,65
1746571693219,PHYS 2CL,A01,886467,Staff,0,4,28,28
1746571693219,PHYS 2CL,A02,886468,Staff,0,3,28,28
1746571694246,PHYS 2D,A01,886470,Staff,10,0,50,40
1746571695277,PHYS 4B,A01,886475,Grinstein; Benjamin,22,0,40,18
1746571696307,POLI 5,A00,891173,Desposato; Scott,7,0,25,18
1746571697333,POLI 5D,A01,891175,Staff,5,0,5,0
1746571697333,POLI 5D,B01,891178,Staff,5,0,5,0
1746571698362,POLI 11,A00,891179,Ferree; Karen E,2,0,35,33
1746571699391,POLI 12,A00,891180,Staff,16,0,30,14
1746571700419,POLI 27,A01,891182,Staff,12,0,75,63
1746571701443,POLI 30,A00,891183,Staff,8,0,50,42
1746571702473,POLI 100B,A00,891244,Staff,5,1,35,30
1746571703502,POLI 100I,A00,891247,Staff,7,0,30,23
1746571704528,POLI 104J,A00,891248,Nichter; Maysa,14,0,30,16
1746571705558,POLI 104U,A00,891250,Nichter; Maysa,2,0,30,28
1746571707611,POLI 110B,A00,891255,Wiens; David,19,0,25,6
1746571708640,POLI 112A,A00,891256,Wiens; David,6,0,25,19
1746571709666,POLI 114BR,A00,891261,Staff,19,0,30,11
1746571710693,POLI 117R,A00,891262,Forman; Fonna,0,6,50,50
1746571711719,POLI 118,A00,891264,Ingham; Sean,17,0,25,8
1746571712749,POLI 124A,A00,891265,Staff,18,0,20,2
1746571713774,POLI 125D,A00,891266,Nichter; Simeon C,2,0,25,23
1746571714839,POLI 126,A00,891268,Nichter; Simeon C,7,0,25,18
1746571715862,POLI 126AA,A00,891272,Staff,16,0,25,9
1746571716891,POLI 130AA,A00,891273,Staff,15,0,20,5
1746571717916,POLI 134AA,A00,891274,Staff,4,0,20,16
1746571719972,POLI 138,A00,891278,Staff,21,0,25,4
1746571720997,POLI 142K,A00,891280,Staff,10,0,25,15
1746571722026,POLI 142M,A00,891281,Gartzke; Erik,16,0,30,14
1746571723052,POLI 142P,A00,891284,Staff,20,0,30,10
1746571724077,POLI 143,A00,891285,Gartzke; Erik,12,0,30,18
1746571725101,POLI 153,A00,891286,Staff,19,0,20,1
1746571727153,POLI 175,A00,891290,Staff,15,0,20,5
1746571728180,PSYC 1,A00,890674,Steiner; Eric Tomas,0,11,45,45
1746571729208,PSYC 2,A00,890676,Albright; Thomas D,21,0,35,14
1746571730234,PSYC 3,A00,890679,Staff,17,0,20,3
1746571731263,PSYC 6,A00,959858,Staff,20,0,20,0
1746571732290,PSYC 60,A01,890684,Rickard; Timothy C.,0,5,45,45
1746571733320,PSYC 70,A01,890689,Geller; Emma Harlan,7,0,30,23
1746571734350,PSYC 71,A01,959860,Staff,21,0,25,4
1746571735374,PSYC 100,A00,890690,Lacefield; Katharine I,0,50,180,180
1746571736402,PSYC 102,A00,890695,Staff,18,0,40,22
1746571737428,PSYC 105,A00,890699,Geller; Emma Harlan,70,0,100,30
1746571738458,PSYC 106,A00,890701,Gorman; Michael R.,6,0,30,24
1746571739486,PSYC 108,A00,890704,Adrian; Julia Anna,0,28,50,50
1746571740515,PSYC 118,A01,890712,Staff,11,0,30,19
1746571741544,PSYC 124,A00,890716,Chapman; Eddie Nathaniel,25,0,60,35
1746571742572,PSYC 131,A00,890717,Anagnostaras; Stephan,0,8,80,80
1746571743602,PSYC 137,A00,890719,Winkielman; Piotr,0,11,30,30
1746571744628,PSYC 144,A00,890721,Adrian; Julia Anna,0,9,45,45
1746571745655,PSYC 162,A00,890805,Staff,0,0,75,75
1746571746684,PSYC 169,A00,890810,Staff,0,14,30,30
1746571747709,PSYC 172,A00,890814,Gorman; Michael R.,9,0,30,21
1746571748736,PSYC 181,A00,890818,Anagnostaras; Stephan,9,0,200,191
1746571749762,PSYC 184,A00,959861,Staff,168,0,175,7
1746571750788,PSYC 189,A00,890823,Staff,0,2,30,30
1746571751816,PSYC 191,A00,890884,Rickard; Timothy C.,0,12,35,35
1746571752842,PSYC 193,A00,890913,Staff,19,0,30,11
1746571752842,PSYC 193,B00,890914,Chapman; Eddie Nathaniel,24,0,30,6
1746571753870,PSYC 193L,A01,890918,Lowe; Angela Beth,20,0,30,10
1746571753870,PSYC 193L,B01,890921,Hurwitz; Ethan Scott,20,0,30,10
1746571753870,PSYC 193L,C01,890928,Staff,30,0,30,0
1746571754899,RELI 149,A00,886806,Rahimi; Babak,23,0,40,17
1746571755926,SE 9,A01,886814,Staff,7,0,20,13
1746571756952,SE 101B,A01,886816,Chadha; Mayank,4,0,35,31
1746571757984,SE 110B,A00,886818,Zhu; Qiang,4,0,75,71
1746571759010,SE 125,A01,886830,Staff,10,0,30,20
1746571760045,SE 130B,A01,886835,Staff,14,0,40,26
1746571761070,SE 131A,A01,886838,Krysl; Petr,34,0,55,21
1746571762101,SE 154,A00,886840,Staff,29,0,50,21
1746571763129,SE 164GS,A01,886849,Staff,6,0,20,14
1746571764153,SE 167GS,A01,886853,Staff,6,0,20,14
1746571765179,SIO 25,A01,890107,Staff,19,0,30,11
1746571766207,SIO 45,A00,890109,Cook; Geoffrey W,117,0,200,83
1746571767237,SIO 109R,A00,890110,Forman; Fonna,0,16,20,20
1746571768266,SIO 187,A01,890114,Kacev; David,15,0,40,25
1746571769295,SOCI 1,A01,890431,Thorpe; Charles Robert,15,0,30,15
1746571769295,SOCI 1,A02,890518,Thorpe; Charles Robert,30,0,30,0
1746571770320,SOCI 2,A01,957978,Staff,25,0,25,0
1746571770320,SOCI 2,A02,957979,Staff,23,0,25,2
1746571771345,SOCI 20,A01,890523,Calderon-Zaks; Michael Aar,21,0,30,9
1746571771345,SOCI 20,A02,890526,Calderon-Zaks; Michael Aar,29,0,30,1
1746571772371,SOCI 30,A01,890533,Pardo Guerra; Juan Pablo,37,0,40,3
1746571773399,SOCI 40,A01,890535,Staff,27,0,45,18
1746571774423,SOCI 104Q,A00,890559,Staff,18,0,30,12
1746571775450,SOCI 106,A00,890560,Arnal; Maud Marie Leonie,20,0,30,10
1746571776476,SOCI 110,A00,890567,Holkenbrink-Monk; Charlene,19,0,30,11
1746571777500,SOCI 112,A00,890568,Victoria Torres; Pablo,2,0,55,53
1746571778530,SOCI 115,A00,890597,Arnal; Maud Marie Leonie,28,0,45,17
1746571780582,SOCI 121,A00,890604,Pardo Guerra; Juan Pablo,38,0,45,7
1746571781607,SOCI 126,A01,890608,Staff,8,0,10,2
1746571782636,SOCI 127,A00,890609,Staff,18,0,30,12
1746571783677,SOCI 131,A00,890610,Thorpe; Charles Robert,37,0,45,8
1746571784702,SOCI 135,A00,890615,Payne; Christine Anna,13,0,45,32
1746571785728,SOCI 139,A00,890620,Staff,38,0,45,7
1746571786759,SOCI 148E,A00,890622,Calderon-Zaks; Michael Aar,36,0,45,9
1746571787784,SOCI 150,A00,890623,Kohler; Kristopher M.,31,0,45,14
1746571788812,SOCI 157,A00,890625,Jules-Rosette; Bennetta W.,18,0,20,2
1746571789842,SOCI 160,A00,890627,Payne; Christine Anna,21,0,45,24
1746571790868,SYN 1,A00,886855,Fish; Gwendolyn Anne,0,0,0,0
1746571790868,SYN 1,B00,906086,Fish; Gwendolyn Anne,0,2,0,2
1746571791893,SYN 2R,A00,886860,Staff,0,17,15,15
1746571791893,SYN 2R,B00,906106,Atkinson; Arthur Laird,0,16,15,15
1746571792920,SYN 100,A01,886866,Browne; Emily,0,28,20,20
1746571792920,SYN 100,B01,906128,Rock; Martin,0,5,20,20
1746571792920,SYN 100,C01,906140,Deavenport; James Cary,0,3,20,20
1746571792920,SYN 100,D01,907816,Deavenport; James Cary,0,5,20,20
1746571793946,TDAC 1,A00,890286,Walsh; Kim C.,8,0,20,12
1746571794971,TDAC 101,A00,890296,Basso; Beatrice,15,0,20,5
1746571795997,TDDE 131,A00,890297,Staff,47,0,50,3
1746571797023,TDDM 1,A00,890287,Weinberg; Sadie,25,0,30,5
1746571798051,TDGE 11,A00,890288,Fulton; Julia,137,0,200,63
1746571798051,TDGE 11,B00,890289,Castro; Robert Jess,184,0,200,16
1746571799075,TDGE 25,B00,957359,Walsh; Kim C.,4,0,20,16
1746571800101,TDGE 40,A01,890292,Power; Jade Yukana,27,0,30,3
1746571801126,TDGE 124,A00,890298,Havis; Allan,0,1,50,50
1746571802154,TDGE 131R,A00,890299,Burelle; Julie Sara Veronique,15,0,42,27
1746571803189,TDHT 101,A00,890300,Staff,10,0,20,10
1746571804217,TDHT 109,A01,890302,Anderson; Mysia Anyse,31,0,40,9
1746571805243,TDMV 1,A00,890293,Arcidiacono; Kristin,18,0,30,12
1746571806269,TDMV 2,A00,890294,Weinberg; Sadie,23,0,30,7
1746571807296,TDMV 3,A00,957878,Arcidiacono; Kristin,28,0,30,2
1746571809349,TDMV 138,A00,890304,Jun; Grace Shin Hae,25,0,40,15
1746571810380,TDMV 140,A00,890305,Corrales; Joseph Bernales,25,0,30,5
1746571811406,TDMV 142,A00,890307,Caligagan; Tony,32,0,40,8
1746571812432,TDMV 144,A00,890308,Camaya; Michelle Ann,25,0,30,5
1746571813457,TDPW 1,A00,890295,Stein; Deborah Isobel,3,0,20,17
1746571814488,USP 2,A01,890272,Lerner; Amy M,6,0,20,14
1746571815512,USP 3,A01,890274,Staff,12,0,30,18
1746571816541,USP 15,A01,890276,Sun; Feiyang,16,0,30,14
1746571817567,USP 25,A00,890277,Shenkman; Michael Thomas,19,0,25,6
1746571818595,USP 138,A00,890278,Staff,14,0,25,11
1746571819619,USP 143,A00,890279,Staff,22,0,70,48
1746571820648,USP 144,A00,890280,Chowdhury; Muhammed Zohir,16,0,30,14
1746571821675,USP 150,A00,890281,Boomhower; Matthew Charles,4,0,30,26
1746571822699,USP 151,A00,890282,Staff,16,0,20,4
1746571823725,USP 162,A00,890283,Andrews; Abigail Leslie,16,0,20,4
1746571824750,USP 168,A00,920477,Kwak; Nancy,0,0,5,5
1746571825775,USP 181,A00,890284,Staff,3,0,20,17
1746571826800,USP 191A,A00,890285,Staff,12,0,20,8
1746571837776,VIS 101,A00,886512,Staff,26,0,75,49
1746571838804,VIS 103,A00,886513,Cruz; Edwin Teddy,61,0,75,14
1746571839832,VIS 108,A00,886514,Staff,3,0,15,12
1746571840857,VIS 127P,A00,886515,Shen; Kuiyi,80,0,146,66
1746571841893,VIS 149,A00,886516,Yoldas; Pinar,0,0,15,15
1746571842919,VIS 164,A00,886526,Erdmann; Dean,19,0,22,3
1746571843944,VIS 194S,A00,886527,Staff,61,0,75,14
1746571844970,WCWP 10A,C00,886484,Martiniuk; Jill,12,0,15,3
1746571846000,WCWP 10B,A00,886490,Uriarte; Emma,0,0,15,15
1746571846000,WCWP 10B,B00,886491,Dhir; Simrita,9,0,15,6
1746571846000,WCWP 10B,C00,886492,Ornelas; Tricia,0,0,15,15
1746571847026,WCWP 100,A00,886494,Young; Mark T,0,6,15,15
1746571849149,AAS 10,A01,886199,Childs; Dennis R.,0,3,0,0
1746571850175,ANAR 104,A01,886940,Shtienberg; Gilad,27,0,30,3
1746571851200,ANAR 120,A00,886953,Staff,12,0,20,8
1746571852230,ANBI 148,A01,886955,Wilder; Linnea Lorene,30,0,40,10
1746571854281,ANSC 122,A00,886957,Staff,25,0,30,5
1746571855306,ANSC 150,A00,886958,Sloane; Julia Kathryn,2,0,15,13
1746571856333,ANSC 156,A00,886959,Jenkins; Janis A.,0,1,15,15
1746571857356,ANSC 180,A00,886960,Staff,11,0,17,6
1746571858383,ANSC 188,A00,886961,Jassal; Aftab,9,0,25,16
1746571859411,ANSC 190,A00,886962,Jassal; Aftab,14,0,25,11
1746571860438,ANSC 191,A00,886963,Staff,18,0,20,2
1746571861462,ANTH 3,A01,891689,Staff,17,0,20,3
1746571862488,ANTH 5,A00,886933,Semendeferi; Ekaterini,16,0,20,4
1746571863513,ANTH 10,A00,886934,Staff,0,12,30,30
1746571864539,ANTH 21,A01,886936,Staff,41,0,60,19
1746571865563,ANTH 23,A01,886938,Staff,92,0,100,8
1746571866592,ANTH 105,A00,886964,Stewart; Alexander B,84,0,100,16
1746571867620,ANTH 108,A00,886965,Pedersen; David,9,0,20,11
1746571868650,AWP 10,001,886147,Staff,0,0,0,0
1746571868650,AWP 10,002,886148,Staff,0,0,0,0
1746571868650,AWP 10,003,886149,Staff,0,0,0,0
1746571868650,AWP 10,004,886150,Staff,0,0,0,0
1746571868650,AWP 10,005,886151,Staff,0,0,0,0
1746571868650,AWP 10,006,886152,Staff,0,0,0,0
1746571868650,AWP 10,007,886153,Staff,0,0,0,0
1746571868650,AWP 10,008,886154,Staff,0,0,0,0
1746571868650,AWP 10,009,886155,Staff,0,0,0,0
1746571868650,AWP 10,010,886156,Staff,0,0,0,0
1746571868650,AWP 10,011,886158,Staff,0,0,0,0
1746571868650,AWP 10,012,886160,Staff,0,0,0,0
1746571868650,AWP 10,013,886161,Staff,0,0,0,0
1746571868650,AWP 10,014,886162,Staff,0,0,0,0
1746571868650,AWP 10,015,886163,Staff,0,0,0,0
1746571868650,AWP 10,016,886164,Staff,0,0,0,0
1746571868650,AWP 10,017,886165,Staff,0,0,0,0
1746571868650,AWP 10,018,886166,Staff,0,0,0,0
1746571868650,AWP 10,019,886168,Staff,0,0,0,0
1746571868650,AWP 10,020,886170,Staff,0,0,0,0
1746571868650,AWP 10,021,886172,Staff,0,0,0,0
1746571869680,AWP 10R,001,886173,Staff,0,1,0,0
1746571869680,AWP 10R,002,886174,Staff,0,1,0,0
1746571869680,AWP 10R,003,886175,Staff,0,0,0,0
1746571869680,AWP 10R,004,886176,Staff,0,0,0,0
1746571869680,AWP 10R,005,886177,Staff,0,0,0,0
1746571869680,AWP 10R,006,886178,Staff,0,0,0,0
1746571869680,AWP 10R,007,886179,Staff,0,0,0,0
1746571869680,AWP 10R,008,886181,Staff,0,0,0,0
1746571869680,AWP 10R,009,886182,Staff,0,0,0,0
1746571869680,AWP 10R,010,886183,Staff,0,0,0,0
1746571869680,AWP 10R,011,886184,Staff,0,0,0,0
1746571869680,AWP 10R,012,886185,Staff,0,0,0,0
1746571869680,AWP 10R,013,886186,Staff,0,0,0,0
1746571869680,AWP 10R,014,886187,Staff,0,0,0,0
1746571869680,AWP 10R,015,886188,Staff,0,0,0,0
1746571869680,AWP 10R,016,886189,Staff,0,0,0,0
1746571869680,AWP 10R,017,960532,Staff,0,0,0,0
1746571869680,AWP 10R,018,960533,Staff,0,0,0,0
1746571869680,AWP 10R,019,960534,Staff,0,0,0,0
1746571869680,AWP 10R,020,960538,Staff,0,0,0,0
1746571869680,AWP 10R,021,960540,Staff,0,0,0,0
1746571869680,AWP 10R,022,960541,Staff,0,0,0,0
1746571869680,AWP 10R,023,960542,Staff,0,0,0,0
1746571869680,AWP 10R,024,960544,Staff,0,0,0,0
1746571869680,AWP 10R,025,960545,Staff,0,0,0,0
1746571869680,AWP 10R,026,960548,Staff,0,0,0,0
1746571870705,AWP 102R,A00,886190,Staff,0,0,0,0
1746571870705,AWP 102R,B00,886191,Staff,0,0,0,0
1746571871734,BENG 100,A01,886193,Staff,17,0,30,13
1746571872759,BENG 122A,A01,886195,Hasty; Jeff M,13,0,30,17
1746571873784,BENG 166A,A00,886196,Sah; Robert Lie-Yuan,0,2,30,30
1746571874810,BENG 190,A00,958050,Khojah; Reem I,20,0,25,5
1746571875836,BIBC 102,A01,894320,Staff,0,0,46,46
1746571875836,BIBC 102,A02,894321,Staff,0,0,46,46
1746571875836,BIBC 102,A03,894344,Staff,7,0,46,39
1746571875836,BIBC 102,A04,894345,Staff,27,0,47,20
1746571876864,BICD 100R,A01,894365,Smith; Laurie,0,3,58,58
1746571876864,BICD 100R,A02,894366,Smith; Laurie,0,5,58,58
1746571876864,BICD 100R,A03,894367,Smith; Laurie,0,0,59,59
1746571876864,BICD 100R,A04,959869,Smith; Laurie,40,0,59,19
1746571877893,BICD 136,A01,894383,Gustafson-Brown; Cindy,14,0,50,36
1746571878921,BIEB 102,A01,894494,Butler; Shannon Rhey,51,0,130,79
1746571880975,BIEB 150,A01,894617,Wills; Christopher,3,0,20,17
1746571880975,BIEB 150,A02,894631,Wills; Christopher,3,0,20,17
1746571880975,BIEB 150,A03,894937,Wills; Christopher,3,0,20,17
1746571880975,BIEB 150,A04,894946,Wills; Christopher,5,0,20,15
1746571882002,BIEB 194,A00,906141,Kurle; Carolyn M.,6,0,20,14
1746571883028,BILD 1,A01,894154,Staff,3,0,19,16
1746571883028,BILD 1,A02,894155,Staff,14,0,19,5
1746571883028,BILD 1,A03,894160,Staff,13,0,19,6
1746571883028,BILD 1,A04,894161,Staff,15,0,18,3
1746571884054,BILD 2,A01,894168,Staff,0,0,50,50
1746571884054,BILD 2,A02,894169,Staff,0,0,50,50
1746571884054,BILD 2,A03,894179,Staff,0,0,50,50
1746571884054,BILD 2,A04,894203,Staff,24,0,50,26
1746571885079,BILD 3,A01,894213,Staff,22,0,31,9
1746571885079,BILD 3,A02,894214,Staff,26,0,31,5
1746571885079,BILD 3,A03,894235,Staff,28,0,31,3
1746571885079,BILD 3,A04,894236,Staff,28,0,32,4
1746571886109,BILD 4,A01,894253,Reuther; Keefe,6,0,24,18
1746571886109,BILD 4,A02,894258,Reuther; Keefe,16,0,24,8
1746571887140,BILD 5,A01,894276,Reuther; Keefe,35,0,50,15
1746571887140,BILD 5,A02,894277,Reuther; Keefe,45,0,50,5
1746571887140,BILD 5,A03,894290,Reuther; Keefe,44,0,50,6
1746571887140,BILD 5,A04,894291,Reuther; Keefe,48,0,50,2
1746571888165,BILD 24,A01,894297,Pirino; Giorgia,40,0,60,20
1746571889191,BIMM 100,B01,958915,Staff,71,0,100,29
1746571890216,BIMM 101,A01,895017,McDonnell; Lisa Marie,0,5,24,24
1746571890216,BIMM 101,A02,895018,McDonnell; Lisa Marie,0,5,24,24
1746571890216,BIMM 101,B01,895020,McDonnell; Lisa Marie,0,6,24,24
1746571890216,BIMM 101,B02,895021,McDonnell; Lisa Marie,0,4,24,24
1746571891246,BIMM 110,A01,895023,Staff,1,0,25,24
1746571891246,BIMM 110,A02,895024,Staff,9,0,25,16
1746571891246,BIMM 110,A03,895025,Staff,18,0,25,7
1746571891246,BIMM 110,A04,895031,Staff,20,0,25,5
1746571892276,BIMM 120,A01,895114,Gustafson-Brown; Cindy,14,0,28,14
1746571892276,BIMM 120,A02,895126,Gustafson-Brown; Cindy,21,0,27,6
1746571893303,BIPN 100,A01,895130,Yang; Mingyu,0,0,38,38
1746571893303,BIPN 100,A02,895131,Yang; Mingyu,32,0,38,6
1746571893303,BIPN 100,A03,895132,Yang; Mingyu,32,0,38,6
1746571893303,BIPN 100,A04,895133,Yang; Mingyu,27,0,36,9
1746571894327,BIPN 120,A01,895135,Cooke; James Edward,0,3,13,13
1746571894327,BIPN 120,A02,895136,Cooke; James Edward,0,1,13,13
1746571894327,BIPN 120,A03,895137,Cooke; James Edward,0,3,13,13
1746571894327,BIPN 120,A04,895156,Cooke; James Edward,0,2,11,11
1746571895351,BIPN 134,A01,895235,Cooke; James Edward,0,2,25,25
1746571895351,BIPN 134,A02,895237,Cooke; James Edward,0,0,25,25
1746571895351,BIPN 134,A03,895240,Cooke; James Edward,3,0,25,22
1746571895351,BIPN 134,A04,895270,Cooke; James Edward,20,0,25,5
1746571896376,BIPN 189,A00,892103,Staff,0,14,14,14
1746571898424,BISP 194,A00,958008,Staff,0,2,0,0
1746571899449,CAT 124,A01,922009,Staff,0,5,20,20
1746571900481,CAT 125R,A00,886390,Morales; Celeste Georgianna,0,2,20,20
1746571900481,CAT 125R,B00,886391,Irwin; Matthew Joseph,0,4,20,20
1746571900481,CAT 125R,C00,886392,Smith; Lauryn Alissa,0,2,20,20
1746571900481,CAT 125R,D00,886393,Vanderschuit; Maya Alysia,0,3,20,20
1746571900481,CAT 125R,E00,886394,Marchisotto; Jennifer Anne,0,3,20,20
1746571901507,CENG 15,A01,886218,Drews; Aaron,3,0,8,5
1746571902533,CENG 113,A00,886219,Opatkiewicz; Justin Paul,15,0,25,10
1746571903558,CGS 101,A00,887044,Staff,7,0,20,13
1746571904586,CGS 105,A01,887046,Staff,14,0,25,11
1746571905611,CGS 112,A00,887047,Cuong; Marisol,12,0,15,3
1746571906636,CGS 113,A00,887048,Staff,23,0,30,7
1746571907662,CGS 120,A00,887049,Staff,10,0,17,7
1746571908688,CHEM 6A,A01,886336,Lam; Tin Yiu,38,0,50,12
1746571908688,CHEM 6A,A02,886338,Lam; Tin Yiu,37,0,50,13
1746571909717,CHEM 6B,A01,886341,Hopkins; Patrycja Anna,16,0,50,34
1746571909717,CHEM 6B,A02,886343,Hopkins; Patrycja Anna,42,0,50,8
1746571910742,CHEM 6C,A01,886346,Albizati; Kim F.,0,2,50,50
1746571910742,CHEM 6C,A02,886348,Albizati; Kim F.,23,0,50,27
1746571911771,CHEM 40A,A01,886352,Klosterman; Jeremy K,65,0,100,35
1746571912795,CHEM 40B,A01,886356,Klosterman; Jeremy K,0,23,100,100
1746571913823,CHEM 41B,A01,886360,Theodorakis; Emmanuel,25,0,50,25
1746571913823,CHEM 41B,A02,886362,Theodorakis; Emmanuel,47,0,50,3
1746571914851,CHIN 165A,A00,886382,Xu; Li,18,0,20,2
1746571915878,CLAS 120,A00,886387,Myerston Santana; Jacobo,33,0,40,7
1746571916904,COGS 9,A01,886967,Shannon; Kyle Michael,42,0,60,18
1746571917929,COGS 11,A01,886969,Staff,10,0,30,20
1746571918957,COGS 14A,A01,886971,Staff,6,0,60,54
1746571919981,COGS 14B,A01,886973,Hoffman; Drew Ellen,4,0,60,56
1746571921007,COGS 18,A01,886975,Morgan; Eric,35,0,60,25
1746571922033,COGS 20,A01,886977,Staff,4,0,8,4
1746571922033,COGS 20,A02,886978,Staff,5,0,7,2
1746571923056,COGS 100,A01,907783,Staff,1,2,30,29
1746571924081,COGS 101B,A01,886980,Staff,0,3,48,48
1746571925106,COGS 101C,A01,886982,Delgado; Tania,0,5,44,44
1746571926131,COGS 102A,A01,886984,Johnson; Christine M.,4,0,30,26
1746571927159,COGS 118B,A01,886986,Staff,1,3,88,87
1746571928188,COGS 150,A01,886988,Bergen; Benjamin,22,0,50,28
1746571929212,COGS 153,A00,886989,Delgado; Tania,0,2,41,41
1746571930237,COGS 186,A01,886991,Staff,0,0,32,32
1746571931264,COGS 187A,A01,886993,Boyle; Mary E. T.,7,0,30,23
1746571932288,COGS 189,A00,886994,Staff,0,1,30,30
1746571933313,COMM 10,A01,886996,Staff,0,0,20,21
1746571933313,COMM 10,A02,886997,Staff,12,0,20,8
1746571933313,COMM 10,A03,959845,Staff,19,0,20,1
1746571934339,COMM 20,A01,886999,Leuning; Grant Maurstad,24,0,40,16
1746571936397,COMM 100A,A01,887002,Staff,0,0,20,25
1746571936397,COMM 100A,A02,887003,Staff,6,0,20,14
1746571937423,COMM 100B,A01,887005,Staff,0,8,20,24
1746571938449,COMM 106D,A00,887006,Staff,13,0,40,27
1746571939475,COMM 110G,A00,887007,Whitworth-Smith; Andrew C,12,0,40,28
1746571940502,COMM 111B,A00,887008,Staff,31,0,40,9
1746571941528,COMM 113T,A00,887009,Abuelhiga; Soraya Jill,28,0,40,12
1746571941528,COMM 113T,B00,906733,Staff,40,0,40,0
1746571942552,COMM 145,A00,887010,Staff,12,0,40,28
1746571943577,COMM 146,A00,887054,Staff,31,0,40,9
1746571944603,COMM 190,A00,887012,Staff,8,0,23,15
1746571945628,CSE 8A,A50,887015,Cao; Yingjun,57,0,85,28
1746571946652,CSE 11,A01,887017,Cao; Yingjun,12,0,70,58
1746571947679,CSE 20,A01,887019,Staff,30,0,50,20
1746571948707,CSE 21,A01,887021,Staff,78,0,100,22
1746571948707,CSE 21,B01,892583,Braun; Oliver,45,0,50,5
1746571949735,CSE 30,A01,887025,Eldon; John,143,0,200,57
1746571950763,CSE 100,A01,887027,Staff,26,0,50,24
1746571950763,CSE 100,A02,887028,Staff,42,0,50,8
1746571951788,CSE 101,A01,887030,Braun; Oliver,74,0,100,26
1746571951788,CSE 101,B01,887032,Jones; Miles E,0,3,50,50
1746571951788,CSE 101,B02,887033,Jones; Miles E,0,2,50,50
1746571952812,CSE 105,A01,908084,Jones; Miles E,32,0,50,18
1746571952812,CSE 105,A02,908087,Jones; Miles E,31,0,50,19
1746571953842,CSE 135,A01,887035,Powell; Thomas Allan,0,5,50,50
1746571954866,CSE 142,A01,887037,Staff,8,0,60,52
1746571955895,CSE 142L,A01,887039,Staff,34,0,60,26
1746571956920,CSE 151A,A01,887041,Solares; Edwin A,47,0,100,53
1746571957946,CSE 175,A01,887043,Kumar; Rakesh,30,0,30,0
1746571958973,CSS 1,A01,886389,Staff,1,1,40,39
1746571960003,DSC 30,A01,908097,Liao; Soohyun Nam,47,0,75,28
1746571961029,DSC 40A,A01,908099,Shannon; Kyle Michael,30,0,50,20
1746571962057,DSC 40B,A01,908112,Staff,15,0,50,35
1746571963085,DSC 80,A01,908116,Staff,19,0,60,41
1746571964110,DSC 197,001,956863,Eldridge; Justin Matthew,9999,0,9999,0
1746571965140,ECE 5,A01,886400,Morris; Karcher William,1,0,6,5
1746571965140,ECE 5,A02,886401,Morris; Karcher William,3,0,6,3
1746571966169,ECE 148,A01,886403,Silberman; Jack,0,14,14,14
1746571967198,ECON 1,A01,887265,Crane; Meredith Helen,12,0,70,58
1746571967198,ECON 1,B01,887268,Staff,43,0,50,7
1746571968226,ECON 2,A01,887273,Crane; Meredith Helen,55,0,70,15
1746571969257,ECON 3,A01,887279,Rondina; Giacomo,32,0,70,38
1746571970283,ECON 4,A01,887282,Anderson; John Charles,0,2,10,10
1746571971308,ECON 5,A01,887285,Staff,34,0,45,11
1746571971308,ECON 5,B01,887292,Staff,41,0,45,4
1746571972339,ECON 100A,A01,887337,Newhouse; Herbert S,54,0,70,16
1746571972339,ECON 100A,B01,887349,Staff,45,0,50,5
1746571973363,ECON 100B,A01,887361,Du; Songzi,29,0,70,41
1746571974392,ECON 100C,A01,887445,Newhouse; Herbert S,59,0,70,11
1746571975417,ECON 105,A00,887488,Vespa; Emanuel Ignacio,23,0,35,12
1746571976444,ECON 109,A01,887506,Shishkin; Denis,28,0,35,7
1746571977469,ECON 110A,A01,887568,Alon; Titan Michael,0,3,35,35
1746571977469,ECON 110A,B01,907601,Alon; Titan Michael,20,0,35,15
1746571978494,ECON 110B,A01,887598,Levkoff; Steven B.,0,24,70,70
1746571979521,ECON 112,A00,887599,Rondina; Giacomo,19,0,35,16
1746571980548,ECON 120A,A01,887603,Dai; Yinlin,35,0,70,35
1746571981576,ECON 120C,A01,887608,Sun; Yixiao,0,1,35,35
1746571981576,ECON 120C,B01,887614,Sun; Yixiao,0,0,35,35
1746571982601,ECON 138,A00,887621,Bharadwaj; Prashant,0,21,20,20
1746571983626,ECON 144,A00,958007,Squires; Dale E,12,0,35,23
1746571984651,ECON 171,A01,907666,Staff,18,0,35,17
1746571985680,ECON 175,A00,887626,Wu; Pak Yeung,22,0,35,13
1746571986706,ECON 190,A00,887640,Vespa; Emanuel Ignacio,22,0,35,13
1746571987737,EDS 25,A01,888197,Staff,0,0,0,0
1746571987737,EDS 25,A02,888209,Staff,0,0,0,0
1746571987737,EDS 25,A03,888210,Staff,0,0,0,0
1746571987737,EDS 25,A04,888212,Staff,0,0,0,0
1746571987737,EDS 25,A05,888213,Staff,0,0,0,0
1746571987737,EDS 25,A06,888214,Staff,0,0,0,0
1746571987737,EDS 25,A07,888235,Staff,0,2,0,0
1746571987737,EDS 25,A08,888236,Staff,0,0,0,0
1746571987737,EDS 25,A09,888240,Staff,0,0,0,0
1746571987737,EDS 25,A10,888244,Staff,0,0,0,0
1746571987737,EDS 25,B01,888273,Staff,0,0,0,0
1746571987737,EDS 25,B02,888285,Staff,0,0,0,0
1746571987737,EDS 25,B03,888423,Staff,0,0,0,1
1746571987737,EDS 25,B04,888432,Staff,0,0,0,0
1746571987737,EDS 25,B05,888433,Staff,0,0,0,0
1746571987737,EDS 25,B06,888467,Staff,0,0,0,0
1746571987737,EDS 25,B07,888468,Staff,0,0,0,0
1746571987737,EDS 25,B08,888479,Staff,0,0,0,0
1746571987737,EDS 25,B09,888484,Staff,0,0,0,0
1746571987737,EDS 25,B10,888487,Staff,0,0,0,0
1746571988763,EDS 38,A01,907700,Choi; Bailey Miyeon,30,0,30,0
1746571989788,EDS 112,A01,888601,Chapman; Thandeka K,12,0,40,28
1746571990815,EDS 115,A00,888697,Mendez; Kathrina Mendoza,10,0,30,20
1746571991840,EDS 116,A01,888893,Staff,34,0,40,6
1746571993893,EDS 124AR,A00,889133,Staff,29,0,50,21
1746571993893,EDS 124AR,B00,907471,Simon; Elizabeth A,37,0,50,13
1746571994918,EDS 124BR,A00,889134,Simon; Elizabeth A,44,0,100,56
1746571995947,EDS 125,A00,889135,Staff,25,0,30,5
1746571996972,EDS 126,A01,889138,Staff,35,0,40,5
1746571998000,EDS 164R,A01,889142,Wishard Guerra; Alison G.,33,0,50,17
1746571999026,ENG 30,A01,886396,Staff,0,0,0,0
1746571999026,ENG 30,B01,886398,Staff,0,0,0,0
1746572000052,ENVR 102,A00,906150,Montejo; Carolina,23,0,25,2
1746572001078,ETHN 103A,A00,887236,Man; Simeon S,0,3,0,0
1746572002104,ETHN 113,A00,887239,Staff,16,0,30,14
1746572003129,ETHN 116,A00,887240,Staff,16,0,25,9
1746572004157,ETHN 117,A00,887241,Choi; Esther Min,28,0,30,2
1746572005181,ETHN 118,A00,887243,Staff,24,0,30,6
1746572006207,ETHN 127,A00,887248,Cuong; Marisol,11,0,15,4
1746572007231,ETHN 139,A00,887250,Staff,7,0,10,3
1746572008259,ETHN 142,A00,887252,Staff,10,0,30,20
1746572009287,ETHN 161,A00,887253,Browne; Errol Tsekani,24,0,30,6
1746572010315,ETHN 163FR,A00,887255,Burelle; Julie Sara Veronique,0,0,5,5
1746572011341,GLBH 20,A00,889149,Elwardani; Nile Regina,8,0,42,34
1746572013393,GLBH 111,A01,889152,Burgos; Jose L.,17,0,17,0
1746572014421,GLBH 150,A00,889181,Sloane; Julia Kathryn,0,5,15,15
1746572016473,HDS 60,A01,886406,Warstadt; Melissa Fawn,73,0,80,7
1746572017504,HIAF 111,A00,889324,Gyamfi; Bright,25,0,32,7
1746572018532,HIEA 131,A00,889328,Staff,15,0,32,17
1746572019557,HIEA 144,A00,889333,Henry; Todd A.,26,0,32,6
1746572020587,HIEA 154,A00,889336,Henry; Todd A.,24,0,32,8
1746572021612,HIEU 106,A00,889339,Staff,22,0,32,10
1746572023665,HIEU 114,A00,889340,Staff,4,0,32,28
1746572024691,HIEU 135GS,A00,889342,Patterson; Patrick H.,0,0,1,24
1746572025719,HIEU 137,A00,889343,Edington; Claire Ellen,10,0,25,15
1746572026744,HIEU 148,A00,889345,Staff,14,0,32,18
1746572027769,HIEU 154,A00,889346,Biess; Frank Peter,21,0,32,11
1746572028796,HILA 102,A00,889351,Staff,12,0,32,20
1746572029822,HILD 2A,A01,889221,Lewandoski; Julia Mavis,1,10,32,31
1746572030847,HILD 7B,A01,889225,Man; Simeon S,0,12,32,32
1746572031873,HILD 7C,A01,889288,Alvarez; Luis A,0,14,32,32
1746572032901,HILD 30,A01,889323,Staff,0,5,32,32
1746572034959,HISC 119,A00,889383,Golan; Tal,19,0,32,13
1746572035984,HIUS 103,A00,889384,Man; Simeon S,0,0,32,32
1746572037015,HIUS 117,A00,919797,Kwak; Nancy,19,0,32,13
1746572038040,HIUS 142A,A00,919788,Staff,22,0,32,10
1746572040102,HIUS 149,A00,889386,Gyamfi; Bright,26,0,32,6
1746572041126,HIUS 155,A00,889387,Alvarez; Luis A,15,0,32,17
1746572042151,HUM 3,A01,886499,Caldwell; Michael Alan,19,0,50,31
1746572043176,HUM 3GS,A00,886500,Rodriguez; Bretton Sigfred,0,0,0,28
1746572044241,HUM 3R,A01,886502,Markman; Kristina,0,36,50,50
1746572045271,HUM 4,A01,886504,Crum; Matthew Stephen,24,0,50,26
1746572045271,HUM 4,B01,886506,West; Geoffrey Scott,17,0,50,33
1746572046295,HUM 4GS,A00,886507,Staff,0,0,0,19
1746572047322,HUM 5,A01,886509,Staff,32,0,50,18
1746572048351,HUM 5R,A01,886511,Zavodny; Tatiana Sophia,0,39,50,50
1746572049378,JAPN 180,A00,886407,Staff,16,0,40,24
1746572050403,LATI 50,A01,886409,Martin-Cabrera; Luis,4,0,22,18
1746572050403,LATI 50,A02,886410,Martin-Cabrera; Luis,19,0,22,3
1746572050403,LATI 50,A03,886411,Martin-Cabrera; Luis,21,0,22,1
1746572050403,LATI 50,A04,886412,Martin-Cabrera; Luis,9,0,22,13
1746572051432,LAWS 101,A00,907664,Staff,28,0,60,32
1746572052456,LIAB 1A,A00,889388,Saab; Dima,17,0,20,3
1746572053485,LIAB 1AX,A00,889389,El Cheddadi; Youniss,18,0,20,2
1746572054510,LIFR 1C,A00,889391,Van Moer; Vinciane G,8,0,20,12
1746572055535,LIFR 1CX,A00,889392,Van Moer; Vinciane G,7,0,20,13
1746572056560,LIFR 1D,A00,889393,Van Moer; Vinciane G,7,0,20,13
1746572057589,LIFR 1DX,A00,889394,Van Moer; Vinciane G,8,0,20,12
1746572058616,LIGN 7,A00,886923,Staff,24,0,50,26
1746572059641,LIGN 17,A00,886924,Kehler; Andrew Scott,125,0,150,25
1746572060665,LTAM 110,A00,889395,Staff,15,0,30,15
1746572061689,LTAM 110GS,A00,958010,Rodriguez; Bretton Sigfred,0,0,0,28
1746572062714,LTCH 101,A00,889397,Staff,23,0,25,2
1746572063742,LTCS 130,A00,889398,Staff,23,0,25,2
1746572064768,LTEA 138,A00,889399,Staff,24,0,40,16
1746572065793,LTEN 149,A00,889400,Wesling; Megan E.,0,3,25,25
1746572066819,LTEN 169,A00,889401,Staff,20,0,25,5
1746572067844,LTEN 180,A00,889402,Staff,10,0,15,5
1746572068869,LTEN 181,A00,889403,Staff,21,0,25,4
1746572069894,LTWL 100,A00,889404,Myerston Santana; Jacobo,2,0,25,23
1746572070920,LTWL 180GS,A00,889405,Staff,0,0,20,20
1746572071946,LTWL 181,A00,889406,Staff,16,0,25,9
1746572072979,LTWL 184,A00,889475,Mukherjee; Silpa,22,0,25,3
1746572074006,LTWR 102C,A00,889486,Staff,29,0,30,1
1746572075034,LTWR 115W,A00,889491,Staff,0,2,15,15
1746572076061,MAE 8,A01,886905,Staff,0,2,0,0
1746572077090,MAE 11,A00,886906,Bandaru; Prabhakar,0,7,50,50
1746572078115,MAE 20,A00,886907,Evdokimenko; Ekaterina,43,0,70,27
1746572079145,MAE 30B,A00,886909,Ghazinejad; Maziar,26,0,45,19
1746572080176,MAE 101B,A00,886910,Saintillan; David,29,0,45,16
1746572081205,MAE 105,A00,886911,Bandaru; Prabhakar,18,0,50,32
1746572082233,MAE 107,B00,958024,Staff,8,0,50,42
1746572083265,MAE 143B,A00,886913,Bewley; Thomas R,5,0,40,35
1746572084292,MAE 148,A01,886915,Silberman; Jack,0,3,14,14
1746572085317,MAE 160,A00,886916,Evdokimenko; Ekaterina,31,0,60,29
1746572086343,MATH 3C,A01,889681,Staff,0,2,30,30
1746572086343,MATH 3C,A02,960048,Staff,24,0,30,6
1746572087368,MATH 10A,A01,889760,Staff,26,0,30,4
1746572087368,MATH 10A,A02,889783,Staff,29,0,30,1
1746572088394,MATH 10B,A01,889785,Verstraete; Jacques Allan,2,0,35,33
1746572088394,MATH 10B,A02,889795,Verstraete; Jacques Allan,4,0,35,31
1746572088394,MATH 10B,B01,889797,Verstraete; Jacques Allan,3,0,35,32
1746572088394,MATH 10B,B02,889828,Verstraete; Jacques Allan,3,0,35,32
1746572089419,MATH 10C,A01,889849,Habib; Yousaf,7,0,30,23
1746572089419,MATH 10C,A02,889852,Habib; Yousaf,14,0,30,16
1746572089419,MATH 10C,A03,889853,Habib; Yousaf,22,0,30,8
1746572089419,MATH 10C,A04,889858,Habib; Yousaf,20,0,30,10
1746572089419,MATH 10C,B01,889861,Staff,1,0,30,29
1746572089419,MATH 10C,B02,889862,Staff,24,0,30,6
1746572089419,MATH 10C,B03,889863,Staff,27,0,30,3
1746572089419,MATH 10C,B04,889967,Staff,23,0,30,7
1746572090449,MATH 18,A01,889974,Staff,7,0,30,23
1746572090449,MATH 18,A02,889977,Staff,20,0,30,10
1746572090449,MATH 18,B01,889984,Hardiman; Liam,21,0,30,9
1746572090449,MATH 18,B02,889985,Hardiman; Liam,25,0,30,5
1746572091473,MATH 20A,A01,889990,Suk; Andrew Hoon,30,0,35,5
1746572092500,MATH 20B,A01,889993,Ohm; Ko Woon,22,0,30,8
1746572092500,MATH 20B,A02,889994,Ohm; Ko Woon,30,0,30,0
1746572092500,MATH 20B,B01,889996,Ohm; Ko Woon,22,0,30,8
1746572092500,MATH 20B,B02,889997,Ohm; Ko Woon,23,0,30,7
1746572093529,MATH 20C,A01,889999,Hammock; Frances H,17,0,30,13
1746572093529,MATH 20C,A02,890003,Hammock; Frances H,23,0,30,7
1746572093529,MATH 20C,B01,890006,Hammock; Frances H,3,0,30,27
1746572093529,MATH 20C,B02,890007,Hammock; Frances H,12,0,30,18
1746572094555,MATH 20D,A01,890011,Cheng; Hsiao-Bing,1,1,30,29
1746572094555,MATH 20D,A02,890012,Cheng; Hsiao-Bing,14,0,30,16
1746572094555,MATH 20D,B01,890016,Cheng; Hsiao-Bing,13,0,30,17
1746572094555,MATH 20D,B02,890017,Cheng; Hsiao-Bing,13,0,30,17
1746572095586,MATH 20E,A01,890026,Harel; Guershon,1,0,30,29
1746572095586,MATH 20E,A02,890029,Harel; Guershon,23,0,30,7
1746572095586,MATH 20E,B01,890033,Harel; Guershon,7,0,30,23
1746572095586,MATH 20E,B02,890101,Harel; Guershon,21,0,30,9
1746572096611,MATH 102,A01,890104,Staff,17,0,30,13
1746572096611,MATH 102,A02,890105,Staff,27,0,30,3
1746572097643,MATH 103B,A01,890116,Salehi Golsefidy; Alireza,3,0,30,27
1746572097643,MATH 103B,B01,890118,Staff,0,3,34,34
1746572098668,MATH 109,A01,890121,Aliabadi Sr.; Mohsen,1,0,30,29
1746572098668,MATH 109,B01,890124,Upadrashta; Pranav Kumar,18,0,30,12
1746572099693,MATH 120A,A01,890126,Eggers; John Dietrich,13,0,30,17
1746572100723,MATH 142B,A01,890128,Ioana; Adrian,19,0,30,11
1746572100723,MATH 142B,A02,890129,Ioana; Adrian,13,0,30,17
1746572101749,MATH 154,A01,890174,Staff,0,0,30,30
1746572101749,MATH 154,A02,890182,Staff,0,0,30,30
1746572102783,MATH 168A,A01,890197,Dumitriu; Ioana,21,0,35,14
1746572103808,MATH 170A,A01,890240,Nie; Jiawang,1,0,30,29
1746572103808,MATH 170A,A02,890241,Nie; Jiawang,11,0,30,19
1746572103808,MATH 170A,A03,890249,Nie; Jiawang,23,0,30,7
1746572104838,MATH 170B,A01,957891,Nag; Panchali,13,0,35,22
1746572106891,MATH 181A,A01,908025,Staff,0,4,35,35
1746572106891,MATH 181A,A02,960115,Staff,27,0,35,8
1746572107922,MATH 181B,A01,959874,Staff,25,0,30,5
1746572108948,MATH 193B,A01,890265,Staff,0,4,35,35
1746572109977,MGT 4,A01,890311,Anderson; John Charles,42,0,88,46
1746572111002,MGT 5,A00,907740,Staff,13,0,98,85
1746572112028,MGT 12,A00,890312,Lindenberger; Wade Douglas,67,0,98,31
1746572113052,MGT 16,A00,957883,Staff,78,0,98,20
1746572115111,MGT 45,A00,890314,Pecore; Joseph P.,46,0,98,52
1746572116138,MGT 71,A00,890315,Staff,0,11,98,98
1746572117164,MGT 100,A00,890316,Yavorsky; Daniel Ryan,44,0,98,54
1746572118192,MGT 103,A00,890317,Ehrich; Kristine R,73,0,98,25
1746572119221,MGT 105,A00,890356,Bates; Kenneth Walter,0,8,98,98
1746572120247,MGT 112,A00,890360,Ehrich; Kristine R,55,0,98,43
1746572121273,MGT 127R,A00,907732,Zhu; Kevin Xiaoguo,23,0,98,75
1746572122300,MGT 131B,A00,890361,Anderson; John Charles,60,0,98,38
1746572123325,MGT 137,A00,890362,Lindenberger; Wade Douglas,65,0,98,33
1746572124350,MGT 160,A00,890369,Johnson; Erik Barry,9,0,98,89
1746572126399,MGT 164,A00,890372,Zimmermann; Carsten,0,40,98,98
1746572127425,MGT 180,A00,890374,Bliss; Barbara Ann,12,0,98,86
1746572128460,MMW 15,A01,886414,Chang; Edmond Yi-Teh,0,12,28,28
1746572128460,MMW 15,A02,886415,Chang; Edmond Yi-Teh,0,8,28,28
1746572128460,MMW 15,A03,886416,Chang; Edmond Yi-Teh,0,8,28,28
1746572128460,MMW 15,A04,886417,Chang; Edmond Yi-Teh,0,8,28,28
1746572128460,MMW 15,B01,886419,Chang; Edmond Yi-Teh,0,7,28,28
1746572128460,MMW 15,B02,886420,Chang; Edmond Yi-Teh,0,8,28,28
1746572128460,MMW 15,B03,886421,Chang; Edmond Yi-Teh,0,7,28,28
1746572128460,MMW 15,B04,886422,Chang; Edmond Yi-Teh,0,8,28,28
1746572128460,MMW 15,C01,886424,Staff,0,9,28,28
1746572128460,MMW 15,C02,886425,Staff,0,8,28,28
1746572128460,MMW 15,C03,886426,Staff,0,8,28,28
1746572128460,MMW 15,C04,886427,Staff,0,8,28,28
1746572128460,MMW 15,C05,958038,Staff,0,8,28,28
1746572128460,MMW 15,C06,958039,Staff,1,8,28,27
1746572129486,MMW 15GS,A00,906910,Patterson; Patrick H.,4,0,28,24
1746572130515,MMW 122R,A01,886429,Rahimi; Babak,0,13,28,28
1746572130515,MMW 122R,A02,886430,Rahimi; Babak,0,12,28,28
1746572130515,MMW 122R,A03,958040,Rahimi; Babak,0,11,28,28
1746572131547,MUS 1A,A01,890937,Staff,2,0,25,23
1746572131547,MUS 1A,A02,891035,Staff,6,0,25,19
1746572131547,MUS 1A,C01,958912,Staff,24,0,25,1
1746572131547,MUS 1A,C02,958913,Staff,25,0,25,0
1746572133601,MUS 2AK,A00,957092,Ohnishi; Takae,15,0,15,0
1746572134627,MUS 4,A01,891044,Staff,1,0,25,24
1746572134627,MUS 4,A02,891045,Staff,23,0,25,2
1746572134627,MUS 4,B01,891048,Staff,17,0,25,8
1746572134627,MUS 4,B02,891050,Staff,25,0,25,0
1746572135652,MUS 5,A01,957506,Dubnov; Shlomo,0,0,25,25
1746572135652,MUS 5,A02,957622,Dubnov; Shlomo,13,0,25,12
1746572135652,MUS 5,A03,957623,Dubnov; Shlomo,20,0,25,5
1746572136680,MUS 6,A01,891053,Freitas Caetano; Marcelo,24,0,25,1
1746572136680,MUS 6,A02,891054,Freitas Caetano; Marcelo,23,0,25,2
1746572137705,MUS 7,A01,891081,Staff,0,0,25,25
1746572137705,MUS 7,A02,891082,Staff,3,0,25,22
1746572138729,MUS 8GS,A00,891118,Borgo; David Garcia,1,0,25,24
1746572139755,MUS 11,A01,891140,Staff,9,0,25,16
1746572139755,MUS 11,A02,891141,Staff,22,0,25,3
1746572140784,MUS 13,A01,891143,Staff,8,0,25,17
1746572140784,MUS 13,A02,891144,Staff,24,0,25,1
1746572141809,MUS 15,A01,891146,Staff,9,0,25,16
1746572141809,MUS 15,A02,891148,Staff,21,0,25,4
1746572141809,MUS 15,B01,891150,Staff,18,0,25,7
1746572141809,MUS 15,B02,891151,Staff,25,0,25,0
1746572142835,MUS 20,A01,891153,Staff,5,0,20,15
1746572142835,MUS 20,A02,891155,Staff,14,0,20,6
1746572143863,MUS 80,A00,891156,Staff,19,0,25,6
1746572143863,MUS 80,B00,891157,Staff,23,0,25,2
1746572144887,MUS 130,A00,891158,Ohnishi; Takae,35,0,35,0
1746572145915,MUS 150GS,A01,891160,Borgo; David Garcia,1,0,25,24
1746572146943,MUS 170,A01,891162,Freitas Caetano; Marcelo,20,0,25,5
1746572146943,MUS 170,A02,891164,Freitas Caetano; Marcelo,21,0,25,4
1746572147968,NANO 11,A00,886220,Vazquez Mena; Oscar,13,0,15,2
1746572148993,NANO 15,A01,886222,Drews; Aaron,4,0,7,3
1746572150023,NANO 104,A00,886224,Sirbuly; Donald,17,0,25,8
1746572151050,PH 40,A00,886528,Staff,23,0,40,17
1746572152075,PH 45,A01,886799,Staff,35,0,40,5
1746572153101,PH 110,A00,886802,Staff,0,7,40,40
1746572154129,PH 172,A00,906716,Staff,19,0,35,16
1746572155153,PH 191,A00,886803,Staff,6,0,40,34
1746572156179,PHIL 1,A00,889500,Staff,20,0,30,10
1746572157205,PHIL 10,A01,889549,Grush; Rick Scott,15,0,22,7
1746572157205,PHIL 10,A02,889551,Grush; Rick Scott,22,0,22,0
1746572158233,PHIL 28,A01,889559,Lamey; Andy M.,0,2,31,31
1746572158233,PHIL 28,A02,889561,Lamey; Andy M.,0,1,30,30
1746572158233,PHIL 28,A03,889572,Lamey; Andy M.,0,1,30,30
1746572159258,PHIL 35,A00,907839,Staff,13,0,15,2
1746572160283,PHIL 60,A00,889574,Staff,73,0,90,17
1746572161311,PHIL 101,A00,958004,Staff,12,0,15,3
1746572163361,PHIL 136,A00,889582,Fulkerson; Matthew Todd,26,0,45,19
1746572164390,PHIL 163,A01,889601,Staff,21,0,30,9
1746572164390,PHIL 163,B01,889606,Brandt; Reuven A,0,3,0,0
1746572165417,PHIL 164,A00,889610,Staff,16,0,30,14
1746572166443,PHIL 165,A00,889613,Staff,22,0,30,8
1746572167471,PHYS 1A,A00,886431,Staff,26,0,70,44
1746572168499,PHYS 1AL,001,886432,Tsai; Philbert S,0,2,30,30
1746572168499,PHYS 1AL,002,886436,Tsai; Philbert S,11,0,30,19
1746572169527,PHYS 1B,A00,886439,Staff,185,0,240,55
1746572170558,PHYS 1BL,001,886441,Tsai; Philbert S,0,4,30,30
1746572170558,PHYS 1BL,002,886444,Tsai; Philbert S,2,0,30,28
1746572171585,PHYS 1C,A00,896092,Arnold; Kam S,78,0,146,68
1746572172617,PHYS 1CL,001,886448,Tsai; Philbert S,0,0,30,30
1746572172617,PHYS 1CL,002,886449,Tsai; Philbert S,1,0,30,29
1746572172617,PHYS 1CL,003,886450,Tsai; Philbert S,16,0,30,14
1746572172617,PHYS 1CL,004,886451,Tsai; Philbert S,15,0,30,15
1746572173644,PHYS 2B,A01,886457,Staff,68,0,115,47
1746572174672,PHYS 2C,A01,886460,Shotwell; Brian,0,9,65,65
1746572175698,PHYS 2CL,A01,886467,Staff,0,4,28,28
1746572175698,PHYS 2CL,A02,886468,Staff,0,3,28,28
1746572176723,PHYS 2D,A01,886470,Staff,10,0,50,40
1746572177753,PHYS 4B,A01,886475,Grinstein; Benjamin,22,0,40,18
1746572178780,POLI 5,A00,891173,Desposato; Scott,7,0,25,18
1746572179804,POLI 5D,A01,891175,Staff,5,0,5,0
1746572179804,POLI 5D,B01,891178,Staff,5,0,5,0
1746572180841,POLI 11,A00,891179,Ferree; Karen E,2,0,35,33
1746572181869,POLI 12,A00,891180,Staff,16,0,30,14
1746572182895,POLI 27,A01,891182,Staff,12,0,75,63
1746572183922,POLI 30,A00,891183,Staff,8,0,50,42
1746572184950,POLI 100B,A00,891244,Staff,5,1,35,30
1746572185978,POLI 100I,A00,891247,Staff,7,0,30,23
1746572187004,POLI 104J,A00,891248,Nichter; Maysa,14,0,30,16
1746572188029,POLI 104U,A00,891250,Nichter; Maysa,2,0,30,28
1746572190086,POLI 110B,A00,891255,Wiens; David,19,0,25,6
1746572191111,POLI 112A,A00,891256,Wiens; David,6,0,25,19
1746572192138,POLI 114BR,A00,891261,Staff,19,0,30,11
1746572193164,POLI 117R,A00,891262,Forman; Fonna,0,6,50,50
1746572194192,POLI 118,A00,891264,Ingham; Sean,17,0,25,8
1746572195217,POLI 124A,A00,891265,Staff,18,0,20,2
1746572196242,POLI 125D,A00,891266,Nichter; Simeon C,2,0,25,23
1746572197270,POLI 126,A00,891268,Nichter; Simeon C,7,0,25,18
1746572198297,POLI 126AA,A00,891272,Staff,16,0,25,9
1746572199327,POLI 130AA,A00,891273,Staff,15,0,20,5
1746572200353,POLI 134AA,A00,891274,Staff,4,0,20,16
1746572202412,POLI 138,A00,891278,Staff,21,0,25,4
1746572203437,POLI 142K,A00,891280,Staff,10,0,25,15
1746572204463,POLI 142M,A00,891281,Gartzke; Erik,16,0,30,14
1746572205488,POLI 142P,A00,891284,Staff,20,0,30,10
1746572206511,POLI 143,A00,891285,Gartzke; Erik,12,0,30,18
1746572207539,POLI 153,A00,891286,Staff,19,0,20,1
1746572209595,POLI 175,A00,891290,Staff,15,0,20,5
1746572210619,PSYC 1,A00,890674,Steiner; Eric Tomas,0,11,45,45
1746572211643,PSYC 2,A00,890676,Albright; Thomas D,21,0,35,14
1746572212674,PSYC 3,A00,890679,Staff,17,0,20,3
1746572213698,PSYC 6,A00,959858,Staff,20,0,20,0
1746572214726,PSYC 60,A01,890684,Rickard; Timothy C.,0,5,45,45
1746572215751,PSYC 70,A01,890689,Geller; Emma Harlan,7,0,30,23
1746572216778,PSYC 71,A01,959860,Staff,21,0,25,4
1746572217806,PSYC 100,A00,890690,Lacefield; Katharine I,0,50,180,180
1746572218832,PSYC 102,A00,890695,Staff,18,0,40,22
1746572219858,PSYC 105,A00,890699,Geller; Emma Harlan,70,0,100,30
1746572220886,PSYC 106,A00,890701,Gorman; Michael R.,6,0,30,24
1746572221913,PSYC 108,A00,890704,Adrian; Julia Anna,0,28,50,50
1746572222940,PSYC 118,A01,890712,Staff,11,0,30,19
1746572223965,PSYC 124,A00,890716,Chapman; Eddie Nathaniel,25,0,60,35
1746572224993,PSYC 131,A00,890717,Anagnostaras; Stephan,0,8,80,80
1746572226023,PSYC 137,A00,890719,Winkielman; Piotr,0,11,30,30
1746572227048,PSYC 144,A00,890721,Adrian; Julia Anna,0,9,45,45
1746572228076,PSYC 162,A00,890805,Staff,0,0,75,75
1746572229106,PSYC 169,A00,890810,Staff,0,14,30,30
1746572230134,PSYC 172,A00,890814,Gorman; Michael R.,9,0,30,21
1746572231159,PSYC 181,A00,890818,Anagnostaras; Stephan,9,0,200,191
1746572232186,PSYC 184,A00,959861,Staff,168,0,175,7
1746572233211,PSYC 189,A00,890823,Staff,0,2,30,30
1746572234237,PSYC 191,A00,890884,Rickard; Timothy C.,0,12,35,35
1746572235261,PSYC 193,A00,890913,Staff,19,0,30,11
1746572235261,PSYC 193,B00,890914,Chapman; Eddie Nathaniel,24,0,30,6
1746572236287,PSYC 193L,A01,890918,Lowe; Angela Beth,20,0,30,10
1746572236287,PSYC 193L,B01,890921,Hurwitz; Ethan Scott,20,0,30,10
1746572236287,PSYC 193L,C01,890928,Staff,30,0,30,0
1746572237315,RELI 149,A00,886806,Rahimi; Babak,23,0,40,17
1746572238339,SE 9,A01,886814,Staff,7,0,20,13
1746572239366,SE 101B,A01,886816,Chadha; Mayank,4,0,35,31
1746572240396,SE 110B,A00,886818,Zhu; Qiang,4,0,75,71
1746572241420,SE 125,A01,886830,Staff,10,0,30,20
1746572242447,SE 130B,A01,886835,Staff,14,0,40,26
1746572243477,SE 131A,A01,886838,Krysl; Petr,34,0,55,21
1746572244504,SE 154,A00,886840,Staff,29,0,50,21
1746572245529,SE 164GS,A01,886849,Staff,6,0,20,14
1746572246556,SE 167GS,A01,886853,Staff,6,0,20,14
1746572247582,SIO 25,A01,890107,Staff,19,0,30,11
1746572248608,SIO 45,A00,890109,Cook; Geoffrey W,117,0,200,83
1746572249634,SIO 109R,A00,890110,Forman; Fonna,0,16,20,20
1746572250662,SIO 187,A01,890114,Kacev; David,15,0,40,25
1746572251687,SOCI 1,A01,890431,Thorpe; Charles Robert,15,0,30,15
1746572251687,SOCI 1,A02,890518,Thorpe; Charles Robert,30,0,30,0
1746572252716,SOCI 2,A01,957978,Staff,25,0,25,0
1746572252716,SOCI 2,A02,957979,Staff,23,0,25,2
1746572253742,SOCI 20,A01,890523,Calderon-Zaks; Michael Aar,21,0,30,9
1746572253742,SOCI 20,A02,890526,Calderon-Zaks; Michael Aar,29,0,30,1
1746572254766,SOCI 30,A01,890533,Pardo Guerra; Juan Pablo,37,0,40,3
1746572255792,SOCI 40,A01,890535,Staff,27,0,45,18
1746572256818,SOCI 104Q,A00,890559,Staff,18,0,30,12
1746572257845,SOCI 106,A00,890560,Arnal; Maud Marie Leonie,20,0,30,10
1746572258869,SOCI 110,A00,890567,Holkenbrink-Monk; Charlene,19,0,30,11
1746572259897,SOCI 112,A00,890568,Victoria Torres; Pablo,2,0,55,53
1746572260922,SOCI 115,A00,890597,Arnal; Maud Marie Leonie,28,0,45,17
1746572262972,SOCI 121,A00,890604,Pardo Guerra; Juan Pablo,38,0,45,7
1746572264015,SOCI 126,A01,890608,Staff,8,0,10,2
1746572265042,SOCI 127,A00,890609,Staff,18,0,30,12
1746572266070,SOCI 131,A00,890610,Thorpe; Charles Robert,37,0,45,8
1746572267096,SOCI 135,A00,890615,Payne; Christine Anna,13,0,45,32
1746572268121,SOCI 139,A00,890620,Staff,38,0,45,7
1746572269148,SOCI 148E,A00,890622,Calderon-Zaks; Michael Aar,36,0,45,9
1746572270176,SOCI 150,A00,890623,Kohler; Kristopher M.,31,0,45,14
1746572271202,SOCI 157,A00,890625,Jules-Rosette; Bennetta W.,18,0,20,2
1746572272227,SOCI 160,A00,890627,Payne; Christine Anna,21,0,45,24
1746572273252,SYN 1,A00,886855,Fish; Gwendolyn Anne,0,0,0,0
1746572273252,SYN 1,B00,906086,Fish; Gwendolyn Anne,0,3,0,2
1746572274281,SYN 2R,A00,886860,Staff,0,17,15,15
1746572274281,SYN 2R,B00,906106,Atkinson; Arthur Laird,0,16,15,15
1746572275308,SYN 100,A01,886866,Browne; Emily,0,28,20,20
1746572275308,SYN 100,B01,906128,Rock; Martin,0,5,20,20
1746572275308,SYN 100,C01,906140,Deavenport; James Cary,0,3,20,20
1746572275308,SYN 100,D01,907816,Deavenport; James Cary,0,5,20,20
1746572276337,TDAC 1,A00,890286,Walsh; Kim C.,8,0,20,12
1746572277361,TDAC 101,A00,890296,Basso; Beatrice,15,0,20,5
1746572278387,TDDE 131,A00,890297,Staff,47,0,50,3
1746572279412,TDDM 1,A00,890287,Weinberg; Sadie,25,0,30,5
1746572280437,TDGE 11,A00,890288,Fulton; Julia,137,0,200,63
1746572280437,TDGE 11,B00,890289,Castro; Robert Jess,184,0,200,16
1746572281461,TDGE 25,B00,957359,Walsh; Kim C.,4,0,20,16
1746572282489,TDGE 40,A01,890292,Power; Jade Yukana,27,0,30,3
1746572283516,TDGE 124,A00,890298,Havis; Allan,0,1,50,50
1746572284541,TDGE 131R,A00,890299,Burelle; Julie Sara Veronique,15,0,42,27
1746572285569,TDHT 101,A00,890300,Staff,10,0,20,10
1746572286596,TDHT 109,A01,890302,Anderson; Mysia Anyse,31,0,40,9
1746572287622,TDMV 1,A00,890293,Arcidiacono; Kristin,18,0,30,12
1746572288648,TDMV 2,A00,890294,Weinberg; Sadie,23,0,30,7
1746572289677,TDMV 3,A00,957878,Arcidiacono; Kristin,28,0,30,2
1746572291729,TDMV 138,A00,890304,Jun; Grace Shin Hae,25,0,40,15
1746572292754,TDMV 140,A00,890305,Corrales; Joseph Bernales,25,0,30,5
1746572293780,TDMV 142,A00,890307,Caligagan; Tony,32,0,40,8
1746572294807,TDMV 144,A00,890308,Camaya; Michelle Ann,25,0,30,5
1746572295835,TDPW 1,A00,890295,Stein; Deborah Isobel,3,0,20,17
1746572296861,USP 2,A01,890272,Lerner; Amy M,7,0,20,13
1746572297887,USP 3,A01,890274,Staff,12,0,30,18
1746572298916,USP 15,A01,890276,Sun; Feiyang,16,0,30,14
1746572299944,USP 25,A00,890277,Shenkman; Michael Thomas,19,0,25,6
1746572300973,USP 138,A00,890278,Staff,14,0,25,11
1746572301999,USP 143,A00,890279,Staff,22,0,70,48
1746572303029,USP 144,A00,890280,Chowdhury; Muhammed Zohir,16,0,30,14
1746572304055,USP 150,A00,890281,Boomhower; Matthew Charles,4,0,30,26
1746572305080,USP 151,A00,890282,Staff,16,0,20,4
1746572306108,USP 162,A00,890283,Andrews; Abigail Leslie,16,0,20,4
1746572307135,USP 168,A00,920477,Kwak; Nancy,0,0,5,5
1746572308161,USP 181,A00,890284,Staff,3,0,20,17
1746572309186,USP 191A,A00,890285,Staff,12,0,20,8
1746572310213,VIS 101,A00,886512,Staff,26,0,75,49
1746572311240,VIS 103,A00,886513,Cruz; Edwin Teddy,61,0,75,14
1746572312269,VIS 108,A00,886514,Staff,3,0,15,12
1746572313297,VIS 127P,A00,886515,Shen; Kuiyi,80,0,146,66
1746572314328,VIS 149,A00,886516,Yoldas; Pinar,0,0,15,15
1746572315353,VIS 164,A00,886526,Erdmann; Dean,19,0,22,3
1746572316379,VIS 194S,A00,886527,Staff,61,0,75,14
1746572317408,WCWP 10A,C00,886484,Martiniuk; Jill,12,0,15,3
1746572318442,WCWP 10B,A00,886490,Uriarte; Emma,0,0,15,15
1746572318442,WCWP 10B,B00,886491,Dhir; Simrita,9,0,15,6
1746572318442,WCWP 10B,C00,886492,Ornelas; Tricia,0,0,15,15
1746572319467,WCWP 100,A00,886494,Young; Mark T,0,6,15,15
1746572321597,AAS 10,A01,886199,Childs; Dennis R.,0,3,0,0
1746572322627,ANAR 104,A01,886940,Shtienberg; Gilad,27,0,30,3
1746572323689,ANAR 120,A00,886953,Staff,12,0,20,8
1746572324717,ANBI 148,A01,886955,Wilder; Linnea Lorene,30,0,40,10
1746572326772,ANSC 122,A00,886957,Staff,25,0,30,5
1746572327797,ANSC 150,A00,886958,Sloane; Julia Kathryn,2,0,15,13
1746572328824,ANSC 156,A00,886959,Jenkins; Janis A.,0,1,15,15
1746572329849,ANSC 180,A00,886960,Staff,11,0,17,6
1746572330875,ANSC 188,A00,886961,Jassal; Aftab,9,0,25,16
1746572331902,ANSC 190,A00,886962,Jassal; Aftab,14,0,25,11
1746572332928,ANSC 191,A00,886963,Staff,18,0,20,2
1746572333952,ANTH 3,A01,891689,Staff,17,0,20,3
1746572334978,ANTH 5,A00,886933,Semendeferi; Ekaterini,16,0,20,4
1746572336007,ANTH 10,A00,886934,Staff,0,12,30,30
1746572337032,ANTH 21,A01,886936,Staff,41,0,60,19
1746572338060,ANTH 23,A01,886938,Staff,92,0,100,8
1746572339088,ANTH 105,A00,886964,Stewart; Alexander B,84,0,100,16
1746572340120,ANTH 108,A00,886965,Pedersen; David,9,0,20,11
1746572341155,AWP 10,001,886147,Staff,0,0,0,0
1746572341155,AWP 10,002,886148,Staff,0,0,0,0
1746572341155,AWP 10,003,886149,Staff,0,0,0,0
1746572341155,AWP 10,004,886150,Staff,0,0,0,0
1746572341155,AWP 10,005,886151,Staff,0,0,0,0
1746572341155,AWP 10,006,886152,Staff,0,0,0,0
1746572341155,AWP 10,007,886153,Staff,0,0,0,0
1746572341155,AWP 10,008,886154,Staff,0,0,0,0
1746572341155,AWP 10,009,886155,Staff,0,0,0,0
1746572341155,AWP 10,010,886156,Staff,0,0,0,0
1746572341155,AWP 10,011,886158,Staff,0,0,0,0
1746572341155,AWP 10,012,886160,Staff,0,0,0,0
1746572341155,AWP 10,013,886161,Staff,0,0,0,0
1746572341155,AWP 10,014,886162,Staff,0,0,0,0
1746572341155,AWP 10,015,886163,Staff,0,0,0,0
1746572341155,AWP 10,016,886164,Staff,0,0,0,0
1746572341155,AWP 10,017,886165,Staff,0,0,0,0
1746572341155,AWP 10,018,886166,Staff,0,0,0,0
1746572341155,AWP 10,019,886168,Staff,0,0,0,0
1746572341155,AWP 10,020,886170,Staff,0,0,0,0
1746572341155,AWP 10,021,886172,Staff,0,0,0,0
1746572342191,AWP 10R,001,886173,Staff,0,1,0,0
1746572342191,AWP 10R,002,886174,Staff,0,1,0,0
1746572342191,AWP 10R,003,886175,Staff,0,0,0,0
1746572342191,AWP 10R,004,886176,Staff,0,0,0,0
1746572342191,AWP 10R,005,886177,Staff,0,0,0,0
1746572342191,AWP 10R,006,886178,Staff,0,0,0,0
1746572342191,AWP 10R,007,886179,Staff,0,0,0,0
1746572342191,AWP 10R,008,886181,Staff,0,0,0,0
1746572342191,AWP 10R,009,886182,Staff,0,0,0,0
1746572342191,AWP 10R,010,886183,Staff,0,0,0,0
1746572342191,AWP 10R,011,886184,Staff,0,0,0,0
1746572342191,AWP 10R,012,886185,Staff,0,0,0,0
1746572342191,AWP 10R,013,886186,Staff,0,0,0,0
1746572342191,AWP 10R,014,886187,Staff,0,0,0,0
1746572342191,AWP 10R,015,886188,Staff,0,0,0,0
1746572342191,AWP 10R,016,886189,Staff,0,0,0,0
1746572342191,AWP 10R,017,960532,Staff,0,0,0,0
1746572342191,AWP 10R,018,960533,Staff,0,0,0,0
1746572342191,AWP 10R,019,960534,Staff,0,0,0,0
1746572342191,AWP 10R,020,960538,Staff,0,0,0,0
1746572342191,AWP 10R,021,960540,Staff,0,0,0,0
1746572342191,AWP 10R,022,960541,Staff,0,0,0,0
1746572342191,AWP 10R,023,960542,Staff,0,0,0,0
1746572342191,AWP 10R,024,960544,Staff,0,0,0,0
1746572342191,AWP 10R,025,960545,Staff,0,0,0,0
1746572342191,AWP 10R,026,960548,Staff,0,0,0,0
1746572343217,AWP 102R,A00,886190,Staff,0,0,0,0
1746572343217,AWP 102R,B00,886191,Staff,0,0,0,0
1746572344240,BENG 100,A01,886193,Staff,17,0,30,13
1746572345268,BENG 122A,A01,886195,Hasty; Jeff M,13,0,30,17
1746572346297,BENG 166A,A00,886196,Sah; Robert Lie-Yuan,0,2,30,30
1746572347320,BENG 190,A00,958050,Khojah; Reem I,20,0,25,5
1746572348347,BIBC 102,A01,894320,Staff,0,0,46,46
1746572348347,BIBC 102,A02,894321,Staff,0,0,46,46
1746572348347,BIBC 102,A03,894344,Staff,7,0,46,39
1746572348347,BIBC 102,A04,894345,Staff,27,0,47,20
1746572349375,BICD 100R,A01,894365,Smith; Laurie,0,3,58,58
1746572349375,BICD 100R,A02,894366,Smith; Laurie,0,5,58,58
1746572349375,BICD 100R,A03,894367,Smith; Laurie,0,0,59,59
1746572349375,BICD 100R,A04,959869,Smith; Laurie,40,0,59,19
1746572350401,BICD 136,A01,894383,Gustafson-Brown; Cindy,14,0,50,36
1746572351427,BIEB 102,A01,894494,Butler; Shannon Rhey,51,0,130,79
1746572353480,BIEB 150,A01,894617,Wills; Christopher,3,0,20,17
1746572353480,BIEB 150,A02,894631,Wills; Christopher,3,0,20,17
1746572353480,BIEB 150,A03,894937,Wills; Christopher,3,0,20,17
1746572353480,BIEB 150,A04,894946,Wills; Christopher,5,0,20,15
1746572354507,BIEB 194,A00,906141,Kurle; Carolyn M.,6,0,20,14
1746572355536,BILD 1,A01,894154,Staff,3,0,19,16
1746572355536,BILD 1,A02,894155,Staff,14,0,19,5
1746572355536,BILD 1,A03,894160,Staff,13,0,19,6
1746572355536,BILD 1,A04,894161,Staff,15,0,18,3
1746572356567,BILD 2,A01,894168,Staff,0,0,50,50
1746572356567,BILD 2,A02,894169,Staff,0,0,50,50
1746572356567,BILD 2,A03,894179,Staff,0,0,50,50
1746572356567,BILD 2,A04,894203,Staff,24,0,50,26
1746572357596,BILD 3,A01,894213,Staff,22,0,31,9
1746572357596,BILD 3,A02,894214,Staff,26,0,31,5
1746572357596,BILD 3,A03,894235,Staff,28,0,31,3
1746572357596,BILD 3,A04,894236,Staff,28,0,32,4
1746572358622,BILD 4,A01,894253,Reuther; Keefe,5,0,24,19
1746572358622,BILD 4,A02,894258,Reuther; Keefe,16,0,24,8
1746572359649,BILD 5,A01,894276,Reuther; Keefe,35,0,50,15
1746572359649,BILD 5,A02,894277,Reuther; Keefe,45,0,50,5
1746572359649,BILD 5,A03,894290,Reuther; Keefe,44,0,50,6
1746572359649,BILD 5,A04,894291,Reuther; Keefe,48,0,50,2
1746572360679,BILD 24,A01,894297,Pirino; Giorgia,40,0,60,20
1746572361707,BIMM 100,B01,958915,Staff,71,0,100,29
1746572362737,BIMM 101,A01,895017,McDonnell; Lisa Marie,0,5,24,24
1746572362737,BIMM 101,A02,895018,McDonnell; Lisa Marie,0,5,24,24
1746572362737,BIMM 101,B01,895020,McDonnell; Lisa Marie,0,6,24,24
1746572362737,BIMM 101,B02,895021,McDonnell; Lisa Marie,0,4,24,24
1746572363766,BIMM 110,A01,895023,Staff,1,0,25,24
1746572363766,BIMM 110,A02,895024,Staff,9,0,25,16
1746572363766,BIMM 110,A03,895025,Staff,18,0,25,7
1746572363766,BIMM 110,A04,895031,Staff,20,0,25,5
1746572364791,BIMM 120,A01,895114,Gustafson-Brown; Cindy,14,0,28,14
1746572364791,BIMM 120,A02,895126,Gustafson-Brown; Cindy,21,0,27,6
1746572365816,BIPN 100,A01,895130,Yang; Mingyu,0,0,38,38
1746572365816,BIPN 100,A02,895131,Yang; Mingyu,32,0,38,6
1746572365816,BIPN 100,A03,895132,Yang; Mingyu,32,0,38,6
1746572365816,BIPN 100,A04,895133,Yang; Mingyu,27,0,36,9
1746572366845,BIPN 120,A01,895135,Cooke; James Edward,0,3,13,13
1746572366845,BIPN 120,A02,895136,Cooke; James Edward,0,1,13,13
1746572366845,BIPN 120,A03,895137,Cooke; James Edward,0,3,13,13
1746572366845,BIPN 120,A04,895156,Cooke; James Edward,0,2,11,11
1746572367870,BIPN 134,A01,895235,Cooke; James Edward,0,2,25,25
1746572367870,BIPN 134,A02,895237,Cooke; James Edward,0,0,25,25
1746572367870,BIPN 134,A03,895240,Cooke; James Edward,3,0,25,22
1746572367870,BIPN 134,A04,895270,Cooke; James Edward,20,0,25,5
1746572368895,BIPN 189,A00,892103,Staff,0,14,14,14
1746572370947,BISP 194,A00,958008,Staff,0,2,0,0
1746572371972,CAT 124,A01,922009,Staff,0,5,20,20
1746572372999,CAT 125R,A00,886390,Morales; Celeste Georgianna,0,2,20,20
1746572372999,CAT 125R,B00,886391,Irwin; Matthew Joseph,0,4,20,20
1746572372999,CAT 125R,C00,886392,Smith; Lauryn Alissa,0,2,20,20
1746572372999,CAT 125R,D00,886393,Vanderschuit; Maya Alysia,0,3,20,20
1746572372999,CAT 125R,E00,886394,Marchisotto; Jennifer Anne,0,3,20,20
1746572374028,CENG 15,A01,886218,Drews; Aaron,3,0,8,5
1746572375054,CENG 113,A00,886219,Opatkiewicz; Justin Paul,15,0,25,10
1746572376079,CGS 101,A00,887044,Staff,7,0,20,13
1746572377104,CGS 105,A01,887046,Staff,14,0,25,11
1746572378129,CGS 112,A00,887047,Cuong; Marisol,12,0,15,3
1746572379157,CGS 113,A00,887048,Staff,23,0,30,7
1746572380181,CGS 120,A00,887049,Staff,10,0,17,7
1746572381210,CHEM 6A,A01,886336,Lam; Tin Yiu,38,0,50,12
1746572381210,CHEM 6A,A02,886338,Lam; Tin Yiu,37,0,50,13
1746572382235,CHEM 6B,A01,886341,Hopkins; Patrycja Anna,16,0,50,34
1746572382235,CHEM 6B,A02,886343,Hopkins; Patrycja Anna,42,0,50,8
1746572383264,CHEM 6C,A01,886346,Albizati; Kim F.,0,2,50,50
1746572383264,CHEM 6C,A02,886348,Albizati; Kim F.,23,0,50,27
1746572384294,CHEM 40A,A01,886352,Klosterman; Jeremy K,65,0,100,35
1746572385325,CHEM 40B,A01,886356,Klosterman; Jeremy K,0,23,100,100
1746572386351,CHEM 41B,A01,886360,Theodorakis; Emmanuel,25,0,50,25
1746572386351,CHEM 41B,A02,886362,Theodorakis; Emmanuel,47,0,50,3
1746572387377,CHIN 165A,A00,886382,Xu; Li,18,0,20,2
1746572388403,CLAS 120,A00,886387,Myerston Santana; Jacobo,33,0,40,7
1746572389431,COGS 9,A01,886967,Shannon; Kyle Michael,42,0,60,18
1746572390461,COGS 11,A01,886969,Staff,10,0,30,20
1746572391487,COGS 14A,A01,886971,Staff,6,0,60,54
1746572392515,COGS 14B,A01,886973,Hoffman; Drew Ellen,4,0,60,56
1746572393539,COGS 18,A01,886975,Morgan; Eric,35,0,60,25
1746572394563,COGS 20,A01,886977,Staff,4,0,8,4
1746572394563,COGS 20,A02,886978,Staff,5,0,7,2
1746572395588,COGS 100,A01,907783,Staff,1,2,30,29
1746572396613,COGS 101B,A01,886980,Staff,0,3,48,48
1746572397641,COGS 101C,A01,886982,Delgado; Tania,0,5,44,44
1746572398665,COGS 102A,A01,886984,Johnson; Christine M.,4,0,30,26
1746572399690,COGS 118B,A01,886986,Staff,1,3,88,87
1746572400714,COGS 150,A01,886988,Bergen; Benjamin,22,0,50,28
1746572401744,COGS 153,A00,886989,Delgado; Tania,0,2,41,41
1746572402777,COGS 186,A01,886991,Staff,0,0,32,32
1746572403806,COGS 187A,A01,886993,Boyle; Mary E. T.,7,0,30,23
1746572404833,COGS 189,A00,886994,Staff,0,1,30,30
1746572405859,COMM 10,A01,886996,Staff,0,0,20,21
1746572405859,COMM 10,A02,886997,Staff,12,0,20,8
1746572405859,COMM 10,A03,959845,Staff,19,0,20,1
1746572406889,COMM 20,A01,886999,Leuning; Grant Maurstad,24,0,40,16
1746572408941,COMM 100A,A01,887002,Staff,0,0,20,25
1746572408941,COMM 100A,A02,887003,Staff,6,0,20,14
1746572409976,COMM 100B,A01,887005,Staff,0,8,20,24
1746572411003,COMM 106D,A00,887006,Staff,13,0,40,27
1746572412033,COMM 110G,A00,887007,Whitworth-Smith; Andrew C,12,0,40,28
1746572413058,COMM 111B,A00,887008,Staff,31,0,40,9
1746572414107,COMM 113T,A00,887009,Abuelhiga; Soraya Jill,28,0,40,12
1746572414107,COMM 113T,B00,906733,Staff,40,0,40,0
1746572415132,COMM 145,A00,887010,Staff,12,0,40,28
1746572416159,COMM 146,A00,887054,Staff,31,0,40,9
1746572417184,COMM 190,A00,887012,Staff,8,0,23,15
1746572418211,CSE 8A,A50,887015,Cao; Yingjun,57,0,85,28
1746572419236,CSE 11,A01,887017,Cao; Yingjun,12,0,70,58
1746572420262,CSE 20,A01,887019,Staff,30,0,50,20
1746572421288,CSE 21,A01,887021,Staff,78,0,100,22
1746572421288,CSE 21,B01,892583,Braun; Oliver,45,0,50,5
1746572422314,CSE 30,A01,887025,Eldon; John,143,0,200,57
1746572423342,CSE 100,A01,887027,Staff,26,0,50,24
1746572423342,CSE 100,A02,887028,Staff,42,0,50,8
1746572424368,CSE 101,A01,887030,Braun; Oliver,74,0,100,26
1746572424368,CSE 101,B01,887032,Jones; Miles E,0,3,50,50
1746572424368,CSE 101,B02,887033,Jones; Miles E,0,2,50,50
1746572425400,CSE 105,A01,908084,Jones; Miles E,32,0,50,18
1746572425400,CSE 105,A02,908087,Jones; Miles E,31,0,50,19
1746572426425,CSE 135,A01,887035,Powell; Thomas Allan,0,5,50,50
1746572427451,CSE 142,A01,887037,Staff,8,0,60,52
1746572428475,CSE 142L,A01,887039,Staff,34,0,60,26
1746572429502,CSE 151A,A01,887041,Solares; Edwin A,47,0,100,53
1746572430737,CSE 175,A01,887043,Kumar; Rakesh,30,0,30,0
1746572431772,CSS 1,A01,886389,Staff,1,1,40,39
1746572432802,DSC 30,A01,908097,Liao; Soohyun Nam,47,0,75,28
1746572433828,DSC 40A,A01,908099,Shannon; Kyle Michael,30,0,50,20
1746572434854,DSC 40B,A01,908112,Staff,15,0,50,35
1746572435883,DSC 80,A01,908116,Staff,19,0,60,41
1746572436910,DSC 197,001,956863,Eldridge; Justin Matthew,9999,0,9999,0
1746572437937,ECE 5,A01,886400,Morris; Karcher William,1,0,6,5
1746572437937,ECE 5,A02,886401,Morris; Karcher William,3,0,6,3
1746572438966,ECE 148,A01,886403,Silberman; Jack,0,14,14,14
1746572439994,ECON 1,A01,887265,Crane; Meredith Helen,12,0,70,58
1746572439994,ECON 1,B01,887268,Staff,42,0,50,8
1746572441022,ECON 2,A01,887273,Crane; Meredith Helen,55,0,70,15
1746572442046,ECON 3,A01,887279,Rondina; Giacomo,32,0,70,38
1746572443074,ECON 4,A01,887282,Anderson; John Charles,0,2,10,10
1746572444103,ECON 5,A01,887285,Staff,34,0,45,11
1746572444103,ECON 5,B01,887292,Staff,41,0,45,4
1746572445129,ECON 100A,A01,887337,Newhouse; Herbert S,54,0,70,16
1746572445129,ECON 100A,B01,887349,Staff,45,0,50,5
1746572446155,ECON 100B,A01,887361,Du; Songzi,29,0,70,41
1746572447181,ECON 100C,A01,887445,Newhouse; Herbert S,59,0,70,11
1746572448208,ECON 105,A00,887488,Vespa; Emanuel Ignacio,23,0,35,12
1746572449233,ECON 109,A01,887506,Shishkin; Denis,28,0,35,7
1746572450259,ECON 110A,A01,887568,Alon; Titan Michael,0,3,35,35
1746572450259,ECON 110A,B01,907601,Alon; Titan Michael,20,0,35,15
1746572451287,ECON 110B,A01,887598,Levkoff; Steven B.,0,24,70,70
1746572452310,ECON 112,A00,887599,Rondina; Giacomo,19,0,35,16
1746572453335,ECON 120A,A01,887603,Dai; Yinlin,35,0,70,35
1746572454366,ECON 120C,A01,887608,Sun; Yixiao,0,1,35,35
1746572454366,ECON 120C,B01,887614,Sun; Yixiao,0,0,35,35
1746572455390,ECON 138,A00,887621,Bharadwaj; Prashant,0,21,20,20
1746572456421,ECON 144,A00,958007,Squires; Dale E,12,0,35,23
1746572457449,ECON 171,A01,907666,Staff,18,0,35,17
1746572458479,ECON 175,A00,887626,Wu; Pak Yeung,22,0,35,13
1746572459504,ECON 190,A00,887640,Vespa; Emanuel Ignacio,22,0,35,13
1746572460531,EDS 25,A01,888197,Staff,0,0,0,0
1746572460531,EDS 25,A02,888209,Staff,0,0,0,0
1746572460531,EDS 25,A03,888210,Staff,0,0,0,0
1746572460531,EDS 25,A04,888212,Staff,0,0,0,0
1746572460531,EDS 25,A05,888213,Staff,0,0,0,0
1746572460531,EDS 25,A06,888214,Staff,0,0,0,0
1746572460531,EDS 25,A07,888235,Staff,0,2,0,0
1746572460531,EDS 25,A08,888236,Staff,0,0,0,0
1746572460531,EDS 25,A09,888240,Staff,0,0,0,0
1746572460531,EDS 25,A10,888244,Staff,0,0,0,0
1746572460531,EDS 25,B01,888273,Staff,0,0,0,0
1746572460531,EDS 25,B02,888285,Staff,0,0,0,0
1746572460531,EDS 25,B03,888423,Staff,0,0,0,1
1746572460531,EDS 25,B04,888432,Staff,0,0,0,0
1746572460531,EDS 25,B05,888433,Staff,0,0,0,0
1746572460531,EDS 25,B06,888467,Staff,0,0,0,0
1746572460531,EDS 25,B07,888468,Staff,0,0,0,0
1746572460531,EDS 25,B08,888479,Staff,0,0,0,0
1746572460531,EDS 25,B09,888484,Staff,0,0,0,0
1746572460531,EDS 25,B10,888487,Staff,0,0,0,0
1746572461558,EDS 38,A01,907700,Choi; Bailey Miyeon,30,0,30,0
1746572462589,EDS 112,A01,888601,Chapman; Thandeka K,12,0,40,28
1746572463617,EDS 115,A00,888697,Mendez; Kathrina Mendoza,10,0,30,20
1746572464643,EDS 116,A01,888893,Staff,34,0,40,6
1746572466703,EDS 124AR,A00,889133,Staff,29,0,50,21
1746572466703,EDS 124AR,B00,907471,Simon; Elizabeth A,37,0,50,13
1746572467731,EDS 124BR,A00,889134,Simon; Elizabeth A,44,0,100,56
1746572468756,EDS 125,A00,889135,Staff,25,0,30,5
1746572469785,EDS 126,A01,889138,Staff,35,0,40,5
1746572470815,EDS 164R,A01,889142,Wishard Guerra; Alison G.,33,0,50,17
1746572471841,ENG 30,A01,886396,Staff,0,0,0,0
1746572471841,ENG 30,B01,886398,Staff,0,0,0,0
1746572472870,ENVR 102,A00,906150,Montejo; Carolina,23,0,25,2
1746572473914,ETHN 103A,A00,887236,Man; Simeon S,0,3,0,0
1746572474941,ETHN 113,A00,887239,Staff,16,0,30,14
1746572475965,ETHN 116,A00,887240,Staff,16,0,25,9
1746572476992,ETHN 117,A00,887241,Choi; Esther Min,28,0,30,2
1746572478019,ETHN 118,A00,887243,Staff,24,0,30,6
1746572479046,ETHN 127,A00,887248,Cuong; Marisol,11,0,15,4
1746572480071,ETHN 139,A00,887250,Staff,7,0,10,3
1746572481099,ETHN 142,A00,887252,Staff,10,0,30,20
1746572482125,ETHN 161,A00,887253,Browne; Errol Tsekani,24,0,30,6
1746572483150,ETHN 163FR,A00,887255,Burelle; Julie Sara Veronique,0,0,5,5
1746572484176,GLBH 20,A00,889149,Elwardani; Nile Regina,8,0,42,34
1746572486231,GLBH 111,A01,889152,Burgos; Jose L.,17,0,17,0
1746572487258,GLBH 150,A00,889181,Sloane; Julia Kathryn,0,5,15,15
1746572489311,HDS 60,A01,886406,Warstadt; Melissa Fawn,73,0,80,7
1746572490336,HIAF 111,A00,889324,Gyamfi; Bright,25,0,32,7
1746572491361,HIEA 131,A00,889328,Staff,15,0,32,17
1746572492396,HIEA 144,A00,889333,Henry; Todd A.,26,0,32,6
1746572493423,HIEA 154,A00,889336,Henry; Todd A.,24,0,32,8
1746572494448,HIEU 106,A00,889339,Staff,22,0,32,10
1746572496499,HIEU 114,A00,889340,Staff,4,0,32,28
1746572497523,HIEU 135GS,A00,889342,Patterson; Patrick H.,0,0,1,24
1746572498548,HIEU 137,A00,889343,Edington; Claire Ellen,10,0,25,15
1746572499571,HIEU 148,A00,889345,Staff,14,0,32,18
1746572500597,HIEU 154,A00,889346,Biess; Frank Peter,21,0,32,11
1746572501624,HILA 102,A00,889351,Staff,12,0,32,20
1746572502647,HILD 2A,A01,889221,Lewandoski; Julia Mavis,1,10,32,31
1746572503672,HILD 7B,A01,889225,Man; Simeon S,0,12,32,32
1746572504697,HILD 7C,A01,889288,Alvarez; Luis A,0,14,32,32
1746572505726,HILD 30,A01,889323,Staff,0,5,32,32
1746572507781,HISC 119,A00,889383,Golan; Tal,19,0,32,13
1746572508805,HIUS 103,A00,889384,Man; Simeon S,0,0,32,32
1746572509830,HIUS 117,A00,919797,Kwak; Nancy,19,0,32,13
1746572510855,HIUS 142A,A00,919788,Staff,22,0,32,10
1746572512906,HIUS 149,A00,889386,Gyamfi; Bright,26,0,32,6
1746572513930,HIUS 155,A00,889387,Alvarez; Luis A,15,0,32,17
1746572514957,HUM 3,A01,886499,Caldwell; Michael Alan,19,0,50,31
1746572515981,HUM 3GS,A00,886500,Rodriguez; Bretton Sigfred,0,0,0,28
1746572517005,HUM 3R,A01,886502,Markman; Kristina,0,36,50,50
1746572518032,HUM 4,A01,886504,Crum; Matthew Stephen,24,0,50,26
1746572518032,HUM 4,B01,886506,West; Geoffrey Scott,17,0,50,33
1746572519057,HUM 4GS,A00,886507,Staff,0,0,0,19
1746572520087,HUM 5,A01,886509,Staff,32,0,50,18
1746572521116,HUM 5R,A01,886511,Zavodny; Tatiana Sophia,0,39,50,50
1746572522145,JAPN 180,A00,886407,Staff,16,0,40,24
1746572523179,LATI 50,A01,886409,Martin-Cabrera; Luis,4,0,22,18
1746572523179,LATI 50,A02,886410,Martin-Cabrera; Luis,19,0,22,3
1746572523179,LATI 50,A03,886411,Martin-Cabrera; Luis,21,0,22,1
1746572523179,LATI 50,A04,886412,Martin-Cabrera; Luis,9,0,22,13
1746572524203,LAWS 101,A00,907664,Staff,28,0,60,32
1746572525234,LIAB 1A,A00,889388,Saab; Dima,17,0,20,3
1746572526260,LIAB 1AX,A00,889389,El Cheddadi; Youniss,18,0,20,2
1746572527286,LIFR 1C,A00,889391,Van Moer; Vinciane G,8,0,20,12
1746572528315,LIFR 1CX,A00,889392,Van Moer; Vinciane G,7,0,20,13
1746572529341,LIFR 1D,A00,889393,Van Moer; Vinciane G,7,0,20,13
1746572530369,LIFR 1DX,A00,889394,Van Moer; Vinciane G,8,0,20,12
1746572531395,LIGN 7,A00,886923,Staff,24,0,50,26
1746572532426,LIGN 17,A00,886924,Kehler; Andrew Scott,125,0,150,25
1746572533451,LTAM 110,A00,889395,Staff,15,0,30,15
1746572534478,LTAM 110GS,A00,958010,Rodriguez; Bretton Sigfred,0,0,0,28
1746572535505,LTCH 101,A00,889397,Staff,23,0,25,2
1746572536531,LTCS 130,A00,889398,Staff,23,0,25,2
1746572537559,LTEA 138,A00,889399,Staff,24,0,40,16
1746572538587,LTEN 149,A00,889400,Wesling; Megan E.,0,3,25,25
1746572539615,LTEN 169,A00,889401,Staff,20,0,25,5
1746572540640,LTEN 180,A00,889402,Staff,10,0,15,5
1746572541665,LTEN 181,A00,889403,Staff,21,0,25,4
1746572542694,LTWL 100,A00,889404,Myerston Santana; Jacobo,2,0,25,23
1746572543720,LTWL 180GS,A00,889405,Staff,0,0,20,20
1746572544748,LTWL 181,A00,889406,Staff,16,0,25,9
1746572545773,LTWL 184,A00,889475,Mukherjee; Silpa,22,0,25,3
1746572546802,LTWR 102C,A00,889486,Staff,29,0,30,1
1746572547827,LTWR 115W,A00,889491,Staff,0,2,15,15
1746572548852,MAE 8,A01,886905,Staff,0,2,0,0
1746572549878,MAE 11,A00,886906,Bandaru; Prabhakar,0,7,50,50
1746572550904,MAE 20,A00,886907,Evdokimenko; Ekaterina,43,0,70,27
1746572551932,MAE 30B,A00,886909,Ghazinejad; Maziar,26,0,45,19
1746572552961,MAE 101B,A00,886910,Saintillan; David,29,0,45,16
1746572553989,MAE 105,A00,886911,Bandaru; Prabhakar,18,0,50,32
1746572555016,MAE 107,B00,958024,Staff,8,0,50,42
1746572556041,MAE 143B,A00,886913,Bewley; Thomas R,5,0,40,35
1746572557068,MAE 148,A01,886915,Silberman; Jack,0,3,14,14
1746572558096,MAE 160,A00,886916,Evdokimenko; Ekaterina,31,0,60,29
1746572559125,MATH 3C,A01,889681,Staff,0,2,30,30
1746572559125,MATH 3C,A02,960048,Staff,24,0,30,6
1746572560151,MATH 10A,A01,889760,Staff,26,0,30,4
1746572560151,MATH 10A,A02,889783,Staff,29,0,30,1
1746572561184,MATH 10B,A01,889785,Verstraete; Jacques Allan,2,0,35,33
1746572561184,MATH 10B,A02,889795,Verstraete; Jacques Allan,4,0,35,31
1746572561184,MATH 10B,B01,889797,Verstraete; Jacques Allan,3,0,35,32
1746572561184,MATH 10B,B02,889828,Verstraete; Jacques Allan,3,0,35,32
1746572562211,MATH 10C,A01,889849,Habib; Yousaf,7,0,30,23
1746572562211,MATH 10C,A02,889852,Habib; Yousaf,14,0,30,16
1746572562211,MATH 10C,A03,889853,Habib; Yousaf,22,0,30,8
1746572562211,MATH 10C,A04,889858,Habib; Yousaf,20,0,30,10
1746572562211,MATH 10C,B01,889861,Staff,1,0,30,29
1746572562211,MATH 10C,B02,889862,Staff,24,0,30,6
1746572562211,MATH 10C,B03,889863,Staff,27,0,30,3
1746572562211,MATH 10C,B04,889967,Staff,23,0,30,7
1746572563243,MATH 18,A01,889974,Staff,7,0,30,23
1746572563243,MATH 18,A02,889977,Staff,20,0,30,10
1746572563243,MATH 18,B01,889984,Hardiman; Liam,21,0,30,9
1746572563243,MATH 18,B02,889985,Hardiman; Liam,25,0,30,5
1746572564267,MATH 20A,A01,889990,Suk; Andrew Hoon,30,0,35,5
1746572565292,MATH 20B,A01,889993,Ohm; Ko Woon,22,0,30,8
1746572565292,MATH 20B,A02,889994,Ohm; Ko Woon,30,0,30,0
1746572565292,MATH 20B,B01,889996,Ohm; Ko Woon,22,0,30,8
1746572565292,MATH 20B,B02,889997,Ohm; Ko Woon,23,0,30,7
1746572566320,MATH 20C,A01,889999,Hammock; Frances H,17,0,30,13
1746572566320,MATH 20C,A02,890003,Hammock; Frances H,23,0,30,7
1746572566320,MATH 20C,B01,890006,Hammock; Frances H,3,0,30,27
1746572566320,MATH 20C,B02,890007,Hammock; Frances H,12,0,30,18
1746572567350,MATH 20D,A01,890011,Cheng; Hsiao-Bing,1,1,30,29
1746572567350,MATH 20D,A02,890012,Cheng; Hsiao-Bing,14,0,30,16
1746572567350,MATH 20D,B01,890016,Cheng; Hsiao-Bing,13,0,30,17
1746572567350,MATH 20D,B02,890017,Cheng; Hsiao-Bing,13,0,30,17
1746572568380,MATH 20E,A01,890026,Harel; Guershon,1,0,30,29
1746572568380,MATH 20E,A02,890029,Harel; Guershon,23,0,30,7
1746572568380,MATH 20E,B01,890033,Harel; Guershon,7,0,30,23
1746572568380,MATH 20E,B02,890101,Harel; Guershon,21,0,30,9
1746572569403,MATH 102,A01,890104,Staff,17,0,30,13
1746572569403,MATH 102,A02,890105,Staff,27,0,30,3
1746572570433,MATH 103B,A01,890116,Salehi Golsefidy; Alireza,3,0,30,27
1746572570433,MATH 103B,B01,890118,Staff,0,3,34,34
1746572571458,MATH 109,A01,890121,Aliabadi Sr.; Mohsen,1,0,30,29
1746572571458,MATH 109,B01,890124,Upadrashta; Pranav Kumar,18,0,30,12
1746572572481,MATH 120A,A01,890126,Eggers; John Dietrich,13,0,30,17
1746572573506,MATH 142B,A01,890128,Ioana; Adrian,19,0,30,11
1746572573506,MATH 142B,A02,890129,Ioana; Adrian,13,0,30,17
1746572574534,MATH 154,A01,890174,Staff,0,0,30,30
1746572574534,MATH 154,A02,890182,Staff,0,0,30,30
1746572575560,MATH 168A,A01,890197,Dumitriu; Ioana,21,0,35,14
1746572576585,MATH 170A,A01,890240,Nie; Jiawang,1,0,30,29
1746572576585,MATH 170A,A02,890241,Nie; Jiawang,11,0,30,19
1746572576585,MATH 170A,A03,890249,Nie; Jiawang,23,0,30,7
1746572577613,MATH 170B,A01,957891,Nag; Panchali,13,0,35,22
1746572579664,MATH 181A,A01,908025,Staff,0,4,35,35
1746572579664,MATH 181A,A02,960115,Staff,27,0,35,8
1746572580693,MATH 181B,A01,959874,Staff,25,0,30,5
1746572581721,MATH 193B,A01,890265,Staff,0,4,35,35
1746572582750,MGT 4,A01,890311,Anderson; John Charles,42,0,88,46
1746572583776,MGT 5,A00,907740,Staff,13,0,98,85
1746572584801,MGT 12,A00,890312,Lindenberger; Wade Douglas,67,0,98,31
1746572585826,MGT 16,A00,957883,Staff,78,0,98,20
1746572587880,MGT 45,A00,890314,Pecore; Joseph P.,46,0,98,52
1746572588908,MGT 71,A00,890315,Staff,0,11,98,98
1746572589935,MGT 100,A00,890316,Yavorsky; Daniel Ryan,44,0,98,54
1746572590959,MGT 103,A00,890317,Ehrich; Kristine R,73,0,98,25
1746572591988,MGT 105,A00,890356,Bates; Kenneth Walter,0,8,98,98
1746572593011,MGT 112,A00,890360,Ehrich; Kristine R,55,0,98,43
1746572594036,MGT 127R,A00,907732,Zhu; Kevin Xiaoguo,23,0,98,75
1746572595060,MGT 131B,A00,890361,Anderson; John Charles,60,0,98,38
1746572596085,MGT 137,A00,890362,Lindenberger; Wade Douglas,65,0,98,33
1746572597113,MGT 160,A00,890369,Johnson; Erik Barry,9,0,98,89
1746572599165,MGT 164,A00,890372,Zimmermann; Carsten,0,40,98,98
1746572600191,MGT 180,A00,890374,Bliss; Barbara Ann,12,0,98,86
1746572601222,MMW 15,A01,886414,Chang; Edmond Yi-Teh,0,12,28,28
1746572601222,MMW 15,A02,886415,Chang; Edmond Yi-Teh,0,8,28,28
1746572601222,MMW 15,A03,886416,Chang; Edmond Yi-Teh,0,8,28,28
1746572601222,MMW 15,A04,886417,Chang; Edmond Yi-Teh,0,8,28,28
1746572601222,MMW 15,B01,886419,Chang; Edmond Yi-Teh,0,7,28,28
1746572601222,MMW 15,B02,886420,Chang; Edmond Yi-Teh,0,8,28,28
1746572601222,MMW 15,B03,886421,Chang; Edmond Yi-Teh,0,7,28,28
1746572601222,MMW 15,B04,886422,Chang; Edmond Yi-Teh,0,8,28,28
1746572601222,MMW 15,C01,886424,Staff,0,9,28,28
1746572601222,MMW 15,C02,886425,Staff,0,8,28,28
1746572601222,MMW 15,C03,886426,Staff,0,8,28,28
1746572601222,MMW 15,C04,886427,Staff,0,8,28,28
1746572601222,MMW 15,C05,958038,Staff,0,8,28,28
1746572601222,MMW 15,C06,958039,Staff,1,8,28,27
1746572602250,MMW 15GS,A00,906910,Patterson; Patrick H.,4,0,28,24
1746572603278,MMW 122R,A01,886429,Rahimi; Babak,0,13,28,28
1746572603278,MMW 122R,A02,886430,Rahimi; Babak,0,12,28,28
1746572603278,MMW 122R,A03,958040,Rahimi; Babak,0,11,28,28
1746572604301,MUS 1A,A01,890937,Staff,2,0,25,23
1746572604301,MUS 1A,A02,891035,Staff,6,0,25,19
1746572604301,MUS 1A,C01,958912,Staff,24,0,25,1
1746572604301,MUS 1A,C02,958913,Staff,25,0,25,0
1746572606354,MUS 2AK,A00,957092,Ohnishi; Takae,15,0,15,0
1746572607382,MUS 4,A01,891044,Staff,1,0,25,24
1746572607382,MUS 4,A02,891045,Staff,23,0,25,2
1746572607382,MUS 4,B01,891048,Staff,17,0,25,8
1746572607382,MUS 4,B02,891050,Staff,25,0,25,0
1746572608405,MUS 5,A01,957506,Dubnov; Shlomo,0,0,25,25
1746572608405,MUS 5,A02,957622,Dubnov; Shlomo,13,0,25,12
1746572608405,MUS 5,A03,957623,Dubnov; Shlomo,20,0,25,5
1746572609433,MUS 6,A01,891053,Freitas Caetano; Marcelo,24,0,25,1
1746572609433,MUS 6,A02,891054,Freitas Caetano; Marcelo,23,0,25,2
1746572610457,MUS 7,A01,891081,Staff,1,0,25,24
1746572610457,MUS 7,A02,891082,Staff,3,0,25,22
1746572611482,MUS 8GS,A00,891118,Borgo; David Garcia,1,0,25,24
1746572612510,MUS 11,A01,891140,Staff,9,0,25,16
1746572612510,MUS 11,A02,891141,Staff,22,0,25,3
1746572613550,MUS 13,A01,891143,Staff,8,0,25,17
1746572613550,MUS 13,A02,891144,Staff,24,0,25,1
1746572614578,MUS 15,A01,891146,Staff,9,0,25,16
1746572614578,MUS 15,A02,891148,Staff,21,0,25,4
1746572614578,MUS 15,B01,891150,Staff,18,0,25,7
1746572614578,MUS 15,B02,891151,Staff,25,0,25,0
1746572615604,MUS 20,A01,891153,Staff,5,0,20,15
1746572615604,MUS 20,A02,891155,Staff,14,0,20,6
1746572616629,MUS 80,A00,891156,Staff,19,0,25,6
1746572616629,MUS 80,B00,891157,Staff,23,0,25,2
1746572617654,MUS 130,A00,891158,Ohnishi; Takae,35,0,35,0
1746572618685,MUS 150GS,A01,891160,Borgo; David Garcia,1,0,25,24
1746572619715,MUS 170,A01,891162,Freitas Caetano; Marcelo,20,0,25,5
1746572619715,MUS 170,A02,891164,Freitas Caetano; Marcelo,21,0,25,4
1746572620739,NANO 11,A00,886220,Vazquez Mena; Oscar,13,0,15,2
1746572621771,NANO 15,A01,886222,Drews; Aaron,4,0,7,3
1746572622799,NANO 104,A00,886224,Sirbuly; Donald,17,0,25,8
1746572623824,PH 40,A00,886528,Staff,23,0,40,17
1746572624849,PH 45,A01,886799,Staff,35,0,40,5
1746572625888,PH 110,A00,886802,Staff,0,7,40,40
1746572626911,PH 172,A00,906716,Staff,19,0,35,16
1746572627940,PH 191,A00,886803,Staff,6,0,40,34
1746572628967,PHIL 1,A00,889500,Staff,20,0,30,10
1746572629991,PHIL 10,A01,889549,Grush; Rick Scott,16,0,22,6
1746572629991,PHIL 10,A02,889551,Grush; Rick Scott,22,0,22,0
1746572631017,PHIL 28,A01,889559,Lamey; Andy M.,0,2,31,31
1746572631017,PHIL 28,A02,889561,Lamey; Andy M.,0,1,30,30
1746572631017,PHIL 28,A03,889572,Lamey; Andy M.,0,1,30,30
1746572632041,PHIL 35,A00,907839,Staff,13,0,15,2
1746572633070,PHIL 60,A00,889574,Staff,73,0,90,17
1746572634093,PHIL 101,A00,958004,Staff,12,0,15,3
1746572636146,PHIL 136,A00,889582,Fulkerson; Matthew Todd,26,0,45,19
1746572637171,PHIL 163,A01,889601,Staff,21,0,30,9
1746572637171,PHIL 163,B01,889606,Brandt; Reuven A,0,3,0,0
1746572638198,PHIL 164,A00,889610,Staff,16,0,30,14
1746572639221,PHIL 165,A00,889613,Staff,22,0,30,8
1746572640247,PHYS 1A,A00,886431,Staff,26,0,70,44
1746572641271,PHYS 1AL,001,886432,Tsai; Philbert S,0,2,30,30
1746572641271,PHYS 1AL,002,886436,Tsai; Philbert S,11,0,30,19
1746572642298,PHYS 1B,A00,886439,Staff,185,0,240,55
1746572643322,PHYS 1BL,001,886441,Tsai; Philbert S,0,4,30,30
1746572643322,PHYS 1BL,002,886444,Tsai; Philbert S,2,0,30,28
1746572644349,PHYS 1C,A00,896092,Arnold; Kam S,78,0,146,68
1746572645376,PHYS 1CL,001,886448,Tsai; Philbert S,0,0,30,30
1746572645376,PHYS 1CL,002,886449,Tsai; Philbert S,1,0,30,29
1746572645376,PHYS 1CL,003,886450,Tsai; Philbert S,16,0,30,14
1746572645376,PHYS 1CL,004,886451,Tsai; Philbert S,15,0,30,15
1746572646402,PHYS 2B,A01,886457,Staff,68,0,115,47
1746572647427,PHYS 2C,A01,886460,Shotwell; Brian,0,9,65,65
1746572648450,PHYS 2CL,A01,886467,Staff,0,4,28,28
1746572648450,PHYS 2CL,A02,886468,Staff,0,3,28,28
1746572649479,PHYS 2D,A01,886470,Staff,10,0,50,40
1746572650508,PHYS 4B,A01,886475,Grinstein; Benjamin,22,0,40,18
1746572651533,POLI 5,A00,891173,Desposato; Scott,7,0,25,18
1746572652559,POLI 5D,A01,891175,Staff,5,0,5,0
1746572652559,POLI 5D,B01,891178,Staff,5,0,5,0
1746572653586,POLI 11,A00,891179,Ferree; Karen E,2,0,35,33
1746572654614,POLI 12,A00,891180,Staff,16,0,30,14
1746572655644,POLI 27,A01,891182,Staff,12,0,75,63
1746572656673,POLI 30,A00,891183,Staff,8,0,50,42
1746572657704,POLI 100B,A00,891244,Staff,5,1,35,30
1746572658735,POLI 100I,A00,891247,Staff,7,0,30,23
1746572659759,POLI 104J,A00,891248,Nichter; Maysa,14,0,30,16
1746572660784,POLI 104U,A00,891250,Nichter; Maysa,2,0,30,28
1746572662844,POLI 110B,A00,891255,Wiens; David,19,0,25,6
1746572663872,POLI 112A,A00,891256,Wiens; David,6,0,25,19
1746572664897,POLI 114BR,A00,891261,Staff,19,0,30,11
1746572665922,POLI 117R,A00,891262,Forman; Fonna,0,6,50,50
1746572666948,POLI 118,A00,891264,Ingham; Sean,17,0,25,8
1746572667974,POLI 124A,A00,891265,Staff,18,0,20,2
1746572668999,POLI 125D,A00,891266,Nichter; Simeon C,2,0,25,23
1746572670023,POLI 126,A00,891268,Nichter; Simeon C,7,0,25,18
1746572671048,POLI 126AA,A00,891272,Staff,16,0,25,9
1746572672072,POLI 130AA,A00,891273,Staff,15,0,20,5
1746572673095,POLI 134AA,A00,891274,Staff,4,0,20,16
1746572675146,POLI 138,A00,891278,Staff,21,0,25,4
1746572676173,POLI 142K,A00,891280,Staff,10,0,25,15
1746572677201,POLI 142M,A00,891281,Gartzke; Erik,16,0,30,14
1746572678227,POLI 142P,A00,891284,Staff,20,0,30,10
1746572679255,POLI 143,A00,891285,Gartzke; Erik,12,0,30,18
1746572680284,POLI 153,A00,891286,Staff,19,0,20,1
1746572682332,POLI 175,A00,891290,Staff,15,0,20,5
1746572683357,PSYC 1,A00,890674,Steiner; Eric Tomas,0,11,45,45
1746572684383,PSYC 2,A00,890676,Albright; Thomas D,21,0,35,14
1746572685409,PSYC 3,A00,890679,Staff,17,0,20,3
1746572686437,PSYC 6,A00,959858,Staff,20,0,20,0
1746572687463,PSYC 60,A01,890684,Rickard; Timothy C.,0,5,45,45
1746572688490,PSYC 70,A01,890689,Geller; Emma Harlan,7,0,30,23
1746572689515,PSYC 71,A01,959860,Staff,21,0,25,4
1746572690543,PSYC 100,A00,890690,Lacefield; Katharine I,0,50,180,180
1746572691569,PSYC 102,A00,890695,Staff,18,0,40,22
1746572692598,PSYC 105,A00,890699,Geller; Emma Harlan,70,0,100,30
1746572693625,PSYC 106,A00,890701,Gorman; Michael R.,6,0,30,24
1746572694652,PSYC 108,A00,890704,Adrian; Julia Anna,0,28,50,50
1746572695682,PSYC 118,A01,890712,Staff,11,0,30,19
1746572696712,PSYC 124,A00,890716,Chapman; Eddie Nathaniel,25,0,60,35
1746572697741,PSYC 131,A00,890717,Anagnostaras; Stephan,0,8,80,80
1746572698765,PSYC 137,A00,890719,Winkielman; Piotr,0,11,30,30
1746572699794,PSYC 144,A00,890721,Adrian; Julia Anna,0,9,45,45
1746572700825,PSYC 162,A00,890805,Staff,0,0,75,75
1746572701857,PSYC 169,A00,890810,Staff,0,14,30,30
1746572702910,PSYC 172,A00,890814,Gorman; Michael R.,9,0,30,21
1746572703934,PSYC 181,A00,890818,Anagnostaras; Stephan,9,0,200,191
1746572704962,PSYC 184,A00,959861,Staff,168,0,175,7
1746572705988,PSYC 189,A00,890823,Staff,0,2,30,30
1746572707016,PSYC 191,A00,890884,Rickard; Timothy C.,0,12,35,35
1746572708044,PSYC 193,A00,890913,Staff,19,0,30,11
1746572708044,PSYC 193,B00,890914,Chapman; Eddie Nathaniel,24,0,30,6
1746572709070,PSYC 193L,A01,890918,Lowe; Angela Beth,20,0,30,10
1746572709070,PSYC 193L,B01,890921,Hurwitz; Ethan Scott,20,0,30,10
1746572709070,PSYC 193L,C01,890928,Staff,30,0,30,0
1746572710099,RELI 149,A00,886806,Rahimi; Babak,23,0,40,17
1746572711125,SE 9,A01,886814,Staff,7,0,20,13
1746572712153,SE 101B,A01,886816,Chadha; Mayank,4,0,35,31
1746572713178,SE 110B,A00,886818,Zhu; Qiang,4,0,75,71
1746572714204,SE 125,A01,886830,Staff,10,0,30,20
1746572715229,SE 130B,A01,886835,Staff,14,0,40,26
1746572716258,SE 131A,A01,886838,Krysl; Petr,34,0,55,21
1746572717283,SE 154,A00,886840,Staff,29,0,50,21
1746572718310,SE 164GS,A01,886849,Staff,6,0,20,14
1746572719334,SE 167GS,A01,886853,Staff,6,0,20,14
1746572720360,SIO 25,A01,890107,Staff,19,0,30,11
1746572721591,SIO 45,A00,890109,Cook; Geoffrey W,117,0,200,83
1746572722617,SIO 109R,A00,890110,Forman; Fonna,0,16,20,20
1746572723645,SIO 187,A01,890114,Kacev; David,15,0,40,25
1746572724673,SOCI 1,A01,890431,Thorpe; Charles Robert,14,0,30,16
1746572724673,SOCI 1,A02,890518,Thorpe; Charles Robert,30,0,30,0
1746572725698,SOCI 2,A01,957978,Staff,25,0,25,0
1746572725698,SOCI 2,A02,957979,Staff,23,0,25,2
1746572726727,SOCI 20,A01,890523,Calderon-Zaks; Michael Aar,21,0,30,9
1746572726727,SOCI 20,A02,890526,Calderon-Zaks; Michael Aar,29,0,30,1
1746572727759,SOCI 30,A01,890533,Pardo Guerra; Juan Pablo,37,0,40,3
1746572728787,SOCI 40,A01,890535,Staff,27,0,45,18
1746572729818,SOCI 104Q,A00,890559,Staff,18,0,30,12
1746572730842,SOCI 106,A00,890560,Arnal; Maud Marie Leonie,20,0,30,10
1746572731868,SOCI 110,A00,890567,Holkenbrink-Monk; Charlene,19,0,30,11
1746572732893,SOCI 112,A00,890568,Victoria Torres; Pablo,2,0,55,53
1746572733918,SOCI 115,A00,890597,Arnal; Maud Marie Leonie,28,0,45,17
1746572735971,SOCI 121,A00,890604,Pardo Guerra; Juan Pablo,38,0,45,7
1746572736996,SOCI 126,A01,890608,Staff,8,0,10,2
1746572738024,SOCI 127,A00,890609,Staff,18,0,30,12
1746572739048,SOCI 131,A00,890610,Thorpe; Charles Robert,37,0,45,8
1746572740075,SOCI 135,A00,890615,Payne; Christine Anna,13,0,45,32
1746572741102,SOCI 139,A00,890620,Staff,38,0,45,7
1746572742128,SOCI 148E,A00,890622,Calderon-Zaks; Michael Aar,36,0,45,9
1746572743153,SOCI 150,A00,890623,Kohler; Kristopher M.,31,0,45,14
1746572744177,SOCI 157,A00,890625,Jules-Rosette; Bennetta W.,18,0,20,2
1746572745203,SOCI 160,A00,890627,Payne; Christine Anna,21,0,45,24
1746572746231,SYN 1,A00,886855,Fish; Gwendolyn Anne,0,1,0,0
1746572746231,SYN 1,B00,906086,Fish; Gwendolyn Anne,0,2,0,2
1746572747257,SYN 2R,A00,886860,Staff,0,17,15,15
1746572747257,SYN 2R,B00,906106,Atkinson; Arthur Laird,0,16,15,15
1746572748289,SYN 100,A01,886866,Browne; Emily,0,28,20,20
1746572748289,SYN 100,B01,906128,Rock; Martin,0,5,20,20
1746572748289,SYN 100,C01,906140,Deavenport; James Cary,0,3,20,20
1746572748289,SYN 100,D01,907816,Deavenport; James Cary,0,5,20,20
1746572749315,TDAC 1,A00,890286,Walsh; Kim C.,8,0,20,12
1746572750341,TDAC 101,A00,890296,Basso; Beatrice,15,0,20,5
1746572751366,TDDE 131,A00,890297,Staff,47,0,50,3
1746572752392,TDDM 1,A00,890287,Weinberg; Sadie,25,0,30,5
1746572753419,TDGE 11,A00,890288,Fulton; Julia,137,0,200,63
1746572753419,TDGE 11,B00,890289,Castro; Robert Jess,184,0,200,16
1746572754443,TDGE 25,B00,957359,Walsh; Kim C.,5,0,20,15
1746572755471,TDGE 40,A01,890292,Power; Jade Yukana,27,0,30,3
1746572756497,TDGE 124,A00,890298,Havis; Allan,0,1,50,50
1746572757521,TDGE 131R,A00,890299,Burelle; Julie Sara Veronique,15,0,42,27
1746572758551,TDHT 101,A00,890300,Staff,10,0,20,10
1746572759576,TDHT 109,A01,890302,Anderson; Mysia Anyse,31,0,40,9
1746572760605,TDMV 1,A00,890293,Arcidiacono; Kristin,18,0,30,12
1746572761632,TDMV 2,A00,890294,Weinberg; Sadie,23,0,30,7
1746572762657,TDMV 3,A00,957878,Arcidiacono; Kristin,28,0,30,2
1746572764710,TDMV 138,A00,890304,Jun; Grace Shin Hae,25,0,40,15
1746572765738,TDMV 140,A00,890305,Corrales; Joseph Bernales,25,0,30,5
1746572766762,TDMV 142,A00,890307,Caligagan; Tony,32,0,40,8
1746572767793,TDMV 144,A00,890308,Camaya; Michelle Ann,25,0,30,5
1746572768819,TDPW 1,A00,890295,Stein; Deborah Isobel,2,0,20,18
1746572769846,USP 2,A01,890272,Lerner; Amy M,7,0,20,13
1746572770872,USP 3,A01,890274,Staff,12,0,30,18
1746572771902,USP 15,A01,890276,Sun; Feiyang,16,0,30,14
1746572772930,USP 25,A00,890277,Shenkman; Michael Thomas,19,0,25,6
1746572773955,USP 138,A00,890278,Staff,14,0,25,11
1746572774983,USP 143,A00,890279,Staff,22,0,70,48
1746572776009,USP 144,A00,890280,Chowdhury; Muhammed Zohir,16,0,30,14
1746572777034,USP 150,A00,890281,Boomhower; Matthew Charles,4,0,30,26
1746572778062,USP 151,A00,890282,Staff,16,0,20,4
1746572779087,USP 162,A00,890283,Andrews; Abigail Leslie,16,0,20,4
1746572780116,USP 168,A00,920477,Kwak; Nancy,0,0,5,5
1746572781140,USP 181,A00,890284,Staff,3,0,20,17
1746572782169,USP 191A,A00,890285,Staff,12,0,20,8
1746572783197,VIS 101,A00,886512,Staff,26,0,75,49
1746572784224,VIS 103,A00,886513,Cruz; Edwin Teddy,61,0,75,14
1746572785249,VIS 108,A00,886514,Staff,3,0,15,12
1746572786278,VIS 127P,A00,886515,Shen; Kuiyi,80,0,146,66
1746572787307,VIS 149,A00,886516,Yoldas; Pinar,0,0,15,15
1746572788332,VIS 164,A00,886526,Erdmann; Dean,19,0,22,3
1746572789360,VIS 194S,A00,886527,Staff,61,0,75,14
1746572790398,WCWP 10A,C00,886484,Martiniuk; Jill,12,0,15,3
1746572791426,WCWP 10B,A00,886490,Uriarte; Emma,0,0,15,15
1746572791426,WCWP 10B,B00,886491,Dhir; Simrita,9,0,15,6
1746572791426,WCWP 10B,C00,886492,Ornelas; Tricia,0,0,15,15
1746572792454,WCWP 100,A00,886494,Young; Mark T,0,6,15,15
1746572794559,AAS 10,A01,886199,Childs; Dennis R.,0,3,0,0
1746572795589,ANAR 104,A01,886940,Shtienberg; Gilad,27,0,30,3
1746572796615,ANAR 120,A00,886953,Staff,12,0,20,8
1746572797645,ANBI 148,A01,886955,Wilder; Linnea Lorene,30,0,40,10
1746572799697,ANSC 122,A00,886957,Staff,25,0,30,5
1746572800722,ANSC 150,A00,886958,Sloane; Julia Kathryn,2,0,15,13
1746572801752,ANSC 156,A00,886959,Jenkins; Janis A.,0,1,15,15
1746572802777,ANSC 180,A00,886960,Staff,11,0,17,6
1746572803803,ANSC 188,A00,886961,Jassal; Aftab,9,0,25,16
1746572804832,ANSC 190,A00,886962,Jassal; Aftab,14,0,25,11
1746572805857,ANSC 191,A00,886963,Staff,18,0,20,2
1746572806882,ANTH 3,A01,891689,Staff,17,0,20,3
1746572807907,ANTH 5,A00,886933,Semendeferi; Ekaterini,16,0,20,4
1746572808935,ANTH 10,A00,886934,Staff,0,12,30,30
1746572809963,ANTH 21,A01,886936,Staff,41,0,60,19
1746572810987,ANTH 23,A01,886938,Staff,92,0,100,8
1746572812013,ANTH 105,A00,886964,Stewart; Alexander B,84,0,100,16
1746572813041,ANTH 108,A00,886965,Pedersen; David,9,0,20,11
1746572814069,AWP 10,001,886147,Staff,0,0,0,0
1746572814069,AWP 10,002,886148,Staff,0,0,0,0
1746572814069,AWP 10,003,886149,Staff,0,0,0,0
1746572814069,AWP 10,004,886150,Staff,0,0,0,0
1746572814069,AWP 10,005,886151,Staff,0,0,0,0
1746572814069,AWP 10,006,886152,Staff,0,0,0,0
1746572814069,AWP 10,007,886153,Staff,0,0,0,0
1746572814069,AWP 10,008,886154,Staff,0,0,0,0
1746572814069,AWP 10,009,886155,Staff,0,0,0,0
1746572814069,AWP 10,010,886156,Staff,0,0,0,0
1746572814069,AWP 10,011,886158,Staff,0,0,0,0
1746572814069,AWP 10,012,886160,Staff,0,0,0,0
1746572814069,AWP 10,013,886161,Staff,0,0,0,0
1746572814069,AWP 10,014,886162,Staff,0,0,0,0
1746572814069,AWP 10,015,886163,Staff,0,0,0,0
1746572814069,AWP 10,016,886164,Staff,0,0,0,0
1746572814069,AWP 10,017,886165,Staff,0,0,0,0
1746572814069,AWP 10,018,886166,Staff,0,0,0,0
1746572814069,AWP 10,019,886168,Staff,0,0,0,0
1746572814069,AWP 10,020,886170,Staff,0,0,0,0
1746572814069,AWP 10,021,886172,Staff,0,0,0,0
1746572815097,AWP 10R,001,886173,Staff,0,1,0,0
1746572815097,AWP 10R,002,886174,Staff,0,1,0,0
1746572815097,AWP 10R,003,886175,Staff,0,0,0,0
1746572815097,AWP 10R,004,886176,Staff,0,0,0,0
1746572815097,AWP 10R,005,886177,Staff,0,0,0,0
1746572815097,AWP 10R,006,886178,Staff,0,0,0,0
1746572815097,AWP 10R,007,886179,Staff,0,0,0,0
1746572815097,AWP 10R,008,886181,Staff,0,0,0,0
1746572815097,AWP 10R,009,886182,Staff,0,0,0,0
1746572815097,AWP 10R,010,886183,Staff,0,0,0,0
1746572815097,AWP 10R,011,886184,Staff,0,0,0,0
1746572815097,AWP 10R,012,886185,Staff,0,0,0,0
1746572815097,AWP 10R,013,886186,Staff,0,0,0,0
1746572815097,AWP 10R,014,886187,Staff,0,0,0,0
1746572815097,AWP 10R,015,886188,Staff,0,0,0,0
1746572815097,AWP 10R,016,886189,Staff,0,0,0,0
1746572815097,AWP 10R,017,960532,Staff,0,0,0,0
1746572815097,AWP 10R,018,960533,Staff,0,0,0,0
1746572815097,AWP 10R,019,960534,Staff,0,0,0,0
1746572815097,AWP 10R,020,960538,Staff,0,0,0,0
1746572815097,AWP 10R,021,960540,Staff,0,0,0,0
1746572815097,AWP 10R,022,960541,Staff,0,0,0,0
1746572815097,AWP 10R,023,960542,Staff,0,0,0,0
1746572815097,AWP 10R,024,960544,Staff,0,0,0,0
1746572815097,AWP 10R,025,960545,Staff,0,0,0,0
1746572815097,AWP 10R,026,960548,Staff,0,0,0,0
1746572816125,AWP 102R,A00,886190,Staff,0,0,0,0
1746572816125,AWP 102R,B00,886191,Staff,0,0,0,0
1746572817155,BENG 100,A01,886193,Staff,17,0,30,13
1746572818186,BENG 122A,A01,886195,Hasty; Jeff M,13,0,30,17
1746572819210,BENG 166A,A00,886196,Sah; Robert Lie-Yuan,0,2,30,30
1746572820235,BENG 190,A00,958050,Khojah; Reem I,20,0,25,5
1746572821261,BIBC 102,A01,894320,Staff,0,0,46,46
1746572821261,BIBC 102,A02,894321,Staff,0,0,46,46
1746572821261,BIBC 102,A03,894344,Staff,7,0,46,39
1746572821261,BIBC 102,A04,894345,Staff,27,0,47,20
1746572822289,BICD 100R,A01,894365,Smith; Laurie,0,3,58,58
1746572822289,BICD 100R,A02,894366,Smith; Laurie,0,5,58,58
1746572822289,BICD 100R,A03,894367,Smith; Laurie,0,0,59,59
1746572822289,BICD 100R,A04,959869,Smith; Laurie,40,0,59,19
1746572823314,BICD 136,A01,894383,Gustafson-Brown; Cindy,14,0,50,36
1746572824339,BIEB 102,A01,894494,Butler; Shannon Rhey,51,0,130,79
1746572826399,BIEB 150,A01,894617,Wills; Christopher,3,0,20,17
1746572826399,BIEB 150,A02,894631,Wills; Christopher,3,0,20,17
1746572826399,BIEB 150,A03,894937,Wills; Christopher,3,0,20,17
1746572826399,BIEB 150,A04,894946,Wills; Christopher,5,0,20,15
1746572827424,BIEB 194,A00,906141,Kurle; Carolyn M.,6,0,20,14
1746572828454,BILD 1,A01,894154,Staff,3,0,19,16
1746572828454,BILD 1,A02,894155,Staff,14,0,19,5
1746572828454,BILD 1,A03,894160,Staff,13,0,19,6
1746572828454,BILD 1,A04,894161,Staff,15,0,18,3
1746572829480,BILD 2,A01,894168,Staff,0,0,50,50
1746572829480,BILD 2,A02,894169,Staff,0,0,50,50
1746572829480,BILD 2,A03,894179,Staff,0,0,50,50
1746572829480,BILD 2,A04,894203,Staff,24,0,50,26
1746572830509,BILD 3,A01,894213,Staff,23,0,31,8
1746572830509,BILD 3,A02,894214,Staff,26,0,31,5
1746572830509,BILD 3,A03,894235,Staff,28,0,31,3
1746572830509,BILD 3,A04,894236,Staff,28,0,32,4
1746572831535,BILD 4,A01,894253,Reuther; Keefe,5,0,24,19
1746572831535,BILD 4,A02,894258,Reuther; Keefe,16,0,24,8
1746572832565,BILD 5,A01,894276,Reuther; Keefe,35,0,50,15
1746572832565,BILD 5,A02,894277,Reuther; Keefe,45,0,50,5
1746572832565,BILD 5,A03,894290,Reuther; Keefe,44,0,50,6
1746572832565,BILD 5,A04,894291,Reuther; Keefe,48,0,50,2
1746572833591,BILD 24,A01,894297,Pirino; Giorgia,40,0,60,20
1746572834622,BIMM 100,B01,958915,Staff,71,0,100,29
1746572835648,BIMM 101,A01,895017,McDonnell; Lisa Marie,0,5,24,24
1746572835648,BIMM 101,A02,895018,McDonnell; Lisa Marie,0,5,24,24
1746572835648,BIMM 101,B01,895020,McDonnell; Lisa Marie,0,6,24,24
1746572835648,BIMM 101,B02,895021,McDonnell; Lisa Marie,0,4,24,24
1746572836677,BIMM 110,A01,895023,Staff,1,0,25,24
1746572836677,BIMM 110,A02,895024,Staff,9,0,25,16
1746572836677,BIMM 110,A03,895025,Staff,18,0,25,7
1746572836677,BIMM 110,A04,895031,Staff,20,0,25,5
1746572837701,BIMM 120,A01,895114,Gustafson-Brown; Cindy,14,0,28,14
1746572837701,BIMM 120,A02,895126,Gustafson-Brown; Cindy,21,0,27,6
1746572838728,BIPN 100,A01,895130,Yang; Mingyu,0,0,38,38
1746572838728,BIPN 100,A02,895131,Yang; Mingyu,32,0,38,6
1746572838728,BIPN 100,A03,895132,Yang; Mingyu,32,0,38,6
1746572838728,BIPN 100,A04,895133,Yang; Mingyu,27,0,36,9
1746572839756,BIPN 120,A01,895135,Cooke; James Edward,0,3,13,13
1746572839756,BIPN 120,A02,895136,Cooke; James Edward,0,1,13,13
1746572839756,BIPN 120,A03,895137,Cooke; James Edward,0,3,13,13
1746572839756,BIPN 120,A04,895156,Cooke; James Edward,0,2,11,11
1746572840781,BIPN 134,A01,895235,Cooke; James Edward,0,2,25,25
1746572840781,BIPN 134,A02,895237,Cooke; James Edward,0,0,25,25
1746572840781,BIPN 134,A03,895240,Cooke; James Edward,3,0,25,22
1746572840781,BIPN 134,A04,895270,Cooke; James Edward,20,0,25,5
1746572841807,BIPN 189,A00,892103,Staff,0,14,14,14
1746572843857,BISP 194,A00,958008,Staff,0,2,0,0
1746572844883,CAT 124,A01,922009,Staff,0,5,20,20
1746572845915,CAT 125R,A00,886390,Morales; Celeste Georgianna,0,2,20,20
1746572845915,CAT 125R,B00,886391,Irwin; Matthew Joseph,0,4,20,20
1746572845915,CAT 125R,C00,886392,Smith; Lauryn Alissa,0,2,20,20
1746572845915,CAT 125R,D00,886393,Vanderschuit; Maya Alysia,0,3,20,20
1746572845915,CAT 125R,E00,886394,Marchisotto; Jennifer Anne,0,3,20,20
1746572846941,CENG 15,A01,886218,Drews; Aaron,3,0,8,5
1746572847968,CENG 113,A00,886219,Opatkiewicz; Justin Paul,15,0,25,10
1746572848992,CGS 101,A00,887044,Staff,7,0,20,13
1746572850021,CGS 105,A01,887046,Staff,14,0,25,11
1746572851048,CGS 112,A00,887047,Cuong; Marisol,12,0,15,3
1746572852078,CGS 113,A00,887048,Staff,23,0,30,7
1746572853105,CGS 120,A00,887049,Staff,10,0,17,7
1746572854130,CHEM 6A,A01,886336,Lam; Tin Yiu,38,0,50,12
1746572854130,CHEM 6A,A02,886338,Lam; Tin Yiu,37,0,50,13
1746572855161,CHEM 6B,A01,886341,Hopkins; Patrycja Anna,16,0,50,34
1746572855161,CHEM 6B,A02,886343,Hopkins; Patrycja Anna,42,0,50,8
1746572856192,CHEM 6C,A01,886346,Albizati; Kim F.,0,2,50,50
1746572856192,CHEM 6C,A02,886348,Albizati; Kim F.,23,0,50,27
1746572857233,CHEM 40A,A01,886352,Klosterman; Jeremy K,65,0,100,35
1746572858259,CHEM 40B,A01,886356,Klosterman; Jeremy K,0,23,100,100
1746572859284,CHEM 41B,A01,886360,Theodorakis; Emmanuel,25,0,50,25
1746572859284,CHEM 41B,A02,886362,Theodorakis; Emmanuel,47,0,50,3
1746572860309,CHIN 165A,A00,886382,Xu; Li,18,0,20,2
1746572861334,CLAS 120,A00,886387,Myerston Santana; Jacobo,33,0,40,7
1746572862361,COGS 9,A01,886967,Shannon; Kyle Michael,42,0,60,18
1746572863385,COGS 11,A01,886969,Staff,10,0,30,20
1746572864417,COGS 14A,A01,886971,Staff,6,0,60,54
1746572865447,COGS 14B,A01,886973,Hoffman; Drew Ellen,4,0,60,56
1746572866472,COGS 18,A01,886975,Morgan; Eric,35,0,60,25
1746572867501,COGS 20,A01,886977,Staff,4,0,8,4
1746572867501,COGS 20,A02,886978,Staff,5,0,7,2
1746572868530,COGS 100,A01,907783,Staff,1,2,30,29
1746572869561,COGS 101B,A01,886980,Staff,0,3,48,48
1746572870589,COGS 101C,A01,886982,Delgado; Tania,0,5,44,44
1746572871618,COGS 102A,A01,886984,Johnson; Christine M.,4,0,30,26
1746572872643,COGS 118B,A01,886986,Staff,1,3,88,87
1746572873672,COGS 150,A01,886988,Bergen; Benjamin,22,0,50,28
1746572874696,COGS 153,A00,886989,Delgado; Tania,0,2,41,41
1746572875722,COGS 186,A01,886991,Staff,0,0,32,32
1746572876748,COGS 187A,A01,886993,Boyle; Mary E. T.,7,0,30,23
1746572877777,COGS 189,A00,886994,Staff,0,1,30,30
1746572878801,COMM 10,A01,886996,Staff,0,0,20,21
1746572878801,COMM 10,A02,886997,Staff,11,0,20,9
1746572878801,COMM 10,A03,959845,Staff,19,0,20,1
1746572879829,COMM 20,A01,886999,Leuning; Grant Maurstad,24,0,40,16
1746572881883,COMM 100A,A01,887002,Staff,0,0,20,25
1746572881883,COMM 100A,A02,887003,Staff,6,0,20,14
1746572882913,COMM 100B,A01,887005,Staff,0,8,20,24
1746572883938,COMM 106D,A00,887006,Staff,13,0,40,27
1746572884966,COMM 110G,A00,887007,Whitworth-Smith; Andrew C,12,0,40,28
1746572885996,COMM 111B,A00,887008,Staff,31,0,40,9
1746572887025,COMM 113T,A00,887009,Abuelhiga; Soraya Jill,28,0,40,12
1746572887025,COMM 113T,B00,906733,Staff,40,0,40,0
1746572888052,COMM 145,A00,887010,Staff,12,0,40,28
1746572889080,COMM 146,A00,887054,Staff,31,0,40,9
1746572890109,COMM 190,A00,887012,Staff,8,0,23,15
1746572891137,CSE 8A,A50,887015,Cao; Yingjun,57,0,85,28
1746572892164,CSE 11,A01,887017,Cao; Yingjun,12,0,70,58
1746572893189,CSE 20,A01,887019,Staff,30,0,50,20
1746572894218,CSE 21,A01,887021,Staff,78,0,100,22
1746572894218,CSE 21,B01,892583,Braun; Oliver,45,0,50,5
1746572895248,CSE 30,A01,887025,Eldon; John,143,0,200,57
1746572896277,CSE 100,A01,887027,Staff,26,0,50,24
1746572896277,CSE 100,A02,887028,Staff,42,0,50,8
1746572897303,CSE 101,A01,887030,Braun; Oliver,74,0,100,26
1746572897303,CSE 101,B01,887032,Jones; Miles E,0,3,50,50
1746572897303,CSE 101,B02,887033,Jones; Miles E,0,2,50,50
1746572898332,CSE 105,A01,908084,Jones; Miles E,32,0,50,18
1746572898332,CSE 105,A02,908087,Jones; Miles E,31,0,50,19
1746572899362,CSE 135,A01,887035,Powell; Thomas Allan,0,5,50,50
1746572900390,CSE 142,A01,887037,Staff,8,0,60,52
1746572901417,CSE 142L,A01,887039,Staff,34,0,60,26
1746572902444,CSE 151A,A01,887041,Solares; Edwin A,47,0,100,53
1746572903472,CSE 175,A01,887043,Kumar; Rakesh,30,0,30,0
1746572904499,CSS 1,A01,886389,Staff,1,1,40,39
1746572905526,DSC 30,A01,908097,Liao; Soohyun Nam,47,0,75,28
1746572906552,DSC 40A,A01,908099,Shannon; Kyle Michael,30,0,50,20
1746572907581,DSC 40B,A01,908112,Staff,15,0,50,35
1746572908606,DSC 80,A01,908116,Staff,19,0,60,41
1746572909634,DSC 197,001,956863,Eldridge; Justin Matthew,9999,0,9999,0
1746572910663,ECE 5,A01,886400,Morris; Karcher William,1,0,6,5
1746572910663,ECE 5,A02,886401,Morris; Karcher William,3,0,6,3
1746572911690,ECE 148,A01,886403,Silberman; Jack,0,14,14,14
1746572912716,ECON 1,A01,887265,Crane; Meredith Helen,12,0,70,58
1746572912716,ECON 1,B01,887268,Staff,42,0,50,8
1746572913741,ECON 2,A01,887273,Crane; Meredith Helen,55,0,70,15
1746572914771,ECON 3,A01,887279,Rondina; Giacomo,32,0,70,38
1746572915802,ECON 4,A01,887282,Anderson; John Charles,0,2,10,10
1746572916827,ECON 5,A01,887285,Staff,34,0,45,11
1746572916827,ECON 5,B01,887292,Staff,41,0,45,4
1746572917853,ECON 100A,A01,887337,Newhouse; Herbert S,54,0,70,16
1746572917853,ECON 100A,B01,887349,Staff,45,0,50,5
1746572918877,ECON 100B,A01,887361,Du; Songzi,29,0,70,41
1746572919902,ECON 100C,A01,887445,Newhouse; Herbert S,59,0,70,11
1746572920931,ECON 105,A00,887488,Vespa; Emanuel Ignacio,23,0,35,12
1746572921958,ECON 109,A01,887506,Shishkin; Denis,28,0,35,7
1746572922983,ECON 110A,A01,887568,Alon; Titan Michael,0,3,35,35
1746572922983,ECON 110A,B01,907601,Alon; Titan Michael,20,0,35,15
1746572924009,ECON 110B,A01,887598,Levkoff; Steven B.,0,24,70,70
1746572925034,ECON 112,A00,887599,Rondina; Giacomo,19,0,35,16
1746572926063,ECON 120A,A01,887603,Dai; Yinlin,35,0,70,35
1746572927088,ECON 120C,A01,887608,Sun; Yixiao,0,1,35,35
1746572927088,ECON 120C,B01,887614,Sun; Yixiao,0,0,35,35
1746572928118,ECON 138,A00,887621,Bharadwaj; Prashant,0,21,20,20
1746572929144,ECON 144,A00,958007,Squires; Dale E,12,0,35,23
1746572930169,ECON 171,A01,907666,Staff,18,0,35,17
1746572931196,ECON 175,A00,887626,Wu; Pak Yeung,22,0,35,13
1746572932220,ECON 190,A00,887640,Vespa; Emanuel Ignacio,22,0,35,13
1746572933245,EDS 25,A01,888197,Staff,0,0,0,0
1746572933245,EDS 25,A02,888209,Staff,0,0,0,0
1746572933245,EDS 25,A03,888210,Staff,0,0,0,0
1746572933245,EDS 25,A04,888212,Staff,0,0,0,0
1746572933245,EDS 25,A05,888213,Staff,0,0,0,0
1746572933245,EDS 25,A06,888214,Staff,0,0,0,0
1746572933245,EDS 25,A07,888235,Staff,0,2,0,0
1746572933245,EDS 25,A08,888236,Staff,0,0,0,0
1746572933245,EDS 25,A09,888240,Staff,0,0,0,0
1746572933245,EDS 25,A10,888244,Staff,0,0,0,0
1746572933245,EDS 25,B01,888273,Staff,0,0,0,0
1746572933245,EDS 25,B02,888285,Staff,0,0,0,0
1746572933245,EDS 25,B03,888423,Staff,0,0,0,1
1746572933245,EDS 25,B04,888432,Staff,0,0,0,0
1746572933245,EDS 25,B05,888433,Staff,0,0,0,0
1746572933245,EDS 25,B06,888467,Staff,0,0,0,0
1746572933245,EDS 25,B07,888468,Staff,0,0,0,0
1746572933245,EDS 25,B08,888479,Staff,0,0,0,0
1746572933245,EDS 25,B09,888484,Staff,0,0,0,0
1746572933245,EDS 25,B10,888487,Staff,0,0,0,0
1746572934273,EDS 38,A01,907700,Choi; Bailey Miyeon,30,0,30,0
1746572935297,EDS 112,A01,888601,Chapman; Thandeka K,12,0,40,28
1746572936326,EDS 115,A00,888697,Mendez; Kathrina Mendoza,10,0,30,20
1746572937354,EDS 116,A01,888893,Staff,34,0,40,6
1746572939415,EDS 124AR,A00,889133,Staff,29,0,50,21
1746572939415,EDS 124AR,B00,907471,Simon; Elizabeth A,37,0,50,13
1746572940441,EDS 124BR,A00,889134,Simon; Elizabeth A,44,0,100,56
1746572941473,EDS 125,A00,889135,Staff,25,0,30,5
1746572942500,EDS 126,A01,889138,Staff,35,0,40,5
1746572943529,EDS 164R,A01,889142,Wishard Guerra; Alison G.,33,0,50,17
1746572944554,ENG 30,A01,886396,Staff,0,0,0,0
1746572944554,ENG 30,B01,886398,Staff,0,0,0,0
1746572945585,ENVR 102,A00,906150,Montejo; Carolina,23,0,25,2
1746572946611,ETHN 103A,A00,887236,Man; Simeon S,0,3,0,0
1746572947635,ETHN 113,A00,887239,Staff,16,0,30,14
1746572948663,ETHN 116,A00,887240,Staff,16,0,25,9
1746572949688,ETHN 117,A00,887241,Choi; Esther Min,28,0,30,2
1746572950713,ETHN 118,A00,887243,Staff,24,0,30,6
1746572951738,ETHN 127,A00,887248,Cuong; Marisol,11,0,15,4
1746572952762,ETHN 139,A00,887250,Staff,7,0,10,3
1746572953788,ETHN 142,A00,887252,Staff,10,0,30,20
1746572954816,ETHN 161,A00,887253,Browne; Errol Tsekani,24,0,30,6
1746572955845,ETHN 163FR,A00,887255,Burelle; Julie Sara Veronique,0,0,5,5
1746572956870,GLBH 20,A00,889149,Elwardani; Nile Regina,8,0,42,34
1746572958920,GLBH 111,A01,889152,Burgos; Jose L.,17,0,17,0
1746572959948,GLBH 150,A00,889181,Sloane; Julia Kathryn,0,5,15,15
1746572961998,HDS 60,A01,886406,Warstadt; Melissa Fawn,73,0,80,7
1746572963023,HIAF 111,A00,889324,Gyamfi; Bright,25,0,32,7
1746572964048,HIEA 131,A00,889328,Staff,15,0,32,17
1746572965076,HIEA 144,A00,889333,Henry; Todd A.,26,0,32,6
1746572966101,HIEA 154,A00,889336,Henry; Todd A.,24,0,32,8
1746572967126,HIEU 106,A00,889339,Staff,22,0,32,10
1746572969179,HIEU 114,A00,889340,Staff,4,0,32,28
1746572970205,HIEU 135GS,A00,889342,Patterson; Patrick H.,0,0,1,24
1746572971230,HIEU 137,A00,889343,Edington; Claire Ellen,10,0,25,15
1746572972254,HIEU 148,A00,889345,Staff,14,0,32,18
1746572973279,HIEU 154,A00,889346,Biess; Frank Peter,21,0,32,11
1746572974307,HILA 102,A00,889351,Staff,12,0,32,20
1746572975331,HILD 2A,A01,889221,Lewandoski; Julia Mavis,1,10,32,31
1746572976357,HILD 7B,A01,889225,Man; Simeon S,0,12,32,32
1746572977382,HILD 7C,A01,889288,Alvarez; Luis A,0,14,32,32
1746572978409,HILD 30,A01,889323,Staff,0,5,32,32
1746572980460,HISC 119,A00,889383,Golan; Tal,19,0,32,13
1746572981485,HIUS 103,A00,889384,Man; Simeon S,0,0,32,32
1746572982510,HIUS 117,A00,919797,Kwak; Nancy,19,0,32,13
1746572983536,HIUS 142A,A00,919788,Staff,22,0,32,10
1746572985587,HIUS 149,A00,889386,Gyamfi; Bright,26,0,32,6
1746572986613,HIUS 155,A00,889387,Alvarez; Luis A,15,0,32,17
1746572987641,HUM 3,A01,886499,Caldwell; Michael Alan,19,0,50,31
1746572988667,HUM 3GS,A00,886500,Rodriguez; Bretton Sigfred,0,0,0,28
1746572989692,HUM 3R,A01,886502,Markman; Kristina,0,36,50,50
1746572990717,HUM 4,A01,886504,Crum; Matthew Stephen,24,0,50,26
1746572990717,HUM 4,B01,886506,West; Geoffrey Scott,17,0,50,33
1746572991746,HUM 4GS,A00,886507,Staff,0,0,0,19
1746572992774,HUM 5,A01,886509,Staff,32,0,50,18
1746572993802,HUM 5R,A01,886511,Zavodny; Tatiana Sophia,0,39,50,50
1746572994827,JAPN 180,A00,886407,Staff,16,0,40,24
1746572995853,LATI 50,A01,886409,Martin-Cabrera; Luis,4,0,22,18
1746572995853,LATI 50,A02,886410,Martin-Cabrera; Luis,19,0,22,3
1746572995853,LATI 50,A03,886411,Martin-Cabrera; Luis,21,0,22,1
1746572995853,LATI 50,A04,886412,Martin-Cabrera; Luis,9,0,22,13
1746572996879,LAWS 101,A00,907664,Staff,28,0,60,32
1746572997903,LIAB 1A,A00,889388,Saab; Dima,17,0,20,3
1746572998932,LIAB 1AX,A00,889389,El Cheddadi; Youniss,18,0,20,2
1746572999957,LIFR 1C,A00,889391,Van Moer; Vinciane G,8,0,20,12
1746573000983,LIFR 1CX,A00,889392,Van Moer; Vinciane G,7,0,20,13
1746573002008,LIFR 1D,A00,889393,Van Moer; Vinciane G,7,0,20,13
1746573003034,LIFR 1DX,A00,889394,Van Moer; Vinciane G,8,0,20,12
1746573004065,LIGN 7,A00,886923,Staff,24,0,50,26
1746573005095,LIGN 17,A00,886924,Kehler; Andrew Scott,125,0,150,25
1746573006119,LTAM 110,A00,889395,Staff,15,0,30,15
1746573007143,LTAM 110GS,A00,958010,Rodriguez; Bretton Sigfred,0,0,0,28
1746573008168,LTCH 101,A00,889397,Staff,23,0,25,2
1746573009194,LTCS 130,A00,889398,Staff,23,0,25,2
1746573010220,LTEA 138,A00,889399,Staff,24,0,40,16
1746573011245,LTEN 149,A00,889400,Wesling; Megan E.,0,3,25,25
1746573012270,LTEN 169,A00,889401,Staff,20,0,25,5
1746573013296,LTEN 180,A00,889402,Staff,10,0,15,5
1746573014322,LTEN 181,A00,889403,Staff,21,0,25,4
1746573015348,LTWL 100,A00,889404,Myerston Santana; Jacobo,2,0,25,23
1746573016373,LTWL 180GS,A00,889405,Staff,0,0,20,20
1746573017401,LTWL 181,A00,889406,Staff,16,0,25,9
1746573018428,LTWL 184,A00,889475,Mukherjee; Silpa,22,0,25,3
1746573019457,LTWR 102C,A00,889486,Staff,29,0,30,1
1746573020483,LTWR 115W,A00,889491,Staff,0,2,15,15
1746573021510,MAE 8,A01,886905,Staff,0,2,0,0
1746573022543,MAE 11,A00,886906,Bandaru; Prabhakar,0,7,50,50
1746573023573,MAE 20,A00,886907,Evdokimenko; Ekaterina,43,0,70,27
1746573024602,MAE 30B,A00,886909,Ghazinejad; Maziar,26,0,45,19
1746573025631,MAE 101B,A00,886910,Saintillan; David,29,0,45,16
1746573026657,MAE 105,A00,886911,Bandaru; Prabhakar,18,0,50,32
1746573027684,MAE 107,B00,958024,Staff,8,0,50,42
1746573028708,MAE 143B,A00,886913,Bewley; Thomas R,5,0,40,35
1746573029736,MAE 148,A01,886915,Silberman; Jack,0,3,14,14
1746573030763,MAE 160,A00,886916,Evdokimenko; Ekaterina,31,0,60,29
1746573031789,MATH 3C,A01,889681,Staff,0,2,30,30
1746573031789,MATH 3C,A02,960048,Staff,24,0,30,6
1746573032819,MATH 10A,A01,889760,Staff,26,0,30,4
1746573032819,MATH 10A,A02,889783,Staff,29,0,30,1
1746573033853,MATH 10B,A01,889785,Verstraete; Jacques Allan,2,0,35,33
1746573033853,MATH 10B,A02,889795,Verstraete; Jacques Allan,4,0,35,31
1746573033853,MATH 10B,B01,889797,Verstraete; Jacques Allan,3,0,35,32
1746573033853,MATH 10B,B02,889828,Verstraete; Jacques Allan,3,0,35,32
1746573034881,MATH 10C,A01,889849,Habib; Yousaf,7,0,30,23
1746573034881,MATH 10C,A02,889852,Habib; Yousaf,14,0,30,16
1746573034881,MATH 10C,A03,889853,Habib; Yousaf,22,0,30,8
1746573034881,MATH 10C,A04,889858,Habib; Yousaf,20,0,30,10
1746573034881,MATH 10C,B01,889861,Staff,1,0,30,29
1746573034881,MATH 10C,B02,889862,Staff,24,0,30,6
1746573034881,MATH 10C,B03,889863,Staff,27,0,30,3
1746573034881,MATH 10C,B04,889967,Staff,23,0,30,7
1746573035910,MATH 18,A01,889974,Staff,7,0,30,23
1746573035910,MATH 18,A02,889977,Staff,20,0,30,10
1746573035910,MATH 18,B01,889984,Hardiman; Liam,21,0,30,9
1746573035910,MATH 18,B02,889985,Hardiman; Liam,25,0,30,5
1746573036938,MATH 20A,A01,889990,Suk; Andrew Hoon,30,0,35,5
1746573037966,MATH 20B,A01,889993,Ohm; Ko Woon,22,0,30,8
1746573037966,MATH 20B,A02,889994,Ohm; Ko Woon,30,0,30,0
1746573037966,MATH 20B,B01,889996,Ohm; Ko Woon,22,0,30,8
1746573037966,MATH 20B,B02,889997,Ohm; Ko Woon,23,0,30,7
1746573038995,MATH 20C,A01,889999,Hammock; Frances H,17,0,30,13
1746573038995,MATH 20C,A02,890003,Hammock; Frances H,23,0,30,7
1746573038995,MATH 20C,B01,890006,Hammock; Frances H,3,0,30,27
1746573038995,MATH 20C,B02,890007,Hammock; Frances H,12,0,30,18
1746573040026,MATH 20D,A01,890011,Cheng; Hsiao-Bing,1,1,30,29
1746573040026,MATH 20D,A02,890012,Cheng; Hsiao-Bing,14,0,30,16
1746573040026,MATH 20D,B01,890016,Cheng; Hsiao-Bing,13,0,30,17
1746573040026,MATH 20D,B02,890017,Cheng; Hsiao-Bing,13,0,30,17
1746573041051,MATH 20E,A01,890026,Harel; Guershon,1,0,30,29
1746573041051,MATH 20E,A02,890029,Harel; Guershon,23,0,30,7
1746573041051,MATH 20E,B01,890033,Harel; Guershon,7,0,30,23
1746573041051,MATH 20E,B02,890101,Harel; Guershon,21,0,30,9
1746573042078,MATH 102,A01,890104,Staff,17,0,30,13
1746573042078,MATH 102,A02,890105,Staff,27,0,30,3
1746573043148,MATH 103B,A01,890116,Salehi Golsefidy; Alireza,3,0,30,27
1746573043148,MATH 103B,B01,890118,Staff,0,3,34,34
1746573044175,MATH 109,A01,890121,Aliabadi Sr.; Mohsen,1,0,30,29
1746573044175,MATH 109,B01,890124,Upadrashta; Pranav Kumar,18,0,30,12
1746573045202,MATH 120A,A01,890126,Eggers; John Dietrich,13,0,30,17
1746573046229,MATH 142B,A01,890128,Ioana; Adrian,19,0,30,11
1746573046229,MATH 142B,A02,890129,Ioana; Adrian,13,0,30,17
1746573047255,MATH 154,A01,890174,Staff,0,0,30,30
1746573047255,MATH 154,A02,890182,Staff,0,0,30,30
1746573048285,MATH 168A,A01,890197,Dumitriu; Ioana,21,0,35,14
1746573049312,MATH 170A,A01,890240,Nie; Jiawang,1,0,30,29
1746573049312,MATH 170A,A02,890241,Nie; Jiawang,11,0,30,19
1746573049312,MATH 170A,A03,890249,Nie; Jiawang,23,0,30,7
1746573050339,MATH 170B,A01,957891,Nag; Panchali,13,0,35,22
1746573052401,MATH 181A,A01,908025,Staff,0,4,35,35
1746573052401,MATH 181A,A02,960115,Staff,27,0,35,8
1746573053432,MATH 181B,A01,959874,Staff,25,0,30,5
1746573054459,MATH 193B,A01,890265,Staff,0,4,35,35
1746573055485,MGT 4,A01,890311,Anderson; John Charles,42,0,88,46
1746573056514,MGT 5,A00,907740,Staff,13,0,98,85
1746573057543,MGT 12,A00,890312,Lindenberger; Wade Douglas,67,0,98,31
1746573058571,MGT 16,A00,957883,Staff,78,0,98,20
1746573060626,MGT 45,A00,890314,Pecore; Joseph P.,46,0,98,52
1746573061656,MGT 71,A00,890315,Staff,0,11,98,98
1746573062685,MGT 100,A00,890316,Yavorsky; Daniel Ryan,44,0,98,54
1746573063711,MGT 103,A00,890317,Ehrich; Kristine R,73,0,98,25
1746573064743,MGT 105,A00,890356,Bates; Kenneth Walter,0,8,98,98
1746573065769,MGT 112,A00,890360,Ehrich; Kristine R,55,0,98,43
1746573066798,MGT 127R,A00,907732,Zhu; Kevin Xiaoguo,23,0,98,75
1746573067829,MGT 131B,A00,890361,Anderson; John Charles,60,0,98,38
1746573068862,MGT 137,A00,890362,Lindenberger; Wade Douglas,65,0,98,33
1746573069889,MGT 160,A00,890369,Johnson; Erik Barry,9,0,98,89
1746573071947,MGT 164,A00,890372,Zimmermann; Carsten,0,40,98,98
1746573072974,MGT 180,A00,890374,Bliss; Barbara Ann,12,0,98,86
1746573074004,MMW 15,A01,886414,Chang; Edmond Yi-Teh,0,12,28,28
1746573074004,MMW 15,A02,886415,Chang; Edmond Yi-Teh,0,8,28,28
1746573074004,MMW 15,A03,886416,Chang; Edmond Yi-Teh,0,8,28,28
1746573074004,MMW 15,A04,886417,Chang; Edmond Yi-Teh,0,8,28,28
1746573074004,MMW 15,B01,886419,Chang; Edmond Yi-Teh,0,7,28,28
1746573074004,MMW 15,B02,886420,Chang; Edmond Yi-Teh,0,8,28,28
1746573074004,MMW 15,B03,886421,Chang; Edmond Yi-Teh,0,7,28,28
1746573074004,MMW 15,B04,886422,Chang; Edmond Yi-Teh,0,8,28,28
1746573074004,MMW 15,C01,886424,Staff,0,9,28,28
1746573074004,MMW 15,C02,886425,Staff,0,8,28,28
1746573074004,MMW 15,C03,886426,Staff,0,8,28,28
1746573074004,MMW 15,C04,886427,Staff,0,8,28,28
1746573074004,MMW 15,C05,958038,Staff,0,8,28,28
1746573074004,MMW 15,C06,958039,Staff,1,8,28,27
1746573075031,MMW 15GS,A00,906910,Patterson; Patrick H.,4,0,28,24
1746573076056,MMW 122R,A01,886429,Rahimi; Babak,0,13,28,28
1746573076056,MMW 122R,A02,886430,Rahimi; Babak,0,12,28,28
1746573076056,MMW 122R,A03,958040,Rahimi; Babak,0,11,28,28
1746573077086,MUS 1A,A01,890937,Staff,2,0,25,23
1746573077086,MUS 1A,A02,891035,Staff,6,0,25,19
1746573077086,MUS 1A,C01,958912,Staff,24,0,25,1
1746573077086,MUS 1A,C02,958913,Staff,25,0,25,0
1746573079138,MUS 2AK,A00,957092,Ohnishi; Takae,15,0,15,0
1746573080164,MUS 4,A01,891044,Staff,1,0,25,24
1746573080164,MUS 4,A02,891045,Staff,23,0,25,2
1746573080164,MUS 4,B01,891048,Staff,17,0,25,8
1746573080164,MUS 4,B02,891050,Staff,25,0,25,0
1746573081194,MUS 5,A01,957506,Dubnov; Shlomo,0,0,25,25
1746573081194,MUS 5,A02,957622,Dubnov; Shlomo,13,0,25,12
1746573081194,MUS 5,A03,957623,Dubnov; Shlomo,20,0,25,5
1746573082220,MUS 6,A01,891053,Freitas Caetano; Marcelo,24,0,25,1
1746573082220,MUS 6,A02,891054,Freitas Caetano; Marcelo,23,0,25,2
1746573083248,MUS 7,A01,891081,Staff,1,0,25,24
1746573083248,MUS 7,A02,891082,Staff,3,0,25,22
1746573084305,MUS 8GS,A00,891118,Borgo; David Garcia,1,0,25,24
1746573085331,MUS 11,A01,891140,Staff,9,0,25,16
1746573085331,MUS 11,A02,891141,Staff,22,0,25,3
1746573086357,MUS 13,A01,891143,Staff,8,0,25,17
1746573086357,MUS 13,A02,891144,Staff,24,0,25,1
1746573087386,MUS 15,A01,891146,Staff,9,0,25,16
1746573087386,MUS 15,A02,891148,Staff,21,0,25,4
1746573087386,MUS 15,B01,891150,Staff,18,0,25,7
1746573087386,MUS 15,B02,891151,Staff,25,0,25,0
1746573088415,MUS 20,A01,891153,Staff,5,0,20,15
1746573088415,MUS 20,A02,891155,Staff,14,0,20,6
1746573089443,MUS 80,A00,891156,Staff,19,0,25,6
1746573089443,MUS 80,B00,891157,Staff,23,0,25,2
1746573090471,MUS 130,A00,891158,Ohnishi; Takae,35,0,35,0
1746573091498,MUS 150GS,A01,891160,Borgo; David Garcia,1,0,25,24
1746573092529,MUS 170,A01,891162,Freitas Caetano; Marcelo,20,0,25,5
1746573092529,MUS 170,A02,891164,Freitas Caetano; Marcelo,21,0,25,4
1746573093557,NANO 11,A00,886220,Vazquez Mena; Oscar,13,0,15,2
1746573094586,NANO 15,A01,886222,Drews; Aaron,4,0,7,3
1746573095613,NANO 104,A00,886224,Sirbuly; Donald,17,0,25,8
1746573096643,PH 40,A00,886528,Staff,24,0,40,16
1746573097671,PH 45,A01,886799,Staff,35,0,40,5
1746573098715,PH 110,A00,886802,Staff,0,7,40,40
1746573099743,PH 172,A00,906716,Staff,19,0,35,16
1746573100768,PH 191,A00,886803,Staff,6,0,40,34
1746573101796,PHIL 1,A00,889500,Staff,20,0,30,10
1746573102822,PHIL 10,A01,889549,Grush; Rick Scott,16,0,22,6
1746573102822,PHIL 10,A02,889551,Grush; Rick Scott,22,0,22,0
1746573103849,PHIL 28,A01,889559,Lamey; Andy M.,0,2,31,31
1746573103849,PHIL 28,A02,889561,Lamey; Andy M.,0,1,30,30
1746573103849,PHIL 28,A03,889572,Lamey; Andy M.,0,1,30,30
1746573104874,PHIL 35,A00,907839,Staff,13,0,15,2
1746573105900,PHIL 60,A00,889574,Staff,73,0,90,17
1746573106930,PHIL 101,A00,958004,Staff,12,0,15,3
1746573108988,PHIL 136,A00,889582,Fulkerson; Matthew Todd,26,0,45,19
1746573110014,PHIL 163,A01,889601,Staff,21,0,30,9
1746573110014,PHIL 163,B01,889606,Brandt; Reuven A,0,3,0,0
1746573111041,PHIL 164,A00,889610,Staff,16,0,30,14
1746573112067,PHIL 165,A00,889613,Staff,22,0,30,8
1746573113098,PHYS 1A,A00,886431,Staff,26,0,70,44
1746573114123,PHYS 1AL,001,886432,Tsai; Philbert S,0,2,30,30
1746573114123,PHYS 1AL,002,886436,Tsai; Philbert S,11,0,30,19
1746573115150,PHYS 1B,A00,886439,Staff,185,0,240,55
1746573116179,PHYS 1BL,001,886441,Tsai; Philbert S,0,4,30,30
1746573116179,PHYS 1BL,002,886444,Tsai; Philbert S,2,0,30,28
1746573117207,PHYS 1C,A00,896092,Arnold; Kam S,78,0,146,68
1746573118237,PHYS 1CL,001,886448,Tsai; Philbert S,0,0,30,30
1746573118237,PHYS 1CL,002,886449,Tsai; Philbert S,1,0,30,29
1746573118237,PHYS 1CL,003,886450,Tsai; Philbert S,16,0,30,14
1746573118237,PHYS 1CL,004,886451,Tsai; Philbert S,15,0,30,15
1746573119263,PHYS 2B,A01,886457,Staff,68,0,115,47
1746573120295,PHYS 2C,A01,886460,Shotwell; Brian,0,9,65,65
1746573121321,PHYS 2CL,A01,886467,Staff,0,4,28,28
1746573121321,PHYS 2CL,A02,886468,Staff,0,3,28,28
1746573122354,PHYS 2D,A01,886470,Staff,10,0,50,40
1746573123384,PHYS 4B,A01,886475,Grinstein; Benjamin,22,0,40,18
1746573124411,POLI 5,A00,891173,Desposato; Scott,7,0,25,18
1746573125444,POLI 5D,A01,891175,Staff,5,0,5,0
1746573125444,POLI 5D,B01,891178,Staff,5,0,5,0
1746573126499,POLI 11,A00,891179,Ferree; Karen E,2,0,35,33
1746573127525,POLI 12,A00,891180,Staff,16,0,30,14
1746573128557,POLI 27,A01,891182,Staff,12,0,75,63
1746573129584,POLI 30,A00,891183,Staff,8,0,50,42
1746573130611,POLI 100B,A00,891244,Staff,5,1,35,30
1746573131639,POLI 100I,A00,891247,Staff,7,0,30,23
1746573132670,POLI 104J,A00,891248,Nichter; Maysa,14,0,30,16
1746573133699,POLI 104U,A00,891250,Nichter; Maysa,2,0,30,28
1746573135756,POLI 110B,A00,891255,Wiens; David,19,0,25,6
1746573136788,POLI 112A,A00,891256,Wiens; David,6,0,25,19
1746573137819,POLI 114BR,A00,891261,Staff,19,0,30,11
1746573138851,POLI 117R,A00,891262,Forman; Fonna,0,6,50,50
1746573139878,POLI 118,A00,891264,Ingham; Sean,17,0,25,8
1746573140907,POLI 124A,A00,891265,Staff,18,0,20,2
1746573141933,POLI 125D,A00,891266,Nichter; Simeon C,2,0,25,23
1746573142963,POLI 126,A00,891268,Nichter; Simeon C,7,0,25,18
1746573143991,POLI 126AA,A00,891272,Staff,16,0,25,9
1746573145019,POLI 130AA,A00,891273,Staff,15,0,20,5
1746573146047,POLI 134AA,A00,891274,Staff,4,0,20,16
1746573148099,POLI 138,A00,891278,Staff,21,0,25,4
1746573149127,POLI 142K,A00,891280,Staff,10,0,25,15
1746573150153,POLI 142M,A00,891281,Gartzke; Erik,16,0,30,14
1746573151180,POLI 142P,A00,891284,Staff,20,0,30,10
1746573152211,POLI 143,A00,891285,Gartzke; Erik,12,0,30,18
1746573153239,POLI 153,A00,891286,Staff,19,0,20,1
1746573155290,POLI 175,A00,891290,Staff,15,0,20,5
1746573156320,PSYC 1,A00,890674,Steiner; Eric Tomas,0,11,45,45
1746573157365,PSYC 2,A00,890676,Albright; Thomas D,21,0,35,14
1746573158397,PSYC 3,A00,890679,Staff,17,0,20,3
1746573159427,PSYC 6,A00,959858,Staff,20,0,20,0
1746573160457,PSYC 60,A01,890684,Rickard; Timothy C.,0,5,45,45
1746573161483,PSYC 70,A01,890689,Geller; Emma Harlan,7,0,30,23
1746573162512,PSYC 71,A01,959860,Staff,21,0,25,4
1746573163539,PSYC 100,A00,890690,Lacefield; Katharine I,0,50,180,180
1746573164565,PSYC 102,A00,890695,Staff,18,0,40,22
1746573165594,PSYC 105,A00,890699,Geller; Emma Harlan,70,0,100,30
1746573166621,PSYC 106,A00,890701,Gorman; Michael R.,6,0,30,24
1746573167649,PSYC 108,A00,890704,Adrian; Julia Anna,0,28,50,50
1746573168679,PSYC 118,A01,890712,Staff,11,0,30,19
1746573169706,PSYC 124,A00,890716,Chapman; Eddie Nathaniel,25,0,60,35
1746573170734,PSYC 131,A00,890717,Anagnostaras; Stephan,0,8,80,80
1746573171764,PSYC 137,A00,890719,Winkielman; Piotr,0,11,30,30
1746573172792,PSYC 144,A00,890721,Adrian; Julia Anna,0,9,45,45
1746573173825,PSYC 162,A00,890805,Staff,0,0,75,75
1746573174852,PSYC 169,A00,890810,Staff,0,14,30,30
1746573175882,PSYC 172,A00,890814,Gorman; Michael R.,9,0,30,21
1746573176910,PSYC 181,A00,890818,Anagnostaras; Stephan,9,0,200,191
1746573177941,PSYC 184,A00,959861,Staff,168,0,175,7
1746573178968,PSYC 189,A00,890823,Staff,0,2,30,30
1746573179996,PSYC 191,A00,890884,Rickard; Timothy C.,0,12,35,35
1746573181024,PSYC 193,A00,890913,Staff,19,0,30,11
1746573181024,PSYC 193,B00,890914,Chapman; Eddie Nathaniel,24,0,30,6
1746573182053,PSYC 193L,A01,890918,Lowe; Angela Beth,20,0,30,10
1746573182053,PSYC 193L,B01,890921,Hurwitz; Ethan Scott,20,0,30,10
1746573182053,PSYC 193L,C01,890928,Staff,30,0,30,0
1746573183080,RELI 149,A00,886806,Rahimi; Babak,23,0,40,17
1746573184113,SE 9,A01,886814,Staff,7,0,20,13
1746573185139,SE 101B,A01,886816,Chadha; Mayank,4,0,35,31
1746573186169,SE 110B,A00,886818,Zhu; Qiang,4,0,75,71
1746573187199,SE 125,A01,886830,Staff,10,0,30,20
1746573188231,SE 130B,A01,886835,Staff,14,0,40,26
1746573189265,SE 131A,A01,886838,Krysl; Petr,34,0,55,21
1746573190293,SE 154,A00,886840,Staff,29,0,50,21
1746573191324,SE 164GS,A01,886849,Staff,6,0,20,14
1746573192350,SE 167GS,A01,886853,Staff,6,0,20,14
1746573193383,SIO 25,A01,890107,Staff,19,0,30,11
1746573194410,SIO 45,A00,890109,Cook; Geoffrey W,117,0,200,83
1746573195437,SIO 109R,A00,890110,Forman; Fonna,0,16,20,20
1746573196468,SIO 187,A01,890114,Kacev; David,15,0,40,25
1746573197496,SOCI 1,A01,890431,Thorpe; Charles Robert,14,0,30,16
1746573197496,SOCI 1,A02,890518,Thorpe; Charles Robert,30,0,30,0
1746573198527,SOCI 2,A01,957978,Staff,25,0,25,0
1746573198527,SOCI 2,A02,957979,Staff,23,0,25,2
1746573199556,SOCI 20,A01,890523,Calderon-Zaks; Michael Aar,21,0,30,9
1746573199556,SOCI 20,A02,890526,Calderon-Zaks; Michael Aar,29,0,30,1
1746573200589,SOCI 30,A01,890533,Pardo Guerra; Juan Pablo,37,0,40,3
1746573201617,SOCI 40,A01,890535,Staff,27,0,45,18
1746573202645,SOCI 104Q,A00,890559,Staff,18,0,30,12
1746573203673,SOCI 106,A00,890560,Arnal; Maud Marie Leonie,20,0,30,10
1746573204701,SOCI 110,A00,890567,Holkenbrink-Monk; Charlene,19,0,30,11
1746573205734,SOCI 112,A00,890568,Victoria Torres; Pablo,2,0,55,53
1746573206770,SOCI 115,A00,890597,Arnal; Maud Marie Leonie,28,0,45,17
1746573208851,SOCI 121,A00,890604,Pardo Guerra; Juan Pablo,38,0,45,7
1746573209878,SOCI 126,A01,890608,Staff,8,0,10,2
1746573210907,SOCI 127,A00,890609,Staff,18,0,30,12
1746573211938,SOCI 131,A00,890610,Thorpe; Charles Robert,37,0,45,8
1746573212973,SOCI 135,A00,890615,Payne; Christine Anna,13,0,45,32
1746573214002,SOCI 139,A00,890620,Staff,38,0,45,7
1746573215029,SOCI 148E,A00,890622,Calderon-Zaks; Michael Aar,36,0,45,9
1746573216057,SOCI 150,A00,890623,Kohler; Kristopher M.,31,0,45,14
1746573217086,SOCI 157,A00,890625,Jules-Rosette; Bennetta W.,18,0,20,2
1746573218112,SOCI 160,A00,890627,Payne; Christine Anna,21,0,45,24
1746573219144,SYN 1,A00,886855,Fish; Gwendolyn Anne,0,1,0,0
1746573219144,SYN 1,B00,906086,Fish; Gwendolyn Anne,0,2,0,2
1746573220176,SYN 2R,A00,886860,Staff,0,17,15,15
1746573220176,SYN 2R,B00,906106,Atkinson; Arthur Laird,0,16,15,15
1746573221212,SYN 100,A01,886866,Browne; Emily,0,28,20,20
1746573221212,SYN 100,B01,906128,Rock; Martin,0,5,20,20
1746573221212,SYN 100,C01,906140,Deavenport; James Cary,0,3,20,20
1746573221212,SYN 100,D01,907816,Deavenport; James Cary,0,5,20,20
1746573222242,TDAC 1,A00,890286,Walsh; Kim C.,8,0,20,12
1746573223268,TDAC 101,A00,890296,Basso; Beatrice,15,0,20,5
1746573224299,TDDE 131,A00,890297,Staff,47,0,50,3
1746573225328,TDDM 1,A00,890287,Weinberg; Sadie,25,0,30,5
1746573226355,TDGE 11,A00,890288,Fulton; Julia,138,0,200,62
1746573226355,TDGE 11,B00,890289,Castro; Robert Jess,184,0,200,16
1746573227386,TDGE 25,B00,957359,Walsh; Kim C.,5,0,20,15
1746573228413,TDGE 40,A01,890292,Power; Jade Yukana,27,0,30,3
1746573229444,TDGE 124,A00,890298,Havis; Allan,0,1,50,50
1746573230476,TDGE 131R,A00,890299,Burelle; Julie Sara Veronique,15,0,42,27
1746573231509,TDHT 101,A00,890300,Staff,10,0,20,10
1746573232536,TDHT 109,A01,890302,Anderson; Mysia Anyse,31,0,40,9
1746573233564,TDMV 1,A00,890293,Arcidiacono; Kristin,18,0,30,12
1746573234591,TDMV 2,A00,890294,Weinberg; Sadie,23,0,30,7
1746573235617,TDMV 3,A00,957878,Arcidiacono; Kristin,28,0,30,2
1746573237675,TDMV 138,A00,890304,Jun; Grace Shin Hae,25,0,40,15
1746573238706,TDMV 140,A00,890305,Corrales; Joseph Bernales,25,0,30,5
1746573239736,TDMV 142,A00,890307,Caligagan; Tony,32,0,40,8
1746573240765,TDMV 144,A00,890308,Camaya; Michelle Ann,25,0,30,5
1746573241792,TDPW 1,A00,890295,Stein; Deborah Isobel,2,0,20,18
1746573242821,USP 2,A01,890272,Lerner; Amy M,7,0,20,13
1746573243852,USP 3,A01,890274,Staff,12,0,30,18
1746573244883,USP 15,A01,890276,Sun; Feiyang,16,0,30,14
1746573245909,USP 25,A00,890277,Shenkman; Michael Thomas,19,0,25,6
1746573246936,USP 138,A00,890278,Staff,14,0,25,11
1746573247967,USP 143,A00,890279,Staff,22,0,70,48
1746573248994,USP 144,A00,890280,Chowdhury; Muhammed Zohir,16,0,30,14
1746573250022,USP 150,A00,890281,Boomhower; Matthew Charles,4,0,30,26
1746573251076,USP 151,A00,890282,Staff,16,0,20,4
1746573252105,USP 162,A00,890283,Andrews; Abigail Leslie,16,0,20,4
1746573253133,USP 168,A00,920477,Kwak; Nancy,0,0,5,5
1746573254160,USP 181,A00,890284,Staff,3,0,20,17
1746573255187,USP 191A,A00,890285,Staff,12,0,20,8
1746573256213,VIS 101,A00,886512,Staff,26,0,75,49
1746573257241,VIS 103,A00,886513,Cruz; Edwin Teddy,61,0,75,14
1746573258267,VIS 108,A00,886514,Staff,3,0,15,12
1746573259293,VIS 127P,A00,886515,Shen; Kuiyi,80,0,146,66
1746573260320,VIS 149,A00,886516,Yoldas; Pinar,0,0,15,15
1746573261346,VIS 164,A00,886526,Erdmann; Dean,19,0,22,3
1746573262375,VIS 194S,A00,886527,Staff,61,0,75,14
1746573263402,WCWP 10A,C00,886484,Martiniuk; Jill,12,0,15,3
1746573264441,WCWP 10B,A00,886490,Uriarte; Emma,0,0,15,15
1746573264441,WCWP 10B,B00,886491,Dhir; Simrita,9,0,15,6
1746573264441,WCWP 10B,C00,886492,Ornelas; Tricia,0,0,15,15
1746573265468,WCWP 100,A00,886494,Young; Mark T,0,6,15,15
1746573267567,AAS 10,A01,886199,Childs; Dennis R.,0,3,0,0
1746573268592,ANAR 104,A01,886940,Shtienberg; Gilad,27,0,30,3
1746573269618,ANAR 120,A00,886953,Staff,12,0,20,8
1746573270644,ANBI 148,A01,886955,Wilder; Linnea Lorene,30,0,40,10
1746573272701,ANSC 122,A00,886957,Staff,25,0,30,5
1746573273728,ANSC 150,A00,886958,Sloane; Julia Kathryn,2,0,15,13
1746573274759,ANSC 156,A00,886959,Jenkins; Janis A.,0,1,15,15
1746573275786,ANSC 180,A00,886960,Staff,11,0,17,6
1746573276812,ANSC 188,A00,886961,Jassal; Aftab,9,0,25,16
1746573277839,ANSC 190,A00,886962,Jassal; Aftab,14,0,25,11
1746573278868,ANSC 191,A00,886963,Staff,18,0,20,2
1746573279896,ANTH 3,A01,891689,Staff,17,0,20,3
1746573280923,ANTH 5,A00,886933,Semendeferi; Ekaterini,16,0,20,4
1746573281952,ANTH 10,A00,886934,Staff,0,12,30,30
1746573282978,ANTH 21,A01,886936,Staff,41,0,60,19
1746573284005,ANTH 23,A01,886938,Staff,92,0,100,8
1746573285042,ANTH 105,A00,886964,Stewart; Alexander B,84,0,100,16
1746573286069,ANTH 108,A00,886965,Pedersen; David,9,0,20,11
1746573287102,AWP 10,001,886147,Staff,0,0,0,0
1746573287102,AWP 10,002,886148,Staff,0,0,0,0
1746573287102,AWP 10,003,886149,Staff,0,0,0,0
1746573287102,AWP 10,004,886150,Staff,0,0,0,0
1746573287102,AWP 10,005,886151,Staff,0,0,0,0
1746573287102,AWP 10,006,886152,Staff,0,0,0,0
1746573287102,AWP 10,007,886153,Staff,0,0,0,0
1746573287102,AWP 10,008,886154,Staff,0,0,0,0
1746573287102,AWP 10,009,886155,Staff,0,0,0,0
1746573287102,AWP 10,010,886156,Staff,0,0,0,0
1746573287102,AWP 10,011,886158,Staff,0,0,0,0
1746573287102,AWP 10,012,886160,Staff,0,0,0,0
1746573287102,AWP 10,013,886161,Staff,0,0,0,0
1746573287102,AWP 10,014,886162,Staff,0,0,0,0
1746573287102,AWP 10,015,886163,Staff,0,0,0,0
1746573287102,AWP 10,016,886164,Staff,0,0,0,0
1746573287102,AWP 10,017,886165,Staff,0,0,0,0
1746573287102,AWP 10,018,886166,Staff,0,0,0,0
1746573287102,AWP 10,019,886168,Staff,0,0,0,0
1746573287102,AWP 10,020,886170,Staff,0,0,0,0
1746573287102,AWP 10,021,886172,Staff,0,0,0,0
1746573288130,AWP 10R,001,886173,Staff,0,1,0,0
1746573288130,AWP 10R,002,886174,Staff,0,1,0,0
1746573288130,AWP 10R,003,886175,Staff,0,0,0,0
1746573288130,AWP 10R,004,886176,Staff,0,0,0,0
1746573288130,AWP 10R,005,886177,Staff,0,0,0,0
1746573288130,AWP 10R,006,886178,Staff,0,0,0,0
1746573288130,AWP 10R,007,886179,Staff,0,0,0,0
1746573288130,AWP 10R,008,886181,Staff,0,0,0,0
1746573288130,AWP 10R,009,886182,Staff,0,0,0,0
1746573288130,AWP 10R,010,886183,Staff,0,0,0,0
1746573288130,AWP 10R,011,886184,Staff,0,0,0,0
1746573288130,AWP 10R,012,886185,Staff,0,0,0,0
1746573288130,AWP 10R,013,886186,Staff,0,0,0,0
1746573288130,AWP 10R,014,886187,Staff,0,0,0,0
1746573288130,AWP 10R,015,886188,Staff,0,0,0,0
1746573288130,AWP 10R,016,886189,Staff,0,0,0,0
1746573288130,AWP 10R,017,960532,Staff,0,0,0,0
1746573288130,AWP 10R,018,960533,Staff,0,0,0,0
1746573288130,AWP 10R,019,960534,Staff,0,0,0,0
1746573288130,AWP 10R,020,960538,Staff,0,0,0,0
1746573288130,AWP 10R,021,960540,Staff,0,0,0,0
1746573288130,AWP 10R,022,960541,Staff,0,0,0,0
1746573288130,AWP 10R,023,960542,Staff,0,0,0,0
1746573288130,AWP 10R,024,960544,Staff,0,0,0,0
1746573288130,AWP 10R,025,960545,Staff,0,0,0,0
1746573288130,AWP 10R,026,960548,Staff,0,0,0,0
1746573289157,AWP 102R,A00,886190,Staff,0,0,0,0
1746573289157,AWP 102R,B00,886191,Staff,0,0,0,0
1746573290188,BENG 100,A01,886193,Staff,17,0,30,13
1746573291217,BENG 122A,A01,886195,Hasty; Jeff M,13,0,30,17
1746573292244,BENG 166A,A00,886196,Sah; Robert Lie-Yuan,0,2,30,30
1746573293270,BENG 190,A00,958050,Khojah; Reem I,20,0,25,5
1746573294297,BIBC 102,A01,894320,Staff,0,0,46,46
1746573294297,BIBC 102,A02,894321,Staff,0,0,46,46
1746573294297,BIBC 102,A03,894344,Staff,7,0,46,39
1746573294297,BIBC 102,A04,894345,Staff,27,0,47,20
1746573295324,BICD 100R,A01,894365,Smith; Laurie,0,3,58,58
1746573295324,BICD 100R,A02,894366,Smith; Laurie,0,5,58,58
1746573295324,BICD 100R,A03,894367,Smith; Laurie,0,0,59,59
1746573295324,BICD 100R,A04,959869,Smith; Laurie,40,0,59,19
1746573296353,BICD 136,A01,894383,Gustafson-Brown; Cindy,14,0,50,36
1746573297385,BIEB 102,A01,894494,Butler; Shannon Rhey,51,0,130,79
1746573299439,BIEB 150,A01,894617,Wills; Christopher,3,0,20,17
1746573299439,BIEB 150,A02,894631,Wills; Christopher,3,0,20,17
1746573299439,BIEB 150,A03,894937,Wills; Christopher,3,0,20,17
1746573299439,BIEB 150,A04,894946,Wills; Christopher,5,0,20,15
1746573300466,BIEB 194,A00,906141,Kurle; Carolyn M.,6,0,20,14
1746573301493,BILD 1,A01,894154,Staff,3,0,19,16
1746573301493,BILD 1,A02,894155,Staff,14,0,19,5
1746573301493,BILD 1,A03,894160,Staff,13,0,19,6
1746573301493,BILD 1,A04,894161,Staff,15,0,18,3
1746573302520,BILD 2,A01,894168,Staff,0,0,50,50
1746573302520,BILD 2,A02,894169,Staff,0,0,50,50
1746573302520,BILD 2,A03,894179,Staff,0,0,50,50
1746573302520,BILD 2,A04,894203,Staff,24,0,50,26
1746573303552,BILD 3,A01,894213,Staff,23,0,31,8
1746573303552,BILD 3,A02,894214,Staff,26,0,31,5
1746573303552,BILD 3,A03,894235,Staff,28,0,31,3
1746573303552,BILD 3,A04,894236,Staff,28,0,32,4
1746573304577,BILD 4,A01,894253,Reuther; Keefe,5,0,24,19
1746573304577,BILD 4,A02,894258,Reuther; Keefe,16,0,24,8
1746573305603,BILD 5,A01,894276,Reuther; Keefe,35,0,50,15
1746573305603,BILD 5,A02,894277,Reuther; Keefe,45,0,50,5
1746573305603,BILD 5,A03,894290,Reuther; Keefe,44,0,50,6
1746573305603,BILD 5,A04,894291,Reuther; Keefe,48,0,50,2
1746573306634,BILD 24,A01,894297,Pirino; Giorgia,40,0,60,20
1746573307665,BIMM 100,B01,958915,Staff,71,0,100,29
1746573308693,BIMM 101,A01,895017,McDonnell; Lisa Marie,0,5,24,24
1746573308693,BIMM 101,A02,895018,McDonnell; Lisa Marie,0,5,24,24
1746573308693,BIMM 101,B01,895020,McDonnell; Lisa Marie,0,6,24,24
1746573308693,BIMM 101,B02,895021,McDonnell; Lisa Marie,0,4,24,24
1746573309719,BIMM 110,A01,895023,Staff,1,0,25,24
1746573309719,BIMM 110,A02,895024,Staff,9,0,25,16
1746573309719,BIMM 110,A03,895025,Staff,18,0,25,7
1746573309719,BIMM 110,A04,895031,Staff,20,0,25,5
1746573310752,BIMM 120,A01,895114,Gustafson-Brown; Cindy,14,0,28,14
1746573310752,BIMM 120,A02,895126,Gustafson-Brown; Cindy,21,0,27,6
1746573311780,BIPN 100,A01,895130,Yang; Mingyu,0,0,38,38
1746573311780,BIPN 100,A02,895131,Yang; Mingyu,32,0,38,6
1746573311780,BIPN 100,A03,895132,Yang; Mingyu,32,0,38,6
1746573311780,BIPN 100,A04,895133,Yang; Mingyu,27,0,36,9
1746573312810,BIPN 120,A01,895135,Cooke; James Edward,0,3,13,13
1746573312810,BIPN 120,A02,895136,Cooke; James Edward,0,1,13,13
1746573312810,BIPN 120,A03,895137,Cooke; James Edward,0,3,13,13
1746573312810,BIPN 120,A04,895156,Cooke; James Edward,0,2,11,11
1746573313839,BIPN 134,A01,895235,Cooke; James Edward,0,2,25,25
1746573313839,BIPN 134,A02,895237,Cooke; James Edward,0,0,25,25
1746573313839,BIPN 134,A03,895240,Cooke; James Edward,3,0,25,22
1746573313839,BIPN 134,A04,895270,Cooke; James Edward,20,0,25,5
1746573314868,BIPN 189,A00,892103,Staff,0,14,14,14
1746573316921,BISP 194,A00,958008,Staff,0,2,0,0
1746573317950,CAT 124,A01,922009,Staff,0,5,20,20
1746573318977,CAT 125R,A00,886390,Morales; Celeste Georgianna,0,2,20,20
1746573318977,CAT 125R,B00,886391,Irwin; Matthew Joseph,0,4,20,20
1746573318977,CAT 125R,C00,886392,Smith; Lauryn Alissa,0,2,20,20
1746573318977,CAT 125R,D00,886393,Vanderschuit; Maya Alysia,0,3,20,20
1746573318977,CAT 125R,E00,886394,Marchisotto; Jennifer Anne,0,3,20,20
1746573320005,CENG 15,A01,886218,Drews; Aaron,3,0,8,5
1746573321034,CENG 113,A00,886219,Opatkiewicz; Justin Paul,15,0,25,10
1746573322061,CGS 101,A00,887044,Staff,7,0,20,13
1746573323088,CGS 105,A01,887046,Staff,14,0,25,11
1746573324118,CGS 112,A00,887047,Cuong; Marisol,12,0,15,3
1746573325145,CGS 113,A00,887048,Staff,23,0,30,7
1746573326170,CGS 120,A00,887049,Staff,10,0,17,7
1746573327200,CHEM 6A,A01,886336,Lam; Tin Yiu,38,0,50,12
1746573327200,CHEM 6A,A02,886338,Lam; Tin Yiu,37,0,50,13
1746573328225,CHEM 6B,A01,886341,Hopkins; Patrycja Anna,16,0,50,34
1746573328225,CHEM 6B,A02,886343,Hopkins; Patrycja Anna,42,0,50,8
1746573329254,CHEM 6C,A01,886346,Albizati; Kim F.,0,2,50,50
1746573329254,CHEM 6C,A02,886348,Albizati; Kim F.,23,0,50,27
1746573330297,CHEM 40A,A01,886352,Klosterman; Jeremy K,65,0,100,35
1746573331324,CHEM 40B,A01,886356,Klosterman; Jeremy K,0,23,100,100
1746573332351,CHEM 41B,A01,886360,Theodorakis; Emmanuel,25,0,50,25
1746573332351,CHEM 41B,A02,886362,Theodorakis; Emmanuel,47,0,50,3
1746573333380,CHIN 165A,A00,886382,Xu; Li,18,0,20,2
1746573334406,CLAS 120,A00,886387,Myerston Santana; Jacobo,33,0,40,7
1746573335437,COGS 9,A01,886967,Shannon; Kyle Michael,42,0,60,18
1746573336464,COGS 11,A01,886969,Staff,10,0,30,20
1746573337495,COGS 14A,A01,886971,Staff,6,0,60,54
1746573338526,COGS 14B,A01,886973,Hoffman; Drew Ellen,4,0,60,56
1746573339556,COGS 18,A01,886975,Morgan; Eric,35,0,60,25
1746573340583,COGS 20,A01,886977,Staff,4,0,8,4
1746573340583,COGS 20,A02,886978,Staff,5,0,7,2
1746573341613,COGS 100,A01,907783,Staff,1,2,30,29
1746573342643,COGS 101B,A01,886980,Staff,0,3,48,48
1746573343671,COGS 101C,A01,886982,Delgado; Tania,0,5,44,44
1746573344698,COGS 102A,A01,886984,Johnson; Christine M.,4,0,30,26
1746573345728,COGS 118B,A01,886986,Staff,1,3,88,87
1746573346758,COGS 150,A01,886988,Bergen; Benjamin,22,0,50,28
1746573347784,COGS 153,A00,886989,Delgado; Tania,0,2,41,41
1746573348809,COGS 186,A01,886991,Staff,0,0,32,32
1746573349834,COGS 187A,A01,886993,Boyle; Mary E. T.,7,0,30,23
1746573350860,COGS 189,A00,886994,Staff,0,1,30,30
1746573351890,COMM 10,A01,886996,Staff,0,0,20,21
1746573351890,COMM 10,A02,886997,Staff,11,0,20,9
1746573351890,COMM 10,A03,959845,Staff,19,0,20,1
1746573352919,COMM 20,A01,886999,Leuning; Grant Maurstad,24,0,40,16
1746573354983,COMM 100A,A01,887002,Staff,0,0,20,25
1746573354983,COMM 100A,A02,887003,Staff,6,0,20,14
1746573356008,COMM 100B,A01,887005,Staff,0,8,20,24
1746573357037,COMM 106D,A00,887006,Staff,13,0,40,27
1746573358064,COMM 110G,A00,887007,Whitworth-Smith; Andrew C,12,0,40,28
1746573359137,COMM 111B,A00,887008,Staff,31,0,40,9
1746573360169,COMM 113T,A00,887009,Abuelhiga; Soraya Jill,28,0,40,12
1746573360169,COMM 113T,B00,906733,Staff,40,0,40,0
1746573361195,COMM 145,A00,887010,Staff,12,0,40,28
1746573362224,COMM 146,A00,887054,Staff,31,0,40,9
1746573363254,COMM 190,A00,887012,Staff,8,0,23,15
1746573364279,CSE 8A,A50,887015,Cao; Yingjun,57,0,85,28
1746573365308,CSE 11,A01,887017,Cao; Yingjun,12,0,70,58
1746573366335,CSE 20,A01,887019,Staff,30,0,50,20
1746573367365,CSE 21,A01,887021,Staff,78,0,100,22
1746573367365,CSE 21,B01,892583,Braun; Oliver,45,0,50,5
1746573368391,CSE 30,A01,887025,Eldon; John,143,0,200,57
1746573369417,CSE 100,A01,887027,Staff,26,0,50,24
1746573369417,CSE 100,A02,887028,Staff,42,0,50,8
1746573370449,CSE 101,A01,887030,Braun; Oliver,74,0,100,26
1746573370449,CSE 101,B01,887032,Jones; Miles E,0,3,50,50
1746573370449,CSE 101,B02,887033,Jones; Miles E,0,2,50,50
1746573371479,CSE 105,A01,908084,Jones; Miles E,32,0,50,18
1746573371479,CSE 105,A02,908087,Jones; Miles E,31,0,50,19
1746573372508,CSE 135,A01,887035,Powell; Thomas Allan,0,5,50,50
1746573373536,CSE 142,A01,887037,Staff,8,0,60,52
1746573374562,CSE 142L,A01,887039,Staff,34,0,60,26
1746573375587,CSE 151A,A01,887041,Solares; Edwin A,47,0,100,53
1746573376617,CSE 175,A01,887043,Kumar; Rakesh,30,0,30,0
1746573377643,CSS 1,A01,886389,Staff,1,1,40,39
1746573378674,DSC 30,A01,908097,Liao; Soohyun Nam,47,0,75,28
1746573379702,DSC 40A,A01,908099,Shannon; Kyle Michael,30,0,50,20
1746573380729,DSC 40B,A01,908112,Staff,15,0,50,35
1746573381754,DSC 80,A01,908116,Staff,19,0,60,41
1746573382784,DSC 197,001,956863,Eldridge; Justin Matthew,9999,0,9999,0
1746573383811,ECE 5,A01,886400,Morris; Karcher William,1,0,6,5
1746573383811,ECE 5,A02,886401,Morris; Karcher William,3,0,6,3
1746573384837,ECE 148,A01,886403,Silberman; Jack,0,14,14,14
1746573385868,ECON 1,A01,887265,Crane; Meredith Helen,12,0,70,58
1746573385868,ECON 1,B01,887268,Staff,42,0,50,8
1746573386899,ECON 2,A01,887273,Crane; Meredith Helen,55,0,70,15
1746573387930,ECON 3,A01,887279,Rondina; Giacomo,32,0,70,38
1746573388955,ECON 4,A01,887282,Anderson; John Charles,0,2,10,10
1746573389982,ECON 5,A01,887285,Staff,34,0,45,11
1746573389982,ECON 5,B01,887292,Staff,41,0,45,4
1746573391014,ECON 100A,A01,887337,Newhouse; Herbert S,54,0,70,16
1746573391014,ECON 100A,B01,887349,Staff,45,0,50,5
1746573392043,ECON 100B,A01,887361,Du; Songzi,29,0,70,41
1746573393073,ECON 100C,A01,887445,Newhouse; Herbert S,59,0,70,11
1746573394102,ECON 105,A00,887488,Vespa; Emanuel Ignacio,23,0,35,12
1746573395140,ECON 109,A01,887506,Shishkin; Denis,28,0,35,7
1746573396165,ECON 110A,A01,887568,Alon; Titan Michael,0,3,35,35
1746573396165,ECON 110A,B01,907601,Alon; Titan Michael,20,0,35,15
1746573397191,ECON 110B,A01,887598,Levkoff; Steven B.,0,24,70,70
1746573398222,ECON 112,A00,887599,Rondina; Giacomo,19,0,35,16
1746573399248,ECON 120A,A01,887603,Dai; Yinlin,35,0,70,35
1746573400278,ECON 120C,A01,887608,Sun; Yixiao,0,1,35,35
1746573400278,ECON 120C,B01,887614,Sun; Yixiao,0,0,35,35
1746573401307,ECON 138,A00,887621,Bharadwaj; Prashant,0,21,20,20
1746573402333,ECON 144,A00,958007,Squires; Dale E,12,0,35,23
1746573403358,ECON 171,A01,907666,Staff,18,0,35,17
1746573404384,ECON 175,A00,887626,Wu; Pak Yeung,22,0,35,13
1746573405412,ECON 190,A00,887640,Vespa; Emanuel Ignacio,22,0,35,13
1746573406448,EDS 25,A01,888197,Staff,0,0,0,0
1746573406448,EDS 25,A02,888209,Staff,0,0,0,0
1746573406448,EDS 25,A03,888210,Staff,0,0,0,0
1746573406448,EDS 25,A04,888212,Staff,0,0,0,0
1746573406448,EDS 25,A05,888213,Staff,0,0,0,0
1746573406448,EDS 25,A06,888214,Staff,0,0,0,0
1746573406448,EDS 25,A07,888235,Staff,0,2,0,0
1746573406448,EDS 25,A08,888236,Staff,0,0,0,0
1746573406448,EDS 25,A09,888240,Staff,0,0,0,0
1746573406448,EDS 25,A10,888244,Staff,0,0,0,0
1746573406448,EDS 25,B01,888273,Staff,0,0,0,0
1746573406448,EDS 25,B02,888285,Staff,0,0,0,0
1746573406448,EDS 25,B03,888423,Staff,0,0,0,1
1746573406448,EDS 25,B04,888432,Staff,0,0,0,0
1746573406448,EDS 25,B05,888433,Staff,0,0,0,0
1746573406448,EDS 25,B06,888467,Staff,0,0,0,0
1746573406448,EDS 25,B07,888468,Staff,0,0,0,0
1746573406448,EDS 25,B08,888479,Staff,0,0,0,0
1746573406448,EDS 25,B09,888484,Staff,0,0,0,0
1746573406448,EDS 25,B10,888487,Staff,0,0,0,0
1746573407474,EDS 38,A01,907700,Choi; Bailey Miyeon,30,0,30,0
1746573408501,EDS 112,A01,888601,Chapman; Thandeka K,12,0,40,28
1746573409531,EDS 115,A00,888697,Mendez; Kathrina Mendoza,10,0,30,20
1746573410562,EDS 116,A01,888893,Staff,34,0,40,6
1746573412617,EDS 124AR,A00,889133,Staff,29,0,50,21
1746573412617,EDS 124AR,B00,907471,Simon; Elizabeth A,37,0,50,13
1746573413646,EDS 124BR,A00,889134,Simon; Elizabeth A,44,0,100,56
1746573414671,EDS 125,A00,889135,Staff,25,0,30,5
1746573415697,EDS 126,A01,889138,Staff,35,0,40,5
1746573416726,EDS 164R,A01,889142,Wishard Guerra; Alison G.,33,0,50,17
1746573417752,ENG 30,A01,886396,Staff,0,0,0,0
1746573417752,ENG 30,B01,886398,Staff,0,0,0,0
1746573418782,ENVR 102,A00,906150,Montejo; Carolina,23,0,25,2
1746573419807,ETHN 103A,A00,887236,Man; Simeon S,0,3,0,0
1746573420833,ETHN 113,A00,887239,Staff,16,0,30,14
1746573421863,ETHN 116,A00,887240,Staff,16,0,25,9
1746573422889,ETHN 117,A00,887241,Choi; Esther Min,28,0,30,2
1746573423917,ETHN 118,A00,887243,Staff,24,0,30,6
1746573424942,ETHN 127,A00,887248,Cuong; Marisol,11,0,15,4
1746573425968,ETHN 139,A00,887250,Staff,7,0,10,3
1746573426996,ETHN 142,A00,887252,Staff,10,0,30,20
1746573428022,ETHN 161,A00,887253,Browne; Errol Tsekani,24,0,30,6
1746573429052,ETHN 163FR,A00,887255,Burelle; Julie Sara Veronique,0,0,5,5
1746573430080,GLBH 20,A00,889149,Elwardani; Nile Regina,8,0,42,34
1746573432135,GLBH 111,A01,889152,Burgos; Jose L.,17,0,17,0
1746573433163,GLBH 150,A00,889181,Sloane; Julia Kathryn,0,5,15,15
1746573435221,HDS 60,A01,886406,Warstadt; Melissa Fawn,73,0,80,7
1746573436249,HIAF 111,A00,889324,Gyamfi; Bright,25,0,32,7
1746573437330,HIEA 131,A00,889328,Staff,15,0,32,17
1746573438353,HIEA 144,A00,889333,Henry; Todd A.,26,0,32,6
1746573439378,HIEA 154,A00,889336,Henry; Todd A.,24,0,32,8
1746573440404,HIEU 106,A00,889339,Staff,22,0,32,10
1746573442458,HIEU 114,A00,889340,Staff,4,0,32,28
1746573443483,HIEU 135GS,A00,889342,Patterson; Patrick H.,0,0,1,24
1746573444508,HIEU 137,A00,889343,Edington; Claire Ellen,10,0,25,15
1746573445536,HIEU 148,A00,889345,Staff,14,0,32,18
1746573446563,HIEU 154,A00,889346,Biess; Frank Peter,21,0,32,11
1746573447590,HILA 102,A00,889351,Staff,12,0,32,20
1746573448616,HILD 2A,A01,889221,Lewandoski; Julia Mavis,1,10,32,31
1746573449642,HILD 7B,A01,889225,Man; Simeon S,0,12,32,32
1746573450727,HILD 7C,A01,889288,Alvarez; Luis A,0,14,32,32
1746573451751,HILD 30,A01,889323,Staff,0,5,32,32
1746573453803,HISC 119,A00,889383,Golan; Tal,19,0,32,13
1746573454828,HIUS 103,A00,889384,Man; Simeon S,0,0,32,32
1746573455851,HIUS 117,A00,919797,Kwak; Nancy,19,0,32,13
1746573456876,HIUS 142A,A00,919788,Staff,22,0,32,10
1746573458928,HIUS 149,A00,889386,Gyamfi; Bright,26,0,32,6
1746573459954,HIUS 155,A00,889387,Alvarez; Luis A,15,0,32,17
1746573460979,HUM 3,A01,886499,Caldwell; Michael Alan,19,0,50,31
1746573462003,HUM 3GS,A00,886500,Rodriguez; Bretton Sigfred,0,0,0,28
1746573463029,HUM 3R,A01,886502,Markman; Kristina,0,36,50,50
1746573464060,HUM 4,A01,886504,Crum; Matthew Stephen,23,0,50,27
1746573464060,HUM 4,B01,886506,West; Geoffrey Scott,17,0,50,33
1746573465084,HUM 4GS,A00,886507,Staff,0,0,0,19
1746573466113,HUM 5,A01,886509,Staff,32,0,50,18
1746573467140,HUM 5R,A01,886511,Zavodny; Tatiana Sophia,0,39,50,50
1746573468165,JAPN 180,A00,886407,Staff,16,0,40,24
1746573469195,LATI 50,A01,886409,Martin-Cabrera; Luis,4,0,22,18
1746573469195,LATI 50,A02,886410,Martin-Cabrera; Luis,19,0,22,3
1746573469195,LATI 50,A03,886411,Martin-Cabrera; Luis,21,0,22,1
1746573469195,LATI 50,A04,886412,Martin-Cabrera; Luis,9,0,22,13
1746573470223,LAWS 101,A00,907664,Staff,28,0,60,32
1746573471250,LIAB 1A,A00,889388,Saab; Dima,17,0,20,3
1746573472277,LIAB 1AX,A00,889389,El Cheddadi; Youniss,18,0,20,2
1746573473302,LIFR 1C,A00,889391,Van Moer; Vinciane G,8,0,20,12
1746573474329,LIFR 1CX,A00,889392,Van Moer; Vinciane G,7,0,20,13
1746573475353,LIFR 1D,A00,889393,Van Moer; Vinciane G,7,0,20,13
1746573476378,LIFR 1DX,A00,889394,Van Moer; Vinciane G,8,0,20,12
1746573477405,LIGN 7,A00,886923,Staff,24,0,50,26
1746573478432,LIGN 17,A00,886924,Kehler; Andrew Scott,125,0,150,25
1746573479460,LTAM 110,A00,889395,Staff,15,0,30,15
1746573480485,LTAM 110GS,A00,958010,Rodriguez; Bretton Sigfred,0,0,0,28
1746573481512,LTCH 101,A00,889397,Staff,23,0,25,2
1746573482538,LTCS 130,A00,889398,Staff,23,0,25,2
1746573483564,LTEA 138,A00,889399,Staff,24,0,40,16
1746573484594,LTEN 149,A00,889400,Wesling; Megan E.,0,3,25,25
1746573485622,LTEN 169,A00,889401,Staff,20,0,25,5
1746573486646,LTEN 180,A00,889402,Staff,10,0,15,5
1746573487672,LTEN 181,A00,889403,Staff,21,0,25,4
1746573488696,LTWL 100,A00,889404,Myerston Santana; Jacobo,2,0,25,23
1746573489720,LTWL 180GS,A00,889405,Staff,0,0,20,20
1746573490744,LTWL 181,A00,889406,Staff,16,0,25,9
1746573491774,LTWL 184,A00,889475,Mukherjee; Silpa,22,0,25,3
1746573492803,LTWR 102C,A00,889486,Staff,29,0,30,1
1746573493831,LTWR 115W,A00,889491,Staff,0,2,15,15
1746573494862,MAE 8,A01,886905,Staff,0,2,0,0
1746573495886,MAE 11,A00,886906,Bandaru; Prabhakar,0,7,50,50
1746573496910,MAE 20,A00,886907,Evdokimenko; Ekaterina,43,0,70,27
1746573497935,MAE 30B,A00,886909,Ghazinejad; Maziar,26,0,45,19
1746573498963,MAE 101B,A00,886910,Saintillan; David,29,0,45,16
1746573499990,MAE 105,A00,886911,Bandaru; Prabhakar,18,0,50,32
1746573501016,MAE 107,B00,958024,Staff,8,0,50,42
1746573502040,MAE 143B,A00,886913,Bewley; Thomas R,4,0,40,36
1746573503068,MAE 148,A01,886915,Silberman; Jack,0,3,14,14
1746573504097,MAE 160,A00,886916,Evdokimenko; Ekaterina,31,0,60,29
1746573505123,MATH 3C,A01,889681,Staff,0,2,30,30
1746573505123,MATH 3C,A02,960048,Staff,24,0,30,6
1746573506147,MATH 10A,A01,889760,Staff,26,0,30,4
1746573506147,MATH 10A,A02,889783,Staff,29,0,30,1
1746573507178,MATH 10B,A01,889785,Verstraete; Jacques Allan,2,0,35,33
1746573507178,MATH 10B,A02,889795,Verstraete; Jacques Allan,4,0,35,31
1746573507178,MATH 10B,B01,889797,Verstraete; Jacques Allan,3,0,35,32
1746573507178,MATH 10B,B02,889828,Verstraete; Jacques Allan,3,0,35,32
1746573508204,MATH 10C,A01,889849,Habib; Yousaf,7,0,30,23
1746573508204,MATH 10C,A02,889852,Habib; Yousaf,14,0,30,16
1746573508204,MATH 10C,A03,889853,Habib; Yousaf,22,0,30,8
1746573508204,MATH 10C,A04,889858,Habib; Yousaf,20,0,30,10
1746573508204,MATH 10C,B01,889861,Staff,1,0,30,29
1746573508204,MATH 10C,B02,889862,Staff,24,0,30,6
1746573508204,MATH 10C,B03,889863,Staff,27,0,30,3
1746573508204,MATH 10C,B04,889967,Staff,23,0,30,7
1746573509236,MATH 18,A01,889974,Staff,7,0,30,23
1746573509236,MATH 18,A02,889977,Staff,20,0,30,10
1746573509236,MATH 18,B01,889984,Hardiman; Liam,21,0,30,9
1746573509236,MATH 18,B02,889985,Hardiman; Liam,25,0,30,5
1746573510261,MATH 20A,A01,889990,Suk; Andrew Hoon,30,0,35,5
1746573511290,MATH 20B,A01,889993,Ohm; Ko Woon,22,0,30,8
1746573511290,MATH 20B,A02,889994,Ohm; Ko Woon,30,0,30,0
1746573511290,MATH 20B,B01,889996,Ohm; Ko Woon,22,0,30,8
1746573511290,MATH 20B,B02,889997,Ohm; Ko Woon,23,0,30,7
1746573512316,MATH 20C,A01,889999,Hammock; Frances H,17,0,30,13
1746573512316,MATH 20C,A02,890003,Hammock; Frances H,23,0,30,7
1746573512316,MATH 20C,B01,890006,Hammock; Frances H,3,0,30,27
1746573512316,MATH 20C,B02,890007,Hammock; Frances H,12,0,30,18
1746573513346,MATH 20D,A01,890011,Cheng; Hsiao-Bing,1,1,30,29
1746573513346,MATH 20D,A02,890012,Cheng; Hsiao-Bing,14,0,30,16
1746573513346,MATH 20D,B01,890016,Cheng; Hsiao-Bing,13,0,30,17
1746573513346,MATH 20D,B02,890017,Cheng; Hsiao-Bing,13,0,30,17
1746573514371,MATH 20E,A01,890026,Harel; Guershon,1,0,30,29
1746573514371,MATH 20E,A02,890029,Harel; Guershon,23,0,30,7
1746573514371,MATH 20E,B01,890033,Harel; Guershon,7,0,30,23
1746573514371,MATH 20E,B02,890101,Harel; Guershon,21,0,30,9
1746573515397,MATH 102,A01,890104,Staff,17,0,30,13
1746573515397,MATH 102,A02,890105,Staff,27,0,30,3
1746573516422,MATH 103B,A01,890116,Salehi Golsefidy; Alireza,3,0,30,27
1746573516422,MATH 103B,B01,890118,Staff,0,3,34,34
1746573517451,MATH 109,A01,890121,Aliabadi Sr.; Mohsen,1,0,30,29
1746573517451,MATH 109,B01,890124,Upadrashta; Pranav Kumar,18,0,30,12
1746573518476,MATH 120A,A01,890126,Eggers; John Dietrich,13,0,30,17
1746573519501,MATH 142B,A01,890128,Ioana; Adrian,19,0,30,11
1746573519501,MATH 142B,A02,890129,Ioana; Adrian,13,0,30,17
1746573520525,MATH 154,A01,890174,Staff,0,0,30,30
1746573520525,MATH 154,A02,890182,Staff,0,0,30,30
1746573521554,MATH 168A,A01,890197,Dumitriu; Ioana,21,0,35,14
1746573522579,MATH 170A,A01,890240,Nie; Jiawang,1,0,30,29
1746573522579,MATH 170A,A02,890241,Nie; Jiawang,11,0,30,19
1746573522579,MATH 170A,A03,890249,Nie; Jiawang,23,0,30,7
1746573523605,MATH 170B,A01,957891,Nag; Panchali,13,0,35,22
1746573525661,MATH 181A,A01,908025,Staff,0,3,35,35
1746573525661,MATH 181A,A02,960115,Staff,26,0,35,9
1746573526687,MATH 181B,A01,959874,Staff,25,0,30,5
1746573527720,MATH 193B,A01,890265,Staff,0,4,35,35
1746573528745,MGT 4,A01,890311,Anderson; John Charles,42,0,88,46
1746573529774,MGT 5,A00,907740,Staff,13,0,98,85
1746573530803,MGT 12,A00,890312,Lindenberger; Wade Douglas,67,0,98,31
1746573531827,MGT 16,A00,957883,Staff,78,0,98,20
1746573533879,MGT 45,A00,890314,Pecore; Joseph P.,46,0,98,52
1746573534903,MGT 71,A00,890315,Staff,0,11,98,98
1746573535927,MGT 100,A00,890316,Yavorsky; Daniel Ryan,44,0,98,54
1746573536952,MGT 103,A00,890317,Ehrich; Kristine R,73,0,98,25
1746573537977,MGT 105,A00,890356,Bates; Kenneth Walter,0,8,98,98
1746573539001,MGT 112,A00,890360,Ehrich; Kristine R,55,0,98,43
1746573540028,MGT 127R,A00,907732,Zhu; Kevin Xiaoguo,23,0,98,75
1746573541053,MGT 131B,A00,890361,Anderson; John Charles,60,0,98,38
1746573542082,MGT 137,A00,890362,Lindenberger; Wade Douglas,65,0,98,33
1746573543114,MGT 160,A00,890369,Johnson; Erik Barry,9,0,98,89
1746573545171,MGT 164,A00,890372,Zimmermann; Carsten,0,40,98,98
1746573546195,MGT 180,A00,890374,Bliss; Barbara Ann,12,0,98,86
1746573547222,MMW 15,A01,886414,Chang; Edmond Yi-Teh,0,12,28,28
1746573547222,MMW 15,A02,886415,Chang; Edmond Yi-Teh,0,8,28,28
1746573547222,MMW 15,A03,886416,Chang; Edmond Yi-Teh,0,9,28,28
1746573547222,MMW 15,A04,886417,Chang; Edmond Yi-Teh,0,8,28,28
1746573547222,MMW 15,B01,886419,Chang; Edmond Yi-Teh,0,7,28,28
1746573547222,MMW 15,B02,886420,Chang; Edmond Yi-Teh,0,8,28,28
1746573547222,MMW 15,B03,886421,Chang; Edmond Yi-Teh,0,7,28,28
1746573547222,MMW 15,B04,886422,Chang; Edmond Yi-Teh,0,8,28,28
1746573547222,MMW 15,C01,886424,Staff,0,9,28,28
1746573547222,MMW 15,C02,886425,Staff,0,8,28,28
1746573547222,MMW 15,C03,886426,Staff,0,8,28,28
1746573547222,MMW 15,C04,886427,Staff,0,8,28,28
1746573547222,MMW 15,C05,958038,Staff,0,8,28,28
1746573547222,MMW 15,C06,958039,Staff,1,8,28,27
1746573548248,MMW 15GS,A00,906910,Patterson; Patrick H.,4,0,28,24
1746573549275,MMW 122R,A01,886429,Rahimi; Babak,0,13,28,28
1746573549275,MMW 122R,A02,886430,Rahimi; Babak,0,12,28,28
1746573549275,MMW 122R,A03,958040,Rahimi; Babak,0,11,28,28
1746573550300,MUS 1A,A01,890937,Staff,2,0,25,23
1746573550300,MUS 1A,A02,891035,Staff,6,0,25,19
1746573550300,MUS 1A,C01,958912,Staff,24,0,25,1
1746573550300,MUS 1A,C02,958913,Staff,25,0,25,0
1746573552354,MUS 2AK,A00,957092,Ohnishi; Takae,15,0,15,0
1746573553379,MUS 4,A01,891044,Staff,1,0,25,24
1746573553379,MUS 4,A02,891045,Staff,23,0,25,2
1746573553379,MUS 4,B01,891048,Staff,17,0,25,8
1746573553379,MUS 4,B02,891050,Staff,25,0,25,0
1746573554409,MUS 5,A01,957506,Dubnov; Shlomo,0,0,25,25
1746573554409,MUS 5,A02,957622,Dubnov; Shlomo,13,0,25,12
1746573554409,MUS 5,A03,957623,Dubnov; Shlomo,20,0,25,5
1746573555437,MUS 6,A01,891053,Freitas Caetano; Marcelo,24,0,25,1
1746573555437,MUS 6,A02,891054,Freitas Caetano; Marcelo,23,0,25,2
1746573556462,MUS 7,A01,891081,Staff,1,0,25,24
1746573556462,MUS 7,A02,891082,Staff,3,0,25,22
1746573557489,MUS 8GS,A00,891118,Borgo; David Garcia,1,0,25,24
1746573558517,MUS 11,A01,891140,Staff,9,0,25,16
1746573558517,MUS 11,A02,891141,Staff,22,0,25,3
1746573559543,MUS 13,A01,891143,Staff,8,0,25,17
1746573559543,MUS 13,A02,891144,Staff,24,0,25,1
1746573560569,MUS 15,A01,891146,Staff,9,0,25,16
1746573560569,MUS 15,A02,891148,Staff,21,0,25,4
1746573560569,MUS 15,B01,891150,Staff,18,0,25,7
1746573560569,MUS 15,B02,891151,Staff,25,0,25,0
1746573561598,MUS 20,A01,891153,Staff,5,0,20,15
1746573561598,MUS 20,A02,891155,Staff,14,0,20,6
1746573562622,MUS 80,A00,891156,Staff,19,0,25,6
1746573562622,MUS 80,B00,891157,Staff,23,0,25,2
1746573563645,MUS 130,A00,891158,Ohnishi; Takae,35,0,35,0
1746573564677,MUS 150GS,A01,891160,Borgo; David Garcia,1,0,25,24
1746573565703,MUS 170,A01,891162,Freitas Caetano; Marcelo,20,0,25,5
1746573565703,MUS 170,A02,891164,Freitas Caetano; Marcelo,21,0,25,4
1746573566732,NANO 11,A00,886220,Vazquez Mena; Oscar,13,0,15,2
1746573567760,NANO 15,A01,886222,Drews; Aaron,4,0,7,3
1746573568785,NANO 104,A00,886224,Sirbuly; Donald,17,0,25,8
1746573569808,PH 40,A00,886528,Staff,24,0,40,16
1746573570836,PH 45,A01,886799,Staff,35,0,40,5
1746573571860,PH 110,A00,886802,Staff,0,7,40,40
1746573572889,PH 172,A00,906716,Staff,19,0,35,16
1746573573915,PH 191,A00,886803,Staff,6,0,40,34
1746573574940,PHIL 1,A00,889500,Staff,20,0,30,10
1746573575966,PHIL 10,A01,889549,Grush; Rick Scott,16,0,22,6
1746573575966,PHIL 10,A02,889551,Grush; Rick Scott,22,0,22,0
1746573576991,PHIL 28,A01,889559,Lamey; Andy M.,0,2,31,31
1746573576991,PHIL 28,A02,889561,Lamey; Andy M.,0,1,30,30
1746573576991,PHIL 28,A03,889572,Lamey; Andy M.,0,1,30,30
1746573578020,PHIL 35,A00,907839,Staff,13,0,15,2
1746573579044,PHIL 60,A00,889574,Staff,73,0,90,17
1746573580073,PHIL 101,A00,958004,Staff,12,0,15,3
1746573582130,PHIL 136,A00,889582,Fulkerson; Matthew Todd,26,0,45,19
1746573583154,PHIL 163,A01,889601,Staff,21,0,30,9
1746573583154,PHIL 163,B01,889606,Brandt; Reuven A,0,3,0,0
1746573584179,PHIL 164,A00,889610,Staff,16,0,30,14
1746573585208,PHIL 165,A00,889613,Staff,22,0,30,8
1746573586232,PHYS 1A,A00,886431,Staff,26,0,70,44
1746573587257,PHYS 1AL,001,886432,Tsai; Philbert S,0,2,30,30
1746573587257,PHYS 1AL,002,886436,Tsai; Philbert S,11,0,30,19
1746573588282,PHYS 1B,A00,886439,Staff,185,0,240,55
1746573589310,PHYS 1BL,001,886441,Tsai; Philbert S,0,4,30,30
1746573589310,PHYS 1BL,002,886444,Tsai; Philbert S,2,0,30,28
1746573590336,PHYS 1C,A00,896092,Arnold; Kam S,78,0,146,68
1746573591361,PHYS 1CL,001,886448,Tsai; Philbert S,0,0,30,30
1746573591361,PHYS 1CL,002,886449,Tsai; Philbert S,1,0,30,29
1746573591361,PHYS 1CL,003,886450,Tsai; Philbert S,16,0,30,14
1746573591361,PHYS 1CL,004,886451,Tsai; Philbert S,15,0,30,15
1746573592394,PHYS 2B,A01,886457,Staff,68,0,115,47
1746573593423,PHYS 2C,A01,886460,Shotwell; Brian,0,9,65,65
1746573594453,PHYS 2CL,A01,886467,Staff,0,4,28,28
1746573594453,PHYS 2CL,A02,886468,Staff,0,3,28,28
1746573595482,PHYS 2D,A01,886470,Staff,10,0,50,40
1746573596507,PHYS 4B,A01,886475,Grinstein; Benjamin,22,0,40,18
1746573597535,POLI 5,A00,891173,Desposato; Scott,7,0,25,18
1746573598561,POLI 5D,A01,891175,Staff,5,0,5,0
1746573598561,POLI 5D,B01,891178,Staff,5,0,5,0
1746573599585,POLI 11,A00,891179,Ferree; Karen E,2,0,35,33
1746573600615,POLI 12,A00,891180,Staff,16,0,30,14
1746573601640,POLI 27,A01,891182,Staff,12,0,75,63
1746573602668,POLI 30,A00,891183,Staff,8,0,50,42
1746573603692,POLI 100B,A00,891244,Staff,5,1,35,30
1746573604721,POLI 100I,A00,891247,Staff,7,0,30,23
1746573605748,POLI 104J,A00,891248,Nichter; Maysa,14,0,30,16
1746573606786,POLI 104U,A00,891250,Nichter; Maysa,2,0,30,28
1746573608837,POLI 110B,A00,891255,Wiens; David,19,0,25,6
1746573609868,POLI 112A,A00,891256,Wiens; David,6,0,25,19
1746573610896,POLI 114BR,A00,891261,Staff,19,0,30,11
1746573611922,POLI 117R,A00,891262,Forman; Fonna,0,6,50,50
1746573612952,POLI 118,A00,891264,Ingham; Sean,17,0,25,8
1746573613982,POLI 124A,A00,891265,Staff,18,0,20,2
1746573615011,POLI 125D,A00,891266,Nichter; Simeon C,2,0,25,23
1746573616040,POLI 126,A00,891268,Nichter; Simeon C,7,0,25,18
1746573617064,POLI 126AA,A00,891272,Staff,16,0,25,9
1746573618088,POLI 130AA,A00,891273,Staff,15,0,20,5
1746573619113,POLI 134AA,A00,891274,Staff,4,0,20,16
1746573621164,POLI 138,A00,891278,Staff,21,0,25,4
1746573622189,POLI 142K,A00,891280,Staff,10,0,25,15
1746573623217,POLI 142M,A00,891281,Gartzke; Erik,16,0,30,14
1746573624242,POLI 142P,A00,891284,Staff,20,0,30,10
1746573625268,POLI 143,A00,891285,Gartzke; Erik,12,0,30,18
1746573626295,POLI 153,A00,891286,Staff,19,0,20,1
1746573628343,POLI 175,A00,891290,Staff,15,0,20,5
1746573629371,PSYC 1,A00,890674,Steiner; Eric Tomas,0,11,45,45
1746573630394,PSYC 2,A00,890676,Albright; Thomas D,21,0,35,14
1746573631418,PSYC 3,A00,890679,Staff,17,0,20,3
1746573632445,PSYC 6,A00,959858,Staff,20,0,20,0
1746573633470,PSYC 60,A01,890684,Rickard; Timothy C.,0,5,45,45
1746573634494,PSYC 70,A01,890689,Geller; Emma Harlan,7,0,30,23
1746573635522,PSYC 71,A01,959860,Staff,21,0,25,4
1746573636549,PSYC 100,A00,890690,Lacefield; Katharine I,0,50,180,180
1746573637573,PSYC 102,A00,890695,Staff,18,0,40,22
1746573638599,PSYC 105,A00,890699,Geller; Emma Harlan,70,0,100,30
1746573639625,PSYC 106,A00,890701,Gorman; Michael R.,6,0,30,24
1746573640650,PSYC 108,A00,890704,Adrian; Julia Anna,0,28,50,50
1746573641675,PSYC 118,A01,890712,Staff,11,0,30,19
1746573642700,PSYC 124,A00,890716,Chapman; Eddie Nathaniel,25,0,60,35
1746573643724,PSYC 131,A00,890717,Anagnostaras; Stephan,0,8,80,80
1746573644749,PSYC 137,A00,890719,Winkielman; Piotr,0,11,30,30
1746573645773,PSYC 144,A00,890721,Adrian; Julia Anna,0,9,45,45
1746573646798,PSYC 162,A00,890805,Staff,0,0,75,75
1746573647822,PSYC 169,A00,890810,Staff,0,14,30,30
1746573648848,PSYC 172,A00,890814,Gorman; Michael R.,9,0,30,21
1746573649877,PSYC 181,A00,890818,Anagnostaras; Stephan,9,0,200,191
1746573650905,PSYC 184,A00,959861,Staff,168,0,175,7
1746573651933,PSYC 189,A00,890823,Staff,0,2,30,30
1746573652958,PSYC 191,A00,890884,Rickard; Timothy C.,0,12,35,35
1746573653984,PSYC 193,A00,890913,Staff,19,0,30,11
1746573653984,PSYC 193,B00,890914,Chapman; Eddie Nathaniel,24,0,30,6
1746573655010,PSYC 193L,A01,890918,Lowe; Angela Beth,20,0,30,10
1746573655010,PSYC 193L,B01,890921,Hurwitz; Ethan Scott,20,0,30,10
1746573655010,PSYC 193L,C01,890928,Staff,30,0,30,0
1746573656037,RELI 149,A00,886806,Rahimi; Babak,23,0,40,17
1746573657064,SE 9,A01,886814,Staff,7,0,20,13
1746573658093,SE 101B,A01,886816,Chadha; Mayank,4,0,35,31
1746573659123,SE 110B,A00,886818,Zhu; Qiang,4,0,75,71
1746573660171,SE 125,A01,886830,Staff,10,0,30,20
1746573661199,SE 130B,A01,886835,Staff,14,0,40,26
1746573662233,SE 131A,A01,886838,Krysl; Petr,34,0,55,21
1746573663262,SE 154,A00,886840,Staff,29,0,50,21
1746573664287,SE 164GS,A01,886849,Staff,6,0,20,14
1746573665311,SE 167GS,A01,886853,Staff,6,0,20,14
1746573666335,SIO 25,A01,890107,Staff,19,0,30,11
1746573667359,SIO 45,A00,890109,Cook; Geoffrey W,117,0,200,83
1746573668387,SIO 109R,A00,890110,Forman; Fonna,0,16,20,20
1746573669413,SIO 187,A01,890114,Kacev; David,15,0,40,25
1746573670442,SOCI 1,A01,890431,Thorpe; Charles Robert,14,0,30,16
1746573670442,SOCI 1,A02,890518,Thorpe; Charles Robert,30,0,30,0
1746573671467,SOCI 2,A01,957978,Staff,25,0,25,0
1746573671467,SOCI 2,A02,957979,Staff,23,0,25,2
1746573672494,SOCI 20,A01,890523,Calderon-Zaks; Michael Aar,21,0,30,9
1746573672494,SOCI 20,A02,890526,Calderon-Zaks; Michael Aar,29,0,30,1
1746573673522,SOCI 30,A01,890533,Pardo Guerra; Juan Pablo,37,0,40,3
1746573674547,SOCI 40,A01,890535,Staff,27,0,45,18
1746573675572,SOCI 104Q,A00,890559,Staff,18,0,30,12
1746573676601,SOCI 106,A00,890560,Arnal; Maud Marie Leonie,20,0,30,10
1746573677631,SOCI 110,A00,890567,Holkenbrink-Monk; Charlene,19,0,30,11
1746573678657,SOCI 112,A00,890568,Victoria Torres; Pablo,2,0,55,53
1746573679686,SOCI 115,A00,890597,Arnal; Maud Marie Leonie,28,0,45,17
1746573681741,SOCI 121,A00,890604,Pardo Guerra; Juan Pablo,38,0,45,7
1746573682766,SOCI 126,A01,890608,Staff,8,0,10,2
1746573683793,SOCI 127,A00,890609,Staff,18,0,30,12
1746573684821,SOCI 131,A00,890610,Thorpe; Charles Robert,37,0,45,8
1746573685849,SOCI 135,A00,890615,Payne; Christine Anna,13,0,45,32
1746573686876,SOCI 139,A00,890620,Staff,38,0,45,7
1746573687903,SOCI 148E,A00,890622,Calderon-Zaks; Michael Aar,36,0,45,9
1746573688927,SOCI 150,A00,890623,Kohler; Kristopher M.,31,0,45,14
1746573689950,SOCI 157,A00,890625,Jules-Rosette; Bennetta W.,18,0,20,2
1746573690974,SOCI 160,A00,890627,Payne; Christine Anna,21,0,45,24
1746573692005,SYN 1,A00,886855,Fish; Gwendolyn Anne,0,1,0,0
1746573692005,SYN 1,B00,906086,Fish; Gwendolyn Anne,0,2,0,2
1746573693030,SYN 2R,A00,886860,Staff,0,17,15,15
1746573693030,SYN 2R,B00,906106,Atkinson; Arthur Laird,0,16,15,15
1746573694055,SYN 100,A01,886866,Browne; Emily,0,28,20,20
1746573694055,SYN 100,B01,906128,Rock; Martin,0,5,20,20
1746573694055,SYN 100,C01,906140,Deavenport; James Cary,0,3,20,20
1746573694055,SYN 100,D01,907816,Deavenport; James Cary,0,5,20,20
1746573695079,TDAC 1,A00,890286,Walsh; Kim C.,8,0,20,12
1746573696102,TDAC 101,A00,890296,Basso; Beatrice,15,0,20,5
1746573697130,TDDE 131,A00,890297,Staff,47,0,50,3
1746573698157,TDDM 1,A00,890287,Weinberg; Sadie,25,0,30,5
1746573699181,TDGE 11,A00,890288,Fulton; Julia,138,0,200,62
1746573699181,TDGE 11,B00,890289,Castro; Robert Jess,184,0,200,16
1746573700208,TDGE 25,B00,957359,Walsh; Kim C.,5,0,20,15
1746573701233,TDGE 40,A01,890292,Power; Jade Yukana,27,0,30,3
1746573702260,TDGE 124,A00,890298,Havis; Allan,0,1,50,50
1746573703283,TDGE 131R,A00,890299,Burelle; Julie Sara Veronique,15,0,42,27
1746573704311,TDHT 101,A00,890300,Staff,10,0,20,10
1746573705336,TDHT 109,A01,890302,Anderson; Mysia Anyse,31,0,40,9
1746573706361,TDMV 1,A00,890293,Arcidiacono; Kristin,18,0,30,12
1746573707386,TDMV 2,A00,890294,Weinberg; Sadie,23,0,30,7
1746573708410,TDMV 3,A00,957878,Arcidiacono; Kristin,28,0,30,2
1746573710461,TDMV 138,A00,890304,Jun; Grace Shin Hae,25,0,40,15
1746573711500,TDMV 140,A00,890305,Corrales; Joseph Bernales,25,0,30,5
1746573712525,TDMV 142,A00,890307,Caligagan; Tony,32,0,40,8
1746573713553,TDMV 144,A00,890308,Camaya; Michelle Ann,25,0,30,5
1746573714583,TDPW 1,A00,890295,Stein; Deborah Isobel,2,0,20,18
1746573715608,USP 2,A01,890272,Lerner; Amy M,7,0,20,13
1746573716635,USP 3,A01,890274,Staff,12,0,30,18
1746573717660,USP 15,A01,890276,Sun; Feiyang,16,0,30,14
1746573718686,USP 25,A00,890277,Shenkman; Michael Thomas,18,0,25,7
1746573719710,USP 138,A00,890278,Staff,14,0,25,11
1746573720735,USP 143,A00,890279,Staff,22,0,70,48
1746573721763,USP 144,A00,890280,Chowdhury; Muhammed Zohir,16,0,30,14
1746573722789,USP 150,A00,890281,Boomhower; Matthew Charles,4,0,30,26
1746573723813,USP 151,A00,890282,Staff,16,0,20,4
1746573724837,USP 162,A00,890283,Andrews; Abigail Leslie,16,0,20,4
1746573725862,USP 168,A00,920477,Kwak; Nancy,0,0,5,5
1746573726886,USP 181,A00,890284,Staff,3,0,20,17
1746573727912,USP 191A,A00,890285,Staff,12,0,20,8
1746573728937,VIS 101,A00,886512,Staff,26,0,75,49
1746573729962,VIS 103,A00,886513,Cruz; Edwin Teddy,61,0,75,14
1746573730994,VIS 108,A00,886514,Staff,3,0,15,12
1746573732023,VIS 127P,A00,886515,Shen; Kuiyi,80,0,146,66
1746573733048,VIS 149,A00,886516,Yoldas; Pinar,0,0,15,15
1746573734074,VIS 164,A00,886526,Erdmann; Dean,19,0,22,3
1746573735099,VIS 194S,A00,886527,Staff,61,0,75,14
1746573736123,WCWP 10A,C00,886484,Martiniuk; Jill,12,0,15,3
1746573737149,WCWP 10B,A00,886490,Uriarte; Emma,0,0,15,15
1746573737149,WCWP 10B,B00,886491,Dhir; Simrita,9,0,15,6
1746573737149,WCWP 10B,C00,886492,Ornelas; Tricia,0,0,15,15
1746573738181,WCWP 100,A00,886494,Young; Mark T,0,6,15,15
1746573740292,AAS 10,A01,886199,Childs; Dennis R.,0,3,0,0
1746573741317,ANAR 104,A01,886940,Shtienberg; Gilad,27,0,30,3
1746573742344,ANAR 120,A00,886953,Staff,12,0,20,8
1746573743372,ANBI 148,A01,886955,Wilder; Linnea Lorene,30,0,40,10
1746573745421,ANSC 122,A00,886957,Staff,25,0,30,5
1746573746446,ANSC 150,A00,886958,Sloane; Julia Kathryn,2,0,15,13
1746573747474,ANSC 156,A00,886959,Jenkins; Janis A.,0,1,15,15
1746573748500,ANSC 180,A00,886960,Staff,11,0,17,6
1746573749525,ANSC 188,A00,886961,Jassal; Aftab,9,0,25,16
1746573750549,ANSC 190,A00,886962,Jassal; Aftab,14,0,25,11
1746573751575,ANSC 191,A00,886963,Staff,18,0,20,2
1746573752600,ANTH 3,A01,891689,Staff,17,0,20,3
1746573753624,ANTH 5,A00,886933,Semendeferi; Ekaterini,16,0,20,4
1746573754650,ANTH 10,A00,886934,Staff,0,12,30,30
1746573755678,ANTH 21,A01,886936,Staff,41,0,60,19
1746573756706,ANTH 23,A01,886938,Staff,92,0,100,8
1746573757735,ANTH 105,A00,886964,Stewart; Alexander B,84,0,100,16
1746573758759,ANTH 108,A00,886965,Pedersen; David,9,0,20,11
1746573759785,AWP 10,001,886147,Staff,0,0,0,0
1746573759785,AWP 10,002,886148,Staff,0,0,0,0
1746573759785,AWP 10,003,886149,Staff,0,0,0,0
1746573759785,AWP 10,004,886150,Staff,0,0,0,0
1746573759785,AWP 10,005,886151,Staff,0,0,0,0
1746573759785,AWP 10,006,886152,Staff,0,0,0,0
1746573759785,AWP 10,007,886153,Staff,0,0,0,0
1746573759785,AWP 10,008,886154,Staff,0,0,0,0
1746573759785,AWP 10,009,886155,Staff,0,0,0,0
1746573759785,AWP 10,010,886156,Staff,0,0,0,0
1746573759785,AWP 10,011,886158,Staff,0,0,0,0
1746573759785,AWP 10,012,886160,Staff,0,0,0,0
1746573759785,AWP 10,013,886161,Staff,0,0,0,0
1746573759785,AWP 10,014,886162,Staff,0,0,0,0
1746573759785,AWP 10,015,886163,Staff,0,0,0,0
1746573759785,AWP 10,016,886164,Staff,0,0,0,0
1746573759785,AWP 10,017,886165,Staff,0,0,0,0
1746573759785,AWP 10,018,886166,Staff,0,0,0,0
1746573759785,AWP 10,019,886168,Staff,0,0,0,0
1746573759785,AWP 10,020,886170,Staff,0,0,0,0
1746573759785,AWP 10,021,886172,Staff,0,0,0,0
1746573760812,AWP 10R,001,886173,Staff,0,1,0,0
1746573760812,AWP 10R,002,886174,Staff,0,1,0,0
1746573760812,AWP 10R,003,886175,Staff,0,0,0,0
1746573760812,AWP 10R,004,886176,Staff,0,0,0,0
1746573760812,AWP 10R,005,886177,Staff,0,0,0,0
1746573760812,AWP 10R,006,886178,Staff,0,0,0,0
1746573760812,AWP 10R,007,886179,Staff,0,0,0,0
1746573760812,AWP 10R,008,886181,Staff,0,0,0,0
1746573760812,AWP 10R,009,886182,Staff,0,0,0,0
1746573760812,AWP 10R,010,886183,Staff,0,0,0,0
1746573760812,AWP 10R,011,886184,Staff,0,0,0,0
1746573760812,AWP 10R,012,886185,Staff,0,0,0,0
1746573760812,AWP 10R,013,886186,Staff,0,0,0,0
1746573760812,AWP 10R,014,886187,Staff,0,0,0,0
1746573760812,AWP 10R,015,886188,Staff,0,0,0,0
1746573760812,AWP 10R,016,886189,Staff,0,0,0,0
1746573760812,AWP 10R,017,960532,Staff,0,0,0,0
1746573760812,AWP 10R,018,960533,Staff,0,0,0,0
1746573760812,AWP 10R,019,960534,Staff,0,0,0,0
1746573760812,AWP 10R,020,960538,Staff,0,0,0,0
1746573760812,AWP 10R,021,960540,Staff,0,0,0,0
1746573760812,AWP 10R,022,960541,Staff,0,0,0,0
1746573760812,AWP 10R,023,960542,Staff,0,0,0,0
1746573760812,AWP 10R,024,960544,Staff,0,0,0,0
1746573760812,AWP 10R,025,960545,Staff,0,0,0,0
1746573760812,AWP 10R,026,960548,Staff,0,0,0,0
1746573761837,AWP 102R,A00,886190,Staff,0,0,0,0
1746573761837,AWP 102R,B00,886191,Staff,0,0,0,0
1746573762866,BENG 100,A01,886193,Staff,17,0,30,13
1746573763891,BENG 122A,A01,886195,Hasty; Jeff M,13,0,30,17
1746573764915,BENG 166A,A00,886196,Sah; Robert Lie-Yuan,0,2,30,30
1746573765940,BENG 190,A00,958050,Khojah; Reem I,20,0,25,5
1746573766966,BIBC 102,A01,894320,Staff,0,0,46,46
1746573766966,BIBC 102,A02,894321,Staff,0,0,46,46
1746573766966,BIBC 102,A03,894344,Staff,7,0,46,39
1746573766966,BIBC 102,A04,894345,Staff,27,0,47,20
1746573767991,BICD 100R,A01,894365,Smith; Laurie,0,3,58,58
1746573767991,BICD 100R,A02,894366,Smith; Laurie,0,5,58,58
1746573767991,BICD 100R,A03,894367,Smith; Laurie,0,0,59,59
1746573767991,BICD 100R,A04,959869,Smith; Laurie,40,0,59,19
1746573769016,BICD 136,A01,894383,Gustafson-Brown; Cindy,14,0,50,36
1746573770042,BIEB 102,A01,894494,Butler; Shannon Rhey,51,0,130,79
1746573772097,BIEB 150,A01,894617,Wills; Christopher,3,0,20,17
1746573772097,BIEB 150,A02,894631,Wills; Christopher,3,0,20,17
1746573772097,BIEB 150,A03,894937,Wills; Christopher,3,0,20,17
1746573772097,BIEB 150,A04,894946,Wills; Christopher,5,0,20,15
1746573773120,BIEB 194,A00,906141,Kurle; Carolyn M.,6,0,20,14
1746573774148,BILD 1,A01,894154,Staff,3,0,19,16
1746573774148,BILD 1,A02,894155,Staff,14,0,19,5
1746573774148,BILD 1,A03,894160,Staff,13,0,19,6
1746573774148,BILD 1,A04,894161,Staff,15,0,18,3
1746573775172,BILD 2,A01,894168,Staff,0,0,50,50
1746573775172,BILD 2,A02,894169,Staff,0,0,50,50
1746573775172,BILD 2,A03,894179,Staff,0,0,50,50
1746573775172,BILD 2,A04,894203,Staff,24,0,50,26
1746573776196,BILD 3,A01,894213,Staff,23,0,31,8
1746573776196,BILD 3,A02,894214,Staff,26,0,31,5
1746573776196,BILD 3,A03,894235,Staff,28,0,31,3
1746573776196,BILD 3,A04,894236,Staff,28,0,32,4
1746573777224,BILD 4,A01,894253,Reuther; Keefe,5,0,24,19
1746573777224,BILD 4,A02,894258,Reuther; Keefe,16,0,24,8
1746573778249,BILD 5,A01,894276,Reuther; Keefe,35,0,50,15
1746573778249,BILD 5,A02,894277,Reuther; Keefe,45,0,50,5
1746573778249,BILD 5,A03,894290,Reuther; Keefe,44,0,50,6
1746573778249,BILD 5,A04,894291,Reuther; Keefe,48,0,50,2
1746573779273,BILD 24,A01,894297,Pirino; Giorgia,40,0,60,20
1746573780300,BIMM 100,B01,958915,Staff,71,0,100,29
1746573781330,BIMM 101,A01,895017,McDonnell; Lisa Marie,0,5,24,24
1746573781330,BIMM 101,A02,895018,McDonnell; Lisa Marie,0,5,24,24
1746573781330,BIMM 101,B01,895020,McDonnell; Lisa Marie,0,6,24,24
1746573781330,BIMM 101,B02,895021,McDonnell; Lisa Marie,0,4,24,24
1746573782358,BIMM 110,A01,895023,Staff,1,0,25,24
1746573782358,BIMM 110,A02,895024,Staff,9,0,25,16
1746573782358,BIMM 110,A03,895025,Staff,18,0,25,7
1746573782358,BIMM 110,A04,895031,Staff,20,0,25,5
1746573783385,BIMM 120,A01,895114,Gustafson-Brown; Cindy,14,0,28,14
1746573783385,BIMM 120,A02,895126,Gustafson-Brown; Cindy,21,0,27,6
1746573784412,BIPN 100,A01,895130,Yang; Mingyu,0,0,38,38
1746573784412,BIPN 100,A02,895131,Yang; Mingyu,32,0,38,6
1746573784412,BIPN 100,A03,895132,Yang; Mingyu,32,0,38,6
1746573784412,BIPN 100,A04,895133,Yang; Mingyu,27,0,36,9
1746573785441,BIPN 120,A01,895135,Cooke; James Edward,0,3,13,13
1746573785441,BIPN 120,A02,895136,Cooke; James Edward,0,1,13,13
1746573785441,BIPN 120,A03,895137,Cooke; James Edward,0,3,13,13
1746573785441,BIPN 120,A04,895156,Cooke; James Edward,0,2,11,11
1746573786467,BIPN 134,A01,895235,Cooke; James Edward,0,2,25,25
1746573786467,BIPN 134,A02,895237,Cooke; James Edward,0,0,25,25
1746573786467,BIPN 134,A03,895240,Cooke; James Edward,3,0,25,22
1746573786467,BIPN 134,A04,895270,Cooke; James Edward,20,0,25,5
1746573787492,BIPN 189,A00,892103,Staff,0,14,14,14
1746573789542,BISP 194,A00,958008,Staff,0,2,0,0
1746573790568,CAT 124,A01,922009,Staff,0,5,20,20
1746573791595,CAT 125R,A00,886390,Morales; Celeste Georgianna,0,2,20,20
1746573791595,CAT 125R,B00,886391,Irwin; Matthew Joseph,0,4,20,20
1746573791595,CAT 125R,C00,886392,Smith; Lauryn Alissa,0,2,20,20
1746573791595,CAT 125R,D00,886393,Vanderschuit; Maya Alysia,0,3,20,20
1746573791595,CAT 125R,E00,886394,Marchisotto; Jennifer Anne,0,3,20,20
1746573792625,CENG 15,A01,886218,Drews; Aaron,3,0,8,5
1746573793653,CENG 113,A00,886219,Opatkiewicz; Justin Paul,15,0,25,10
1746573794884,CGS 101,A00,887044,Staff,7,0,20,13
1746573795911,CGS 105,A01,887046,Staff,14,0,25,11
1746573796936,CGS 112,A00,887047,Cuong; Marisol,12,0,15,3
1746573797963,CGS 113,A00,887048,Staff,23,0,30,7
1746573798987,CGS 120,A00,887049,Staff,10,0,17,7
1746573800013,CHEM 6A,A01,886336,Lam; Tin Yiu,38,0,50,12
1746573800013,CHEM 6A,A02,886338,Lam; Tin Yiu,37,0,50,13
1746573801042,CHEM 6B,A01,886341,Hopkins; Patrycja Anna,16,0,50,34
1746573801042,CHEM 6B,A02,886343,Hopkins; Patrycja Anna,42,0,50,8
1746573802070,CHEM 6C,A01,886346,Albizati; Kim F.,0,2,50,50
1746573802070,CHEM 6C,A02,886348,Albizati; Kim F.,23,0,50,27
1746573803095,CHEM 40A,A01,886352,Klosterman; Jeremy K,65,0,100,35
1746573804124,CHEM 40B,A01,886356,Klosterman; Jeremy K,0,23,100,100
1746573805150,CHEM 41B,A01,886360,Theodorakis; Emmanuel,25,0,50,25
1746573805150,CHEM 41B,A02,886362,Theodorakis; Emmanuel,47,0,50,3
1746573806174,CHIN 165A,A00,886382,Xu; Li,18,0,20,2
1746573807202,CLAS 120,A00,886387,Myerston Santana; Jacobo,33,0,40,7
1746573808232,COGS 9,A01,886967,Shannon; Kyle Michael,42,0,60,18
1746573809258,COGS 11,A01,886969,Staff,10,0,30,20
1746573810283,COGS 14A,A01,886971,Staff,6,0,60,54
1746573811312,COGS 14B,A01,886973,Hoffman; Drew Ellen,4,0,60,56
1746573812340,COGS 18,A01,886975,Morgan; Eric,35,0,60,25
1746573813369,COGS 20,A01,886977,Staff,4,0,8,4
1746573813369,COGS 20,A02,886978,Staff,5,0,7,2
1746573814394,COGS 100,A01,907783,Staff,1,2,30,29
1746573815443,COGS 101B,A01,886980,Staff,0,3,48,48
1746573816467,COGS 101C,A01,886982,Delgado; Tania,0,5,44,44
1746573817494,COGS 102A,A01,886984,Johnson; Christine M.,4,0,30,26
1746573818521,COGS 118B,A01,886986,Staff,1,4,88,87
1746573819546,COGS 150,A01,886988,Bergen; Benjamin,22,0,50,28
1746573820573,COGS 153,A00,886989,Delgado; Tania,0,2,41,41
1746573821601,COGS 186,A01,886991,Staff,0,0,32,32
1746573822626,COGS 187A,A01,886993,Boyle; Mary E. T.,7,0,30,23
1746573823654,COGS 189,A00,886994,Staff,0,1,30,30
1746573824682,COMM 10,A01,886996,Staff,0,0,20,21
1746573824682,COMM 10,A02,886997,Staff,11,0,20,9
1746573824682,COMM 10,A03,959845,Staff,19,0,20,1
1746573825710,COMM 20,A01,886999,Leuning; Grant Maurstad,24,0,40,16
1746573827766,COMM 100A,A01,887002,Staff,0,0,20,25
1746573827766,COMM 100A,A02,887003,Staff,6,0,20,14
1746573828792,COMM 100B,A01,887005,Staff,0,8,20,24
1746573829819,COMM 106D,A00,887006,Staff,13,0,40,27
1746573830848,COMM 110G,A00,887007,Whitworth-Smith; Andrew C,12,0,40,28
1746573831872,COMM 111B,A00,887008,Staff,31,0,40,9
1746573832898,COMM 113T,A00,887009,Abuelhiga; Soraya Jill,28,0,40,12
1746573832898,COMM 113T,B00,906733,Staff,40,0,40,0
1746573833923,COMM 145,A00,887010,Staff,12,0,40,28
1746573834950,COMM 146,A00,887054,Staff,31,0,40,9
1746573835978,COMM 190,A00,887012,Staff,8,0,23,15
1746573837002,CSE 8A,A50,887015,Cao; Yingjun,57,0,85,28
1746573838028,CSE 11,A01,887017,Cao; Yingjun,12,0,70,58
1746573839111,CSE 20,A01,887019,Staff,30,0,50,20
1746573840135,CSE 21,A01,887021,Staff,78,0,100,22
1746573840135,CSE 21,B01,892583,Braun; Oliver,45,0,50,5
1746573841160,CSE 30,A01,887025,Eldon; John,143,0,200,57
1746573842189,CSE 100,A01,887027,Staff,26,0,50,24
1746573842189,CSE 100,A02,887028,Staff,42,0,50,8
1746573843218,CSE 101,A01,887030,Braun; Oliver,74,0,100,26
1746573843218,CSE 101,B01,887032,Jones; Miles E,0,3,50,50
1746573843218,CSE 101,B02,887033,Jones; Miles E,0,2,50,50
1746573844246,CSE 105,A01,908084,Jones; Miles E,32,0,50,18
1746573844246,CSE 105,A02,908087,Jones; Miles E,31,0,50,19
1746573845273,CSE 135,A01,887035,Powell; Thomas Allan,0,5,50,50
1746573846297,CSE 142,A01,887037,Staff,8,0,60,52
1746573847323,CSE 142L,A01,887039,Staff,34,0,60,26
1746573848352,CSE 151A,A01,887041,Solares; Edwin A,47,0,100,53
1746573849382,CSE 175,A01,887043,Kumar; Rakesh,30,0,30,0
1746573850408,CSS 1,A01,886389,Staff,1,1,40,39
1746573851435,DSC 30,A01,908097,Liao; Soohyun Nam,47,0,75,28
1746573852460,DSC 40A,A01,908099,Shannon; Kyle Michael,30,0,50,20
1746573853487,DSC 40B,A01,908112,Staff,15,0,50,35
1746573854512,DSC 80,A01,908116,Staff,19,0,60,41
1746573855539,DSC 197,001,956863,Eldridge; Justin Matthew,9999,0,9999,0
1746573856566,ECE 5,A01,886400,Morris; Karcher William,1,0,6,5
1746573856566,ECE 5,A02,886401,Morris; Karcher William,3,0,6,3
1746573857592,ECE 148,A01,886403,Silberman; Jack,0,14,14,14
1746573858619,ECON 1,A01,887265,Crane; Meredith Helen,12,0,70,58
1746573858619,ECON 1,B01,887268,Staff,42,0,50,8
1746573859644,ECON 2,A01,887273,Crane; Meredith Helen,55,0,70,15
1746573860670,ECON 3,A01,887279,Rondina; Giacomo,32,0,70,38
1746573861695,ECON 4,A01,887282,Anderson; John Charles,0,2,10,10
1746573862725,ECON 5,A01,887285,Staff,34,0,45,11
1746573862725,ECON 5,B01,887292,Staff,41,0,45,4
1746573863755,ECON 100A,A01,887337,Newhouse; Herbert S,54,0,70,16
1746573863755,ECON 100A,B01,887349,Staff,45,0,50,5
1746573864783,ECON 100B,A01,887361,Du; Songzi,29,0,70,41
1746573865810,ECON 100C,A01,887445,Newhouse; Herbert S,59,0,70,11
1746573866835,ECON 105,A00,887488,Vespa; Emanuel Ignacio,23,0,35,12
1746573867865,ECON 109,A01,887506,Shishkin; Denis,28,0,35,7
1746573868896,ECON 110A,A01,887568,Alon; Titan Michael,0,3,35,35
1746573868896,ECON 110A,B01,907601,Alon; Titan Michael,20,0,35,15
1746573869924,ECON 110B,A01,887598,Levkoff; Steven B.,0,24,70,70
1746573870951,ECON 112,A00,887599,Rondina; Giacomo,19,0,35,16
1746573871977,ECON 120A,A01,887603,Dai; Yinlin,35,0,70,35
1746573873002,ECON 120C,A01,887608,Sun; Yixiao,0,1,35,35
1746573873002,ECON 120C,B01,887614,Sun; Yixiao,0,0,35,35
1746573874028,ECON 138,A00,887621,Bharadwaj; Prashant,0,21,20,20
1746573875057,ECON 144,A00,958007,Squires; Dale E,12,0,35,23
1746573876083,ECON 171,A01,907666,Staff,18,0,35,17
1746573877109,ECON 175,A00,887626,Wu; Pak Yeung,22,0,35,13
1746573878135,ECON 190,A00,887640,Vespa; Emanuel Ignacio,22,0,35,13
1746573879169,EDS 25,A01,888197,Staff,0,0,0,0
1746573879169,EDS 25,A02,888209,Staff,0,0,0,0
1746573879169,EDS 25,A03,888210,Staff,0,0,0,0
1746573879169,EDS 25,A04,888212,Staff,0,0,0,0
1746573879169,EDS 25,A05,888213,Staff,0,0,0,0
1746573879169,EDS 25,A06,888214,Staff,0,0,0,0
1746573879169,EDS 25,A07,888235,Staff,0,2,0,0
1746573879169,EDS 25,A08,888236,Staff,0,0,0,0
1746573879169,EDS 25,A09,888240,Staff,0,0,0,0
1746573879169,EDS 25,A10,888244,Staff,0,0,0,0
1746573879169,EDS 25,B01,888273,Staff,0,0,0,0
1746573879169,EDS 25,B02,888285,Staff,0,0,0,0
1746573879169,EDS 25,B03,888423,Staff,0,0,0,1
1746573879169,EDS 25,B04,888432,Staff,0,0,0,0
1746573879169,EDS 25,B05,888433,Staff,0,0,0,0
1746573879169,EDS 25,B06,888467,Staff,0,0,0,0
1746573879169,EDS 25,B07,888468,Staff,0,0,0,0
1746573879169,EDS 25,B08,888479,Staff,0,0,0,0
1746573879169,EDS 25,B09,888484,Staff,0,0,0,0
1746573879169,EDS 25,B10,888487,Staff,0,0,0,0
1746573880198,EDS 38,A01,907700,Choi; Bailey Miyeon,30,0,30,0
1746573881224,EDS 112,A01,888601,Chapman; Thandeka K,12,0,40,28
1746573882252,EDS 115,A00,888697,Mendez; Kathrina Mendoza,10,0,30,20
1746573883278,EDS 116,A01,888893,Staff,34,0,40,6
1746573885331,EDS 124AR,A00,889133,Staff,29,0,50,21
1746573885331,EDS 124AR,B00,907471,Simon; Elizabeth A,37,0,50,13
1746573886357,EDS 124BR,A00,889134,Simon; Elizabeth A,44,0,100,56
1746573887382,EDS 125,A00,889135,Staff,25,0,30,5
1746573888409,EDS 126,A01,889138,Staff,35,0,40,5
1746573889437,EDS 164R,A01,889142,Wishard Guerra; Alison G.,33,0,50,17
1746573890464,ENG 30,A01,886396,Staff,0,0,0,0
1746573890464,ENG 30,B01,886398,Staff,0,0,0,0
1746573891489,ENVR 102,A00,906150,Montejo; Carolina,23,0,25,2
1746573892516,ETHN 103A,A00,887236,Man; Simeon S,0,3,0,0
1746573893541,ETHN 113,A00,887239,Staff,16,0,30,14
1746573894568,ETHN 116,A00,887240,Staff,16,0,25,9
1746573895593,ETHN 117,A00,887241,Choi; Esther Min,28,0,30,2
1746573896618,ETHN 118,A00,887243,Staff,24,0,30,6
1746573897643,ETHN 127,A00,887248,Cuong; Marisol,11,0,15,4
1746573898668,ETHN 139,A00,887250,Staff,7,0,10,3
1746573899694,ETHN 142,A00,887252,Staff,10,0,30,20
1746573900722,ETHN 161,A00,887253,Browne; Errol Tsekani,24,0,30,6
1746573901747,ETHN 163FR,A00,887255,Burelle; Julie Sara Veronique,0,0,5,5
1746573902772,GLBH 20,A00,889149,Elwardani; Nile Regina,8,0,42,34
1746573904829,GLBH 111,A01,889152,Burgos; Jose L.,17,0,17,0
1746573905853,GLBH 150,A00,889181,Sloane; Julia Kathryn,0,5,15,15
1746573907908,HDS 60,A01,886406,Warstadt; Melissa Fawn,73,0,80,7
1746573908933,HIAF 111,A00,889324,Gyamfi; Bright,25,0,32,7
1746573909960,HIEA 131,A00,889328,Staff,15,0,32,17
1746573910986,HIEA 144,A00,889333,Henry; Todd A.,26,0,32,6
1746573912014,HIEA 154,A00,889336,Henry; Todd A.,24,0,32,8
1746573913039,HIEU 106,A00,889339,Staff,22,0,32,10
1746573915096,HIEU 114,A00,889340,Staff,4,0,32,28
1746573916121,HIEU 135GS,A00,889342,Patterson; Patrick H.,0,0,1,24
1746573917146,HIEU 137,A00,889343,Edington; Claire Ellen,10,0,25,15
1746573918175,HIEU 148,A00,889345,Staff,14,0,32,18
1746573919203,HIEU 154,A00,889346,Biess; Frank Peter,21,0,32,11
1746573920230,HILA 102,A00,889351,Staff,12,0,32,20
1746573921256,HILD 2A,A01,889221,Lewandoski; Julia Mavis,1,10,32,31
1746573922281,HILD 7B,A01,889225,Man; Simeon S,0,12,32,32
1746573923305,HILD 7C,A01,889288,Alvarez; Luis A,0,14,32,32
1746573924332,HILD 30,A01,889323,Staff,0,5,32,32
1746573926385,HISC 119,A00,889383,Golan; Tal,19,0,32,13
1746573927412,HIUS 103,A00,889384,Man; Simeon S,0,0,32,32
1746573928437,HIUS 117,A00,919797,Kwak; Nancy,19,0,32,13
1746573929461,HIUS 142A,A00,919788,Staff,22,0,32,10
1746573931513,HIUS 149,A00,889386,Gyamfi; Bright,26,0,32,6
1746573932539,HIUS 155,A00,889387,Alvarez; Luis A,15,0,32,17
1746573933563,HUM 3,A01,886499,Caldwell; Michael Alan,19,0,50,31
1746573934588,HUM 3GS,A00,886500,Rodriguez; Bretton Sigfred,0,0,0,28
1746573935618,HUM 3R,A01,886502,Markman; Kristina,0,36,50,50
1746573936651,HUM 4,A01,886504,Crum; Matthew Stephen,23,0,50,27
1746573936651,HUM 4,B01,886506,West; Geoffrey Scott,17,0,50,33
1746573937676,HUM 4GS,A00,886507,Staff,0,0,0,19
1746573938705,HUM 5,A01,886509,Staff,32,0,50,18
1746573939731,HUM 5R,A01,886511,Zavodny; Tatiana Sophia,0,39,50,50
1746573940756,JAPN 180,A00,886407,Staff,16,0,40,24
1746573941781,LATI 50,A01,886409,Martin-Cabrera; Luis,4,0,22,18
1746573941781,LATI 50,A02,886410,Martin-Cabrera; Luis,19,0,22,3
1746573941781,LATI 50,A03,886411,Martin-Cabrera; Luis,21,0,22,1
1746573941781,LATI 50,A04,886412,Martin-Cabrera; Luis,9,0,22,13
1746573942809,LAWS 101,A00,907664,Staff,28,0,60,32
1746573943834,LIAB 1A,A00,889388,Saab; Dima,17,0,20,3
1746573944860,LIAB 1AX,A00,889389,El Cheddadi; Youniss,18,0,20,2
1746573945889,LIFR 1C,A00,889391,Van Moer; Vinciane G,8,0,20,12
1746573946913,LIFR 1CX,A00,889392,Van Moer; Vinciane G,7,0,20,13
1746573947939,LIFR 1D,A00,889393,Van Moer; Vinciane G,7,0,20,13
1746573948967,LIFR 1DX,A00,889394,Van Moer; Vinciane G,8,0,20,12
1746573949999,LIGN 7,A00,886923,Staff,24,0,50,26
1746573951024,LIGN 17,A00,886924,Kehler; Andrew Scott,125,0,150,25
1746573952048,LTAM 110,A00,889395,Staff,15,0,30,15
1746573953074,LTAM 110GS,A00,958010,Rodriguez; Bretton Sigfred,0,0,0,28
1746573954100,LTCH 101,A00,889397,Staff,23,0,25,2
1746573955128,LTCS 130,A00,889398,Staff,23,0,25,2
1746573956157,LTEA 138,A00,889399,Staff,24,0,40,16
1746573957182,LTEN 149,A00,889400,Wesling; Megan E.,0,3,25,25
1746573958210,LTEN 169,A00,889401,Staff,20,0,25,5
1746573959237,LTEN 180,A00,889402,Staff,10,0,15,5
1746573960262,LTEN 181,A00,889403,Staff,21,0,25,4
1746573961288,LTWL 100,A00,889404,Myerston Santana; Jacobo,2,0,25,23
1746573962312,LTWL 180GS,A00,889405,Staff,0,0,20,20
1746573963338,LTWL 181,A00,889406,Staff,16,0,25,9
1746573964366,LTWL 184,A00,889475,Mukherjee; Silpa,22,0,25,3
1746573965393,LTWR 102C,A00,889486,Staff,29,0,30,1
1746573966423,LTWR 115W,A00,889491,Staff,0,2,15,15
1746573967453,MAE 8,A01,886905,Staff,0,2,0,0
1746573968478,MAE 11,A00,886906,Bandaru; Prabhakar,0,7,50,50
1746573969506,MAE 20,A00,886907,Evdokimenko; Ekaterina,43,0,70,27
1746573970533,MAE 30B,A00,886909,Ghazinejad; Maziar,26,0,45,19
1746573971563,MAE 101B,A00,886910,Saintillan; David,29,0,45,16
1746573972590,MAE 105,A00,886911,Bandaru; Prabhakar,18,0,50,32
1746573973614,MAE 107,B00,958024,Staff,8,0,50,42
1746573974643,MAE 143B,A00,886913,Bewley; Thomas R,4,0,40,36
1746573975669,MAE 148,A01,886915,Silberman; Jack,0,3,14,14
1746573976693,MAE 160,A00,886916,Evdokimenko; Ekaterina,31,0,60,29
1746573977718,MATH 3C,A01,889681,Staff,0,2,30,30
1746573977718,MATH 3C,A02,960048,Staff,24,0,30,6
1746573978746,MATH 10A,A01,889760,Staff,26,0,30,4
1746573978746,MATH 10A,A02,889783,Staff,29,0,30,1
1746573979778,MATH 10B,A01,889785,Verstraete; Jacques Allan,2,0,35,33
1746573979778,MATH 10B,A02,889795,Verstraete; Jacques Allan,4,0,35,31
1746573979778,MATH 10B,B01,889797,Verstraete; Jacques Allan,3,0,35,32
1746573979778,MATH 10B,B02,889828,Verstraete; Jacques Allan,3,0,35,32
1746573980809,MATH 10C,A01,889849,Habib; Yousaf,7,0,30,23
1746573980809,MATH 10C,A02,889852,Habib; Yousaf,14,0,30,16
1746573980809,MATH 10C,A03,889853,Habib; Yousaf,22,0,30,8
1746573980809,MATH 10C,A04,889858,Habib; Yousaf,20,0,30,10
1746573980809,MATH 10C,B01,889861,Staff,1,0,30,29
1746573980809,MATH 10C,B02,889862,Staff,24,0,30,6
1746573980809,MATH 10C,B03,889863,Staff,27,0,30,3
1746573980809,MATH 10C,B04,889967,Staff,23,0,30,7
1746573981839,MATH 18,A01,889974,Staff,7,0,30,23
1746573981839,MATH 18,A02,889977,Staff,20,0,30,10
1746573981839,MATH 18,B01,889984,Hardiman; Liam,21,0,30,9
1746573981839,MATH 18,B02,889985,Hardiman; Liam,25,0,30,5
1746573982868,MATH 20A,A01,889990,Suk; Andrew Hoon,30,0,35,5
1746573983898,MATH 20B,A01,889993,Ohm; Ko Woon,22,0,30,8
1746573983898,MATH 20B,A02,889994,Ohm; Ko Woon,30,0,30,0
1746573983898,MATH 20B,B01,889996,Ohm; Ko Woon,22,0,30,8
1746573983898,MATH 20B,B02,889997,Ohm; Ko Woon,23,0,30,7
1746573984923,MATH 20C,A01,889999,Hammock; Frances H,17,0,30,13
1746573984923,MATH 20C,A02,890003,Hammock; Frances H,23,0,30,7
1746573984923,MATH 20C,B01,890006,Hammock; Frances H,3,0,30,27
1746573984923,MATH 20C,B02,890007,Hammock; Frances H,12,0,30,18
1746573985954,MATH 20D,A01,890011,Cheng; Hsiao-Bing,1,1,30,29
1746573985954,MATH 20D,A02,890012,Cheng; Hsiao-Bing,14,0,30,16
1746573985954,MATH 20D,B01,890016,Cheng; Hsiao-Bing,13,0,30,17
1746573985954,MATH 20D,B02,890017,Cheng; Hsiao-Bing,13,0,30,17
1746573986981,MATH 20E,A01,890026,Harel; Guershon,1,0,30,29
1746573986981,MATH 20E,A02,890029,Harel; Guershon,23,0,30,7
1746573986981,MATH 20E,B01,890033,Harel; Guershon,7,0,30,23
1746573986981,MATH 20E,B02,890101,Harel; Guershon,21,0,30,9
1746573988010,MATH 102,A01,890104,Staff,17,0,30,13
1746573988010,MATH 102,A02,890105,Staff,27,0,30,3
1746573989035,MATH 103B,A01,890116,Salehi Golsefidy; Alireza,3,0,30,27
1746573989035,MATH 103B,B01,890118,Staff,0,3,34,34
1746573990065,MATH 109,A01,890121,Aliabadi Sr.; Mohsen,1,0,30,29
1746573990065,MATH 109,B01,890124,Upadrashta; Pranav Kumar,18,0,30,12
1746573991093,MATH 120A,A01,890126,Eggers; John Dietrich,13,0,30,17
1746573992118,MATH 142B,A01,890128,Ioana; Adrian,19,0,30,11
1746573992118,MATH 142B,A02,890129,Ioana; Adrian,13,0,30,17
1746573993144,MATH 154,A01,890174,Staff,0,0,30,30
1746573993144,MATH 154,A02,890182,Staff,0,0,30,30
1746573994169,MATH 168A,A01,890197,Dumitriu; Ioana,21,0,35,14
1746573995193,MATH 170A,A01,890240,Nie; Jiawang,1,0,30,29
1746573995193,MATH 170A,A02,890241,Nie; Jiawang,11,0,30,19
1746573995193,MATH 170A,A03,890249,Nie; Jiawang,23,0,30,7
1746573996217,MATH 170B,A01,957891,Nag; Panchali,13,0,35,22
1746573998270,MATH 181A,A01,908025,Staff,0,3,35,35
1746573998270,MATH 181A,A02,960115,Staff,26,0,35,9
1746573999294,MATH 181B,A01,959874,Staff,25,0,30,5
1746574000324,MATH 193B,A01,890265,Staff,0,4,35,35
1746574001350,MGT 4,A01,890311,Anderson; John Charles,42,0,88,46
1746574002380,MGT 5,A00,907740,Staff,13,0,98,85
1746574003408,MGT 12,A00,890312,Lindenberger; Wade Douglas,67,0,98,31
1746574004436,MGT 16,A00,957883,Staff,78,0,98,20
1746574006488,MGT 45,A00,890314,Pecore; Joseph P.,46,0,98,52
1746574007514,MGT 71,A00,890315,Staff,0,11,98,98
1746574008540,MGT 100,A00,890316,Yavorsky; Daniel Ryan,44,0,98,54
1746574009565,MGT 103,A00,890317,Ehrich; Kristine R,73,0,98,25
1746574010594,MGT 105,A00,890356,Bates; Kenneth Walter,0,8,98,98
1746574011621,MGT 112,A00,890360,Ehrich; Kristine R,55,0,98,43
1746574012647,MGT 127R,A00,907732,Zhu; Kevin Xiaoguo,23,0,98,75
1746574013675,MGT 131B,A00,890361,Anderson; John Charles,60,0,98,38
1746574014701,MGT 137,A00,890362,Lindenberger; Wade Douglas,65,0,98,33
1746574015727,MGT 160,A00,890369,Johnson; Erik Barry,9,0,98,89
1746574017781,MGT 164,A00,890372,Zimmermann; Carsten,0,40,98,98
1746574018805,MGT 180,A00,890374,Bliss; Barbara Ann,12,0,98,86
1746574019831,MMW 15,A01,886414,Chang; Edmond Yi-Teh,0,12,28,28
1746574019831,MMW 15,A02,886415,Chang; Edmond Yi-Teh,0,8,28,28
1746574019831,MMW 15,A03,886416,Chang; Edmond Yi-Teh,0,9,28,28
1746574019831,MMW 15,A04,886417,Chang; Edmond Yi-Teh,0,8,28,28
1746574019831,MMW 15,B01,886419,Chang; Edmond Yi-Teh,0,7,28,28
1746574019831,MMW 15,B02,886420,Chang; Edmond Yi-Teh,0,8,28,28
1746574019831,MMW 15,B03,886421,Chang; Edmond Yi-Teh,0,7,28,28
1746574019831,MMW 15,B04,886422,Chang; Edmond Yi-Teh,0,8,28,28
1746574019831,MMW 15,C01,886424,Staff,0,9,28,28
1746574019831,MMW 15,C02,886425,Staff,0,8,28,28
1746574019831,MMW 15,C03,886426,Staff,0,8,28,28
1746574019831,MMW 15,C04,886427,Staff,0,8,28,28
1746574019831,MMW 15,C05,958038,Staff,0,8,28,28
1746574019831,MMW 15,C06,958039,Staff,1,8,28,27
1746574020859,MMW 15GS,A00,906910,Patterson; Patrick H.,4,0,28,24
1746574021887,MMW 122R,A01,886429,Rahimi; Babak,0,13,28,28
1746574021887,MMW 122R,A02,886430,Rahimi; Babak,0,12,28,28
1746574021887,MMW 122R,A03,958040,Rahimi; Babak,0,11,28,28
1746574022911,MUS 1A,A01,890937,Staff,2,0,25,23
1746574022911,MUS 1A,A02,891035,Staff,6,0,25,19
1746574022911,MUS 1A,C01,958912,Staff,24,0,25,1
1746574022911,MUS 1A,C02,958913,Staff,25,0,25,0
1746574024965,MUS 2AK,A00,957092,Ohnishi; Takae,15,0,15,0
1746574025994,MUS 4,A01,891044,Staff,1,0,25,24
1746574025994,MUS 4,A02,891045,Staff,23,0,25,2
1746574025994,MUS 4,B01,891048,Staff,17,0,25,8
1746574025994,MUS 4,B02,891050,Staff,25,0,25,0
1746574027020,MUS 5,A01,957506,Dubnov; Shlomo,0,0,25,25
1746574027020,MUS 5,A02,957622,Dubnov; Shlomo,13,0,25,12
1746574027020,MUS 5,A03,957623,Dubnov; Shlomo,20,0,25,5
1746574028048,MUS 6,A01,891053,Freitas Caetano; Marcelo,24,0,25,1
1746574028048,MUS 6,A02,891054,Freitas Caetano; Marcelo,23,0,25,2
1746574029074,MUS 7,A01,891081,Staff,1,0,25,24
1746574029074,MUS 7,A02,891082,Staff,3,0,25,22
1746574030105,MUS 8GS,A00,891118,Borgo; David Garcia,1,0,25,24
1746574031133,MUS 11,A01,891140,Staff,9,0,25,16
1746574031133,MUS 11,A02,891141,Staff,22,0,25,3
1746574032159,MUS 13,A01,891143,Staff,8,0,25,17
1746574032159,MUS 13,A02,891144,Staff,24,0,25,1
1746574033189,MUS 15,A01,891146,Staff,9,0,25,16
1746574033189,MUS 15,A02,891148,Staff,21,0,25,4
1746574033189,MUS 15,B01,891150,Staff,18,0,25,7
1746574033189,MUS 15,B02,891151,Staff,25,0,25,0
1746574034215,MUS 20,A01,891153,Staff,5,0,20,15
1746574034215,MUS 20,A02,891155,Staff,14,0,20,6
1746574035243,MUS 80,A00,891156,Staff,19,0,25,6
1746574035243,MUS 80,B00,891157,Staff,23,0,25,2
1746574036267,MUS 130,A00,891158,Ohnishi; Takae,35,0,35,0
1746574037291,MUS 150GS,A01,891160,Borgo; David Garcia,1,0,25,24
1746574038318,MUS 170,A01,891162,Freitas Caetano; Marcelo,20,0,25,5
1746574038318,MUS 170,A02,891164,Freitas Caetano; Marcelo,21,0,25,4
1746574039347,NANO 11,A00,886220,Vazquez Mena; Oscar,13,0,15,2
1746574040374,NANO 15,A01,886222,Drews; Aaron,4,0,7,3
1746574041455,NANO 104,A00,886224,Sirbuly; Donald,17,0,25,8
1746574042478,PH 40,A00,886528,Staff,24,0,40,16
1746574043503,PH 45,A01,886799,Staff,35,0,40,5
1746574044531,PH 110,A00,886802,Staff,0,7,40,40
1746574045556,PH 172,A00,906716,Staff,19,0,35,16
1746574046583,PH 191,A00,886803,Staff,6,0,40,34
1746574047607,PHIL 1,A00,889500,Staff,20,0,30,10
1746574048632,PHIL 10,A01,889549,Grush; Rick Scott,16,0,22,6
1746574048632,PHIL 10,A02,889551,Grush; Rick Scott,22,0,22,0
1746574049659,PHIL 28,A01,889559,Lamey; Andy M.,0,2,31,31
1746574049659,PHIL 28,A02,889561,Lamey; Andy M.,0,1,30,30
1746574049659,PHIL 28,A03,889572,Lamey; Andy M.,0,1,30,30
1746574050683,PHIL 35,A00,907839,Staff,13,0,15,2
1746574051708,PHIL 60,A00,889574,Staff,73,0,90,17
1746574052733,PHIL 101,A00,958004,Staff,12,0,15,3
1746574054787,PHIL 136,A00,889582,Fulkerson; Matthew Todd,26,0,45,19
1746574055818,PHIL 163,A01,889601,Staff,21,0,30,9
1746574055818,PHIL 163,B01,889606,Brandt; Reuven A,0,3,0,0
1746574056843,PHIL 164,A00,889610,Staff,16,0,30,14
1746574057869,PHIL 165,A00,889613,Staff,22,0,30,8
1746574058897,PHYS 1A,A00,886431,Staff,26,0,70,44
1746574059925,PHYS 1AL,001,886432,Tsai; Philbert S,0,2,30,30
1746574059925,PHYS 1AL,002,886436,Tsai; Philbert S,11,0,30,19
1746574060949,PHYS 1B,A00,886439,Staff,185,0,240,55
1746574061979,PHYS 1BL,001,886441,Tsai; Philbert S,0,4,30,30
1746574061979,PHYS 1BL,002,886444,Tsai; Philbert S,2,0,30,28
1746574063004,PHYS 1C,A00,896092,Arnold; Kam S,78,0,146,68
1746574064035,PHYS 1CL,001,886448,Tsai; Philbert S,0,0,30,30
1746574064035,PHYS 1CL,002,886449,Tsai; Philbert S,1,0,30,29
1746574064035,PHYS 1CL,003,886450,Tsai; Philbert S,16,0,30,14
1746574064035,PHYS 1CL,004,886451,Tsai; Philbert S,15,0,30,15
1746574065060,PHYS 2B,A01,886457,Staff,68,0,115,47
1746574066089,PHYS 2C,A01,886460,Shotwell; Brian,0,9,65,65
1746574067114,PHYS 2CL,A01,886467,Staff,0,4,28,28
1746574067114,PHYS 2CL,A02,886468,Staff,0,3,28,28
1746574068145,PHYS 2D,A01,886470,Staff,10,0,50,40
1746574069174,PHYS 4B,A01,886475,Grinstein; Benjamin,22,0,40,18
1746574070202,POLI 5,A00,891173,Desposato; Scott,7,0,25,18
1746574071231,POLI 5D,A01,891175,Staff,5,0,5,0
1746574071231,POLI 5D,B01,891178,Staff,5,0,5,0
1746574072257,POLI 11,A00,891179,Ferree; Karen E,2,0,35,33
1746574073283,POLI 12,A00,891180,Staff,16,0,30,14
1746574074308,POLI 27,A01,891182,Staff,12,0,75,63
1746574075337,POLI 30,A00,891183,Staff,8,0,50,42
1746574076361,POLI 100B,A00,891244,Staff,5,1,35,30
1746574077387,POLI 100I,A00,891247,Staff,7,0,30,23
1746574078411,POLI 104J,A00,891248,Nichter; Maysa,14,0,30,16
1746574079436,POLI 104U,A00,891250,Nichter; Maysa,2,0,30,28
1746574081486,POLI 110B,A00,891255,Wiens; David,19,0,25,6
1746574082515,POLI 112A,A00,891256,Wiens; David,6,0,25,19
1746574083542,POLI 114BR,A00,891261,Staff,19,0,30,11
1746574084571,POLI 117R,A00,891262,Forman; Fonna,0,6,50,50
1746574085596,POLI 118,A00,891264,Ingham; Sean,17,0,25,8
1746574086622,POLI 124A,A00,891265,Staff,18,0,20,2
1746574087653,POLI 125D,A00,891266,Nichter; Simeon C,2,0,25,23
1746574088679,POLI 126,A00,891268,Nichter; Simeon C,7,0,25,18
1746574089705,POLI 126AA,A00,891272,Staff,16,0,25,9
1746574090732,POLI 130AA,A00,891273,Staff,15,0,20,5
1746574091759,POLI 134AA,A00,891274,Staff,4,0,20,16
1746574093808,POLI 138,A00,891278,Staff,21,0,25,4
1746574094835,POLI 142K,A00,891280,Staff,10,0,25,15
1746574095862,POLI 142M,A00,891281,Gartzke; Erik,16,0,30,14
1746574096889,POLI 142P,A00,891284,Staff,20,0,30,10
1746574097915,POLI 143,A00,891285,Gartzke; Erik,12,0,30,18
1746574098944,POLI 153,A00,891286,Staff,19,0,20,1
1746574101008,POLI 175,A00,891290,Staff,15,0,20,5
1746574102033,PSYC 1,A00,890674,Steiner; Eric Tomas,0,11,45,45
1746574103058,PSYC 2,A00,890676,Albright; Thomas D,21,0,35,14
1746574104082,PSYC 3,A00,890679,Staff,17,0,20,3
1746574105123,PSYC 6,A00,959858,Staff,20,0,20,0
1746574106148,PSYC 60,A01,890684,Rickard; Timothy C.,0,5,45,45
1746574107173,PSYC 70,A01,890689,Geller; Emma Harlan,7,0,30,23
1746574108197,PSYC 71,A01,959860,Staff,21,0,25,4
1746574109226,PSYC 100,A00,890690,Lacefield; Katharine I,0,50,180,180
1746574110250,PSYC 102,A00,890695,Staff,18,0,40,22
1746574111277,PSYC 105,A00,890699,Geller; Emma Harlan,70,0,100,30
1746574112304,PSYC 106,A00,890701,Gorman; Michael R.,6,0,30,24
1746574113329,PSYC 108,A00,890704,Adrian; Julia Anna,0,28,50,50
1746574114355,PSYC 118,A01,890712,Staff,11,0,30,19
1746574115380,PSYC 124,A00,890716,Chapman; Eddie Nathaniel,25,0,60,35
1746574116406,PSYC 131,A00,890717,Anagnostaras; Stephan,0,8,80,80
1746574117431,PSYC 137,A00,890719,Winkielman; Piotr,0,11,30,30
1746574118458,PSYC 144,A00,890721,Adrian; Julia Anna,0,9,45,45
1746574119484,PSYC 162,A00,890805,Staff,0,0,75,75
1746574120530,PSYC 169,A00,890810,Staff,0,14,30,30
1746574121559,PSYC 172,A00,890814,Gorman; Michael R.,9,0,30,21
1746574122586,PSYC 181,A00,890818,Anagnostaras; Stephan,9,0,200,191
1746574123612,PSYC 184,A00,959861,Staff,168,0,175,7
1746574124636,PSYC 189,A00,890823,Staff,0,2,30,30
1746574125666,PSYC 191,A00,890884,Rickard; Timothy C.,0,12,35,35
1746574126693,PSYC 193,A00,890913,Staff,19,0,30,11
1746574126693,PSYC 193,B00,890914,Chapman; Eddie Nathaniel,24,0,30,6
1746574127719,PSYC 193L,A01,890918,Lowe; Angela Beth,20,0,30,10
1746574127719,PSYC 193L,B01,890921,Hurwitz; Ethan Scott,20,0,30,10
1746574127719,PSYC 193L,C01,890928,Staff,30,0,30,0
1746574128747,RELI 149,A00,886806,Rahimi; Babak,23,0,40,17
1746574129772,SE 9,A01,886814,Staff,7,0,20,13
1746574130798,SE 101B,A01,886816,Chadha; Mayank,4,0,35,31
1746574131825,SE 110B,A00,886818,Zhu; Qiang,4,0,75,71
1746574132854,SE 125,A01,886830,Staff,10,0,30,20
1746574133883,SE 130B,A01,886835,Staff,14,0,40,26
1746574134923,SE 131A,A01,886838,Krysl; Petr,34,0,55,21
1746574135950,SE 154,A00,886840,Staff,29,0,50,21
1746574136976,SE 164GS,A01,886849,Staff,6,0,20,14
1746574138005,SE 167GS,A01,886853,Staff,6,0,20,14
1746574139032,SIO 25,A01,890107,Staff,19,0,30,11
1746574140055,SIO 45,A00,890109,Cook; Geoffrey W,117,0,200,83
1746574141083,SIO 109R,A00,890110,Forman; Fonna,0,16,20,20
1746574142108,SIO 187,A01,890114,Kacev; David,15,0,40,25
1746574143136,SOCI 1,A01,890431,Thorpe; Charles Robert,14,0,30,16
1746574143136,SOCI 1,A02,890518,Thorpe; Charles Robert,30,0,30,0
1746574144165,SOCI 2,A01,957978,Staff,25,0,25,0
1746574144165,SOCI 2,A02,957979,Staff,23,0,25,2
1746574145190,SOCI 20,A01,890523,Calderon-Zaks; Michael Aar,21,0,30,9
1746574145190,SOCI 20,A02,890526,Calderon-Zaks; Michael Aar,29,0,30,1
1746574146217,SOCI 30,A01,890533,Pardo Guerra; Juan Pablo,37,0,40,3
1746574147248,SOCI 40,A01,890535,Staff,27,0,45,18
1746574148273,SOCI 104Q,A00,890559,Staff,18,0,30,12
1746574149299,SOCI 106,A00,890560,Arnal; Maud Marie Leonie,20,0,30,10
1746574150325,SOCI 110,A00,890567,Holkenbrink-Monk; Charlene,19,0,30,11
1746574151353,SOCI 112,A00,890568,Victoria Torres; Pablo,2,0,55,53
1746574152387,SOCI 115,A00,890597,Arnal; Maud Marie Leonie,28,0,45,17
1746574154437,SOCI 121,A00,890604,Pardo Guerra; Juan Pablo,38,0,45,7
1746574155465,SOCI 126,A01,890608,Staff,8,0,10,2
1746574156491,SOCI 127,A00,890609,Staff,18,0,30,12
1746574157516,SOCI 131,A00,890610,Thorpe; Charles Robert,37,0,45,8
1746574158545,SOCI 135,A00,890615,Payne; Christine Anna,13,0,45,32
1746574159573,SOCI 139,A00,890620,Staff,38,0,45,7
1746574160599,SOCI 148E,A00,890622,Calderon-Zaks; Michael Aar,36,0,45,9
1746574161623,SOCI 150,A00,890623,Kohler; Kristopher M.,31,0,45,14
1746574162650,SOCI 157,A00,890625,Jules-Rosette; Bennetta W.,18,0,20,2
1746574163677,SOCI 160,A00,890627,Payne; Christine Anna,21,0,45,24
1746574164706,SYN 1,A00,886855,Fish; Gwendolyn Anne,0,1,0,0
1746574164706,SYN 1,B00,906086,Fish; Gwendolyn Anne,0,2,0,2
1746574165732,SYN 2R,A00,886860,Staff,0,17,15,15
1746574165732,SYN 2R,B00,906106,Atkinson; Arthur Laird,0,16,15,15
1746574166762,SYN 100,A01,886866,Browne; Emily,0,28,20,20
1746574166762,SYN 100,B01,906128,Rock; Martin,0,5,20,20
1746574166762,SYN 100,C01,906140,Deavenport; James Cary,0,3,20,20
1746574166762,SYN 100,D01,907816,Deavenport; James Cary,0,5,20,20
1746574167791,TDAC 1,A00,890286,Walsh; Kim C.,8,0,20,12
1746574168816,TDAC 101,A00,890296,Basso; Beatrice,15,0,20,5
1746574169841,TDDE 131,A00,890297,Staff,47,0,50,3
1746574170871,TDDM 1,A00,890287,Weinberg; Sadie,25,0,30,5
1746574171897,TDGE 11,A00,890288,Fulton; Julia,138,0,200,62
1746574171897,TDGE 11,B00,890289,Castro; Robert Jess,184,0,200,16
1746574172926,TDGE 25,B00,957359,Walsh; Kim C.,5,0,20,15
1746574173950,TDGE 40,A01,890292,Power; Jade Yukana,27,0,30,3
1746574174985,TDGE 124,A00,890298,Havis; Allan,0,1,50,50
1746574176011,TDGE 131R,A00,890299,Burelle; Julie Sara Veronique,15,0,42,27
1746574177035,TDHT 101,A00,890300,Staff,10,0,20,10
1746574178065,TDHT 109,A01,890302,Anderson; Mysia Anyse,31,0,40,9
1746574179093,TDMV 1,A00,890293,Arcidiacono; Kristin,18,0,30,12
1746574180122,TDMV 2,A00,890294,Weinberg; Sadie,23,0,30,7
1746574181152,TDMV 3,A00,957878,Arcidiacono; Kristin,28,0,30,2
1746574183202,TDMV 138,A00,890304,Jun; Grace Shin Hae,25,0,40,15
1746574184232,TDMV 140,A00,890305,Corrales; Joseph Bernales,25,0,30,5
1746574185258,TDMV 142,A00,890307,Caligagan; Tony,32,0,40,8
1746574186282,TDMV 144,A00,890308,Camaya; Michelle Ann,25,0,30,5
1746574187307,TDPW 1,A00,890295,Stein; Deborah Isobel,2,0,20,18
1746574188335,USP 2,A01,890272,Lerner; Amy M,7,0,20,13
1746574189360,USP 3,A01,890274,Staff,12,0,30,18
1746574190389,USP 15,A01,890276,Sun; Feiyang,16,0,30,14
1746574191415,USP 25,A00,890277,Shenkman; Michael Thomas,18,0,25,7
1746574192445,USP 138,A00,890278,Staff,14,0,25,11
1746574193470,USP 143,A00,890279,Staff,22,0,70,48
1746574194494,USP 144,A00,890280,Chowdhury; Muhammed Zohir,16,0,30,14
1746574195519,USP 150,A00,890281,Boomhower; Matthew Charles,4,0,30,26
1746574196544,USP 151,A00,890282,Staff,16,0,20,4
1746574197572,USP 162,A00,890283,Andrews; Abigail Leslie,16,0,20,4
1746574198596,USP 168,A00,920477,Kwak; Nancy,0,0,5,5
1746574199624,USP 181,A00,890284,Staff,3,0,20,17
1746574200649,USP 191A,A00,890285,Staff,12,0,20,8
1746574201674,VIS 101,A00,886512,Staff,26,0,75,49
1746574202702,VIS 103,A00,886513,Cruz; Edwin Teddy,61,0,75,14
1746574203727,VIS 108,A00,886514,Staff,3,0,15,12
1746574204752,VIS 127P,A00,886515,Shen; Kuiyi,80,0,146,66
1746574205781,VIS 149,A00,886516,Yoldas; Pinar,0,0,15,15
1746574206807,VIS 164,A00,886526,Erdmann; Dean,19,0,22,3
1746574207835,VIS 194S,A00,886527,Staff,61,0,75,14
1746574208861,WCWP 10A,C00,886484,Martiniuk; Jill,12,0,15,3
1746574209887,WCWP 10B,A00,886490,Uriarte; Emma,0,0,15,15
1746574209887,WCWP 10B,B00,886491,Dhir; Simrita,9,0,15,6
1746574209887,WCWP 10B,C00,886492,Ornelas; Tricia,0,0,15,15
1746574210916,WCWP 100,A00,886494,Young; Mark T,0,6,15,15
1746574213064,AAS 10,A01,886199,Childs; Dennis R.,0,3,0,0
1746574214094,ANAR 104,A01,886940,Shtienberg; Gilad,27,0,30,3
1746574215119,ANAR 120,A00,886953,Staff,12,0,20,8
1746574216143,ANBI 148,A01,886955,Wilder; Linnea Lorene,30,0,40,10
1746574218197,ANSC 122,A00,886957,Staff,25,0,30,5
1746574219222,ANSC 150,A00,886958,Sloane; Julia Kathryn,2,0,15,13
1746574220247,ANSC 156,A00,886959,Jenkins; Janis A.,0,1,15,15
1746574221275,ANSC 180,A00,886960,Staff,11,0,17,6
1746574222300,ANSC 188,A00,886961,Jassal; Aftab,9,0,25,16
1746574223327,ANSC 190,A00,886962,Jassal; Aftab,14,0,25,11
1746574224351,ANSC 191,A00,886963,Staff,18,0,20,2
1746574225375,ANTH 3,A01,891689,Staff,17,0,20,3
1746574226406,ANTH 5,A00,886933,Semendeferi; Ekaterini,16,0,20,4
1746574227434,ANTH 10,A00,886934,Staff,0,12,30,30
1746574228462,ANTH 21,A01,886936,Staff,41,0,60,19
1746574229487,ANTH 23,A01,886938,Staff,92,0,100,8
1746574230512,ANTH 105,A00,886964,Stewart; Alexander B,84,0,100,16
1746574231538,ANTH 108,A00,886965,Pedersen; David,9,0,20,11
1746574232568,AWP 10,001,886147,Staff,0,0,0,0
1746574232568,AWP 10,002,886148,Staff,0,0,0,0
1746574232568,AWP 10,003,886149,Staff,0,0,0,0
1746574232568,AWP 10,004,886150,Staff,0,0,0,0
1746574232568,AWP 10,005,886151,Staff,0,0,0,0
1746574232568,AWP 10,006,886152,Staff,0,0,0,0
1746574232568,AWP 10,007,886153,Staff,0,0,0,0
1746574232568,AWP 10,008,886154,Staff,0,0,0,0
1746574232568,AWP 10,009,886155,Staff,0,0,0,0
1746574232568,AWP 10,010,886156,Staff,0,0,0,0
1746574232568,AWP 10,011,886158,Staff,0,0,0,0
1746574232568,AWP 10,012,886160,Staff,0,0,0,0
1746574232568,AWP 10,013,886161,Staff,0,0,0,0
1746574232568,AWP 10,014,886162,Staff,0,0,0,0
1746574232568,AWP 10,015,886163,Staff,0,0,0,0
1746574232568,AWP 10,016,886164,Staff,0,0,0,0
1746574232568,AWP 10,017,886165,Staff,0,0,0,0
1746574232568,AWP 10,018,886166,Staff,0,0,0,0
1746574232568,AWP 10,019,886168,Staff,0,0,0,0
1746574232568,AWP 10,020,886170,Staff,0,0,0,0
1746574232568,AWP 10,021,886172,Staff,0,0,0,0
1746574233597,AWP 10R,001,886173,Staff,0,1,0,0
1746574233597,AWP 10R,002,886174,Staff,0,1,0,0
1746574233597,AWP 10R,003,886175,Staff,0,0,0,0
1746574233597,AWP 10R,004,886176,Staff,0,0,0,0
1746574233597,AWP 10R,005,886177,Staff,0,0,0,0
1746574233597,AWP 10R,006,886178,Staff,0,0,0,0
1746574233597,AWP 10R,007,886179,Staff,0,0,0,0
1746574233597,AWP 10R,008,886181,Staff,0,0,0,0
1746574233597,AWP 10R,009,886182,Staff,0,0,0,0
1746574233597,AWP 10R,010,886183,Staff,0,0,0,0
1746574233597,AWP 10R,011,886184,Staff,0,0,0,0
1746574233597,AWP 10R,012,886185,Staff,0,0,0,0
1746574233597,AWP 10R,013,886186,Staff,0,0,0,0
1746574233597,AWP 10R,014,886187,Staff,0,0,0,0
1746574233597,AWP 10R,015,886188,Staff,0,0,0,0
1746574233597,AWP 10R,016,886189,Staff,0,0,0,0
1746574233597,AWP 10R,017,960532,Staff,0,0,0,0
1746574233597,AWP 10R,018,960533,Staff,0,0,0,0
1746574233597,AWP 10R,019,960534,Staff,0,0,0,0
1746574233597,AWP 10R,020,960538,Staff,0,0,0,0
1746574233597,AWP 10R,021,960540,Staff,0,0,0,0
1746574233597,AWP 10R,022,960541,Staff,0,0,0,0
1746574233597,AWP 10R,023,960542,Staff,0,0,0,0
1746574233597,AWP 10R,024,960544,Staff,0,0,0,0
1746574233597,AWP 10R,025,960545,Staff,0,0,0,0
1746574233597,AWP 10R,026,960548,Staff,0,0,0,0
1746574234623,AWP 102R,A00,886190,Staff,0,0,0,0
1746574234623,AWP 102R,B00,886191,Staff,0,0,0,0
1746574235652,BENG 100,A01,886193,Staff,17,0,30,13
1746574236678,BENG 122A,A01,886195,Hasty; Jeff M,13,0,30,17
1746574237704,BENG 166A,A00,886196,Sah; Robert Lie-Yuan,0,2,30,30
1746574238730,BENG 190,A00,958050,Khojah; Reem I,20,0,25,5
1746574239754,BIBC 102,A01,894320,Staff,0,0,46,46
1746574239754,BIBC 102,A02,894321,Staff,0,0,46,46
1746574239754,BIBC 102,A03,894344,Staff,7,0,46,39
1746574239754,BIBC 102,A04,894345,Staff,27,0,47,20
1746574240789,BICD 100R,A01,894365,Smith; Laurie,0,3,58,58
1746574240789,BICD 100R,A02,894366,Smith; Laurie,0,5,58,58
1746574240789,BICD 100R,A03,894367,Smith; Laurie,0,0,59,59
1746574240789,BICD 100R,A04,959869,Smith; Laurie,40,0,59,19
1746574241815,BICD 136,A01,894383,Gustafson-Brown; Cindy,14,0,50,36
1746574242840,BIEB 102,A01,894494,Butler; Shannon Rhey,51,0,130,79
1746574244892,BIEB 150,A01,894617,Wills; Christopher,3,0,20,17
1746574244892,BIEB 150,A02,894631,Wills; Christopher,3,0,20,17
1746574244892,BIEB 150,A03,894937,Wills; Christopher,3,0,20,17
1746574244892,BIEB 150,A04,894946,Wills; Christopher,5,0,20,15
1746574245919,BIEB 194,A00,906141,Kurle; Carolyn M.,6,0,20,14
1746574246945,BILD 1,A01,894154,Staff,3,0,19,16
1746574246945,BILD 1,A02,894155,Staff,14,0,19,5
1746574246945,BILD 1,A03,894160,Staff,13,0,19,6
1746574246945,BILD 1,A04,894161,Staff,15,0,18,3
1746574247972,BILD 2,A01,894168,Staff,0,0,50,50
1746574247972,BILD 2,A02,894169,Staff,0,0,50,50
1746574247972,BILD 2,A03,894179,Staff,0,0,50,50
1746574247972,BILD 2,A04,894203,Staff,24,0,50,26
1746574248998,BILD 3,A01,894213,Staff,23,0,31,8
1746574248998,BILD 3,A02,894214,Staff,26,0,31,5
1746574248998,BILD 3,A03,894235,Staff,28,0,31,3
1746574248998,BILD 3,A04,894236,Staff,28,0,32,4
1746574250023,BILD 4,A01,894253,Reuther; Keefe,5,0,24,19
1746574250023,BILD 4,A02,894258,Reuther; Keefe,16,0,24,8
1746574251050,BILD 5,A01,894276,Reuther; Keefe,35,0,50,15
1746574251050,BILD 5,A02,894277,Reuther; Keefe,45,0,50,5
1746574251050,BILD 5,A03,894290,Reuther; Keefe,44,0,50,6
1746574251050,BILD 5,A04,894291,Reuther; Keefe,48,0,50,2
1746574252079,BILD 24,A01,894297,Pirino; Giorgia,40,0,60,20
1746574253104,BIMM 100,B01,958915,Staff,71,0,100,29
1746574254129,BIMM 101,A01,895017,McDonnell; Lisa Marie,0,5,24,24
1746574254129,BIMM 101,A02,895018,McDonnell; Lisa Marie,0,5,24,24
1746574254129,BIMM 101,B01,895020,McDonnell; Lisa Marie,0,6,24,24
1746574254129,BIMM 101,B02,895021,McDonnell; Lisa Marie,0,4,24,24
1746574255154,BIMM 110,A01,895023,Staff,1,0,25,24
1746574255154,BIMM 110,A02,895024,Staff,9,0,25,16
1746574255154,BIMM 110,A03,895025,Staff,18,0,25,7
1746574255154,BIMM 110,A04,895031,Staff,20,0,25,5
1746574256179,BIMM 120,A01,895114,Gustafson-Brown; Cindy,14,0,28,14
1746574256179,BIMM 120,A02,895126,Gustafson-Brown; Cindy,21,0,27,6
1746574257214,BIPN 100,A01,895130,Yang; Mingyu,0,0,38,38
1746574257214,BIPN 100,A02,895131,Yang; Mingyu,32,0,38,6
1746574257214,BIPN 100,A03,895132,Yang; Mingyu,32,0,38,6
1746574257214,BIPN 100,A04,895133,Yang; Mingyu,27,0,36,9
1746574258240,BIPN 120,A01,895135,Cooke; James Edward,0,3,13,13
1746574258240,BIPN 120,A02,895136,Cooke; James Edward,0,1,13,13
1746574258240,BIPN 120,A03,895137,Cooke; James Edward,0,3,13,13
1746574258240,BIPN 120,A04,895156,Cooke; James Edward,0,2,11,11
1746574259267,BIPN 134,A01,895235,Cooke; James Edward,0,2,25,25
1746574259267,BIPN 134,A02,895237,Cooke; James Edward,0,0,25,25
1746574259267,BIPN 134,A03,895240,Cooke; James Edward,3,0,25,22
1746574259267,BIPN 134,A04,895270,Cooke; James Edward,20,0,25,5
1746574260295,BIPN 189,A00,892103,Staff,0,14,14,14
1746574262352,BISP 194,A00,958008,Staff,0,2,0,0
1746574263379,CAT 124,A01,922009,Staff,0,5,20,20
1746574264406,CAT 125R,A00,886390,Morales; Celeste Georgianna,0,2,20,20
1746574264406,CAT 125R,B00,886391,Irwin; Matthew Joseph,0,4,20,20
1746574264406,CAT 125R,C00,886392,Smith; Lauryn Alissa,0,2,20,20
1746574264406,CAT 125R,D00,886393,Vanderschuit; Maya Alysia,0,3,20,20
1746574264406,CAT 125R,E00,886394,Marchisotto; Jennifer Anne,0,3,20,20
1746574265431,CENG 15,A01,886218,Drews; Aaron,3,0,8,5
1746574266461,CENG 113,A00,886219,Opatkiewicz; Justin Paul,15,0,25,10
1746574267484,CGS 101,A00,887044,Staff,7,0,20,13
1746574268515,CGS 105,A01,887046,Staff,14,0,25,11
1746574269541,CGS 112,A00,887047,Cuong; Marisol,12,0,15,3
1746574270566,CGS 113,A00,887048,Staff,23,0,30,7
1746574271592,CGS 120,A00,887049,Staff,10,0,17,7
1746574272618,CHEM 6A,A01,886336,Lam; Tin Yiu,38,0,50,12
1746574272618,CHEM 6A,A02,886338,Lam; Tin Yiu,37,0,50,13
1746574273644,CHEM 6B,A01,886341,Hopkins; Patrycja Anna,16,0,50,34
1746574273644,CHEM 6B,A02,886343,Hopkins; Patrycja Anna,42,0,50,8
1746574274669,CHEM 6C,A01,886346,Albizati; Kim F.,0,2,50,50
1746574274669,CHEM 6C,A02,886348,Albizati; Kim F.,23,0,50,27
1746574275694,CHEM 40A,A01,886352,Klosterman; Jeremy K,65,0,100,35
1746574276720,CHEM 40B,A01,886356,Klosterman; Jeremy K,0,23,100,100
1746574277746,CHEM 41B,A01,886360,Theodorakis; Emmanuel,25,0,50,25
1746574277746,CHEM 41B,A02,886362,Theodorakis; Emmanuel,47,0,50,3
1746574278775,CHIN 165A,A00,886382,Xu; Li,18,0,20,2
1746574279806,CLAS 120,A00,886387,Myerston Santana; Jacobo,33,0,40,7
1746574280833,COGS 9,A01,886967,Shannon; Kyle Michael,42,0,60,18
1746574281861,COGS 11,A01,886969,Staff,10,0,30,20
1746574282888,COGS 14A,A01,886971,Staff,6,0,60,54
1746574283916,COGS 14B,A01,886973,Hoffman; Drew Ellen,4,0,60,56
1746574284945,COGS 18,A01,886975,Morgan; Eric,35,0,60,25
1746574285970,COGS 20,A01,886977,Staff,4,0,8,4
1746574285970,COGS 20,A02,886978,Staff,5,0,7,2
1746574286997,COGS 100,A01,907783,Staff,1,2,30,29
1746574288023,COGS 101B,A01,886980,Staff,0,3,48,48
1746574289052,COGS 101C,A01,886982,Delgado; Tania,0,5,44,44
1746574290076,COGS 102A,A01,886984,Johnson; Christine M.,4,0,30,26
1746574291101,COGS 118B,A01,886986,Staff,1,4,88,87
1746574292127,COGS 150,A01,886988,Bergen; Benjamin,22,0,50,28
1746574293152,COGS 153,A00,886989,Delgado; Tania,0,2,41,41
1746574294178,COGS 186,A01,886991,Staff,0,0,32,32
1746574295204,COGS 187A,A01,886993,Boyle; Mary E. T.,7,0,30,23
1746574296230,COGS 189,A00,886994,Staff,0,1,30,30
1746574297256,COMM 10,A01,886996,Staff,0,0,20,21
1746574297256,COMM 10,A02,886997,Staff,11,0,20,9
1746574297256,COMM 10,A03,959845,Staff,19,0,20,1
1746574298285,COMM 20,A01,886999,Leuning; Grant Maurstad,24,0,40,16
1746574300342,COMM 100A,A01,887002,Staff,0,0,20,25
1746574300342,COMM 100A,A02,887003,Staff,6,0,20,14
1746574301369,COMM 100B,A01,887005,Staff,0,8,20,24
1746574302395,COMM 106D,A00,887006,Staff,13,0,40,27
1746574303421,COMM 110G,A00,887007,Whitworth-Smith; Andrew C,12,0,40,28
1746574304447,COMM 111B,A00,887008,Staff,31,0,40,9
1746574305472,COMM 113T,A00,887009,Abuelhiga; Soraya Jill,28,0,40,12
1746574305472,COMM 113T,B00,906733,Staff,40,0,40,0
1746574306496,COMM 145,A00,887010,Staff,12,0,40,28
1746574307521,COMM 146,A00,887054,Staff,31,0,40,9
1746574308546,COMM 190,A00,887012,Staff,8,0,23,15
1746574309573,CSE 8A,A50,887015,Cao; Yingjun,57,0,85,28
1746574310598,CSE 11,A01,887017,Cao; Yingjun,12,0,70,58
1746574311626,CSE 20,A01,887019,Staff,30,0,50,20
1746574312658,CSE 21,A01,887021,Staff,78,0,100,22
1746574312658,CSE 21,B01,892583,Braun; Oliver,45,0,50,5
1746574313688,CSE 30,A01,887025,Eldon; John,143,0,200,57
1746574314719,CSE 100,A01,887027,Staff,26,0,50,24
1746574314719,CSE 100,A02,887028,Staff,42,0,50,8
1746574315745,CSE 101,A01,887030,Braun; Oliver,74,0,100,26
1746574315745,CSE 101,B01,887032,Jones; Miles E,0,3,50,50
1746574315745,CSE 101,B02,887033,Jones; Miles E,0,2,50,50
1746574316771,CSE 105,A01,908084,Jones; Miles E,32,0,50,18
1746574316771,CSE 105,A02,908087,Jones; Miles E,31,0,50,19
1746574317801,CSE 135,A01,887035,Powell; Thomas Allan,0,5,50,50
1746574318830,CSE 142,A01,887037,Staff,8,0,60,52
1746574319855,CSE 142L,A01,887039,Staff,34,0,60,26
1746574320884,CSE 151A,A01,887041,Solares; Edwin A,47,0,100,53
1746574321911,CSE 175,A01,887043,Kumar; Rakesh,30,0,30,0
1746574322935,CSS 1,A01,886389,Staff,1,1,40,39
1746574323961,DSC 30,A01,908097,Liao; Soohyun Nam,47,0,75,28
1746574324986,DSC 40A,A01,908099,Shannon; Kyle Michael,30,0,50,20
1746574326016,DSC 40B,A01,908112,Staff,15,0,50,35
1746574327042,DSC 80,A01,908116,Staff,19,0,60,41
1746574328071,DSC 197,001,956863,Eldridge; Justin Matthew,9999,0,9999,0
1746574329096,ECE 5,A01,886400,Morris; Karcher William,1,0,6,5
1746574329096,ECE 5,A02,886401,Morris; Karcher William,3,0,6,3
1746574330121,ECE 148,A01,886403,Silberman; Jack,0,14,14,14
1746574331147,ECON 1,A01,887265,Crane; Meredith Helen,12,0,70,58
1746574331147,ECON 1,B01,887268,Staff,42,0,50,8
1746574332175,ECON 2,A01,887273,Crane; Meredith Helen,55,0,70,15
1746574333202,ECON 3,A01,887279,Rondina; Giacomo,32,0,70,38
1746574334231,ECON 4,A01,887282,Anderson; John Charles,0,2,10,10
1746574335257,ECON 5,A01,887285,Staff,34,0,45,11
1746574335257,ECON 5,B01,887292,Staff,41,0,45,4
1746574336283,ECON 100A,A01,887337,Newhouse; Herbert S,54,0,70,16
1746574336283,ECON 100A,B01,887349,Staff,45,0,50,5
1746574337311,ECON 100B,A01,887361,Du; Songzi,29,0,70,41
1746574338339,ECON 100C,A01,887445,Newhouse; Herbert S,59,0,70,11
1746574339363,ECON 105,A00,887488,Vespa; Emanuel Ignacio,23,0,35,12
1746574340392,ECON 109,A01,887506,Shishkin; Denis,28,0,35,7
1746574341424,ECON 110A,A01,887568,Alon; Titan Michael,0,3,35,35
1746574341424,ECON 110A,B01,907601,Alon; Titan Michael,20,0,35,15
1746574342450,ECON 110B,A01,887598,Levkoff; Steven B.,0,24,70,70
1746574343479,ECON 112,A00,887599,Rondina; Giacomo,19,0,35,16
1746574344504,ECON 120A,A01,887603,Dai; Yinlin,35,0,70,35
1746574345530,ECON 120C,A01,887608,Sun; Yixiao,0,1,35,35
1746574345530,ECON 120C,B01,887614,Sun; Yixiao,0,0,35,35
1746574346558,ECON 138,A00,887621,Bharadwaj; Prashant,0,21,20,20
1746574347583,ECON 144,A00,958007,Squires; Dale E,12,0,35,23
1746574348609,ECON 171,A01,907666,Staff,18,0,35,17
1746574349635,ECON 175,A00,887626,Wu; Pak Yeung,22,0,35,13
1746574350663,ECON 190,A00,887640,Vespa; Emanuel Ignacio,22,0,35,13
1746574351691,EDS 25,A01,888197,Staff,0,0,0,0
1746574351691,EDS 25,A02,888209,Staff,0,0,0,0
1746574351691,EDS 25,A03,888210,Staff,0,0,0,0
1746574351691,EDS 25,A04,888212,Staff,0,0,0,0
1746574351691,EDS 25,A05,888213,Staff,0,0,0,0
1746574351691,EDS 25,A06,888214,Staff,0,0,0,0
1746574351691,EDS 25,A07,888235,Staff,0,2,0,0
1746574351691,EDS 25,A08,888236,Staff,0,0,0,0
1746574351691,EDS 25,A09,888240,Staff,0,0,0,0
1746574351691,EDS 25,A10,888244,Staff,0,0,0,0
1746574351691,EDS 25,B01,888273,Staff,0,0,0,0
1746574351691,EDS 25,B02,888285,Staff,0,0,0,0
1746574351691,EDS 25,B03,888423,Staff,0,0,0,1
1746574351691,EDS 25,B04,888432,Staff,0,0,0,0
1746574351691,EDS 25,B05,888433,Staff,0,0,0,0
1746574351691,EDS 25,B06,888467,Staff,0,0,0,0
1746574351691,EDS 25,B07,888468,Staff,0,0,0,0
1746574351691,EDS 25,B08,888479,Staff,0,0,0,0
1746574351691,EDS 25,B09,888484,Staff,0,0,0,0
1746574351691,EDS 25,B10,888487,Staff,0,0,0,0
1746574352720,EDS 38,A01,907700,Choi; Bailey Miyeon,30,0,30,0
1746574353749,EDS 112,A01,888601,Chapman; Thandeka K,12,0,40,28
1746574354774,EDS 115,A00,888697,Mendez; Kathrina Mendoza,10,0,30,20
1746574355798,EDS 116,A01,888893,Staff,34,0,40,6
1746574357850,EDS 124AR,A00,889133,Staff,29,0,50,21
1746574357850,EDS 124AR,B00,907471,Simon; Elizabeth A,37,0,50,13
1746574358873,EDS 124BR,A00,889134,Simon; Elizabeth A,44,0,100,56
1746574359898,EDS 125,A00,889135,Staff,25,0,30,5
1746574360923,EDS 126,A01,889138,Staff,35,0,40,5
1746574361949,EDS 164R,A01,889142,Wishard Guerra; Alison G.,33,0,50,17
1746574362975,ENG 30,A01,886396,Staff,0,0,0,0
1746574362975,ENG 30,B01,886398,Staff,0,0,0,0
1746574364000,ENVR 102,A00,906150,Montejo; Carolina,23,0,25,2
1746574365029,ETHN 103A,A00,887236,Man; Simeon S,0,3,0,0
1746574366053,ETHN 113,A00,887239,Staff,16,0,30,14
1746574367082,ETHN 116,A00,887240,Staff,16,0,25,9
1746574368112,ETHN 117,A00,887241,Choi; Esther Min,28,0,30,2
1746574369138,ETHN 118,A00,887243,Staff,24,0,30,6
1746574370167,ETHN 127,A00,887248,Cuong; Marisol,11,0,15,4
1746574371193,ETHN 139,A00,887250,Staff,7,0,10,3
1746574372218,ETHN 142,A00,887252,Staff,10,0,30,20
1746574373242,ETHN 161,A00,887253,Browne; Errol Tsekani,24,0,30,6
1746574374268,ETHN 163FR,A00,887255,Burelle; Julie Sara Veronique,0,0,5,5
1746574375292,GLBH 20,A00,889149,Elwardani; Nile Regina,8,0,42,34
1746574377346,GLBH 111,A01,889152,Burgos; Jose L.,17,0,17,0
1746574378377,GLBH 150,A00,889181,Sloane; Julia Kathryn,0,5,15,15
1746574380427,HDS 60,A01,886406,Warstadt; Melissa Fawn,73,0,80,7
1746574381453,HIAF 111,A00,889324,Gyamfi; Bright,25,0,32,7
1746574382476,HIEA 131,A00,889328,Staff,15,0,32,17
1746574383501,HIEA 144,A00,889333,Henry; Todd A.,26,0,32,6
1746574384526,HIEA 154,A00,889336,Henry; Todd A.,24,0,32,8
1746574385551,HIEU 106,A00,889339,Staff,22,0,32,10
1746574387602,HIEU 114,A00,889340,Staff,4,0,32,28
1746574388630,HIEU 135GS,A00,889342,Patterson; Patrick H.,0,0,1,24
1746574389658,HIEU 137,A00,889343,Edington; Claire Ellen,10,0,25,15
1746574390681,HIEU 148,A00,889345,Staff,14,0,32,18
1746574391708,HIEU 154,A00,889346,Biess; Frank Peter,21,0,32,11
1746574392736,HILA 102,A00,889351,Staff,12,0,32,20
1746574393762,HILD 2A,A01,889221,Lewandoski; Julia Mavis,1,10,32,31
1746574394786,HILD 7B,A01,889225,Man; Simeon S,0,12,32,32
1746574395815,HILD 7C,A01,889288,Alvarez; Luis A,0,14,32,32
1746574396843,HILD 30,A01,889323,Staff,0,5,32,32
1746574398891,HISC 119,A00,889383,Golan; Tal,19,0,32,13
1746574399919,HIUS 103,A00,889384,Man; Simeon S,0,0,32,32
1746574400944,HIUS 117,A00,919797,Kwak; Nancy,19,0,32,13
1746574401972,HIUS 142A,A00,919788,Staff,22,0,32,10
1746574404022,HIUS 149,A00,889386,Gyamfi; Bright,26,0,32,6
1746574405052,HIUS 155,A00,889387,Alvarez; Luis A,15,0,32,17
1746574406079,HUM 3,A01,886499,Caldwell; Michael Alan,19,0,50,31
1746574407108,HUM 3GS,A00,886500,Rodriguez; Bretton Sigfred,0,0,0,28
1746574408136,HUM 3R,A01,886502,Markman; Kristina,0,36,50,50
1746574409160,HUM 4,A01,886504,Crum; Matthew Stephen,23,0,50,27
1746574409160,HUM 4,B01,886506,West; Geoffrey Scott,17,0,50,33
1746574410188,HUM 4GS,A00,886507,Staff,0,0,0,19
1746574411213,HUM 5,A01,886509,Staff,32,0,50,18
1746574412240,HUM 5R,A01,886511,Zavodny; Tatiana Sophia,0,39,50,50
1746574413265,JAPN 180,A00,886407,Staff,16,0,40,24
1746574414290,LATI 50,A01,886409,Martin-Cabrera; Luis,4,0,22,18
1746574414290,LATI 50,A02,886410,Martin-Cabrera; Luis,19,0,22,3
1746574414290,LATI 50,A03,886411,Martin-Cabrera; Luis,21,0,22,1
1746574414290,LATI 50,A04,886412,Martin-Cabrera; Luis,9,0,22,13
1746574415317,LAWS 101,A00,907664,Staff,28,0,60,32
1746574416342,LIAB 1A,A00,889388,Saab; Dima,17,0,20,3
1746574417367,LIAB 1AX,A00,889389,El Cheddadi; Youniss,18,0,20,2
1746574418392,LIFR 1C,A00,889391,Van Moer; Vinciane G,8,0,20,12
1746574419419,LIFR 1CX,A00,889392,Van Moer; Vinciane G,7,0,20,13
1746574420443,LIFR 1D,A00,889393,Van Moer; Vinciane G,7,0,20,13
1746574421468,LIFR 1DX,A00,889394,Van Moer; Vinciane G,8,0,20,12
1746574422497,LIGN 7,A00,886923,Staff,24,0,50,26
1746574423522,LIGN 17,A00,886924,Kehler; Andrew Scott,125,0,150,25
1746574424550,LTAM 110,A00,889395,Staff,15,0,30,15
1746574425576,LTAM 110GS,A00,958010,Rodriguez; Bretton Sigfred,0,0,0,28
1746574426599,LTCH 101,A00,889397,Staff,23,0,25,2
1746574427626,LTCS 130,A00,889398,Staff,23,0,25,2
1746574428655,LTEA 138,A00,889399,Staff,24,0,40,16
1746574429681,LTEN 149,A00,889400,Wesling; Megan E.,0,3,25,25
1746574430709,LTEN 169,A00,889401,Staff,20,0,25,5
1746574431737,LTEN 180,A00,889402,Staff,10,0,15,5
1746574432765,LTEN 181,A00,889403,Staff,21,0,25,4
1746574433790,LTWL 100,A00,889404,Myerston Santana; Jacobo,2,0,25,23
1746574434817,LTWL 180GS,A00,889405,Staff,0,0,20,20
1746574435842,LTWL 181,A00,889406,Staff,16,0,25,9
1746574436870,LTWL 184,A00,889475,Mukherjee; Silpa,22,0,25,3
1746574437899,LTWR 102C,A00,889486,Staff,29,0,30,1
1746574438923,LTWR 115W,A00,889491,Staff,0,2,15,15
1746574439949,MAE 8,A01,886905,Staff,0,2,0,0
1746574440975,MAE 11,A00,886906,Bandaru; Prabhakar,0,7,50,50
1746574442004,MAE 20,A00,886907,Evdokimenko; Ekaterina,43,0,70,27
1746574443030,MAE 30B,A00,886909,Ghazinejad; Maziar,26,0,45,19
1746574444054,MAE 101B,A00,886910,Saintillan; David,29,0,45,16
1746574445079,MAE 105,A00,886911,Bandaru; Prabhakar,18,0,50,32
1746574446110,MAE 107,B00,958024,Staff,8,0,50,42
1746574447136,MAE 143B,A00,886913,Bewley; Thomas R,4,0,40,36
1746574448165,MAE 148,A01,886915,Silberman; Jack,0,3,14,14
1746574449193,MAE 160,A00,886916,Evdokimenko; Ekaterina,31,0,60,29
1746574450220,MATH 3C,A01,889681,Staff,0,2,30,30
1746574450220,MATH 3C,A02,960048,Staff,24,0,30,6
1746574451244,MATH 10A,A01,889760,Staff,26,0,30,4
1746574451244,MATH 10A,A02,889783,Staff,29,0,30,1
1746574452271,MATH 10B,A01,889785,Verstraete; Jacques Allan,2,0,35,33
1746574452271,MATH 10B,A02,889795,Verstraete; Jacques Allan,4,0,35,31
1746574452271,MATH 10B,B01,889797,Verstraete; Jacques Allan,3,0,35,32
1746574452271,MATH 10B,B02,889828,Verstraete; Jacques Allan,3,0,35,32
1746574453304,MATH 10C,A01,889849,Habib; Yousaf,7,0,30,23
1746574453304,MATH 10C,A02,889852,Habib; Yousaf,14,0,30,16
1746574453304,MATH 10C,A03,889853,Habib; Yousaf,22,0,30,8
1746574453304,MATH 10C,A04,889858,Habib; Yousaf,20,0,30,10
1746574453304,MATH 10C,B01,889861,Staff,1,0,30,29
1746574453304,MATH 10C,B02,889862,Staff,24,0,30,6
1746574453304,MATH 10C,B03,889863,Staff,27,0,30,3
1746574453304,MATH 10C,B04,889967,Staff,23,0,30,7
1746574454329,MATH 18,A01,889974,Staff,7,0,30,23
1746574454329,MATH 18,A02,889977,Staff,20,0,30,10
1746574454329,MATH 18,B01,889984,Hardiman; Liam,21,0,30,9
1746574454329,MATH 18,B02,889985,Hardiman; Liam,25,0,30,5
1746574455354,MATH 20A,A01,889990,Suk; Andrew Hoon,30,0,35,5
1746574456378,MATH 20B,A01,889993,Ohm; Ko Woon,22,0,30,8
1746574456378,MATH 20B,A02,889994,Ohm; Ko Woon,30,0,30,0
1746574456378,MATH 20B,B01,889996,Ohm; Ko Woon,22,0,30,8
1746574456378,MATH 20B,B02,889997,Ohm; Ko Woon,23,0,30,7
1746574457409,MATH 20C,A01,889999,Hammock; Frances H,17,0,30,13
1746574457409,MATH 20C,A02,890003,Hammock; Frances H,23,0,30,7
1746574457409,MATH 20C,B01,890006,Hammock; Frances H,3,0,30,27
1746574457409,MATH 20C,B02,890007,Hammock; Frances H,12,0,30,18
1746574458439,MATH 20D,A01,890011,Cheng; Hsiao-Bing,1,1,30,29
1746574458439,MATH 20D,A02,890012,Cheng; Hsiao-Bing,14,0,30,16
1746574458439,MATH 20D,B01,890016,Cheng; Hsiao-Bing,13,0,30,17
1746574458439,MATH 20D,B02,890017,Cheng; Hsiao-Bing,13,0,30,17
1746574459466,MATH 20E,A01,890026,Harel; Guershon,1,0,30,29
1746574459466,MATH 20E,A02,890029,Harel; Guershon,23,0,30,7
1746574459466,MATH 20E,B01,890033,Harel; Guershon,7,0,30,23
1746574459466,MATH 20E,B02,890101,Harel; Guershon,21,0,30,9
1746574460491,MATH 102,A01,890104,Staff,17,0,30,13
1746574460491,MATH 102,A02,890105,Staff,27,0,30,3
1746574461516,MATH 103B,A01,890116,Salehi Golsefidy; Alireza,3,0,30,27
1746574461516,MATH 103B,B01,890118,Staff,0,3,34,34
1746574462543,MATH 109,A01,890121,Aliabadi Sr.; Mohsen,1,0,30,29
1746574462543,MATH 109,B01,890124,Upadrashta; Pranav Kumar,18,0,30,12
1746574463570,MATH 120A,A01,890126,Eggers; John Dietrich,13,0,30,17
1746574464596,MATH 142B,A01,890128,Ioana; Adrian,19,0,30,11
1746574464596,MATH 142B,A02,890129,Ioana; Adrian,13,0,30,17
1746574465621,MATH 154,A01,890174,Staff,0,0,30,30
1746574465621,MATH 154,A02,890182,Staff,0,0,30,30
1746574466647,MATH 168A,A01,890197,Dumitriu; Ioana,21,0,35,14
1746574467676,MATH 170A,A01,890240,Nie; Jiawang,1,0,30,29
1746574467676,MATH 170A,A02,890241,Nie; Jiawang,11,0,30,19
1746574467676,MATH 170A,A03,890249,Nie; Jiawang,23,0,30,7
1746574468703,MATH 170B,A01,957891,Nag; Panchali,13,0,35,22
1746574470785,MATH 181A,A01,908025,Staff,0,3,35,35
1746574470785,MATH 181A,A02,960115,Staff,26,0,35,9
1746574471812,MATH 181B,A01,959874,Staff,25,0,30,5
1746574472844,MATH 193B,A01,890265,Staff,0,4,35,35
1746574473869,MGT 4,A01,890311,Anderson; John Charles,42,0,88,46
1746574474895,MGT 5,A00,907740,Staff,13,0,98,85
1746574475920,MGT 12,A00,890312,Lindenberger; Wade Douglas,67,0,98,31
1746574476945,MGT 16,A00,957883,Staff,78,0,98,20
1746574478996,MGT 45,A00,890314,Pecore; Joseph P.,45,0,98,53
1746574480023,MGT 71,A00,890315,Staff,0,11,98,98
1746574481049,MGT 100,A00,890316,Yavorsky; Daniel Ryan,44,0,98,54
1746574482073,MGT 103,A00,890317,Ehrich; Kristine R,73,0,98,25
1746574483101,MGT 105,A00,890356,Bates; Kenneth Walter,0,8,98,98
1746574484129,MGT 112,A00,890360,Ehrich; Kristine R,55,0,98,43
1746574485154,MGT 127R,A00,907732,Zhu; Kevin Xiaoguo,23,0,98,75
1746574486177,MGT 131B,A00,890361,Anderson; John Charles,60,0,98,38
1746574487205,MGT 137,A00,890362,Lindenberger; Wade Douglas,65,0,98,33
1746574488232,MGT 160,A00,890369,Johnson; Erik Barry,9,0,98,89
1746574490286,MGT 164,A00,890372,Zimmermann; Carsten,0,40,98,98
1746574491312,MGT 180,A00,890374,Bliss; Barbara Ann,12,0,98,86
1746574492338,MMW 15,A01,886414,Chang; Edmond Yi-Teh,0,12,28,28
1746574492338,MMW 15,A02,886415,Chang; Edmond Yi-Teh,0,8,28,28
1746574492338,MMW 15,A03,886416,Chang; Edmond Yi-Teh,0,9,28,28
1746574492338,MMW 15,A04,886417,Chang; Edmond Yi-Teh,0,8,28,28
1746574492338,MMW 15,B01,886419,Chang; Edmond Yi-Teh,0,7,28,28
1746574492338,MMW 15,B02,886420,Chang; Edmond Yi-Teh,0,8,28,28
1746574492338,MMW 15,B03,886421,Chang; Edmond Yi-Teh,0,7,28,28
1746574492338,MMW 15,B04,886422,Chang; Edmond Yi-Teh,0,8,28,28
1746574492338,MMW 15,C01,886424,Staff,0,9,28,28
1746574492338,MMW 15,C02,886425,Staff,0,8,28,28
1746574492338,MMW 15,C03,886426,Staff,0,8,28,28
1746574492338,MMW 15,C04,886427,Staff,0,8,28,28
1746574492338,MMW 15,C05,958038,Staff,0,8,28,28
1746574492338,MMW 15,C06,958039,Staff,1,8,28,27
1746574493363,MMW 15GS,A00,906910,Patterson; Patrick H.,4,0,28,24
1746574494389,MMW 122R,A01,886429,Rahimi; Babak,0,13,28,28
1746574494389,MMW 122R,A02,886430,Rahimi; Babak,0,12,28,28
1746574494389,MMW 122R,A03,958040,Rahimi; Babak,0,11,28,28
1746574495430,MUS 1A,A01,890937,Staff,2,0,25,23
1746574495430,MUS 1A,A02,891035,Staff,6,0,25,19
1746574495430,MUS 1A,C01,958912,Staff,24,0,25,1
1746574495430,MUS 1A,C02,958913,Staff,25,0,25,0
1746574497480,MUS 2AK,A00,957092,Ohnishi; Takae,15,0,15,0
1746574498510,MUS 4,A01,891044,Staff,1,0,25,24
1746574498510,MUS 4,A02,891045,Staff,23,0,25,2
1746574498510,MUS 4,B01,891048,Staff,17,0,25,8
1746574498510,MUS 4,B02,891050,Staff,25,0,25,0
1746574499535,MUS 5,A01,957506,Dubnov; Shlomo,0,0,25,25
1746574499535,MUS 5,A02,957622,Dubnov; Shlomo,13,0,25,12
1746574499535,MUS 5,A03,957623,Dubnov; Shlomo,20,0,25,5
1746574500559,MUS 6,A01,891053,Freitas Caetano; Marcelo,24,0,25,1
1746574500559,MUS 6,A02,891054,Freitas Caetano; Marcelo,23,0,25,2
1746574501587,MUS 7,A01,891081,Staff,1,0,25,24
1746574501587,MUS 7,A02,891082,Staff,3,0,25,22
1746574502615,MUS 8GS,A00,891118,Borgo; David Garcia,1,0,25,24
1746574503643,MUS 11,A01,891140,Staff,9,0,25,16
1746574503643,MUS 11,A02,891141,Staff,22,0,25,3
1746574504672,MUS 13,A01,891143,Staff,8,0,25,17
1746574504672,MUS 13,A02,891144,Staff,24,0,25,1
1746574505699,MUS 15,A01,891146,Staff,9,0,25,16
1746574505699,MUS 15,A02,891148,Staff,21,0,25,4
1746574505699,MUS 15,B01,891150,Staff,18,0,25,7
1746574505699,MUS 15,B02,891151,Staff,25,0,25,0
1746574506727,MUS 20,A01,891153,Staff,5,0,20,15
1746574506727,MUS 20,A02,891155,Staff,14,0,20,6
1746574507756,MUS 80,A00,891156,Staff,19,0,25,6
1746574507756,MUS 80,B00,891157,Staff,23,0,25,2
1746574508784,MUS 130,A00,891158,Ohnishi; Takae,35,0,35,0
1746574509811,MUS 150GS,A01,891160,Borgo; David Garcia,1,0,25,24
1746574510836,MUS 170,A01,891162,Freitas Caetano; Marcelo,20,0,25,5
1746574510836,MUS 170,A02,891164,Freitas Caetano; Marcelo,21,0,25,4
1746574511860,NANO 11,A00,886220,Vazquez Mena; Oscar,13,0,15,2
1746574512912,NANO 15,A01,886222,Drews; Aaron,4,0,7,3
1746574513938,NANO 104,A00,886224,Sirbuly; Donald,17,0,25,8
1746574514963,PH 40,A00,886528,Staff,24,0,40,16
1746574515988,PH 45,A01,886799,Staff,35,0,40,5
1746574517012,PH 110,A00,886802,Staff,0,7,40,40
1746574518036,PH 172,A00,906716,Staff,19,0,35,16
1746574519065,PH 191,A00,886803,Staff,6,0,40,34
1746574520090,PHIL 1,A00,889500,Staff,20,0,30,10
1746574521118,PHIL 10,A01,889549,Grush; Rick Scott,16,0,22,6
1746574521118,PHIL 10,A02,889551,Grush; Rick Scott,22,0,22,0
1746574522150,PHIL 28,A01,889559,Lamey; Andy M.,0,2,31,31
1746574522150,PHIL 28,A02,889561,Lamey; Andy M.,0,1,30,30
1746574522150,PHIL 28,A03,889572,Lamey; Andy M.,0,1,30,30
1746574523175,PHIL 35,A00,907839,Staff,13,0,15,2
1746574524199,PHIL 60,A00,889574,Staff,73,0,90,17
1746574525224,PHIL 101,A00,958004,Staff,12,0,15,3
1746574527277,PHIL 136,A00,889582,Fulkerson; Matthew Todd,26,0,45,19
1746574528303,PHIL 163,A01,889601,Staff,21,0,30,9
1746574528303,PHIL 163,B01,889606,Brandt; Reuven A,0,3,0,0
1746574529328,PHIL 164,A00,889610,Staff,16,0,30,14
1746574530356,PHIL 165,A00,889613,Staff,22,0,30,8
1746574531385,PHYS 1A,A00,886431,Staff,26,0,70,44
1746574532410,PHYS 1AL,001,886432,Tsai; Philbert S,0,2,30,30
1746574532410,PHYS 1AL,002,886436,Tsai; Philbert S,11,0,30,19
1746574533438,PHYS 1B,A00,886439,Staff,185,0,240,55
1746574534466,PHYS 1BL,001,886441,Tsai; Philbert S,0,4,30,30
1746574534466,PHYS 1BL,002,886444,Tsai; Philbert S,2,0,30,28
1746574535493,PHYS 1C,A00,896092,Arnold; Kam S,78,0,146,68
1746574536525,PHYS 1CL,001,886448,Tsai; Philbert S,0,0,30,30
1746574536525,PHYS 1CL,002,886449,Tsai; Philbert S,1,0,30,29
1746574536525,PHYS 1CL,003,886450,Tsai; Philbert S,16,0,30,14
1746574536525,PHYS 1CL,004,886451,Tsai; Philbert S,15,0,30,15
1746574537551,PHYS 2B,A01,886457,Staff,68,0,115,47
1746574538577,PHYS 2C,A01,886460,Shotwell; Brian,0,9,65,65
1746574539606,PHYS 2CL,A01,886467,Staff,0,4,28,28
1746574539606,PHYS 2CL,A02,886468,Staff,0,3,28,28
1746574540637,PHYS 2D,A01,886470,Staff,10,0,50,40
1746574541668,PHYS 4B,A01,886475,Grinstein; Benjamin,22,0,40,18
1746574542693,POLI 5,A00,891173,Desposato; Scott,7,0,25,18
1746574543718,POLI 5D,A01,891175,Staff,5,0,5,0
1746574543718,POLI 5D,B01,891178,Staff,5,0,5,0
1746574544747,POLI 11,A00,891179,Ferree; Karen E,2,0,35,33
1746574545771,POLI 12,A00,891180,Staff,16,0,30,14
1746574546797,POLI 27,A01,891182,Staff,12,0,75,63
1746574547823,POLI 30,A00,891183,Staff,8,0,50,42
1746574548851,POLI 100B,A00,891244,Staff,5,1,35,30
1746574549879,POLI 100I,A00,891247,Staff,7,0,30,23
1746574550904,POLI 104J,A00,891248,Nichter; Maysa,14,0,30,16
1746574551927,POLI 104U,A00,891250,Nichter; Maysa,1,0,30,29
1746574553980,POLI 110B,A00,891255,Wiens; David,19,0,25,6
1746574555009,POLI 112A,A00,891256,Wiens; David,6,0,25,19
1746574556039,POLI 114BR,A00,891261,Staff,19,0,30,11
1746574557064,POLI 117R,A00,891262,Forman; Fonna,0,6,50,50
1746574558090,POLI 118,A00,891264,Ingham; Sean,17,0,25,8
1746574559119,POLI 124A,A00,891265,Staff,18,0,20,2
1746574560145,POLI 125D,A00,891266,Nichter; Simeon C,2,0,25,23
1746574561174,POLI 126,A00,891268,Nichter; Simeon C,7,0,25,18
1746574562204,POLI 126AA,A00,891272,Staff,15,0,25,10
1746574563228,POLI 130AA,A00,891273,Staff,15,0,20,5
1746574564253,POLI 134AA,A00,891274,Staff,4,0,20,16
1746574566307,POLI 138,A00,891278,Staff,21,0,25,4
1746574567333,POLI 142K,A00,891280,Staff,10,0,25,15
1746574568361,POLI 142M,A00,891281,Gartzke; Erik,16,0,30,14
1746574569389,POLI 142P,A00,891284,Staff,20,0,30,10
1746574570418,POLI 143,A00,891285,Gartzke; Erik,12,0,30,18
1746574571445,POLI 153,A00,891286,Staff,19,0,20,1
1746574573497,POLI 175,A00,891290,Staff,15,0,20,5
1746574574526,PSYC 1,A00,890674,Steiner; Eric Tomas,0,11,45,45
1746574575553,PSYC 2,A00,890676,Albright; Thomas D,21,0,35,14
1746574576580,PSYC 3,A00,890679,Staff,17,0,20,3
1746574577607,PSYC 6,A00,959858,Staff,20,0,20,0
1746574578633,PSYC 60,A01,890684,Rickard; Timothy C.,0,5,45,45
1746574579661,PSYC 70,A01,890689,Geller; Emma Harlan,7,0,30,23
1746574580688,PSYC 71,A01,959860,Staff,21,0,25,4
1746574581716,PSYC 100,A00,890690,Lacefield; Katharine I,0,50,180,180
1746574582742,PSYC 102,A00,890695,Staff,18,0,40,22
1746574583770,PSYC 105,A00,890699,Geller; Emma Harlan,70,0,100,30
1746574584795,PSYC 106,A00,890701,Gorman; Michael R.,6,0,30,24
1746574585819,PSYC 108,A00,890704,Adrian; Julia Anna,0,28,50,50
1746574586845,PSYC 118,A01,890712,Staff,11,0,30,19
1746574587872,PSYC 124,A00,890716,Chapman; Eddie Nathaniel,25,0,60,35
1746574588899,PSYC 131,A00,890717,Anagnostaras; Stephan,0,8,80,80
1746574589925,PSYC 137,A00,890719,Winkielman; Piotr,0,11,30,30
1746574590951,PSYC 144,A00,890721,Adrian; Julia Anna,0,9,45,45
1746574591975,PSYC 162,A00,890805,Staff,0,0,75,75
1746574593000,PSYC 169,A00,890810,Staff,0,14,30,30
1746574594027,PSYC 172,A00,890814,Gorman; Michael R.,9,0,30,21
1746574595054,PSYC 181,A00,890818,Anagnostaras; Stephan,9,0,200,191
1746574596079,PSYC 184,A00,959861,Staff,168,0,175,7
1746574597102,PSYC 189,A00,890823,Staff,0,2,30,30
1746574598131,PSYC 191,A00,890884,Rickard; Timothy C.,0,12,35,35
1746574599156,PSYC 193,A00,890913,Staff,19,0,30,11
1746574599156,PSYC 193,B00,890914,Chapman; Eddie Nathaniel,24,0,30,6
1746574600180,PSYC 193L,A01,890918,Lowe; Angela Beth,20,0,30,10
1746574600180,PSYC 193L,B01,890921,Hurwitz; Ethan Scott,20,0,30,10
1746574600180,PSYC 193L,C01,890928,Staff,30,0,30,0
1746574601207,RELI 149,A00,886806,Rahimi; Babak,23,0,40,17
1746574602233,SE 9,A01,886814,Staff,7,0,20,13
1746574603261,SE 101B,A01,886816,Chadha; Mayank,4,0,35,31
1746574604285,SE 110B,A00,886818,Zhu; Qiang,4,0,75,71
1746574605310,SE 125,A01,886830,Staff,10,0,30,20
1746574606334,SE 130B,A01,886835,Staff,14,0,40,26
1746574607364,SE 131A,A01,886838,Krysl; Petr,34,0,55,21
1746574608390,SE 154,A00,886840,Staff,29,0,50,21
1746574609416,SE 164GS,A01,886849,Staff,6,0,20,14
1746574610443,SE 167GS,A01,886853,Staff,6,0,20,14
1746574611470,SIO 25,A01,890107,Staff,19,0,30,11
1746574612499,SIO 45,A00,890109,Cook; Geoffrey W,117,0,200,83
1746574613523,SIO 109R,A00,890110,Forman; Fonna,0,16,20,20
1746574614547,SIO 187,A01,890114,Kacev; David,15,0,40,25
1746574615572,SOCI 1,A01,890431,Thorpe; Charles Robert,14,0,30,16
1746574615572,SOCI 1,A02,890518,Thorpe; Charles Robert,30,0,30,0
1746574616598,SOCI 2,A01,957978,Staff,25,0,25,0
1746574616598,SOCI 2,A02,957979,Staff,23,0,25,2
1746574617625,SOCI 20,A01,890523,Calderon-Zaks; Michael Aar,21,0,30,9
1746574617625,SOCI 20,A02,890526,Calderon-Zaks; Michael Aar,29,0,30,1
1746574618650,SOCI 30,A01,890533,Pardo Guerra; Juan Pablo,37,0,40,3
1746574619675,SOCI 40,A01,890535,Staff,27,0,45,18
1746574620701,SOCI 104Q,A00,890559,Staff,18,0,30,12
1746574621729,SOCI 106,A00,890560,Arnal; Maud Marie Leonie,20,0,30,10
1746574622757,SOCI 110,A00,890567,Holkenbrink-Monk; Charlene,19,0,30,11
1746574623783,SOCI 112,A00,890568,Victoria Torres; Pablo,2,0,55,53
1746574624809,SOCI 115,A00,890597,Arnal; Maud Marie Leonie,28,0,45,17
1746574626858,SOCI 121,A00,890604,Pardo Guerra; Juan Pablo,38,0,45,7
1746574627883,SOCI 126,A01,890608,Staff,8,0,10,2
1746574628909,SOCI 127,A00,890609,Staff,18,0,30,12
1746574629934,SOCI 131,A00,890610,Thorpe; Charles Robert,37,0,45,8
1746574630959,SOCI 135,A00,890615,Payne; Christine Anna,13,0,45,32
1746574631987,SOCI 139,A00,890620,Staff,38,0,45,7
1746574633015,SOCI 148E,A00,890622,Calderon-Zaks; Michael Aar,36,0,45,9
1746574634039,SOCI 150,A00,890623,Kohler; Kristopher M.,31,0,45,14
1746574635064,SOCI 157,A00,890625,Jules-Rosette; Bennetta W.,18,0,20,2
1746574636090,SOCI 160,A00,890627,Payne; Christine Anna,21,0,45,24
1746574637118,SYN 1,A00,886855,Fish; Gwendolyn Anne,0,1,0,0
1746574637118,SYN 1,B00,906086,Fish; Gwendolyn Anne,0,2,0,2
1746574638141,SYN 2R,A00,886860,Staff,0,17,15,15
1746574638141,SYN 2R,B00,906106,Atkinson; Arthur Laird,0,16,15,15
1746574639168,SYN 100,A01,886866,Browne; Emily,0,28,20,20
1746574639168,SYN 100,B01,906128,Rock; Martin,0,5,20,20
1746574639168,SYN 100,C01,906140,Deavenport; James Cary,0,3,20,20
1746574639168,SYN 100,D01,907816,Deavenport; James Cary,0,5,20,20
1746574640193,TDAC 1,A00,890286,Walsh; Kim C.,8,0,20,12
1746574641222,TDAC 101,A00,890296,Basso; Beatrice,15,0,20,5
1746574642249,TDDE 131,A00,890297,Staff,47,0,50,3
1746574643280,TDDM 1,A00,890287,Weinberg; Sadie,25,0,30,5
1746574644306,TDGE 11,A00,890288,Fulton; Julia,138,0,200,62
1746574644306,TDGE 11,B00,890289,Castro; Robert Jess,184,0,200,16
1746574645330,TDGE 25,B00,957359,Walsh; Kim C.,5,0,20,15
1746574646354,TDGE 40,A01,890292,Power; Jade Yukana,27,0,30,3
1746574647382,TDGE 124,A00,890298,Havis; Allan,0,1,50,50
1746574648410,TDGE 131R,A00,890299,Burelle; Julie Sara Veronique,15,0,42,27
1746574649435,TDHT 101,A00,890300,Staff,10,0,20,10
1746574650465,TDHT 109,A01,890302,Anderson; Mysia Anyse,31,0,40,9
1746574651492,TDMV 1,A00,890293,Arcidiacono; Kristin,18,0,30,12
1746574652517,TDMV 2,A00,890294,Weinberg; Sadie,23,0,30,7
1746574653545,TDMV 3,A00,957878,Arcidiacono; Kristin,28,0,30,2
1746574655649,TDMV 138,A00,890304,Jun; Grace Shin Hae,25,0,40,15
1746574656674,TDMV 140,A00,890305,Corrales; Joseph Bernales,25,0,30,5
1746574657699,TDMV 142,A00,890307,Caligagan; Tony,32,0,40,8
1746574658725,TDMV 144,A00,890308,Camaya; Michelle Ann,25,0,30,5
1746574659754,TDPW 1,A00,890295,Stein; Deborah Isobel,3,0,20,17
1746574660779,USP 2,A01,890272,Lerner; Amy M,7,0,20,13
1746574661806,USP 3,A01,890274,Staff,12,0,30,18
1746574662833,USP 15,A01,890276,Sun; Feiyang,16,0,30,14
1746574663858,USP 25,A00,890277,Shenkman; Michael Thomas,18,0,25,7
1746574664881,USP 138,A00,890278,Staff,14,0,25,11
1746574665908,USP 143,A00,890279,Staff,22,0,70,48
1746574666934,USP 144,A00,890280,Chowdhury; Muhammed Zohir,16,0,30,14
1746574667959,USP 150,A00,890281,Boomhower; Matthew Charles,4,0,30,26
1746574668986,USP 151,A00,890282,Staff,16,0,20,4
1746574670011,USP 162,A00,890283,Andrews; Abigail Leslie,16,0,20,4
1746574671040,USP 168,A00,920477,Kwak; Nancy,0,0,5,5
1746574672071,USP 181,A00,890284,Staff,3,0,20,17
1746574673098,USP 191A,A00,890285,Staff,12,0,20,8
1746574674125,VIS 101,A00,886512,Staff,26,0,75,49
1746574675149,VIS 103,A00,886513,Cruz; Edwin Teddy,61,0,75,14
1746574676177,VIS 108,A00,886514,Staff,3,0,15,12
1746574677202,VIS 127P,A00,886515,Shen; Kuiyi,80,0,146,66
1746574678228,VIS 149,A00,886516,Yoldas; Pinar,0,0,15,15
1746574679258,VIS 164,A00,886526,Erdmann; Dean,19,0,22,3
1746574680283,VIS 194S,A00,886527,Staff,61,0,75,14
1746574681308,WCWP 10A,C00,886484,Martiniuk; Jill,12,0,15,3
1746574682340,WCWP 10B,A00,886490,Uriarte; Emma,0,0,15,15
1746574682340,WCWP 10B,B00,886491,Dhir; Simrita,9,0,15,6
1746574682340,WCWP 10B,C00,886492,Ornelas; Tricia,0,0,15,15
1746574683369,WCWP 100,A00,886494,Young; Mark T,0,6,15,15
1746574685450,AAS 10,A01,886199,Childs; Dennis R.,0,3,0,0
1746574686476,ANAR 104,A01,886940,Shtienberg; Gilad,27,0,30,3
1746574687501,ANAR 120,A00,886953,Staff,12,0,20,8
1746574688529,ANBI 148,A01,886955,Wilder; Linnea Lorene,30,0,40,10
1746574690590,ANSC 122,A00,886957,Staff,25,0,30,5
1746574691616,ANSC 150,A00,886958,Sloane; Julia Kathryn,2,0,15,13
1746574692645,ANSC 156,A00,886959,Jenkins; Janis A.,0,1,15,15
1746574693672,ANSC 180,A00,886960,Staff,11,0,17,6
1746574694699,ANSC 188,A00,886961,Jassal; Aftab,9,0,25,16
1746574695723,ANSC 190,A00,886962,Jassal; Aftab,14,0,25,11
1746574696752,ANSC 191,A00,886963,Staff,18,0,20,2
1746574697781,ANTH 3,A01,891689,Staff,17,0,20,3
1746574698809,ANTH 5,A00,886933,Semendeferi; Ekaterini,16,0,20,4
1746574699836,ANTH 10,A00,886934,Staff,0,12,30,30
1746574700861,ANTH 21,A01,886936,Staff,41,0,60,19
1746574701887,ANTH 23,A01,886938,Staff,92,0,100,8
1746574702915,ANTH 105,A00,886964,Stewart; Alexander B,84,0,100,16
1746574703944,ANTH 108,A00,886965,Pedersen; David,9,0,20,11
1746574704973,AWP 10,001,886147,Staff,0,0,0,0
1746574704973,AWP 10,002,886148,Staff,0,0,0,0
1746574704973,AWP 10,003,886149,Staff,0,0,0,0
1746574704973,AWP 10,004,886150,Staff,0,0,0,0
1746574704973,AWP 10,005,886151,Staff,0,0,0,0
1746574704973,AWP 10,006,886152,Staff,0,0,0,0
1746574704973,AWP 10,007,886153,Staff,0,0,0,0
1746574704973,AWP 10,008,886154,Staff,0,0,0,0
1746574704973,AWP 10,009,886155,Staff,0,0,0,0
1746574704973,AWP 10,010,886156,Staff,0,0,0,0
1746574704973,AWP 10,011,886158,Staff,0,0,0,0
1746574704973,AWP 10,012,886160,Staff,0,0,0,0
1746574704973,AWP 10,013,886161,Staff,0,0,0,0
1746574704973,AWP 10,014,886162,Staff,0,0,0,0
1746574704973,AWP 10,015,886163,Staff,0,0,0,0
1746574704973,AWP 10,016,886164,Staff,0,0,0,0
1746574704973,AWP 10,017,886165,Staff,0,0,0,0
1746574704973,AWP 10,018,886166,Staff,0,0,0,0
1746574704973,AWP 10,019,886168,Staff,0,0,0,0
1746574704973,AWP 10,020,886170,Staff,0,0,0,0
1746574704973,AWP 10,021,886172,Staff,0,0,0,0
1746574706000,AWP 10R,001,886173,Staff,0,1,0,0
1746574706000,AWP 10R,002,886174,Staff,0,1,0,0
1746574706000,AWP 10R,003,886175,Staff,0,0,0,0
1746574706000,AWP 10R,004,886176,Staff,0,0,0,0
1746574706000,AWP 10R,005,886177,Staff,0,0,0,0
1746574706000,AWP 10R,006,886178,Staff,0,0,0,0
1746574706000,AWP 10R,007,886179,Staff,0,0,0,0
1746574706000,AWP 10R,008,886181,Staff,0,0,0,0
1746574706000,AWP 10R,009,886182,Staff,0,0,0,0
1746574706000,AWP 10R,010,886183,Staff,0,0,0,0
1746574706000,AWP 10R,011,886184,Staff,0,0,0,0
1746574706000,AWP 10R,012,886185,Staff,0,0,0,0
1746574706000,AWP 10R,013,886186,Staff,0,0,0,0
1746574706000,AWP 10R,014,886187,Staff,0,0,0,0
1746574706000,AWP 10R,015,886188,Staff,0,0,0,0
1746574706000,AWP 10R,016,886189,Staff,0,0,0,0
1746574706000,AWP 10R,017,960532,Staff,0,0,0,0
1746574706000,AWP 10R,018,960533,Staff,0,0,0,0
1746574706000,AWP 10R,019,960534,Staff,0,0,0,0
1746574706000,AWP 10R,020,960538,Staff,0,0,0,0
1746574706000,AWP 10R,021,960540,Staff,0,0,0,0
1746574706000,AWP 10R,022,960541,Staff,0,0,0,0
1746574706000,AWP 10R,023,960542,Staff,0,0,0,0
1746574706000,AWP 10R,024,960544,Staff,0,0,0,0
1746574706000,AWP 10R,025,960545,Staff,0,0,0,0
1746574706000,AWP 10R,026,960548,Staff,0,0,0,0
1746574707025,AWP 102R,A00,886190,Staff,0,0,0,0
1746574707025,AWP 102R,B00,886191,Staff,0,0,0,0
1746574708052,BENG 100,A01,886193,Staff,17,0,30,13
1746574709076,BENG 122A,A01,886195,Hasty; Jeff M,13,0,30,17
1746574710102,BENG 166A,A00,886196,Sah; Robert Lie-Yuan,0,2,30,30
1746574711126,BENG 190,A00,958050,Khojah; Reem I,20,0,25,5
1746574712155,BIBC 102,A01,894320,Staff,0,0,46,46
1746574712155,BIBC 102,A02,894321,Staff,0,0,46,46
1746574712155,BIBC 102,A03,894344,Staff,7,0,46,39
1746574712155,BIBC 102,A04,894345,Staff,27,0,47,20
1746574713181,BICD 100R,A01,894365,Smith; Laurie,0,3,58,58
1746574713181,BICD 100R,A02,894366,Smith; Laurie,0,5,58,58
1746574713181,BICD 100R,A03,894367,Smith; Laurie,0,0,59,59
1746574713181,BICD 100R,A04,959869,Smith; Laurie,40,0,59,19
1746574714206,BICD 136,A01,894383,Gustafson-Brown; Cindy,14,0,50,36
1746574715237,BIEB 102,A01,894494,Butler; Shannon Rhey,51,0,130,79
1746574717288,BIEB 150,A01,894617,Wills; Christopher,3,0,20,17
1746574717288,BIEB 150,A02,894631,Wills; Christopher,3,0,20,17
1746574717288,BIEB 150,A03,894937,Wills; Christopher,3,0,20,17
1746574717288,BIEB 150,A04,894946,Wills; Christopher,5,0,20,15
1746574718315,BIEB 194,A00,906141,Kurle; Carolyn M.,6,0,20,14
1746574719344,BILD 1,A01,894154,Staff,3,0,19,16
1746574719344,BILD 1,A02,894155,Staff,14,0,19,5
1746574719344,BILD 1,A03,894160,Staff,13,0,19,6
1746574719344,BILD 1,A04,894161,Staff,15,0,18,3
1746574720371,BILD 2,A01,894168,Staff,0,0,50,50
1746574720371,BILD 2,A02,894169,Staff,0,0,50,50
1746574720371,BILD 2,A03,894179,Staff,0,0,50,50
1746574720371,BILD 2,A04,894203,Staff,24,0,50,26
1746574721399,BILD 3,A01,894213,Staff,23,0,31,8
1746574721399,BILD 3,A02,894214,Staff,26,0,31,5
1746574721399,BILD 3,A03,894235,Staff,28,0,31,3
1746574721399,BILD 3,A04,894236,Staff,28,0,32,4
1746574722423,BILD 4,A01,894253,Reuther; Keefe,5,0,24,19
1746574722423,BILD 4,A02,894258,Reuther; Keefe,16,0,24,8
1746574723449,BILD 5,A01,894276,Reuther; Keefe,35,0,50,15
1746574723449,BILD 5,A02,894277,Reuther; Keefe,45,0,50,5
1746574723449,BILD 5,A03,894290,Reuther; Keefe,44,0,50,6
1746574723449,BILD 5,A04,894291,Reuther; Keefe,48,0,50,2
1746574724479,BILD 24,A01,894297,Pirino; Giorgia,40,0,60,20
1746574725506,BIMM 100,B01,958915,Staff,71,0,100,29
1746574726532,BIMM 101,A01,895017,McDonnell; Lisa Marie,0,5,24,24
1746574726532,BIMM 101,A02,895018,McDonnell; Lisa Marie,0,5,24,24
1746574726532,BIMM 101,B01,895020,McDonnell; Lisa Marie,0,6,24,24
1746574726532,BIMM 101,B02,895021,McDonnell; Lisa Marie,0,4,24,24
1746574727557,BIMM 110,A01,895023,Staff,1,0,25,24
1746574727557,BIMM 110,A02,895024,Staff,9,0,25,16
1746574727557,BIMM 110,A03,895025,Staff,18,0,25,7
1746574727557,BIMM 110,A04,895031,Staff,20,0,25,5
1746574728584,BIMM 120,A01,895114,Gustafson-Brown; Cindy,14,0,28,14
1746574728584,BIMM 120,A02,895126,Gustafson-Brown; Cindy,21,0,27,6
1746574729614,BIPN 100,A01,895130,Yang; Mingyu,0,0,38,38
1746574729614,BIPN 100,A02,895131,Yang; Mingyu,32,0,38,6
1746574729614,BIPN 100,A03,895132,Yang; Mingyu,32,0,38,6
1746574729614,BIPN 100,A04,895133,Yang; Mingyu,27,0,36,9
1746574730643,BIPN 120,A01,895135,Cooke; James Edward,0,3,13,13
1746574730643,BIPN 120,A02,895136,Cooke; James Edward,0,1,13,13
1746574730643,BIPN 120,A03,895137,Cooke; James Edward,0,3,13,13
1746574730643,BIPN 120,A04,895156,Cooke; James Edward,0,2,11,11
1746574731670,BIPN 134,A01,895235,Cooke; James Edward,0,2,25,25
1746574731670,BIPN 134,A02,895237,Cooke; James Edward,0,0,25,25
1746574731670,BIPN 134,A03,895240,Cooke; James Edward,3,0,25,22
1746574731670,BIPN 134,A04,895270,Cooke; James Edward,20,0,25,5
1746574732698,BIPN 189,A00,892103,Staff,0,14,14,14
1746574734753,BISP 194,A00,958008,Staff,0,2,0,0
1746574735779,CAT 124,A01,922009,Staff,0,5,20,20
1746574736806,CAT 125R,A00,886390,Morales; Celeste Georgianna,0,2,20,20
1746574736806,CAT 125R,B00,886391,Irwin; Matthew Joseph,0,4,20,20
1746574736806,CAT 125R,C00,886392,Smith; Lauryn Alissa,0,2,20,20
1746574736806,CAT 125R,D00,886393,Vanderschuit; Maya Alysia,0,3,20,20
1746574736806,CAT 125R,E00,886394,Marchisotto; Jennifer Anne,0,3,20,20
1746574737834,CENG 15,A01,886218,Drews; Aaron,3,0,8,5
1746574738860,CENG 113,A00,886219,Opatkiewicz; Justin Paul,15,0,25,10
1746574739887,CGS 101,A00,887044,Staff,7,0,20,13
1746574740913,CGS 105,A01,887046,Staff,14,0,25,11
1746574741940,CGS 112,A00,887047,Cuong; Marisol,12,0,15,3
1746574742966,CGS 113,A00,887048,Staff,23,0,30,7
1746574743991,CGS 120,A00,887049,Staff,10,0,17,7
1746574745019,CHEM 6A,A01,886336,Lam; Tin Yiu,38,0,50,12
1746574745019,CHEM 6A,A02,886338,Lam; Tin Yiu,37,0,50,13
1746574746045,CHEM 6B,A01,886341,Hopkins; Patrycja Anna,16,0,50,34
1746574746045,CHEM 6B,A02,886343,Hopkins; Patrycja Anna,42,0,50,8
1746574747071,CHEM 6C,A01,886346,Albizati; Kim F.,0,2,50,50
1746574747071,CHEM 6C,A02,886348,Albizati; Kim F.,23,0,50,27
1746574748098,CHEM 40A,A01,886352,Klosterman; Jeremy K,65,0,100,35
1746574749126,CHEM 40B,A01,886356,Klosterman; Jeremy K,0,23,100,100
1746574750156,CHEM 41B,A01,886360,Theodorakis; Emmanuel,25,0,50,25
1746574750156,CHEM 41B,A02,886362,Theodorakis; Emmanuel,47,0,50,3
1746574751182,CHIN 165A,A00,886382,Xu; Li,18,0,20,2
1746574752205,CLAS 120,A00,886387,Myerston Santana; Jacobo,33,0,40,7
1746574753251,COGS 9,A01,886967,Shannon; Kyle Michael,42,0,60,18
1746574754276,COGS 11,A01,886969,Staff,9,0,30,21
1746574755301,COGS 14A,A01,886971,Staff,6,0,60,54
1746574756329,COGS 14B,A01,886973,Hoffman; Drew Ellen,4,0,60,56
1746574757358,COGS 18,A01,886975,Morgan; Eric,35,0,60,25
1746574758387,COGS 20,A01,886977,Staff,4,0,8,4
1746574758387,COGS 20,A02,886978,Staff,5,0,7,2
1746574759412,COGS 100,A01,907783,Staff,1,2,30,29
1746574760440,COGS 101B,A01,886980,Staff,0,3,48,48
1746574761466,COGS 101C,A01,886982,Delgado; Tania,0,5,44,44
1746574762494,COGS 102A,A01,886984,Johnson; Christine M.,4,0,30,26
1746574763519,COGS 118B,A01,886986,Staff,1,4,88,87
1746574764544,COGS 150,A01,886988,Bergen; Benjamin,22,0,50,28
1746574765569,COGS 153,A00,886989,Delgado; Tania,0,2,41,41
1746574766598,COGS 186,A01,886991,Staff,0,0,32,32
1746574767623,COGS 187A,A01,886993,Boyle; Mary E. T.,7,0,30,23
1746574768647,COGS 189,A00,886994,Staff,0,1,30,30
1746574769674,COMM 10,A01,886996,Staff,0,0,20,21
1746574769674,COMM 10,A02,886997,Staff,11,0,20,9
1746574769674,COMM 10,A03,959845,Staff,19,0,20,1
1746574770700,COMM 20,A01,886999,Leuning; Grant Maurstad,24,0,40,16
1746574772751,COMM 100A,A01,887002,Staff,0,0,20,25
1746574772751,COMM 100A,A02,887003,Staff,6,0,20,14
1746574773779,COMM 100B,A01,887005,Staff,0,8,20,24
1746574774803,COMM 106D,A00,887006,Staff,13,0,40,27
1746574775841,COMM 110G,A00,887007,Whitworth-Smith; Andrew C,12,0,40,28
1746574776871,COMM 111B,A00,887008,Staff,31,0,40,9
1746574777896,COMM 113T,A00,887009,Abuelhiga; Soraya Jill,28,0,40,12
1746574777896,COMM 113T,B00,906733,Staff,40,0,40,0
1746574778921,COMM 145,A00,887010,Staff,12,0,40,28
1746574779947,COMM 146,A00,887054,Staff,31,0,40,9
1746574780972,COMM 190,A00,887012,Staff,8,0,23,15
1746574781996,CSE 8A,A50,887015,Cao; Yingjun,57,0,85,28
1746574783020,CSE 11,A01,887017,Cao; Yingjun,12,0,70,58
1746574784044,CSE 20,A01,887019,Staff,30,0,50,20
1746574785068,CSE 21,A01,887021,Staff,78,0,100,22
1746574785068,CSE 21,B01,892583,Braun; Oliver,45,0,50,5
1746574786094,CSE 30,A01,887025,Eldon; John,143,0,200,57
1746574787117,CSE 100,A01,887027,Staff,26,0,50,24
1746574787117,CSE 100,A02,887028,Staff,42,0,50,8
1746574788143,CSE 101,A01,887030,Braun; Oliver,74,0,100,26
1746574788143,CSE 101,B01,887032,Jones; Miles E,0,3,50,50
1746574788143,CSE 101,B02,887033,Jones; Miles E,0,2,50,50
1746574789171,CSE 105,A01,908084,Jones; Miles E,32,0,50,18
1746574789171,CSE 105,A02,908087,Jones; Miles E,31,0,50,19
1746574790196,CSE 135,A01,887035,Powell; Thomas Allan,0,5,50,50
1746574791225,CSE 142,A01,887037,Staff,8,0,60,52
1746574792248,CSE 142L,A01,887039,Staff,34,0,60,26
1746574793274,CSE 151A,A01,887041,Solares; Edwin A,47,0,100,53
1746574794299,CSE 175,A01,887043,Kumar; Rakesh,30,0,30,0
1746574795324,CSS 1,A01,886389,Staff,1,1,40,39
1746574796349,DSC 30,A01,908097,Liao; Soohyun Nam,47,0,75,28
1746574797378,DSC 40A,A01,908099,Shannon; Kyle Michael,30,0,50,20
1746574798407,DSC 40B,A01,908112,Staff,15,0,50,35
1746574799435,DSC 80,A01,908116,Staff,19,0,60,41
1746574800461,DSC 197,001,956863,Eldridge; Justin Matthew,9999,0,9999,0
1746574801486,ECE 5,A01,886400,Morris; Karcher William,1,0,6,5
1746574801486,ECE 5,A02,886401,Morris; Karcher William,3,0,6,3
1746574802511,ECE 148,A01,886403,Silberman; Jack,0,14,14,14
1746574803542,ECON 1,A01,887265,Crane; Meredith Helen,12,0,70,58
1746574803542,ECON 1,B01,887268,Staff,42,0,50,8
1746574804568,ECON 2,A01,887273,Crane; Meredith Helen,55,0,70,15
1746574805593,ECON 3,A01,887279,Rondina; Giacomo,32,0,70,38
1746574806623,ECON 4,A01,887282,Anderson; John Charles,0,2,10,10
1746574807652,ECON 5,A01,887285,Staff,34,0,45,11
1746574807652,ECON 5,B01,887292,Staff,41,0,45,4
1746574808678,ECON 100A,A01,887337,Newhouse; Herbert S,54,0,70,16
1746574808678,ECON 100A,B01,887349,Staff,45,0,50,5
1746574809706,ECON 100B,A01,887361,Du; Songzi,29,0,70,41
1746574810734,ECON 100C,A01,887445,Newhouse; Herbert S,59,0,70,11
1746574811760,ECON 105,A00,887488,Vespa; Emanuel Ignacio,23,0,35,12
1746574812785,ECON 109,A01,887506,Shishkin; Denis,28,0,35,7
1746574813810,ECON 110A,A01,887568,Alon; Titan Michael,0,3,35,35
1746574813810,ECON 110A,B01,907601,Alon; Titan Michael,20,0,35,15
1746574814838,ECON 110B,A01,887598,Levkoff; Steven B.,0,24,70,70
1746574815869,ECON 112,A00,887599,Rondina; Giacomo,19,0,35,16
1746574816894,ECON 120A,A01,887603,Dai; Yinlin,35,0,70,35
1746574817922,ECON 120C,A01,887608,Sun; Yixiao,0,1,35,35
1746574817922,ECON 120C,B01,887614,Sun; Yixiao,0,0,35,35
1746574818952,ECON 138,A00,887621,Bharadwaj; Prashant,0,21,20,20
1746574819979,ECON 144,A00,958007,Squires; Dale E,12,0,35,23
1746574821003,ECON 171,A01,907666,Staff,18,0,35,17
1746574822032,ECON 175,A00,887626,Wu; Pak Yeung,22,0,35,13
1746574823061,ECON 190,A00,887640,Vespa; Emanuel Ignacio,22,0,35,13
1746574824095,EDS 25,A01,888197,Staff,0,0,0,0
1746574824095,EDS 25,A02,888209,Staff,0,0,0,0
1746574824095,EDS 25,A03,888210,Staff,0,0,0,0
1746574824095,EDS 25,A04,888212,Staff,0,0,0,0
1746574824095,EDS 25,A05,888213,Staff,0,0,0,0
1746574824095,EDS 25,A06,888214,Staff,0,0,0,0
1746574824095,EDS 25,A07,888235,Staff,0,2,0,0
1746574824095,EDS 25,A08,888236,Staff,0,0,0,0
1746574824095,EDS 25,A09,888240,Staff,0,0,0,0
1746574824095,EDS 25,A10,888244,Staff,0,0,0,0
1746574824095,EDS 25,B01,888273,Staff,0,0,0,0
1746574824095,EDS 25,B02,888285,Staff,0,0,0,0
1746574824095,EDS 25,B03,888423,Staff,0,0,0,1
1746574824095,EDS 25,B04,888432,Staff,0,0,0,0
1746574824095,EDS 25,B05,888433,Staff,0,0,0,0
1746574824095,EDS 25,B06,888467,Staff,0,0,0,0
1746574824095,EDS 25,B07,888468,Staff,0,0,0,0
1746574824095,EDS 25,B08,888479,Staff,0,0,0,0
1746574824095,EDS 25,B09,888484,Staff,0,0,0,0
1746574824095,EDS 25,B10,888487,Staff,0,0,0,0
1746574825121,EDS 38,A01,907700,Choi; Bailey Miyeon,30,0,30,0
1746574826150,EDS 112,A01,888601,Chapman; Thandeka K,12,0,40,28
1746574827178,EDS 115,A00,888697,Mendez; Kathrina Mendoza,10,0,30,20
1746574828205,EDS 116,A01,888893,Staff,34,0,40,6
1746574830257,EDS 124AR,A00,889133,Staff,29,0,50,21
1746574830257,EDS 124AR,B00,907471,Simon; Elizabeth A,37,0,50,13
1746574831285,EDS 124BR,A00,889134,Simon; Elizabeth A,44,0,100,56
1746574832310,EDS 125,A00,889135,Staff,25,0,30,5
1746574833335,EDS 126,A01,889138,Staff,35,0,40,5
1746574834360,EDS 164R,A01,889142,Wishard Guerra; Alison G.,33,0,50,17
1746574835389,ENG 30,A01,886396,Staff,0,0,0,0
1746574835389,ENG 30,B01,886398,Staff,0,0,0,0
1746574836415,ENVR 102,A00,906150,Montejo; Carolina,23,0,25,2
1746574837441,ETHN 103A,A00,887236,Man; Simeon S,0,3,0,0
1746574838470,ETHN 113,A00,887239,Staff,16,0,30,14
1746574839495,ETHN 116,A00,887240,Staff,16,0,25,9
1746574840523,ETHN 117,A00,887241,Choi; Esther Min,28,0,30,2
1746574841547,ETHN 118,A00,887243,Staff,24,0,30,6
1746574842573,ETHN 127,A00,887248,Cuong; Marisol,11,0,15,4
1746574843601,ETHN 139,A00,887250,Staff,7,0,10,3
1746574844625,ETHN 142,A00,887252,Staff,10,0,30,20
1746574845652,ETHN 161,A00,887253,Browne; Errol Tsekani,24,0,30,6
1746574846680,ETHN 163FR,A00,887255,Burelle; Julie Sara Veronique,0,0,5,5
1746574847706,GLBH 20,A00,889149,Elwardani; Nile Regina,8,0,42,34
1746574849761,GLBH 111,A01,889152,Burgos; Jose L.,17,0,17,0
1746574850787,GLBH 150,A00,889181,Sloane; Julia Kathryn,0,5,15,15
1746574852857,HDS 60,A01,886406,Warstadt; Melissa Fawn,73,0,80,7
1746574853887,HIAF 111,A00,889324,Gyamfi; Bright,25,0,32,7
1746574854915,HIEA 131,A00,889328,Staff,15,0,32,17
1746574855943,HIEA 144,A00,889333,Henry; Todd A.,26,0,32,6
1746574856970,HIEA 154,A00,889336,Henry; Todd A.,24,0,32,8
1746574857999,HIEU 106,A00,889339,Staff,22,0,32,10
1746574860050,HIEU 114,A00,889340,Staff,4,0,32,28
1746574861078,HIEU 135GS,A00,889342,Patterson; Patrick H.,0,0,1,24
1746574862103,HIEU 137,A00,889343,Edington; Claire Ellen,10,0,25,15
1746574863128,HIEU 148,A00,889345,Staff,14,0,32,18
1746574864153,HIEU 154,A00,889346,Biess; Frank Peter,21,0,32,11
1746574865179,HILA 102,A00,889351,Staff,12,0,32,20
1746574866204,HILD 2A,A01,889221,Lewandoski; Julia Mavis,1,10,32,31
1746574867230,HILD 7B,A01,889225,Man; Simeon S,0,12,32,32
1746574868255,HILD 7C,A01,889288,Alvarez; Luis A,0,14,32,32
1746574869281,HILD 30,A01,889323,Staff,0,5,32,32
1746574871339,HISC 119,A00,889383,Golan; Tal,19,0,32,13
1746574872363,HIUS 103,A00,889384,Man; Simeon S,0,0,32,32
1746574873388,HIUS 117,A00,919797,Kwak; Nancy,19,0,32,13
1746574874416,HIUS 142A,A00,919788,Staff,22,0,32,10
1746574876468,HIUS 149,A00,889386,Gyamfi; Bright,26,0,32,6
1746574877495,HIUS 155,A00,889387,Alvarez; Luis A,15,0,32,17
1746574878520,HUM 3,A01,886499,Caldwell; Michael Alan,19,0,50,31
1746574879547,HUM 3GS,A00,886500,Rodriguez; Bretton Sigfred,0,0,0,28
1746574880573,HUM 3R,A01,886502,Markman; Kristina,0,36,50,50
1746574881598,HUM 4,A01,886504,Crum; Matthew Stephen,23,0,50,27
1746574881598,HUM 4,B01,886506,West; Geoffrey Scott,17,0,50,33
1746574882624,HUM 4GS,A00,886507,Staff,0,0,0,19
1746574883651,HUM 5,A01,886509,Staff,32,0,50,18
1746574884680,HUM 5R,A01,886511,Zavodny; Tatiana Sophia,0,39,50,50
1746574885757,JAPN 180,A00,886407,Staff,16,0,40,24
1746574886786,LATI 50,A01,886409,Martin-Cabrera; Luis,4,0,22,18
1746574886786,LATI 50,A02,886410,Martin-Cabrera; Luis,19,0,22,3
1746574886786,LATI 50,A03,886411,Martin-Cabrera; Luis,21,0,22,1
1746574886786,LATI 50,A04,886412,Martin-Cabrera; Luis,9,0,22,13
1746574887813,LAWS 101,A00,907664,Staff,28,0,60,32
1746574888841,LIAB 1A,A00,889388,Saab; Dima,17,0,20,3
1746574889871,LIAB 1AX,A00,889389,El Cheddadi; Youniss,18,0,20,2
1746574890897,LIFR 1C,A00,889391,Van Moer; Vinciane G,8,0,20,12
1746574891924,LIFR 1CX,A00,889392,Van Moer; Vinciane G,7,0,20,13
1746574892950,LIFR 1D,A00,889393,Van Moer; Vinciane G,7,0,20,13
1746574893975,LIFR 1DX,A00,889394,Van Moer; Vinciane G,8,0,20,12
1746574895004,LIGN 7,A00,886923,Staff,24,0,50,26
1746574896033,LIGN 17,A00,886924,Kehler; Andrew Scott,125,0,150,25
1746574897061,LTAM 110,A00,889395,Staff,15,0,30,15
1746574898092,LTAM 110GS,A00,958010,Rodriguez; Bretton Sigfred,0,0,0,28
1746574899121,LTCH 101,A00,889397,Staff,23,0,25,2
1746574900147,LTCS 130,A00,889398,Staff,23,0,25,2
1746574901175,LTEA 138,A00,889399,Staff,24,0,40,16
1746574902205,LTEN 149,A00,889400,Wesling; Megan E.,0,3,25,25
1746574903235,LTEN 169,A00,889401,Staff,20,0,25,5
1746574904261,LTEN 180,A00,889402,Staff,10,0,15,5
1746574905286,LTEN 181,A00,889403,Staff,21,0,25,4
1746574906313,LTWL 100,A00,889404,Myerston Santana; Jacobo,2,0,25,23
1746574907339,LTWL 180GS,A00,889405,Staff,0,0,20,20
1746574908368,LTWL 181,A00,889406,Staff,16,0,25,9
1746574909393,LTWL 184,A00,889475,Mukherjee; Silpa,22,0,25,3
1746574910421,LTWR 102C,A00,889486,Staff,29,0,30,1
1746574911448,LTWR 115W,A00,889491,Staff,0,2,15,15
1746574912478,MAE 8,A01,886905,Staff,0,2,0,0
1746574913504,MAE 11,A00,886906,Bandaru; Prabhakar,0,7,50,50
1746574914529,MAE 20,A00,886907,Evdokimenko; Ekaterina,43,0,70,27
1746574915553,MAE 30B,A00,886909,Ghazinejad; Maziar,26,0,45,19
1746574916580,MAE 101B,A00,886910,Saintillan; David,29,0,45,16
1746574917605,MAE 105,A00,886911,Bandaru; Prabhakar,18,0,50,32
1746574918630,MAE 107,B00,958024,Staff,8,0,50,42
1746574919661,MAE 143B,A00,886913,Bewley; Thomas R,4,0,40,36
1746574920686,MAE 148,A01,886915,Silberman; Jack,0,3,14,14
1746574921716,MAE 160,A00,886916,Evdokimenko; Ekaterina,31,0,60,29
1746574922743,MATH 3C,A01,889681,Staff,0,2,30,30
1746574922743,MATH 3C,A02,960048,Staff,24,0,30,6
1746574923770,MATH 10A,A01,889760,Staff,26,0,30,4
1746574923770,MATH 10A,A02,889783,Staff,29,0,30,1
1746574924797,MATH 10B,A01,889785,Verstraete; Jacques Allan,2,0,35,33
1746574924797,MATH 10B,A02,889795,Verstraete; Jacques Allan,4,0,35,31
1746574924797,MATH 10B,B01,889797,Verstraete; Jacques Allan,3,0,35,32
1746574924797,MATH 10B,B02,889828,Verstraete; Jacques Allan,3,0,35,32
1746574925823,MATH 10C,A01,889849,Habib; Yousaf,7,0,30,23
1746574925823,MATH 10C,A02,889852,Habib; Yousaf,14,0,30,16
1746574925823,MATH 10C,A03,889853,Habib; Yousaf,22,0,30,8
1746574925823,MATH 10C,A04,889858,Habib; Yousaf,20,0,30,10
1746574925823,MATH 10C,B01,889861,Staff,1,0,30,29
1746574925823,MATH 10C,B02,889862,Staff,24,0,30,6
1746574925823,MATH 10C,B03,889863,Staff,27,0,30,3
1746574925823,MATH 10C,B04,889967,Staff,23,0,30,7
1746574926853,MATH 18,A01,889974,Staff,7,0,30,23
1746574926853,MATH 18,A02,889977,Staff,20,0,30,10
1746574926853,MATH 18,B01,889984,Hardiman; Liam,21,0,30,9
1746574926853,MATH 18,B02,889985,Hardiman; Liam,25,0,30,5
1746574927878,MATH 20A,A01,889990,Suk; Andrew Hoon,30,0,35,5
1746574928906,MATH 20B,A01,889993,Ohm; Ko Woon,22,0,30,8
1746574928906,MATH 20B,A02,889994,Ohm; Ko Woon,30,0,30,0
1746574928906,MATH 20B,B01,889996,Ohm; Ko Woon,22,0,30,8
1746574928906,MATH 20B,B02,889997,Ohm; Ko Woon,23,0,30,7
1746574929936,MATH 20C,A01,889999,Hammock; Frances H,17,0,30,13
1746574929936,MATH 20C,A02,890003,Hammock; Frances H,23,0,30,7
1746574929936,MATH 20C,B01,890006,Hammock; Frances H,3,0,30,27
1746574929936,MATH 20C,B02,890007,Hammock; Frances H,12,0,30,18
1746574931007,MATH 20D,A01,890011,Cheng; Hsiao-Bing,1,1,30,29
1746574931007,MATH 20D,A02,890012,Cheng; Hsiao-Bing,14,0,30,16
1746574931007,MATH 20D,B01,890016,Cheng; Hsiao-Bing,13,0,30,17
1746574931007,MATH 20D,B02,890017,Cheng; Hsiao-Bing,13,0,30,17
1746574932032,MATH 20E,A01,890026,Harel; Guershon,1,0,30,29
1746574932032,MATH 20E,A02,890029,Harel; Guershon,23,0,30,7
1746574932032,MATH 20E,B01,890033,Harel; Guershon,7,0,30,23
1746574932032,MATH 20E,B02,890101,Harel; Guershon,21,0,30,9
1746574933060,MATH 102,A01,890104,Staff,17,0,30,13
1746574933060,MATH 102,A02,890105,Staff,27,0,30,3
1746574934086,MATH 103B,A01,890116,Salehi Golsefidy; Alireza,3,0,30,27
1746574934086,MATH 103B,B01,890118,Staff,0,3,34,34
1746574935113,MATH 109,A01,890121,Aliabadi Sr.; Mohsen,1,0,30,29
1746574935113,MATH 109,B01,890124,Upadrashta; Pranav Kumar,18,0,30,12
1746574936137,MATH 120A,A01,890126,Eggers; John Dietrich,13,0,30,17
1746574937163,MATH 142B,A01,890128,Ioana; Adrian,19,0,30,11
1746574937163,MATH 142B,A02,890129,Ioana; Adrian,13,0,30,17
1746574938188,MATH 154,A01,890174,Staff,0,0,30,30
1746574938188,MATH 154,A02,890182,Staff,0,0,30,30
1746574939213,MATH 168A,A01,890197,Dumitriu; Ioana,21,0,35,14
1746574940239,MATH 170A,A01,890240,Nie; Jiawang,1,0,30,29
1746574940239,MATH 170A,A02,890241,Nie; Jiawang,11,0,30,19
1746574940239,MATH 170A,A03,890249,Nie; Jiawang,23,0,30,7
1746574941264,MATH 170B,A01,957891,Nag; Panchali,13,0,35,22
1746574943314,MATH 181A,A01,908025,Staff,0,3,35,35
1746574943314,MATH 181A,A02,960115,Staff,26,0,35,9
1746574944341,MATH 181B,A01,959874,Staff,25,0,30,5
1746574945366,MATH 193B,A01,890265,Staff,0,4,35,35
1746574946392,MGT 4,A01,890311,Anderson; John Charles,42,0,88,46
1746574947420,MGT 5,A00,907740,Staff,13,0,98,85
1746574948446,MGT 12,A00,890312,Lindenberger; Wade Douglas,67,0,98,31
1746574949472,MGT 16,A00,957883,Staff,78,0,98,20
1746574951525,MGT 45,A00,890314,Pecore; Joseph P.,45,0,98,53
1746574952553,MGT 71,A00,890315,Staff,0,11,98,98
1746574953579,MGT 100,A00,890316,Yavorsky; Daniel Ryan,44,0,98,54
1746574954603,MGT 103,A00,890317,Ehrich; Kristine R,73,0,98,25
1746574955627,MGT 105,A00,890356,Bates; Kenneth Walter,0,8,98,98
1746574956655,MGT 112,A00,890360,Ehrich; Kristine R,55,0,98,43
1746574957682,MGT 127R,A00,907732,Zhu; Kevin Xiaoguo,23,0,98,75
1746574958709,MGT 131B,A00,890361,Anderson; John Charles,60,0,98,38
1746574959734,MGT 137,A00,890362,Lindenberger; Wade Douglas,65,0,98,33
1746574960757,MGT 160,A00,890369,Johnson; Erik Barry,9,0,98,89
1746574962807,MGT 164,A00,890372,Zimmermann; Carsten,0,40,98,98
1746574963831,MGT 180,A00,890374,Bliss; Barbara Ann,12,0,98,86
1746574964862,MMW 15,A01,886414,Chang; Edmond Yi-Teh,0,12,28,28
1746574964862,MMW 15,A02,886415,Chang; Edmond Yi-Teh,0,8,28,28
1746574964862,MMW 15,A03,886416,Chang; Edmond Yi-Teh,0,9,28,28
1746574964862,MMW 15,A04,886417,Chang; Edmond Yi-Teh,0,8,28,28
1746574964862,MMW 15,B01,886419,Chang; Edmond Yi-Teh,0,7,28,28
1746574964862,MMW 15,B02,886420,Chang; Edmond Yi-Teh,0,8,28,28
1746574964862,MMW 15,B03,886421,Chang; Edmond Yi-Teh,0,7,28,28
1746574964862,MMW 15,B04,886422,Chang; Edmond Yi-Teh,0,8,28,28
1746574964862,MMW 15,C01,886424,Staff,0,9,28,28
1746574964862,MMW 15,C02,886425,Staff,0,8,28,28
1746574964862,MMW 15,C03,886426,Staff,0,8,28,28
1746574964862,MMW 15,C04,886427,Staff,0,8,28,28
1746574964862,MMW 15,C05,958038,Staff,0,8,28,28
1746574964862,MMW 15,C06,958039,Staff,1,8,28,27
1746574965886,MMW 15GS,A00,906910,Patterson; Patrick H.,4,0,28,24
1746574966911,MMW 122R,A01,886429,Rahimi; Babak,0,13,28,28
1746574966911,MMW 122R,A02,886430,Rahimi; Babak,0,12,28,28
1746574966911,MMW 122R,A03,958040,Rahimi; Babak,0,11,28,28
1746574967936,MUS 1A,A01,890937,Staff,2,0,25,23
1746574967936,MUS 1A,A02,891035,Staff,6,0,25,19
1746574967936,MUS 1A,C01,958912,Staff,24,0,25,1
1746574967936,MUS 1A,C02,958913,Staff,25,0,25,0
1746574970016,MUS 2AK,A00,957092,Ohnishi; Takae,15,0,15,0
1746574971041,MUS 4,A01,891044,Staff,1,0,25,24
1746574971041,MUS 4,A02,891045,Staff,23,0,25,2
1746574971041,MUS 4,B01,891048,Staff,17,0,25,8
1746574971041,MUS 4,B02,891050,Staff,25,0,25,0
1746574972066,MUS 5,A01,957506,Dubnov; Shlomo,0,0,25,25
1746574972066,MUS 5,A02,957622,Dubnov; Shlomo,13,0,25,12
1746574972066,MUS 5,A03,957623,Dubnov; Shlomo,20,0,25,5
1746574973094,MUS 6,A01,891053,Freitas Caetano; Marcelo,24,0,25,1
1746574973094,MUS 6,A02,891054,Freitas Caetano; Marcelo,23,0,25,2
1746574974118,MUS 7,A01,891081,Staff,1,0,25,24
1746574974118,MUS 7,A02,891082,Staff,3,0,25,22
1746574975144,MUS 8GS,A00,891118,Borgo; David Garcia,1,0,25,24
1746574976170,MUS 11,A01,891140,Staff,9,0,25,16
1746574976170,MUS 11,A02,891141,Staff,22,0,25,3
1746574977193,MUS 13,A01,891143,Staff,8,0,25,17
1746574977193,MUS 13,A02,891144,Staff,24,0,25,1
1746574978217,MUS 15,A01,891146,Staff,9,0,25,16
1746574978217,MUS 15,A02,891148,Staff,21,0,25,4
1746574978217,MUS 15,B01,891150,Staff,18,0,25,7
1746574978217,MUS 15,B02,891151,Staff,25,0,25,0
1746574979250,MUS 20,A01,891153,Staff,5,0,20,15
1746574979250,MUS 20,A02,891155,Staff,14,0,20,6
1746574980276,MUS 80,A00,891156,Staff,19,0,25,6
1746574980276,MUS 80,B00,891157,Staff,23,0,25,2
1746574981303,MUS 130,A00,891158,Ohnishi; Takae,35,0,35,0
1746574982331,MUS 150GS,A01,891160,Borgo; David Garcia,1,0,25,24
1746574983364,MUS 170,A01,891162,Freitas Caetano; Marcelo,20,0,25,5
1746574983364,MUS 170,A02,891164,Freitas Caetano; Marcelo,21,0,25,4
1746574984387,NANO 11,A00,886220,Vazquez Mena; Oscar,13,0,15,2
1746574985413,NANO 15,A01,886222,Drews; Aaron,4,0,7,3
1746574986437,NANO 104,A00,886224,Sirbuly; Donald,17,0,25,8
1746574987465,PH 40,A00,886528,Staff,24,0,40,16
1746574988491,PH 45,A01,886799,Staff,35,0,40,5
1746574989517,PH 110,A00,886802,Staff,0,7,40,40
1746574990542,PH 172,A00,906716,Staff,19,0,35,16
1746574991568,PH 191,A00,886803,Staff,6,0,40,34
1746574992592,PHIL 1,A00,889500,Staff,20,0,30,10
1746574993619,PHIL 10,A01,889549,Grush; Rick Scott,16,0,22,6
1746574993619,PHIL 10,A02,889551,Grush; Rick Scott,22,0,22,0
1746574994646,PHIL 28,A01,889559,Lamey; Andy M.,0,2,31,31
1746574994646,PHIL 28,A02,889561,Lamey; Andy M.,0,1,30,30
1746574994646,PHIL 28,A03,889572,Lamey; Andy M.,0,1,30,30
1746574995671,PHIL 35,A00,907839,Staff,13,0,15,2
1746574996695,PHIL 60,A00,889574,Staff,73,0,90,17
1746574997723,PHIL 101,A00,958004,Staff,12,0,15,3
1746574999774,PHIL 136,A00,889582,Fulkerson; Matthew Todd,26,0,45,19
1746575000806,PHIL 163,A01,889601,Staff,21,0,30,9
1746575000806,PHIL 163,B01,889606,Brandt; Reuven A,0,3,0,0
1746575001831,PHIL 164,A00,889610,Staff,16,0,30,14
1746575002860,PHIL 165,A00,889613,Staff,22,0,30,8
1746575003884,PHYS 1A,A00,886431,Staff,26,0,70,44
1746575004913,PHYS 1AL,001,886432,Tsai; Philbert S,0,2,30,30
1746575004913,PHYS 1AL,002,886436,Tsai; Philbert S,11,0,30,19
1746575005941,PHYS 1B,A00,886439,Staff,185,0,240,55
1746575006965,PHYS 1BL,001,886441,Tsai; Philbert S,0,4,30,30
1746575006965,PHYS 1BL,002,886444,Tsai; Philbert S,2,0,30,28
1746575007995,PHYS 1C,A00,896092,Arnold; Kam S,78,0,146,68
1746575009023,PHYS 1CL,001,886448,Tsai; Philbert S,0,0,30,30
1746575009023,PHYS 1CL,002,886449,Tsai; Philbert S,1,0,30,29
1746575009023,PHYS 1CL,003,886450,Tsai; Philbert S,16,0,30,14
1746575009023,PHYS 1CL,004,886451,Tsai; Philbert S,15,0,30,15
1746575010049,PHYS 2B,A01,886457,Staff,68,0,115,47
1746575011074,PHYS 2C,A01,886460,Shotwell; Brian,0,9,65,65
1746575012100,PHYS 2CL,A01,886467,Staff,0,4,28,28
1746575012100,PHYS 2CL,A02,886468,Staff,0,3,28,28
1746575013128,PHYS 2D,A01,886470,Staff,10,0,50,40
1746575014154,PHYS 4B,A01,886475,Grinstein; Benjamin,22,0,40,18
1746575015180,POLI 5,A00,891173,Desposato; Scott,7,0,25,18
1746575016204,POLI 5D,A01,891175,Staff,5,0,5,0
1746575016204,POLI 5D,B01,891178,Staff,5,0,5,0
1746575017229,POLI 11,A00,891179,Ferree; Karen E,2,0,35,33
1746575018255,POLI 12,A00,891180,Staff,16,0,30,14
1746575019280,POLI 27,A01,891182,Staff,12,0,75,63
1746575020306,POLI 30,A00,891183,Staff,8,0,50,42
1746575021330,POLI 100B,A00,891244,Staff,5,1,35,30
1746575022355,POLI 100I,A00,891247,Staff,7,0,30,23
1746575023381,POLI 104J,A00,891248,Nichter; Maysa,14,0,30,16
1746575024409,POLI 104U,A00,891250,Nichter; Maysa,1,0,30,29
1746575026462,POLI 110B,A00,891255,Wiens; David,19,0,25,6
1746575027487,POLI 112A,A00,891256,Wiens; David,6,0,25,19
1746575028514,POLI 114BR,A00,891261,Staff,19,0,30,11
1746575029542,POLI 117R,A00,891262,Forman; Fonna,0,6,50,50
1746575030571,POLI 118,A00,891264,Ingham; Sean,17,0,25,8
1746575031602,POLI 124A,A00,891265,Staff,18,0,20,2
1746575032632,POLI 125D,A00,891266,Nichter; Simeon C,2,0,25,23
1746575033658,POLI 126,A00,891268,Nichter; Simeon C,7,0,25,18
1746575034685,POLI 126AA,A00,891272,Staff,15,0,25,10
1746575035712,POLI 130AA,A00,891273,Staff,15,0,20,5
1746575036738,POLI 134AA,A00,891274,Staff,4,0,20,16
1746575038790,POLI 138,A00,891278,Staff,21,0,25,4
1746575039819,POLI 142K,A00,891280,Staff,10,0,25,15
1746575040846,POLI 142M,A00,891281,Gartzke; Erik,16,0,30,14
1746575041871,POLI 142P,A00,891284,Staff,20,0,30,10
1746575042896,POLI 143,A00,891285,Gartzke; Erik,12,0,30,18
1746575043921,POLI 153,A00,891286,Staff,19,0,20,1
1746575045974,POLI 175,A00,891290,Staff,15,0,20,5
1746575047001,PSYC 1,A00,890674,Steiner; Eric Tomas,0,11,45,45
1746575048028,PSYC 2,A00,890676,Albright; Thomas D,21,0,35,14
1746575049057,PSYC 3,A00,890679,Staff,17,0,20,3
1746575050086,PSYC 6,A00,959858,Staff,20,0,20,0
1746575051113,PSYC 60,A01,890684,Rickard; Timothy C.,0,5,45,45
1746575052138,PSYC 70,A01,890689,Geller; Emma Harlan,7,0,30,23
1746575053166,PSYC 71,A01,959860,Staff,21,0,25,4
1746575054192,PSYC 100,A00,890690,Lacefield; Katharine I,0,50,180,180
1746575055218,PSYC 102,A00,890695,Staff,18,0,40,22
1746575056240,PSYC 105,A00,890699,Geller; Emma Harlan,70,0,100,30
1746575057269,PSYC 106,A00,890701,Gorman; Michael R.,6,0,30,24
1746575058294,PSYC 108,A00,890704,Adrian; Julia Anna,0,28,50,50
1746575059317,PSYC 118,A01,890712,Staff,11,0,30,19
1746575060346,PSYC 124,A00,890716,Chapman; Eddie Nathaniel,25,0,60,35
1746575061373,PSYC 131,A00,890717,Anagnostaras; Stephan,0,8,80,80
1746575062401,PSYC 137,A00,890719,Winkielman; Piotr,0,11,30,30
1746575063431,PSYC 144,A00,890721,Adrian; Julia Anna,0,9,45,45
1746575064457,PSYC 162,A00,890805,Staff,0,0,75,75
1746575065483,PSYC 169,A00,890810,Staff,0,14,30,30
1746575066508,PSYC 172,A00,890814,Gorman; Michael R.,9,0,30,21
1746575067533,PSYC 181,A00,890818,Anagnostaras; Stephan,9,0,200,191
1746575068562,PSYC 184,A00,959861,Staff,168,0,175,7
1746575069592,PSYC 189,A00,890823,Staff,0,2,30,30
1746575070621,PSYC 191,A00,890884,Rickard; Timothy C.,0,12,35,35
1746575071646,PSYC 193,A00,890913,Staff,19,0,30,11
1746575071646,PSYC 193,B00,890914,Chapman; Eddie Nathaniel,24,0,30,6
1746575072674,PSYC 193L,A01,890918,Lowe; Angela Beth,20,0,30,10
1746575072674,PSYC 193L,B01,890921,Hurwitz; Ethan Scott,20,0,30,10
1746575072674,PSYC 193L,C01,890928,Staff,30,0,30,0
1746575073701,RELI 149,A00,886806,Rahimi; Babak,23,0,40,17
1746575074726,SE 9,A01,886814,Staff,7,0,20,13
1746575075751,SE 101B,A01,886816,Chadha; Mayank,4,0,35,31
1746575076780,SE 110B,A00,886818,Zhu; Qiang,4,0,75,71
1746575077804,SE 125,A01,886830,Staff,10,0,30,20
1746575078832,SE 130B,A01,886835,Staff,14,0,40,26
1746575079858,SE 131A,A01,886838,Krysl; Petr,34,0,55,21
1746575080891,SE 154,A00,886840,Staff,29,0,50,21
1746575081917,SE 164GS,A01,886849,Staff,6,0,20,14
1746575082943,SE 167GS,A01,886853,Staff,6,0,20,14
1746575083973,SIO 25,A01,890107,Staff,19,0,30,11
1746575085015,SIO 45,A00,890109,Cook; Geoffrey W,117,0,200,83
1746575086041,SIO 109R,A00,890110,Forman; Fonna,0,16,20,20
1746575087066,SIO 187,A01,890114,Kacev; David,15,0,40,25
1746575088095,SOCI 1,A01,890431,Thorpe; Charles Robert,14,0,30,16
1746575088095,SOCI 1,A02,890518,Thorpe; Charles Robert,30,0,30,0
1746575089121,SOCI 2,A01,957978,Staff,25,0,25,0
1746575089121,SOCI 2,A02,957979,Staff,23,0,25,2
1746575090149,SOCI 20,A01,890523,Calderon-Zaks; Michael Aar,21,0,30,9
1746575090149,SOCI 20,A02,890526,Calderon-Zaks; Michael Aar,29,0,30,1
1746575091177,SOCI 30,A01,890533,Pardo Guerra; Juan Pablo,37,0,40,3
1746575092206,SOCI 40,A01,890535,Staff,27,0,45,18
1746575093232,SOCI 104Q,A00,890559,Staff,18,0,30,12
1746575094260,SOCI 106,A00,890560,Arnal; Maud Marie Leonie,20,0,30,10
1746575095288,SOCI 110,A00,890567,Holkenbrink-Monk; Charlene,19,0,30,11
1746575096313,SOCI 112,A00,890568,Victoria Torres; Pablo,2,0,55,53
1746575097341,SOCI 115,A00,890597,Arnal; Maud Marie Leonie,28,0,45,17
1746575099393,SOCI 121,A00,890604,Pardo Guerra; Juan Pablo,38,0,45,7
1746575100417,SOCI 126,A01,890608,Staff,8,0,10,2
1746575101445,SOCI 127,A00,890609,Staff,18,0,30,12
1746575102471,SOCI 131,A00,890610,Thorpe; Charles Robert,37,0,45,8
1746575103505,SOCI 135,A00,890615,Payne; Christine Anna,13,0,45,32
1746575104534,SOCI 139,A00,890620,Staff,38,0,45,7
1746575105557,SOCI 148E,A00,890622,Calderon-Zaks; Michael Aar,36,0,45,9
1746575106583,SOCI 150,A00,890623,Kohler; Kristopher M.,31,0,45,14
1746575107610,SOCI 157,A00,890625,Jules-Rosette; Bennetta W.,18,0,20,2
1746575108634,SOCI 160,A00,890627,Payne; Christine Anna,21,0,45,24
1746575109661,SYN 1,A00,886855,Fish; Gwendolyn Anne,0,1,0,0
1746575109661,SYN 1,B00,906086,Fish; Gwendolyn Anne,0,2,0,2
1746575110686,SYN 2R,A00,886860,Staff,0,17,15,15
1746575110686,SYN 2R,B00,906106,Atkinson; Arthur Laird,0,16,15,15
1746575111713,SYN 100,A01,886866,Browne; Emily,0,28,20,20
1746575111713,SYN 100,B01,906128,Rock; Martin,0,5,20,20
1746575111713,SYN 100,C01,906140,Deavenport; James Cary,0,3,20,20
1746575111713,SYN 100,D01,907816,Deavenport; James Cary,0,5,20,20
1746575112738,TDAC 1,A00,890286,Walsh; Kim C.,8,0,20,12
1746575113768,TDAC 101,A00,890296,Basso; Beatrice,15,0,20,5
1746575114792,TDDE 131,A00,890297,Staff,47,0,50,3
1746575115820,TDDM 1,A00,890287,Weinberg; Sadie,25,0,30,5
1746575116848,TDGE 11,A00,890288,Fulton; Julia,138,0,200,62
1746575116848,TDGE 11,B00,890289,Castro; Robert Jess,184,0,200,16
1746575117873,TDGE 25,B00,957359,Walsh; Kim C.,5,0,20,15
1746575118905,TDGE 40,A01,890292,Power; Jade Yukana,27,0,30,3
1746575119932,TDGE 124,A00,890298,Havis; Allan,0,1,50,50
1746575120958,TDGE 131R,A00,890299,Burelle; Julie Sara Veronique,15,0,42,27
1746575121984,TDHT 101,A00,890300,Staff,10,0,20,10
1746575123010,TDHT 109,A01,890302,Anderson; Mysia Anyse,31,0,40,9
1746575124035,TDMV 1,A00,890293,Arcidiacono; Kristin,18,0,30,12
1746575125063,TDMV 2,A00,890294,Weinberg; Sadie,23,0,30,7
1746575126088,TDMV 3,A00,957878,Arcidiacono; Kristin,28,0,30,2
1746575128141,TDMV 138,A00,890304,Jun; Grace Shin Hae,25,0,40,15
1746575129165,TDMV 140,A00,890305,Corrales; Joseph Bernales,25,0,30,5
1746575130190,TDMV 142,A00,890307,Caligagan; Tony,32,0,40,8
1746575131215,TDMV 144,A00,890308,Camaya; Michelle Ann,25,0,30,5
1746575132242,TDPW 1,A00,890295,Stein; Deborah Isobel,3,0,20,17
1746575133267,USP 2,A01,890272,Lerner; Amy M,7,0,20,13
1746575134290,USP 3,A01,890274,Staff,12,0,30,18
1746575135315,USP 15,A01,890276,Sun; Feiyang,16,0,30,14
1746575136341,USP 25,A00,890277,Shenkman; Michael Thomas,18,0,25,7
1746575137365,USP 138,A00,890278,Staff,14,0,25,11
1746575138391,USP 143,A00,890279,Staff,22,0,70,48
1746575139419,USP 144,A00,890280,Chowdhury; Muhammed Zohir,16,0,30,14
1746575140445,USP 150,A00,890281,Boomhower; Matthew Charles,4,0,30,26
1746575141470,USP 151,A00,890282,Staff,16,0,20,4
1746575142494,USP 162,A00,890283,Andrews; Abigail Leslie,16,0,20,4
1746575143521,USP 168,A00,920477,Kwak; Nancy,0,0,5,5
1746575144547,USP 181,A00,890284,Staff,3,0,20,17
1746575145576,USP 191A,A00,890285,Staff,12,0,20,8
1746575146602,VIS 101,A00,886512,Staff,26,0,75,49
1746575147626,VIS 103,A00,886513,Cruz; Edwin Teddy,61,0,75,14
1746575148651,VIS 108,A00,886514,Staff,3,0,15,12
1746575149676,VIS 127P,A00,886515,Shen; Kuiyi,80,0,146,66
1746575150706,VIS 149,A00,886516,Yoldas; Pinar,0,0,15,15
1746575151733,VIS 164,A00,886526,Erdmann; Dean,19,0,22,3
1746575152758,VIS 194S,A00,886527,Staff,61,0,75,14
1746575153784,WCWP 10A,C00,886484,Martiniuk; Jill,12,0,15,3
1746575154813,WCWP 10B,A00,886490,Uriarte; Emma,0,0,15,15
1746575154813,WCWP 10B,B00,886491,Dhir; Simrita,9,0,15,6
1746575154813,WCWP 10B,C00,886492,Ornelas; Tricia,0,0,15,15
1746575155845,WCWP 100,A00,886494,Young; Mark T,0,6,15,15
1746575157952,AAS 10,A01,886199,Childs; Dennis R.,0,3,0,0
1746575158980,ANAR 104,A01,886940,Shtienberg; Gilad,27,0,30,3
1746575160008,ANAR 120,A00,886953,Staff,12,0,20,8
1746575161038,ANBI 148,A01,886955,Wilder; Linnea Lorene,30,0,40,10
1746575163095,ANSC 122,A00,886957,Staff,25,0,30,5
1746575164120,ANSC 150,A00,886958,Sloane; Julia Kathryn,2,0,15,13
1746575165145,ANSC 156,A00,886959,Jenkins; Janis A.,0,1,15,15
1746575166169,ANSC 180,A00,886960,Staff,11,0,17,6
1746575167199,ANSC 188,A00,886961,Jassal; Aftab,9,0,25,16
1746575168227,ANSC 190,A00,886962,Jassal; Aftab,14,0,25,11
1746575169252,ANSC 191,A00,886963,Staff,18,0,20,2
1746575170282,ANTH 3,A01,891689,Staff,17,0,20,3
1746575171311,ANTH 5,A00,886933,Semendeferi; Ekaterini,16,0,20,4
1746575172340,ANTH 10,A00,886934,Staff,0,12,30,30
1746575173369,ANTH 21,A01,886936,Staff,41,0,60,19
1746575174392,ANTH 23,A01,886938,Staff,92,0,100,8
1746575175419,ANTH 105,A00,886964,Stewart; Alexander B,84,0,100,16
1746575176444,ANTH 108,A00,886965,Pedersen; David,9,0,20,11
1746575177476,AWP 10,001,886147,Staff,0,0,0,0
1746575177476,AWP 10,002,886148,Staff,0,0,0,0
1746575177476,AWP 10,003,886149,Staff,0,0,0,0
1746575177476,AWP 10,004,886150,Staff,0,0,0,0
1746575177476,AWP 10,005,886151,Staff,0,0,0,0
1746575177476,AWP 10,006,886152,Staff,0,0,0,0
1746575177476,AWP 10,007,886153,Staff,0,0,0,0
1746575177476,AWP 10,008,886154,Staff,0,0,0,0
1746575177476,AWP 10,009,886155,Staff,0,0,0,0
1746575177476,AWP 10,010,886156,Staff,0,0,0,0
1746575177476,AWP 10,011,886158,Staff,0,0,0,0
1746575177476,AWP 10,012,886160,Staff,0,0,0,0
1746575177476,AWP 10,013,886161,Staff,0,0,0,0
1746575177476,AWP 10,014,886162,Staff,0,0,0,0
1746575177476,AWP 10,015,886163,Staff,0,0,0,0
1746575177476,AWP 10,016,886164,Staff,0,0,0,0
1746575177476,AWP 10,017,886165,Staff,0,0,0,0
1746575177476,AWP 10,018,886166,Staff,0,0,0,0
1746575177476,AWP 10,019,886168,Staff,0,0,0,0
1746575177476,AWP 10,020,886170,Staff,0,0,0,0
1746575177476,AWP 10,021,886172,Staff,0,0,0,0
1746575178507,AWP 10R,001,886173,Staff,0,1,0,0
1746575178507,AWP 10R,002,886174,Staff,0,1,0,0
1746575178507,AWP 10R,003,886175,Staff,0,0,0,0
1746575178507,AWP 10R,004,886176,Staff,0,0,0,0
1746575178507,AWP 10R,005,886177,Staff,0,0,0,0
1746575178507,AWP 10R,006,886178,Staff,0,0,0,0
1746575178507,AWP 10R,007,886179,Staff,0,0,0,0
1746575178507,AWP 10R,008,886181,Staff,0,0,0,0
1746575178507,AWP 10R,009,886182,Staff,0,0,0,0
1746575178507,AWP 10R,010,886183,Staff,0,0,0,0
1746575178507,AWP 10R,011,886184,Staff,0,0,0,0
1746575178507,AWP 10R,012,886185,Staff,0,0,0,0
1746575178507,AWP 10R,013,886186,Staff,0,0,0,0
1746575178507,AWP 10R,014,886187,Staff,0,0,0,0
1746575178507,AWP 10R,015,886188,Staff,0,0,0,0
1746575178507,AWP 10R,016,886189,Staff,0,0,0,0
1746575178507,AWP 10R,017,960532,Staff,0,0,0,0
1746575178507,AWP 10R,018,960533,Staff,0,0,0,0
1746575178507,AWP 10R,019,960534,Staff,0,0,0,0
1746575178507,AWP 10R,020,960538,Staff,0,0,0,0
1746575178507,AWP 10R,021,960540,Staff,0,0,0,0
1746575178507,AWP 10R,022,960541,Staff,0,0,0,0
1746575178507,AWP 10R,023,960542,Staff,0,0,0,0
1746575178507,AWP 10R,024,960544,Staff,0,0,0,0
1746575178507,AWP 10R,025,960545,Staff,0,0,0,0
1746575178507,AWP 10R,026,960548,Staff,0,0,0,0
1746575179532,AWP 102R,A00,886190,Staff,0,0,0,0
1746575179532,AWP 102R,B00,886191,Staff,0,0,0,0
1746575180558,BENG 100,A01,886193,Staff,17,0,30,13
1746575181587,BENG 122A,A01,886195,Hasty; Jeff M,13,0,30,17
1746575182615,BENG 166A,A00,886196,Sah; Robert Lie-Yuan,0,2,30,30
1746575183654,BENG 190,A00,958050,Khojah; Reem I,20,0,25,5
1746575184682,BIBC 102,A01,894320,Staff,0,0,46,46
1746575184682,BIBC 102,A02,894321,Staff,0,0,46,46
1746575184682,BIBC 102,A03,894344,Staff,6,0,46,40
1746575184682,BIBC 102,A04,894345,Staff,27,0,47,20
1746575185708,BICD 100R,A01,894365,Smith; Laurie,0,3,58,58
1746575185708,BICD 100R,A02,894366,Smith; Laurie,0,5,58,58
1746575185708,BICD 100R,A03,894367,Smith; Laurie,0,0,59,59
1746575185708,BICD 100R,A04,959869,Smith; Laurie,40,0,59,19
1746575186734,BICD 136,A01,894383,Gustafson-Brown; Cindy,14,0,50,36
1746575187760,BIEB 102,A01,894494,Butler; Shannon Rhey,51,0,130,79
1746575189814,BIEB 150,A01,894617,Wills; Christopher,3,0,20,17
1746575189814,BIEB 150,A02,894631,Wills; Christopher,3,0,20,17
1746575189814,BIEB 150,A03,894937,Wills; Christopher,3,0,20,17
1746575189814,BIEB 150,A04,894946,Wills; Christopher,5,0,20,15
1746575190838,BIEB 194,A00,906141,Kurle; Carolyn M.,6,0,20,14
1746575191864,BILD 1,A01,894154,Staff,3,0,19,16
1746575191864,BILD 1,A02,894155,Staff,14,0,19,5
1746575191864,BILD 1,A03,894160,Staff,13,0,19,6
1746575191864,BILD 1,A04,894161,Staff,15,0,18,3
1746575192890,BILD 2,A01,894168,Staff,0,0,50,50
1746575192890,BILD 2,A02,894169,Staff,0,0,50,50
1746575192890,BILD 2,A03,894179,Staff,0,0,50,50
1746575192890,BILD 2,A04,894203,Staff,24,0,50,26
1746575193920,BILD 3,A01,894213,Staff,23,0,31,8
1746575193920,BILD 3,A02,894214,Staff,26,0,31,5
1746575193920,BILD 3,A03,894235,Staff,28,0,31,3
1746575193920,BILD 3,A04,894236,Staff,28,0,32,4
1746575194945,BILD 4,A01,894253,Reuther; Keefe,5,0,24,19
1746575194945,BILD 4,A02,894258,Reuther; Keefe,16,0,24,8
1746575195975,BILD 5,A01,894276,Reuther; Keefe,35,0,50,15
1746575195975,BILD 5,A02,894277,Reuther; Keefe,45,0,50,5
1746575195975,BILD 5,A03,894290,Reuther; Keefe,44,0,50,6
1746575195975,BILD 5,A04,894291,Reuther; Keefe,48,0,50,2
1746575197000,BILD 24,A01,894297,Pirino; Giorgia,40,0,60,20
1746575198029,BIMM 100,B01,958915,Staff,71,0,100,29
1746575199054,BIMM 101,A01,895017,McDonnell; Lisa Marie,0,5,24,24
1746575199054,BIMM 101,A02,895018,McDonnell; Lisa Marie,0,5,24,24
1746575199054,BIMM 101,B01,895020,McDonnell; Lisa Marie,0,6,24,24
1746575199054,BIMM 101,B02,895021,McDonnell; Lisa Marie,0,4,24,24
1746575200081,BIMM 110,A01,895023,Staff,1,0,25,24
1746575200081,BIMM 110,A02,895024,Staff,9,0,25,16
1746575200081,BIMM 110,A03,895025,Staff,18,0,25,7
1746575200081,BIMM 110,A04,895031,Staff,20,0,25,5
1746575201105,BIMM 120,A01,895114,Gustafson-Brown; Cindy,14,0,28,14
1746575201105,BIMM 120,A02,895126,Gustafson-Brown; Cindy,21,0,27,6
1746575202131,BIPN 100,A01,895130,Yang; Mingyu,0,0,38,38
1746575202131,BIPN 100,A02,895131,Yang; Mingyu,32,0,38,6
1746575202131,BIPN 100,A03,895132,Yang; Mingyu,32,0,38,6
1746575202131,BIPN 100,A04,895133,Yang; Mingyu,27,0,36,9
1746575203158,BIPN 120,A01,895135,Cooke; James Edward,0,3,13,13
1746575203158,BIPN 120,A02,895136,Cooke; James Edward,0,1,13,13
1746575203158,BIPN 120,A03,895137,Cooke; James Edward,0,3,13,13
1746575203158,BIPN 120,A04,895156,Cooke; James Edward,0,2,11,11
1746575204187,BIPN 134,A01,895235,Cooke; James Edward,0,2,25,25
1746575204187,BIPN 134,A02,895237,Cooke; James Edward,0,0,25,25
1746575204187,BIPN 134,A03,895240,Cooke; James Edward,3,0,25,22
1746575204187,BIPN 134,A04,895270,Cooke; James Edward,20,0,25,5
1746575205215,BIPN 189,A00,892103,Staff,0,14,14,14
1746575207268,BISP 194,A00,958008,Staff,0,2,0,0
1746575208291,CAT 124,A01,922009,Staff,0,5,20,20
1746575209316,CAT 125R,A00,886390,Morales; Celeste Georgianna,0,2,20,20
1746575209316,CAT 125R,B00,886391,Irwin; Matthew Joseph,0,4,20,20
1746575209316,CAT 125R,C00,886392,Smith; Lauryn Alissa,0,2,20,20
1746575209316,CAT 125R,D00,886393,Vanderschuit; Maya Alysia,0,3,20,20
1746575209316,CAT 125R,E00,886394,Marchisotto; Jennifer Anne,0,3,20,20
1746575210345,CENG 15,A01,886218,Drews; Aaron,3,0,8,5
1746575211369,CENG 113,A00,886219,Opatkiewicz; Justin Paul,15,0,25,10
1746575212394,CGS 101,A00,887044,Staff,7,0,20,13
1746575213418,CGS 105,A01,887046,Staff,14,0,25,11
1746575214446,CGS 112,A00,887047,Cuong; Marisol,12,0,15,3
1746575215469,CGS 113,A00,887048,Staff,23,0,30,7
1746575216497,CGS 120,A00,887049,Staff,10,0,17,7
1746575217524,CHEM 6A,A01,886336,Lam; Tin Yiu,38,0,50,12
1746575217524,CHEM 6A,A02,886338,Lam; Tin Yiu,37,0,50,13
1746575218551,CHEM 6B,A01,886341,Hopkins; Patrycja Anna,16,0,50,34
1746575218551,CHEM 6B,A02,886343,Hopkins; Patrycja Anna,42,0,50,8
1746575219582,CHEM 6C,A01,886346,Albizati; Kim F.,0,2,50,50
1746575219582,CHEM 6C,A02,886348,Albizati; Kim F.,23,0,50,27
1746575220609,CHEM 40A,A01,886352,Klosterman; Jeremy K,65,0,100,35
1746575221641,CHEM 40B,A01,886356,Klosterman; Jeremy K,0,23,100,100
1746575222685,CHEM 41B,A01,886360,Theodorakis; Emmanuel,25,0,50,25
1746575222685,CHEM 41B,A02,886362,Theodorakis; Emmanuel,47,0,50,3
1746575223710,CHIN 165A,A00,886382,Xu; Li,18,0,20,2
1746575224736,CLAS 120,A00,886387,Myerston Santana; Jacobo,33,0,40,7
1746575225760,COGS 9,A01,886967,Shannon; Kyle Michael,42,0,60,18
1746575226785,COGS 11,A01,886969,Staff,9,0,30,21
1746575227810,COGS 14A,A01,886971,Staff,6,0,60,54
1746575228839,COGS 14B,A01,886973,Hoffman; Drew Ellen,4,0,60,56
1746575229863,COGS 18,A01,886975,Morgan; Eric,35,0,60,25
1746575230887,COGS 20,A01,886977,Staff,4,0,8,4
1746575230887,COGS 20,A02,886978,Staff,5,0,7,2
1746575231912,COGS 100,A01,907783,Staff,1,2,30,29
1746575232938,COGS 101B,A01,886980,Staff,0,3,48,48
1746575233965,COGS 101C,A01,886982,Delgado; Tania,0,5,44,44
1746575234997,COGS 102A,A01,886984,Johnson; Christine M.,4,0,30,26
1746575236034,COGS 118B,A01,886986,Staff,1,4,88,87
1746575237060,COGS 150,A01,886988,Bergen; Benjamin,22,0,50,28
1746575238088,COGS 153,A00,886989,Delgado; Tania,0,2,41,41
1746575239113,COGS 186,A01,886991,Staff,0,0,32,32
1746575240137,COGS 187A,A01,886993,Boyle; Mary E. T.,7,0,30,23
1746575241165,COGS 189,A00,886994,Staff,0,1,30,30
1746575242190,COMM 10,A01,886996,Staff,0,0,20,21
1746575242190,COMM 10,A02,886997,Staff,11,0,20,9
1746575242190,COMM 10,A03,959845,Staff,19,0,20,1
1746575243218,COMM 20,A01,886999,Leuning; Grant Maurstad,24,0,40,16
1746575245270,COMM 100A,A01,887002,Staff,0,0,20,25
1746575245270,COMM 100A,A02,887003,Staff,6,0,20,14
1746575246298,COMM 100B,A01,887005,Staff,0,8,20,24
1746575247325,COMM 106D,A00,887006,Staff,13,0,40,27
1746575248351,COMM 110G,A00,887007,Whitworth-Smith; Andrew C,12,0,40,28
1746575249377,COMM 111B,A00,887008,Staff,31,0,40,9
1746575250402,COMM 113T,A00,887009,Abuelhiga; Soraya Jill,28,0,40,12
1746575250402,COMM 113T,B00,906733,Staff,40,0,40,0
1746575251427,COMM 145,A00,887010,Staff,12,0,40,28
1746575252452,COMM 146,A00,887054,Staff,31,0,40,9
1746575253481,COMM 190,A00,887012,Staff,8,0,23,15
1746575254508,CSE 8A,A50,887015,Cao; Yingjun,57,0,85,28
1746575255533,CSE 11,A01,887017,Cao; Yingjun,12,0,70,58
1746575256558,CSE 20,A01,887019,Staff,30,0,50,20
1746575257588,CSE 21,A01,887021,Staff,78,0,100,22
1746575257588,CSE 21,B01,892583,Braun; Oliver,45,0,50,5
1746575258612,CSE 30,A01,887025,Eldon; John,143,0,200,57
1746575259640,CSE 100,A01,887027,Staff,26,0,50,24
1746575259640,CSE 100,A02,887028,Staff,42,0,50,8
1746575260666,CSE 101,A01,887030,Braun; Oliver,74,0,100,26
1746575260666,CSE 101,B01,887032,Jones; Miles E,0,3,50,50
1746575260666,CSE 101,B02,887033,Jones; Miles E,0,2,50,50
1746575261695,CSE 105,A01,908084,Jones; Miles E,32,0,50,18
1746575261695,CSE 105,A02,908087,Jones; Miles E,31,0,50,19
1746575262720,CSE 135,A01,887035,Powell; Thomas Allan,0,5,50,50
1746575263747,CSE 142,A01,887037,Staff,8,0,60,52
1746575264772,CSE 142L,A01,887039,Staff,34,0,60,26
1746575265798,CSE 151A,A01,887041,Solares; Edwin A,47,0,100,53
1746575266822,CSE 175,A01,887043,Kumar; Rakesh,30,0,30,0
1746575267849,CSS 1,A01,886389,Staff,1,1,40,39
1746575268875,DSC 30,A01,908097,Liao; Soohyun Nam,47,0,75,28
1746575269904,DSC 40A,A01,908099,Shannon; Kyle Michael,30,0,50,20
1746575270931,DSC 40B,A01,908112,Staff,15,0,50,35
1746575271957,DSC 80,A01,908116,Staff,19,0,60,41
1746575272981,DSC 197,001,956863,Eldridge; Justin Matthew,9999,0,9999,0
1746575274006,ECE 5,A01,886400,Morris; Karcher William,1,0,6,5
1746575274006,ECE 5,A02,886401,Morris; Karcher William,3,0,6,3
1746575275032,ECE 148,A01,886403,Silberman; Jack,0,14,14,14
1746575276062,ECON 1,A01,887265,Crane; Meredith Helen,12,0,70,58
1746575276062,ECON 1,B01,887268,Staff,42,0,50,8
1746575277085,ECON 2,A01,887273,Crane; Meredith Helen,55,0,70,15
1746575278113,ECON 3,A01,887279,Rondina; Giacomo,32,0,70,38
1746575279138,ECON 4,A01,887282,Anderson; John Charles,0,2,10,10
1746575280162,ECON 5,A01,887285,Staff,34,0,45,11
1746575280162,ECON 5,B01,887292,Staff,41,0,45,4
1746575281188,ECON 100A,A01,887337,Newhouse; Herbert S,54,0,70,16
1746575281188,ECON 100A,B01,887349,Staff,45,0,50,5
1746575282215,ECON 100B,A01,887361,Du; Songzi,29,0,70,41
1746575283244,ECON 100C,A01,887445,Newhouse; Herbert S,59,0,70,11
1746575284267,ECON 105,A00,887488,Vespa; Emanuel Ignacio,23,0,35,12
1746575285294,ECON 109,A01,887506,Shishkin; Denis,28,0,35,7
1746575286325,ECON 110A,A01,887568,Alon; Titan Michael,0,3,35,35
1746575286325,ECON 110A,B01,907601,Alon; Titan Michael,20,0,35,15
1746575287353,ECON 110B,A01,887598,Levkoff; Steven B.,0,24,70,70
1746575288377,ECON 112,A00,887599,Rondina; Giacomo,19,0,35,16
1746575289401,ECON 120A,A01,887603,Dai; Yinlin,35,0,70,35
1746575290431,ECON 120C,A01,887608,Sun; Yixiao,0,1,35,35
1746575290431,ECON 120C,B01,887614,Sun; Yixiao,0,0,35,35
1746575291471,ECON 138,A00,887621,Bharadwaj; Prashant,0,21,20,20
1746575292498,ECON 144,A00,958007,Squires; Dale E,12,0,35,23
1746575293522,ECON 171,A01,907666,Staff,18,0,35,17
1746575294549,ECON 175,A00,887626,Wu; Pak Yeung,22,0,35,13
1746575295577,ECON 190,A00,887640,Vespa; Emanuel Ignacio,22,0,35,13
1746575296605,EDS 25,A01,888197,Staff,0,0,0,0
1746575296605,EDS 25,A02,888209,Staff,0,0,0,0
1746575296605,EDS 25,A03,888210,Staff,0,0,0,0
1746575296605,EDS 25,A04,888212,Staff,0,0,0,0
1746575296605,EDS 25,A05,888213,Staff,0,0,0,0
1746575296605,EDS 25,A06,888214,Staff,0,0,0,0
1746575296605,EDS 25,A07,888235,Staff,0,2,0,0
1746575296605,EDS 25,A08,888236,Staff,0,0,0,0
1746575296605,EDS 25,A09,888240,Staff,0,0,0,0
1746575296605,EDS 25,A10,888244,Staff,0,0,0,0
1746575296605,EDS 25,B01,888273,Staff,0,0,0,0
1746575296605,EDS 25,B02,888285,Staff,0,0,0,0
1746575296605,EDS 25,B03,888423,Staff,0,0,0,1
1746575296605,EDS 25,B04,888432,Staff,0,0,0,0
1746575296605,EDS 25,B05,888433,Staff,0,0,0,0
1746575296605,EDS 25,B06,888467,Staff,0,0,0,0
1746575296605,EDS 25,B07,888468,Staff,0,0,0,0
1746575296605,EDS 25,B08,888479,Staff,0,0,0,0
1746575296605,EDS 25,B09,888484,Staff,0,0,0,0
1746575296605,EDS 25,B10,888487,Staff,0,0,0,0
1746575297635,EDS 38,A01,907700,Choi; Bailey Miyeon,30,0,30,0
1746575298660,EDS 112,A01,888601,Chapman; Thandeka K,12,0,40,28
1746575299684,EDS 115,A00,888697,Mendez; Kathrina Mendoza,10,0,30,20
1746575300709,EDS 116,A01,888893,Staff,34,0,40,6
1746575302767,EDS 124AR,A00,889133,Staff,29,0,50,21
1746575302767,EDS 124AR,B00,907471,Simon; Elizabeth A,37,0,50,13
1746575303793,EDS 124BR,A00,889134,Simon; Elizabeth A,44,0,100,56
1746575304818,EDS 125,A00,889135,Staff,25,0,30,5
1746575305847,EDS 126,A01,889138,Staff,35,0,40,5
1746575306875,EDS 164R,A01,889142,Wishard Guerra; Alison G.,33,0,50,17
1746575307900,ENG 30,A01,886396,Staff,0,0,0,0
1746575307900,ENG 30,B01,886398,Staff,0,0,0,0
1746575308925,ENVR 102,A00,906150,Montejo; Carolina,23,0,25,2
1746575309955,ETHN 103A,A00,887236,Man; Simeon S,0,3,0,0
1746575310980,ETHN 113,A00,887239,Staff,16,0,30,14
1746575312008,ETHN 116,A00,887240,Staff,16,0,25,9
1746575313033,ETHN 117,A00,887241,Choi; Esther Min,28,0,30,2
1746575314062,ETHN 118,A00,887243,Staff,24,0,30,6
1746575315086,ETHN 127,A00,887248,Cuong; Marisol,11,0,15,4
1746575316111,ETHN 139,A00,887250,Staff,7,0,10,3
1746575317135,ETHN 142,A00,887252,Staff,10,0,30,20
1746575318160,ETHN 161,A00,887253,Browne; Errol Tsekani,24,0,30,6
1746575319188,ETHN 163FR,A00,887255,Burelle; Julie Sara Veronique,0,0,5,5
1746575320216,GLBH 20,A00,889149,Elwardani; Nile Regina,8,0,42,34
1746575322267,GLBH 111,A01,889152,Burgos; Jose L.,17,0,17,0
1746575323294,GLBH 150,A00,889181,Sloane; Julia Kathryn,0,5,15,15
1746575325349,HDS 60,A01,886406,Warstadt; Melissa Fawn,73,0,80,7
1746575326375,HIAF 111,A00,889324,Gyamfi; Bright,25,0,32,7
1746575327400,HIEA 131,A00,889328,Staff,15,0,32,17
1746575328424,HIEA 144,A00,889333,Henry; Todd A.,26,0,32,6
1746575329449,HIEA 154,A00,889336,Henry; Todd A.,24,0,32,8
1746575330474,HIEU 106,A00,889339,Staff,22,0,32,10
1746575332523,HIEU 114,A00,889340,Staff,4,0,32,28
1746575333568,HIEU 135GS,A00,889342,Patterson; Patrick H.,0,0,1,24
1746575334595,HIEU 137,A00,889343,Edington; Claire Ellen,10,0,25,15
1746575335620,HIEU 148,A00,889345,Staff,14,0,32,18
1746575336645,HIEU 154,A00,889346,Biess; Frank Peter,21,0,32,11
1746575337673,HILA 102,A00,889351,Staff,12,0,32,20
1746575338699,HILD 2A,A01,889221,Lewandoski; Julia Mavis,1,10,32,31
1746575339723,HILD 7B,A01,889225,Man; Simeon S,0,12,32,32
1746575340747,HILD 7C,A01,889288,Alvarez; Luis A,0,14,32,32
1746575341773,HILD 30,A01,889323,Staff,0,5,32,32
1746575343826,HISC 119,A00,889383,Golan; Tal,19,0,32,13
1746575344855,HIUS 103,A00,889384,Man; Simeon S,0,0,32,32
1746575345880,HIUS 117,A00,919797,Kwak; Nancy,19,0,32,13
1746575346905,HIUS 142A,A00,919788,Staff,22,0,32,10
1746575348953,HIUS 149,A00,889386,Gyamfi; Bright,26,0,32,6
1746575349978,HIUS 155,A00,889387,Alvarez; Luis A,15,0,32,17
1746575351004,HUM 3,A01,886499,Caldwell; Michael Alan,19,0,50,31
1746575352028,HUM 3GS,A00,886500,Rodriguez; Bretton Sigfred,0,0,0,28
1746575353052,HUM 3R,A01,886502,Markman; Kristina,0,36,50,50
1746575354077,HUM 4,A01,886504,Crum; Matthew Stephen,23,0,50,27
1746575354077,HUM 4,B01,886506,West; Geoffrey Scott,17,0,50,33
1746575355102,HUM 4GS,A00,886507,Staff,0,0,0,19
1746575356130,HUM 5,A01,886509,Staff,32,0,50,18
1746575357157,HUM 5R,A01,886511,Zavodny; Tatiana Sophia,0,39,50,50
1746575358181,JAPN 180,A00,886407,Staff,16,0,40,24
1746575359210,LATI 50,A01,886409,Martin-Cabrera; Luis,4,0,22,18
1746575359210,LATI 50,A02,886410,Martin-Cabrera; Luis,19,0,22,3
1746575359210,LATI 50,A03,886411,Martin-Cabrera; Luis,21,0,22,1
1746575359210,LATI 50,A04,886412,Martin-Cabrera; Luis,9,0,22,13
1746575360236,LAWS 101,A00,907664,Staff,28,0,60,32
1746575361262,LIAB 1A,A00,889388,Saab; Dima,17,0,20,3
1746575362287,LIAB 1AX,A00,889389,El Cheddadi; Youniss,18,0,20,2
1746575363312,LIFR 1C,A00,889391,Van Moer; Vinciane G,8,0,20,12
1746575364337,LIFR 1CX,A00,889392,Van Moer; Vinciane G,7,0,20,13
1746575365361,LIFR 1D,A00,889393,Van Moer; Vinciane G,7,0,20,13
1746575366389,LIFR 1DX,A00,889394,Van Moer; Vinciane G,8,0,20,12
1746575367419,LIGN 7,A00,886923,Staff,24,0,50,26
1746575368443,LIGN 17,A00,886924,Kehler; Andrew Scott,125,0,150,25
1746575369468,LTAM 110,A00,889395,Staff,15,0,30,15
1746575370513,LTAM 110GS,A00,958010,Rodriguez; Bretton Sigfred,0,0,0,28
1746575371538,LTCH 101,A00,889397,Staff,23,0,25,2
1746575372564,LTCS 130,A00,889398,Staff,23,0,25,2
1746575373589,LTEA 138,A00,889399,Staff,24,0,40,16
1746575374616,LTEN 149,A00,889400,Wesling; Megan E.,0,3,25,25
1746575375641,LTEN 169,A00,889401,Staff,20,0,25,5
1746575376665,LTEN 180,A00,889402,Staff,10,0,15,5
1746575377692,LTEN 181,A00,889403,Staff,21,0,25,4
1746575378715,LTWL 100,A00,889404,Myerston Santana; Jacobo,2,0,25,23
1746575379741,LTWL 180GS,A00,889405,Staff,0,0,20,20
1746575380767,LTWL 181,A00,889406,Staff,16,0,25,9
1746575381792,LTWL 184,A00,889475,Mukherjee; Silpa,22,0,25,3
1746575382816,LTWR 102C,A00,889486,Staff,29,0,30,1
1746575383843,LTWR 115W,A00,889491,Staff,0,2,15,15
1746575384869,MAE 8,A01,886905,Staff,0,2,0,0
1746575385896,MAE 11,A00,886906,Bandaru; Prabhakar,0,7,50,50
1746575386922,MAE 20,A00,886907,Evdokimenko; Ekaterina,43,0,70,27
1746575387950,MAE 30B,A00,886909,Ghazinejad; Maziar,26,0,45,19
1746575388979,MAE 101B,A00,886910,Saintillan; David,29,0,45,16
1746575390005,MAE 105,A00,886911,Bandaru; Prabhakar,18,0,50,32
1746575391031,MAE 107,B00,958024,Staff,8,0,50,42
1746575392062,MAE 143B,A00,886913,Bewley; Thomas R,4,0,40,36
1746575393090,MAE 148,A01,886915,Silberman; Jack,0,3,14,14
1746575394118,MAE 160,A00,886916,Evdokimenko; Ekaterina,31,0,60,29
1746575395147,MATH 3C,A01,889681,Staff,0,2,30,30
1746575395147,MATH 3C,A02,960048,Staff,24,0,30,6
1746575396171,MATH 10A,A01,889760,Staff,26,0,30,4
1746575396171,MATH 10A,A02,889783,Staff,29,0,30,1
1746575397196,MATH 10B,A01,889785,Verstraete; Jacques Allan,2,0,35,33
1746575397196,MATH 10B,A02,889795,Verstraete; Jacques Allan,4,0,35,31
1746575397196,MATH 10B,B01,889797,Verstraete; Jacques Allan,3,0,35,32
1746575397196,MATH 10B,B02,889828,Verstraete; Jacques Allan,3,0,35,32
1746575398223,MATH 10C,A01,889849,Habib; Yousaf,7,0,30,23
1746575398223,MATH 10C,A02,889852,Habib; Yousaf,14,0,30,16
1746575398223,MATH 10C,A03,889853,Habib; Yousaf,22,0,30,8
1746575398223,MATH 10C,A04,889858,Habib; Yousaf,20,0,30,10
1746575398223,MATH 10C,B01,889861,Staff,1,0,30,29
1746575398223,MATH 10C,B02,889862,Staff,24,0,30,6
1746575398223,MATH 10C,B03,889863,Staff,27,0,30,3
1746575398223,MATH 10C,B04,889967,Staff,23,0,30,7
1746575399249,MATH 18,A01,889974,Staff,7,0,30,23
1746575399249,MATH 18,A02,889977,Staff,20,0,30,10
1746575399249,MATH 18,B01,889984,Hardiman; Liam,21,0,30,9
1746575399249,MATH 18,B02,889985,Hardiman; Liam,25,0,30,5
1746575400273,MATH 20A,A01,889990,Suk; Andrew Hoon,30,0,35,5
1746575401297,MATH 20B,A01,889993,Ohm; Ko Woon,22,0,30,8
1746575401297,MATH 20B,A02,889994,Ohm; Ko Woon,30,0,30,0
1746575401297,MATH 20B,B01,889996,Ohm; Ko Woon,22,0,30,8
1746575401297,MATH 20B,B02,889997,Ohm; Ko Woon,23,0,30,7
1746575402325,MATH 20C,A01,889999,Hammock; Frances H,17,0,30,13
1746575402325,MATH 20C,A02,890003,Hammock; Frances H,23,0,30,7
1746575402325,MATH 20C,B01,890006,Hammock; Frances H,3,0,30,27
1746575402325,MATH 20C,B02,890007,Hammock; Frances H,12,0,30,18
1746575403351,MATH 20D,A01,890011,Cheng; Hsiao-Bing,1,1,30,29
1746575403351,MATH 20D,A02,890012,Cheng; Hsiao-Bing,14,0,30,16
1746575403351,MATH 20D,B01,890016,Cheng; Hsiao-Bing,13,0,30,17
1746575403351,MATH 20D,B02,890017,Cheng; Hsiao-Bing,13,0,30,17
1746575404381,MATH 20E,A01,890026,Harel; Guershon,1,0,30,29
1746575404381,MATH 20E,A02,890029,Harel; Guershon,23,0,30,7
1746575404381,MATH 20E,B01,890033,Harel; Guershon,7,0,30,23
1746575404381,MATH 20E,B02,890101,Harel; Guershon,21,0,30,9
1746575405408,MATH 102,A01,890104,Staff,17,0,30,13
1746575405408,MATH 102,A02,890105,Staff,27,0,30,3
1746575406434,MATH 103B,A01,890116,Salehi Golsefidy; Alireza,3,0,30,27
1746575406434,MATH 103B,B01,890118,Staff,0,3,34,34
1746575407459,MATH 109,A01,890121,Aliabadi Sr.; Mohsen,1,0,30,29
1746575407459,MATH 109,B01,890124,Upadrashta; Pranav Kumar,18,0,30,12
1746575408485,MATH 120A,A01,890126,Eggers; John Dietrich,13,0,30,17
1746575409511,MATH 142B,A01,890128,Ioana; Adrian,19,0,30,11
1746575409511,MATH 142B,A02,890129,Ioana; Adrian,13,0,30,17
1746575410535,MATH 154,A01,890174,Staff,0,0,30,30
1746575410535,MATH 154,A02,890182,Staff,0,0,30,30
1746575411560,MATH 168A,A01,890197,Dumitriu; Ioana,21,0,35,14
1746575412585,MATH 170A,A01,890240,Nie; Jiawang,1,0,30,29
1746575412585,MATH 170A,A02,890241,Nie; Jiawang,11,0,30,19
1746575412585,MATH 170A,A03,890249,Nie; Jiawang,23,0,30,7
1746575413613,MATH 170B,A01,957891,Nag; Panchali,13,0,35,22
1746575415670,MATH 181A,A01,908025,Staff,0,3,35,35
1746575415670,MATH 181A,A02,960115,Staff,26,0,35,9
1746575416698,MATH 181B,A01,959874,Staff,25,0,30,5
1746575417726,MATH 193B,A01,890265,Staff,0,4,35,35
1746575418750,MGT 4,A01,890311,Anderson; John Charles,42,0,88,46
1746575419776,MGT 5,A00,907740,Staff,13,0,98,85
1746575420801,MGT 12,A00,890312,Lindenberger; Wade Douglas,67,0,98,31
1746575421828,MGT 16,A00,957883,Staff,78,0,98,20
1746575423879,MGT 45,A00,890314,Pecore; Joseph P.,45,0,98,53
1746575424906,MGT 71,A00,890315,Staff,0,11,98,98
1746575425932,MGT 100,A00,890316,Yavorsky; Daniel Ryan,44,0,98,54
1746575426959,MGT 103,A00,890317,Ehrich; Kristine R,73,0,98,25
1746575427987,MGT 105,A00,890356,Bates; Kenneth Walter,0,8,98,98
1746575429010,MGT 112,A00,890360,Ehrich; Kristine R,55,0,98,43
1746575430038,MGT 127R,A00,907732,Zhu; Kevin Xiaoguo,23,0,98,75
1746575431064,MGT 131B,A00,890361,Anderson; John Charles,59,0,98,39
1746575432299,MGT 137,A00,890362,Lindenberger; Wade Douglas,65,0,98,33
1746575433325,MGT 160,A00,890369,Johnson; Erik Barry,9,0,98,89
1746575435375,MGT 164,A00,890372,Zimmermann; Carsten,0,40,98,98
1746575436403,MGT 180,A00,890374,Bliss; Barbara Ann,12,0,98,86
1746575437429,MMW 15,A01,886414,Chang; Edmond Yi-Teh,0,12,28,28
1746575437429,MMW 15,A02,886415,Chang; Edmond Yi-Teh,0,8,28,28
1746575437429,MMW 15,A03,886416,Chang; Edmond Yi-Teh,0,9,28,28
1746575437429,MMW 15,A04,886417,Chang; Edmond Yi-Teh,0,8,28,28
1746575437429,MMW 15,B01,886419,Chang; Edmond Yi-Teh,0,7,28,28
1746575437429,MMW 15,B02,886420,Chang; Edmond Yi-Teh,0,8,28,28
1746575437429,MMW 15,B03,886421,Chang; Edmond Yi-Teh,0,7,28,28
1746575437429,MMW 15,B04,886422,Chang; Edmond Yi-Teh,0,8,28,28
1746575437429,MMW 15,C01,886424,Staff,0,9,28,28
1746575437429,MMW 15,C02,886425,Staff,0,8,28,28
1746575437429,MMW 15,C03,886426,Staff,0,8,28,28
1746575437429,MMW 15,C04,886427,Staff,0,8,28,28
1746575437429,MMW 15,C05,958038,Staff,0,8,28,28
1746575437429,MMW 15,C06,958039,Staff,1,8,28,27
1746575438453,MMW 15GS,A00,906910,Patterson; Patrick H.,4,0,28,24
1746575439480,MMW 122R,A01,886429,Rahimi; Babak,0,13,28,28
1746575439480,MMW 122R,A02,886430,Rahimi; Babak,0,12,28,28
1746575439480,MMW 122R,A03,958040,Rahimi; Babak,0,11,28,28
1746575440512,MUS 1A,A01,890937,Staff,2,0,25,23
1746575440512,MUS 1A,A02,891035,Staff,6,0,25,19
1746575440512,MUS 1A,C01,958912,Staff,24,0,25,1
1746575440512,MUS 1A,C02,958913,Staff,25,0,25,0
1746575442567,MUS 2AK,A00,957092,Ohnishi; Takae,15,0,15,0
1746575443597,MUS 4,A01,891044,Staff,1,0,25,24
1746575443597,MUS 4,A02,891045,Staff,23,0,25,2
1746575443597,MUS 4,B01,891048,Staff,17,0,25,8
1746575443597,MUS 4,B02,891050,Staff,25,0,25,0
1746575444631,MUS 5,A01,957506,Dubnov; Shlomo,0,0,25,25
1746575444631,MUS 5,A02,957622,Dubnov; Shlomo,13,0,25,12
1746575444631,MUS 5,A03,957623,Dubnov; Shlomo,20,0,25,5
1746575445661,MUS 6,A01,891053,Freitas Caetano; Marcelo,24,0,25,1
1746575445661,MUS 6,A02,891054,Freitas Caetano; Marcelo,23,0,25,2
1746575446688,MUS 7,A01,891081,Staff,1,0,25,24
1746575446688,MUS 7,A02,891082,Staff,3,0,25,22
1746575447717,MUS 8GS,A00,891118,Borgo; David Garcia,1,0,25,24
1746575448742,MUS 11,A01,891140,Staff,9,0,25,16
1746575448742,MUS 11,A02,891141,Staff,22,0,25,3
1746575449770,MUS 13,A01,891143,Staff,8,0,25,17
1746575449770,MUS 13,A02,891144,Staff,24,0,25,1
1746575450798,MUS 15,A01,891146,Staff,9,0,25,16
1746575450798,MUS 15,A02,891148,Staff,21,0,25,4
1746575450798,MUS 15,B01,891150,Staff,18,0,25,7
1746575450798,MUS 15,B02,891151,Staff,25,0,25,0
1746575451823,MUS 20,A01,891153,Staff,5,0,20,15
1746575451823,MUS 20,A02,891155,Staff,14,0,20,6
1746575452848,MUS 80,A00,891156,Staff,19,0,25,6
1746575452848,MUS 80,B00,891157,Staff,23,0,25,2
1746575453873,MUS 130,A00,891158,Ohnishi; Takae,35,0,35,0
1746575454898,MUS 150GS,A01,891160,Borgo; David Garcia,1,0,25,24
1746575455922,MUS 170,A01,891162,Freitas Caetano; Marcelo,20,0,25,5
1746575455922,MUS 170,A02,891164,Freitas Caetano; Marcelo,21,0,25,4
1746575456956,NANO 11,A00,886220,Vazquez Mena; Oscar,13,0,15,2
1746575457982,NANO 15,A01,886222,Drews; Aaron,4,0,7,3
1746575459009,NANO 104,A00,886224,Sirbuly; Donald,17,0,25,8
1746575460042,PH 40,A00,886528,Staff,24,0,40,16
1746575461067,PH 45,A01,886799,Staff,35,0,40,5
1746575462093,PH 110,A00,886802,Staff,0,7,40,40
1746575463121,PH 172,A00,906716,Staff,19,0,35,16
1746575464147,PH 191,A00,886803,Staff,6,0,40,34
1746575465172,PHIL 1,A00,889500,Staff,20,0,30,10
1746575466197,PHIL 10,A01,889549,Grush; Rick Scott,16,0,22,6
1746575466197,PHIL 10,A02,889551,Grush; Rick Scott,22,0,22,0
1746575467222,PHIL 28,A01,889559,Lamey; Andy M.,0,2,31,31
1746575467222,PHIL 28,A02,889561,Lamey; Andy M.,0,1,30,30
1746575467222,PHIL 28,A03,889572,Lamey; Andy M.,0,1,30,30
1746575468247,PHIL 35,A00,907839,Staff,13,0,15,2
1746575469276,PHIL 60,A00,889574,Staff,73,0,90,17
1746575470305,PHIL 101,A00,958004,Staff,12,0,15,3
1746575472359,PHIL 136,A00,889582,Fulkerson; Matthew Todd,26,0,45,19
1746575473390,PHIL 163,A01,889601,Staff,21,0,30,9
1746575473390,PHIL 163,B01,889606,Brandt; Reuven A,0,3,0,0
1746575474417,PHIL 164,A00,889610,Staff,16,0,30,14
1746575475445,PHIL 165,A00,889613,Staff,22,0,30,8
1746575476472,PHYS 1A,A00,886431,Staff,26,0,70,44
1746575477500,PHYS 1AL,001,886432,Tsai; Philbert S,0,2,30,30
1746575477500,PHYS 1AL,002,886436,Tsai; Philbert S,11,0,30,19
1746575478530,PHYS 1B,A00,886439,Staff,185,0,240,55
1746575479555,PHYS 1BL,001,886441,Tsai; Philbert S,0,4,30,30
1746575479555,PHYS 1BL,002,886444,Tsai; Philbert S,2,0,30,28
1746575480579,PHYS 1C,A00,896092,Arnold; Kam S,78,0,146,68
1746575481605,PHYS 1CL,001,886448,Tsai; Philbert S,0,0,30,30
1746575481605,PHYS 1CL,002,886449,Tsai; Philbert S,1,0,30,29
1746575481605,PHYS 1CL,003,886450,Tsai; Philbert S,16,0,30,14
1746575481605,PHYS 1CL,004,886451,Tsai; Philbert S,15,0,30,15
1746575482631,PHYS 2B,A01,886457,Staff,68,0,115,47
1746575483656,PHYS 2C,A01,886460,Shotwell; Brian,0,9,65,65
1746575484682,PHYS 2CL,A01,886467,Staff,0,4,28,28
1746575484682,PHYS 2CL,A02,886468,Staff,0,3,28,28
1746575485714,PHYS 2D,A01,886470,Staff,10,0,50,40
1746575486745,PHYS 4B,A01,886475,Grinstein; Benjamin,22,0,40,18
1746575487775,POLI 5,A00,891173,Desposato; Scott,7,0,25,18
1746575488804,POLI 5D,A01,891175,Staff,5,0,5,0
1746575488804,POLI 5D,B01,891178,Staff,5,0,5,0
1746575489831,POLI 11,A00,891179,Ferree; Karen E,2,0,35,33
1746575490857,POLI 12,A00,891180,Staff,16,0,30,14
1746575491887,POLI 27,A01,891182,Staff,12,0,75,63
1746575492911,POLI 30,A00,891183,Staff,8,0,50,42
1746575493936,POLI 100B,A00,891244,Staff,5,1,35,30
1746575494961,POLI 100I,A00,891247,Staff,7,0,30,23
1746575495985,POLI 104J,A00,891248,Nichter; Maysa,14,0,30,16
1746575497016,POLI 104U,A00,891250,Nichter; Maysa,1,0,30,29
1746575499066,POLI 110B,A00,891255,Wiens; David,19,0,25,6
1746575500089,POLI 112A,A00,891256,Wiens; David,6,0,25,19
1746575501114,POLI 114BR,A00,891261,Staff,19,0,30,11
1746575502140,POLI 117R,A00,891262,Forman; Fonna,0,6,50,50
1746575503164,POLI 118,A00,891264,Ingham; Sean,17,0,25,8
1746575504191,POLI 124A,A00,891265,Staff,18,0,20,2
1746575505215,POLI 125D,A00,891266,Nichter; Simeon C,2,0,25,23
1746575506243,POLI 126,A00,891268,Nichter; Simeon C,7,0,25,18
1746575507267,POLI 126AA,A00,891272,Staff,15,0,25,10
1746575508293,POLI 130AA,A00,891273,Staff,15,0,20,5
1746575509319,POLI 134AA,A00,891274,Staff,4,0,20,16
1746575511372,POLI 138,A00,891278,Staff,21,0,25,4
1746575512400,POLI 142K,A00,891280,Staff,10,0,25,15
1746575513429,POLI 142M,A00,891281,Gartzke; Erik,16,0,30,14
1746575514454,POLI 142P,A00,891284,Staff,20,0,30,10
1746575515480,POLI 143,A00,891285,Gartzke; Erik,12,0,30,18
1746575516504,POLI 153,A00,891286,Staff,19,0,20,1
1746575518556,POLI 175,A00,891290,Staff,15,0,20,5
1746575519584,PSYC 1,A00,890674,Steiner; Eric Tomas,0,11,45,45
1746575520612,PSYC 2,A00,890676,Albright; Thomas D,21,0,35,14
1746575521639,PSYC 3,A00,890679,Staff,17,0,20,3
1746575522668,PSYC 6,A00,959858,Staff,20,0,20,0
1746575523692,PSYC 60,A01,890684,Rickard; Timothy C.,0,5,45,45
1746575524716,PSYC 70,A01,890689,Geller; Emma Harlan,7,0,30,23
1746575525744,PSYC 71,A01,959860,Staff,21,0,25,4
1746575526770,PSYC 100,A00,890690,Lacefield; Katharine I,0,50,180,180
1746575527796,PSYC 102,A00,890695,Staff,18,0,40,22
1746575528820,PSYC 105,A00,890699,Geller; Emma Harlan,70,0,100,30
1746575529845,PSYC 106,A00,890701,Gorman; Michael R.,6,0,30,24
1746575530876,PSYC 108,A00,890704,Adrian; Julia Anna,0,28,50,50
1746575531900,PSYC 118,A01,890712,Staff,11,0,30,19
1746575532928,PSYC 124,A00,890716,Chapman; Eddie Nathaniel,25,0,60,35
1746575533952,PSYC 131,A00,890717,Anagnostaras; Stephan,0,8,80,80
1746575534982,PSYC 137,A00,890719,Winkielman; Piotr,0,11,30,30
1746575536011,PSYC 144,A00,890721,Adrian; Julia Anna,0,9,45,45
1746575537038,PSYC 162,A00,890805,Staff,0,0,75,75
1746575538064,PSYC 169,A00,890810,Staff,0,14,30,30
1746575539089,PSYC 172,A00,890814,Gorman; Michael R.,9,0,30,21
1746575540118,PSYC 181,A00,890818,Anagnostaras; Stephan,9,0,200,191
1746575541146,PSYC 184,A00,959861,Staff,168,0,175,7
1746575542173,PSYC 189,A00,890823,Staff,0,2,30,30
1746575543200,PSYC 191,A00,890884,Rickard; Timothy C.,0,12,35,35
1746575544228,PSYC 193,A00,890913,Staff,19,0,30,11
1746575544228,PSYC 193,B00,890914,Chapman; Eddie Nathaniel,24,0,30,6
1746575545257,PSYC 193L,A01,890918,Lowe; Angela Beth,20,0,30,10
1746575545257,PSYC 193L,B01,890921,Hurwitz; Ethan Scott,20,0,30,10
1746575545257,PSYC 193L,C01,890928,Staff,30,0,30,0
1746575546283,RELI 149,A00,886806,Rahimi; Babak,23,0,40,17
1746575547306,SE 9,A01,886814,Staff,7,0,20,13
1746575548335,SE 101B,A01,886816,Chadha; Mayank,4,0,35,31
1746575549359,SE 110B,A00,886818,Zhu; Qiang,4,0,75,71
1746575550384,SE 125,A01,886830,Staff,10,0,30,20
1746575551412,SE 130B,A01,886835,Staff,14,0,40,26
1746575552439,SE 131A,A01,886838,Krysl; Petr,34,0,55,21
1746575553463,SE 154,A00,886840,Staff,29,0,50,21
1746575554490,SE 164GS,A01,886849,Staff,6,0,20,14
1746575555515,SE 167GS,A01,886853,Staff,6,0,20,14
1746575556539,SIO 25,A01,890107,Staff,19,0,30,11
1746575557568,SIO 45,A00,890109,Cook; Geoffrey W,117,0,200,83
1746575558593,SIO 109R,A00,890110,Forman; Fonna,0,16,20,20
1746575559620,SIO 187,A01,890114,Kacev; David,15,0,40,25
1746575560644,SOCI 1,A01,890431,Thorpe; Charles Robert,14,0,30,16
1746575560644,SOCI 1,A02,890518,Thorpe; Charles Robert,30,0,30,0
1746575561672,SOCI 2,A01,957978,Staff,25,0,25,0
1746575561672,SOCI 2,A02,957979,Staff,23,0,25,2
1746575562698,SOCI 20,A01,890523,Calderon-Zaks; Michael Aar,21,0,30,9
1746575562698,SOCI 20,A02,890526,Calderon-Zaks; Michael Aar,29,0,30,1
1746575563727,SOCI 30,A01,890533,Pardo Guerra; Juan Pablo,37,0,40,3
1746575564752,SOCI 40,A01,890535,Staff,27,0,45,18
1746575565777,SOCI 104Q,A00,890559,Staff,18,0,30,12
1746575566802,SOCI 106,A00,890560,Arnal; Maud Marie Leonie,20,0,30,10
1746575567831,SOCI 110,A00,890567,Holkenbrink-Monk; Charlene,19,0,30,11
1746575568856,SOCI 112,A00,890568,Victoria Torres; Pablo,2,0,55,53
1746575569883,SOCI 115,A00,890597,Arnal; Maud Marie Leonie,28,0,45,17
1746575571938,SOCI 121,A00,890604,Pardo Guerra; Juan Pablo,38,0,45,7
1746575572962,SOCI 126,A01,890608,Staff,8,0,10,2
1746575573988,SOCI 127,A00,890609,Staff,18,0,30,12
1746575575016,SOCI 131,A00,890610,Thorpe; Charles Robert,37,0,45,8
1746575576046,SOCI 135,A00,890615,Payne; Christine Anna,13,0,45,32
1746575577073,SOCI 139,A00,890620,Staff,38,0,45,7
1746575578101,SOCI 148E,A00,890622,Calderon-Zaks; Michael Aar,36,0,45,9
1746575579128,SOCI 150,A00,890623,Kohler; Kristopher M.,31,0,45,14
1746575580156,SOCI 157,A00,890625,Jules-Rosette; Bennetta W.,18,0,20,2
1746575581184,SOCI 160,A00,890627,Payne; Christine Anna,21,0,45,24
1746575582208,SYN 1,A00,886855,Fish; Gwendolyn Anne,0,1,0,0
1746575582208,SYN 1,B00,906086,Fish; Gwendolyn Anne,0,2,0,2
1746575583233,SYN 2R,A00,886860,Staff,0,17,15,15
1746575583233,SYN 2R,B00,906106,Atkinson; Arthur Laird,0,16,15,15
1746575584259,SYN 100,A01,886866,Browne; Emily,0,28,20,20
1746575584259,SYN 100,B01,906128,Rock; Martin,0,5,20,20
1746575584259,SYN 100,C01,906140,Deavenport; James Cary,0,3,20,20
1746575584259,SYN 100,D01,907816,Deavenport; James Cary,0,5,20,20
1746575585284,TDAC 1,A00,890286,Walsh; Kim C.,8,0,20,12
1746575586310,TDAC 101,A00,890296,Basso; Beatrice,15,0,20,5
1746575587337,TDDE 131,A00,890297,Staff,47,0,50,3
1746575588361,TDDM 1,A00,890287,Weinberg; Sadie,25,0,30,5
1746575589386,TDGE 11,A00,890288,Fulton; Julia,138,0,200,62
1746575589386,TDGE 11,B00,890289,Castro; Robert Jess,184,0,200,16
1746575590410,TDGE 25,B00,957359,Walsh; Kim C.,5,0,20,15
1746575591434,TDGE 40,A01,890292,Power; Jade Yukana,27,0,30,3
1746575592458,TDGE 124,A00,890298,Havis; Allan,0,1,50,50
1746575593483,TDGE 131R,A00,890299,Burelle; Julie Sara Veronique,15,0,42,27
1746575594506,TDHT 101,A00,890300,Staff,10,0,20,10
1746575595534,TDHT 109,A01,890302,Anderson; Mysia Anyse,31,0,40,9
1746575596559,TDMV 1,A00,890293,Arcidiacono; Kristin,18,0,30,12
1746575597588,TDMV 2,A00,890294,Weinberg; Sadie,23,0,30,7
1746575598614,TDMV 3,A00,957878,Arcidiacono; Kristin,28,0,30,2
1746575600663,TDMV 138,A00,890304,Jun; Grace Shin Hae,25,0,40,15
1746575601689,TDMV 140,A00,890305,Corrales; Joseph Bernales,25,0,30,5
1746575602714,TDMV 142,A00,890307,Caligagan; Tony,32,0,40,8
1746575603739,TDMV 144,A00,890308,Camaya; Michelle Ann,25,0,30,5
1746575604766,TDPW 1,A00,890295,Stein; Deborah Isobel,3,0,20,17
1746575605791,USP 2,A01,890272,Lerner; Amy M,7,0,20,13
1746575606817,USP 3,A01,890274,Staff,12,0,30,18
1746575607842,USP 15,A01,890276,Sun; Feiyang,16,0,30,14
1746575608866,USP 25,A00,890277,Shenkman; Michael Thomas,18,0,25,7
1746575609893,USP 138,A00,890278,Staff,14,0,25,11
1746575610918,USP 143,A00,890279,Staff,22,0,70,48
1746575611946,USP 144,A00,890280,Chowdhury; Muhammed Zohir,16,0,30,14
1746575612970,USP 150,A00,890281,Boomhower; Matthew Charles,4,0,30,26
1746575613996,USP 151,A00,890282,Staff,16,0,20,4
1746575615023,USP 162,A00,890283,Andrews; Abigail Leslie,16,0,20,4
1746575616048,USP 168,A00,920477,Kwak; Nancy,0,0,5,5
1746575617077,USP 181,A00,890284,Staff,3,0,20,17
1746575618102,USP 191A,A00,890285,Staff,12,0,20,8
1746575619126,VIS 101,A00,886512,Staff,26,0,75,49
1746575620155,VIS 103,A00,886513,Cruz; Edwin Teddy,61,0,75,14
1746575621183,VIS 108,A00,886514,Staff,3,0,15,12
1746575622210,VIS 127P,A00,886515,Shen; Kuiyi,80,0,146,66
1746575623237,VIS 149,A00,886516,Yoldas; Pinar,0,0,15,15
1746575624267,VIS 164,A00,886526,Erdmann; Dean,19,0,22,3
1746575625291,VIS 194S,A00,886527,Staff,61,0,75,14
1746575626319,WCWP 10A,C00,886484,Martiniuk; Jill,12,0,15,3
1746575627344,WCWP 10B,A00,886490,Uriarte; Emma,0,0,15,15
1746575627344,WCWP 10B,B00,886491,Dhir; Simrita,9,0,15,6
1746575627344,WCWP 10B,C00,886492,Ornelas; Tricia,0,0,15,15
1746575628373,WCWP 100,A00,886494,Young; Mark T,0,6,15,15
1746575630494,AAS 10,A01,886199,Childs; Dennis R.,0,3,0,0
1746575631520,ANAR 104,A01,886940,Shtienberg; Gilad,27,0,30,3
1746575632546,ANAR 120,A00,886953,Staff,12,0,20,8
1746575633569,ANBI 148,A01,886955,Wilder; Linnea Lorene,30,0,40,10
1746575635622,ANSC 122,A00,886957,Staff,25,0,30,5
1746575636646,ANSC 150,A00,886958,Sloane; Julia Kathryn,2,0,15,13
1746575637673,ANSC 156,A00,886959,Jenkins; Janis A.,0,1,15,15
1746575638699,ANSC 180,A00,886960,Staff,11,0,17,6
1746575639723,ANSC 188,A00,886961,Jassal; Aftab,9,0,25,16
1746575640748,ANSC 190,A00,886962,Jassal; Aftab,14,0,25,11
1746575641773,ANSC 191,A00,886963,Staff,18,0,20,2
1746575642801,ANTH 3,A01,891689,Staff,17,0,20,3
1746575643827,ANTH 5,A00,886933,Semendeferi; Ekaterini,16,0,20,4
1746575644853,ANTH 10,A00,886934,Staff,0,12,30,30
1746575645877,ANTH 21,A01,886936,Staff,41,0,60,19
1746575646902,ANTH 23,A01,886938,Staff,92,0,100,8
1746575647929,ANTH 105,A00,886964,Stewart; Alexander B,84,0,100,16
1746575648954,ANTH 108,A00,886965,Pedersen; David,9,0,20,11
1746575649999,AWP 10,001,886147,Staff,0,0,0,0
1746575649999,AWP 10,002,886148,Staff,0,0,0,0
1746575649999,AWP 10,003,886149,Staff,0,0,0,0
1746575649999,AWP 10,004,886150,Staff,0,0,0,0
1746575649999,AWP 10,005,886151,Staff,0,0,0,0
1746575649999,AWP 10,006,886152,Staff,0,0,0,0
1746575649999,AWP 10,007,886153,Staff,0,0,0,0
1746575649999,AWP 10,008,886154,Staff,0,0,0,0
1746575649999,AWP 10,009,886155,Staff,0,0,0,0
1746575649999,AWP 10,010,886156,Staff,0,0,0,0
1746575649999,AWP 10,011,886158,Staff,0,0,0,0
1746575649999,AWP 10,012,886160,Staff,0,0,0,0
1746575649999,AWP 10,013,886161,Staff,0,0,0,0
1746575649999,AWP 10,014,886162,Staff,0,0,0,0
1746575649999,AWP 10,015,886163,Staff,0,0,0,0
1746575649999,AWP 10,016,886164,Staff,0,0,0,0
1746575649999,AWP 10,017,886165,Staff,0,0,0,0
1746575649999,AWP 10,018,886166,Staff,0,0,0,0
1746575649999,AWP 10,019,886168,Staff,0,0,0,0
1746575649999,AWP 10,020,886170,Staff,0,0,0,0
1746575649999,AWP 10,021,886172,Staff,0,0,0,0
1746575651026,AWP 10R,001,886173,Staff,0,1,0,0
1746575651026,AWP 10R,002,886174,Staff,0,1,0,0
1746575651026,AWP 10R,003,886175,Staff,0,0,0,0
1746575651026,AWP 10R,004,886176,Staff,0,0,0,0
1746575651026,AWP 10R,005,886177,Staff,0,0,0,0
1746575651026,AWP 10R,006,886178,Staff,0,0,0,0
1746575651026,AWP 10R,007,886179,Staff,0,0,0,0
1746575651026,AWP 10R,008,886181,Staff,0,0,0,0
1746575651026,AWP 10R,009,886182,Staff,0,0,0,0
1746575651026,AWP 10R,010,886183,Staff,0,0,0,0
1746575651026,AWP 10R,011,886184,Staff,0,0,0,0
1746575651026,AWP 10R,012,886185,Staff,0,0,0,0
1746575651026,AWP 10R,013,886186,Staff,0,0,0,0
1746575651026,AWP 10R,014,886187,Staff,0,0,0,0
1746575651026,AWP 10R,015,886188,Staff,0,0,0,0
1746575651026,AWP 10R,016,886189,Staff,0,0,0,0
1746575651026,AWP 10R,017,960532,Staff,0,0,0,0
1746575651026,AWP 10R,018,960533,Staff,0,0,0,0
1746575651026,AWP 10R,019,960534,Staff,0,0,0,0
1746575651026,AWP 10R,020,960538,Staff,0,0,0,0
1746575651026,AWP 10R,021,960540,Staff,0,0,0,0
1746575651026,AWP 10R,022,960541,Staff,0,0,0,0
1746575651026,AWP 10R,023,960542,Staff,0,0,0,0
1746575651026,AWP 10R,024,960544,Staff,0,0,0,0
1746575651026,AWP 10R,025,960545,Staff,0,0,0,0
1746575651026,AWP 10R,026,960548,Staff,0,0,0,0
1746575652051,AWP 102R,A00,886190,Staff,0,0,0,0
1746575652051,AWP 102R,B00,886191,Staff,0,0,0,0
1746575653078,BENG 100,A01,886193,Staff,17,0,30,13
1746575654106,BENG 122A,A01,886195,Hasty; Jeff M,13,0,30,17
1746575655133,BENG 166A,A00,886196,Sah; Robert Lie-Yuan,0,2,30,30
1746575656156,BENG 190,A00,958050,Khojah; Reem I,20,0,25,5
1746575657184,BIBC 102,A01,894320,Staff,0,0,46,46
1746575657184,BIBC 102,A02,894321,Staff,0,0,46,46
1746575657184,BIBC 102,A03,894344,Staff,6,0,46,40
1746575657184,BIBC 102,A04,894345,Staff,27,0,47,20
1746575658209,BICD 100R,A01,894365,Smith; Laurie,0,3,58,58
1746575658209,BICD 100R,A02,894366,Smith; Laurie,0,5,58,58
1746575658209,BICD 100R,A03,894367,Smith; Laurie,0,0,59,59
1746575658209,BICD 100R,A04,959869,Smith; Laurie,40,0,59,19
1746575659238,BICD 136,A01,894383,Gustafson-Brown; Cindy,14,0,50,36
1746575660269,BIEB 102,A01,894494,Butler; Shannon Rhey,51,0,130,79
1746575662326,BIEB 150,A01,894617,Wills; Christopher,3,0,20,17
1746575662326,BIEB 150,A02,894631,Wills; Christopher,3,0,20,17
1746575662326,BIEB 150,A03,894937,Wills; Christopher,3,0,20,17
1746575662326,BIEB 150,A04,894946,Wills; Christopher,5,0,20,15
1746575663352,BIEB 194,A00,906141,Kurle; Carolyn M.,6,0,20,14
1746575664378,BILD 1,A01,894154,Staff,3,0,19,16
1746575664378,BILD 1,A02,894155,Staff,14,0,19,5
1746575664378,BILD 1,A03,894160,Staff,13,0,19,6
1746575664378,BILD 1,A04,894161,Staff,15,0,18,3
1746575665404,BILD 2,A01,894168,Staff,0,0,50,50
1746575665404,BILD 2,A02,894169,Staff,0,0,50,50
1746575665404,BILD 2,A03,894179,Staff,0,0,50,50
1746575665404,BILD 2,A04,894203,Staff,24,0,50,26
1746575666432,BILD 3,A01,894213,Staff,23,0,31,8
1746575666432,BILD 3,A02,894214,Staff,26,0,31,5
1746575666432,BILD 3,A03,894235,Staff,28,0,31,3
1746575666432,BILD 3,A04,894236,Staff,28,0,32,4
1746575667457,BILD 4,A01,894253,Reuther; Keefe,5,0,24,19
1746575667457,BILD 4,A02,894258,Reuther; Keefe,16,0,24,8
1746575668481,BILD 5,A01,894276,Reuther; Keefe,35,0,50,15
1746575668481,BILD 5,A02,894277,Reuther; Keefe,45,0,50,5
1746575668481,BILD 5,A03,894290,Reuther; Keefe,44,0,50,6
1746575668481,BILD 5,A04,894291,Reuther; Keefe,48,0,50,2
1746575669508,BILD 24,A01,894297,Pirino; Giorgia,40,0,60,20
1746575670533,BIMM 100,B01,958915,Staff,71,0,100,29
1746575671562,BIMM 101,A01,895017,McDonnell; Lisa Marie,0,5,24,24
1746575671562,BIMM 101,A02,895018,McDonnell; Lisa Marie,0,5,24,24
1746575671562,BIMM 101,B01,895020,McDonnell; Lisa Marie,0,6,24,24
1746575671562,BIMM 101,B02,895021,McDonnell; Lisa Marie,0,4,24,24
1746575672587,BIMM 110,A01,895023,Staff,1,0,25,24
1746575672587,BIMM 110,A02,895024,Staff,9,0,25,16
1746575672587,BIMM 110,A03,895025,Staff,18,0,25,7
1746575672587,BIMM 110,A04,895031,Staff,20,0,25,5
1746575673617,BIMM 120,A01,895114,Gustafson-Brown; Cindy,14,0,28,14
1746575673617,BIMM 120,A02,895126,Gustafson-Brown; Cindy,21,0,27,6
1746575674642,BIPN 100,A01,895130,Yang; Mingyu,0,0,38,38
1746575674642,BIPN 100,A02,895131,Yang; Mingyu,32,0,38,6
1746575674642,BIPN 100,A03,895132,Yang; Mingyu,32,0,38,6
1746575674642,BIPN 100,A04,895133,Yang; Mingyu,27,0,36,9
1746575675666,BIPN 120,A01,895135,Cooke; James Edward,0,3,13,13
1746575675666,BIPN 120,A02,895136,Cooke; James Edward,0,1,13,13
1746575675666,BIPN 120,A03,895137,Cooke; James Edward,0,3,13,13
1746575675666,BIPN 120,A04,895156,Cooke; James Edward,0,2,11,11
1746575676692,BIPN 134,A01,895235,Cooke; James Edward,0,2,25,25
1746575676692,BIPN 134,A02,895237,Cooke; James Edward,0,0,25,25
1746575676692,BIPN 134,A03,895240,Cooke; James Edward,3,0,25,22
1746575676692,BIPN 134,A04,895270,Cooke; James Edward,20,0,25,5
1746575677715,BIPN 189,A00,892103,Staff,0,14,14,14
1746575679769,BISP 194,A00,958008,Staff,0,2,0,0
1746575680798,CAT 124,A01,922009,Staff,0,5,20,20
1746575681824,CAT 125R,A00,886390,Morales; Celeste Georgianna,0,2,20,20
1746575681824,CAT 125R,B00,886391,Irwin; Matthew Joseph,0,4,20,20
1746575681824,CAT 125R,C00,886392,Smith; Lauryn Alissa,0,2,20,20
1746575681824,CAT 125R,D00,886393,Vanderschuit; Maya Alysia,0,3,20,20
1746575681824,CAT 125R,E00,886394,Marchisotto; Jennifer Anne,0,3,20,20
1746575682852,CENG 15,A01,886218,Drews; Aaron,3,0,8,5
1746575683877,CENG 113,A00,886219,Opatkiewicz; Justin Paul,15,0,25,10
1746575684902,CGS 101,A00,887044,Staff,7,0,20,13
1746575685927,CGS 105,A01,887046,Staff,14,0,25,11
1746575686951,CGS 112,A00,887047,Cuong; Marisol,12,0,15,3
1746575687976,CGS 113,A00,887048,Staff,23,0,30,7
1746575689002,CGS 120,A00,887049,Staff,10,0,17,7
1746575690028,CHEM 6A,A01,886336,Lam; Tin Yiu,38,0,50,12
1746575690028,CHEM 6A,A02,886338,Lam; Tin Yiu,37,0,50,13
1746575691054,CHEM 6B,A01,886341,Hopkins; Patrycja Anna,16,0,50,34
1746575691054,CHEM 6B,A02,886343,Hopkins; Patrycja Anna,42,0,50,8
1746575692080,CHEM 6C,A01,886346,Albizati; Kim F.,0,2,50,50
1746575692080,CHEM 6C,A02,886348,Albizati; Kim F.,23,0,50,27
1746575693105,CHEM 40A,A01,886352,Klosterman; Jeremy K,65,0,100,35
1746575694134,CHEM 40B,A01,886356,Klosterman; Jeremy K,0,23,100,100
1746575695159,CHEM 41B,A01,886360,Theodorakis; Emmanuel,25,0,50,25
1746575695159,CHEM 41B,A02,886362,Theodorakis; Emmanuel,47,0,50,3
1746575696184,CHIN 165A,A00,886382,Xu; Li,18,0,20,2
1746575697209,CLAS 120,A00,886387,Myerston Santana; Jacobo,33,0,40,7
1746575698238,COGS 9,A01,886967,Shannon; Kyle Michael,42,0,60,18
1746575699265,COGS 11,A01,886969,Staff,9,0,30,21
1746575700290,COGS 14A,A01,886971,Staff,6,0,60,54
1746575701319,COGS 14B,A01,886973,Hoffman; Drew Ellen,4,0,60,56
1746575702348,COGS 18,A01,886975,Morgan; Eric,35,0,60,25
1746575703376,COGS 20,A01,886977,Staff,4,0,8,4
1746575703376,COGS 20,A02,886978,Staff,5,0,7,2
1746575704401,COGS 100,A01,907783,Staff,1,2,30,29
1746575705427,COGS 101B,A01,886980,Staff,0,3,48,48
1746575706453,COGS 101C,A01,886982,Delgado; Tania,0,5,44,44
1746575707477,COGS 102A,A01,886984,Johnson; Christine M.,4,0,30,26
1746575708502,COGS 118B,A01,886986,Staff,1,4,88,87
1746575709527,COGS 150,A01,886988,Bergen; Benjamin,22,0,50,28
1746575710555,COGS 153,A00,886989,Delgado; Tania,0,2,41,41
1746575711586,COGS 186,A01,886991,Staff,0,0,32,32
1746575712610,COGS 187A,A01,886993,Boyle; Mary E. T.,7,0,30,23
1746575713638,COGS 189,A00,886994,Staff,0,1,30,30
1746575714668,COMM 10,A01,886996,Staff,0,0,20,21
1746575714668,COMM 10,A02,886997,Staff,11,0,20,9
1746575714668,COMM 10,A03,959845,Staff,19,0,20,1
1746575715696,COMM 20,A01,886999,Leuning; Grant Maurstad,24,0,40,16
1746575717745,COMM 100A,A01,887002,Staff,0,0,20,25
1746575717745,COMM 100A,A02,887003,Staff,6,0,20,14
1746575718769,COMM 100B,A01,887005,Staff,0,8,20,24
1746575719797,COMM 106D,A00,887006,Staff,13,0,40,27
1746575720821,COMM 110G,A00,887007,Whitworth-Smith; Andrew C,12,0,40,28
1746575721848,COMM 111B,A00,887008,Staff,31,0,40,9
1746575722873,COMM 113T,A00,887009,Abuelhiga; Soraya Jill,28,0,40,12
1746575722873,COMM 113T,B00,906733,Staff,40,0,40,0
1746575723900,COMM 145,A00,887010,Staff,12,0,40,28
1746575724924,COMM 146,A00,887054,Staff,31,0,40,9
1746575725952,COMM 190,A00,887012,Staff,8,0,23,15
1746575726978,CSE 8A,A50,887015,Cao; Yingjun,57,0,85,28
1746575728003,CSE 11,A01,887017,Cao; Yingjun,12,0,70,58
1746575729028,CSE 20,A01,887019,Staff,30,0,50,20
1746575730057,CSE 21,A01,887021,Staff,78,0,100,22
1746575730057,CSE 21,B01,892583,Braun; Oliver,45,0,50,5
1746575731140,CSE 30,A01,887025,Eldon; John,143,0,200,57
1746575732164,CSE 100,A01,887027,Staff,26,0,50,24
1746575732164,CSE 100,A02,887028,Staff,42,0,50,8
1746575733220,CSE 101,A01,887030,Braun; Oliver,74,0,100,26
1746575733220,CSE 101,B01,887032,Jones; Miles E,0,3,50,50
1746575733220,CSE 101,B02,887033,Jones; Miles E,0,2,50,50
1746575734245,CSE 105,A01,908084,Jones; Miles E,32,0,50,18
1746575734245,CSE 105,A02,908087,Jones; Miles E,31,0,50,19
1746575735275,CSE 135,A01,887035,Powell; Thomas Allan,0,5,50,50
1746575736299,CSE 142,A01,887037,Staff,8,0,60,52
1746575737325,CSE 142L,A01,887039,Staff,34,0,60,26
1746575738350,CSE 151A,A01,887041,Solares; Edwin A,47,0,100,53
1746575739375,CSE 175,A01,887043,Kumar; Rakesh,30,0,30,0
1746575740398,CSS 1,A01,886389,Staff,1,1,40,39
1746575741424,DSC 30,A01,908097,Liao; Soohyun Nam,47,0,75,28
1746575742453,DSC 40A,A01,908099,Shannon; Kyle Michael,30,0,50,20
1746575743477,DSC 40B,A01,908112,Staff,15,0,50,35
1746575744501,DSC 80,A01,908116,Staff,19,0,60,41
1746575745526,DSC 197,001,956863,Eldridge; Justin Matthew,9999,0,9999,0
1746575746553,ECE 5,A01,886400,Morris; Karcher William,1,0,6,5
1746575746553,ECE 5,A02,886401,Morris; Karcher William,3,0,6,3
1746575747579,ECE 148,A01,886403,Silberman; Jack,0,14,14,14
1746575748605,ECON 1,A01,887265,Crane; Meredith Helen,12,0,70,58
1746575748605,ECON 1,B01,887268,Staff,42,0,50,8
1746575749629,ECON 2,A01,887273,Crane; Meredith Helen,55,0,70,15
1746575750654,ECON 3,A01,887279,Rondina; Giacomo,32,0,70,38
1746575751677,ECON 4,A01,887282,Anderson; John Charles,0,2,10,10
1746575752704,ECON 5,A01,887285,Staff,34,0,45,11
1746575752704,ECON 5,B01,887292,Staff,41,0,45,4
1746575753728,ECON 100A,A01,887337,Newhouse; Herbert S,54,0,70,16
1746575753728,ECON 100A,B01,887349,Staff,45,0,50,5
1746575754751,ECON 100B,A01,887361,Du; Songzi,29,0,70,41
1746575755775,ECON 100C,A01,887445,Newhouse; Herbert S,59,0,70,11
1746575756801,ECON 105,A00,887488,Vespa; Emanuel Ignacio,23,0,35,12
1746575757826,ECON 109,A01,887506,Shishkin; Denis,28,0,35,7
1746575758855,ECON 110A,A01,887568,Alon; Titan Michael,0,3,35,35
1746575758855,ECON 110A,B01,907601,Alon; Titan Michael,20,0,35,15
1746575759882,ECON 110B,A01,887598,Levkoff; Steven B.,0,24,70,70
1746575760909,ECON 112,A00,887599,Rondina; Giacomo,19,0,35,16
1746575761935,ECON 120A,A01,887603,Dai; Yinlin,35,0,70,35
1746575762966,ECON 120C,A01,887608,Sun; Yixiao,0,1,35,35
1746575762966,ECON 120C,B01,887614,Sun; Yixiao,0,0,35,35
1746575763993,ECON 138,A00,887621,Bharadwaj; Prashant,0,21,20,20
1746575765036,ECON 144,A00,958007,Squires; Dale E,12,0,35,23
1746575766061,ECON 171,A01,907666,Staff,18,0,35,17
1746575767090,ECON 175,A00,887626,Wu; Pak Yeung,22,0,35,13
1746575768116,ECON 190,A00,887640,Vespa; Emanuel Ignacio,22,0,35,13
1746575769144,EDS 25,A01,888197,Staff,0,0,0,0
1746575769144,EDS 25,A02,888209,Staff,0,0,0,0
1746575769144,EDS 25,A03,888210,Staff,0,0,0,0
1746575769144,EDS 25,A04,888212,Staff,0,0,0,0
1746575769144,EDS 25,A05,888213,Staff,0,0,0,0
1746575769144,EDS 25,A06,888214,Staff,0,0,0,0
1746575769144,EDS 25,A07,888235,Staff,0,2,0,0
1746575769144,EDS 25,A08,888236,Staff,0,0,0,0
1746575769144,EDS 25,A09,888240,Staff,0,0,0,0
1746575769144,EDS 25,A10,888244,Staff,0,0,0,0
1746575769144,EDS 25,B01,888273,Staff,0,0,0,0
1746575769144,EDS 25,B02,888285,Staff,0,0,0,0
1746575769144,EDS 25,B03,888423,Staff,0,0,0,1
1746575769144,EDS 25,B04,888432,Staff,0,0,0,0
1746575769144,EDS 25,B05,888433,Staff,0,0,0,0
1746575769144,EDS 25,B06,888467,Staff,0,0,0,0
1746575769144,EDS 25,B07,888468,Staff,0,0,0,0
1746575769144,EDS 25,B08,888479,Staff,0,0,0,0
1746575769144,EDS 25,B09,888484,Staff,0,0,0,0
1746575769144,EDS 25,B10,888487,Staff,0,0,0,0
1746575770174,EDS 38,A01,907700,Choi; Bailey Miyeon,30,0,30,0
1746575771200,EDS 112,A01,888601,Chapman; Thandeka K,12,0,40,28
1746575772224,EDS 115,A00,888697,Mendez; Kathrina Mendoza,10,0,30,20
1746575773249,EDS 116,A01,888893,Staff,34,0,40,6
1746575775304,EDS 124AR,A00,889133,Staff,29,0,50,21
1746575775304,EDS 124AR,B00,907471,Simon; Elizabeth A,37,0,50,13
1746575776331,EDS 124BR,A00,889134,Simon; Elizabeth A,44,0,100,56
1746575777359,EDS 125,A00,889135,Staff,25,0,30,5
1746575778383,EDS 126,A01,889138,Staff,35,0,40,5
1746575779410,EDS 164R,A01,889142,Wishard Guerra; Alison G.,33,0,50,17
1746575780436,ENG 30,A01,886396,Staff,0,0,0,0
1746575780436,ENG 30,B01,886398,Staff,0,0,0,0
1746575781462,ENVR 102,A00,906150,Montejo; Carolina,23,0,25,2
1746575782490,ETHN 103A,A00,887236,Man; Simeon S,0,3,0,0
1746575783515,ETHN 113,A00,887239,Staff,16,0,30,14
1746575784541,ETHN 116,A00,887240,Staff,16,0,25,9
1746575785566,ETHN 117,A00,887241,Choi; Esther Min,28,0,30,2
1746575786591,ETHN 118,A00,887243,Staff,24,0,30,6
1746575787615,ETHN 127,A00,887248,Cuong; Marisol,11,0,15,4
1746575788640,ETHN 139,A00,887250,Staff,7,0,10,3
1746575789665,ETHN 142,A00,887252,Staff,10,0,30,20
1746575790696,ETHN 161,A00,887253,Browne; Errol Tsekani,24,0,30,6
1746575791719,ETHN 163FR,A00,887255,Burelle; Julie Sara Veronique,0,0,5,5
1746575792746,GLBH 20,A00,889149,Elwardani; Nile Regina,8,0,42,34
1746575794795,GLBH 111,A01,889152,Burgos; Jose L.,17,0,17,0
1746575795827,GLBH 150,A00,889181,Sloane; Julia Kathryn,0,5,15,15
1746575797881,HDS 60,A01,886406,Warstadt; Melissa Fawn,73,0,80,7
1746575798918,HIAF 111,A00,889324,Gyamfi; Bright,25,0,32,7
1746575799944,HIEA 131,A00,889328,Staff,15,0,32,17
1746575800972,HIEA 144,A00,889333,Henry; Todd A.,26,0,32,6
1746575801997,HIEA 154,A00,889336,Henry; Todd A.,24,0,32,8
1746575803024,HIEU 106,A00,889339,Staff,22,0,32,10
1746575805081,HIEU 114,A00,889340,Staff,4,0,32,28
1746575806109,HIEU 135GS,A00,889342,Patterson; Patrick H.,0,0,1,24
1746575807133,HIEU 137,A00,889343,Edington; Claire Ellen,10,0,25,15
1746575808158,HIEU 148,A00,889345,Staff,14,0,32,18
1746575809184,HIEU 154,A00,889346,Biess; Frank Peter,21,0,32,11
1746575810212,HILA 102,A00,889351,Staff,12,0,32,20
1746575811239,HILD 2A,A01,889221,Lewandoski; Julia Mavis,1,10,32,31
1746575812267,HILD 7B,A01,889225,Man; Simeon S,0,12,32,32
1746575813296,HILD 7C,A01,889288,Alvarez; Luis A,0,14,32,32
1746575814324,HILD 30,A01,889323,Staff,0,5,32,32
1746575816375,HISC 119,A00,889383,Golan; Tal,19,0,32,13
1746575817400,HIUS 103,A00,889384,Man; Simeon S,0,0,32,32
1746575818426,HIUS 117,A00,919797,Kwak; Nancy,19,0,32,13
1746575819450,HIUS 142A,A00,919788,Staff,22,0,32,10
1746575821505,HIUS 149,A00,889386,Gyamfi; Bright,26,0,32,6
1746575822531,HIUS 155,A00,889387,Alvarez; Luis A,15,0,32,17
1746575823556,HUM 3,A01,886499,Caldwell; Michael Alan,19,0,50,31
1746575824581,HUM 3GS,A00,886500,Rodriguez; Bretton Sigfred,0,0,0,28
1746575825612,HUM 3R,A01,886502,Markman; Kristina,0,36,50,50
1746575826641,HUM 4,A01,886504,Crum; Matthew Stephen,23,0,50,27
1746575826641,HUM 4,B01,886506,West; Geoffrey Scott,17,0,50,33
1746575827666,HUM 4GS,A00,886507,Staff,0,0,0,19
1746575828696,HUM 5,A01,886509,Staff,32,0,50,18
1746575829723,HUM 5R,A01,886511,Zavodny; Tatiana Sophia,0,39,50,50
1746575830749,JAPN 180,A00,886407,Staff,16,0,40,24
1746575831779,LATI 50,A01,886409,Martin-Cabrera; Luis,4,0,22,18
1746575831779,LATI 50,A02,886410,Martin-Cabrera; Luis,19,0,22,3
1746575831779,LATI 50,A03,886411,Martin-Cabrera; Luis,21,0,22,1
1746575831779,LATI 50,A04,886412,Martin-Cabrera; Luis,9,0,22,13
1746575832802,LAWS 101,A00,907664,Staff,28,0,60,32
1746575833829,LIAB 1A,A00,889388,Saab; Dima,17,0,20,3
1746575834859,LIAB 1AX,A00,889389,El Cheddadi; Youniss,18,0,20,2
1746575835883,LIFR 1C,A00,889391,Van Moer; Vinciane G,8,0,20,12
1746575836912,LIFR 1CX,A00,889392,Van Moer; Vinciane G,7,0,20,13
1746575837938,LIFR 1D,A00,889393,Van Moer; Vinciane G,7,0,20,13
1746575838964,LIFR 1DX,A00,889394,Van Moer; Vinciane G,8,0,20,12
1746575839991,LIGN 7,A00,886923,Staff,24,0,50,26
1746575841021,LIGN 17,A00,886924,Kehler; Andrew Scott,125,0,150,25
1746575842045,LTAM 110,A00,889395,Staff,15,0,30,15
1746575843073,LTAM 110GS,A00,958010,Rodriguez; Bretton Sigfred,0,0,0,28
1746575844096,LTCH 101,A00,889397,Staff,23,0,25,2
1746575845121,LTCS 130,A00,889398,Staff,23,0,25,2
1746575846148,LTEA 138,A00,889399,Staff,24,0,40,16
1746575847174,LTEN 149,A00,889400,Wesling; Megan E.,0,3,25,25
1746575848207,LTEN 169,A00,889401,Staff,20,0,25,5
1746575849232,LTEN 180,A00,889402,Staff,10,0,15,5
1746575850262,LTEN 181,A00,889403,Staff,21,0,25,4
1746575851289,LTWL 100,A00,889404,Myerston Santana; Jacobo,2,0,25,23
1746575852318,LTWL 180GS,A00,889405,Staff,0,0,20,20
1746575853347,LTWL 181,A00,889406,Staff,16,0,25,9
1746575854372,LTWL 184,A00,889475,Mukherjee; Silpa,22,0,25,3
1746575855394,LTWR 102C,A00,889486,Staff,29,0,30,1
1746575856420,LTWR 115W,A00,889491,Staff,0,2,15,15
1746575857444,MAE 8,A01,886905,Staff,0,2,0,0
1746575858469,MAE 11,A00,886906,Bandaru; Prabhakar,0,7,50,50
1746575859497,MAE 20,A00,886907,Evdokimenko; Ekaterina,43,0,70,27
1746575860527,MAE 30B,A00,886909,Ghazinejad; Maziar,26,0,45,19
1746575861552,MAE 101B,A00,886910,Saintillan; David,29,0,45,16
1746575862583,MAE 105,A00,886911,Bandaru; Prabhakar,18,0,50,32
1746575863607,MAE 107,B00,958024,Staff,8,0,50,42
1746575864636,MAE 143B,A00,886913,Bewley; Thomas R,4,0,40,36
1746575865665,MAE 148,A01,886915,Silberman; Jack,0,3,14,14
1746575866689,MAE 160,A00,886916,Evdokimenko; Ekaterina,31,0,60,29
1746575867718,MATH 3C,A01,889681,Staff,0,2,30,30
1746575867718,MATH 3C,A02,960048,Staff,24,0,30,6
1746575868747,MATH 10A,A01,889760,Staff,26,0,30,4
1746575868747,MATH 10A,A02,889783,Staff,29,0,30,1
1746575869773,MATH 10B,A01,889785,Verstraete; Jacques Allan,2,0,35,33
1746575869773,MATH 10B,A02,889795,Verstraete; Jacques Allan,4,0,35,31
1746575869773,MATH 10B,B01,889797,Verstraete; Jacques Allan,3,0,35,32
1746575869773,MATH 10B,B02,889828,Verstraete; Jacques Allan,3,0,35,32
1746575870802,MATH 10C,A01,889849,Habib; Yousaf,7,0,30,23
1746575870802,MATH 10C,A02,889852,Habib; Yousaf,14,0,30,16
1746575870802,MATH 10C,A03,889853,Habib; Yousaf,22,0,30,8
1746575870802,MATH 10C,A04,889858,Habib; Yousaf,20,0,30,10
1746575870802,MATH 10C,B01,889861,Staff,1,0,30,29
1746575870802,MATH 10C,B02,889862,Staff,24,0,30,6
1746575870802,MATH 10C,B03,889863,Staff,27,0,30,3
1746575870802,MATH 10C,B04,889967,Staff,23,0,30,7
1746575871829,MATH 18,A01,889974,Staff,7,0,30,23
1746575871829,MATH 18,A02,889977,Staff,20,0,30,10
1746575871829,MATH 18,B01,889984,Hardiman; Liam,21,0,30,9
1746575871829,MATH 18,B02,889985,Hardiman; Liam,25,0,30,5
1746575872857,MATH 20A,A01,889990,Suk; Andrew Hoon,30,0,35,5
1746575873887,MATH 20B,A01,889993,Ohm; Ko Woon,22,0,30,8
1746575873887,MATH 20B,A02,889994,Ohm; Ko Woon,30,0,30,0
1746575873887,MATH 20B,B01,889996,Ohm; Ko Woon,22,0,30,8
1746575873887,MATH 20B,B02,889997,Ohm; Ko Woon,23,0,30,7
1746575874912,MATH 20C,A01,889999,Hammock; Frances H,17,0,30,13
1746575874912,MATH 20C,A02,890003,Hammock; Frances H,23,0,30,7
1746575874912,MATH 20C,B01,890006,Hammock; Frances H,3,0,30,27
1746575874912,MATH 20C,B02,890007,Hammock; Frances H,12,0,30,18
1746575875941,MATH 20D,A01,890011,Cheng; Hsiao-Bing,1,1,30,29
1746575875941,MATH 20D,A02,890012,Cheng; Hsiao-Bing,14,0,30,16
1746575875941,MATH 20D,B01,890016,Cheng; Hsiao-Bing,13,0,30,17
1746575875941,MATH 20D,B02,890017,Cheng; Hsiao-Bing,13,0,30,17
1746575876967,MATH 20E,A01,890026,Harel; Guershon,1,0,30,29
1746575876967,MATH 20E,A02,890029,Harel; Guershon,23,0,30,7
1746575876967,MATH 20E,B01,890033,Harel; Guershon,7,0,30,23
1746575876967,MATH 20E,B02,890101,Harel; Guershon,21,0,30,9
1746575877991,MATH 102,A01,890104,Staff,17,0,30,13
1746575877991,MATH 102,A02,890105,Staff,27,0,30,3
1746575879019,MATH 103B,A01,890116,Salehi Golsefidy; Alireza,3,0,30,27
1746575879019,MATH 103B,B01,890118,Staff,0,3,34,34
1746575880044,MATH 109,A01,890121,Aliabadi Sr.; Mohsen,1,0,30,29
1746575880044,MATH 109,B01,890124,Upadrashta; Pranav Kumar,18,0,30,12
1746575881068,MATH 120A,A01,890126,Eggers; John Dietrich,13,0,30,17
1746575882093,MATH 142B,A01,890128,Ioana; Adrian,19,0,30,11
1746575882093,MATH 142B,A02,890129,Ioana; Adrian,13,0,30,17
1746575883117,MATH 154,A01,890174,Staff,0,0,30,30
1746575883117,MATH 154,A02,890182,Staff,0,0,30,30
1746575884145,MATH 168A,A01,890197,Dumitriu; Ioana,21,0,35,14
1746575885171,MATH 170A,A01,890240,Nie; Jiawang,1,0,30,29
1746575885171,MATH 170A,A02,890241,Nie; Jiawang,11,0,30,19
1746575885171,MATH 170A,A03,890249,Nie; Jiawang,23,0,30,7
1746575886199,MATH 170B,A01,957891,Nag; Panchali,13,0,35,22
1746575888256,MATH 181A,A01,908025,Staff,0,3,35,35
1746575888256,MATH 181A,A02,960115,Staff,26,0,35,9
1746575889285,MATH 181B,A01,959874,Staff,25,0,30,5
1746575890310,MATH 193B,A01,890265,Staff,0,4,35,35
1746575891337,MGT 4,A01,890311,Anderson; John Charles,42,0,88,46
1746575892366,MGT 5,A00,907740,Staff,13,0,98,85
1746575893393,MGT 12,A00,890312,Lindenberger; Wade Douglas,67,0,98,31
1746575894418,MGT 16,A00,957883,Staff,78,0,98,20
1746575896468,MGT 45,A00,890314,Pecore; Joseph P.,45,0,98,53
1746575897514,MGT 71,A00,890315,Staff,0,11,98,98
1746575898539,MGT 100,A00,890316,Yavorsky; Daniel Ryan,44,0,98,54
1746575899565,MGT 103,A00,890317,Ehrich; Kristine R,73,0,98,25
1746575900592,MGT 105,A00,890356,Bates; Kenneth Walter,0,8,98,98
1746575901618,MGT 112,A00,890360,Ehrich; Kristine R,55,0,98,43
1746575902645,MGT 127R,A00,907732,Zhu; Kevin Xiaoguo,23,0,98,75
1746575903674,MGT 131B,A00,890361,Anderson; John Charles,59,0,98,39
1746575904698,MGT 137,A00,890362,Lindenberger; Wade Douglas,65,0,98,33
1746575905726,MGT 160,A00,890369,Johnson; Erik Barry,9,0,98,89
1746575907780,MGT 164,A00,890372,Zimmermann; Carsten,0,40,98,98
1746575908805,MGT 180,A00,890374,Bliss; Barbara Ann,12,0,98,86
1746575909829,MMW 15,A01,886414,Chang; Edmond Yi-Teh,0,12,28,28
1746575909829,MMW 15,A02,886415,Chang; Edmond Yi-Teh,0,8,28,28
1746575909829,MMW 15,A03,886416,Chang; Edmond Yi-Teh,0,9,28,28
1746575909829,MMW 15,A04,886417,Chang; Edmond Yi-Teh,0,8,28,28
1746575909829,MMW 15,B01,886419,Chang; Edmond Yi-Teh,0,7,28,28
1746575909829,MMW 15,B02,886420,Chang; Edmond Yi-Teh,0,8,28,28
1746575909829,MMW 15,B03,886421,Chang; Edmond Yi-Teh,0,7,28,28
1746575909829,MMW 15,B04,886422,Chang; Edmond Yi-Teh,0,8,28,28
1746575909829,MMW 15,C01,886424,Staff,0,9,28,28
1746575909829,MMW 15,C02,886425,Staff,0,8,28,28
1746575909829,MMW 15,C03,886426,Staff,0,8,28,28
1746575909829,MMW 15,C04,886427,Staff,0,8,28,28
1746575909829,MMW 15,C05,958038,Staff,0,8,28,28
1746575909829,MMW 15,C06,958039,Staff,1,8,28,27
1746575910854,MMW 15GS,A00,906910,Patterson; Patrick H.,4,0,28,24
1746575911880,MMW 122R,A01,886429,Rahimi; Babak,0,13,28,28
1746575911880,MMW 122R,A02,886430,Rahimi; Babak,0,12,28,28
1746575911880,MMW 122R,A03,958040,Rahimi; Babak,0,11,28,28
1746575912909,MUS 1A,A01,890937,Staff,2,0,25,23
1746575912909,MUS 1A,A02,891035,Staff,6,0,25,19
1746575912909,MUS 1A,C01,958912,Staff,24,0,25,1
1746575912909,MUS 1A,C02,958913,Staff,25,0,25,0
1746575914960,MUS 2AK,A00,957092,Ohnishi; Takae,15,0,15,0
1746575915991,MUS 4,A01,891044,Staff,1,0,25,24
1746575915991,MUS 4,A02,891045,Staff,23,0,25,2
1746575915991,MUS 4,B01,891048,Staff,17,0,25,8
1746575915991,MUS 4,B02,891050,Staff,25,0,25,0
1746575917021,MUS 5,A01,957506,Dubnov; Shlomo,0,0,25,25
1746575917021,MUS 5,A02,957622,Dubnov; Shlomo,13,0,25,12
1746575917021,MUS 5,A03,957623,Dubnov; Shlomo,20,0,25,5
1746575918049,MUS 6,A01,891053,Freitas Caetano; Marcelo,24,0,25,1
1746575918049,MUS 6,A02,891054,Freitas Caetano; Marcelo,23,0,25,2
1746575919075,MUS 7,A01,891081,Staff,1,0,25,24
1746575919075,MUS 7,A02,891082,Staff,3,0,25,22
1746575920100,MUS 8GS,A00,891118,Borgo; David Garcia,1,0,25,24
1746575921143,MUS 11,A01,891140,Staff,9,0,25,16
1746575921143,MUS 11,A02,891141,Staff,22,0,25,3
1746575922172,MUS 13,A01,891143,Staff,8,0,25,17
1746575922172,MUS 13,A02,891144,Staff,24,0,25,1
1746575923200,MUS 15,A01,891146,Staff,9,0,25,16
1746575923200,MUS 15,A02,891148,Staff,21,0,25,4
1746575923200,MUS 15,B01,891150,Staff,18,0,25,7
1746575923200,MUS 15,B02,891151,Staff,25,0,25,0
1746575924224,MUS 20,A01,891153,Staff,5,0,20,15
1746575924224,MUS 20,A02,891155,Staff,14,0,20,6
1746575925250,MUS 80,A00,891156,Staff,19,0,25,6
1746575925250,MUS 80,B00,891157,Staff,23,0,25,2
1746575926276,MUS 130,A00,891158,Ohnishi; Takae,35,0,35,0
1746575927300,MUS 150GS,A01,891160,Borgo; David Garcia,1,0,25,24
1746575928326,MUS 170,A01,891162,Freitas Caetano; Marcelo,20,0,25,5
1746575928326,MUS 170,A02,891164,Freitas Caetano; Marcelo,21,0,25,4
1746575929349,NANO 11,A00,886220,Vazquez Mena; Oscar,13,0,15,2
1746575930378,NANO 15,A01,886222,Drews; Aaron,4,0,7,3
1746575931407,NANO 104,A00,886224,Sirbuly; Donald,17,0,25,8
1746575932432,PH 40,A00,886528,Staff,24,0,40,16
1746575933456,PH 45,A01,886799,Staff,35,0,40,5
1746575934481,PH 110,A00,886802,Staff,0,7,40,40
1746575935508,PH 172,A00,906716,Staff,19,0,35,16
1746575936537,PH 191,A00,886803,Staff,6,0,40,34
1746575937561,PHIL 1,A00,889500,Staff,20,0,30,10
1746575938585,PHIL 10,A01,889549,Grush; Rick Scott,16,0,22,6
1746575938585,PHIL 10,A02,889551,Grush; Rick Scott,22,0,22,0
1746575939612,PHIL 28,A01,889559,Lamey; Andy M.,0,2,31,31
1746575939612,PHIL 28,A02,889561,Lamey; Andy M.,0,1,30,30
1746575939612,PHIL 28,A03,889572,Lamey; Andy M.,0,1,30,30
1746575940639,PHIL 35,A00,907839,Staff,13,0,15,2
1746575941668,PHIL 60,A00,889574,Staff,73,0,90,17
1746575942695,PHIL 101,A00,958004,Staff,12,0,15,3
1746575944747,PHIL 136,A00,889582,Fulkerson; Matthew Todd,26,0,45,19
1746575945771,PHIL 163,A01,889601,Staff,21,0,30,9
1746575945771,PHIL 163,B01,889606,Brandt; Reuven A,0,3,0,0
1746575946798,PHIL 164,A00,889610,Staff,16,0,30,14
1746575947822,PHIL 165,A00,889613,Staff,22,0,30,8
1746575948850,PHYS 1A,A00,886431,Staff,26,0,70,44
1746575949875,PHYS 1AL,001,886432,Tsai; Philbert S,0,2,30,30
1746575949875,PHYS 1AL,002,886436,Tsai; Philbert S,11,0,30,19
1746575950905,PHYS 1B,A00,886439,Staff,185,0,240,55
1746575951930,PHYS 1BL,001,886441,Tsai; Philbert S,0,4,30,30
1746575951930,PHYS 1BL,002,886444,Tsai; Philbert S,2,0,30,28
1746575952958,PHYS 1C,A00,896092,Arnold; Kam S,78,0,146,68
1746575953987,PHYS 1CL,001,886448,Tsai; Philbert S,0,0,30,30
1746575953987,PHYS 1CL,002,886449,Tsai; Philbert S,1,0,30,29
1746575953987,PHYS 1CL,003,886450,Tsai; Philbert S,16,0,30,14
1746575953987,PHYS 1CL,004,886451,Tsai; Philbert S,15,0,30,15
1746575955015,PHYS 2B,A01,886457,Staff,68,0,115,47
1746575956045,PHYS 2C,A01,886460,Shotwell; Brian,0,9,65,65
1746575957073,PHYS 2CL,A01,886467,Staff,0,4,28,28
1746575957073,PHYS 2CL,A02,886468,Staff,0,3,28,28
1746575958098,PHYS 2D,A01,886470,Staff,10,0,50,40
1746575959125,PHYS 4B,A01,886475,Grinstein; Benjamin,22,0,40,18
1746575960154,POLI 5,A00,891173,Desposato; Scott,7,0,25,18
1746575961180,POLI 5D,A01,891175,Staff,5,0,5,0
1746575961180,POLI 5D,B01,891178,Staff,5,0,5,0
1746575962206,POLI 11,A00,891179,Ferree; Karen E,2,0,35,33
1746575963232,POLI 12,A00,891180,Staff,16,0,30,14
1746575964258,POLI 27,A01,891182,Staff,12,0,75,63
1746575965285,POLI 30,A00,891183,Staff,8,0,50,42
1746575966312,POLI 100B,A00,891244,Staff,5,1,35,30
1746575967342,POLI 100I,A00,891247,Staff,7,0,30,23
1746575968367,POLI 104J,A00,891248,Nichter; Maysa,14,0,30,16
1746575969395,POLI 104U,A00,891250,Nichter; Maysa,1,0,30,29
1746575971444,POLI 110B,A00,891255,Wiens; David,19,0,25,6
1746575972470,POLI 112A,A00,891256,Wiens; David,6,0,25,19
1746575973496,POLI 114BR,A00,891261,Staff,19,0,30,11
1746575974520,POLI 117R,A00,891262,Forman; Fonna,0,6,50,50
1746575975549,POLI 118,A00,891264,Ingham; Sean,17,0,25,8
1746575976573,POLI 124A,A00,891265,Staff,18,0,20,2
1746575977600,POLI 125D,A00,891266,Nichter; Simeon C,2,0,25,23
1746575978628,POLI 126,A00,891268,Nichter; Simeon C,7,0,25,18
1746575979653,POLI 126AA,A00,891272,Staff,15,0,25,10
1746575980678,POLI 130AA,A00,891273,Staff,15,0,20,5
1746575981708,POLI 134AA,A00,891274,Staff,4,0,20,16
1746575983762,POLI 138,A00,891278,Staff,21,0,25,4
1746575984788,POLI 142K,A00,891280,Staff,10,0,25,15
1746575985817,POLI 142M,A00,891281,Gartzke; Erik,16,0,30,14
1746575986843,POLI 142P,A00,891284,Staff,20,0,30,10
1746575987871,POLI 143,A00,891285,Gartzke; Erik,12,0,30,18
1746575988896,POLI 153,A00,891286,Staff,19,0,20,1
1746575990947,POLI 175,A00,891290,Staff,15,0,20,5
1746575991975,PSYC 1,A00,890674,Steiner; Eric Tomas,0,11,45,45
1746575993003,PSYC 2,A00,890676,Albright; Thomas D,21,0,35,14
1746575994029,PSYC 3,A00,890679,Staff,17,0,20,3
1746575995058,PSYC 6,A00,959858,Staff,20,0,20,0
1746575996084,PSYC 60,A01,890684,Rickard; Timothy C.,0,5,45,45
1746575997109,PSYC 70,A01,890689,Geller; Emma Harlan,7,0,30,23
1746575998136,PSYC 71,A01,959860,Staff,21,0,25,4
1746575999165,PSYC 100,A00,890690,Lacefield; Katharine I,0,50,180,180
1746576000190,PSYC 102,A00,890695,Staff,18,0,40,22
1746576001217,PSYC 105,A00,890699,Geller; Emma Harlan,70,0,100,30
1746576002244,PSYC 106,A00,890701,Gorman; Michael R.,6,0,30,24
1746576003335,PSYC 108,A00,890704,Adrian; Julia Anna,0,28,50,50
1746576004361,PSYC 118,A01,890712,Staff,11,0,30,19
1746576005387,PSYC 124,A00,890716,Chapman; Eddie Nathaniel,25,0,60,35
1746576006419,PSYC 131,A00,890717,Anagnostaras; Stephan,0,8,80,80
1746576007447,PSYC 137,A00,890719,Winkielman; Piotr,0,11,30,30
1746576008476,PSYC 144,A00,890721,Adrian; Julia Anna,0,9,45,45
1746576009510,PSYC 162,A00,890805,Staff,0,0,75,75
1746576010536,PSYC 169,A00,890810,Staff,0,14,30,30
1746576011568,PSYC 172,A00,890814,Gorman; Michael R.,9,0,30,21
1746576012598,PSYC 181,A00,890818,Anagnostaras; Stephan,9,0,200,191
1746576013634,PSYC 184,A00,959861,Staff,168,0,175,7
1746576014661,PSYC 189,A00,890823,Staff,0,2,30,30
1746576015686,PSYC 191,A00,890884,Rickard; Timothy C.,0,12,35,35
1746576016716,PSYC 193,A00,890913,Staff,19,0,30,11
1746576016716,PSYC 193,B00,890914,Chapman; Eddie Nathaniel,24,0,30,6
1746576017744,PSYC 193L,A01,890918,Lowe; Angela Beth,20,0,30,10
1746576017744,PSYC 193L,B01,890921,Hurwitz; Ethan Scott,20,0,30,10
1746576017744,PSYC 193L,C01,890928,Staff,30,0,30,0
1746576018773,RELI 149,A00,886806,Rahimi; Babak,23,0,40,17
1746576019798,SE 9,A01,886814,Staff,7,0,20,13
1746576020825,SE 101B,A01,886816,Chadha; Mayank,4,0,35,31
1746576021853,SE 110B,A00,886818,Zhu; Qiang,4,0,75,71
1746576022878,SE 125,A01,886830,Staff,10,0,30,20
1746576023906,SE 130B,A01,886835,Staff,14,0,40,26
1746576024936,SE 131A,A01,886838,Krysl; Petr,34,0,55,21
1746576025960,SE 154,A00,886840,Staff,29,0,50,21
1746576026989,SE 164GS,A01,886849,Staff,6,0,20,14
1746576028017,SE 167GS,A01,886853,Staff,6,0,20,14
1746576029046,SIO 25,A01,890107,Staff,19,0,30,11
1746576030073,SIO 45,A00,890109,Cook; Geoffrey W,117,0,200,83
1746576031103,SIO 109R,A00,890110,Forman; Fonna,0,16,20,20
1746576032130,SIO 187,A01,890114,Kacev; David,15,0,40,25
1746576033156,SOCI 1,A01,890431,Thorpe; Charles Robert,14,0,30,16
1746576033156,SOCI 1,A02,890518,Thorpe; Charles Robert,30,0,30,0
1746576034185,SOCI 2,A01,957978,Staff,25,0,25,0
1746576034185,SOCI 2,A02,957979,Staff,23,0,25,2
1746576035212,SOCI 20,A01,890523,Calderon-Zaks; Michael Aar,21,0,30,9
1746576035212,SOCI 20,A02,890526,Calderon-Zaks; Michael Aar,29,0,30,1
1746576036241,SOCI 30,A01,890533,Pardo Guerra; Juan Pablo,37,0,40,3
1746576037267,SOCI 40,A01,890535,Staff,27,0,45,18
1746576038292,SOCI 104Q,A00,890559,Staff,18,0,30,12
1746576039318,SOCI 106,A00,890560,Arnal; Maud Marie Leonie,20,0,30,10
1746576040344,SOCI 110,A00,890567,Holkenbrink-Monk; Charlene,19,0,30,11
1746576041371,SOCI 112,A00,890568,Victoria Torres; Pablo,2,0,55,53
1746576042406,SOCI 115,A00,890597,Arnal; Maud Marie Leonie,28,0,45,17
1746576044463,SOCI 121,A00,890604,Pardo Guerra; Juan Pablo,38,0,45,7
1746576045493,SOCI 126,A01,890608,Staff,8,0,10,2
1746576046516,SOCI 127,A00,890609,Staff,18,0,30,12
1746576047541,SOCI 131,A00,890610,Thorpe; Charles Robert,37,0,45,8
1746576048567,SOCI 135,A00,890615,Payne; Christine Anna,13,0,45,32
1746576049598,SOCI 139,A00,890620,Staff,38,0,45,7
1746576050627,SOCI 148E,A00,890622,Calderon-Zaks; Michael Aar,36,0,45,9
1746576051657,SOCI 150,A00,890623,Kohler; Kristopher M.,31,0,45,14
1746576052687,SOCI 157,A00,890625,Jules-Rosette; Bennetta W.,18,0,20,2
1746576053712,SOCI 160,A00,890627,Payne; Christine Anna,21,0,45,24
1746576054739,SYN 1,A00,886855,Fish; Gwendolyn Anne,0,1,0,0
1746576054739,SYN 1,B00,906086,Fish; Gwendolyn Anne,0,2,0,2
1746576055769,SYN 2R,A00,886860,Staff,0,17,15,15
1746576055769,SYN 2R,B00,906106,Atkinson; Arthur Laird,0,16,15,15
1746576056797,SYN 100,A01,886866,Browne; Emily,0,28,20,20
1746576056797,SYN 100,B01,906128,Rock; Martin,0,5,20,20
1746576056797,SYN 100,C01,906140,Deavenport; James Cary,0,3,20,20
1746576056797,SYN 100,D01,907816,Deavenport; James Cary,0,5,20,20
1746576057822,TDAC 1,A00,890286,Walsh; Kim C.,8,0,20,12
1746576058849,TDAC 101,A00,890296,Basso; Beatrice,15,0,20,5
1746576059877,TDDE 131,A00,890297,Staff,47,0,50,3
1746576060903,TDDM 1,A00,890287,Weinberg; Sadie,25,0,30,5
1746576061930,TDGE 11,A00,890288,Fulton; Julia,138,0,200,62
1746576061930,TDGE 11,B00,890289,Castro; Robert Jess,184,0,200,16
1746576062956,TDGE 25,B00,957359,Walsh; Kim C.,5,0,20,15
1746576063983,TDGE 40,A01,890292,Power; Jade Yukana,27,0,30,3
1746576065008,TDGE 124,A00,890298,Havis; Allan,0,1,50,50
1746576066038,TDGE 131R,A00,890299,Burelle; Julie Sara Veronique,15,0,42,27
1746576067064,TDHT 101,A00,890300,Staff,10,0,20,10
1746576068090,TDHT 109,A01,890302,Anderson; Mysia Anyse,31,0,40,9
1746576069115,TDMV 1,A00,890293,Arcidiacono; Kristin,18,0,30,12
1746576070144,TDMV 2,A00,890294,Weinberg; Sadie,23,0,30,7
1746576071172,TDMV 3,A00,957878,Arcidiacono; Kristin,28,0,30,2
1746576073231,TDMV 138,A00,890304,Jun; Grace Shin Hae,25,0,40,15
1746576074258,TDMV 140,A00,890305,Corrales; Joseph Bernales,25,0,30,5
1746576075288,TDMV 142,A00,890307,Caligagan; Tony,32,0,40,8
1746576076314,TDMV 144,A00,890308,Camaya; Michelle Ann,25,0,30,5
1746576077345,TDPW 1,A00,890295,Stein; Deborah Isobel,3,0,20,17
1746576078371,USP 2,A01,890272,Lerner; Amy M,7,0,20,13
1746576079396,USP 3,A01,890274,Staff,12,0,30,18
1746576080428,USP 15,A01,890276,Sun; Feiyang,16,0,30,14
1746576081457,USP 25,A00,890277,Shenkman; Michael Thomas,18,0,25,7
1746576082482,USP 138,A00,890278,Staff,14,0,25,11
1746576083508,USP 143,A00,890279,Staff,22,0,70,48
1746576084538,USP 144,A00,890280,Chowdhury; Muhammed Zohir,16,0,30,14
1746576085570,USP 150,A00,890281,Boomhower; Matthew Charles,4,0,30,26
1746576086598,USP 151,A00,890282,Staff,16,0,20,4
1746576087624,USP 162,A00,890283,Andrews; Abigail Leslie,16,0,20,4
1746576088653,USP 168,A00,920477,Kwak; Nancy,0,0,5,5
1746576089679,USP 181,A00,890284,Staff,3,0,20,17
1746576090705,USP 191A,A00,890285,Staff,12,0,20,8
1746576091733,VIS 101,A00,886512,Staff,26,0,75,49
1746576092762,VIS 103,A00,886513,Cruz; Edwin Teddy,61,0,75,14
1746576093792,VIS 108,A00,886514,Staff,3,0,15,12
1746576094816,VIS 127P,A00,886515,Shen; Kuiyi,80,0,146,66
1746576095844,VIS 149,A00,886516,Yoldas; Pinar,0,0,15,15
1746576096873,VIS 164,A00,886526,Erdmann; Dean,19,0,22,3
1746576097901,VIS 194S,A00,886527,Staff,61,0,75,14
1746576098927,WCWP 10A,C00,886484,Martiniuk; Jill,12,0,15,3
1746576099953,WCWP 10B,A00,886490,Uriarte; Emma,0,0,15,15
1746576099953,WCWP 10B,B00,886491,Dhir; Simrita,9,0,15,6
1746576099953,WCWP 10B,C00,886492,Ornelas; Tricia,0,0,15,15
1746576100978,WCWP 100,A00,886494,Young; Mark T,0,6,15,15
1746576103069,AAS 10,A01,886199,Childs; Dennis R.,0,3,0,0
1746576104094,ANAR 104,A01,886940,Shtienberg; Gilad,27,0,30,3
1746576105117,ANAR 120,A00,886953,Staff,12,0,20,8
1746576106145,ANBI 148,A01,886955,Wilder; Linnea Lorene,30,0,40,10
1746576108197,ANSC 122,A00,886957,Staff,25,0,30,5
1746576109221,ANSC 150,A00,886958,Sloane; Julia Kathryn,2,0,15,13
1746576110249,ANSC 156,A00,886959,Jenkins; Janis A.,0,1,15,15
1746576111277,ANSC 180,A00,886960,Staff,11,0,17,6
1746576112304,ANSC 188,A00,886961,Jassal; Aftab,9,0,25,16
1746576113332,ANSC 190,A00,886962,Jassal; Aftab,14,0,25,11
1746576114357,ANSC 191,A00,886963,Staff,18,0,20,2
1746576115381,ANTH 3,A01,891689,Staff,17,0,20,3
1746576116406,ANTH 5,A00,886933,Semendeferi; Ekaterini,16,0,20,4
1746576117434,ANTH 10,A00,886934,Staff,0,12,30,30
1746576118459,ANTH 21,A01,886936,Staff,41,0,60,19
1746576119486,ANTH 23,A01,886938,Staff,92,0,100,8
1746576120515,ANTH 105,A00,886964,Stewart; Alexander B,84,0,100,16
1746576121542,ANTH 108,A00,886965,Pedersen; David,9,0,20,11
1746576122572,AWP 10,001,886147,Staff,0,0,0,0
1746576122572,AWP 10,002,886148,Staff,0,0,0,0
1746576122572,AWP 10,003,886149,Staff,0,0,0,0
1746576122572,AWP 10,004,886150,Staff,0,0,0,0
1746576122572,AWP 10,005,886151,Staff,0,0,0,0
1746576122572,AWP 10,006,886152,Staff,0,0,0,0
1746576122572,AWP 10,007,886153,Staff,0,0,0,0
1746576122572,AWP 10,008,886154,Staff,0,0,0,0
1746576122572,AWP 10,009,886155,Staff,0,0,0,0
1746576122572,AWP 10,010,886156,Staff,0,0,0,0
1746576122572,AWP 10,011,886158,Staff,0,0,0,0
1746576122572,AWP 10,012,886160,Staff,0,0,0,0
1746576122572,AWP 10,013,886161,Staff,0,0,0,0
1746576122572,AWP 10,014,886162,Staff,0,0,0,0
1746576122572,AWP 10,015,886163,Staff,0,0,0,0
1746576122572,AWP 10,016,886164,Staff,0,0,0,0
1746576122572,AWP 10,017,886165,Staff,0,0,0,0
1746576122572,AWP 10,018,886166,Staff,0,0,0,0
1746576122572,AWP 10,019,886168,Staff,0,0,0,0
1746576122572,AWP 10,020,886170,Staff,0,0,0,0
1746576122572,AWP 10,021,886172,Staff,0,0,0,0
1746576123606,AWP 10R,001,886173,Staff,0,1,0,0
1746576123606,AWP 10R,002,886174,Staff,0,1,0,0
1746576123606,AWP 10R,003,886175,Staff,0,0,0,0
1746576123606,AWP 10R,004,886176,Staff,0,0,0,0
1746576123606,AWP 10R,005,886177,Staff,0,0,0,0
1746576123606,AWP 10R,006,886178,Staff,0,0,0,0
1746576123606,AWP 10R,007,886179,Staff,0,0,0,0
1746576123606,AWP 10R,008,886181,Staff,0,0,0,0
1746576123606,AWP 10R,009,886182,Staff,0,0,0,0
1746576123606,AWP 10R,010,886183,Staff,0,0,0,0
1746576123606,AWP 10R,011,886184,Staff,0,0,0,0
1746576123606,AWP 10R,012,886185,Staff,0,0,0,0
1746576123606,AWP 10R,013,886186,Staff,0,0,0,0
1746576123606,AWP 10R,014,886187,Staff,0,0,0,0
1746576123606,AWP 10R,015,886188,Staff,0,0,0,0
1746576123606,AWP 10R,016,886189,Staff,0,0,0,0
1746576123606,AWP 10R,017,960532,Staff,0,0,0,0
1746576123606,AWP 10R,018,960533,Staff,0,0,0,0
1746576123606,AWP 10R,019,960534,Staff,0,0,0,0
1746576123606,AWP 10R,020,960538,Staff,0,0,0,0
1746576123606,AWP 10R,021,960540,Staff,0,0,0,0
1746576123606,AWP 10R,022,960541,Staff,0,0,0,0
1746576123606,AWP 10R,023,960542,Staff,0,0,0,0
1746576123606,AWP 10R,024,960544,Staff,0,0,0,0
1746576123606,AWP 10R,025,960545,Staff,0,0,0,0
1746576123606,AWP 10R,026,960548,Staff,0,0,0,0
1746576124633,AWP 102R,A00,886190,Staff,0,0,0,0
1746576124633,AWP 102R,B00,886191,Staff,0,0,0,0
1746576125656,BENG 100,A01,886193,Staff,17,0,30,13
1746576126696,BENG 122A,A01,886195,Hasty; Jeff M,13,0,30,17
1746576127725,BENG 166A,A00,886196,Sah; Robert Lie-Yuan,0,2,30,30
1746576128749,BENG 190,A00,958050,Khojah; Reem I,20,0,25,5
1746576129775,BIBC 102,A01,894320,Staff,0,0,46,46
1746576129775,BIBC 102,A02,894321,Staff,0,0,46,46
1746576129775,BIBC 102,A03,894344,Staff,6,0,46,40
1746576129775,BIBC 102,A04,894345,Staff,27,0,47,20
1746576130801,BICD 100R,A01,894365,Smith; Laurie,0,3,58,58
1746576130801,BICD 100R,A02,894366,Smith; Laurie,0,5,58,58
1746576130801,BICD 100R,A03,894367,Smith; Laurie,0,0,59,59
1746576130801,BICD 100R,A04,959869,Smith; Laurie,40,0,59,19
1746576131829,BICD 136,A01,894383,Gustafson-Brown; Cindy,14,0,50,36
1746576132857,BIEB 102,A01,894494,Butler; Shannon Rhey,51,0,130,79
1746576134919,BIEB 150,A01,894617,Wills; Christopher,3,0,20,17
1746576134919,BIEB 150,A02,894631,Wills; Christopher,3,0,20,17
1746576134919,BIEB 150,A03,894937,Wills; Christopher,3,0,20,17
1746576134919,BIEB 150,A04,894946,Wills; Christopher,5,0,20,15
1746576135948,BIEB 194,A00,906141,Kurle; Carolyn M.,6,0,20,14
1746576136972,BILD 1,A01,894154,Staff,3,0,19,16
1746576136972,BILD 1,A02,894155,Staff,14,0,19,5
1746576136972,BILD 1,A03,894160,Staff,13,0,19,6
1746576136972,BILD 1,A04,894161,Staff,15,0,18,3
1746576138003,BILD 2,A01,894168,Staff,0,0,50,50
1746576138003,BILD 2,A02,894169,Staff,0,0,50,50
1746576138003,BILD 2,A03,894179,Staff,0,0,50,50
1746576138003,BILD 2,A04,894203,Staff,24,0,50,26
1746576139033,BILD 3,A01,894213,Staff,23,0,31,8
1746576139033,BILD 3,A02,894214,Staff,26,0,31,5
1746576139033,BILD 3,A03,894235,Staff,28,0,31,3
1746576139033,BILD 3,A04,894236,Staff,28,0,32,4
1746576140059,BILD 4,A01,894253,Reuther; Keefe,5,0,24,19
1746576140059,BILD 4,A02,894258,Reuther; Keefe,16,0,24,8
1746576141088,BILD 5,A01,894276,Reuther; Keefe,35,0,50,15
1746576141088,BILD 5,A02,894277,Reuther; Keefe,45,0,50,5
1746576141088,BILD 5,A03,894290,Reuther; Keefe,44,0,50,6
1746576141088,BILD 5,A04,894291,Reuther; Keefe,48,0,50,2
1746576142118,BILD 24,A01,894297,Pirino; Giorgia,40,0,60,20
1746576143145,BIMM 100,B01,958915,Staff,71,0,100,29
1746576144177,BIMM 101,A01,895017,McDonnell; Lisa Marie,0,5,24,24
1746576144177,BIMM 101,A02,895018,McDonnell; Lisa Marie,0,5,24,24
1746576144177,BIMM 101,B01,895020,McDonnell; Lisa Marie,0,6,24,24
1746576144177,BIMM 101,B02,895021,McDonnell; Lisa Marie,0,4,24,24
1746576145206,BIMM 110,A01,895023,Staff,1,0,25,24
1746576145206,BIMM 110,A02,895024,Staff,9,0,25,16
1746576145206,BIMM 110,A03,895025,Staff,18,0,25,7
1746576145206,BIMM 110,A04,895031,Staff,20,0,25,5
1746576146234,BIMM 120,A01,895114,Gustafson-Brown; Cindy,14,0,28,14
1746576146234,BIMM 120,A02,895126,Gustafson-Brown; Cindy,21,0,27,6
1746576147277,BIPN 100,A01,895130,Yang; Mingyu,0,0,38,38
1746576147277,BIPN 100,A02,895131,Yang; Mingyu,32,0,38,6
1746576147277,BIPN 100,A03,895132,Yang; Mingyu,32,0,38,6
1746576147277,BIPN 100,A04,895133,Yang; Mingyu,27,0,36,9
1746576148302,BIPN 120,A01,895135,Cooke; James Edward,0,3,13,13
1746576148302,BIPN 120,A02,895136,Cooke; James Edward,0,1,13,13
1746576148302,BIPN 120,A03,895137,Cooke; James Edward,0,3,13,13
1746576148302,BIPN 120,A04,895156,Cooke; James Edward,0,2,11,11
1746576149329,BIPN 134,A01,895235,Cooke; James Edward,0,2,25,25
1746576149329,BIPN 134,A02,895237,Cooke; James Edward,0,0,25,25
1746576149329,BIPN 134,A03,895240,Cooke; James Edward,3,0,25,22
1746576149329,BIPN 134,A04,895270,Cooke; James Edward,20,0,25,5
1746576150353,BIPN 189,A00,892103,Staff,0,14,14,14
1746576152406,BISP 194,A00,958008,Staff,0,2,0,0
1746576153432,CAT 124,A01,922009,Staff,0,5,20,20
1746576154458,CAT 125R,A00,886390,Morales; Celeste Georgianna,0,2,20,20
1746576154458,CAT 125R,B00,886391,Irwin; Matthew Joseph,0,4,20,20
1746576154458,CAT 125R,C00,886392,Smith; Lauryn Alissa,0,2,20,20
1746576154458,CAT 125R,D00,886393,Vanderschuit; Maya Alysia,0,3,20,20
1746576154458,CAT 125R,E00,886394,Marchisotto; Jennifer Anne,0,3,20,20
1746576155488,CENG 15,A01,886218,Drews; Aaron,3,0,8,5
1746576156515,CENG 113,A00,886219,Opatkiewicz; Justin Paul,15,0,25,10
1746576157539,CGS 101,A00,887044,Staff,7,0,20,13
1746576158565,CGS 105,A01,887046,Staff,14,0,25,11
1746576159594,CGS 112,A00,887047,Cuong; Marisol,12,0,15,3
1746576160619,CGS 113,A00,887048,Staff,23,0,30,7
1746576161643,CGS 120,A00,887049,Staff,10,0,17,7
1746576162669,CHEM 6A,A01,886336,Lam; Tin Yiu,38,0,50,12
1746576162669,CHEM 6A,A02,886338,Lam; Tin Yiu,37,0,50,13
1746576163700,CHEM 6B,A01,886341,Hopkins; Patrycja Anna,16,0,50,34
1746576163700,CHEM 6B,A02,886343,Hopkins; Patrycja Anna,42,0,50,8
1746576164727,CHEM 6C,A01,886346,Albizati; Kim F.,0,2,50,50
1746576164727,CHEM 6C,A02,886348,Albizati; Kim F.,23,0,50,27
1746576165753,CHEM 40A,A01,886352,Klosterman; Jeremy K,65,0,100,35
1746576166781,CHEM 40B,A01,886356,Klosterman; Jeremy K,0,23,100,100
1746576167806,CHEM 41B,A01,886360,Theodorakis; Emmanuel,25,0,50,25
1746576167806,CHEM 41B,A02,886362,Theodorakis; Emmanuel,47,0,50,3
1746576168830,CHIN 165A,A00,886382,Xu; Li,18,0,20,2
1746576169854,CLAS 120,A00,886387,Myerston Santana; Jacobo,33,0,40,7
1746576170884,COGS 9,A01,886967,Shannon; Kyle Michael,42,0,60,18
1746576171909,COGS 11,A01,886969,Staff,9,0,30,21
1746576172934,COGS 14A,A01,886971,Staff,6,0,60,54
1746576173960,COGS 14B,A01,886973,Hoffman; Drew Ellen,4,0,60,56
1746576174989,COGS 18,A01,886975,Morgan; Eric,35,0,60,25
1746576176014,COGS 20,A01,886977,Staff,4,0,8,4
1746576176014,COGS 20,A02,886978,Staff,5,0,7,2
1746576177042,COGS 100,A01,907783,Staff,1,2,30,29
1746576178068,COGS 101B,A01,886980,Staff,0,3,48,48
1746576179094,COGS 101C,A01,886982,Delgado; Tania,0,5,44,44
1746576180119,COGS 102A,A01,886984,Johnson; Christine M.,4,0,30,26
1746576181144,COGS 118B,A01,886986,Staff,1,4,88,87
1746576182174,COGS 150,A01,886988,Bergen; Benjamin,22,0,50,28
1746576183199,COGS 153,A00,886989,Delgado; Tania,0,2,41,41
1746576184223,COGS 186,A01,886991,Staff,0,0,32,32
1746576185253,COGS 187A,A01,886993,Boyle; Mary E. T.,7,0,30,23
1746576186276,COGS 189,A00,886994,Staff,0,1,30,30
1746576187301,COMM 10,A01,886996,Staff,0,0,20,21
1746576187301,COMM 10,A02,886997,Staff,11,0,20,9
1746576187301,COMM 10,A03,959845,Staff,19,0,20,1
1746576188329,COMM 20,A01,886999,Leuning; Grant Maurstad,24,0,40,16
1746576190382,COMM 100A,A01,887002,Staff,0,0,20,25
1746576190382,COMM 100A,A02,887003,Staff,6,0,20,14
1746576191411,COMM 100B,A01,887005,Staff,0,8,20,24
1746576192436,COMM 106D,A00,887006,Staff,13,0,40,27
1746576193460,COMM 110G,A00,887007,Whitworth-Smith; Andrew C,12,0,40,28
1746576194488,COMM 111B,A00,887008,Staff,31,0,40,9
1746576195521,COMM 113T,A00,887009,Abuelhiga; Soraya Jill,28,0,40,12
1746576195521,COMM 113T,B00,906733,Staff,40,0,40,0
1746576196547,COMM 145,A00,887010,Staff,12,0,40,28
1746576197578,COMM 146,A00,887054,Staff,31,0,40,9
1746576198604,COMM 190,A00,887012,Staff,8,0,23,15
1746576199629,CSE 8A,A50,887015,Cao; Yingjun,57,0,85,28
1746576200664,CSE 11,A01,887017,Cao; Yingjun,12,0,70,58
1746576201706,CSE 20,A01,887019,Staff,30,0,50,20
1746576202732,CSE 21,A01,887021,Staff,78,0,100,22
1746576202732,CSE 21,B01,892583,Braun; Oliver,45,0,50,5
1746576203760,CSE 30,A01,887025,Eldon; John,143,0,200,57
1746576204788,CSE 100,A01,887027,Staff,26,0,50,24
1746576204788,CSE 100,A02,887028,Staff,42,0,50,8
1746576205813,CSE 101,A01,887030,Braun; Oliver,74,0,100,26
1746576205813,CSE 101,B01,887032,Jones; Miles E,0,3,50,50
1746576205813,CSE 101,B02,887033,Jones; Miles E,0,2,50,50
1746576206838,CSE 105,A01,908084,Jones; Miles E,32,0,50,18
1746576206838,CSE 105,A02,908087,Jones; Miles E,31,0,50,19
1746576207865,CSE 135,A01,887035,Powell; Thomas Allan,0,5,50,50
1746576208889,CSE 142,A01,887037,Staff,8,0,60,52
1746576209913,CSE 142L,A01,887039,Staff,34,0,60,26
1746576210937,CSE 151A,A01,887041,Solares; Edwin A,47,0,100,53
1746576211966,CSE 175,A01,887043,Kumar; Rakesh,30,0,30,0
1746576212990,CSS 1,A01,886389,Staff,1,1,40,39
1746576214020,DSC 30,A01,908097,Liao; Soohyun Nam,47,0,75,28
1746576215054,DSC 40A,A01,908099,Shannon; Kyle Michael,30,0,50,20
1746576216078,DSC 40B,A01,908112,Staff,15,0,50,35
1746576217104,DSC 80,A01,908116,Staff,19,0,60,41
1746576218129,DSC 197,001,956863,Eldridge; Justin Matthew,9999,0,9999,0
1746576219155,ECE 5,A01,886400,Morris; Karcher William,1,0,6,5
1746576219155,ECE 5,A02,886401,Morris; Karcher William,3,0,6,3
1746576220180,ECE 148,A01,886403,Silberman; Jack,0,14,14,14
1746576221206,ECON 1,A01,887265,Crane; Meredith Helen,12,0,70,58
1746576221206,ECON 1,B01,887268,Staff,42,0,50,8
1746576222234,ECON 2,A01,887273,Crane; Meredith Helen,55,0,70,15
1746576223264,ECON 3,A01,887279,Rondina; Giacomo,32,0,70,38
1746576224306,ECON 4,A01,887282,Anderson; John Charles,0,2,10,10
1746576225331,ECON 5,A01,887285,Staff,34,0,45,11
1746576225331,ECON 5,B01,887292,Staff,41,0,45,4
1746576226356,ECON 100A,A01,887337,Newhouse; Herbert S,54,0,70,16
1746576226356,ECON 100A,B01,887349,Staff,45,0,50,5
1746576227383,ECON 100B,A01,887361,Du; Songzi,29,0,70,41
1746576228412,ECON 100C,A01,887445,Newhouse; Herbert S,59,0,70,11
1746576229441,ECON 105,A00,887488,Vespa; Emanuel Ignacio,23,0,35,12
1746576230467,ECON 109,A01,887506,Shishkin; Denis,28,0,35,7
1746576231496,ECON 110A,A01,887568,Alon; Titan Michael,0,3,35,35
1746576231496,ECON 110A,B01,907601,Alon; Titan Michael,20,0,35,15
1746576232524,ECON 110B,A01,887598,Levkoff; Steven B.,0,24,70,70
1746576233553,ECON 112,A00,887599,Rondina; Giacomo,19,0,35,16
1746576234579,ECON 120A,A01,887603,Dai; Yinlin,35,0,70,35
1746576235612,ECON 120C,A01,887608,Sun; Yixiao,0,1,35,35
1746576235612,ECON 120C,B01,887614,Sun; Yixiao,0,0,35,35
1746576236641,ECON 138,A00,887621,Bharadwaj; Prashant,0,21,20,20
1746576237664,ECON 144,A00,958007,Squires; Dale E,12,0,35,23
1746576238689,ECON 171,A01,907666,Staff,18,0,35,17
1746576239719,ECON 175,A00,887626,Wu; Pak Yeung,22,0,35,13
1746576240747,ECON 190,A00,887640,Vespa; Emanuel Ignacio,22,0,35,13
1746576241774,EDS 25,A01,888197,Staff,0,0,0,0
1746576241774,EDS 25,A02,888209,Staff,0,0,0,0
1746576241774,EDS 25,A03,888210,Staff,0,0,0,0
1746576241774,EDS 25,A04,888212,Staff,0,0,0,0
1746576241774,EDS 25,A05,888213,Staff,0,0,0,0
1746576241774,EDS 25,A06,888214,Staff,0,0,0,0
1746576241774,EDS 25,A07,888235,Staff,0,2,0,0
1746576241774,EDS 25,A08,888236,Staff,0,0,0,0
1746576241774,EDS 25,A09,888240,Staff,0,0,0,0
1746576241774,EDS 25,A10,888244,Staff,0,0,0,0
1746576241774,EDS 25,B01,888273,Staff,0,0,0,0
1746576241774,EDS 25,B02,888285,Staff,0,0,0,0
1746576241774,EDS 25,B03,888423,Staff,0,0,0,1
1746576241774,EDS 25,B04,888432,Staff,0,0,0,0
1746576241774,EDS 25,B05,888433,Staff,0,0,0,0
1746576241774,EDS 25,B06,888467,Staff,0,0,0,0
1746576241774,EDS 25,B07,888468,Staff,0,0,0,0
1746576241774,EDS 25,B08,888479,Staff,0,0,0,0
1746576241774,EDS 25,B09,888484,Staff,0,0,0,0
1746576241774,EDS 25,B10,888487,Staff,0,0,0,0
1746576242799,EDS 38,A01,907700,Choi; Bailey Miyeon,30,0,30,0
1746576243824,EDS 112,A01,888601,Chapman; Thandeka K,12,0,40,28
1746576244855,EDS 115,A00,888697,Mendez; Kathrina Mendoza,10,0,30,20
1746576245883,EDS 116,A01,888893,Staff,34,0,40,6
1746576247934,EDS 124AR,A00,889133,Staff,29,0,50,21
1746576247934,EDS 124AR,B00,907471,Simon; Elizabeth A,37,0,50,13
1746576248959,EDS 124BR,A00,889134,Simon; Elizabeth A,44,0,100,56
1746576249987,EDS 125,A00,889135,Staff,25,0,30,5
1746576251016,EDS 126,A01,889138,Staff,35,0,40,5
1746576252043,EDS 164R,A01,889142,Wishard Guerra; Alison G.,33,0,50,17
1746576253075,ENG 30,A01,886396,Staff,0,0,0,0
1746576253075,ENG 30,B01,886398,Staff,0,0,0,0
1746576254101,ENVR 102,A00,906150,Montejo; Carolina,23,0,25,2
1746576255126,ETHN 103A,A00,887236,Man; Simeon S,0,3,0,0
1746576256152,ETHN 113,A00,887239,Staff,16,0,30,14
1746576257179,ETHN 116,A00,887240,Staff,16,0,25,9
1746576258211,ETHN 117,A00,887241,Choi; Esther Min,28,0,30,2
1746576259237,ETHN 118,A00,887243,Staff,24,0,30,6
1746576260268,ETHN 127,A00,887248,Cuong; Marisol,11,0,15,4
1746576261296,ETHN 139,A00,887250,Staff,7,0,10,3
1746576262324,ETHN 142,A00,887252,Staff,10,0,30,20
1746576263351,ETHN 161,A00,887253,Browne; Errol Tsekani,24,0,30,6
1746576264382,ETHN 163FR,A00,887255,Burelle; Julie Sara Veronique,0,0,5,5
1746576265410,GLBH 20,A00,889149,Elwardani; Nile Regina,8,0,42,34
1746576267463,GLBH 111,A01,889152,Burgos; Jose L.,17,0,17,0
1746576268489,GLBH 150,A00,889181,Sloane; Julia Kathryn,0,5,15,15
1746576270546,HDS 60,A01,886406,Warstadt; Melissa Fawn,73,0,80,7
1746576271572,HIAF 111,A00,889324,Gyamfi; Bright,25,0,32,7
1746576272601,HIEA 131,A00,889328,Staff,15,0,32,17
1746576273626,HIEA 144,A00,889333,Henry; Todd A.,26,0,32,6
1746576274651,HIEA 154,A00,889336,Henry; Todd A.,24,0,32,8
1746576275676,HIEU 106,A00,889339,Staff,22,0,32,10
1746576277732,HIEU 114,A00,889340,Staff,4,0,32,28
1746576278760,HIEU 135GS,A00,889342,Patterson; Patrick H.,0,0,1,24
1746576279786,HIEU 137,A00,889343,Edington; Claire Ellen,10,0,25,15
1746576280811,HIEU 148,A00,889345,Staff,14,0,32,18
1746576281836,HIEU 154,A00,889346,Biess; Frank Peter,21,0,32,11
1746576282863,HILA 102,A00,889351,Staff,12,0,32,20
1746576283887,HILD 2A,A01,889221,Lewandoski; Julia Mavis,1,10,32,31
1746576284913,HILD 7B,A01,889225,Man; Simeon S,0,12,32,32
1746576285944,HILD 7C,A01,889288,Alvarez; Luis A,0,14,32,32
1746576286971,HILD 30,A01,889323,Staff,0,5,32,32
1746576289034,HISC 119,A00,889383,Golan; Tal,19,0,32,13
1746576290065,HIUS 103,A00,889384,Man; Simeon S,0,0,32,32
1746576291089,HIUS 117,A00,919797,Kwak; Nancy,19,0,32,13
1746576292115,HIUS 142A,A00,919788,Staff,22,0,32,10
1746576294167,HIUS 149,A00,889386,Gyamfi; Bright,26,0,32,6
1746576295199,HIUS 155,A00,889387,Alvarez; Luis A,15,0,32,17
1746576296225,HUM 3,A01,886499,Caldwell; Michael Alan,19,0,50,31
1746576297250,HUM 3GS,A00,886500,Rodriguez; Bretton Sigfred,0,0,0,28
1746576298277,HUM 3R,A01,886502,Markman; Kristina,0,36,50,50
1746576299308,HUM 4,A01,886504,Crum; Matthew Stephen,23,0,50,27
1746576299308,HUM 4,B01,886506,West; Geoffrey Scott,17,0,50,33
1746576300337,HUM 4GS,A00,886507,Staff,0,0,0,19
1746576301366,HUM 5,A01,886509,Staff,32,0,50,18
1746576302412,HUM 5R,A01,886511,Zavodny; Tatiana Sophia,0,39,50,50
1746576303445,JAPN 180,A00,886407,Staff,16,0,40,24
1746576304475,LATI 50,A01,886409,Martin-Cabrera; Luis,4,0,22,18
1746576304475,LATI 50,A02,886410,Martin-Cabrera; Luis,19,0,22,3
1746576304475,LATI 50,A03,886411,Martin-Cabrera; Luis,21,0,22,1
1746576304475,LATI 50,A04,886412,Martin-Cabrera; Luis,9,0,22,13
1746576305503,LAWS 101,A00,907664,Staff,28,0,60,32
1746576306529,LIAB 1A,A00,889388,Saab; Dima,17,0,20,3
1746576307555,LIAB 1AX,A00,889389,El Cheddadi; Youniss,18,0,20,2
1746576308580,LIFR 1C,A00,889391,Van Moer; Vinciane G,8,0,20,12
1746576309605,LIFR 1CX,A00,889392,Van Moer; Vinciane G,7,0,20,13
1746576310631,LIFR 1D,A00,889393,Van Moer; Vinciane G,7,0,20,13
1746576311659,LIFR 1DX,A00,889394,Van Moer; Vinciane G,8,0,20,12
1746576312689,LIGN 7,A00,886923,Staff,24,0,50,26
1746576313717,LIGN 17,A00,886924,Kehler; Andrew Scott,125,0,150,25
1746576314741,LTAM 110,A00,889395,Staff,15,0,30,15
1746576315767,LTAM 110GS,A00,958010,Rodriguez; Bretton Sigfred,0,0,0,28
1746576316797,LTCH 101,A00,889397,Staff,23,0,25,2
1746576317825,LTCS 130,A00,889398,Staff,23,0,25,2
1746576318849,LTEA 138,A00,889399,Staff,24,0,40,16
1746576319881,LTEN 149,A00,889400,Wesling; Megan E.,0,3,25,25
1746576320906,LTEN 169,A00,889401,Staff,20,0,25,5
1746576321931,LTEN 180,A00,889402,Staff,10,0,15,5
1746576322958,LTEN 181,A00,889403,Staff,21,0,25,4
1746576323988,LTWL 100,A00,889404,Myerston Santana; Jacobo,2,0,25,23
1746576325012,LTWL 180GS,A00,889405,Staff,0,0,20,20
1746576326041,LTWL 181,A00,889406,Staff,16,0,25,9
1746576327071,LTWL 184,A00,889475,Mukherjee; Silpa,22,0,25,3
1746576328097,LTWR 102C,A00,889486,Staff,29,0,30,1
1746576329126,LTWR 115W,A00,889491,Staff,0,2,15,15
1746576330152,MAE 8,A01,886905,Staff,0,2,0,0
1746576331178,MAE 11,A00,886906,Bandaru; Prabhakar,0,7,50,50
1746576332206,MAE 20,A00,886907,Evdokimenko; Ekaterina,43,0,70,27
1746576333236,MAE 30B,A00,886909,Ghazinejad; Maziar,26,0,45,19
1746576334267,MAE 101B,A00,886910,Saintillan; David,29,0,45,16
1746576335292,MAE 105,A00,886911,Bandaru; Prabhakar,18,0,50,32
1746576336318,MAE 107,B00,958024,Staff,8,0,50,42
1746576337343,MAE 143B,A00,886913,Bewley; Thomas R,4,0,40,36
1746576338388,MAE 148,A01,886915,Silberman; Jack,0,3,14,14
1746576339417,MAE 160,A00,886916,Evdokimenko; Ekaterina,31,0,60,29
1746576340443,MATH 3C,A01,889681,Staff,0,2,30,30
1746576340443,MATH 3C,A02,960048,Staff,24,0,30,6
1746576341474,MATH 10A,A01,889760,Staff,26,0,30,4
1746576341474,MATH 10A,A02,889783,Staff,29,0,30,1
1746576342504,MATH 10B,A01,889785,Verstraete; Jacques Allan,2,0,35,33
1746576342504,MATH 10B,A02,889795,Verstraete; Jacques Allan,4,0,35,31
1746576342504,MATH 10B,B01,889797,Verstraete; Jacques Allan,3,0,35,32
1746576342504,MATH 10B,B02,889828,Verstraete; Jacques Allan,3,0,35,32
1746576343535,MATH 10C,A01,889849,Habib; Yousaf,7,0,30,23
1746576343535,MATH 10C,A02,889852,Habib; Yousaf,14,0,30,16
1746576343535,MATH 10C,A03,889853,Habib; Yousaf,22,0,30,8
1746576343535,MATH 10C,A04,889858,Habib; Yousaf,20,0,30,10
1746576343535,MATH 10C,B01,889861,Staff,1,0,30,29
1746576343535,MATH 10C,B02,889862,Staff,24,0,30,6
1746576343535,MATH 10C,B03,889863,Staff,27,0,30,3
1746576343535,MATH 10C,B04,889967,Staff,23,0,30,7
1746576344561,MATH 18,A01,889974,Staff,7,0,30,23
1746576344561,MATH 18,A02,889977,Staff,20,0,30,10
1746576344561,MATH 18,B01,889984,Hardiman; Liam,21,0,30,9
1746576344561,MATH 18,B02,889985,Hardiman; Liam,25,0,30,5
1746576345586,MATH 20A,A01,889990,Suk; Andrew Hoon,30,0,35,5
1746576346613,MATH 20B,A01,889993,Ohm; Ko Woon,22,0,30,8
1746576346613,MATH 20B,A02,889994,Ohm; Ko Woon,30,0,30,0
1746576346613,MATH 20B,B01,889996,Ohm; Ko Woon,22,0,30,8
1746576346613,MATH 20B,B02,889997,Ohm; Ko Woon,23,0,30,7
1746576347644,MATH 20C,A01,889999,Hammock; Frances H,17,0,30,13
1746576347644,MATH 20C,A02,890003,Hammock; Frances H,23,0,30,7
1746576347644,MATH 20C,B01,890006,Hammock; Frances H,3,0,30,27
1746576347644,MATH 20C,B02,890007,Hammock; Frances H,12,0,30,18
1746576348669,MATH 20D,A01,890011,Cheng; Hsiao-Bing,1,1,30,29
1746576348669,MATH 20D,A02,890012,Cheng; Hsiao-Bing,14,0,30,16
1746576348669,MATH 20D,B01,890016,Cheng; Hsiao-Bing,13,0,30,17
1746576348669,MATH 20D,B02,890017,Cheng; Hsiao-Bing,13,0,30,17
1746576349700,MATH 20E,A01,890026,Harel; Guershon,1,0,30,29
1746576349700,MATH 20E,A02,890029,Harel; Guershon,23,0,30,7
1746576349700,MATH 20E,B01,890033,Harel; Guershon,7,0,30,23
1746576349700,MATH 20E,B02,890101,Harel; Guershon,21,0,30,9
1746576350728,MATH 102,A01,890104,Staff,17,0,30,13
1746576350728,MATH 102,A02,890105,Staff,27,0,30,3
1746576351753,MATH 103B,A01,890116,Salehi Golsefidy; Alireza,3,0,30,27
1746576351753,MATH 103B,B01,890118,Staff,0,3,34,34
1746576352784,MATH 109,A01,890121,Aliabadi Sr.; Mohsen,1,0,30,29
1746576352784,MATH 109,B01,890124,Upadrashta; Pranav Kumar,18,0,30,12
1746576353814,MATH 120A,A01,890126,Eggers; John Dietrich,13,0,30,17
1746576354839,MATH 142B,A01,890128,Ioana; Adrian,19,0,30,11
1746576354839,MATH 142B,A02,890129,Ioana; Adrian,13,0,30,17
1746576355867,MATH 154,A01,890174,Staff,0,0,30,30
1746576355867,MATH 154,A02,890182,Staff,0,0,30,30
1746576356896,MATH 168A,A01,890197,Dumitriu; Ioana,21,0,35,14
1746576357921,MATH 170A,A01,890240,Nie; Jiawang,1,0,30,29
1746576357921,MATH 170A,A02,890241,Nie; Jiawang,11,0,30,19
1746576357921,MATH 170A,A03,890249,Nie; Jiawang,23,0,30,7
1746576358947,MATH 170B,A01,957891,Nag; Panchali,13,0,35,22
1746576360999,MATH 181A,A01,908025,Staff,0,3,35,35
1746576360999,MATH 181A,A02,960115,Staff,26,0,35,9
1746576362030,MATH 181B,A01,959874,Staff,25,0,30,5
1746576363058,MATH 193B,A01,890265,Staff,0,4,35,35
1746576364082,MGT 4,A01,890311,Anderson; John Charles,42,0,88,46
1746576365112,MGT 5,A00,907740,Staff,13,0,98,85
1746576366137,MGT 12,A00,890312,Lindenberger; Wade Douglas,67,0,98,31
1746576367162,MGT 16,A00,957883,Staff,78,0,98,20
1746576369213,MGT 45,A00,890314,Pecore; Joseph P.,45,0,98,53
1746576370238,MGT 71,A00,890315,Staff,0,11,98,98
1746576371263,MGT 100,A00,890316,Yavorsky; Daniel Ryan,44,0,98,54
1746576372291,MGT 103,A00,890317,Ehrich; Kristine R,73,0,98,25
1746576373320,MGT 105,A00,890356,Bates; Kenneth Walter,0,8,98,98
1746576374344,MGT 112,A00,890360,Ehrich; Kristine R,55,0,98,43
1746576375368,MGT 127R,A00,907732,Zhu; Kevin Xiaoguo,23,0,98,75
1746576376397,MGT 131B,A00,890361,Anderson; John Charles,59,0,98,39
1746576377425,MGT 137,A00,890362,Lindenberger; Wade Douglas,65,0,98,33
1746576378456,MGT 160,A00,890369,Johnson; Erik Barry,9,0,98,89
1746576380506,MGT 164,A00,890372,Zimmermann; Carsten,0,40,98,98
1746576381532,MGT 180,A00,890374,Bliss; Barbara Ann,12,0,98,86
1746576382558,MMW 15,A01,886414,Chang; Edmond Yi-Teh,0,12,28,28
1746576382558,MMW 15,A02,886415,Chang; Edmond Yi-Teh,0,8,28,28
1746576382558,MMW 15,A03,886416,Chang; Edmond Yi-Teh,0,9,28,28
1746576382558,MMW 15,A04,886417,Chang; Edmond Yi-Teh,0,8,28,28
1746576382558,MMW 15,B01,886419,Chang; Edmond Yi-Teh,0,7,28,28
1746576382558,MMW 15,B02,886420,Chang; Edmond Yi-Teh,0,8,28,28
1746576382558,MMW 15,B03,886421,Chang; Edmond Yi-Teh,0,7,28,28
1746576382558,MMW 15,B04,886422,Chang; Edmond Yi-Teh,0,8,28,28
1746576382558,MMW 15,C01,886424,Staff,0,9,28,28
1746576382558,MMW 15,C02,886425,Staff,0,8,28,28
1746576382558,MMW 15,C03,886426,Staff,0,8,28,28
1746576382558,MMW 15,C04,886427,Staff,0,8,28,28
1746576382558,MMW 15,C05,958038,Staff,0,8,28,28
1746576382558,MMW 15,C06,958039,Staff,1,8,28,27
1746576383583,MMW 15GS,A00,906910,Patterson; Patrick H.,4,0,28,24
1746576384609,MMW 122R,A01,886429,Rahimi; Babak,0,13,28,28
1746576384609,MMW 122R,A02,886430,Rahimi; Babak,0,12,28,28
1746576384609,MMW 122R,A03,958040,Rahimi; Babak,0,11,28,28
1746576385637,MUS 1A,A01,890937,Staff,2,0,25,23
1746576385637,MUS 1A,A02,891035,Staff,6,0,25,19
1746576385637,MUS 1A,C01,958912,Staff,24,0,25,1
1746576385637,MUS 1A,C02,958913,Staff,25,0,25,0
1746576387687,MUS 2AK,A00,957092,Ohnishi; Takae,15,0,15,0
1746576388713,MUS 4,A01,891044,Staff,1,0,25,24
1746576388713,MUS 4,A02,891045,Staff,23,0,25,2
1746576388713,MUS 4,B01,891048,Staff,17,0,25,8
1746576388713,MUS 4,B02,891050,Staff,25,0,25,0
1746576389745,MUS 5,A01,957506,Dubnov; Shlomo,0,0,25,25
1746576389745,MUS 5,A02,957622,Dubnov; Shlomo,13,0,25,12
1746576389745,MUS 5,A03,957623,Dubnov; Shlomo,20,0,25,5
1746576390775,MUS 6,A01,891053,Freitas Caetano; Marcelo,24,0,25,1
1746576390775,MUS 6,A02,891054,Freitas Caetano; Marcelo,23,0,25,2
1746576391801,MUS 7,A01,891081,Staff,1,0,25,24
1746576391801,MUS 7,A02,891082,Staff,3,0,25,22
1746576392829,MUS 8GS,A00,891118,Borgo; David Garcia,1,0,25,24
1746576393854,MUS 11,A01,891140,Staff,9,0,25,16
1746576393854,MUS 11,A02,891141,Staff,22,0,25,3
1746576394880,MUS 13,A01,891143,Staff,8,0,25,17
1746576394880,MUS 13,A02,891144,Staff,24,0,25,1
1746576395907,MUS 15,A01,891146,Staff,9,0,25,16
1746576395907,MUS 15,A02,891148,Staff,21,0,25,4
1746576395907,MUS 15,B01,891150,Staff,18,0,25,7
1746576395907,MUS 15,B02,891151,Staff,25,0,25,0
1746576396936,MUS 20,A01,891153,Staff,5,0,20,15
1746576396936,MUS 20,A02,891155,Staff,14,0,20,6
1746576397967,MUS 80,A00,891156,Staff,19,0,25,6
1746576397967,MUS 80,B00,891157,Staff,23,0,25,2
1746576398993,MUS 130,A00,891158,Ohnishi; Takae,35,0,35,0
1746576400024,MUS 150GS,A01,891160,Borgo; David Garcia,1,0,25,24
1746576401052,MUS 170,A01,891162,Freitas Caetano; Marcelo,20,0,25,5
1746576401052,MUS 170,A02,891164,Freitas Caetano; Marcelo,21,0,25,4
1746576402083,NANO 11,A00,886220,Vazquez Mena; Oscar,13,0,15,2
1746576403116,NANO 15,A01,886222,Drews; Aaron,4,0,7,3
1746576404143,NANO 104,A00,886224,Sirbuly; Donald,17,0,25,8
1746576405171,PH 40,A00,886528,Staff,24,0,40,16
1746576406195,PH 45,A01,886799,Staff,35,0,40,5
1746576407221,PH 110,A00,886802,Staff,0,7,40,40
1746576408250,PH 172,A00,906716,Staff,19,0,35,16
1746576409280,PH 191,A00,886803,Staff,6,0,40,34
1746576410310,PHIL 1,A00,889500,Staff,20,0,30,10
1746576411337,PHIL 10,A01,889549,Grush; Rick Scott,16,0,22,6
1746576411337,PHIL 10,A02,889551,Grush; Rick Scott,22,0,22,0
1746576412370,PHIL 28,A01,889559,Lamey; Andy M.,0,2,31,31
1746576412370,PHIL 28,A02,889561,Lamey; Andy M.,0,1,30,30
1746576412370,PHIL 28,A03,889572,Lamey; Andy M.,0,1,30,30
1746576413399,PHIL 35,A00,907839,Staff,13,0,15,2
1746576414429,PHIL 60,A00,889574,Staff,73,0,90,17
1746576415453,PHIL 101,A00,958004,Staff,12,0,15,3
1746576417508,PHIL 136,A00,889582,Fulkerson; Matthew Todd,26,0,45,19
1746576418535,PHIL 163,A01,889601,Staff,21,0,30,9
1746576418535,PHIL 163,B01,889606,Brandt; Reuven A,0,3,0,0
1746576419568,PHIL 164,A00,889610,Staff,16,0,30,14
1746576420597,PHIL 165,A00,889613,Staff,22,0,30,8
1746576421625,PHYS 1A,A00,886431,Staff,27,0,70,43
1746576422657,PHYS 1AL,001,886432,Tsai; Philbert S,1,2,30,29
1746576422657,PHYS 1AL,002,886436,Tsai; Philbert S,11,0,30,19
1746576423689,PHYS 1B,A00,886439,Staff,185,0,240,55
1746576424721,PHYS 1BL,001,886441,Tsai; Philbert S,0,4,30,30
1746576424721,PHYS 1BL,002,886444,Tsai; Philbert S,2,0,30,28
1746576425746,PHYS 1C,A00,896092,Arnold; Kam S,78,0,146,68
1746576426775,PHYS 1CL,001,886448,Tsai; Philbert S,0,0,30,30
1746576426775,PHYS 1CL,002,886449,Tsai; Philbert S,1,0,30,29
1746576426775,PHYS 1CL,003,886450,Tsai; Philbert S,16,0,30,14
1746576426775,PHYS 1CL,004,886451,Tsai; Philbert S,15,0,30,15
1746576427805,PHYS 2B,A01,886457,Staff,68,0,115,47
1746576428835,PHYS 2C,A01,886460,Shotwell; Brian,0,9,65,65
1746576429859,PHYS 2CL,A01,886467,Staff,0,4,28,28
1746576429859,PHYS 2CL,A02,886468,Staff,0,3,28,28
1746576430888,PHYS 2D,A01,886470,Staff,10,0,50,40
1746576431913,PHYS 4B,A01,886475,Grinstein; Benjamin,22,0,40,18
1746576432944,POLI 5,A00,891173,Desposato; Scott,7,0,25,18
1746576433970,POLI 5D,A01,891175,Staff,5,0,5,0
1746576433970,POLI 5D,B01,891178,Staff,5,0,5,0
1746576434996,POLI 11,A00,891179,Ferree; Karen E,2,0,35,33
1746576436026,POLI 12,A00,891180,Staff,16,0,30,14
1746576437054,POLI 27,A01,891182,Staff,12,0,75,63
1746576438086,POLI 30,A00,891183,Staff,8,0,50,42
1746576439116,POLI 100B,A00,891244,Staff,5,1,35,30
1746576440149,POLI 100I,A00,891247,Staff,7,0,30,23
1746576441175,POLI 104J,A00,891248,Nichter; Maysa,14,0,30,16
1746576442202,POLI 104U,A00,891250,Nichter; Maysa,1,0,30,29
1746576444251,POLI 110B,A00,891255,Wiens; David,19,0,25,6
1746576445275,POLI 112A,A00,891256,Wiens; David,6,0,25,19
1746576446300,POLI 114BR,A00,891261,Staff,19,0,30,11
1746576447324,POLI 117R,A00,891262,Forman; Fonna,0,6,50,50
1746576448349,POLI 118,A00,891264,Ingham; Sean,17,0,25,8
1746576449378,POLI 124A,A00,891265,Staff,18,0,20,2
1746576450409,POLI 125D,A00,891266,Nichter; Simeon C,2,0,25,23
1746576451432,POLI 126,A00,891268,Nichter; Simeon C,7,0,25,18
1746576452458,POLI 126AA,A00,891272,Staff,15,0,25,10
1746576453485,POLI 130AA,A00,891273,Staff,15,0,20,5
1746576454519,POLI 134AA,A00,891274,Staff,4,0,20,16
1746576456568,POLI 138,A00,891278,Staff,21,0,25,4
1746576457598,POLI 142K,A00,891280,Staff,10,0,25,15
1746576458626,POLI 142M,A00,891281,Gartzke; Erik,16,0,30,14
1746576459652,POLI 142P,A00,891284,Staff,20,0,30,10
1746576460675,POLI 143,A00,891285,Gartzke; Erik,12,0,30,18
1746576461704,POLI 153,A00,891286,Staff,19,0,20,1
1746576463760,POLI 175,A00,891290,Staff,15,0,20,5
1746576464784,PSYC 1,A00,890674,Steiner; Eric Tomas,0,11,45,45
1746576465810,PSYC 2,A00,890676,Albright; Thomas D,21,0,35,14
1746576466838,PSYC 3,A00,890679,Staff,17,0,20,3
1746576467862,PSYC 6,A00,959858,Staff,20,0,20,0
1746576468886,PSYC 60,A01,890684,Rickard; Timothy C.,0,5,45,45
1746576469912,PSYC 70,A01,890689,Geller; Emma Harlan,7,0,30,23
1746576470940,PSYC 71,A01,959860,Staff,21,0,25,4
1746576471966,PSYC 100,A00,890690,Lacefield; Katharine I,0,50,180,180
1746576472992,PSYC 102,A00,890695,Staff,18,0,40,22
1746576474017,PSYC 105,A00,890699,Geller; Emma Harlan,70,0,100,30
1746576475041,PSYC 106,A00,890701,Gorman; Michael R.,6,0,30,24
1746576476066,PSYC 108,A00,890704,Adrian; Julia Anna,0,28,50,50
1746576477094,PSYC 118,A01,890712,Staff,11,0,30,19
1746576478120,PSYC 124,A00,890716,Chapman; Eddie Nathaniel,25,0,60,35
1746576479143,PSYC 131,A00,890717,Anagnostaras; Stephan,0,8,80,80
1746576480168,PSYC 137,A00,890719,Winkielman; Piotr,0,11,30,30
1746576481192,PSYC 144,A00,890721,Adrian; Julia Anna,0,9,45,45
1746576482220,PSYC 162,A00,890805,Staff,0,0,75,75
1746576483265,PSYC 169,A00,890810,Staff,0,14,30,30
1746576484292,PSYC 172,A00,890814,Gorman; Michael R.,9,0,30,21
1746576485317,PSYC 181,A00,890818,Anagnostaras; Stephan,9,0,200,191
1746576486344,PSYC 184,A00,959861,Staff,167,0,175,8
1746576487368,PSYC 189,A00,890823,Staff,0,2,30,30
1746576488392,PSYC 191,A00,890884,Rickard; Timothy C.,0,12,35,35
1746576489421,PSYC 193,A00,890913,Staff,19,0,30,11
1746576489421,PSYC 193,B00,890914,Chapman; Eddie Nathaniel,24,0,30,6
1746576490446,PSYC 193L,A01,890918,Lowe; Angela Beth,20,0,30,10
1746576490446,PSYC 193L,B01,890921,Hurwitz; Ethan Scott,20,0,30,10
1746576490446,PSYC 193L,C01,890928,Staff,30,0,30,0
1746576491474,RELI 149,A00,886806,Rahimi; Babak,23,0,40,17
1746576492556,SE 9,A01,886814,Staff,7,0,20,13
1746576493580,SE 101B,A01,886816,Chadha; Mayank,4,0,35,31
1746576494608,SE 110B,A00,886818,Zhu; Qiang,4,0,75,71
1746576495633,SE 125,A01,886830,Staff,10,0,30,20
1746576496659,SE 130B,A01,886835,Staff,14,0,40,26
1746576497685,SE 131A,A01,886838,Krysl; Petr,34,0,55,21
1746576498716,SE 154,A00,886840,Staff,29,0,50,21
1746576499742,SE 164GS,A01,886849,Staff,6,0,20,14
1746576500770,SE 167GS,A01,886853,Staff,6,0,20,14
1746576501797,SIO 25,A01,890107,Staff,19,0,30,11
1746576502823,SIO 45,A00,890109,Cook; Geoffrey W,117,0,200,83
1746576503848,SIO 109R,A00,890110,Forman; Fonna,0,16,20,20
1746576504874,SIO 187,A01,890114,Kacev; David,15,0,40,25
1746576505901,SOCI 1,A01,890431,Thorpe; Charles Robert,14,0,30,16
1746576505901,SOCI 1,A02,890518,Thorpe; Charles Robert,30,0,30,0
1746576506927,SOCI 2,A01,957978,Staff,25,0,25,0
1746576506927,SOCI 2,A02,957979,Staff,23,0,25,2
1746576507952,SOCI 20,A01,890523,Calderon-Zaks; Michael Aar,21,0,30,9
1746576507952,SOCI 20,A02,890526,Calderon-Zaks; Michael Aar,29,0,30,1
1746576508981,SOCI 30,A01,890533,Pardo Guerra; Juan Pablo,37,0,40,3
1746576510007,SOCI 40,A01,890535,Staff,27,0,45,18
1746576511037,SOCI 104Q,A00,890559,Staff,18,0,30,12
1746576512066,SOCI 106,A00,890560,Arnal; Maud Marie Leonie,20,0,30,10
1746576513092,SOCI 110,A00,890567,Holkenbrink-Monk; Charlene,19,0,30,11
1746576514121,SOCI 112,A00,890568,Victoria Torres; Pablo,2,0,55,53
1746576515154,SOCI 115,A00,890597,Arnal; Maud Marie Leonie,28,0,45,17
1746576517206,SOCI 121,A00,890604,Pardo Guerra; Juan Pablo,38,0,45,7
1746576518231,SOCI 126,A01,890608,Staff,8,0,10,2
1746576519256,SOCI 127,A00,890609,Staff,18,0,30,12
1746576520281,SOCI 131,A00,890610,Thorpe; Charles Robert,37,0,45,8
1746576521311,SOCI 135,A00,890615,Payne; Christine Anna,13,0,45,32
1746576522341,SOCI 139,A00,890620,Staff,38,0,45,7
1746576523369,SOCI 148E,A00,890622,Calderon-Zaks; Michael Aar,36,0,45,9
1746576524395,SOCI 150,A00,890623,Kohler; Kristopher M.,31,0,45,14
1746576525424,SOCI 157,A00,890625,Jules-Rosette; Bennetta W.,18,0,20,2
1746576526455,SOCI 160,A00,890627,Payne; Christine Anna,21,0,45,24
1746576527482,SYN 1,A00,886855,Fish; Gwendolyn Anne,0,1,0,0
1746576527482,SYN 1,B00,906086,Fish; Gwendolyn Anne,0,2,0,2
1746576528508,SYN 2R,A00,886860,Staff,0,17,15,15
1746576528508,SYN 2R,B00,906106,Atkinson; Arthur Laird,0,16,15,15
1746576529547,SYN 100,A01,886866,Browne; Emily,0,28,20,20
1746576529547,SYN 100,B01,906128,Rock; Martin,0,5,20,20
1746576529547,SYN 100,C01,906140,Deavenport; James Cary,0,3,20,20
1746576529547,SYN 100,D01,907816,Deavenport; James Cary,0,5,20,20
1746576530577,TDAC 1,A00,890286,Walsh; Kim C.,8,0,20,12
1746576531605,TDAC 101,A00,890296,Basso; Beatrice,15,0,20,5
1746576532634,TDDE 131,A00,890297,Staff,47,0,50,3
1746576533664,TDDM 1,A00,890287,Weinberg; Sadie,25,0,30,5
1746576534692,TDGE 11,A00,890288,Fulton; Julia,138,0,200,62
1746576534692,TDGE 11,B00,890289,Castro; Robert Jess,184,0,200,16
1746576535717,TDGE 25,B00,957359,Walsh; Kim C.,5,0,20,15
1746576536743,TDGE 40,A01,890292,Power; Jade Yukana,27,0,30,3
1746576537769,TDGE 124,A00,890298,Havis; Allan,0,1,50,50
1746576538796,TDGE 131R,A00,890299,Burelle; Julie Sara Veronique,15,0,42,27
1746576539821,TDHT 101,A00,890300,Staff,10,0,20,10
1746576540852,TDHT 109,A01,890302,Anderson; Mysia Anyse,31,0,40,9
1746576541881,TDMV 1,A00,890293,Arcidiacono; Kristin,18,0,30,12
1746576542905,TDMV 2,A00,890294,Weinberg; Sadie,23,0,30,7
1746576543941,TDMV 3,A00,957878,Arcidiacono; Kristin,28,0,30,2
1746576545996,TDMV 138,A00,890304,Jun; Grace Shin Hae,25,0,40,15
1746576547057,TDMV 140,A00,890305,Corrales; Joseph Bernales,25,0,30,5
1746576548082,TDMV 142,A00,890307,Caligagan; Tony,32,0,40,8
1746576549112,TDMV 144,A00,890308,Camaya; Michelle Ann,25,0,30,5
1746576550138,TDPW 1,A00,890295,Stein; Deborah Isobel,3,0,20,17
1746576551168,USP 2,A01,890272,Lerner; Amy M,7,0,20,13
1746576552193,USP 3,A01,890274,Staff,12,0,30,18
1746576553224,USP 15,A01,890276,Sun; Feiyang,16,0,30,14
1746576554251,USP 25,A00,890277,Shenkman; Michael Thomas,18,0,25,7
1746576555276,USP 138,A00,890278,Staff,14,0,25,11
1746576556303,USP 143,A00,890279,Staff,22,0,70,48
1746576557329,USP 144,A00,890280,Chowdhury; Muhammed Zohir,16,0,30,14
1746576558358,USP 150,A00,890281,Boomhower; Matthew Charles,4,0,30,26
1746576559387,USP 151,A00,890282,Staff,16,0,20,4
1746576560420,USP 162,A00,890283,Andrews; Abigail Leslie,16,0,20,4
1746576561445,USP 168,A00,920477,Kwak; Nancy,0,0,5,5
1746576562471,USP 181,A00,890284,Staff,3,0,20,17
1746576563502,USP 191A,A00,890285,Staff,12,0,20,8
1746576564530,VIS 101,A00,886512,Staff,26,0,75,49
1746576565556,VIS 103,A00,886513,Cruz; Edwin Teddy,61,0,75,14
1746576566580,VIS 108,A00,886514,Staff,3,0,15,12
1746576567606,VIS 127P,A00,886515,Shen; Kuiyi,81,0,146,65
1746576568630,VIS 149,A00,886516,Yoldas; Pinar,0,0,15,15
1746576569655,VIS 164,A00,886526,Erdmann; Dean,19,0,22,3
1746576570684,VIS 194S,A00,886527,Staff,61,0,75,14
1746576571710,WCWP 10A,C00,886484,Martiniuk; Jill,12,0,15,3
1746576572737,WCWP 10B,A00,886490,Uriarte; Emma,0,0,15,15
1746576572737,WCWP 10B,B00,886491,Dhir; Simrita,9,0,15,6
1746576572737,WCWP 10B,C00,886492,Ornelas; Tricia,0,0,15,15
1746576573762,WCWP 100,A00,886494,Young; Mark T,0,6,15,15
1746576575868,AAS 10,A01,886199,Childs; Dennis R.,0,3,0,0
1746576576893,ANAR 104,A01,886940,Shtienberg; Gilad,27,0,30,3
1746576577919,ANAR 120,A00,886953,Staff,12,0,20,8
1746576578944,ANBI 148,A01,886955,Wilder; Linnea Lorene,30,0,40,10
1746576580996,ANSC 122,A00,886957,Staff,25,0,30,5
1746576582022,ANSC 150,A00,886958,Sloane; Julia Kathryn,2,0,15,13
1746576583048,ANSC 156,A00,886959,Jenkins; Janis A.,0,1,15,15
1746576584074,ANSC 180,A00,886960,Staff,11,0,17,6
1746576585100,ANSC 188,A00,886961,Jassal; Aftab,9,0,25,16
1746576586123,ANSC 190,A00,886962,Jassal; Aftab,14,0,25,11
1746576587148,ANSC 191,A00,886963,Staff,18,0,20,2
1746576588177,ANTH 3,A01,891689,Staff,17,0,20,3
1746576589208,ANTH 5,A00,886933,Semendeferi; Ekaterini,16,0,20,4
1746576590235,ANTH 10,A00,886934,Staff,0,12,30,30
1746576591259,ANTH 21,A01,886936,Staff,41,0,60,19
1746576592291,ANTH 23,A01,886938,Staff,92,0,100,8
1746576593321,ANTH 105,A00,886964,Stewart; Alexander B,84,0,100,16
1746576594351,ANTH 108,A00,886965,Pedersen; David,9,0,20,11
1746576595387,AWP 10,001,886147,Staff,0,0,0,0
1746576595387,AWP 10,002,886148,Staff,0,0,0,0
1746576595387,AWP 10,003,886149,Staff,0,0,0,0
1746576595387,AWP 10,004,886150,Staff,0,0,0,0
1746576595387,AWP 10,005,886151,Staff,0,0,0,0
1746576595387,AWP 10,006,886152,Staff,0,0,0,0
1746576595387,AWP 10,007,886153,Staff,0,0,0,0
1746576595387,AWP 10,008,886154,Staff,0,0,0,0
1746576595387,AWP 10,009,886155,Staff,0,0,0,0
1746576595387,AWP 10,010,886156,Staff,0,0,0,0
1746576595387,AWP 10,011,886158,Staff,0,0,0,0
1746576595387,AWP 10,012,886160,Staff,0,0,0,0
1746576595387,AWP 10,013,886161,Staff,0,0,0,0
1746576595387,AWP 10,014,886162,Staff,0,0,0,0
1746576595387,AWP 10,015,886163,Staff,0,0,0,0
1746576595387,AWP 10,016,886164,Staff,0,0,0,0
1746576595387,AWP 10,017,886165,Staff,0,0,0,0
1746576595387,AWP 10,018,886166,Staff,0,0,0,0
1746576595387,AWP 10,019,886168,Staff,0,0,0,0
1746576595387,AWP 10,020,886170,Staff,0,0,0,0
1746576595387,AWP 10,021,886172,Staff,0,0,0,0
1746576596427,AWP 10R,001,886173,Staff,0,1,0,0
1746576596427,AWP 10R,002,886174,Staff,0,1,0,0
1746576596427,AWP 10R,003,886175,Staff,0,0,0,0
1746576596427,AWP 10R,004,886176,Staff,0,0,0,0
1746576596427,AWP 10R,005,886177,Staff,0,0,0,0
1746576596427,AWP 10R,006,886178,Staff,0,0,0,0
1746576596427,AWP 10R,007,886179,Staff,0,0,0,0
1746576596427,AWP 10R,008,886181,Staff,0,0,0,0
1746576596427,AWP 10R,009,886182,Staff,0,0,0,0
1746576596427,AWP 10R,010,886183,Staff,0,0,0,0
1746576596427,AWP 10R,011,886184,Staff,0,0,0,0
1746576596427,AWP 10R,012,886185,Staff,0,0,0,0
1746576596427,AWP 10R,013,886186,Staff,0,0,0,0
1746576596427,AWP 10R,014,886187,Staff,0,0,0,0
1746576596427,AWP 10R,015,886188,Staff,0,0,0,0
1746576596427,AWP 10R,016,886189,Staff,0,0,0,0
1746576596427,AWP 10R,017,960532,Staff,0,0,0,0
1746576596427,AWP 10R,018,960533,Staff,0,0,0,0
1746576596427,AWP 10R,019,960534,Staff,0,0,0,0
1746576596427,AWP 10R,020,960538,Staff,0,0,0,0
1746576596427,AWP 10R,021,960540,Staff,0,0,0,0
1746576596427,AWP 10R,022,960541,Staff,0,0,0,0
1746576596427,AWP 10R,023,960542,Staff,0,0,0,0
1746576596427,AWP 10R,024,960544,Staff,0,0,0,0
1746576596427,AWP 10R,025,960545,Staff,0,0,0,0
1746576596427,AWP 10R,026,960548,Staff,0,0,0,0
1746576597452,AWP 102R,A00,886190,Staff,0,0,0,0
1746576597452,AWP 102R,B00,886191,Staff,0,0,0,0
1746576598480,BENG 100,A01,886193,Staff,17,0,30,13
1746576599509,BENG 122A,A01,886195,Hasty; Jeff M,13,0,30,17
1746576600553,BENG 166A,A00,886196,Sah; Robert Lie-Yuan,0,2,30,30
1746576601578,BENG 190,A00,958050,Khojah; Reem I,20,0,25,5
1746576602606,BIBC 102,A01,894320,Staff,0,0,46,46
1746576602606,BIBC 102,A02,894321,Staff,0,0,46,46
1746576602606,BIBC 102,A03,894344,Staff,6,0,46,40
1746576602606,BIBC 102,A04,894345,Staff,27,0,47,20
1746576603637,BICD 100R,A01,894365,Smith; Laurie,0,3,58,58
1746576603637,BICD 100R,A02,894366,Smith; Laurie,0,5,58,58
1746576603637,BICD 100R,A03,894367,Smith; Laurie,0,0,59,59
1746576603637,BICD 100R,A04,959869,Smith; Laurie,40,0,59,19
1746576604670,BICD 136,A01,894383,Gustafson-Brown; Cindy,14,0,50,36
1746576605696,BIEB 102,A01,894494,Butler; Shannon Rhey,51,0,130,79
1746576607758,BIEB 150,A01,894617,Wills; Christopher,3,0,20,17
1746576607758,BIEB 150,A02,894631,Wills; Christopher,3,0,20,17
1746576607758,BIEB 150,A03,894937,Wills; Christopher,3,0,20,17
1746576607758,BIEB 150,A04,894946,Wills; Christopher,5,0,20,15
1746576608786,BIEB 194,A00,906141,Kurle; Carolyn M.,6,0,20,14
1746576609812,BILD 1,A01,894154,Staff,3,0,19,16
1746576609812,BILD 1,A02,894155,Staff,14,0,19,5
1746576609812,BILD 1,A03,894160,Staff,13,0,19,6
1746576609812,BILD 1,A04,894161,Staff,15,0,18,3
1746576610844,BILD 2,A01,894168,Staff,0,0,50,50
1746576610844,BILD 2,A02,894169,Staff,0,0,50,50
1746576610844,BILD 2,A03,894179,Staff,0,0,50,50
1746576610844,BILD 2,A04,894203,Staff,24,0,50,26
1746576611869,BILD 3,A01,894213,Staff,23,0,31,8
1746576611869,BILD 3,A02,894214,Staff,26,0,31,5
1746576611869,BILD 3,A03,894235,Staff,28,0,31,3
1746576611869,BILD 3,A04,894236,Staff,28,0,32,4
1746576612897,BILD 4,A01,894253,Reuther; Keefe,5,0,24,19
1746576612897,BILD 4,A02,894258,Reuther; Keefe,16,0,24,8
1746576613923,BILD 5,A01,894276,Reuther; Keefe,35,0,50,15
1746576613923,BILD 5,A02,894277,Reuther; Keefe,45,0,50,5
1746576613923,BILD 5,A03,894290,Reuther; Keefe,44,0,50,6
1746576613923,BILD 5,A04,894291,Reuther; Keefe,48,0,50,2
1746576614954,BILD 24,A01,894297,Pirino; Giorgia,40,0,60,20
1746576615981,BIMM 100,B01,958915,Staff,71,0,100,29
1746576617014,BIMM 101,A01,895017,McDonnell; Lisa Marie,0,5,24,24
1746576617014,BIMM 101,A02,895018,McDonnell; Lisa Marie,0,5,24,24
1746576617014,BIMM 101,B01,895020,McDonnell; Lisa Marie,0,6,24,24
1746576617014,BIMM 101,B02,895021,McDonnell; Lisa Marie,0,4,24,24
1746576618042,BIMM 110,A01,895023,Staff,1,0,25,24
1746576618042,BIMM 110,A02,895024,Staff,9,0,25,16
1746576618042,BIMM 110,A03,895025,Staff,18,0,25,7
1746576618042,BIMM 110,A04,895031,Staff,20,0,25,5
1746576619067,BIMM 120,A01,895114,Gustafson-Brown; Cindy,14,0,28,14
1746576619067,BIMM 120,A02,895126,Gustafson-Brown; Cindy,21,0,27,6
1746576620092,BIPN 100,A01,895130,Yang; Mingyu,0,0,38,38
1746576620092,BIPN 100,A02,895131,Yang; Mingyu,32,0,38,6
1746576620092,BIPN 100,A03,895132,Yang; Mingyu,32,0,38,6
1746576620092,BIPN 100,A04,895133,Yang; Mingyu,27,0,36,9
1746576621122,BIPN 120,A01,895135,Cooke; James Edward,0,3,13,13
1746576621122,BIPN 120,A02,895136,Cooke; James Edward,0,1,13,13
1746576621122,BIPN 120,A03,895137,Cooke; James Edward,0,3,13,13
1746576621122,BIPN 120,A04,895156,Cooke; James Edward,0,2,11,11
1746576622155,BIPN 134,A01,895235,Cooke; James Edward,0,2,25,25
1746576622155,BIPN 134,A02,895237,Cooke; James Edward,0,0,25,25
1746576622155,BIPN 134,A03,895240,Cooke; James Edward,3,0,25,22
1746576622155,BIPN 134,A04,895270,Cooke; James Edward,20,0,25,5
1746576623181,BIPN 189,A00,892103,Staff,0,14,14,14
1746576625237,BISP 194,A00,958008,Staff,0,2,0,0
1746576626263,CAT 124,A01,922009,Staff,0,5,20,20
1746576627303,CAT 125R,A00,886390,Morales; Celeste Georgianna,0,2,20,20
1746576627303,CAT 125R,B00,886391,Irwin; Matthew Joseph,0,4,20,20
1746576627303,CAT 125R,C00,886392,Smith; Lauryn Alissa,0,2,20,20
1746576627303,CAT 125R,D00,886393,Vanderschuit; Maya Alysia,0,3,20,20
1746576627303,CAT 125R,E00,886394,Marchisotto; Jennifer Anne,0,3,20,20
1746576628328,CENG 15,A01,886218,Drews; Aaron,3,0,8,5
1746576629355,CENG 113,A00,886219,Opatkiewicz; Justin Paul,15,0,25,10
1746576630596,CGS 101,A00,887044,Staff,7,0,20,13
1746576631620,CGS 105,A01,887046,Staff,14,0,25,11
1746576632649,CGS 112,A00,887047,Cuong; Marisol,12,0,15,3
1746576633673,CGS 113,A00,887048,Staff,23,0,30,7
1746576634701,CGS 120,A00,887049,Staff,10,0,17,7
1746576635730,CHEM 6A,A01,886336,Lam; Tin Yiu,38,0,50,12
1746576635730,CHEM 6A,A02,886338,Lam; Tin Yiu,37,0,50,13
1746576636757,CHEM 6B,A01,886341,Hopkins; Patrycja Anna,16,0,50,34
1746576636757,CHEM 6B,A02,886343,Hopkins; Patrycja Anna,42,0,50,8
1746576637788,CHEM 6C,A01,886346,Albizati; Kim F.,0,2,50,50
1746576637788,CHEM 6C,A02,886348,Albizati; Kim F.,23,0,50,27
1746576638816,CHEM 40A,A01,886352,Klosterman; Jeremy K,65,0,100,35
1746576639842,CHEM 40B,A01,886356,Klosterman; Jeremy K,0,23,100,100
1746576640866,CHEM 41B,A01,886360,Theodorakis; Emmanuel,25,0,50,25
1746576640866,CHEM 41B,A02,886362,Theodorakis; Emmanuel,47,0,50,3
1746576641891,CHIN 165A,A00,886382,Xu; Li,18,0,20,2
1746576642920,CLAS 120,A00,886387,Myerston Santana; Jacobo,33,0,40,7
1746576643950,COGS 9,A01,886967,Shannon; Kyle Michael,42,0,60,18
1746576645031,COGS 11,A01,886969,Staff,9,0,30,21
1746576646061,COGS 14A,A01,886971,Staff,6,0,60,54
1746576647093,COGS 14B,A01,886973,Hoffman; Drew Ellen,4,0,60,56
1746576648117,COGS 18,A01,886975,Morgan; Eric,35,0,60,25
1746576649147,COGS 20,A01,886977,Staff,4,0,8,4
1746576649147,COGS 20,A02,886978,Staff,5,0,7,2
1746576650174,COGS 100,A01,907783,Staff,1,2,30,29
1746576651199,COGS 101B,A01,886980,Staff,0,3,48,48
1746576652225,COGS 101C,A01,886982,Delgado; Tania,0,5,44,44
1746576653253,COGS 102A,A01,886984,Johnson; Christine M.,4,0,30,26
1746576654282,COGS 118B,A01,886986,Staff,1,4,88,87
1746576655308,COGS 150,A01,886988,Bergen; Benjamin,22,0,50,28
1746576656335,COGS 153,A00,886989,Delgado; Tania,0,2,41,41
1746576657364,COGS 186,A01,886991,Staff,0,0,32,32
1746576658389,COGS 187A,A01,886993,Boyle; Mary E. T.,7,0,30,23
1746576659414,COGS 189,A00,886994,Staff,0,1,30,30
1746576660442,COMM 10,A01,886996,Staff,0,0,20,21
1746576660442,COMM 10,A02,886997,Staff,11,0,20,9
1746576660442,COMM 10,A03,959845,Staff,19,0,20,1
1746576661475,COMM 20,A01,886999,Leuning; Grant Maurstad,24,0,40,16
1746576663528,COMM 100A,A01,887002,Staff,0,0,20,25
1746576663528,COMM 100A,A02,887003,Staff,6,0,20,14
1746576664553,COMM 100B,A01,887005,Staff,0,8,20,24
1746576665577,COMM 106D,A00,887006,Staff,13,0,40,27
1746576666606,COMM 110G,A00,887007,Whitworth-Smith; Andrew C,12,0,40,28
1746576667632,COMM 111B,A00,887008,Staff,31,0,40,9
1746576668665,COMM 113T,A00,887009,Abuelhiga; Soraya Jill,28,0,40,12
1746576668665,COMM 113T,B00,906733,Staff,40,0,40,0
1746576669691,COMM 145,A00,887010,Staff,12,0,40,28
1746576670716,COMM 146,A00,887054,Staff,31,0,40,9
1746576671747,COMM 190,A00,887012,Staff,8,0,23,15
1746576672776,CSE 8A,A50,887015,Cao; Yingjun,57,0,85,28
1746576673802,CSE 11,A01,887017,Cao; Yingjun,12,0,70,58
1746576674834,CSE 20,A01,887019,Staff,30,0,50,20
1746576675868,CSE 21,A01,887021,Staff,78,0,100,22
1746576675868,CSE 21,B01,892583,Braun; Oliver,45,0,50,5
1746576676894,CSE 30,A01,887025,Eldon; John,143,0,200,57
1746576677920,CSE 100,A01,887027,Staff,26,0,50,24
1746576677920,CSE 100,A02,887028,Staff,42,0,50,8
1746576678951,CSE 101,A01,887030,Braun; Oliver,74,0,100,26
1746576678951,CSE 101,B01,887032,Jones; Miles E,0,3,50,50
1746576678951,CSE 101,B02,887033,Jones; Miles E,0,2,50,50
1746576679977,CSE 105,A01,908084,Jones; Miles E,32,0,50,18
1746576679977,CSE 105,A02,908087,Jones; Miles E,31,0,50,19
1746576681004,CSE 135,A01,887035,Powell; Thomas Allan,0,5,50,50
1746576682035,CSE 142,A01,887037,Staff,8,0,60,52
1746576683061,CSE 142L,A01,887039,Staff,34,0,60,26
1746576684088,CSE 151A,A01,887041,Solares; Edwin A,47,0,100,53
1746576685115,CSE 175,A01,887043,Kumar; Rakesh,30,0,30,0
1746576686144,CSS 1,A01,886389,Staff,1,1,40,39
1746576687169,DSC 30,A01,908097,Liao; Soohyun Nam,47,0,75,28
1746576688195,DSC 40A,A01,908099,Shannon; Kyle Michael,30,0,50,20
1746576689220,DSC 40B,A01,908112,Staff,15,0,50,35
1746576690250,DSC 80,A01,908116,Staff,19,0,60,41
1746576691275,DSC 197,001,956863,Eldridge; Justin Matthew,9999,0,9999,0
1746576692307,ECE 5,A01,886400,Morris; Karcher William,1,0,6,5
1746576692307,ECE 5,A02,886401,Morris; Karcher William,3,0,6,3
1746576693334,ECE 148,A01,886403,Silberman; Jack,0,14,14,14
1746576694358,ECON 1,A01,887265,Crane; Meredith Helen,12,0,70,58
1746576694358,ECON 1,B01,887268,Staff,42,0,50,8
1746576695387,ECON 2,A01,887273,Crane; Meredith Helen,55,0,70,15
1746576696413,ECON 3,A01,887279,Rondina; Giacomo,32,0,70,38
1746576697437,ECON 4,A01,887282,Anderson; John Charles,0,2,10,10
1746576698467,ECON 5,A01,887285,Staff,34,0,45,11
1746576698467,ECON 5,B01,887292,Staff,41,0,45,4
1746576699494,ECON 100A,A01,887337,Newhouse; Herbert S,54,0,70,16
1746576699494,ECON 100A,B01,887349,Staff,45,0,50,5
1746576700520,ECON 100B,A01,887361,Du; Songzi,29,0,70,41
1746576701546,ECON 100C,A01,887445,Newhouse; Herbert S,59,0,70,11
1746576702574,ECON 105,A00,887488,Vespa; Emanuel Ignacio,23,0,35,12
1746576703605,ECON 109,A01,887506,Shishkin; Denis,28,0,35,7
1746576704636,ECON 110A,A01,887568,Alon; Titan Michael,0,3,35,35
1746576704636,ECON 110A,B01,907601,Alon; Titan Michael,20,0,35,15
1746576705662,ECON 110B,A01,887598,Levkoff; Steven B.,0,24,70,70
1746576706687,ECON 112,A00,887599,Rondina; Giacomo,19,0,35,16
1746576707715,ECON 120A,A01,887603,Dai; Yinlin,35,0,70,35
1746576708742,ECON 120C,A01,887608,Sun; Yixiao,0,1,35,35
1746576708742,ECON 120C,B01,887614,Sun; Yixiao,0,0,35,35
1746576709769,ECON 138,A00,887621,Bharadwaj; Prashant,0,21,20,20
1746576710798,ECON 144,A00,958007,Squires; Dale E,12,0,35,23
1746576711827,ECON 171,A01,907666,Staff,18,0,35,17
1746576712854,ECON 175,A00,887626,Wu; Pak Yeung,22,0,35,13
1746576713878,ECON 190,A00,887640,Vespa; Emanuel Ignacio,22,0,35,13
1746576714917,EDS 25,A01,888197,Staff,0,0,0,0
1746576714917,EDS 25,A02,888209,Staff,0,0,0,0
1746576714917,EDS 25,A03,888210,Staff,0,0,0,0
1746576714917,EDS 25,A04,888212,Staff,0,0,0,0
1746576714917,EDS 25,A05,888213,Staff,0,0,0,0
1746576714917,EDS 25,A06,888214,Staff,0,0,0,0
1746576714917,EDS 25,A07,888235,Staff,0,2,0,0
1746576714917,EDS 25,A08,888236,Staff,0,0,0,0
1746576714917,EDS 25,A09,888240,Staff,0,0,0,0
1746576714917,EDS 25,A10,888244,Staff,0,0,0,0
1746576714917,EDS 25,B01,888273,Staff,0,0,0,0
1746576714917,EDS 25,B02,888285,Staff,0,0,0,0
1746576714917,EDS 25,B03,888423,Staff,0,0,0,1
1746576714917,EDS 25,B04,888432,Staff,0,0,0,0
1746576714917,EDS 25,B05,888433,Staff,0,0,0,0
1746576714917,EDS 25,B06,888467,Staff,0,0,0,0
1746576714917,EDS 25,B07,888468,Staff,0,0,0,0
1746576714917,EDS 25,B08,888479,Staff,0,0,0,0
1746576714917,EDS 25,B09,888484,Staff,0,0,0,0
1746576714917,EDS 25,B10,888487,Staff,0,0,0,0
1746576715941,EDS 38,A01,907700,Choi; Bailey Miyeon,30,0,30,0
1746576716974,EDS 112,A01,888601,Chapman; Thandeka K,12,0,40,28
1746576717999,EDS 115,A00,888697,Mendez; Kathrina Mendoza,10,0,30,20
1746576719026,EDS 116,A01,888893,Staff,34,0,40,6
1746576721078,EDS 124AR,A00,889133,Staff,29,0,50,21
1746576721078,EDS 124AR,B00,907471,Simon; Elizabeth A,37,0,50,13
1746576722107,EDS 124BR,A00,889134,Simon; Elizabeth A,44,0,100,56
1746576723132,EDS 125,A00,889135,Staff,25,0,30,5
1746576724158,EDS 126,A01,889138,Staff,35,0,40,5
1746576725183,EDS 164R,A01,889142,Wishard Guerra; Alison G.,33,0,50,17
1746576726209,ENG 30,A01,886396,Staff,0,0,0,0
1746576726209,ENG 30,B01,886398,Staff,0,0,0,0
1746576727236,ENVR 102,A00,906150,Montejo; Carolina,23,0,25,2
1746576728260,ETHN 103A,A00,887236,Man; Simeon S,0,3,0,0
1746576729292,ETHN 113,A00,887239,Staff,16,0,30,14
1746576730317,ETHN 116,A00,887240,Staff,16,0,25,9
1746576731342,ETHN 117,A00,887241,Choi; Esther Min,28,0,30,2
1746576732370,ETHN 118,A00,887243,Staff,24,0,30,6
1746576733395,ETHN 127,A00,887248,Cuong; Marisol,11,0,15,4
1746576734421,ETHN 139,A00,887250,Staff,7,0,10,3
1746576735447,ETHN 142,A00,887252,Staff,10,0,30,20
1746576736480,ETHN 161,A00,887253,Browne; Errol Tsekani,24,0,30,6
1746576737511,ETHN 163FR,A00,887255,Burelle; Julie Sara Veronique,0,0,5,5
1746576738544,GLBH 20,A00,889149,Elwardani; Nile Regina,8,0,42,34
1746576740602,GLBH 111,A01,889152,Burgos; Jose L.,17,0,17,0
1746576741634,GLBH 150,A00,889181,Sloane; Julia Kathryn,0,5,15,15
1746576743692,HDS 60,A01,886406,Warstadt; Melissa Fawn,73,0,80,7
1746576744718,HIAF 111,A00,889324,Gyamfi; Bright,25,0,32,7
1746576745743,HIEA 131,A00,889328,Staff,15,0,32,17
1746576746773,HIEA 144,A00,889333,Henry; Todd A.,26,0,32,6
1746576747799,HIEA 154,A00,889336,Henry; Todd A.,24,0,32,8
1746576748827,HIEU 106,A00,889339,Staff,22,0,32,10
1746576750880,HIEU 114,A00,889340,Staff,4,0,32,28
1746576751907,HIEU 135GS,A00,889342,Patterson; Patrick H.,0,0,1,24
1746576752939,HIEU 137,A00,889343,Edington; Claire Ellen,10,0,25,15
1746576753966,HIEU 148,A00,889345,Staff,14,0,32,18
1746576754997,HIEU 154,A00,889346,Biess; Frank Peter,21,0,32,11
1746576756024,HILA 102,A00,889351,Staff,12,0,32,20
1746576757049,HILD 2A,A01,889221,Lewandoski; Julia Mavis,1,10,32,31
1746576758079,HILD 7B,A01,889225,Man; Simeon S,0,12,32,32
1746576759104,HILD 7C,A01,889288,Alvarez; Luis A,0,14,32,32
1746576760133,HILD 30,A01,889323,Staff,0,5,32,32
1746576762184,HISC 119,A00,889383,Golan; Tal,19,0,32,13
1746576763213,HIUS 103,A00,889384,Man; Simeon S,0,0,32,32
1746576764240,HIUS 117,A00,919797,Kwak; Nancy,19,0,32,13
1746576765266,HIUS 142A,A00,919788,Staff,22,0,32,10
1746576767321,HIUS 149,A00,889386,Gyamfi; Bright,26,0,32,6
1746576768345,HIUS 155,A00,889387,Alvarez; Luis A,15,0,32,17
1746576769372,HUM 3,A01,886499,Caldwell; Michael Alan,19,0,50,31
1746576770400,HUM 3GS,A00,886500,Rodriguez; Bretton Sigfred,0,0,0,28
1746576771426,HUM 3R,A01,886502,Markman; Kristina,0,36,50,50
1746576772455,HUM 4,A01,886504,Crum; Matthew Stephen,23,0,50,27
1746576772455,HUM 4,B01,886506,West; Geoffrey Scott,17,0,50,33
1746576773483,HUM 4GS,A00,886507,Staff,0,0,0,19
1746576774508,HUM 5,A01,886509,Staff,32,0,50,18
1746576775534,HUM 5R,A01,886511,Zavodny; Tatiana Sophia,0,39,50,50
1746576776559,JAPN 180,A00,886407,Staff,16,0,40,24
1746576777585,LATI 50,A01,886409,Martin-Cabrera; Luis,4,0,22,18
1746576777585,LATI 50,A02,886410,Martin-Cabrera; Luis,19,0,22,3
1746576777585,LATI 50,A03,886411,Martin-Cabrera; Luis,21,0,22,1
1746576777585,LATI 50,A04,886412,Martin-Cabrera; Luis,9,0,22,13
1746576778611,LAWS 101,A00,907664,Staff,28,0,60,32
1746576779637,LIAB 1A,A00,889388,Saab; Dima,17,0,20,3
1746576780668,LIAB 1AX,A00,889389,El Cheddadi; Youniss,18,0,20,2
1746576781693,LIFR 1C,A00,889391,Van Moer; Vinciane G,8,0,20,12
1746576782724,LIFR 1CX,A00,889392,Van Moer; Vinciane G,7,0,20,13
1746576783749,LIFR 1D,A00,889393,Van Moer; Vinciane G,7,0,20,13
1746576784777,LIFR 1DX,A00,889394,Van Moer; Vinciane G,8,0,20,12
1746576785803,LIGN 7,A00,886923,Staff,24,0,50,26
1746576786829,LIGN 17,A00,886924,Kehler; Andrew Scott,125,0,150,25
1746576787857,LTAM 110,A00,889395,Staff,15,0,30,15
1746576788926,LTAM 110GS,A00,958010,Rodriguez; Bretton Sigfred,0,0,0,28
1746576789951,LTCH 101,A00,889397,Staff,23,0,25,2
1746576790979,LTCS 130,A00,889398,Staff,23,0,25,2
1746576792005,LTEA 138,A00,889399,Staff,24,0,40,16
1746576793031,LTEN 149,A00,889400,Wesling; Megan E.,0,3,25,25
1746576794059,LTEN 169,A00,889401,Staff,20,0,25,5
1746576795085,LTEN 180,A00,889402,Staff,10,0,15,5
1746576796111,LTEN 181,A00,889403,Staff,21,0,25,4
1746576797143,LTWL 100,A00,889404,Myerston Santana; Jacobo,2,0,25,23
1746576798172,LTWL 180GS,A00,889405,Staff,0,0,20,20
1746576799202,LTWL 181,A00,889406,Staff,16,0,25,9
1746576800230,LTWL 184,A00,889475,Mukherjee; Silpa,22,0,25,3
1746576801259,LTWR 102C,A00,889486,Staff,29,0,30,1
1746576802286,LTWR 115W,A00,889491,Staff,0,2,15,15
1746576803316,MAE 8,A01,886905,Staff,0,2,0,0
1746576804346,MAE 11,A00,886906,Bandaru; Prabhakar,0,7,50,50
1746576805372,MAE 20,A00,886907,Evdokimenko; Ekaterina,43,0,70,27
1746576806397,MAE 30B,A00,886909,Ghazinejad; Maziar,26,0,45,19
1746576807428,MAE 101B,A00,886910,Saintillan; David,29,0,45,16
1746576808454,MAE 105,A00,886911,Bandaru; Prabhakar,18,0,50,32
1746576809481,MAE 107,B00,958024,Staff,8,0,50,42
1746576810512,MAE 143B,A00,886913,Bewley; Thomas R,4,0,40,36
1746576811539,MAE 148,A01,886915,Silberman; Jack,0,3,14,14
1746576812564,MAE 160,A00,886916,Evdokimenko; Ekaterina,31,0,60,29
1746576813592,MATH 3C,A01,889681,Staff,0,2,30,30
1746576813592,MATH 3C,A02,960048,Staff,24,0,30,6
1746576814616,MATH 10A,A01,889760,Staff,26,0,30,4
1746576814616,MATH 10A,A02,889783,Staff,29,0,30,1
1746576815647,MATH 10B,A01,889785,Verstraete; Jacques Allan,2,0,35,33
1746576815647,MATH 10B,A02,889795,Verstraete; Jacques Allan,4,0,35,31
1746576815647,MATH 10B,B01,889797,Verstraete; Jacques Allan,3,0,35,32
1746576815647,MATH 10B,B02,889828,Verstraete; Jacques Allan,3,0,35,32
1746576816676,MATH 10C,A01,889849,Habib; Yousaf,7,0,30,23
1746576816676,MATH 10C,A02,889852,Habib; Yousaf,14,0,30,16
1746576816676,MATH 10C,A03,889853,Habib; Yousaf,22,0,30,8
1746576816676,MATH 10C,A04,889858,Habib; Yousaf,20,0,30,10
1746576816676,MATH 10C,B01,889861,Staff,1,0,30,29
1746576816676,MATH 10C,B02,889862,Staff,24,0,30,6
1746576816676,MATH 10C,B03,889863,Staff,27,0,30,3
1746576816676,MATH 10C,B04,889967,Staff,23,0,30,7
1746576817709,MATH 18,A01,889974,Staff,7,0,30,23
1746576817709,MATH 18,A02,889977,Staff,20,0,30,10
1746576817709,MATH 18,B01,889984,Hardiman; Liam,21,0,30,9
1746576817709,MATH 18,B02,889985,Hardiman; Liam,25,0,30,5
1746576818736,MATH 20A,A01,889990,Suk; Andrew Hoon,30,0,35,5
1746576819763,MATH 20B,A01,889993,Ohm; Ko Woon,22,0,30,8
1746576819763,MATH 20B,A02,889994,Ohm; Ko Woon,30,0,30,0
1746576819763,MATH 20B,B01,889996,Ohm; Ko Woon,22,0,30,8
1746576819763,MATH 20B,B02,889997,Ohm; Ko Woon,23,0,30,7
1746576820797,MATH 20C,A01,889999,Hammock; Frances H,17,0,30,13
1746576820797,MATH 20C,A02,890003,Hammock; Frances H,23,0,30,7
1746576820797,MATH 20C,B01,890006,Hammock; Frances H,3,0,30,27
1746576820797,MATH 20C,B02,890007,Hammock; Frances H,12,0,30,18
1746576821830,MATH 20D,A01,890011,Cheng; Hsiao-Bing,1,1,30,29
1746576821830,MATH 20D,A02,890012,Cheng; Hsiao-Bing,14,0,30,16
1746576821830,MATH 20D,B01,890016,Cheng; Hsiao-Bing,13,0,30,17
1746576821830,MATH 20D,B02,890017,Cheng; Hsiao-Bing,13,0,30,17
1746576822864,MATH 20E,A01,890026,Harel; Guershon,1,0,30,29
1746576822864,MATH 20E,A02,890029,Harel; Guershon,23,0,30,7
1746576822864,MATH 20E,B01,890033,Harel; Guershon,7,0,30,23
1746576822864,MATH 20E,B02,890101,Harel; Guershon,21,0,30,9
1746576823892,MATH 102,A01,890104,Staff,17,0,30,13
1746576823892,MATH 102,A02,890105,Staff,27,0,30,3
1746576824918,MATH 103B,A01,890116,Salehi Golsefidy; Alireza,3,0,30,27
1746576824918,MATH 103B,B01,890118,Staff,0,3,34,34
1746576825950,MATH 109,A01,890121,Aliabadi Sr.; Mohsen,1,0,30,29
1746576825950,MATH 109,B01,890124,Upadrashta; Pranav Kumar,18,0,30,12
1746576826977,MATH 120A,A01,890126,Eggers; John Dietrich,13,0,30,17
1746576828002,MATH 142B,A01,890128,Ioana; Adrian,19,0,30,11
1746576828002,MATH 142B,A02,890129,Ioana; Adrian,13,0,30,17
1746576829031,MATH 154,A01,890174,Staff,0,0,30,30
1746576829031,MATH 154,A02,890182,Staff,0,0,30,30
1746576830057,MATH 168A,A01,890197,Dumitriu; Ioana,21,0,35,14
1746576831084,MATH 170A,A01,890240,Nie; Jiawang,1,0,30,29
1746576831084,MATH 170A,A02,890241,Nie; Jiawang,11,0,30,19
1746576831084,MATH 170A,A03,890249,Nie; Jiawang,23,0,30,7
1746576832111,MATH 170B,A01,957891,Nag; Panchali,13,0,35,22
1746576834171,MATH 181A,A01,908025,Staff,0,3,35,35
1746576834171,MATH 181A,A02,960115,Staff,26,0,35,9
1746576835197,MATH 181B,A01,959874,Staff,25,0,30,5
1746576836224,MATH 193B,A01,890265,Staff,0,4,35,35
1746576837253,MGT 4,A01,890311,Anderson; John Charles,42,0,88,46
1746576838278,MGT 5,A00,907740,Staff,13,0,98,85
1746576839309,MGT 12,A00,890312,Lindenberger; Wade Douglas,67,0,98,31
1746576840338,MGT 16,A00,957883,Staff,78,0,98,20
1746576842412,MGT 45,A00,890314,Pecore; Joseph P.,45,0,98,53
1746576843436,MGT 71,A00,890315,Staff,0,11,98,98
1746576844467,MGT 100,A00,890316,Yavorsky; Daniel Ryan,44,0,98,54
1746576845495,MGT 103,A00,890317,Ehrich; Kristine R,73,0,98,25
1746576846522,MGT 105,A00,890356,Bates; Kenneth Walter,0,8,98,98
1746576847552,MGT 112,A00,890360,Ehrich; Kristine R,55,0,98,43
1746576848577,MGT 127R,A00,907732,Zhu; Kevin Xiaoguo,23,0,98,75
1746576849604,MGT 131B,A00,890361,Anderson; John Charles,59,0,98,39
1746576850631,MGT 137,A00,890362,Lindenberger; Wade Douglas,65,0,98,33
1746576851657,MGT 160,A00,890369,Johnson; Erik Barry,9,0,98,89
1746576853718,MGT 164,A00,890372,Zimmermann; Carsten,0,40,98,98
1746576854743,MGT 180,A00,890374,Bliss; Barbara Ann,12,0,98,86
1746576855770,MMW 15,A01,886414,Chang; Edmond Yi-Teh,0,12,28,28
1746576855770,MMW 15,A02,886415,Chang; Edmond Yi-Teh,0,8,28,28
1746576855770,MMW 15,A03,886416,Chang; Edmond Yi-Teh,0,9,28,28
1746576855770,MMW 15,A04,886417,Chang; Edmond Yi-Teh,0,8,28,28
1746576855770,MMW 15,B01,886419,Chang; Edmond Yi-Teh,0,7,28,28
1746576855770,MMW 15,B02,886420,Chang; Edmond Yi-Teh,0,8,28,28
1746576855770,MMW 15,B03,886421,Chang; Edmond Yi-Teh,0,7,28,28
1746576855770,MMW 15,B04,886422,Chang; Edmond Yi-Teh,0,8,28,28
1746576855770,MMW 15,C01,886424,Staff,0,9,28,28
1746576855770,MMW 15,C02,886425,Staff,0,8,28,28
1746576855770,MMW 15,C03,886426,Staff,0,8,28,28
1746576855770,MMW 15,C04,886427,Staff,0,8,28,28
1746576855770,MMW 15,C05,958038,Staff,0,8,28,28
1746576855770,MMW 15,C06,958039,Staff,1,8,28,27
1746576856800,MMW 15GS,A00,906910,Patterson; Patrick H.,4,0,28,24
1746576857831,MMW 122R,A01,886429,Rahimi; Babak,0,13,28,28
1746576857831,MMW 122R,A02,886430,Rahimi; Babak,0,12,28,28
1746576857831,MMW 122R,A03,958040,Rahimi; Babak,0,11,28,28
1746576858858,MUS 1A,A01,890937,Staff,2,0,25,23
1746576858858,MUS 1A,A02,891035,Staff,6,0,25,19
1746576858858,MUS 1A,C01,958912,Staff,24,0,25,1
1746576858858,MUS 1A,C02,958913,Staff,25,0,25,0
1746576860915,MUS 2AK,A00,957092,Ohnishi; Takae,15,0,15,0
1746576861947,MUS 4,A01,891044,Staff,1,0,25,24
1746576861947,MUS 4,A02,891045,Staff,23,0,25,2
1746576861947,MUS 4,B01,891048,Staff,17,0,25,8
1746576861947,MUS 4,B02,891050,Staff,25,0,25,0
1746576862974,MUS 5,A01,957506,Dubnov; Shlomo,0,0,25,25
1746576862974,MUS 5,A02,957622,Dubnov; Shlomo,13,0,25,12
1746576862974,MUS 5,A03,957623,Dubnov; Shlomo,20,0,25,5
1746576863999,MUS 6,A01,891053,Freitas Caetano; Marcelo,24,0,25,1
1746576863999,MUS 6,A02,891054,Freitas Caetano; Marcelo,23,0,25,2
1746576865023,MUS 7,A01,891081,Staff,1,0,25,24
1746576865023,MUS 7,A02,891082,Staff,3,0,25,22
1746576866053,MUS 8GS,A00,891118,Borgo; David Garcia,1,0,25,24
1746576867080,MUS 11,A01,891140,Staff,9,0,25,16
1746576867080,MUS 11,A02,891141,Staff,22,0,25,3
1746576868106,MUS 13,A01,891143,Staff,8,0,25,17
1746576868106,MUS 13,A02,891144,Staff,24,0,25,1
1746576869133,MUS 15,A01,891146,Staff,9,0,25,16
1746576869133,MUS 15,A02,891148,Staff,21,0,25,4
1746576869133,MUS 15,B01,891150,Staff,18,0,25,7
1746576869133,MUS 15,B02,891151,Staff,25,0,25,0
1746576870158,MUS 20,A01,891153,Staff,5,0,20,15
1746576870158,MUS 20,A02,891155,Staff,14,0,20,6
1746576871183,MUS 80,A00,891156,Staff,19,0,25,6
1746576871183,MUS 80,B00,891157,Staff,23,0,25,2
1746576872209,MUS 130,A00,891158,Ohnishi; Takae,35,0,35,0
1746576873232,MUS 150GS,A01,891160,Borgo; David Garcia,1,0,25,24
1746576874263,MUS 170,A01,891162,Freitas Caetano; Marcelo,20,0,25,5
1746576874263,MUS 170,A02,891164,Freitas Caetano; Marcelo,21,0,25,4
1746576875294,NANO 11,A00,886220,Vazquez Mena; Oscar,13,0,15,2
1746576876323,NANO 15,A01,886222,Drews; Aaron,4,0,7,3
1746576877348,NANO 104,A00,886224,Sirbuly; Donald,17,0,25,8
1746576878375,PH 40,A00,886528,Staff,24,0,40,16
1746576879400,PH 45,A01,886799,Staff,35,0,40,5
1746576880425,PH 110,A00,886802,Staff,0,7,40,40
1746576881453,PH 172,A00,906716,Staff,19,0,35,16
1746576882482,PH 191,A00,886803,Staff,6,0,40,34
1746576883513,PHIL 1,A00,889500,Staff,20,0,30,10
1746576884539,PHIL 10,A01,889549,Grush; Rick Scott,16,0,22,6
1746576884539,PHIL 10,A02,889551,Grush; Rick Scott,22,0,22,0
1746576885563,PHIL 28,A01,889559,Lamey; Andy M.,0,2,31,31
1746576885563,PHIL 28,A02,889561,Lamey; Andy M.,0,1,30,30
1746576885563,PHIL 28,A03,889572,Lamey; Andy M.,0,1,30,30
1746576886592,PHIL 35,A00,907839,Staff,13,0,15,2
1746576887617,PHIL 60,A00,889574,Staff,73,0,90,17
1746576888644,PHIL 101,A00,958004,Staff,12,0,15,3
1746576890702,PHIL 136,A00,889582,Fulkerson; Matthew Todd,26,0,45,19
1746576891732,PHIL 163,A01,889601,Staff,21,0,30,9
1746576891732,PHIL 163,B01,889606,Brandt; Reuven A,0,3,0,0
1746576892795,PHIL 164,A00,889610,Staff,16,0,30,14
1746576893825,PHIL 165,A00,889613,Staff,22,0,30,8
1746576894855,PHYS 1A,A00,886431,Staff,27,0,70,43
1746576895881,PHYS 1AL,001,886432,Tsai; Philbert S,1,2,30,29
1746576895881,PHYS 1AL,002,886436,Tsai; Philbert S,11,0,30,19
1746576896910,PHYS 1B,A00,886439,Staff,185,0,240,55
1746576897938,PHYS 1BL,001,886441,Tsai; Philbert S,0,4,30,30
1746576897938,PHYS 1BL,002,886444,Tsai; Philbert S,2,0,30,28
1746576898964,PHYS 1C,A00,896092,Arnold; Kam S,78,0,146,68
1746576899990,PHYS 1CL,001,886448,Tsai; Philbert S,0,0,30,30
1746576899990,PHYS 1CL,002,886449,Tsai; Philbert S,1,0,30,29
1746576899990,PHYS 1CL,003,886450,Tsai; Philbert S,16,0,30,14
1746576899990,PHYS 1CL,004,886451,Tsai; Philbert S,15,0,30,15
1746576901015,PHYS 2B,A01,886457,Staff,68,0,115,47
1746576902046,PHYS 2C,A01,886460,Shotwell; Brian,0,9,65,65
1746576903072,PHYS 2CL,A01,886467,Staff,0,4,28,28
1746576903072,PHYS 2CL,A02,886468,Staff,0,3,28,28
1746576904102,PHYS 2D,A01,886470,Staff,10,0,50,40
1746576905134,PHYS 4B,A01,886475,Grinstein; Benjamin,22,0,40,18
1746576906159,POLI 5,A00,891173,Desposato; Scott,7,0,25,18
1746576907189,POLI 5D,A01,891175,Staff,5,0,5,0
1746576907189,POLI 5D,B01,891178,Staff,5,0,5,0
1746576908220,POLI 11,A00,891179,Ferree; Karen E,2,0,35,33
1746576909250,POLI 12,A00,891180,Staff,16,0,30,14
1746576910275,POLI 27,A01,891182,Staff,12,0,75,63
1746576911304,POLI 30,A00,891183,Staff,8,0,50,42
1746576912335,POLI 100B,A00,891244,Staff,5,1,35,30
1746576913360,POLI 100I,A00,891247,Staff,7,0,30,23
1746576914386,POLI 104J,A00,891248,Nichter; Maysa,14,0,30,16
1746576915411,POLI 104U,A00,891250,Nichter; Maysa,1,0,30,29
1746576917464,POLI 110B,A00,891255,Wiens; David,19,0,25,6
1746576918488,POLI 112A,A00,891256,Wiens; David,6,0,25,19
1746576919518,POLI 114BR,A00,891261,Staff,19,0,30,11
1746576920545,POLI 117R,A00,891262,Forman; Fonna,0,6,50,50
1746576921570,POLI 118,A00,891264,Ingham; Sean,17,0,25,8
1746576922597,POLI 124A,A00,891265,Staff,18,0,20,2
1746576923626,POLI 125D,A00,891266,Nichter; Simeon C,2,0,25,23
1746576924652,POLI 126,A00,891268,Nichter; Simeon C,7,0,25,18
1746576925677,POLI 126AA,A00,891272,Staff,15,0,25,10
1746576926704,POLI 130AA,A00,891273,Staff,15,0,20,5
1746576927733,POLI 134AA,A00,891274,Staff,4,0,20,16
1746576929786,POLI 138,A00,891278,Staff,21,0,25,4
1746576930811,POLI 142K,A00,891280,Staff,10,0,25,15
1746576931840,POLI 142M,A00,891281,Gartzke; Erik,16,0,30,14
1746576932867,POLI 142P,A00,891284,Staff,20,0,30,10
1746576933893,POLI 143,A00,891285,Gartzke; Erik,12,0,30,18
1746576934921,POLI 153,A00,891286,Staff,19,0,20,1
1746576936975,POLI 175,A00,891290,Staff,15,0,20,5
1746576938004,PSYC 1,A00,890674,Steiner; Eric Tomas,0,11,45,45
1746576939031,PSYC 2,A00,890676,Albright; Thomas D,21,0,35,14
1746576940057,PSYC 3,A00,890679,Staff,17,0,20,3
1746576941086,PSYC 6,A00,959858,Staff,19,0,20,1
1746576942110,PSYC 60,A01,890684,Rickard; Timothy C.,0,4,45,45
1746576943139,PSYC 70,A01,890689,Geller; Emma Harlan,7,0,30,23
1746576944167,PSYC 71,A01,959860,Staff,21,0,25,4
1746576945198,PSYC 100,A00,890690,Lacefield; Katharine I,0,50,180,180
1746576946221,PSYC 102,A00,890695,Staff,18,0,40,22
1746576947246,PSYC 105,A00,890699,Geller; Emma Harlan,70,0,100,30
1746576948274,PSYC 106,A00,890701,Gorman; Michael R.,6,0,30,24
1746576949299,PSYC 108,A00,890704,Adrian; Julia Anna,0,28,50,50
1746576950324,PSYC 118,A01,890712,Staff,11,0,30,19
1746576951356,PSYC 124,A00,890716,Chapman; Eddie Nathaniel,25,0,60,35
1746576952381,PSYC 131,A00,890717,Anagnostaras; Stephan,0,7,80,80
1746576953405,PSYC 137,A00,890719,Winkielman; Piotr,0,11,30,30
1746576954434,PSYC 144,A00,890721,Adrian; Julia Anna,0,9,45,45
1746576955458,PSYC 162,A00,890805,Staff,0,0,75,75
1746576956484,PSYC 169,A00,890810,Staff,0,14,30,30
1746576957507,PSYC 172,A00,890814,Gorman; Michael R.,9,0,30,21
1746576958534,PSYC 181,A00,890818,Anagnostaras; Stephan,9,0,200,191
1746576959561,PSYC 184,A00,959861,Staff,166,0,175,9
1746576960587,PSYC 189,A00,890823,Staff,0,2,30,30
1746576961613,PSYC 191,A00,890884,Rickard; Timothy C.,0,12,35,35
1746576962641,PSYC 193,A00,890913,Staff,19,0,30,11
1746576962641,PSYC 193,B00,890914,Chapman; Eddie Nathaniel,24,0,30,6
1746576963671,PSYC 193L,A01,890918,Lowe; Angela Beth,20,0,30,10
1746576963671,PSYC 193L,B01,890921,Hurwitz; Ethan Scott,20,0,30,10
1746576963671,PSYC 193L,C01,890928,Staff,30,0,30,0
1746576964696,RELI 149,A00,886806,Rahimi; Babak,23,0,40,17
1746576965723,SE 9,A01,886814,Staff,7,0,20,13
1746576966747,SE 101B,A01,886816,Chadha; Mayank,4,0,35,31
1746576967772,SE 110B,A00,886818,Zhu; Qiang,4,0,75,71
1746576968798,SE 125,A01,886830,Staff,10,0,30,20
1746576969822,SE 130B,A01,886835,Staff,14,0,40,26
1746576970849,SE 131A,A01,886838,Krysl; Petr,34,0,55,21
1746576971875,SE 154,A00,886840,Staff,29,0,50,21
1746576972900,SE 164GS,A01,886849,Staff,6,0,20,14
1746576973927,SE 167GS,A01,886853,Staff,6,0,20,14
1746576974956,SIO 25,A01,890107,Staff,19,0,30,11
1746576975981,SIO 45,A00,890109,Cook; Geoffrey W,117,0,200,83
1746576977008,SIO 109R,A00,890110,Forman; Fonna,0,16,20,20
1746576978033,SIO 187,A01,890114,Kacev; David,15,0,40,25
1746576979063,SOCI 1,A01,890431,Thorpe; Charles Robert,14,0,30,16
1746576979063,SOCI 1,A02,890518,Thorpe; Charles Robert,30,0,30,0
1746576980090,SOCI 2,A01,957978,Staff,25,0,25,0
1746576980090,SOCI 2,A02,957979,Staff,23,0,25,2
1746576981117,SOCI 20,A01,890523,Calderon-Zaks; Michael Aar,21,0,30,9
1746576981117,SOCI 20,A02,890526,Calderon-Zaks; Michael Aar,29,0,30,1
1746576982141,SOCI 30,A01,890533,Pardo Guerra; Juan Pablo,37,0,40,3
1746576983166,SOCI 40,A01,890535,Staff,27,0,45,18
1746576984193,SOCI 104Q,A00,890559,Staff,18,0,30,12
1746576985218,SOCI 106,A00,890560,Arnal; Maud Marie Leonie,20,0,30,10
1746576986245,SOCI 110,A00,890567,Holkenbrink-Monk; Charlene,19,0,30,11
1746576987269,SOCI 112,A00,890568,Victoria Torres; Pablo,2,0,55,53
1746576988294,SOCI 115,A00,890597,Arnal; Maud Marie Leonie,28,0,45,17
1746576990347,SOCI 121,A00,890604,Pardo Guerra; Juan Pablo,38,0,45,7
1746576991371,SOCI 126,A01,890608,Staff,8,0,10,2
1746576992409,SOCI 127,A00,890609,Staff,18,0,30,12
1746576993433,SOCI 131,A00,890610,Thorpe; Charles Robert,37,0,45,8
1746576994474,SOCI 135,A00,890615,Payne; Christine Anna,13,0,45,32
1746576995498,SOCI 139,A00,890620,Staff,38,0,45,7
1746576996562,SOCI 148E,A00,890622,Calderon-Zaks; Michael Aar,36,0,45,9
1746576997586,SOCI 150,A00,890623,Kohler; Kristopher M.,31,0,45,14
1746576998611,SOCI 157,A00,890625,Jules-Rosette; Bennetta W.,18,0,20,2
1746576999640,SOCI 160,A00,890627,Payne; Christine Anna,21,0,45,24
1746577000668,SYN 1,A00,886855,Fish; Gwendolyn Anne,0,1,0,0
1746577000668,SYN 1,B00,906086,Fish; Gwendolyn Anne,0,2,0,2
1746577001693,SYN 2R,A00,886860,Staff,0,17,15,15
1746577001693,SYN 2R,B00,906106,Atkinson; Arthur Laird,0,16,15,15
1746577002721,SYN 100,A01,886866,Browne; Emily,0,28,20,20
1746577002721,SYN 100,B01,906128,Rock; Martin,0,5,20,20
1746577002721,SYN 100,C01,906140,Deavenport; James Cary,0,3,20,20
1746577002721,SYN 100,D01,907816,Deavenport; James Cary,0,5,20,20
1746577003749,TDAC 1,A00,890286,Walsh; Kim C.,8,0,20,12
1746577004778,TDAC 101,A00,890296,Basso; Beatrice,15,0,20,5
1746577005806,TDDE 131,A00,890297,Staff,47,0,50,3
1746577006831,TDDM 1,A00,890287,Weinberg; Sadie,25,0,30,5
1746577007856,TDGE 11,A00,890288,Fulton; Julia,138,0,200,62
1746577007856,TDGE 11,B00,890289,Castro; Robert Jess,184,0,200,16
1746577008884,TDGE 25,B00,957359,Walsh; Kim C.,5,0,20,15
1746577009909,TDGE 40,A01,890292,Power; Jade Yukana,27,0,30,3
1746577010937,TDGE 124,A00,890298,Havis; Allan,0,1,50,50
1746577011964,TDGE 131R,A00,890299,Burelle; Julie Sara Veronique,15,0,42,27
1746577012994,TDHT 101,A00,890300,Staff,10,0,20,10
1746577014021,TDHT 109,A01,890302,Anderson; Mysia Anyse,31,0,40,9
1746577015046,TDMV 1,A00,890293,Arcidiacono; Kristin,18,0,30,12
1746577016071,TDMV 2,A00,890294,Weinberg; Sadie,23,0,30,7
1746577017100,TDMV 3,A00,957878,Arcidiacono; Kristin,28,0,30,2
1746577019154,TDMV 138,A00,890304,Jun; Grace Shin Hae,25,0,40,15
1746577020179,TDMV 140,A00,890305,Corrales; Joseph Bernales,25,0,30,5
1746577021203,TDMV 142,A00,890307,Caligagan; Tony,32,0,40,8
1746577022230,TDMV 144,A00,890308,Camaya; Michelle Ann,25,0,30,5
1746577023254,TDPW 1,A00,890295,Stein; Deborah Isobel,3,0,20,17
1746577024278,USP 2,A01,890272,Lerner; Amy M,7,0,20,13
1746577025304,USP 3,A01,890274,Staff,12,0,30,18
1746577026330,USP 15,A01,890276,Sun; Feiyang,16,0,30,14
1746577027378,USP 25,A00,890277,Shenkman; Michael Thomas,18,0,25,7
1746577028407,USP 138,A00,890278,Staff,14,0,25,11
1746577029432,USP 143,A00,890279,Staff,22,0,70,48
1746577030462,USP 144,A00,890280,Chowdhury; Muhammed Zohir,16,0,30,14
1746577031488,USP 150,A00,890281,Boomhower; Matthew Charles,4,0,30,26
1746577032515,USP 151,A00,890282,Staff,16,0,20,4
1746577033541,USP 162,A00,890283,Andrews; Abigail Leslie,16,0,20,4
1746577034565,USP 168,A00,920477,Kwak; Nancy,0,0,5,5
1746577035591,USP 181,A00,890284,Staff,3,0,20,17
1746577036617,USP 191A,A00,890285,Staff,12,0,20,8
1746577037646,VIS 101,A00,886512,Staff,26,0,75,49
1746577038675,VIS 103,A00,886513,Cruz; Edwin Teddy,61,0,75,14
1746577039700,VIS 108,A00,886514,Staff,3,0,15,12
1746577040725,VIS 127P,A00,886515,Shen; Kuiyi,80,0,146,66
1746577041753,VIS 149,A00,886516,Yoldas; Pinar,0,0,15,15
1746577042782,VIS 164,A00,886526,Erdmann; Dean,19,0,22,3
1746577043809,VIS 194S,A00,886527,Staff,61,0,75,14
1746577044834,WCWP 10A,C00,886484,Martiniuk; Jill,12,0,15,3
1746577045859,WCWP 10B,A00,886490,Uriarte; Emma,0,0,15,15
1746577045859,WCWP 10B,B00,886491,Dhir; Simrita,9,0,15,6
1746577045859,WCWP 10B,C00,886492,Ornelas; Tricia,0,0,15,15
1746577046888,WCWP 100,A00,886494,Young; Mark T,0,6,15,15
1746577049020,AAS 10,A01,886199,Childs; Dennis R.,0,3,0,0
1746577050044,ANAR 104,A01,886940,Shtienberg; Gilad,27,0,30,3
1746577051070,ANAR 120,A00,886953,Staff,12,0,20,8
1746577052099,ANBI 148,A01,886955,Wilder; Linnea Lorene,30,0,40,10
1746577054150,ANSC 122,A00,886957,Staff,25,0,30,5
1746577055174,ANSC 150,A00,886958,Sloane; Julia Kathryn,2,0,15,13
1746577056200,ANSC 156,A00,886959,Jenkins; Janis A.,0,1,15,15
1746577057226,ANSC 180,A00,886960,Staff,11,0,17,6
1746577058255,ANSC 188,A00,886961,Jassal; Aftab,9,0,25,16
1746577059281,ANSC 190,A00,886962,Jassal; Aftab,14,0,25,11
1746577060308,ANSC 191,A00,886963,Staff,18,0,20,2
1746577061337,ANTH 3,A01,891689,Staff,17,0,20,3
1746577062364,ANTH 5,A00,886933,Semendeferi; Ekaterini,16,0,20,4
1746577063387,ANTH 10,A00,886934,Staff,0,12,30,30
1746577064412,ANTH 21,A01,886936,Staff,41,0,60,19
1746577065438,ANTH 23,A01,886938,Staff,92,0,100,8
1746577066462,ANTH 105,A00,886964,Stewart; Alexander B,84,0,100,16
1746577067493,ANTH 108,A00,886965,Pedersen; David,9,0,20,11
1746577068528,AWP 10,001,886147,Staff,0,0,0,0
1746577068528,AWP 10,002,886148,Staff,0,0,0,0
1746577068528,AWP 10,003,886149,Staff,0,0,0,0
1746577068528,AWP 10,004,886150,Staff,0,0,0,0
1746577068528,AWP 10,005,886151,Staff,0,0,0,0
1746577068528,AWP 10,006,886152,Staff,0,0,0,0
1746577068528,AWP 10,007,886153,Staff,0,0,0,0
1746577068528,AWP 10,008,886154,Staff,0,0,0,0
1746577068528,AWP 10,009,886155,Staff,0,0,0,0
1746577068528,AWP 10,010,886156,Staff,0,0,0,0
1746577068528,AWP 10,011,886158,Staff,0,0,0,0
1746577068528,AWP 10,012,886160,Staff,0,0,0,0
1746577068528,AWP 10,013,886161,Staff,0,0,0,0
1746577068528,AWP 10,014,886162,Staff,0,0,0,0
1746577068528,AWP 10,015,886163,Staff,0,0,0,0
1746577068528,AWP 10,016,886164,Staff,0,0,0,0
1746577068528,AWP 10,017,886165,Staff,0,0,0,0
1746577068528,AWP 10,018,886166,Staff,0,0,0,0
1746577068528,AWP 10,019,886168,Staff,0,0,0,0
1746577068528,AWP 10,020,886170,Staff,0,0,0,0
1746577068528,AWP 10,021,886172,Staff,0,0,0,0
1746577069564,AWP 10R,001,886173,Staff,0,1,0,0
1746577069564,AWP 10R,002,886174,Staff,0,1,0,0
1746577069564,AWP 10R,003,886175,Staff,0,0,0,0
1746577069564,AWP 10R,004,886176,Staff,0,0,0,0
1746577069564,AWP 10R,005,886177,Staff,0,0,0,0
1746577069564,AWP 10R,006,886178,Staff,0,0,0,0
1746577069564,AWP 10R,007,886179,Staff,0,0,0,0
1746577069564,AWP 10R,008,886181,Staff,0,0,0,0
1746577069564,AWP 10R,009,886182,Staff,0,0,0,0
1746577069564,AWP 10R,010,886183,Staff,0,0,0,0
1746577069564,AWP 10R,011,886184,Staff,0,0,0,0
1746577069564,AWP 10R,012,886185,Staff,0,0,0,0
1746577069564,AWP 10R,013,886186,Staff,0,0,0,0
1746577069564,AWP 10R,014,886187,Staff,0,0,0,0
1746577069564,AWP 10R,015,886188,Staff,0,0,0,0
1746577069564,AWP 10R,016,886189,Staff,0,0,0,0
1746577069564,AWP 10R,017,960532,Staff,0,0,0,0
1746577069564,AWP 10R,018,960533,Staff,0,0,0,0
1746577069564,AWP 10R,019,960534,Staff,0,0,0,0
1746577069564,AWP 10R,020,960538,Staff,0,0,0,0
1746577069564,AWP 10R,021,960540,Staff,0,0,0,0
1746577069564,AWP 10R,022,960541,Staff,0,0,0,0
1746577069564,AWP 10R,023,960542,Staff,0,0,0,0
1746577069564,AWP 10R,024,960544,Staff,0,0,0,0
1746577069564,AWP 10R,025,960545,Staff,0,0,0,0
1746577069564,AWP 10R,026,960548,Staff,0,0,0,0
1746577070594,AWP 102R,A00,886190,Staff,0,0,0,0
1746577070594,AWP 102R,B00,886191,Staff,0,0,0,0
1746577071618,BENG 100,A01,886193,Staff,17,0,30,13
1746577072643,BENG 122A,A01,886195,Hasty; Jeff M,13,0,30,17
1746577073668,BENG 166A,A00,886196,Sah; Robert Lie-Yuan,0,3,30,30
1746577074693,BENG 190,A00,958050,Khojah; Reem I,20,0,25,5
1746577075716,BIBC 102,A01,894320,Staff,0,0,46,46
1746577075716,BIBC 102,A02,894321,Staff,0,0,46,46
1746577075716,BIBC 102,A03,894344,Staff,6,0,46,40
1746577075716,BIBC 102,A04,894345,Staff,27,0,47,20
1746577076743,BICD 100R,A01,894365,Smith; Laurie,0,3,58,58
1746577076743,BICD 100R,A02,894366,Smith; Laurie,0,5,58,58
1746577076743,BICD 100R,A03,894367,Smith; Laurie,0,0,59,59
1746577076743,BICD 100R,A04,959869,Smith; Laurie,40,0,59,19
1746577077770,BICD 136,A01,894383,Gustafson-Brown; Cindy,14,0,50,36
1746577078795,BIEB 102,A01,894494,Butler; Shannon Rhey,51,0,130,79
1746577080845,BIEB 150,A01,894617,Wills; Christopher,3,0,20,17
1746577080845,BIEB 150,A02,894631,Wills; Christopher,3,0,20,17
1746577080845,BIEB 150,A03,894937,Wills; Christopher,3,0,20,17
1746577080845,BIEB 150,A04,894946,Wills; Christopher,5,0,20,15
1746577081870,BIEB 194,A00,906141,Kurle; Carolyn M.,6,0,20,14
1746577082896,BILD 1,A01,894154,Staff,3,0,19,16
1746577082896,BILD 1,A02,894155,Staff,14,0,19,5
1746577082896,BILD 1,A03,894160,Staff,13,0,19,6
1746577082896,BILD 1,A04,894161,Staff,15,0,18,3
1746577083925,BILD 2,A01,894168,Staff,0,0,50,50
1746577083925,BILD 2,A02,894169,Staff,0,0,50,50
1746577083925,BILD 2,A03,894179,Staff,0,0,50,50
1746577083925,BILD 2,A04,894203,Staff,24,0,50,26
1746577084952,BILD 3,A01,894213,Staff,23,0,31,8
1746577084952,BILD 3,A02,894214,Staff,26,0,31,5
1746577084952,BILD 3,A03,894235,Staff,28,0,31,3
1746577084952,BILD 3,A04,894236,Staff,28,0,32,4
1746577085981,BILD 4,A01,894253,Reuther; Keefe,5,0,24,19
1746577085981,BILD 4,A02,894258,Reuther; Keefe,16,0,24,8
1746577087010,BILD 5,A01,894276,Reuther; Keefe,35,0,50,15
1746577087010,BILD 5,A02,894277,Reuther; Keefe,45,0,50,5
1746577087010,BILD 5,A03,894290,Reuther; Keefe,44,0,50,6
1746577087010,BILD 5,A04,894291,Reuther; Keefe,48,0,50,2
1746577088036,BILD 24,A01,894297,Pirino; Giorgia,40,0,60,20
1746577089062,BIMM 100,B01,958915,Staff,71,0,100,29
1746577090088,BIMM 101,A01,895017,McDonnell; Lisa Marie,0,5,24,24
1746577090088,BIMM 101,A02,895018,McDonnell; Lisa Marie,0,5,24,24
1746577090088,BIMM 101,B01,895020,McDonnell; Lisa Marie,0,6,24,24
1746577090088,BIMM 101,B02,895021,McDonnell; Lisa Marie,0,4,24,24
1746577091114,BIMM 110,A01,895023,Staff,1,0,25,24
1746577091114,BIMM 110,A02,895024,Staff,9,0,25,16
1746577091114,BIMM 110,A03,895025,Staff,18,0,25,7
1746577091114,BIMM 110,A04,895031,Staff,20,0,25,5
1746577092141,BIMM 120,A01,895114,Gustafson-Brown; Cindy,14,0,28,14
1746577092141,BIMM 120,A02,895126,Gustafson-Brown; Cindy,21,0,27,6
1746577093171,BIPN 100,A01,895130,Yang; Mingyu,0,0,38,38
1746577093171,BIPN 100,A02,895131,Yang; Mingyu,32,0,38,6
1746577093171,BIPN 100,A03,895132,Yang; Mingyu,32,0,38,6
1746577093171,BIPN 100,A04,895133,Yang; Mingyu,27,0,36,9
1746577094196,BIPN 120,A01,895135,Cooke; James Edward,0,3,13,13
1746577094196,BIPN 120,A02,895136,Cooke; James Edward,0,1,13,13
1746577094196,BIPN 120,A03,895137,Cooke; James Edward,0,3,13,13
1746577094196,BIPN 120,A04,895156,Cooke; James Edward,0,2,11,11
1746577095223,BIPN 134,A01,895235,Cooke; James Edward,0,2,25,25
1746577095223,BIPN 134,A02,895237,Cooke; James Edward,0,0,25,25
1746577095223,BIPN 134,A03,895240,Cooke; James Edward,3,0,25,22
1746577095223,BIPN 134,A04,895270,Cooke; James Edward,20,0,25,5
1746577096247,BIPN 189,A00,892103,Staff,0,14,14,14
1746577098299,BISP 194,A00,958008,Staff,0,2,0,0
1746577099327,CAT 124,A01,922009,Staff,0,5,20,20
1746577100396,CAT 125R,A00,886390,Morales; Celeste Georgianna,0,2,20,20
1746577100396,CAT 125R,B00,886391,Irwin; Matthew Joseph,0,4,20,20
1746577100396,CAT 125R,C00,886392,Smith; Lauryn Alissa,0,2,20,20
1746577100396,CAT 125R,D00,886393,Vanderschuit; Maya Alysia,0,3,20,20
1746577100396,CAT 125R,E00,886394,Marchisotto; Jennifer Anne,0,3,20,20
1746577101422,CENG 15,A01,886218,Drews; Aaron,3,0,8,5
1746577102449,CENG 113,A00,886219,Opatkiewicz; Justin Paul,15,0,25,10
1746577103475,CGS 101,A00,887044,Staff,7,0,20,13
1746577104504,CGS 105,A01,887046,Staff,14,0,25,11
1746577105534,CGS 112,A00,887047,Cuong; Marisol,12,0,15,3
1746577106558,CGS 113,A00,887048,Staff,23,0,30,7
1746577107582,CGS 120,A00,887049,Staff,10,0,17,7
1746577108607,CHEM 6A,A01,886336,Lam; Tin Yiu,38,0,50,12
1746577108607,CHEM 6A,A02,886338,Lam; Tin Yiu,37,0,50,13
1746577109635,CHEM 6B,A01,886341,Hopkins; Patrycja Anna,16,0,50,34
1746577109635,CHEM 6B,A02,886343,Hopkins; Patrycja Anna,42,0,50,8
1746577110662,CHEM 6C,A01,886346,Albizati; Kim F.,0,2,50,50
1746577110662,CHEM 6C,A02,886348,Albizati; Kim F.,23,0,50,27
1746577111687,CHEM 40A,A01,886352,Klosterman; Jeremy K,65,0,100,35
1746577112717,CHEM 40B,A01,886356,Klosterman; Jeremy K,0,23,100,100
1746577113743,CHEM 41B,A01,886360,Theodorakis; Emmanuel,25,0,50,25
1746577113743,CHEM 41B,A02,886362,Theodorakis; Emmanuel,47,0,50,3
1746577114772,CHIN 165A,A00,886382,Xu; Li,18,0,20,2
1746577115796,CLAS 120,A00,886387,Myerston Santana; Jacobo,33,0,40,7
1746577116825,COGS 9,A01,886967,Shannon; Kyle Michael,42,0,60,18
1746577117849,COGS 11,A01,886969,Staff,9,0,30,21
1746577118877,COGS 14A,A01,886971,Staff,6,0,60,54
1746577119908,COGS 14B,A01,886973,Hoffman; Drew Ellen,4,0,60,56
1746577120934,COGS 18,A01,886975,Morgan; Eric,35,0,60,25
1746577121958,COGS 20,A01,886977,Staff,4,0,8,4
1746577121958,COGS 20,A02,886978,Staff,5,0,7,2
1746577122984,COGS 100,A01,907783,Staff,1,2,30,29
1746577124007,COGS 101B,A01,886980,Staff,0,4,48,48
1746577125032,COGS 101C,A01,886982,Delgado; Tania,0,5,44,44
1746577126059,COGS 102A,A01,886984,Johnson; Christine M.,4,0,30,26
1746577127085,COGS 118B,A01,886986,Staff,1,4,88,87
1746577128114,COGS 150,A01,886988,Bergen; Benjamin,22,0,50,28
1746577129144,COGS 153,A00,886989,Delgado; Tania,0,2,41,41
1746577130170,COGS 186,A01,886991,Staff,0,0,32,32
1746577131197,COGS 187A,A01,886993,Boyle; Mary E. T.,7,0,30,23
1746577132226,COGS 189,A00,886994,Staff,0,1,30,30
1746577133252,COMM 10,A01,886996,Staff,0,0,20,21
1746577133252,COMM 10,A02,886997,Staff,10,0,20,10
1746577133252,COMM 10,A03,959845,Staff,19,0,20,1
1746577134277,COMM 20,A01,886999,Leuning; Grant Maurstad,24,0,40,16
1746577136328,COMM 100A,A01,887002,Staff,0,0,20,25
1746577136328,COMM 100A,A02,887003,Staff,6,0,20,14
1746577137353,COMM 100B,A01,887005,Staff,0,8,20,24
1746577138377,COMM 106D,A00,887006,Staff,13,0,40,27
1746577139402,COMM 110G,A00,887007,Whitworth-Smith; Andrew C,12,0,40,28
1746577140430,COMM 111B,A00,887008,Staff,31,0,40,9
1746577141461,COMM 113T,A00,887009,Abuelhiga; Soraya Jill,28,0,40,12
1746577141461,COMM 113T,B00,906733,Staff,40,0,40,0
1746577142489,COMM 145,A00,887010,Staff,12,0,40,28
1746577143515,COMM 146,A00,887054,Staff,31,0,40,9
1746577144542,COMM 190,A00,887012,Staff,8,0,23,15
1746577145567,CSE 8A,A50,887015,Cao; Yingjun,57,0,85,28
1746577146596,CSE 11,A01,887017,Cao; Yingjun,12,0,70,58
1746577147621,CSE 20,A01,887019,Staff,30,0,50,20
1746577148651,CSE 21,A01,887021,Staff,78,0,100,22
1746577148651,CSE 21,B01,892583,Braun; Oliver,45,0,50,5
1746577149677,CSE 30,A01,887025,Eldon; John,143,0,200,57
1746577150707,CSE 100,A01,887027,Staff,26,0,50,24
1746577150707,CSE 100,A02,887028,Staff,42,0,50,8
1746577151738,CSE 101,A01,887030,Braun; Oliver,74,0,100,26
1746577151738,CSE 101,B01,887032,Jones; Miles E,0,3,50,50
1746577151738,CSE 101,B02,887033,Jones; Miles E,0,2,50,50
1746577152763,CSE 105,A01,908084,Jones; Miles E,32,0,50,18
1746577152763,CSE 105,A02,908087,Jones; Miles E,31,0,50,19
1746577153792,CSE 135,A01,887035,Powell; Thomas Allan,0,5,50,50
1746577154818,CSE 142,A01,887037,Staff,8,0,60,52
1746577155843,CSE 142L,A01,887039,Staff,34,0,60,26
1746577156869,CSE 151A,A01,887041,Solares; Edwin A,47,0,100,53
1746577157897,CSE 175,A01,887043,Kumar; Rakesh,30,0,30,0
1746577158923,CSS 1,A01,886389,Staff,1,1,40,39
1746577159952,DSC 30,A01,908097,Liao; Soohyun Nam,47,0,75,28
1746577160981,DSC 40A,A01,908099,Shannon; Kyle Michael,30,0,50,20
1746577162007,DSC 40B,A01,908112,Staff,15,0,50,35
1746577163035,DSC 80,A01,908116,Staff,19,0,60,41
1746577164060,DSC 197,001,956863,Eldridge; Justin Matthew,9999,0,9999,0
1746577165087,ECE 5,A01,886400,Morris; Karcher William,1,0,6,5
1746577165087,ECE 5,A02,886401,Morris; Karcher William,3,0,6,3
1746577166111,ECE 148,A01,886403,Silberman; Jack,0,14,14,14
1746577167142,ECON 1,A01,887265,Crane; Meredith Helen,12,0,70,58
1746577167142,ECON 1,B01,887268,Staff,42,0,50,8
1746577168169,ECON 2,A01,887273,Crane; Meredith Helen,55,0,70,15
1746577169202,ECON 3,A01,887279,Rondina; Giacomo,32,0,70,38
1746577170227,ECON 4,A01,887282,Anderson; John Charles,0,2,10,10
1746577171255,ECON 5,A01,887285,Staff,34,0,45,11
1746577171255,ECON 5,B01,887292,Staff,41,0,45,4
1746577172284,ECON 100A,A01,887337,Newhouse; Herbert S,54,0,70,16
1746577172284,ECON 100A,B01,887349,Staff,45,0,50,5
1746577173309,ECON 100B,A01,887361,Du; Songzi,29,0,70,41
1746577174335,ECON 100C,A01,887445,Newhouse; Herbert S,59,0,70,11
1746577175361,ECON 105,A00,887488,Vespa; Emanuel Ignacio,23,0,35,12
1746577176385,ECON 109,A01,887506,Shishkin; Denis,28,0,35,7
1746577177414,ECON 110A,A01,887568,Alon; Titan Michael,0,3,35,35
1746577177414,ECON 110A,B01,907601,Alon; Titan Michael,20,0,35,15
1746577178442,ECON 110B,A01,887598,Levkoff; Steven B.,0,24,70,70
1746577179467,ECON 112,A00,887599,Rondina; Giacomo,19,0,35,16
1746577180494,ECON 120A,A01,887603,Dai; Yinlin,35,0,70,35
1746577181524,ECON 120C,A01,887608,Sun; Yixiao,0,1,35,35
1746577181524,ECON 120C,B01,887614,Sun; Yixiao,0,0,35,35
1746577182550,ECON 138,A00,887621,Bharadwaj; Prashant,0,21,20,20
1746577183577,ECON 144,A00,958007,Squires; Dale E,12,0,35,23
1746577184600,ECON 171,A01,907666,Staff,18,0,35,17
1746577185629,ECON 175,A00,887626,Wu; Pak Yeung,22,0,35,13
1746577186657,ECON 190,A00,887640,Vespa; Emanuel Ignacio,22,0,35,13
1746577187686,EDS 25,A01,888197,Staff,0,0,0,0
1746577187686,EDS 25,A02,888209,Staff,0,0,0,0
1746577187686,EDS 25,A03,888210,Staff,0,0,0,0
1746577187686,EDS 25,A04,888212,Staff,0,0,0,0
1746577187686,EDS 25,A05,888213,Staff,0,0,0,0
1746577187686,EDS 25,A06,888214,Staff,0,0,0,0
1746577187686,EDS 25,A07,888235,Staff,0,2,0,0
1746577187686,EDS 25,A08,888236,Staff,0,0,0,0
1746577187686,EDS 25,A09,888240,Staff,0,0,0,0
1746577187686,EDS 25,A10,888244,Staff,0,0,0,0
1746577187686,EDS 25,B01,888273,Staff,0,0,0,0
1746577187686,EDS 25,B02,888285,Staff,0,0,0,0
1746577187686,EDS 25,B03,888423,Staff,0,0,0,1
1746577187686,EDS 25,B04,888432,Staff,0,0,0,0
1746577187686,EDS 25,B05,888433,Staff,0,0,0,0
1746577187686,EDS 25,B06,888467,Staff,0,0,0,0
1746577187686,EDS 25,B07,888468,Staff,0,0,0,0
1746577187686,EDS 25,B08,888479,Staff,0,0,0,0
1746577187686,EDS 25,B09,888484,Staff,0,0,0,0
1746577187686,EDS 25,B10,888487,Staff,0,0,0,0
1746577188714,EDS 38,A01,907700,Choi; Bailey Miyeon,30,0,30,0
1746577189741,EDS 112,A01,888601,Chapman; Thandeka K,12,0,40,28
1746577190766,EDS 115,A00,888697,Mendez; Kathrina Mendoza,10,0,30,20
1746577191794,EDS 116,A01,888893,Staff,34,0,40,6
1746577193846,EDS 124AR,A00,889133,Staff,29,0,50,21
1746577193846,EDS 124AR,B00,907471,Simon; Elizabeth A,37,0,50,13
1746577194873,EDS 124BR,A00,889134,Simon; Elizabeth A,44,0,100,56
1746577195897,EDS 125,A00,889135,Staff,25,0,30,5
1746577196923,EDS 126,A01,889138,Staff,35,0,40,5
1746577197951,EDS 164R,A01,889142,Wishard Guerra; Alison G.,33,0,50,17
1746577198976,ENG 30,A01,886396,Staff,0,0,0,0
1746577198976,ENG 30,B01,886398,Staff,0,0,0,0
1746577200002,ENVR 102,A00,906150,Montejo; Carolina,23,0,25,2
1746577201026,ETHN 103A,A00,887236,Man; Simeon S,0,3,0,0
1746577202052,ETHN 113,A00,887239,Staff,16,0,30,14
1746577203088,ETHN 116,A00,887240,Staff,16,0,25,9
1746577204115,ETHN 117,A00,887241,Choi; Esther Min,28,0,30,2
1746577205141,ETHN 118,A00,887243,Staff,24,0,30,6
1746577206170,ETHN 127,A00,887248,Cuong; Marisol,11,0,15,4
1746577207194,ETHN 139,A00,887250,Staff,7,0,10,3
1746577208218,ETHN 142,A00,887252,Staff,10,0,30,20
1746577209247,ETHN 161,A00,887253,Browne; Errol Tsekani,24,0,30,6
1746577210271,ETHN 163FR,A00,887255,Burelle; Julie Sara Veronique,0,0,5,5
1746577211296,GLBH 20,A00,889149,Elwardani; Nile Regina,8,0,42,34
1746577213348,GLBH 111,A01,889152,Burgos; Jose L.,17,0,17,0
1746577214377,GLBH 150,A00,889181,Sloane; Julia Kathryn,0,5,15,15
1746577216426,HDS 60,A01,886406,Warstadt; Melissa Fawn,73,0,80,7
1746577217452,HIAF 111,A00,889324,Gyamfi; Bright,25,0,32,7
1746577218479,HIEA 131,A00,889328,Staff,15,0,32,17
1746577219503,HIEA 144,A00,889333,Henry; Todd A.,26,0,32,6
1746577220532,HIEA 154,A00,889336,Henry; Todd A.,24,0,32,8
1746577221561,HIEU 106,A00,889339,Staff,22,0,32,10
1746577223609,HIEU 114,A00,889340,Staff,4,0,32,28
1746577224638,HIEU 135GS,A00,889342,Patterson; Patrick H.,0,0,1,24
1746577225664,HIEU 137,A00,889343,Edington; Claire Ellen,10,0,25,15
1746577226690,HIEU 148,A00,889345,Staff,14,0,32,18
1746577227714,HIEU 154,A00,889346,Biess; Frank Peter,21,0,32,11
1746577228741,HILA 102,A00,889351,Staff,12,0,32,20
1746577229768,HILD 2A,A01,889221,Lewandoski; Julia Mavis,1,10,32,31
1746577231003,HILD 7B,A01,889225,Man; Simeon S,0,12,32,32
1746577232031,HILD 7C,A01,889288,Alvarez; Luis A,0,14,32,32
1746577233056,HILD 30,A01,889323,Staff,0,5,32,32
1746577235106,HISC 119,A00,889383,Golan; Tal,19,0,32,13
1746577236133,HIUS 103,A00,889384,Man; Simeon S,0,0,32,32
1746577237158,HIUS 117,A00,919797,Kwak; Nancy,19,0,32,13
1746577238185,HIUS 142A,A00,919788,Staff,22,0,32,10
1746577240234,HIUS 149,A00,889386,Gyamfi; Bright,26,0,32,6
1746577241261,HIUS 155,A00,889387,Alvarez; Luis A,15,0,32,17
1746577242289,HUM 3,A01,886499,Caldwell; Michael Alan,19,0,50,31
1746577243314,HUM 3GS,A00,886500,Rodriguez; Bretton Sigfred,0,0,0,28
1746577244341,HUM 3R,A01,886502,Markman; Kristina,0,36,50,50
1746577245372,HUM 4,A01,886504,Crum; Matthew Stephen,23,0,50,27
1746577245372,HUM 4,B01,886506,West; Geoffrey Scott,17,0,50,33
1746577246396,HUM 4GS,A00,886507,Staff,0,0,0,19
1746577247427,HUM 5,A01,886509,Staff,32,0,50,18
1746577248453,HUM 5R,A01,886511,Zavodny; Tatiana Sophia,0,39,50,50
1746577249481,JAPN 180,A00,886407,Staff,16,0,40,24
1746577250511,LATI 50,A01,886409,Martin-Cabrera; Luis,3,0,22,19
1746577250511,LATI 50,A02,886410,Martin-Cabrera; Luis,19,0,22,3
1746577250511,LATI 50,A03,886411,Martin-Cabrera; Luis,21,0,22,1
1746577250511,LATI 50,A04,886412,Martin-Cabrera; Luis,9,0,22,13
1746577251535,LAWS 101,A00,907664,Staff,28,0,60,32
1746577252561,LIAB 1A,A00,889388,Saab; Dima,17,0,20,3
1746577253586,LIAB 1AX,A00,889389,El Cheddadi; Youniss,18,0,20,2
1746577254615,LIFR 1C,A00,889391,Van Moer; Vinciane G,8,0,20,12
1746577255640,LIFR 1CX,A00,889392,Van Moer; Vinciane G,7,0,20,13
1746577256665,LIFR 1D,A00,889393,Van Moer; Vinciane G,7,0,20,13
1746577257690,LIFR 1DX,A00,889394,Van Moer; Vinciane G,8,0,20,12
1746577258715,LIGN 7,A00,886923,Staff,24,0,50,26
1746577259739,LIGN 17,A00,886924,Kehler; Andrew Scott,125,0,150,25
1746577260768,LTAM 110,A00,889395,Staff,15,0,30,15
1746577261794,LTAM 110GS,A00,958010,Rodriguez; Bretton Sigfred,0,0,0,28
1746577262818,LTCH 101,A00,889397,Staff,23,0,25,2
1746577263844,LTCS 130,A00,889398,Staff,23,0,25,2
1746577264868,LTEA 138,A00,889399,Staff,24,0,40,16
1746577265897,LTEN 149,A00,889400,Wesling; Megan E.,0,3,25,25
1746577266922,LTEN 169,A00,889401,Staff,20,0,25,5
1746577267948,LTEN 180,A00,889402,Staff,10,0,15,5
1746577268972,LTEN 181,A00,889403,Staff,21,0,25,4
1746577270005,LTWL 100,A00,889404,Myerston Santana; Jacobo,2,0,25,23
1746577271033,LTWL 180GS,A00,889405,Staff,0,0,20,20
1746577272062,LTWL 181,A00,889406,Staff,16,0,25,9
1746577273088,LTWL 184,A00,889475,Mukherjee; Silpa,22,0,25,3
1746577274116,LTWR 102C,A00,889486,Staff,29,0,30,1
1746577275141,LTWR 115W,A00,889491,Staff,0,2,15,15
1746577276168,MAE 8,A01,886905,Staff,0,2,0,0
1746577277195,MAE 11,A00,886906,Bandaru; Prabhakar,0,7,50,50
1746577278220,MAE 20,A00,886907,Evdokimenko; Ekaterina,43,0,70,27
1746577279249,MAE 30B,A00,886909,Ghazinejad; Maziar,26,0,45,19
1746577280274,MAE 101B,A00,886910,Saintillan; David,29,0,45,16
1746577281300,MAE 105,A00,886911,Bandaru; Prabhakar,18,0,50,32
1746577282325,MAE 107,B00,958024,Staff,8,0,50,42
1746577283350,MAE 143B,A00,886913,Bewley; Thomas R,4,0,40,36
1746577284377,MAE 148,A01,886915,Silberman; Jack,0,3,14,14
1746577285404,MAE 160,A00,886916,Evdokimenko; Ekaterina,31,0,60,29
1746577286436,MATH 3C,A01,889681,Staff,0,2,30,30
1746577286436,MATH 3C,A02,960048,Staff,24,0,30,6
1746577287464,MATH 10A,A01,889760,Staff,26,0,30,4
1746577287464,MATH 10A,A02,889783,Staff,29,0,30,1
1746577288498,MATH 10B,A01,889785,Verstraete; Jacques Allan,2,0,35,33
1746577288498,MATH 10B,A02,889795,Verstraete; Jacques Allan,4,0,35,31
1746577288498,MATH 10B,B01,889797,Verstraete; Jacques Allan,3,0,35,32
1746577288498,MATH 10B,B02,889828,Verstraete; Jacques Allan,3,0,35,32
1746577289524,MATH 10C,A01,889849,Habib; Yousaf,7,0,30,23
1746577289524,MATH 10C,A02,889852,Habib; Yousaf,14,0,30,16
1746577289524,MATH 10C,A03,889853,Habib; Yousaf,22,0,30,8
1746577289524,MATH 10C,A04,889858,Habib; Yousaf,20,0,30,10
1746577289524,MATH 10C,B01,889861,Staff,1,0,30,29
1746577289524,MATH 10C,B02,889862,Staff,24,0,30,6
1746577289524,MATH 10C,B03,889863,Staff,27,0,30,3
1746577289524,MATH 10C,B04,889967,Staff,23,0,30,7
1746577290551,MATH 18,A01,889974,Staff,7,0,30,23
1746577290551,MATH 18,A02,889977,Staff,20,0,30,10
1746577290551,MATH 18,B01,889984,Hardiman; Liam,21,0,30,9
1746577290551,MATH 18,B02,889985,Hardiman; Liam,25,0,30,5
1746577291580,MATH 20A,A01,889990,Suk; Andrew Hoon,30,0,35,5
1746577292612,MATH 20B,A01,889993,Ohm; Ko Woon,22,0,30,8
1746577292612,MATH 20B,A02,889994,Ohm; Ko Woon,30,0,30,0
1746577292612,MATH 20B,B01,889996,Ohm; Ko Woon,22,0,30,8
1746577292612,MATH 20B,B02,889997,Ohm; Ko Woon,23,0,30,7
1746577293637,MATH 20C,A01,889999,Hammock; Frances H,17,0,30,13
1746577293637,MATH 20C,A02,890003,Hammock; Frances H,23,0,30,7
1746577293637,MATH 20C,B01,890006,Hammock; Frances H,3,0,30,27
1746577293637,MATH 20C,B02,890007,Hammock; Frances H,12,0,30,18
1746577294669,MATH 20D,A01,890011,Cheng; Hsiao-Bing,1,1,30,29
1746577294669,MATH 20D,A02,890012,Cheng; Hsiao-Bing,14,0,30,16
1746577294669,MATH 20D,B01,890016,Cheng; Hsiao-Bing,13,0,30,17
1746577294669,MATH 20D,B02,890017,Cheng; Hsiao-Bing,13,0,30,17
1746577295694,MATH 20E,A01,890026,Harel; Guershon,1,0,30,29
1746577295694,MATH 20E,A02,890029,Harel; Guershon,23,0,30,7
1746577295694,MATH 20E,B01,890033,Harel; Guershon,7,0,30,23
1746577295694,MATH 20E,B02,890101,Harel; Guershon,21,0,30,9
1746577296723,MATH 102,A01,890104,Staff,17,0,30,13
1746577296723,MATH 102,A02,890105,Staff,27,0,30,3
1746577297749,MATH 103B,A01,890116,Salehi Golsefidy; Alireza,3,0,30,27
1746577297749,MATH 103B,B01,890118,Staff,0,3,34,34
1746577298779,MATH 109,A01,890121,Aliabadi Sr.; Mohsen,1,0,30,29
1746577298779,MATH 109,B01,890124,Upadrashta; Pranav Kumar,18,0,30,12
1746577299803,MATH 120A,A01,890126,Eggers; John Dietrich,13,0,30,17
1746577300832,MATH 142B,A01,890128,Ioana; Adrian,19,0,30,11
1746577300832,MATH 142B,A02,890129,Ioana; Adrian,13,0,30,17
1746577301857,MATH 154,A01,890174,Staff,0,0,30,30
1746577301857,MATH 154,A02,890182,Staff,0,0,30,30
1746577302884,MATH 168A,A01,890197,Dumitriu; Ioana,21,0,35,14
1746577303909,MATH 170A,A01,890240,Nie; Jiawang,1,0,30,29
1746577303909,MATH 170A,A02,890241,Nie; Jiawang,11,0,30,19
1746577303909,MATH 170A,A03,890249,Nie; Jiawang,23,0,30,7
1746577304938,MATH 170B,A01,957891,Nag; Panchali,13,0,35,22
1746577306987,MATH 181A,A01,908025,Staff,0,3,35,35
1746577306987,MATH 181A,A02,960115,Staff,26,0,35,9
1746577308014,MATH 181B,A01,959874,Staff,25,0,30,5
1746577309042,MATH 193B,A01,890265,Staff,0,4,35,35
1746577310067,MGT 4,A01,890311,Anderson; John Charles,42,0,88,46
1746577311092,MGT 5,A00,907740,Staff,13,0,98,85
1746577312116,MGT 12,A00,890312,Lindenberger; Wade Douglas,67,0,98,31
1746577313141,MGT 16,A00,957883,Staff,78,0,98,20
1746577315199,MGT 45,A00,890314,Pecore; Joseph P.,45,0,98,53
1746577316228,MGT 71,A00,890315,Staff,0,12,98,98
1746577317256,MGT 100,A00,890316,Yavorsky; Daniel Ryan,44,0,98,54
1746577318280,MGT 103,A00,890317,Ehrich; Kristine R,73,0,98,25
1746577319305,MGT 105,A00,890356,Bates; Kenneth Walter,0,8,98,98
1746577320332,MGT 112,A00,890360,Ehrich; Kristine R,55,0,98,43
1746577321356,MGT 127R,A00,907732,Zhu; Kevin Xiaoguo,23,0,98,75
1746577322383,MGT 131B,A00,890361,Anderson; John Charles,59,0,98,39
1746577323412,MGT 137,A00,890362,Lindenberger; Wade Douglas,65,0,98,33
1746577324436,MGT 160,A00,890369,Johnson; Erik Barry,9,0,98,89
1746577326487,MGT 164,A00,890372,Zimmermann; Carsten,0,40,98,98
1746577327512,MGT 180,A00,890374,Bliss; Barbara Ann,12,0,98,86
1746577328544,MMW 15,A01,886414,Chang; Edmond Yi-Teh,0,12,28,28
1746577328544,MMW 15,A02,886415,Chang; Edmond Yi-Teh,0,8,28,28
1746577328544,MMW 15,A03,886416,Chang; Edmond Yi-Teh,0,9,28,28
1746577328544,MMW 15,A04,886417,Chang; Edmond Yi-Teh,0,8,28,28
1746577328544,MMW 15,B01,886419,Chang; Edmond Yi-Teh,0,7,28,28
1746577328544,MMW 15,B02,886420,Chang; Edmond Yi-Teh,0,8,28,28
1746577328544,MMW 15,B03,886421,Chang; Edmond Yi-Teh,0,7,28,28
1746577328544,MMW 15,B04,886422,Chang; Edmond Yi-Teh,0,8,28,28
1746577328544,MMW 15,C01,886424,Staff,0,9,28,28
1746577328544,MMW 15,C02,886425,Staff,0,8,28,28
1746577328544,MMW 15,C03,886426,Staff,0,8,28,28
1746577328544,MMW 15,C04,886427,Staff,0,8,28,28
1746577328544,MMW 15,C05,958038,Staff,0,8,28,28
1746577328544,MMW 15,C06,958039,Staff,1,8,28,27
1746577329569,MMW 15GS,A00,906910,Patterson; Patrick H.,4,0,28,24
1746577330595,MMW 122R,A01,886429,Rahimi; Babak,0,13,28,28
1746577330595,MMW 122R,A02,886430,Rahimi; Babak,0,12,28,28
1746577330595,MMW 122R,A03,958040,Rahimi; Babak,0,11,28,28
1746577331620,MUS 1A,A01,890937,Staff,2,0,25,23
1746577331620,MUS 1A,A02,891035,Staff,6,0,25,19
1746577331620,MUS 1A,C01,958912,Staff,24,0,25,1
1746577331620,MUS 1A,C02,958913,Staff,25,0,25,0
1746577333679,MUS 2AK,A00,957092,Ohnishi; Takae,15,0,15,0
1746577334705,MUS 4,A01,891044,Staff,1,0,25,24
1746577334705,MUS 4,A02,891045,Staff,23,0,25,2
1746577334705,MUS 4,B01,891048,Staff,17,0,25,8
1746577334705,MUS 4,B02,891050,Staff,25,0,25,0
1746577335734,MUS 5,A01,957506,Dubnov; Shlomo,0,0,25,25
1746577335734,MUS 5,A02,957622,Dubnov; Shlomo,13,0,25,12
1746577335734,MUS 5,A03,957623,Dubnov; Shlomo,20,0,25,5
1746577336763,MUS 6,A01,891053,Freitas Caetano; Marcelo,24,0,25,1
1746577336763,MUS 6,A02,891054,Freitas Caetano; Marcelo,23,0,25,2
1746577337790,MUS 7,A01,891081,Staff,1,0,25,24
1746577337790,MUS 7,A02,891082,Staff,3,0,25,22
1746577338816,MUS 8GS,A00,891118,Borgo; David Garcia,1,0,25,24
1746577339844,MUS 11,A01,891140,Staff,9,0,25,16
1746577339844,MUS 11,A02,891141,Staff,22,0,25,3
1746577340871,MUS 13,A01,891143,Staff,8,0,25,17
1746577340871,MUS 13,A02,891144,Staff,24,0,25,1
1746577341898,MUS 15,A01,891146,Staff,9,0,25,16
1746577341898,MUS 15,A02,891148,Staff,21,0,25,4
1746577341898,MUS 15,B01,891150,Staff,18,0,25,7
1746577341898,MUS 15,B02,891151,Staff,25,0,25,0
1746577342928,MUS 20,A01,891153,Staff,5,0,20,15
1746577342928,MUS 20,A02,891155,Staff,14,0,20,6
1746577343956,MUS 80,A00,891156,Staff,19,0,25,6
1746577343956,MUS 80,B00,891157,Staff,23,0,25,2
1746577344994,MUS 130,A00,891158,Ohnishi; Takae,35,0,35,0
1746577346020,MUS 150GS,A01,891160,Borgo; David Garcia,1,0,25,24
1746577347046,MUS 170,A01,891162,Freitas Caetano; Marcelo,20,0,25,5
1746577347046,MUS 170,A02,891164,Freitas Caetano; Marcelo,21,0,25,4
1746577348076,NANO 11,A00,886220,Vazquez Mena; Oscar,13,0,15,2
1746577349102,NANO 15,A01,886222,Drews; Aaron,4,0,7,3
1746577350127,NANO 104,A00,886224,Sirbuly; Donald,17,0,25,8
1746577351152,PH 40,A00,886528,Staff,24,0,40,16
1746577352178,PH 45,A01,886799,Staff,35,0,40,5
1746577353206,PH 110,A00,886802,Staff,0,7,40,40
1746577354230,PH 172,A00,906716,Staff,18,0,35,17
1746577355257,PH 191,A00,886803,Staff,6,0,40,34
1746577356286,PHIL 1,A00,889500,Staff,20,0,30,10
1746577357310,PHIL 10,A01,889549,Grush; Rick Scott,16,0,22,6
1746577357310,PHIL 10,A02,889551,Grush; Rick Scott,22,0,22,0
1746577358340,PHIL 28,A01,889559,Lamey; Andy M.,0,2,31,31
1746577358340,PHIL 28,A02,889561,Lamey; Andy M.,0,1,30,30
1746577358340,PHIL 28,A03,889572,Lamey; Andy M.,0,1,30,30
1746577359367,PHIL 35,A00,907839,Staff,13,0,15,2
1746577360391,PHIL 60,A00,889574,Staff,73,0,90,17
1746577361416,PHIL 101,A00,958004,Staff,12,0,15,3
1746577363478,PHIL 136,A00,889582,Fulkerson; Matthew Todd,26,0,45,19
1746577364506,PHIL 163,A01,889601,Staff,21,0,30,9
1746577364506,PHIL 163,B01,889606,Brandt; Reuven A,0,3,0,0
1746577365533,PHIL 164,A00,889610,Staff,16,0,30,14
1746577366559,PHIL 165,A00,889613,Staff,22,0,30,8
1746577367584,PHYS 1A,A00,886431,Staff,28,0,70,42
1746577368611,PHYS 1AL,001,886432,Tsai; Philbert S,1,2,30,29
1746577368611,PHYS 1AL,002,886436,Tsai; Philbert S,11,0,30,19
1746577369636,PHYS 1B,A00,886439,Staff,185,0,240,55
1746577370662,PHYS 1BL,001,886441,Tsai; Philbert S,0,4,30,30
1746577370662,PHYS 1BL,002,886444,Tsai; Philbert S,2,0,30,28
1746577371690,PHYS 1C,A00,896092,Arnold; Kam S,78,0,146,68
1746577372719,PHYS 1CL,001,886448,Tsai; Philbert S,0,0,30,30
1746577372719,PHYS 1CL,002,886449,Tsai; Philbert S,1,0,30,29
1746577372719,PHYS 1CL,003,886450,Tsai; Philbert S,16,0,30,14
1746577372719,PHYS 1CL,004,886451,Tsai; Philbert S,15,0,30,15
1746577373745,PHYS 2B,A01,886457,Staff,68,0,115,47
1746577374772,PHYS 2C,A01,886460,Shotwell; Brian,0,9,65,65
1746577375798,PHYS 2CL,A01,886467,Staff,0,4,28,28
1746577375798,PHYS 2CL,A02,886468,Staff,0,3,28,28
1746577376822,PHYS 2D,A01,886470,Staff,10,0,50,40
1746577377853,PHYS 4B,A01,886475,Grinstein; Benjamin,22,0,40,18
1746577378877,POLI 5,A00,891173,Desposato; Scott,7,0,25,18
1746577379902,POLI 5D,A01,891175,Staff,5,0,5,0
1746577379902,POLI 5D,B01,891178,Staff,5,0,5,0
1746577380927,POLI 11,A00,891179,Ferree; Karen E,2,0,35,33
1746577381953,POLI 12,A00,891180,Staff,16,0,30,14
1746577382977,POLI 27,A01,891182,Staff,12,0,75,63
1746577384001,POLI 30,A00,891183,Staff,8,0,50,42
1746577385029,POLI 100B,A00,891244,Staff,5,1,35,30
1746577386059,POLI 100I,A00,891247,Staff,7,0,30,23
1746577387089,POLI 104J,A00,891248,Nichter; Maysa,14,0,30,16
1746577388115,POLI 104U,A00,891250,Nichter; Maysa,1,0,30,29
1746577390167,POLI 110B,A00,891255,Wiens; David,19,0,25,6
1746577391196,POLI 112A,A00,891256,Wiens; David,6,0,25,19
1746577392221,POLI 114BR,A00,891261,Staff,19,0,30,11
1746577393250,POLI 117R,A00,891262,Forman; Fonna,0,6,50,50
1746577394275,POLI 118,A00,891264,Ingham; Sean,17,0,25,8
1746577395304,POLI 124A,A00,891265,Staff,18,0,20,2
1746577396336,POLI 125D,A00,891266,Nichter; Simeon C,2,0,25,23
1746577397364,POLI 126,A00,891268,Nichter; Simeon C,7,0,25,18
1746577398389,POLI 126AA,A00,891272,Staff,15,0,25,10
1746577399417,POLI 130AA,A00,891273,Staff,15,0,20,5
1746577400442,POLI 134AA,A00,891274,Staff,4,0,20,16
1746577402493,POLI 138,A00,891278,Staff,21,0,25,4
1746577403518,POLI 142K,A00,891280,Staff,10,0,25,15
1746577404544,POLI 142M,A00,891281,Gartzke; Erik,16,0,30,14
1746577405574,POLI 142P,A00,891284,Staff,20,0,30,10
1746577406598,POLI 143,A00,891285,Gartzke; Erik,12,0,30,18
1746577407627,POLI 153,A00,891286,Staff,19,0,20,1
1746577409685,POLI 175,A00,891290,Staff,15,0,20,5
1746577410709,PSYC 1,A00,890674,Steiner; Eric Tomas,0,11,45,45
1746577411735,PSYC 2,A00,890676,Albright; Thomas D,21,0,35,14
1746577412762,PSYC 3,A00,890679,Staff,17,0,20,3
1746577413787,PSYC 6,A00,959858,Staff,19,0,20,1
1746577414814,PSYC 60,A01,890684,Rickard; Timothy C.,0,5,45,45
1746577415842,PSYC 70,A01,890689,Geller; Emma Harlan,7,0,30,23
1746577416871,PSYC 71,A01,959860,Staff,21,0,25,4
1746577417901,PSYC 100,A00,890690,Lacefield; Katharine I,0,50,180,180
1746577418930,PSYC 102,A00,890695,Staff,18,0,40,22
1746577419958,PSYC 105,A00,890699,Geller; Emma Harlan,70,0,100,30
1746577420985,PSYC 106,A00,890701,Gorman; Michael R.,6,0,30,24
1746577422011,PSYC 108,A00,890704,Adrian; Julia Anna,0,28,50,50
1746577423038,PSYC 118,A01,890712,Staff,11,0,30,19
1746577424064,PSYC 124,A00,890716,Chapman; Eddie Nathaniel,25,0,60,35
1746577425094,PSYC 131,A00,890717,Anagnostaras; Stephan,0,7,80,80
1746577426123,PSYC 137,A00,890719,Winkielman; Piotr,0,11,30,30
1746577427147,PSYC 144,A00,890721,Adrian; Julia Anna,0,9,45,45
1746577428172,PSYC 162,A00,890805,Staff,0,0,75,75
1746577429200,PSYC 169,A00,890810,Staff,0,14,30,30
1746577430224,PSYC 172,A00,890814,Gorman; Michael R.,9,0,30,21
1746577431254,PSYC 181,A00,890818,Anagnostaras; Stephan,8,0,200,192
1746577432284,PSYC 184,A00,959861,Staff,164,0,175,11
1746577433311,PSYC 189,A00,890823,Staff,0,2,30,30
1746577434335,PSYC 191,A00,890884,Rickard; Timothy C.,0,12,35,35
1746577435361,PSYC 193,A00,890913,Staff,19,0,30,11
1746577435361,PSYC 193,B00,890914,Chapman; Eddie Nathaniel,24,0,30,6
1746577436387,PSYC 193L,A01,890918,Lowe; Angela Beth,20,0,30,10
1746577436387,PSYC 193L,B01,890921,Hurwitz; Ethan Scott,20,0,30,10
1746577436387,PSYC 193L,C01,890928,Staff,30,0,30,0
1746577437412,RELI 149,A00,886806,Rahimi; Babak,23,0,40,17
1746577438437,SE 9,A01,886814,Staff,7,0,20,13
1746577439464,SE 101B,A01,886816,Chadha; Mayank,4,0,35,31
1746577440490,SE 110B,A00,886818,Zhu; Qiang,4,0,75,71
1746577441516,SE 125,A01,886830,Staff,10,0,30,20
1746577442545,SE 130B,A01,886835,Staff,14,0,40,26
1746577443570,SE 131A,A01,886838,Krysl; Petr,34,0,55,21
1746577444596,SE 154,A00,886840,Staff,29,0,50,21
1746577445621,SE 164GS,A01,886849,Staff,6,0,20,14
1746577446647,SE 167GS,A01,886853,Staff,6,0,20,14
1746577447676,SIO 25,A01,890107,Staff,19,0,30,11
1746577448700,SIO 45,A00,890109,Cook; Geoffrey W,116,0,200,84
1746577449725,SIO 109R,A00,890110,Forman; Fonna,0,16,20,20
1746577450750,SIO 187,A01,890114,Kacev; David,15,0,40,25
1746577451775,SOCI 1,A01,890431,Thorpe; Charles Robert,14,0,30,16
1746577451775,SOCI 1,A02,890518,Thorpe; Charles Robert,30,0,30,0
1746577452803,SOCI 2,A01,957978,Staff,25,0,25,0
1746577452803,SOCI 2,A02,957979,Staff,23,0,25,2
1746577453831,SOCI 20,A01,890523,Calderon-Zaks; Michael Aar,21,0,30,9
1746577453831,SOCI 20,A02,890526,Calderon-Zaks; Michael Aar,29,0,30,1
1746577454862,SOCI 30,A01,890533,Pardo Guerra; Juan Pablo,37,0,40,3
1746577455887,SOCI 40,A01,890535,Staff,27,0,45,18
1746577456915,SOCI 104Q,A00,890559,Staff,18,0,30,12
1746577457945,SOCI 106,A00,890560,Arnal; Maud Marie Leonie,20,0,30,10
1746577458970,SOCI 110,A00,890567,Holkenbrink-Monk; Charlene,19,0,30,11
1746577459998,SOCI 112,A00,890568,Victoria Torres; Pablo,2,0,55,53
1746577461026,SOCI 115,A00,890597,Arnal; Maud Marie Leonie,28,0,45,17
1746577463077,SOCI 121,A00,890604,Pardo Guerra; Juan Pablo,38,0,45,7
1746577464105,SOCI 126,A01,890608,Staff,8,0,10,2
1746577465134,SOCI 127,A00,890609,Staff,18,0,30,12
1746577466159,SOCI 131,A00,890610,Thorpe; Charles Robert,37,0,45,8
1746577467187,SOCI 135,A00,890615,Payne; Christine Anna,13,0,45,32
1746577468212,SOCI 139,A00,890620,Staff,38,0,45,7
1746577469235,SOCI 148E,A00,890622,Calderon-Zaks; Michael Aar,36,0,45,9
1746577470262,SOCI 150,A00,890623,Kohler; Kristopher M.,31,0,45,14
1746577471286,SOCI 157,A00,890625,Jules-Rosette; Bennetta W.,18,0,20,2
1746577472311,SOCI 160,A00,890627,Payne; Christine Anna,21,0,45,24
1746577473336,SYN 1,A00,886855,Fish; Gwendolyn Anne,0,1,0,0
1746577473336,SYN 1,B00,906086,Fish; Gwendolyn Anne,0,2,0,2
1746577474360,SYN 2R,A00,886860,Staff,0,17,15,15
1746577474360,SYN 2R,B00,906106,Atkinson; Arthur Laird,0,16,15,15
1746577475388,SYN 100,A01,886866,Browne; Emily,0,28,20,20
1746577475388,SYN 100,B01,906128,Rock; Martin,0,5,20,20
1746577475388,SYN 100,C01,906140,Deavenport; James Cary,0,3,20,20
1746577475388,SYN 100,D01,907816,Deavenport; James Cary,0,5,20,20
1746577476416,TDAC 1,A00,890286,Walsh; Kim C.,8,0,20,12
1746577477442,TDAC 101,A00,890296,Basso; Beatrice,15,0,20,5
1746577478469,TDDE 131,A00,890297,Staff,47,0,50,3
1746577479495,TDDM 1,A00,890287,Weinberg; Sadie,25,0,30,5
1746577480522,TDGE 11,A00,890288,Fulton; Julia,138,0,200,62
1746577480522,TDGE 11,B00,890289,Castro; Robert Jess,184,0,200,16
1746577481551,TDGE 25,B00,957359,Walsh; Kim C.,5,0,20,15
1746577482580,TDGE 40,A01,890292,Power; Jade Yukana,27,0,30,3
1746577483605,TDGE 124,A00,890298,Havis; Allan,0,1,50,50
1746577484632,TDGE 131R,A00,890299,Burelle; Julie Sara Veronique,15,0,42,27
1746577485658,TDHT 101,A00,890300,Staff,10,0,20,10
1746577486682,TDHT 109,A01,890302,Anderson; Mysia Anyse,31,0,40,9
1746577487707,TDMV 1,A00,890293,Arcidiacono; Kristin,18,0,30,12
1746577488731,TDMV 2,A00,890294,Weinberg; Sadie,23,0,30,7
1746577489762,TDMV 3,A00,957878,Arcidiacono; Kristin,28,0,30,2
1746577491818,TDMV 138,A00,890304,Jun; Grace Shin Hae,25,0,40,15
1746577492846,TDMV 140,A00,890305,Corrales; Joseph Bernales,25,0,30,5
1746577493871,TDMV 142,A00,890307,Caligagan; Tony,32,0,40,8
1746577494898,TDMV 144,A00,890308,Camaya; Michelle Ann,25,0,30,5
1746577495923,TDPW 1,A00,890295,Stein; Deborah Isobel,3,0,20,17
1746577496953,USP 2,A01,890272,Lerner; Amy M,7,0,20,13
1746577497979,USP 3,A01,890274,Staff,12,0,30,18
1746577499006,USP 15,A01,890276,Sun; Feiyang,16,0,30,14
1746577500033,USP 25,A00,890277,Shenkman; Michael Thomas,18,0,25,7
1746577501061,USP 138,A00,890278,Staff,14,0,25,11
1746577502088,USP 143,A00,890279,Staff,22,0,70,48
1746577503113,USP 144,A00,890280,Chowdhury; Muhammed Zohir,16,0,30,14
1746577504140,USP 150,A00,890281,Boomhower; Matthew Charles,4,0,30,26
1746577505169,USP 151,A00,890282,Staff,16,0,20,4
1746577506196,USP 162,A00,890283,Andrews; Abigail Leslie,16,0,20,4
1746577507225,USP 168,A00,920477,Kwak; Nancy,0,0,5,5
1746577508256,USP 181,A00,890284,Staff,3,0,20,17
1746577509281,USP 191A,A00,890285,Staff,12,0,20,8
1746577510307,VIS 101,A00,886512,Staff,25,0,75,50
1746577511332,VIS 103,A00,886513,Cruz; Edwin Teddy,61,0,75,14
1746577512357,VIS 108,A00,886514,Staff,3,0,15,12
1746577513381,VIS 127P,A00,886515,Shen; Kuiyi,80,0,146,66
1746577514410,VIS 149,A00,886516,Yoldas; Pinar,0,0,15,15
1746577515435,VIS 164,A00,886526,Erdmann; Dean,19,0,22,3
1746577516463,VIS 194S,A00,886527,Staff,61,0,75,14
1746577517490,WCWP 10A,C00,886484,Martiniuk; Jill,12,0,15,3
1746577518521,WCWP 10B,A00,886490,Uriarte; Emma,0,0,15,15
1746577518521,WCWP 10B,B00,886491,Dhir; Simrita,8,0,15,7
1746577518521,WCWP 10B,C00,886492,Ornelas; Tricia,0,0,15,15
1746577519549,WCWP 100,A00,886494,Young; Mark T,0,6,15,15
1746577521696,AAS 10,A01,886199,Childs; Dennis R.,0,3,0,0
1746577522724,ANAR 104,A01,886940,Shtienberg; Gilad,27,0,30,3
1746577523750,ANAR 120,A00,886953,Staff,12,0,20,8
1746577524778,ANBI 148,A01,886955,Wilder; Linnea Lorene,30,0,40,10
1746577526831,ANSC 122,A00,886957,Staff,25,0,30,5
1746577527856,ANSC 150,A00,886958,Sloane; Julia Kathryn,2,0,15,13
1746577528887,ANSC 156,A00,886959,Jenkins; Janis A.,0,1,15,15
1746577529912,ANSC 180,A00,886960,Staff,11,0,17,6
1746577530940,ANSC 188,A00,886961,Jassal; Aftab,9,0,25,16
1746577531964,ANSC 190,A00,886962,Jassal; Aftab,14,0,25,11
1746577532992,ANSC 191,A00,886963,Staff,18,0,20,2
1746577534021,ANTH 3,A01,891689,Staff,17,0,20,3
1746577535046,ANTH 5,A00,886933,Semendeferi; Ekaterini,16,0,20,4
1746577536071,ANTH 10,A00,886934,Staff,0,12,30,30
1746577537096,ANTH 21,A01,886936,Staff,41,0,60,19
1746577538124,ANTH 23,A01,886938,Staff,92,0,100,8
1746577539150,ANTH 105,A00,886964,Stewart; Alexander B,84,0,100,16
1746577540174,ANTH 108,A00,886965,Pedersen; David,9,0,20,11
1746577541202,AWP 10,001,886147,Staff,0,0,0,0
1746577541202,AWP 10,002,886148,Staff,0,0,0,0
1746577541202,AWP 10,003,886149,Staff,0,0,0,0
1746577541202,AWP 10,004,886150,Staff,0,0,0,0
1746577541202,AWP 10,005,886151,Staff,0,0,0,0
1746577541202,AWP 10,006,886152,Staff,0,0,0,0
1746577541202,AWP 10,007,886153,Staff,0,0,0,0
1746577541202,AWP 10,008,886154,Staff,0,0,0,0
1746577541202,AWP 10,009,886155,Staff,0,0,0,0
1746577541202,AWP 10,010,886156,Staff,0,0,0,0
1746577541202,AWP 10,011,886158,Staff,0,0,0,0
1746577541202,AWP 10,012,886160,Staff,0,0,0,0
1746577541202,AWP 10,013,886161,Staff,0,0,0,0
1746577541202,AWP 10,014,886162,Staff,0,0,0,0
1746577541202,AWP 10,015,886163,Staff,0,0,0,0
1746577541202,AWP 10,016,886164,Staff,0,0,0,0
1746577541202,AWP 10,017,886165,Staff,0,0,0,0
1746577541202,AWP 10,018,886166,Staff,0,0,0,0
1746577541202,AWP 10,019,886168,Staff,0,0,0,0
1746577541202,AWP 10,020,886170,Staff,0,0,0,0
1746577541202,AWP 10,021,886172,Staff,0,0,0,0
1746577542234,AWP 10R,001,886173,Staff,0,1,0,0
1746577542234,AWP 10R,002,886174,Staff,0,1,0,0
1746577542234,AWP 10R,003,886175,Staff,0,0,0,0
1746577542234,AWP 10R,004,886176,Staff,0,0,0,0
1746577542234,AWP 10R,005,886177,Staff,0,0,0,0
1746577542234,AWP 10R,006,886178,Staff,0,0,0,0
1746577542234,AWP 10R,007,886179,Staff,0,0,0,0
1746577542234,AWP 10R,008,886181,Staff,0,0,0,0
1746577542234,AWP 10R,009,886182,Staff,0,0,0,0
1746577542234,AWP 10R,010,886183,Staff,0,0,0,0
1746577542234,AWP 10R,011,886184,Staff,0,0,0,0
1746577542234,AWP 10R,012,886185,Staff,0,0,0,0
1746577542234,AWP 10R,013,886186,Staff,0,0,0,0
1746577542234,AWP 10R,014,886187,Staff,0,0,0,0
1746577542234,AWP 10R,015,886188,Staff,0,0,0,0
1746577542234,AWP 10R,016,886189,Staff,0,0,0,0
1746577542234,AWP 10R,017,960532,Staff,0,0,0,0
1746577542234,AWP 10R,018,960533,Staff,0,0,0,0
1746577542234,AWP 10R,019,960534,Staff,0,0,0,0
1746577542234,AWP 10R,020,960538,Staff,0,0,0,0
1746577542234,AWP 10R,021,960540,Staff,0,0,0,0
1746577542234,AWP 10R,022,960541,Staff,0,0,0,0
1746577542234,AWP 10R,023,960542,Staff,0,0,0,0
1746577542234,AWP 10R,024,960544,Staff,0,0,0,0
1746577542234,AWP 10R,025,960545,Staff,0,0,0,0
1746577542234,AWP 10R,026,960548,Staff,0,0,0,0
1746577543259,AWP 102R,A00,886190,Staff,0,0,0,0
1746577543259,AWP 102R,B00,886191,Staff,0,0,0,0
1746577544286,BENG 100,A01,886193,Staff,17,0,30,13
1746577545314,BENG 122A,A01,886195,Hasty; Jeff M,13,0,30,17
1746577546342,BENG 166A,A00,886196,Sah; Robert Lie-Yuan,0,3,30,30
1746577547368,BENG 190,A00,958050,Khojah; Reem I,20,0,25,5
1746577548393,BIBC 102,A01,894320,Staff,0,0,46,46
1746577548393,BIBC 102,A02,894321,Staff,0,0,46,46
1746577548393,BIBC 102,A03,894344,Staff,6,0,46,40
1746577548393,BIBC 102,A04,894345,Staff,27,0,47,20
1746577549423,BICD 100R,A01,894365,Smith; Laurie,0,3,58,58
1746577549423,BICD 100R,A02,894366,Smith; Laurie,0,5,58,58
1746577549423,BICD 100R,A03,894367,Smith; Laurie,0,0,59,59
1746577549423,BICD 100R,A04,959869,Smith; Laurie,40,0,59,19
1746577550449,BICD 136,A01,894383,Gustafson-Brown; Cindy,14,0,50,36
1746577551478,BIEB 102,A01,894494,Butler; Shannon Rhey,51,0,130,79
1746577553530,BIEB 150,A01,894617,Wills; Christopher,3,0,20,17
1746577553530,BIEB 150,A02,894631,Wills; Christopher,3,0,20,17
1746577553530,BIEB 150,A03,894937,Wills; Christopher,3,0,20,17
1746577553530,BIEB 150,A04,894946,Wills; Christopher,5,0,20,15
1746577554557,BIEB 194,A00,906141,Kurle; Carolyn M.,6,0,20,14
1746577555584,BILD 1,A01,894154,Staff,3,0,19,16
1746577555584,BILD 1,A02,894155,Staff,14,0,19,5
1746577555584,BILD 1,A03,894160,Staff,13,0,19,6
1746577555584,BILD 1,A04,894161,Staff,15,0,18,3
1746577556641,BILD 2,A01,894168,Staff,0,0,50,50
1746577556641,BILD 2,A02,894169,Staff,0,0,50,50
1746577556641,BILD 2,A03,894179,Staff,0,0,50,50
1746577556641,BILD 2,A04,894203,Staff,24,0,50,26
1746577557672,BILD 3,A01,894213,Staff,23,0,31,8
1746577557672,BILD 3,A02,894214,Staff,26,0,31,5
1746577557672,BILD 3,A03,894235,Staff,28,0,31,3
1746577557672,BILD 3,A04,894236,Staff,28,0,32,4
1746577558768,BILD 4,A01,894253,Reuther; Keefe,5,0,24,19
1746577558768,BILD 4,A02,894258,Reuther; Keefe,16,0,24,8
1746577559800,BILD 5,A01,894276,Reuther; Keefe,35,0,50,15
1746577559800,BILD 5,A02,894277,Reuther; Keefe,45,0,50,5
1746577559800,BILD 5,A03,894290,Reuther; Keefe,44,0,50,6
1746577559800,BILD 5,A04,894291,Reuther; Keefe,48,0,50,2
1746577560826,BILD 24,A01,894297,Pirino; Giorgia,40,0,60,20
1746577561851,BIMM 100,B01,958915,Staff,71,0,100,29
1746577562876,BIMM 101,A01,895017,McDonnell; Lisa Marie,0,5,24,24
1746577562876,BIMM 101,A02,895018,McDonnell; Lisa Marie,0,5,24,24
1746577562876,BIMM 101,B01,895020,McDonnell; Lisa Marie,0,6,24,24
1746577562876,BIMM 101,B02,895021,McDonnell; Lisa Marie,0,4,24,24
1746577563902,BIMM 110,A01,895023,Staff,1,0,25,24
1746577563902,BIMM 110,A02,895024,Staff,9,0,25,16
1746577563902,BIMM 110,A03,895025,Staff,18,0,25,7
1746577563902,BIMM 110,A04,895031,Staff,20,0,25,5
1746577564928,BIMM 120,A01,895114,Gustafson-Brown; Cindy,14,0,28,14
1746577564928,BIMM 120,A02,895126,Gustafson-Brown; Cindy,21,0,27,6
1746577565957,BIPN 100,A01,895130,Yang; Mingyu,0,0,38,38
1746577565957,BIPN 100,A02,895131,Yang; Mingyu,32,0,38,6
1746577565957,BIPN 100,A03,895132,Yang; Mingyu,32,0,38,6
1746577565957,BIPN 100,A04,895133,Yang; Mingyu,27,0,36,9
1746577566983,BIPN 120,A01,895135,Cooke; James Edward,0,3,13,13
1746577566983,BIPN 120,A02,895136,Cooke; James Edward,0,1,13,13
1746577566983,BIPN 120,A03,895137,Cooke; James Edward,0,3,13,13
1746577566983,BIPN 120,A04,895156,Cooke; James Edward,0,2,11,11
1746577568009,BIPN 134,A01,895235,Cooke; James Edward,0,2,25,25
1746577568009,BIPN 134,A02,895237,Cooke; James Edward,0,0,25,25
1746577568009,BIPN 134,A03,895240,Cooke; James Edward,3,0,25,22
1746577568009,BIPN 134,A04,895270,Cooke; James Edward,20,0,25,5
1746577569034,BIPN 189,A00,892103,Staff,0,14,14,14
1746577571089,BISP 194,A00,958008,Staff,0,2,0,0
1746577572112,CAT 124,A01,922009,Staff,0,5,20,20
1746577573144,CAT 125R,A00,886390,Morales; Celeste Georgianna,0,2,20,20
1746577573144,CAT 125R,B00,886391,Irwin; Matthew Joseph,0,4,20,20
1746577573144,CAT 125R,C00,886392,Smith; Lauryn Alissa,0,2,20,20
1746577573144,CAT 125R,D00,886393,Vanderschuit; Maya Alysia,0,3,20,20
1746577573144,CAT 125R,E00,886394,Marchisotto; Jennifer Anne,0,3,20,20
1746577574174,CENG 15,A01,886218,Drews; Aaron,3,0,8,5
1746577575200,CENG 113,A00,886219,Opatkiewicz; Justin Paul,15,0,25,10
1746577576225,CGS 101,A00,887044,Staff,7,0,20,13
1746577577251,CGS 105,A01,887046,Staff,14,0,25,11
1746577578277,CGS 112,A00,887047,Cuong; Marisol,12,0,15,3
1746577579302,CGS 113,A00,887048,Staff,23,0,30,7
1746577580330,CGS 120,A00,887049,Staff,10,0,17,7
1746577581355,CHEM 6A,A01,886336,Lam; Tin Yiu,38,0,50,12
1746577581355,CHEM 6A,A02,886338,Lam; Tin Yiu,37,0,50,13
1746577582386,CHEM 6B,A01,886341,Hopkins; Patrycja Anna,16,0,50,34
1746577582386,CHEM 6B,A02,886343,Hopkins; Patrycja Anna,42,0,50,8
1746577583416,CHEM 6C,A01,886346,Albizati; Kim F.,0,2,50,50
1746577583416,CHEM 6C,A02,886348,Albizati; Kim F.,23,0,50,27
1746577584445,CHEM 40A,A01,886352,Klosterman; Jeremy K,65,0,100,35
1746577585469,CHEM 40B,A01,886356,Klosterman; Jeremy K,0,23,100,100
1746577586498,CHEM 41B,A01,886360,Theodorakis; Emmanuel,25,0,50,25
1746577586498,CHEM 41B,A02,886362,Theodorakis; Emmanuel,47,0,50,3
1746577587524,CHIN 165A,A00,886382,Xu; Li,18,0,20,2
1746577588553,CLAS 120,A00,886387,Myerston Santana; Jacobo,33,0,40,7
1746577589581,COGS 9,A01,886967,Shannon; Kyle Michael,42,0,60,18
1746577590610,COGS 11,A01,886969,Staff,9,0,30,21
1746577591635,COGS 14A,A01,886971,Staff,6,0,60,54
1746577592664,COGS 14B,A01,886973,Hoffman; Drew Ellen,4,0,60,56
1746577593691,COGS 18,A01,886975,Morgan; Eric,34,0,60,26
1746577594715,COGS 20,A01,886977,Staff,4,0,8,4
1746577594715,COGS 20,A02,886978,Staff,5,0,7,2
1746577595741,COGS 100,A01,907783,Staff,1,2,30,29
1746577596767,COGS 101B,A01,886980,Staff,0,4,48,48
1746577597793,COGS 101C,A01,886982,Delgado; Tania,0,5,44,44
1746577598822,COGS 102A,A01,886984,Johnson; Christine M.,4,0,30,26
1746577599850,COGS 118B,A01,886986,Staff,1,4,88,87
1746577600877,COGS 150,A01,886988,Bergen; Benjamin,22,0,50,28
1746577601905,COGS 153,A00,886989,Delgado; Tania,0,2,41,41
1746577602935,COGS 186,A01,886991,Staff,0,0,32,32
1746577603959,COGS 187A,A01,886993,Boyle; Mary E. T.,7,0,30,23
1746577604990,COGS 189,A00,886994,Staff,0,1,30,30
1746577606017,COMM 10,A01,886996,Staff,0,0,20,21
1746577606017,COMM 10,A02,886997,Staff,10,0,20,10
1746577606017,COMM 10,A03,959845,Staff,19,0,20,1
1746577607042,COMM 20,A01,886999,Leuning; Grant Maurstad,24,0,40,16
1746577609134,COMM 100A,A01,887002,Staff,0,0,20,25
1746577609134,COMM 100A,A02,887003,Staff,6,0,20,14
1746577610162,COMM 100B,A01,887005,Staff,0,8,20,24
1746577611190,COMM 106D,A00,887006,Staff,13,0,40,27
1746577612215,COMM 110G,A00,887007,Whitworth-Smith; Andrew C,12,0,40,28
1746577613243,COMM 111B,A00,887008,Staff,31,0,40,9
1746577614278,COMM 113T,A00,887009,Abuelhiga; Soraya Jill,28,0,40,12
1746577614278,COMM 113T,B00,906733,Staff,40,0,40,0
1746577615307,COMM 145,A00,887010,Staff,12,0,40,28
1746577616334,COMM 146,A00,887054,Staff,31,0,40,9
1746577617359,COMM 190,A00,887012,Staff,8,0,23,15
1746577618384,CSE 8A,A50,887015,Cao; Yingjun,57,0,85,28
1746577619413,CSE 11,A01,887017,Cao; Yingjun,12,0,70,58
1746577620442,CSE 20,A01,887019,Staff,30,0,50,20
1746577621467,CSE 21,A01,887021,Staff,78,0,100,22
1746577621467,CSE 21,B01,892583,Braun; Oliver,45,0,50,5
1746577622492,CSE 30,A01,887025,Eldon; John,143,0,200,57
1746577623517,CSE 100,A01,887027,Staff,26,0,50,24
1746577623517,CSE 100,A02,887028,Staff,42,0,50,8
1746577624547,CSE 101,A01,887030,Braun; Oliver,74,0,100,26
1746577624547,CSE 101,B01,887032,Jones; Miles E,0,3,50,50
1746577624547,CSE 101,B02,887033,Jones; Miles E,0,2,50,50
1746577625573,CSE 105,A01,908084,Jones; Miles E,32,0,50,18
1746577625573,CSE 105,A02,908087,Jones; Miles E,31,0,50,19
1746577626602,CSE 135,A01,887035,Powell; Thomas Allan,0,5,50,50
1746577627627,CSE 142,A01,887037,Staff,8,0,60,52
1746577628656,CSE 142L,A01,887039,Staff,34,0,60,26
1746577629681,CSE 151A,A01,887041,Solares; Edwin A,47,0,100,53
1746577630709,CSE 175,A01,887043,Kumar; Rakesh,30,0,30,0
1746577631735,CSS 1,A01,886389,Staff,1,2,40,39
1746577632762,DSC 30,A01,908097,Liao; Soohyun Nam,47,0,75,28
1746577633787,DSC 40A,A01,908099,Shannon; Kyle Michael,30,0,50,20
1746577634817,DSC 40B,A01,908112,Staff,15,0,50,35
1746577635846,DSC 80,A01,908116,Staff,19,0,60,41
1746577636871,DSC 197,001,956863,Eldridge; Justin Matthew,9999,0,9999,0
1746577637913,ECE 5,A01,886400,Morris; Karcher William,1,0,6,5
1746577637913,ECE 5,A02,886401,Morris; Karcher William,3,0,6,3
1746577638938,ECE 148,A01,886403,Silberman; Jack,0,14,14,14
1746577639963,ECON 1,A01,887265,Crane; Meredith Helen,12,0,70,58
1746577639963,ECON 1,B01,887268,Staff,42,0,50,8
1746577640988,ECON 2,A01,887273,Crane; Meredith Helen,55,0,70,15
1746577642015,ECON 3,A01,887279,Rondina; Giacomo,32,0,70,38
1746577643040,ECON 4,A01,887282,Anderson; John Charles,0,2,10,10
1746577644067,ECON 5,A01,887285,Staff,34,0,45,11
1746577644067,ECON 5,B01,887292,Staff,41,0,45,4
1746577645092,ECON 100A,A01,887337,Newhouse; Herbert S,54,0,70,16
1746577645092,ECON 100A,B01,887349,Staff,45,0,50,5
1746577646118,ECON 100B,A01,887361,Du; Songzi,29,0,70,41
1746577647146,ECON 100C,A01,887445,Newhouse; Herbert S,59,0,70,11
1746577648173,ECON 105,A00,887488,Vespa; Emanuel Ignacio,23,0,35,12
1746577649200,ECON 109,A01,887506,Shishkin; Denis,28,0,35,7
1746577650230,ECON 110A,A01,887568,Alon; Titan Michael,0,3,35,35
1746577650230,ECON 110A,B01,907601,Alon; Titan Michael,20,0,35,15
1746577651257,ECON 110B,A01,887598,Levkoff; Steven B.,0,24,70,70
1746577652283,ECON 112,A00,887599,Rondina; Giacomo,19,0,35,16
1746577653309,ECON 120A,A01,887603,Dai; Yinlin,35,0,70,35
1746577654335,ECON 120C,A01,887608,Sun; Yixiao,0,1,35,35
1746577654335,ECON 120C,B01,887614,Sun; Yixiao,0,0,35,35
1746577655363,ECON 138,A00,887621,Bharadwaj; Prashant,0,21,20,20
1746577656391,ECON 144,A00,958007,Squires; Dale E,12,0,35,23
1746577657416,ECON 171,A01,907666,Staff,18,0,35,17
1746577658442,ECON 175,A00,887626,Wu; Pak Yeung,22,0,35,13
1746577659469,ECON 190,A00,887640,Vespa; Emanuel Ignacio,22,0,35,13
1746577660504,EDS 25,A01,888197,Staff,0,0,0,0
1746577660504,EDS 25,A02,888209,Staff,0,0,0,0
1746577660504,EDS 25,A03,888210,Staff,0,0,0,0
1746577660504,EDS 25,A04,888212,Staff,0,0,0,0
1746577660504,EDS 25,A05,888213,Staff,0,0,0,0
1746577660504,EDS 25,A06,888214,Staff,0,0,0,0
1746577660504,EDS 25,A07,888235,Staff,0,2,0,0
1746577660504,EDS 25,A08,888236,Staff,0,0,0,0
1746577660504,EDS 25,A09,888240,Staff,0,0,0,0
1746577660504,EDS 25,A10,888244,Staff,0,0,0,0
1746577660504,EDS 25,B01,888273,Staff,0,0,0,0
1746577660504,EDS 25,B02,888285,Staff,0,0,0,0
1746577660504,EDS 25,B03,888423,Staff,0,0,0,1
1746577660504,EDS 25,B04,888432,Staff,0,0,0,0
1746577660504,EDS 25,B05,888433,Staff,0,0,0,0
1746577660504,EDS 25,B06,888467,Staff,0,0,0,0
1746577660504,EDS 25,B07,888468,Staff,0,0,0,0
1746577660504,EDS 25,B08,888479,Staff,0,0,0,0
1746577660504,EDS 25,B09,888484,Staff,0,0,0,0
1746577660504,EDS 25,B10,888487,Staff,0,0,0,0
1746577661529,EDS 38,A01,907700,Choi; Bailey Miyeon,30,0,30,0
1746577662557,EDS 112,A01,888601,Chapman; Thandeka K,12,0,40,28
1746577663593,EDS 115,A00,888697,Mendez; Kathrina Mendoza,10,0,30,20
1746577664619,EDS 116,A01,888893,Staff,34,0,40,6
1746577666674,EDS 124AR,A00,889133,Staff,29,0,50,21
1746577666674,EDS 124AR,B00,907471,Simon; Elizabeth A,37,0,50,13
1746577667700,EDS 124BR,A00,889134,Simon; Elizabeth A,44,0,100,56
1746577668726,EDS 125,A00,889135,Staff,25,0,30,5
1746577669752,EDS 126,A01,889138,Staff,35,0,40,5
1746577670776,EDS 164R,A01,889142,Wishard Guerra; Alison G.,33,0,50,17
1746577671806,ENG 30,A01,886396,Staff,0,0,0,0
1746577671806,ENG 30,B01,886398,Staff,0,0,0,0
1746577672834,ENVR 102,A00,906150,Montejo; Carolina,23,0,25,2
1746577673858,ETHN 103A,A00,887236,Man; Simeon S,0,3,0,0
1746577674883,ETHN 113,A00,887239,Staff,16,0,30,14
1746577675907,ETHN 116,A00,887240,Staff,16,0,25,9
1746577676933,ETHN 117,A00,887241,Choi; Esther Min,28,0,30,2
1746577677960,ETHN 118,A00,887243,Staff,24,0,30,6
1746577678985,ETHN 127,A00,887248,Cuong; Marisol,11,0,15,4
1746577680015,ETHN 139,A00,887250,Staff,7,0,10,3
1746577681042,ETHN 142,A00,887252,Staff,10,0,30,20
1746577682071,ETHN 161,A00,887253,Browne; Errol Tsekani,24,0,30,6
1746577683098,ETHN 163FR,A00,887255,Burelle; Julie Sara Veronique,0,0,5,5
1746577684123,GLBH 20,A00,889149,Elwardani; Nile Regina,8,0,42,34
1746577686178,GLBH 111,A01,889152,Burgos; Jose L.,17,0,17,0
1746577687204,GLBH 150,A00,889181,Sloane; Julia Kathryn,0,5,15,15
1746577689260,HDS 60,A01,886406,Warstadt; Melissa Fawn,73,0,80,7
1746577690286,HIAF 111,A00,889324,Gyamfi; Bright,25,0,32,7
1746577691311,HIEA 131,A00,889328,Staff,15,0,32,17
1746577692337,HIEA 144,A00,889333,Henry; Todd A.,26,0,32,6
1746577693366,HIEA 154,A00,889336,Henry; Todd A.,24,0,32,8
1746577694391,HIEU 106,A00,889339,Staff,22,0,32,10
1746577696444,HIEU 114,A00,889340,Staff,4,0,32,28
1746577697468,HIEU 135GS,A00,889342,Patterson; Patrick H.,0,0,1,24
1746577698495,HIEU 137,A00,889343,Edington; Claire Ellen,10,0,25,15
1746577699519,HIEU 148,A00,889345,Staff,14,0,32,18
1746577700544,HIEU 154,A00,889346,Biess; Frank Peter,21,0,32,11
1746577701570,HILA 102,A00,889351,Staff,12,0,32,20
1746577702600,HILD 2A,A01,889221,Lewandoski; Julia Mavis,1,10,32,31
1746577703628,HILD 7B,A01,889225,Man; Simeon S,0,12,32,32
1746577704658,HILD 7C,A01,889288,Alvarez; Luis A,0,14,32,32
1746577705683,HILD 30,A01,889323,Staff,0,5,32,32
1746577707736,HISC 119,A00,889383,Golan; Tal,19,0,32,13
1746577708764,HIUS 103,A00,889384,Man; Simeon S,0,0,32,32
1746577709789,HIUS 117,A00,919797,Kwak; Nancy,19,0,32,13
1746577710813,HIUS 142A,A00,919788,Staff,22,0,32,10
1746577712906,HIUS 149,A00,889386,Gyamfi; Bright,26,0,32,6
1746577713932,HIUS 155,A00,889387,Alvarez; Luis A,15,0,32,17
1746577714960,HUM 3,A01,886499,Caldwell; Michael Alan,19,0,50,31
1746577715988,HUM 3GS,A00,886500,Rodriguez; Bretton Sigfred,0,0,0,28
1746577717013,HUM 3R,A01,886502,Markman; Kristina,0,36,50,50
1746577718042,HUM 4,A01,886504,Crum; Matthew Stephen,23,0,50,27
1746577718042,HUM 4,B01,886506,West; Geoffrey Scott,17,0,50,33
1746577719067,HUM 4GS,A00,886507,Staff,0,0,0,19
1746577720094,HUM 5,A01,886509,Staff,32,0,50,18
1746577721118,HUM 5R,A01,886511,Zavodny; Tatiana Sophia,0,39,50,50
1746577722144,JAPN 180,A00,886407,Staff,16,0,40,24
1746577723176,LATI 50,A01,886409,Martin-Cabrera; Luis,3,0,22,19
1746577723176,LATI 50,A02,886410,Martin-Cabrera; Luis,19,0,22,3
1746577723176,LATI 50,A03,886411,Martin-Cabrera; Luis,21,0,22,1
1746577723176,LATI 50,A04,886412,Martin-Cabrera; Luis,8,0,22,14
1746577724203,LAWS 101,A00,907664,Staff,28,0,60,32
1746577725228,LIAB 1A,A00,889388,Saab; Dima,17,0,20,3
1746577726254,LIAB 1AX,A00,889389,El Cheddadi; Youniss,18,0,20,2
1746577727280,LIFR 1C,A00,889391,Van Moer; Vinciane G,8,0,20,12
1746577728307,LIFR 1CX,A00,889392,Van Moer; Vinciane G,7,0,20,13
1746577729334,LIFR 1D,A00,889393,Van Moer; Vinciane G,7,0,20,13
1746577730360,LIFR 1DX,A00,889394,Van Moer; Vinciane G,8,0,20,12
1746577731385,LIGN 7,A00,886923,Staff,24,0,50,26
1746577732414,LIGN 17,A00,886924,Kehler; Andrew Scott,125,0,150,25
1746577733442,LTAM 110,A00,889395,Staff,15,0,30,15
1746577734465,LTAM 110GS,A00,958010,Rodriguez; Bretton Sigfred,0,0,0,28
1746577735490,LTCH 101,A00,889397,Staff,23,0,25,2
1746577736515,LTCS 130,A00,889398,Staff,23,0,25,2
1746577737544,LTEA 138,A00,889399,Staff,24,0,40,16
1746577738572,LTEN 149,A00,889400,Wesling; Megan E.,0,3,25,25
1746577739598,LTEN 169,A00,889401,Staff,20,0,25,5
1746577740624,LTEN 180,A00,889402,Staff,10,0,15,5
1746577741653,LTEN 181,A00,889403,Staff,21,0,25,4
1746577742682,LTWL 100,A00,889404,Myerston Santana; Jacobo,2,0,25,23
1746577743706,LTWL 180GS,A00,889405,Staff,0,0,20,20
1746577744734,LTWL 181,A00,889406,Staff,16,0,25,9
1746577745762,LTWL 184,A00,889475,Mukherjee; Silpa,22,0,25,3
1746577746788,LTWR 102C,A00,889486,Staff,29,0,30,1
1746577747812,LTWR 115W,A00,889491,Staff,0,2,15,15
1746577748837,MAE 8,A01,886905,Staff,0,2,0,0
1746577749867,MAE 11,A00,886906,Bandaru; Prabhakar,0,7,50,50
1746577750895,MAE 20,A00,886907,Evdokimenko; Ekaterina,43,0,70,27
1746577751920,MAE 30B,A00,886909,Ghazinejad; Maziar,26,0,45,19
1746577752947,MAE 101B,A00,886910,Saintillan; David,29,0,45,16
1746577753971,MAE 105,A00,886911,Bandaru; Prabhakar,18,0,50,32
1746577755002,MAE 107,B00,958024,Staff,8,0,50,42
1746577756031,MAE 143B,A00,886913,Bewley; Thomas R,4,0,40,36
1746577757058,MAE 148,A01,886915,Silberman; Jack,0,3,14,14
1746577758083,MAE 160,A00,886916,Evdokimenko; Ekaterina,31,0,60,29
1746577759107,MATH 3C,A01,889681,Staff,0,2,30,30
1746577759107,MATH 3C,A02,960048,Staff,24,0,30,6
1746577760137,MATH 10A,A01,889760,Staff,26,0,30,4
1746577760137,MATH 10A,A02,889783,Staff,29,0,30,1
1746577761166,MATH 10B,A01,889785,Verstraete; Jacques Allan,2,0,35,33
1746577761166,MATH 10B,A02,889795,Verstraete; Jacques Allan,4,0,35,31
1746577761166,MATH 10B,B01,889797,Verstraete; Jacques Allan,3,0,35,32
1746577761166,MATH 10B,B02,889828,Verstraete; Jacques Allan,3,0,35,32
1746577762200,MATH 10C,A01,889849,Habib; Yousaf,7,0,30,23
1746577762200,MATH 10C,A02,889852,Habib; Yousaf,14,0,30,16
1746577762200,MATH 10C,A03,889853,Habib; Yousaf,22,0,30,8
1746577762200,MATH 10C,A04,889858,Habib; Yousaf,20,0,30,10
1746577762200,MATH 10C,B01,889861,Staff,1,0,30,29
1746577762200,MATH 10C,B02,889862,Staff,24,0,30,6
1746577762200,MATH 10C,B03,889863,Staff,27,0,30,3
1746577762200,MATH 10C,B04,889967,Staff,23,0,30,7
1746577763231,MATH 18,A01,889974,Staff,7,0,30,23
1746577763231,MATH 18,A02,889977,Staff,20,0,30,10
1746577763231,MATH 18,B01,889984,Hardiman; Liam,20,0,30,10
1746577763231,MATH 18,B02,889985,Hardiman; Liam,25,0,30,5
1746577764260,MATH 20A,A01,889990,Suk; Andrew Hoon,30,0,35,5
1746577765288,MATH 20B,A01,889993,Ohm; Ko Woon,22,0,30,8
1746577765288,MATH 20B,A02,889994,Ohm; Ko Woon,30,0,30,0
1746577765288,MATH 20B,B01,889996,Ohm; Ko Woon,22,0,30,8
1746577765288,MATH 20B,B02,889997,Ohm; Ko Woon,23,0,30,7
1746577766316,MATH 20C,A01,889999,Hammock; Frances H,17,0,30,13
1746577766316,MATH 20C,A02,890003,Hammock; Frances H,23,0,30,7
1746577766316,MATH 20C,B01,890006,Hammock; Frances H,3,0,30,27
1746577766316,MATH 20C,B02,890007,Hammock; Frances H,12,0,30,18
1746577767348,MATH 20D,A01,890011,Cheng; Hsiao-Bing,1,1,30,29
1746577767348,MATH 20D,A02,890012,Cheng; Hsiao-Bing,14,0,30,16
1746577767348,MATH 20D,B01,890016,Cheng; Hsiao-Bing,13,0,30,17
1746577767348,MATH 20D,B02,890017,Cheng; Hsiao-Bing,13,0,30,17
1746577768379,MATH 20E,A01,890026,Harel; Guershon,1,0,30,29
1746577768379,MATH 20E,A02,890029,Harel; Guershon,23,0,30,7
1746577768379,MATH 20E,B01,890033,Harel; Guershon,7,0,30,23
1746577768379,MATH 20E,B02,890101,Harel; Guershon,21,0,30,9
1746577769406,MATH 102,A01,890104,Staff,17,0,30,13
1746577769406,MATH 102,A02,890105,Staff,27,0,30,3
1746577770432,MATH 103B,A01,890116,Salehi Golsefidy; Alireza,3,0,30,27
1746577770432,MATH 103B,B01,890118,Staff,0,3,34,34
1746577771460,MATH 109,A01,890121,Aliabadi Sr.; Mohsen,1,0,30,29
1746577771460,MATH 109,B01,890124,Upadrashta; Pranav Kumar,18,0,30,12
1746577772489,MATH 120A,A01,890126,Eggers; John Dietrich,13,0,30,17
1746577773514,MATH 142B,A01,890128,Ioana; Adrian,19,0,30,11
1746577773514,MATH 142B,A02,890129,Ioana; Adrian,13,0,30,17
1746577774539,MATH 154,A01,890174,Staff,0,0,30,30
1746577774539,MATH 154,A02,890182,Staff,0,0,30,30
1746577775567,MATH 168A,A01,890197,Dumitriu; Ioana,21,0,35,14
1746577776595,MATH 170A,A01,890240,Nie; Jiawang,1,0,30,29
1746577776595,MATH 170A,A02,890241,Nie; Jiawang,11,0,30,19
1746577776595,MATH 170A,A03,890249,Nie; Jiawang,23,0,30,7
1746577777624,MATH 170B,A01,957891,Nag; Panchali,13,0,35,22
1746577779676,MATH 181A,A01,908025,Staff,0,3,35,35
1746577779676,MATH 181A,A02,960115,Staff,26,0,35,9
1746577780702,MATH 181B,A01,959874,Staff,25,0,30,5
1746577781731,MATH 193B,A01,890265,Staff,0,4,35,35
1746577782759,MGT 4,A01,890311,Anderson; John Charles,42,0,88,46
1746577783782,MGT 5,A00,907740,Staff,13,0,98,85
1746577784807,MGT 12,A00,890312,Lindenberger; Wade Douglas,67,0,98,31
1746577785835,MGT 16,A00,957883,Staff,78,0,98,20
1746577787886,MGT 45,A00,890314,Pecore; Joseph P.,45,0,98,53
1746577788912,MGT 71,A00,890315,Staff,0,12,98,98
1746577789939,MGT 100,A00,890316,Yavorsky; Daniel Ryan,44,0,98,54
1746577790965,MGT 103,A00,890317,Ehrich; Kristine R,73,0,98,25
1746577791989,MGT 105,A00,890356,Bates; Kenneth Walter,0,8,98,98
1746577793017,MGT 112,A00,890360,Ehrich; Kristine R,55,0,98,43
1746577794042,MGT 127R,A00,907732,Zhu; Kevin Xiaoguo,23,0,98,75
1746577795067,MGT 131B,A00,890361,Anderson; John Charles,59,0,98,39
1746577796096,MGT 137,A00,890362,Lindenberger; Wade Douglas,65,0,98,33
1746577797120,MGT 160,A00,890369,Johnson; Erik Barry,9,0,98,89
1746577799169,MGT 164,A00,890372,Zimmermann; Carsten,0,40,98,98
1746577800196,MGT 180,A00,890374,Bliss; Barbara Ann,12,0,98,86
1746577801228,MMW 15,A01,886414,Chang; Edmond Yi-Teh,0,12,28,28
1746577801228,MMW 15,A02,886415,Chang; Edmond Yi-Teh,0,8,28,28
1746577801228,MMW 15,A03,886416,Chang; Edmond Yi-Teh,0,9,28,28
1746577801228,MMW 15,A04,886417,Chang; Edmond Yi-Teh,0,8,28,28
1746577801228,MMW 15,B01,886419,Chang; Edmond Yi-Teh,0,7,28,28
1746577801228,MMW 15,B02,886420,Chang; Edmond Yi-Teh,0,8,28,28
1746577801228,MMW 15,B03,886421,Chang; Edmond Yi-Teh,0,7,28,28
1746577801228,MMW 15,B04,886422,Chang; Edmond Yi-Teh,0,8,28,28
1746577801228,MMW 15,C01,886424,Staff,0,9,28,28
1746577801228,MMW 15,C02,886425,Staff,0,8,28,28
1746577801228,MMW 15,C03,886426,Staff,0,8,28,28
1746577801228,MMW 15,C04,886427,Staff,0,8,28,28
1746577801228,MMW 15,C05,958038,Staff,0,8,28,28
1746577801228,MMW 15,C06,958039,Staff,1,8,28,27
1746577802254,MMW 15GS,A00,906910,Patterson; Patrick H.,4,0,28,24
1746577803281,MMW 122R,A01,886429,Rahimi; Babak,0,13,28,28
1746577803281,MMW 122R,A02,886430,Rahimi; Babak,0,12,28,28
1746577803281,MMW 122R,A03,958040,Rahimi; Babak,0,11,28,28
1746577804306,MUS 1A,A01,890937,Staff,2,0,25,23
1746577804306,MUS 1A,A02,891035,Staff,6,0,25,19
1746577804306,MUS 1A,C01,958912,Staff,24,0,25,1
1746577804306,MUS 1A,C02,958913,Staff,25,0,25,0
1746577806357,MUS 2AK,A00,957092,Ohnishi; Takae,15,0,15,0
1746577807385,MUS 4,A01,891044,Staff,1,0,25,24
1746577807385,MUS 4,A02,891045,Staff,23,0,25,2
1746577807385,MUS 4,B01,891048,Staff,17,0,25,8
1746577807385,MUS 4,B02,891050,Staff,25,0,25,0
1746577808412,MUS 5,A01,957506,Dubnov; Shlomo,0,0,25,25
1746577808412,MUS 5,A02,957622,Dubnov; Shlomo,13,0,25,12
1746577808412,MUS 5,A03,957623,Dubnov; Shlomo,20,0,25,5
1746577809437,MUS 6,A01,891053,Freitas Caetano; Marcelo,24,0,25,1
1746577809437,MUS 6,A02,891054,Freitas Caetano; Marcelo,23,0,25,2
1746577810466,MUS 7,A01,891081,Staff,1,0,25,24
1746577810466,MUS 7,A02,891082,Staff,3,0,25,22
1746577811491,MUS 8GS,A00,891118,Borgo; David Garcia,1,0,25,24
1746577812517,MUS 11,A01,891140,Staff,9,0,25,16
1746577812517,MUS 11,A02,891141,Staff,21,0,25,4
1746577813542,MUS 13,A01,891143,Staff,8,0,25,17
1746577813542,MUS 13,A02,891144,Staff,24,0,25,1
1746577814571,MUS 15,A01,891146,Staff,9,0,25,16
1746577814571,MUS 15,A02,891148,Staff,21,0,25,4
1746577814571,MUS 15,B01,891150,Staff,18,0,25,7
1746577814571,MUS 15,B02,891151,Staff,25,0,25,0
1746577815596,MUS 20,A01,891153,Staff,5,0,20,15
1746577815596,MUS 20,A02,891155,Staff,14,0,20,6
1746577816620,MUS 80,A00,891156,Staff,19,0,25,6
1746577816620,MUS 80,B00,891157,Staff,23,0,25,2
1746577817643,MUS 130,A00,891158,Ohnishi; Takae,35,0,35,0
1746577818669,MUS 150GS,A01,891160,Borgo; David Garcia,1,0,25,24
1746577819694,MUS 170,A01,891162,Freitas Caetano; Marcelo,20,0,25,5
1746577819694,MUS 170,A02,891164,Freitas Caetano; Marcelo,21,0,25,4
1746577820719,NANO 11,A00,886220,Vazquez Mena; Oscar,13,0,15,2
1746577821744,NANO 15,A01,886222,Drews; Aaron,4,0,7,3
1746577822770,NANO 104,A00,886224,Sirbuly; Donald,17,0,25,8
1746577823795,PH 40,A00,886528,Staff,24,0,40,16
1746577824824,PH 45,A01,886799,Staff,35,0,40,5
1746577825851,PH 110,A00,886802,Staff,0,7,40,40
1746577826878,PH 172,A00,906716,Staff,19,0,35,16
1746577827905,PH 191,A00,886803,Staff,6,0,40,34
1746577828929,PHIL 1,A00,889500,Staff,20,0,30,10
1746577829958,PHIL 10,A01,889549,Grush; Rick Scott,16,0,22,6
1746577829958,PHIL 10,A02,889551,Grush; Rick Scott,22,0,22,0
1746577830989,PHIL 28,A01,889559,Lamey; Andy M.,0,2,31,31
1746577830989,PHIL 28,A02,889561,Lamey; Andy M.,0,1,30,30
1746577830989,PHIL 28,A03,889572,Lamey; Andy M.,0,1,30,30
1746577832014,PHIL 35,A00,907839,Staff,13,0,15,2
1746577833041,PHIL 60,A00,889574,Staff,73,0,90,17
1746577834069,PHIL 101,A00,958004,Staff,12,0,15,3
1746577836118,PHIL 136,A00,889582,Fulkerson; Matthew Todd,26,0,45,19
1746577837144,PHIL 163,A01,889601,Staff,21,0,30,9
1746577837144,PHIL 163,B01,889606,Brandt; Reuven A,0,3,0,0
1746577838169,PHIL 164,A00,889610,Staff,16,0,30,14
1746577839192,PHIL 165,A00,889613,Staff,22,0,30,8
1746577840218,PHYS 1A,A00,886431,Staff,28,0,70,42
1746577841244,PHYS 1AL,001,886432,Tsai; Philbert S,1,2,30,29
1746577841244,PHYS 1AL,002,886436,Tsai; Philbert S,11,0,30,19
1746577842272,PHYS 1B,A00,886439,Staff,185,0,240,55
1746577843299,PHYS 1BL,001,886441,Tsai; Philbert S,0,4,30,30
1746577843299,PHYS 1BL,002,886444,Tsai; Philbert S,2,0,30,28
1746577844327,PHYS 1C,A00,896092,Arnold; Kam S,78,0,146,68
1746577845353,PHYS 1CL,001,886448,Tsai; Philbert S,0,0,30,30
1746577845353,PHYS 1CL,002,886449,Tsai; Philbert S,1,0,30,29
1746577845353,PHYS 1CL,003,886450,Tsai; Philbert S,16,0,30,14
1746577845353,PHYS 1CL,004,886451,Tsai; Philbert S,15,0,30,15
1746577846378,PHYS 2B,A01,886457,Staff,68,0,115,47
1746577847403,PHYS 2C,A01,886460,Shotwell; Brian,0,9,65,65
1746577848432,PHYS 2CL,A01,886467,Staff,0,4,28,28
1746577848432,PHYS 2CL,A02,886468,Staff,0,3,28,28
1746577849459,PHYS 2D,A01,886470,Staff,10,0,50,40
1746577850488,PHYS 4B,A01,886475,Grinstein; Benjamin,22,0,40,18
1746577851513,POLI 5,A00,891173,Desposato; Scott,7,0,25,18
1746577852537,POLI 5D,A01,891175,Staff,5,0,5,0
1746577852537,POLI 5D,B01,891178,Staff,5,0,5,0
1746577853565,POLI 11,A00,891179,Ferree; Karen E,2,0,35,33
1746577854593,POLI 12,A00,891180,Staff,16,0,30,14
1746577855620,POLI 27,A01,891182,Staff,12,0,75,63
1746577856647,POLI 30,A00,891183,Staff,8,0,50,42
1746577857676,POLI 100B,A00,891244,Staff,5,1,35,30
1746577858701,POLI 100I,A00,891247,Staff,7,0,30,23
1746577859726,POLI 104J,A00,891248,Nichter; Maysa,14,0,30,16
1746577860755,POLI 104U,A00,891250,Nichter; Maysa,1,0,30,29
1746577862812,POLI 110B,A00,891255,Wiens; David,19,0,25,6
1746577863838,POLI 112A,A00,891256,Wiens; David,6,0,25,19
1746577864866,POLI 114BR,A00,891261,Staff,19,0,30,11
1746577865890,POLI 117R,A00,891262,Forman; Fonna,0,6,50,50
1746577866916,POLI 118,A00,891264,Ingham; Sean,17,0,25,8
1746577867943,POLI 124A,A00,891265,Staff,18,0,20,2
1746577868968,POLI 125D,A00,891266,Nichter; Simeon C,2,0,25,23
1746577869997,POLI 126,A00,891268,Nichter; Simeon C,7,0,25,18
1746577871022,POLI 126AA,A00,891272,Staff,15,0,25,10
1746577872049,POLI 130AA,A00,891273,Staff,15,0,20,5
1746577873075,POLI 134AA,A00,891274,Staff,4,0,20,16
1746577875128,POLI 138,A00,891278,Staff,21,0,25,4
1746577876155,POLI 142K,A00,891280,Staff,10,0,25,15
1746577877183,POLI 142M,A00,891281,Gartzke; Erik,16,0,30,14
1746577878207,POLI 142P,A00,891284,Staff,20,0,30,10
1746577879234,POLI 143,A00,891285,Gartzke; Erik,12,0,30,18
1746577880259,POLI 153,A00,891286,Staff,19,0,20,1
1746577882311,POLI 175,A00,891290,Staff,15,0,20,5
1746577883336,PSYC 1,A00,890674,Steiner; Eric Tomas,0,11,45,45
1746577884365,PSYC 2,A00,890676,Albright; Thomas D,21,0,35,14
1746577885390,PSYC 3,A00,890679,Staff,17,0,20,3
1746577886413,PSYC 6,A00,959858,Staff,19,0,20,1
1746577887439,PSYC 60,A01,890684,Rickard; Timothy C.,0,5,45,45
1746577888467,PSYC 70,A01,890689,Geller; Emma Harlan,7,0,30,23
1746577889497,PSYC 71,A01,959860,Staff,21,0,25,4
1746577890522,PSYC 100,A00,890690,Lacefield; Katharine I,0,50,180,180
1746577891550,PSYC 102,A00,890695,Staff,18,0,40,22
1746577892575,PSYC 105,A00,890699,Geller; Emma Harlan,70,0,100,30
1746577893604,PSYC 106,A00,890701,Gorman; Michael R.,6,0,30,24
1746577894630,PSYC 108,A00,890704,Adrian; Julia Anna,0,28,50,50
1746577895656,PSYC 118,A01,890712,Staff,11,0,30,19
1746577896681,PSYC 124,A00,890716,Chapman; Eddie Nathaniel,25,0,60,35
1746577897707,PSYC 131,A00,890717,Anagnostaras; Stephan,0,7,80,80
1746577898735,PSYC 137,A00,890719,Winkielman; Piotr,0,11,30,30
1746577899764,PSYC 144,A00,890721,Adrian; Julia Anna,0,9,45,45
1746577900792,PSYC 162,A00,890805,Staff,0,0,75,75
1746577901820,PSYC 169,A00,890810,Staff,0,14,30,30
1746577902845,PSYC 172,A00,890814,Gorman; Michael R.,9,0,30,21
1746577903874,PSYC 181,A00,890818,Anagnostaras; Stephan,8,0,200,192
1746577904898,PSYC 184,A00,959861,Staff,164,0,175,11
1746577905927,PSYC 189,A00,890823,Staff,0,2,30,30
1746577906956,PSYC 191,A00,890884,Rickard; Timothy C.,0,12,35,35
1746577907981,PSYC 193,A00,890913,Staff,19,0,30,11
1746577907981,PSYC 193,B00,890914,Chapman; Eddie Nathaniel,24,0,30,6
1746577909006,PSYC 193L,A01,890918,Lowe; Angela Beth,20,0,30,10
1746577909006,PSYC 193L,B01,890921,Hurwitz; Ethan Scott,20,0,30,10
1746577909006,PSYC 193L,C01,890928,Staff,30,0,30,0
1746577910032,RELI 149,A00,886806,Rahimi; Babak,23,0,40,17
1746577911063,SE 9,A01,886814,Staff,7,0,20,13
1746577912088,SE 101B,A01,886816,Chadha; Mayank,4,0,35,31
1746577913117,SE 110B,A00,886818,Zhu; Qiang,4,0,75,71
1746577914144,SE 125,A01,886830,Staff,10,0,30,20
1746577915170,SE 130B,A01,886835,Staff,14,0,40,26
1746577916199,SE 131A,A01,886838,Krysl; Petr,34,0,55,21
1746577917223,SE 154,A00,886840,Staff,29,0,50,21
1746577918253,SE 164GS,A01,886849,Staff,6,0,20,14
1746577919281,SE 167GS,A01,886853,Staff,6,0,20,14
1746577920309,SIO 25,A01,890107,Staff,19,0,30,11
1746577921338,SIO 45,A00,890109,Cook; Geoffrey W,116,0,200,84
1746577922364,SIO 109R,A00,890110,Forman; Fonna,0,16,20,20
1746577923391,SIO 187,A01,890114,Kacev; David,15,0,40,25
1746577924415,SOCI 1,A01,890431,Thorpe; Charles Robert,14,0,30,16
1746577924415,SOCI 1,A02,890518,Thorpe; Charles Robert,30,0,30,0
1746577925442,SOCI 2,A01,957978,Staff,25,0,25,0
1746577925442,SOCI 2,A02,957979,Staff,23,0,25,2
1746577926470,SOCI 20,A01,890523,Calderon-Zaks; Michael Aar,21,0,30,9
1746577926470,SOCI 20,A02,890526,Calderon-Zaks; Michael Aar,29,0,30,1
1746577927497,SOCI 30,A01,890533,Pardo Guerra; Juan Pablo,37,0,40,3
1746577928523,SOCI 40,A01,890535,Staff,27,0,45,18
1746577929549,SOCI 104Q,A00,890559,Staff,18,0,30,12
1746577930580,SOCI 106,A00,890560,Arnal; Maud Marie Leonie,20,0,30,10
1746577931608,SOCI 110,A00,890567,Holkenbrink-Monk; Charlene,19,0,30,11
1746577932634,SOCI 112,A00,890568,Victoria Torres; Pablo,2,0,55,53
1746577933659,SOCI 115,A00,890597,Arnal; Maud Marie Leonie,28,0,45,17
1746577935714,SOCI 121,A00,890604,Pardo Guerra; Juan Pablo,38,0,45,7
1746577936742,SOCI 126,A01,890608,Staff,8,0,10,2
1746577937771,SOCI 127,A00,890609,Staff,18,0,30,12
1746577938797,SOCI 131,A00,890610,Thorpe; Charles Robert,37,0,45,8
1746577939822,SOCI 135,A00,890615,Payne; Christine Anna,13,0,45,32
1746577940847,SOCI 139,A00,890620,Staff,38,0,45,7
1746577941871,SOCI 148E,A00,890622,Calderon-Zaks; Michael Aar,36,0,45,9
1746577942896,SOCI 150,A00,890623,Kohler; Kristopher M.,31,0,45,14
1746577943924,SOCI 157,A00,890625,Jules-Rosette; Bennetta W.,18,0,20,2
1746577944950,SOCI 160,A00,890627,Payne; Christine Anna,21,0,45,24
1746577945975,SYN 1,A00,886855,Fish; Gwendolyn Anne,0,1,0,0
1746577945975,SYN 1,B00,906086,Fish; Gwendolyn Anne,0,2,0,2
1746577947004,SYN 2R,A00,886860,Staff,0,17,15,15
1746577947004,SYN 2R,B00,906106,Atkinson; Arthur Laird,0,16,15,15
1746577948029,SYN 100,A01,886866,Browne; Emily,0,28,20,20
1746577948029,SYN 100,B01,906128,Rock; Martin,0,5,20,20
1746577948029,SYN 100,C01,906140,Deavenport; James Cary,0,3,20,20
1746577948029,SYN 100,D01,907816,Deavenport; James Cary,0,5,20,20
1746577949058,TDAC 1,A00,890286,Walsh; Kim C.,8,0,20,12
1746577950086,TDAC 101,A00,890296,Basso; Beatrice,15,0,20,5
1746577951115,TDDE 131,A00,890297,Staff,47,0,50,3
1746577952142,TDDM 1,A00,890287,Weinberg; Sadie,25,0,30,5
1746577953171,TDGE 11,A00,890288,Fulton; Julia,138,0,200,62
1746577953171,TDGE 11,B00,890289,Castro; Robert Jess,184,0,200,16
1746577954197,TDGE 25,B00,957359,Walsh; Kim C.,5,0,20,15
1746577955225,TDGE 40,A01,890292,Power; Jade Yukana,27,0,30,3
1746577956253,TDGE 124,A00,890298,Havis; Allan,0,1,50,50
1746577957282,TDGE 131R,A00,890299,Burelle; Julie Sara Veronique,15,0,42,27
1746577958309,TDHT 101,A00,890300,Staff,10,0,20,10
1746577959337,TDHT 109,A01,890302,Anderson; Mysia Anyse,31,0,40,9
1746577960365,TDMV 1,A00,890293,Arcidiacono; Kristin,18,0,30,12
1746577961391,TDMV 2,A00,890294,Weinberg; Sadie,23,0,30,7
1746577962424,TDMV 3,A00,957878,Arcidiacono; Kristin,28,0,30,2
1746577964476,TDMV 138,A00,890304,Jun; Grace Shin Hae,25,0,40,15
1746577965502,TDMV 140,A00,890305,Corrales; Joseph Bernales,25,0,30,5
1746577966531,TDMV 142,A00,890307,Caligagan; Tony,32,0,40,8
1746577967559,TDMV 144,A00,890308,Camaya; Michelle Ann,25,0,30,5
1746577968584,TDPW 1,A00,890295,Stein; Deborah Isobel,3,0,20,17
1746577969610,USP 2,A01,890272,Lerner; Amy M,7,0,20,13
1746577970634,USP 3,A01,890274,Staff,12,0,30,18
1746577971660,USP 15,A01,890276,Sun; Feiyang,16,0,30,14
1746577972689,USP 25,A00,890277,Shenkman; Michael Thomas,18,0,25,7
1746577973717,USP 138,A00,890278,Staff,14,0,25,11
1746577974744,USP 143,A00,890279,Staff,22,0,70,48
1746577975770,USP 144,A00,890280,Chowdhury; Muhammed Zohir,16,0,30,14
1746577976796,USP 150,A00,890281,Boomhower; Matthew Charles,4,0,30,26
1746577977822,USP 151,A00,890282,Staff,16,0,20,4
1746577978849,USP 162,A00,890283,Andrews; Abigail Leslie,16,0,20,4
1746577979875,USP 168,A00,920477,Kwak; Nancy,0,0,5,5
1746577980898,USP 181,A00,890284,Staff,3,0,20,17
1746577981932,USP 191A,A00,890285,Staff,12,0,20,8
1746577982956,VIS 101,A00,886512,Staff,25,0,75,50
1746577983982,VIS 103,A00,886513,Cruz; Edwin Teddy,61,0,75,14
1746577985007,VIS 108,A00,886514,Staff,3,0,15,12
1746577986032,VIS 127P,A00,886515,Shen; Kuiyi,80,0,146,66
1746577987056,VIS 149,A00,886516,Yoldas; Pinar,0,0,15,15
1746577988088,VIS 164,A00,886526,Erdmann; Dean,19,0,22,3
1746577989113,VIS 194S,A00,886527,Staff,61,0,75,14
1746577990143,WCWP 10A,C00,886484,Martiniuk; Jill,12,0,15,3
1746577991168,WCWP 10B,A00,886490,Uriarte; Emma,0,0,15,15
1746577991168,WCWP 10B,B00,886491,Dhir; Simrita,8,0,15,7
1746577991168,WCWP 10B,C00,886492,Ornelas; Tricia,0,0,15,15
1746577992199,WCWP 100,A00,886494,Young; Mark T,0,6,15,15
1746577994317,AAS 10,A01,886199,Childs; Dennis R.,0,3,0,0
1746577995345,ANAR 104,A01,886940,Shtienberg; Gilad,27,0,30,3
1746577996369,ANAR 120,A00,886953,Staff,12,0,20,8
1746577997393,ANBI 148,A01,886955,Wilder; Linnea Lorene,30,0,40,10
1746577999447,ANSC 122,A00,886957,Staff,25,0,30,5
1746578000471,ANSC 150,A00,886958,Sloane; Julia Kathryn,2,0,15,13
1746578001494,ANSC 156,A00,886959,Jenkins; Janis A.,0,1,15,15
1746578002523,ANSC 180,A00,886960,Staff,11,0,17,6
1746578003548,ANSC 188,A00,886961,Jassal; Aftab,9,0,25,16
1746578004574,ANSC 190,A00,886962,Jassal; Aftab,14,0,25,11
1746578005599,ANSC 191,A00,886963,Staff,18,0,20,2
1746578006625,ANTH 3,A01,891689,Staff,17,0,20,3
1746578007653,ANTH 5,A00,886933,Semendeferi; Ekaterini,16,0,20,4
1746578008680,ANTH 10,A00,886934,Staff,0,12,30,30
1746578009705,ANTH 21,A01,886936,Staff,41,0,60,19
1746578010734,ANTH 23,A01,886938,Staff,92,0,100,8
1746578011758,ANTH 105,A00,886964,Stewart; Alexander B,84,0,100,16
1746578012784,ANTH 108,A00,886965,Pedersen; David,9,0,20,11
1746578013809,AWP 10,001,886147,Staff,0,0,0,0
1746578013809,AWP 10,002,886148,Staff,0,0,0,0
1746578013809,AWP 10,003,886149,Staff,0,0,0,0
1746578013809,AWP 10,004,886150,Staff,0,0,0,0
1746578013809,AWP 10,005,886151,Staff,0,0,0,0
1746578013809,AWP 10,006,886152,Staff,0,0,0,0
1746578013809,AWP 10,007,886153,Staff,0,0,0,0
1746578013809,AWP 10,008,886154,Staff,0,0,0,0
1746578013809,AWP 10,009,886155,Staff,0,0,0,0
1746578013809,AWP 10,010,886156,Staff,0,0,0,0
1746578013809,AWP 10,011,886158,Staff,0,0,0,0
1746578013809,AWP 10,012,886160,Staff,0,0,0,0
1746578013809,AWP 10,013,886161,Staff,0,0,0,0
1746578013809,AWP 10,014,886162,Staff,0,0,0,0
1746578013809,AWP 10,015,886163,Staff,0,0,0,0
1746578013809,AWP 10,016,886164,Staff,0,0,0,0
1746578013809,AWP 10,017,886165,Staff,0,0,0,0
1746578013809,AWP 10,018,886166,Staff,0,0,0,0
1746578013809,AWP 10,019,886168,Staff,0,0,0,0
1746578013809,AWP 10,020,886170,Staff,0,0,0,0
1746578013809,AWP 10,021,886172,Staff,0,0,0,0
1746578014845,AWP 10R,001,886173,Staff,0,1,0,0
1746578014845,AWP 10R,002,886174,Staff,0,1,0,0
1746578014845,AWP 10R,003,886175,Staff,0,0,0,0
1746578014845,AWP 10R,004,886176,Staff,0,0,0,0
1746578014845,AWP 10R,005,886177,Staff,0,0,0,0
1746578014845,AWP 10R,006,886178,Staff,0,0,0,0
1746578014845,AWP 10R,007,886179,Staff,0,0,0,0
1746578014845,AWP 10R,008,886181,Staff,0,0,0,0
1746578014845,AWP 10R,009,886182,Staff,0,0,0,0
1746578014845,AWP 10R,010,886183,Staff,0,0,0,0
1746578014845,AWP 10R,011,886184,Staff,0,0,0,0
1746578014845,AWP 10R,012,886185,Staff,0,0,0,0
1746578014845,AWP 10R,013,886186,Staff,0,0,0,0
1746578014845,AWP 10R,014,886187,Staff,0,0,0,0
1746578014845,AWP 10R,015,886188,Staff,0,0,0,0
1746578014845,AWP 10R,016,886189,Staff,0,0,0,0
1746578014845,AWP 10R,017,960532,Staff,0,0,0,0
1746578014845,AWP 10R,018,960533,Staff,0,0,0,0
1746578014845,AWP 10R,019,960534,Staff,0,0,0,0
1746578014845,AWP 10R,020,960538,Staff,0,0,0,0
1746578014845,AWP 10R,021,960540,Staff,0,0,0,0
1746578014845,AWP 10R,022,960541,Staff,0,0,0,0
1746578014845,AWP 10R,023,960542,Staff,0,0,0,0
1746578014845,AWP 10R,024,960544,Staff,0,0,0,0
1746578014845,AWP 10R,025,960545,Staff,0,0,0,0
1746578014845,AWP 10R,026,960548,Staff,0,0,0,0
1746578015871,AWP 102R,A00,886190,Staff,0,0,0,0
1746578015871,AWP 102R,B00,886191,Staff,0,0,0,0
1746578016896,BENG 100,A01,886193,Staff,17,0,30,13
1746578017921,BENG 122A,A01,886195,Hasty; Jeff M,13,0,30,17
1746578018946,BENG 166A,A00,886196,Sah; Robert Lie-Yuan,0,3,30,30
1746578019971,BENG 190,A00,958050,Khojah; Reem I,20,0,25,5
1746578020996,BIBC 102,A01,894320,Staff,0,0,46,46
1746578020996,BIBC 102,A02,894321,Staff,0,0,46,46
1746578020996,BIBC 102,A03,894344,Staff,6,0,46,40
1746578020996,BIBC 102,A04,894345,Staff,27,0,47,20
1746578022026,BICD 100R,A01,894365,Smith; Laurie,0,3,58,58
1746578022026,BICD 100R,A02,894366,Smith; Laurie,0,5,58,58
1746578022026,BICD 100R,A03,894367,Smith; Laurie,0,0,59,59
1746578022026,BICD 100R,A04,959869,Smith; Laurie,40,0,59,19
1746578023051,BICD 136,A01,894383,Gustafson-Brown; Cindy,14,0,50,36
1746578024081,BIEB 102,A01,894494,Butler; Shannon Rhey,51,0,130,79
1746578026132,BIEB 150,A01,894617,Wills; Christopher,3,0,20,17
1746578026132,BIEB 150,A02,894631,Wills; Christopher,3,0,20,17
1746578026132,BIEB 150,A03,894937,Wills; Christopher,3,0,20,17
1746578026132,BIEB 150,A04,894946,Wills; Christopher,5,0,20,15
1746578027158,BIEB 194,A00,906141,Kurle; Carolyn M.,6,0,20,14
1746578028183,BILD 1,A01,894154,Staff,3,0,19,16
1746578028183,BILD 1,A02,894155,Staff,14,0,19,5
1746578028183,BILD 1,A03,894160,Staff,13,0,19,6
1746578028183,BILD 1,A04,894161,Staff,15,0,18,3
1746578029208,BILD 2,A01,894168,Staff,0,0,50,50
1746578029208,BILD 2,A02,894169,Staff,0,0,50,50
1746578029208,BILD 2,A03,894179,Staff,0,0,50,50
1746578029208,BILD 2,A04,894203,Staff,24,0,50,26
1746578030237,BILD 3,A01,894213,Staff,23,0,31,8
1746578030237,BILD 3,A02,894214,Staff,26,0,31,5
1746578030237,BILD 3,A03,894235,Staff,28,0,31,3
1746578030237,BILD 3,A04,894236,Staff,28,0,32,4
1746578031263,BILD 4,A01,894253,Reuther; Keefe,5,0,24,19
1746578031263,BILD 4,A02,894258,Reuther; Keefe,16,0,24,8
1746578032290,BILD 5,A01,894276,Reuther; Keefe,35,0,50,15
1746578032290,BILD 5,A02,894277,Reuther; Keefe,45,0,50,5
1746578032290,BILD 5,A03,894290,Reuther; Keefe,44,0,50,6
1746578032290,BILD 5,A04,894291,Reuther; Keefe,48,0,50,2
1746578033316,BILD 24,A01,894297,Pirino; Giorgia,40,0,60,20
1746578034344,BIMM 100,B01,958915,Staff,71,0,100,29
1746578035370,BIMM 101,A01,895017,McDonnell; Lisa Marie,0,5,24,24
1746578035370,BIMM 101,A02,895018,McDonnell; Lisa Marie,0,5,24,24
1746578035370,BIMM 101,B01,895020,McDonnell; Lisa Marie,0,6,24,24
1746578035370,BIMM 101,B02,895021,McDonnell; Lisa Marie,0,4,24,24
1746578036396,BIMM 110,A01,895023,Staff,1,0,25,24
1746578036396,BIMM 110,A02,895024,Staff,9,0,25,16
1746578036396,BIMM 110,A03,895025,Staff,18,0,25,7
1746578036396,BIMM 110,A04,895031,Staff,20,0,25,5
1746578037422,BIMM 120,A01,895114,Gustafson-Brown; Cindy,14,0,28,14
1746578037422,BIMM 120,A02,895126,Gustafson-Brown; Cindy,21,0,27,6
1746578038448,BIPN 100,A01,895130,Yang; Mingyu,0,0,38,38
1746578038448,BIPN 100,A02,895131,Yang; Mingyu,32,0,38,6
1746578038448,BIPN 100,A03,895132,Yang; Mingyu,32,0,38,6
1746578038448,BIPN 100,A04,895133,Yang; Mingyu,27,0,36,9
1746578039472,BIPN 120,A01,895135,Cooke; James Edward,0,3,13,13
1746578039472,BIPN 120,A02,895136,Cooke; James Edward,0,1,13,13
1746578039472,BIPN 120,A03,895137,Cooke; James Edward,0,3,13,13
1746578039472,BIPN 120,A04,895156,Cooke; James Edward,0,2,11,11
1746578040496,BIPN 134,A01,895235,Cooke; James Edward,0,2,25,25
1746578040496,BIPN 134,A02,895237,Cooke; James Edward,0,0,25,25
1746578040496,BIPN 134,A03,895240,Cooke; James Edward,3,0,25,22
1746578040496,BIPN 134,A04,895270,Cooke; James Edward,20,0,25,5
1746578041521,BIPN 189,A00,892103,Staff,0,14,14,14
1746578043576,BISP 194,A00,958008,Staff,0,2,0,0
1746578044600,CAT 124,A01,922009,Staff,0,5,20,20
1746578045626,CAT 125R,A00,886390,Morales; Celeste Georgianna,0,2,20,20
1746578045626,CAT 125R,B00,886391,Irwin; Matthew Joseph,0,4,20,20
1746578045626,CAT 125R,C00,886392,Smith; Lauryn Alissa,0,2,20,20
1746578045626,CAT 125R,D00,886393,Vanderschuit; Maya Alysia,0,3,20,20
1746578045626,CAT 125R,E00,886394,Marchisotto; Jennifer Anne,0,3,20,20
1746578046654,CENG 15,A01,886218,Drews; Aaron,3,0,8,5
1746578047683,CENG 113,A00,886219,Opatkiewicz; Justin Paul,15,0,25,10
1746578048709,CGS 101,A00,887044,Staff,7,0,20,13
1746578049735,CGS 105,A01,887046,Staff,14,0,25,11
1746578050763,CGS 112,A00,887047,Cuong; Marisol,12,0,15,3
1746578051796,CGS 113,A00,887048,Staff,23,0,30,7
1746578052825,CGS 120,A00,887049,Staff,10,0,17,7
1746578053850,CHEM 6A,A01,886336,Lam; Tin Yiu,38,0,50,12
1746578053850,CHEM 6A,A02,886338,Lam; Tin Yiu,37,0,50,13
1746578054875,CHEM 6B,A01,886341,Hopkins; Patrycja Anna,16,0,50,34
1746578054875,CHEM 6B,A02,886343,Hopkins; Patrycja Anna,42,0,50,8
1746578055900,CHEM 6C,A01,886346,Albizati; Kim F.,0,2,50,50
1746578055900,CHEM 6C,A02,886348,Albizati; Kim F.,23,0,50,27
1746578056930,CHEM 40A,A01,886352,Klosterman; Jeremy K,65,0,100,35
1746578057961,CHEM 40B,A01,886356,Klosterman; Jeremy K,0,23,100,100
1746578058986,CHEM 41B,A01,886360,Theodorakis; Emmanuel,25,0,50,25
1746578058986,CHEM 41B,A02,886362,Theodorakis; Emmanuel,47,0,50,3
1746578060012,CHIN 165A,A00,886382,Xu; Li,18,0,20,2
1746578061040,CLAS 120,A00,886387,Myerston Santana; Jacobo,33,0,40,7
1746578062074,COGS 9,A01,886967,Shannon; Kyle Michael,42,0,60,18
1746578063102,COGS 11,A01,886969,Staff,9,0,30,21
1746578064128,COGS 14A,A01,886971,Staff,6,0,60,54
1746578065154,COGS 14B,A01,886973,Hoffman; Drew Ellen,4,0,60,56
1746578066183,COGS 18,A01,886975,Morgan; Eric,34,0,60,26
1746578067211,COGS 20,A01,886977,Staff,4,0,8,4
1746578067211,COGS 20,A02,886978,Staff,5,0,7,2
1746578068239,COGS 100,A01,907783,Staff,1,2,30,29
1746578069263,COGS 101B,A01,886980,Staff,0,4,48,48
1746578070292,COGS 101C,A01,886982,Delgado; Tania,0,5,44,44
1746578071317,COGS 102A,A01,886984,Johnson; Christine M.,4,0,30,26
1746578072342,COGS 118B,A01,886986,Staff,1,4,88,87
1746578073366,COGS 150,A01,886988,Bergen; Benjamin,22,0,50,28
1746578074389,COGS 153,A00,886989,Delgado; Tania,0,2,41,41
1746578075419,COGS 186,A01,886991,Staff,0,0,32,32
1746578076444,COGS 187A,A01,886993,Boyle; Mary E. T.,7,0,30,23
1746578077470,COGS 189,A00,886994,Staff,0,1,30,30
1746578078498,COMM 10,A01,886996,Staff,0,0,20,21
1746578078498,COMM 10,A02,886997,Staff,10,0,20,10
1746578078498,COMM 10,A03,959845,Staff,19,0,20,1
1746578079524,COMM 20,A01,886999,Leuning; Grant Maurstad,24,0,40,16
1746578081577,COMM 100A,A01,887002,Staff,0,0,20,25
1746578081577,COMM 100A,A02,887003,Staff,6,0,20,14
1746578082605,COMM 100B,A01,887005,Staff,0,8,20,24
1746578083630,COMM 106D,A00,887006,Staff,13,0,40,27
1746578084654,COMM 110G,A00,887007,Whitworth-Smith; Andrew C,12,0,40,28
1746578085679,COMM 111B,A00,887008,Staff,31,0,40,9
1746578086704,COMM 113T,A00,887009,Abuelhiga; Soraya Jill,28,0,40,12
1746578086704,COMM 113T,B00,906733,Staff,40,0,40,0
1746578087733,COMM 145,A00,887010,Staff,12,0,40,28
1746578088757,COMM 146,A00,887054,Staff,31,0,40,9
1746578089785,COMM 190,A00,887012,Staff,8,0,23,15
1746578090815,CSE 8A,A50,887015,Cao; Yingjun,57,0,85,28
1746578091839,CSE 11,A01,887017,Cao; Yingjun,12,0,70,58
1746578092869,CSE 20,A01,887019,Staff,30,0,50,20
1746578093899,CSE 21,A01,887021,Staff,78,0,100,22
1746578093899,CSE 21,B01,892583,Braun; Oliver,45,0,50,5
1746578094979,CSE 30,A01,887025,Eldon; John,143,0,200,57
1746578096004,CSE 100,A01,887027,Staff,26,0,50,24
1746578096004,CSE 100,A02,887028,Staff,42,0,50,8
1746578097029,CSE 101,A01,887030,Braun; Oliver,74,0,100,26
1746578097029,CSE 101,B01,887032,Jones; Miles E,0,3,50,50
1746578097029,CSE 101,B02,887033,Jones; Miles E,0,2,50,50
1746578098057,CSE 105,A01,908084,Jones; Miles E,32,0,50,18
1746578098057,CSE 105,A02,908087,Jones; Miles E,31,0,50,19
1746578099082,CSE 135,A01,887035,Powell; Thomas Allan,0,5,50,50
1746578100110,CSE 142,A01,887037,Staff,8,0,60,52
1746578101139,CSE 142L,A01,887039,Staff,34,0,60,26
1746578102167,CSE 151A,A01,887041,Solares; Edwin A,47,0,100,53
1746578103200,CSE 175,A01,887043,Kumar; Rakesh,30,0,30,0
1746578104224,CSS 1,A01,886389,Staff,1,2,40,39
1746578105254,DSC 30,A01,908097,Liao; Soohyun Nam,47,0,75,28
1746578106283,DSC 40A,A01,908099,Shannon; Kyle Michael,30,0,50,20
1746578107309,DSC 40B,A01,908112,Staff,15,0,50,35
1746578108336,DSC 80,A01,908116,Staff,19,0,60,41
1746578109361,DSC 197,001,956863,Eldridge; Justin Matthew,9999,0,9999,0
1746578110385,ECE 5,A01,886400,Morris; Karcher William,1,0,6,5
1746578110385,ECE 5,A02,886401,Morris; Karcher William,3,0,6,3
1746578111415,ECE 148,A01,886403,Silberman; Jack,0,14,14,14
1746578112441,ECON 1,A01,887265,Crane; Meredith Helen,12,0,70,58
1746578112441,ECON 1,B01,887268,Staff,42,0,50,8
1746578113471,ECON 2,A01,887273,Crane; Meredith Helen,55,0,70,15
1746578114496,ECON 3,A01,887279,Rondina; Giacomo,32,0,70,38
1746578115524,ECON 4,A01,887282,Anderson; John Charles,0,2,10,10
1746578116550,ECON 5,A01,887285,Staff,34,0,45,11
1746578116550,ECON 5,B01,887292,Staff,41,0,45,4
1746578117580,ECON 100A,A01,887337,Newhouse; Herbert S,54,0,70,16
1746578117580,ECON 100A,B01,887349,Staff,45,0,50,5
1746578118605,ECON 100B,A01,887361,Du; Songzi,29,0,70,41
1746578119636,ECON 100C,A01,887445,Newhouse; Herbert S,59,0,70,11
1746578120666,ECON 105,A00,887488,Vespa; Emanuel Ignacio,23,0,35,12
1746578121693,ECON 109,A01,887506,Shishkin; Denis,28,0,35,7
1746578122722,ECON 110A,A01,887568,Alon; Titan Michael,0,3,35,35
1746578122722,ECON 110A,B01,907601,Alon; Titan Michael,20,0,35,15
1746578123747,ECON 110B,A01,887598,Levkoff; Steven B.,0,24,70,70
1746578124776,ECON 112,A00,887599,Rondina; Giacomo,19,0,35,16
1746578125805,ECON 120A,A01,887603,Dai; Yinlin,35,0,70,35
1746578126833,ECON 120C,A01,887608,Sun; Yixiao,0,1,35,35
1746578126833,ECON 120C,B01,887614,Sun; Yixiao,0,0,35,35
1746578127861,ECON 138,A00,887621,Bharadwaj; Prashant,0,21,20,20
1746578128889,ECON 144,A00,958007,Squires; Dale E,12,0,35,23
1746578129916,ECON 171,A01,907666,Staff,18,0,35,17
1746578130941,ECON 175,A00,887626,Wu; Pak Yeung,22,0,35,13
1746578131970,ECON 190,A00,887640,Vespa; Emanuel Ignacio,22,0,35,13
1746578133005,EDS 25,A01,888197,Staff,0,0,0,0
1746578133005,EDS 25,A02,888209,Staff,0,0,0,0
1746578133005,EDS 25,A03,888210,Staff,0,0,0,0
1746578133005,EDS 25,A04,888212,Staff,0,0,0,0
1746578133005,EDS 25,A05,888213,Staff,0,0,0,0
1746578133005,EDS 25,A06,888214,Staff,0,0,0,0
1746578133005,EDS 25,A07,888235,Staff,0,2,0,0
1746578133005,EDS 25,A08,888236,Staff,0,0,0,0
1746578133005,EDS 25,A09,888240,Staff,0,0,0,0
1746578133005,EDS 25,A10,888244,Staff,0,0,0,0
1746578133005,EDS 25,B01,888273,Staff,0,0,0,0
1746578133005,EDS 25,B02,888285,Staff,0,0,0,0
1746578133005,EDS 25,B03,888423,Staff,0,0,0,1
1746578133005,EDS 25,B04,888432,Staff,0,0,0,0
1746578133005,EDS 25,B05,888433,Staff,0,0,0,0
1746578133005,EDS 25,B06,888467,Staff,0,0,0,0
1746578133005,EDS 25,B07,888468,Staff,0,0,0,0
1746578133005,EDS 25,B08,888479,Staff,0,0,0,0
1746578133005,EDS 25,B09,888484,Staff,0,0,0,0
1746578133005,EDS 25,B10,888487,Staff,0,0,0,0
1746578134030,EDS 38,A01,907700,Choi; Bailey Miyeon,30,0,30,0
1746578135055,EDS 112,A01,888601,Chapman; Thandeka K,12,0,40,28
1746578136083,EDS 115,A00,888697,Mendez; Kathrina Mendoza,10,0,30,20
1746578137107,EDS 116,A01,888893,Staff,34,0,40,6
1746578139162,EDS 124AR,A00,889133,Staff,29,0,50,21
1746578139162,EDS 124AR,B00,907471,Simon; Elizabeth A,37,0,50,13
1746578140186,EDS 124BR,A00,889134,Simon; Elizabeth A,44,0,100,56
1746578141211,EDS 125,A00,889135,Staff,25,0,30,5
1746578142235,EDS 126,A01,889138,Staff,35,0,40,5
1746578143262,EDS 164R,A01,889142,Wishard Guerra; Alison G.,33,0,50,17
1746578144286,ENG 30,A01,886396,Staff,0,0,0,0
1746578144286,ENG 30,B01,886398,Staff,0,0,0,0
1746578145312,ENVR 102,A00,906150,Montejo; Carolina,23,0,25,2
1746578146337,ETHN 103A,A00,887236,Man; Simeon S,0,3,0,0
1746578147366,ETHN 113,A00,887239,Staff,16,0,30,14
1746578148390,ETHN 116,A00,887240,Staff,16,0,25,9
1746578149416,ETHN 117,A00,887241,Choi; Esther Min,28,0,30,2
1746578150443,ETHN 118,A00,887243,Staff,24,0,30,6
1746578151471,ETHN 127,A00,887248,Cuong; Marisol,11,0,15,4
1746578152497,ETHN 139,A00,887250,Staff,7,0,10,3
1746578153524,ETHN 142,A00,887252,Staff,10,0,30,20
1746578154548,ETHN 161,A00,887253,Browne; Errol Tsekani,24,0,30,6
1746578155574,ETHN 163FR,A00,887255,Burelle; Julie Sara Veronique,0,0,5,5
1746578156599,GLBH 20,A00,889149,Elwardani; Nile Regina,8,0,42,34
1746578158649,GLBH 111,A01,889152,Burgos; Jose L.,17,0,17,0
1746578159674,GLBH 150,A00,889181,Sloane; Julia Kathryn,0,5,15,15
1746578161728,HDS 60,A01,886406,Warstadt; Melissa Fawn,73,0,80,7
1746578162754,HIAF 111,A00,889324,Gyamfi; Bright,25,0,32,7
1746578163782,HIEA 131,A00,889328,Staff,15,0,32,17
1746578164808,HIEA 144,A00,889333,Henry; Todd A.,26,0,32,6
1746578165836,HIEA 154,A00,889336,Henry; Todd A.,24,0,32,8
1746578166864,HIEU 106,A00,889339,Staff,22,0,32,10
1746578168917,HIEU 114,A00,889340,Staff,4,0,32,28
1746578169942,HIEU 135GS,A00,889342,Patterson; Patrick H.,0,0,1,24
1746578170967,HIEU 137,A00,889343,Edington; Claire Ellen,10,0,25,15
1746578171996,HIEU 148,A00,889345,Staff,14,0,32,18
1746578173030,HIEU 154,A00,889346,Biess; Frank Peter,21,0,32,11
1746578174058,HILA 102,A00,889351,Staff,12,0,32,20
1746578175084,HILD 2A,A01,889221,Lewandoski; Julia Mavis,1,10,32,31
1746578176110,HILD 7B,A01,889225,Man; Simeon S,0,12,32,32
1746578177135,HILD 7C,A01,889288,Alvarez; Luis A,0,14,32,32
1746578178162,HILD 30,A01,889323,Staff,0,5,32,32
1746578180216,HISC 119,A00,889383,Golan; Tal,19,0,32,13
1746578181242,HIUS 103,A00,889384,Man; Simeon S,0,0,32,32
1746578182266,HIUS 117,A00,919797,Kwak; Nancy,19,0,32,13
1746578183291,HIUS 142A,A00,919788,Staff,22,0,32,10
1746578185341,HIUS 149,A00,889386,Gyamfi; Bright,26,0,32,6
1746578186365,HIUS 155,A00,889387,Alvarez; Luis A,15,0,32,17
1746578187390,HUM 3,A01,886499,Caldwell; Michael Alan,19,0,50,31
1746578188418,HUM 3GS,A00,886500,Rodriguez; Bretton Sigfred,0,0,0,28
1746578189443,HUM 3R,A01,886502,Markman; Kristina,0,36,50,50
1746578190468,HUM 4,A01,886504,Crum; Matthew Stephen,23,0,50,27
1746578190468,HUM 4,B01,886506,West; Geoffrey Scott,17,0,50,33
1746578191498,HUM 4GS,A00,886507,Staff,0,0,0,19
1746578192525,HUM 5,A01,886509,Staff,32,0,50,18
1746578193550,HUM 5R,A01,886511,Zavodny; Tatiana Sophia,0,39,50,50
1746578194577,JAPN 180,A00,886407,Staff,16,0,40,24
1746578195603,LATI 50,A01,886409,Martin-Cabrera; Luis,3,0,22,19
1746578195603,LATI 50,A02,886410,Martin-Cabrera; Luis,19,0,22,3
1746578195603,LATI 50,A03,886411,Martin-Cabrera; Luis,21,0,22,1
1746578195603,LATI 50,A04,886412,Martin-Cabrera; Luis,8,0,22,14
1746578196628,LAWS 101,A00,907664,Staff,28,0,60,32
1746578197652,LIAB 1A,A00,889388,Saab; Dima,17,0,20,3
1746578198719,LIAB 1AX,A00,889389,El Cheddadi; Youniss,18,0,20,2
1746578199742,LIFR 1C,A00,889391,Van Moer; Vinciane G,8,0,20,12
1746578200769,LIFR 1CX,A00,889392,Van Moer; Vinciane G,7,0,20,13
1746578201797,LIFR 1D,A00,889393,Van Moer; Vinciane G,7,0,20,13
1746578202821,LIFR 1DX,A00,889394,Van Moer; Vinciane G,8,0,20,12
1746578203846,LIGN 7,A00,886923,Staff,24,0,50,26
1746578204872,LIGN 17,A00,886924,Kehler; Andrew Scott,125,0,150,25
1746578205901,LTAM 110,A00,889395,Staff,15,0,30,15
1746578206926,LTAM 110GS,A00,958010,Rodriguez; Bretton Sigfred,0,0,0,28
1746578207953,LTCH 101,A00,889397,Staff,23,0,25,2
1746578208983,LTCS 130,A00,889398,Staff,23,0,25,2
1746578210008,LTEA 138,A00,889399,Staff,24,0,40,16
1746578211035,LTEN 149,A00,889400,Wesling; Megan E.,0,3,25,25
1746578212067,LTEN 169,A00,889401,Staff,20,0,25,5
1746578213093,LTEN 180,A00,889402,Staff,10,0,15,5
1746578214117,LTEN 181,A00,889403,Staff,21,0,25,4
1746578215144,LTWL 100,A00,889404,Myerston Santana; Jacobo,2,0,25,23
1746578216169,LTWL 180GS,A00,889405,Staff,0,0,20,20
1746578217198,LTWL 181,A00,889406,Staff,16,0,25,9
1746578218227,LTWL 184,A00,889475,Mukherjee; Silpa,22,0,25,3
1746578219251,LTWR 102C,A00,889486,Staff,29,0,30,1
1746578220279,LTWR 115W,A00,889491,Staff,0,2,15,15
1746578221307,MAE 8,A01,886905,Staff,0,2,0,0
1746578222333,MAE 11,A00,886906,Bandaru; Prabhakar,0,7,50,50
1746578223359,MAE 20,A00,886907,Evdokimenko; Ekaterina,43,0,70,27
1746578224383,MAE 30B,A00,886909,Ghazinejad; Maziar,26,0,45,19
1746578225408,MAE 101B,A00,886910,Saintillan; David,29,0,45,16
1746578226432,MAE 105,A00,886911,Bandaru; Prabhakar,18,0,50,32
1746578227460,MAE 107,B00,958024,Staff,8,0,50,42
1746578228487,MAE 143B,A00,886913,Bewley; Thomas R,4,0,40,36
1746578229511,MAE 148,A01,886915,Silberman; Jack,0,3,14,14
1746578230536,MAE 160,A00,886916,Evdokimenko; Ekaterina,31,0,60,29
1746578231562,MATH 3C,A01,889681,Staff,0,2,30,30
1746578231562,MATH 3C,A02,960048,Staff,24,0,30,6
1746578232588,MATH 10A,A01,889760,Staff,26,0,30,4
1746578232588,MATH 10A,A02,889783,Staff,29,0,30,1
1746578233619,MATH 10B,A01,889785,Verstraete; Jacques Allan,2,0,35,33
1746578233619,MATH 10B,A02,889795,Verstraete; Jacques Allan,4,0,35,31
1746578233619,MATH 10B,B01,889797,Verstraete; Jacques Allan,3,0,35,32
1746578233619,MATH 10B,B02,889828,Verstraete; Jacques Allan,3,0,35,32
1746578234646,MATH 10C,A01,889849,Habib; Yousaf,7,0,30,23
1746578234646,MATH 10C,A02,889852,Habib; Yousaf,14,0,30,16
1746578234646,MATH 10C,A03,889853,Habib; Yousaf,22,0,30,8
1746578234646,MATH 10C,A04,889858,Habib; Yousaf,20,0,30,10
1746578234646,MATH 10C,B01,889861,Staff,1,0,30,29
1746578234646,MATH 10C,B02,889862,Staff,24,0,30,6
1746578234646,MATH 10C,B03,889863,Staff,27,0,30,3
1746578234646,MATH 10C,B04,889967,Staff,23,0,30,7
1746578235677,MATH 18,A01,889974,Staff,7,0,30,23
1746578235677,MATH 18,A02,889977,Staff,20,0,30,10
1746578235677,MATH 18,B01,889984,Hardiman; Liam,20,0,30,10
1746578235677,MATH 18,B02,889985,Hardiman; Liam,25,0,30,5
1746578236702,MATH 20A,A01,889990,Suk; Andrew Hoon,30,0,35,5
1746578237731,MATH 20B,A01,889993,Ohm; Ko Woon,22,0,30,8
1746578237731,MATH 20B,A02,889994,Ohm; Ko Woon,30,0,30,0
1746578237731,MATH 20B,B01,889996,Ohm; Ko Woon,22,0,30,8
1746578237731,MATH 20B,B02,889997,Ohm; Ko Woon,23,0,30,7
1746578238758,MATH 20C,A01,889999,Hammock; Frances H,17,0,30,13
1746578238758,MATH 20C,A02,890003,Hammock; Frances H,23,0,30,7
1746578238758,MATH 20C,B01,890006,Hammock; Frances H,3,0,30,27
1746578238758,MATH 20C,B02,890007,Hammock; Frances H,12,0,30,18
1746578239784,MATH 20D,A01,890011,Cheng; Hsiao-Bing,1,1,30,29
1746578239784,MATH 20D,A02,890012,Cheng; Hsiao-Bing,14,0,30,16
1746578239784,MATH 20D,B01,890016,Cheng; Hsiao-Bing,13,0,30,17
1746578239784,MATH 20D,B02,890017,Cheng; Hsiao-Bing,13,0,30,17
1746578240810,MATH 20E,A01,890026,Harel; Guershon,1,0,30,29
1746578240810,MATH 20E,A02,890029,Harel; Guershon,23,0,30,7
1746578240810,MATH 20E,B01,890033,Harel; Guershon,7,0,30,23
1746578240810,MATH 20E,B02,890101,Harel; Guershon,21,0,30,9
1746578241837,MATH 102,A01,890104,Staff,17,0,30,13
1746578241837,MATH 102,A02,890105,Staff,27,0,30,3
1746578242865,MATH 103B,A01,890116,Salehi Golsefidy; Alireza,3,0,30,27
1746578242865,MATH 103B,B01,890118,Staff,0,3,34,34
1746578243890,MATH 109,A01,890121,Aliabadi Sr.; Mohsen,1,0,30,29
1746578243890,MATH 109,B01,890124,Upadrashta; Pranav Kumar,18,0,30,12
1746578244915,MATH 120A,A01,890126,Eggers; John Dietrich,13,0,30,17
1746578245942,MATH 142B,A01,890128,Ioana; Adrian,19,0,30,11
1746578245942,MATH 142B,A02,890129,Ioana; Adrian,12,0,30,18
1746578246968,MATH 154,A01,890174,Staff,0,0,30,30
1746578246968,MATH 154,A02,890182,Staff,0,0,30,30
1746578247994,MATH 168A,A01,890197,Dumitriu; Ioana,21,0,35,14
1746578249020,MATH 170A,A01,890240,Nie; Jiawang,1,0,30,29
1746578249020,MATH 170A,A02,890241,Nie; Jiawang,11,0,30,19
1746578249020,MATH 170A,A03,890249,Nie; Jiawang,23,0,30,7
1746578250046,MATH 170B,A01,957891,Nag; Panchali,13,0,35,22
1746578252099,MATH 181A,A01,908025,Staff,0,3,35,35
1746578252099,MATH 181A,A02,960115,Staff,26,0,35,9
1746578253126,MATH 181B,A01,959874,Staff,25,0,30,5
1746578254151,MATH 193B,A01,890265,Staff,0,4,35,35
1746578255182,MGT 4,A01,890311,Anderson; John Charles,42,0,88,46
1746578256207,MGT 5,A00,907740,Staff,13,0,98,85
1746578257231,MGT 12,A00,890312,Lindenberger; Wade Douglas,67,0,98,31
1746578258255,MGT 16,A00,957883,Staff,78,0,98,20
1746578260331,MGT 45,A00,890314,Pecore; Joseph P.,45,0,98,53
1746578261359,MGT 71,A00,890315,Staff,0,12,98,98
1746578262383,MGT 100,A00,890316,Yavorsky; Daniel Ryan,44,0,98,54
1746578263413,MGT 103,A00,890317,Ehrich; Kristine R,73,0,98,25
1746578264437,MGT 105,A00,890356,Bates; Kenneth Walter,0,8,98,98
1746578265465,MGT 112,A00,890360,Ehrich; Kristine R,55,0,98,43
1746578266490,MGT 127R,A00,907732,Zhu; Kevin Xiaoguo,23,0,98,75
1746578267516,MGT 131B,A00,890361,Anderson; John Charles,59,0,98,39
1746578268545,MGT 137,A00,890362,Lindenberger; Wade Douglas,65,0,98,33
1746578269569,MGT 160,A00,890369,Johnson; Erik Barry,9,0,98,89
1746578271624,MGT 164,A00,890372,Zimmermann; Carsten,0,40,98,98
1746578272653,MGT 180,A00,890374,Bliss; Barbara Ann,12,0,98,86
1746578273684,MMW 15,A01,886414,Chang; Edmond Yi-Teh,0,12,28,28
1746578273684,MMW 15,A02,886415,Chang; Edmond Yi-Teh,0,8,28,28
1746578273684,MMW 15,A03,886416,Chang; Edmond Yi-Teh,0,9,28,28
1746578273684,MMW 15,A04,886417,Chang; Edmond Yi-Teh,0,8,28,28
1746578273684,MMW 15,B01,886419,Chang; Edmond Yi-Teh,0,7,28,28
1746578273684,MMW 15,B02,886420,Chang; Edmond Yi-Teh,0,8,28,28
1746578273684,MMW 15,B03,886421,Chang; Edmond Yi-Teh,0,7,28,28
1746578273684,MMW 15,B04,886422,Chang; Edmond Yi-Teh,0,8,28,28
1746578273684,MMW 15,C01,886424,Staff,0,9,28,28
1746578273684,MMW 15,C02,886425,Staff,0,8,28,28
1746578273684,MMW 15,C03,886426,Staff,0,8,28,28
1746578273684,MMW 15,C04,886427,Staff,0,8,28,28
1746578273684,MMW 15,C05,958038,Staff,0,8,28,28
1746578273684,MMW 15,C06,958039,Staff,1,8,28,27
1746578274707,MMW 15GS,A00,906910,Patterson; Patrick H.,4,0,28,24
1746578275735,MMW 122R,A01,886429,Rahimi; Babak,0,13,28,28
1746578275735,MMW 122R,A02,886430,Rahimi; Babak,0,12,28,28
1746578275735,MMW 122R,A03,958040,Rahimi; Babak,0,11,28,28
1746578276760,MUS 1A,A01,890937,Staff,2,0,25,23
1746578276760,MUS 1A,A02,891035,Staff,6,0,25,19
1746578276760,MUS 1A,C01,958912,Staff,24,0,25,1
1746578276760,MUS 1A,C02,958913,Staff,25,0,25,0
1746578278813,MUS 2AK,A00,957092,Ohnishi; Takae,15,0,15,0
1746578279839,MUS 4,A01,891044,Staff,1,0,25,24
1746578279839,MUS 4,A02,891045,Staff,23,0,25,2
1746578279839,MUS 4,B01,891048,Staff,17,0,25,8
1746578279839,MUS 4,B02,891050,Staff,25,0,25,0
1746578280869,MUS 5,A01,957506,Dubnov; Shlomo,0,0,25,25
1746578280869,MUS 5,A02,957622,Dubnov; Shlomo,13,0,25,12
1746578280869,MUS 5,A03,957623,Dubnov; Shlomo,20,0,25,5
1746578281897,MUS 6,A01,891053,Freitas Caetano; Marcelo,24,0,25,1
1746578281897,MUS 6,A02,891054,Freitas Caetano; Marcelo,23,0,25,2
1746578282922,MUS 7,A01,891081,Staff,1,0,25,24
1746578282922,MUS 7,A02,891082,Staff,3,0,25,22
1746578283948,MUS 8GS,A00,891118,Borgo; David Garcia,1,0,25,24
1746578284977,MUS 11,A01,891140,Staff,9,0,25,16
1746578284977,MUS 11,A02,891141,Staff,21,0,25,4
1746578286001,MUS 13,A01,891143,Staff,8,0,25,17
1746578286001,MUS 13,A02,891144,Staff,24,0,25,1
1746578287026,MUS 15,A01,891146,Staff,9,0,25,16
1746578287026,MUS 15,A02,891148,Staff,21,0,25,4
1746578287026,MUS 15,B01,891150,Staff,18,0,25,7
1746578287026,MUS 15,B02,891151,Staff,25,0,25,0
1746578288050,MUS 20,A01,891153,Staff,5,0,20,15
1746578288050,MUS 20,A02,891155,Staff,14,0,20,6
1746578289074,MUS 80,A00,891156,Staff,19,0,25,6
1746578289074,MUS 80,B00,891157,Staff,23,0,25,2
1746578290104,MUS 130,A00,891158,Ohnishi; Takae,35,0,35,0
1746578291128,MUS 150GS,A01,891160,Borgo; David Garcia,1,0,25,24
1746578292154,MUS 170,A01,891162,Freitas Caetano; Marcelo,20,0,25,5
1746578292154,MUS 170,A02,891164,Freitas Caetano; Marcelo,21,0,25,4
1746578293178,NANO 11,A00,886220,Vazquez Mena; Oscar,13,0,15,2
1746578294204,NANO 15,A01,886222,Drews; Aaron,4,0,7,3
1746578295232,NANO 104,A00,886224,Sirbuly; Donald,17,0,25,8
1746578296258,PH 40,A00,886528,Staff,24,0,40,16
1746578297283,PH 45,A01,886799,Staff,35,0,40,5
1746578298308,PH 110,A00,886802,Staff,0,7,40,40
1746578299332,PH 172,A00,906716,Staff,19,0,35,16
1746578300359,PH 191,A00,886803,Staff,6,0,40,34
1746578301388,PHIL 1,A00,889500,Staff,20,0,30,10
1746578302422,PHIL 10,A01,889549,Grush; Rick Scott,16,0,22,6
1746578302422,PHIL 10,A02,889551,Grush; Rick Scott,22,0,22,0
1746578303452,PHIL 28,A01,889559,Lamey; Andy M.,0,2,31,31
1746578303452,PHIL 28,A02,889561,Lamey; Andy M.,0,1,30,30
1746578303452,PHIL 28,A03,889572,Lamey; Andy M.,0,1,30,30
1746578304476,PHIL 35,A00,907839,Staff,13,0,15,2
1746578305504,PHIL 60,A00,889574,Staff,73,0,90,17
1746578306528,PHIL 101,A00,958004,Staff,12,0,15,3
1746578308581,PHIL 136,A00,889582,Fulkerson; Matthew Todd,26,0,45,19
1746578309607,PHIL 163,A01,889601,Staff,21,0,30,9
1746578309607,PHIL 163,B01,889606,Brandt; Reuven A,0,3,0,0
1746578310634,PHIL 164,A00,889610,Staff,16,0,30,14
1746578311661,PHIL 165,A00,889613,Staff,22,0,30,8
1746578312686,PHYS 1A,A00,886431,Staff,28,0,70,42
1746578313710,PHYS 1AL,001,886432,Tsai; Philbert S,1,2,30,29
1746578313710,PHYS 1AL,002,886436,Tsai; Philbert S,11,0,30,19
1746578314735,PHYS 1B,A00,886439,Staff,184,0,240,56
1746578315763,PHYS 1BL,001,886441,Tsai; Philbert S,0,4,30,30
1746578315763,PHYS 1BL,002,886444,Tsai; Philbert S,2,0,30,28
1746578316789,PHYS 1C,A00,896092,Arnold; Kam S,78,0,146,68
1746578317818,PHYS 1CL,001,886448,Tsai; Philbert S,0,0,30,30
1746578317818,PHYS 1CL,002,886449,Tsai; Philbert S,1,0,30,29
1746578317818,PHYS 1CL,003,886450,Tsai; Philbert S,16,0,30,14
1746578317818,PHYS 1CL,004,886451,Tsai; Philbert S,15,0,30,15
1746578318843,PHYS 2B,A01,886457,Staff,68,0,115,47
1746578319868,PHYS 2C,A01,886460,Shotwell; Brian,0,9,65,65
1746578320893,PHYS 2CL,A01,886467,Staff,0,4,28,28
1746578320893,PHYS 2CL,A02,886468,Staff,0,3,28,28
1746578321922,PHYS 2D,A01,886470,Staff,10,0,50,40
1746578322949,PHYS 4B,A01,886475,Grinstein; Benjamin,22,0,40,18
1746578323973,POLI 5,A00,891173,Desposato; Scott,7,0,25,18
1746578325001,POLI 5D,A01,891175,Staff,5,0,5,0
1746578325001,POLI 5D,B01,891178,Staff,5,0,5,0
1746578326025,POLI 11,A00,891179,Ferree; Karen E,2,0,35,33
1746578327052,POLI 12,A00,891180,Staff,16,0,30,14
1746578328080,POLI 27,A01,891182,Staff,12,0,75,63
1746578329107,POLI 30,A00,891183,Staff,8,0,50,42
1746578330131,POLI 100B,A00,891244,Staff,5,1,35,30
1746578331157,POLI 100I,A00,891247,Staff,7,0,30,23
1746578332183,POLI 104J,A00,891248,Nichter; Maysa,14,0,30,16
1746578333210,POLI 104U,A00,891250,Nichter; Maysa,1,0,30,29
1746578335263,POLI 110B,A00,891255,Wiens; David,19,0,25,6
1746578336287,POLI 112A,A00,891256,Wiens; David,6,0,25,19
1746578337316,POLI 114BR,A00,891261,Staff,19,0,30,11
1746578338340,POLI 117R,A00,891262,Forman; Fonna,0,6,50,50
1746578339366,POLI 118,A00,891264,Ingham; Sean,17,0,25,8
1746578340392,POLI 124A,A00,891265,Staff,18,0,20,2
1746578341418,POLI 125D,A00,891266,Nichter; Simeon C,2,0,25,23
1746578342444,POLI 126,A00,891268,Nichter; Simeon C,7,0,25,18
1746578343470,POLI 126AA,A00,891272,Staff,15,0,25,10
1746578344497,POLI 130AA,A00,891273,Staff,15,0,20,5
1746578345525,POLI 134AA,A00,891274,Staff,4,0,20,16
1746578347576,POLI 138,A00,891278,Staff,21,0,25,4
1746578348600,POLI 142K,A00,891280,Staff,10,0,25,15
1746578349625,POLI 142M,A00,891281,Gartzke; Erik,16,0,30,14
1746578350653,POLI 142P,A00,891284,Staff,20,0,30,10
1746578351678,POLI 143,A00,891285,Gartzke; Erik,12,0,30,18
1746578352703,POLI 153,A00,891286,Staff,19,0,20,1
1746578354753,POLI 175,A00,891290,Staff,15,0,20,5
1746578355784,PSYC 1,A00,890674,Steiner; Eric Tomas,0,11,45,45
1746578356810,PSYC 2,A00,890676,Albright; Thomas D,21,0,35,14
1746578357835,PSYC 3,A00,890679,Staff,17,0,20,3
1746578358861,PSYC 6,A00,959858,Staff,19,0,20,1
1746578359885,PSYC 60,A01,890684,Rickard; Timothy C.,0,5,45,45
1746578360915,PSYC 70,A01,890689,Geller; Emma Harlan,7,0,30,23
1746578361941,PSYC 71,A01,959860,Staff,21,0,25,4
1746578362969,PSYC 100,A00,890690,Lacefield; Katharine I,0,50,180,180
1746578363993,PSYC 102,A00,890695,Staff,18,0,40,22
1746578365019,PSYC 105,A00,890699,Geller; Emma Harlan,70,0,100,30
1746578366050,PSYC 106,A00,890701,Gorman; Michael R.,6,0,30,24
1746578367078,PSYC 108,A00,890704,Adrian; Julia Anna,0,28,50,50
1746578368125,PSYC 118,A01,890712,Staff,11,0,30,19
1746578369153,PSYC 124,A00,890716,Chapman; Eddie Nathaniel,25,0,60,35
1746578370179,PSYC 131,A00,890717,Anagnostaras; Stephan,0,7,80,80
1746578371205,PSYC 137,A00,890719,Winkielman; Piotr,0,11,30,30
1746578372230,PSYC 144,A00,890721,Adrian; Julia Anna,0,9,45,45
1746578373258,PSYC 162,A00,890805,Staff,0,0,75,75
1746578374288,PSYC 169,A00,890810,Staff,0,14,30,30
1746578375314,PSYC 172,A00,890814,Gorman; Michael R.,9,0,30,21
1746578376340,PSYC 181,A00,890818,Anagnostaras; Stephan,8,0,200,192
1746578377364,PSYC 184,A00,959861,Staff,164,0,175,11
1746578378391,PSYC 189,A00,890823,Staff,0,2,30,30
1746578379415,PSYC 191,A00,890884,Rickard; Timothy C.,0,12,35,35
1746578380443,PSYC 193,A00,890913,Staff,19,0,30,11
1746578380443,PSYC 193,B00,890914,Chapman; Eddie Nathaniel,24,0,30,6
1746578381470,PSYC 193L,A01,890918,Lowe; Angela Beth,20,0,30,10
1746578381470,PSYC 193L,B01,890921,Hurwitz; Ethan Scott,20,0,30,10
1746578381470,PSYC 193L,C01,890928,Staff,30,0,30,0
1746578382496,RELI 149,A00,886806,Rahimi; Babak,23,0,40,17
1746578383520,SE 9,A01,886814,Staff,7,0,20,13
1746578384544,SE 101B,A01,886816,Chadha; Mayank,4,0,35,31
1746578385567,SE 110B,A00,886818,Zhu; Qiang,4,0,75,71
1746578386599,SE 125,A01,886830,Staff,10,0,30,20
1746578387625,SE 130B,A01,886835,Staff,14,0,40,26
1746578388653,SE 131A,A01,886838,Krysl; Petr,34,0,55,21
1746578389678,SE 154,A00,886840,Staff,29,0,50,21
1746578390706,SE 164GS,A01,886849,Staff,6,0,20,14
1746578391734,SE 167GS,A01,886853,Staff,6,0,20,14
1746578392758,SIO 25,A01,890107,Staff,19,0,30,11
1746578393786,SIO 45,A00,890109,Cook; Geoffrey W,116,0,200,84
1746578394811,SIO 109R,A00,890110,Forman; Fonna,0,16,20,20
1746578395836,SIO 187,A01,890114,Kacev; David,15,0,40,25
1746578396880,SOCI 1,A01,890431,Thorpe; Charles Robert,14,0,30,16
1746578396880,SOCI 1,A02,890518,Thorpe; Charles Robert,30,0,30,0
1746578397905,SOCI 2,A01,957978,Staff,25,0,25,0
1746578397905,SOCI 2,A02,957979,Staff,23,0,25,2
1746578398930,SOCI 20,A01,890523,Calderon-Zaks; Michael Aar,21,0,30,9
1746578398930,SOCI 20,A02,890526,Calderon-Zaks; Michael Aar,29,0,30,1
1746578399956,SOCI 30,A01,890533,Pardo Guerra; Juan Pablo,37,0,40,3
1746578400986,SOCI 40,A01,890535,Staff,27,0,45,18
1746578402013,SOCI 104Q,A00,890559,Staff,18,0,30,12
1746578403037,SOCI 106,A00,890560,Arnal; Maud Marie Leonie,20,0,30,10
1746578404062,SOCI 110,A00,890567,Holkenbrink-Monk; Charlene,19,0,30,11
1746578405087,SOCI 112,A00,890568,Victoria Torres; Pablo,2,0,55,53
1746578406113,SOCI 115,A00,890597,Arnal; Maud Marie Leonie,28,0,45,17
1746578408164,SOCI 121,A00,890604,Pardo Guerra; Juan Pablo,38,0,45,7
1746578409188,SOCI 126,A01,890608,Staff,8,0,10,2
1746578410216,SOCI 127,A00,890609,Staff,18,0,30,12
1746578411240,SOCI 131,A00,890610,Thorpe; Charles Robert,37,0,45,8
1746578412264,SOCI 135,A00,890615,Payne; Christine Anna,13,0,45,32
1746578413291,SOCI 139,A00,890620,Staff,38,0,45,7
1746578414315,SOCI 148E,A00,890622,Calderon-Zaks; Michael Aar,36,0,45,9
1746578415348,SOCI 150,A00,890623,Kohler; Kristopher M.,31,0,45,14
1746578416372,SOCI 157,A00,890625,Jules-Rosette; Bennetta W.,18,0,20,2
1746578417395,SOCI 160,A00,890627,Payne; Christine Anna,21,0,45,24
1746578418421,SYN 1,A00,886855,Fish; Gwendolyn Anne,0,1,0,0
1746578418421,SYN 1,B00,906086,Fish; Gwendolyn Anne,0,2,0,2
1746578419445,SYN 2R,A00,886860,Staff,0,17,15,15
1746578419445,SYN 2R,B00,906106,Atkinson; Arthur Laird,0,16,15,15
1746578420479,SYN 100,A01,886866,Browne; Emily,0,28,20,20
1746578420479,SYN 100,B01,906128,Rock; Martin,0,5,20,20
1746578420479,SYN 100,C01,906140,Deavenport; James Cary,0,3,20,20
1746578420479,SYN 100,D01,907816,Deavenport; James Cary,0,5,20,20
1746578421504,TDAC 1,A00,890286,Walsh; Kim C.,7,0,20,13
1746578422527,TDAC 101,A00,890296,Basso; Beatrice,15,0,20,5
1746578423553,TDDE 131,A00,890297,Staff,47,0,50,3
1746578424579,TDDM 1,A00,890287,Weinberg; Sadie,25,0,30,5
1746578425613,TDGE 11,A00,890288,Fulton; Julia,138,0,200,62
1746578425613,TDGE 11,B00,890289,Castro; Robert Jess,184,0,200,16
1746578426636,TDGE 25,B00,957359,Walsh; Kim C.,5,0,20,15
1746578427660,TDGE 40,A01,890292,Power; Jade Yukana,27,0,30,3
1746578428688,TDGE 124,A00,890298,Havis; Allan,0,1,50,50
1746578429711,TDGE 131R,A00,890299,Burelle; Julie Sara Veronique,15,0,42,27
1746578430738,TDHT 101,A00,890300,Staff,10,0,20,10
1746578431977,TDHT 109,A01,890302,Anderson; Mysia Anyse,31,0,40,9
1746578433001,TDMV 1,A00,890293,Arcidiacono; Kristin,18,0,30,12
1746578434028,TDMV 2,A00,890294,Weinberg; Sadie,23,0,30,7
1746578435058,TDMV 3,A00,957878,Arcidiacono; Kristin,28,0,30,2
1746578437111,TDMV 138,A00,890304,Jun; Grace Shin Hae,25,0,40,15
1746578438140,TDMV 140,A00,890305,Corrales; Joseph Bernales,25,0,30,5
1746578439167,TDMV 142,A00,890307,Caligagan; Tony,32,0,40,8
1746578440192,TDMV 144,A00,890308,Camaya; Michelle Ann,25,0,30,5
1746578441219,TDPW 1,A00,890295,Stein; Deborah Isobel,3,0,20,17
1746578442245,USP 2,A01,890272,Lerner; Amy M,7,0,20,13
1746578443270,USP 3,A01,890274,Staff,12,0,30,18
1746578444295,USP 15,A01,890276,Sun; Feiyang,16,0,30,14
1746578445321,USP 25,A00,890277,Shenkman; Michael Thomas,18,0,25,7
1746578446347,USP 138,A00,890278,Staff,14,0,25,11
1746578447371,USP 143,A00,890279,Staff,22,0,70,48
1746578448397,USP 144,A00,890280,Chowdhury; Muhammed Zohir,16,0,30,14
1746578449423,USP 150,A00,890281,Boomhower; Matthew Charles,4,0,30,26
1746578450454,USP 151,A00,890282,Staff,16,0,20,4
1746578451482,USP 162,A00,890283,Andrews; Abigail Leslie,16,0,20,4
1746578452508,USP 168,A00,920477,Kwak; Nancy,0,0,5,5
1746578453535,USP 181,A00,890284,Staff,3,0,20,17
1746578454563,USP 191A,A00,890285,Staff,12,0,20,8
1746578455597,VIS 101,A00,886512,Staff,25,0,75,50
1746578456623,VIS 103,A00,886513,Cruz; Edwin Teddy,61,0,75,14
1746578457648,VIS 108,A00,886514,Staff,3,0,15,12
1746578458676,VIS 127P,A00,886515,Shen; Kuiyi,80,0,146,66
1746578459701,VIS 149,A00,886516,Yoldas; Pinar,0,0,15,15
1746578460728,VIS 164,A00,886526,Erdmann; Dean,19,0,22,3
1746578461753,VIS 194S,A00,886527,Staff,61,0,75,14
1746578462783,WCWP 10A,C00,886484,Martiniuk; Jill,12,0,15,3
1746578463808,WCWP 10B,A00,886490,Uriarte; Emma,0,0,15,15
1746578463808,WCWP 10B,B00,886491,Dhir; Simrita,8,0,15,7
1746578463808,WCWP 10B,C00,886492,Ornelas; Tricia,0,0,15,15
1746578464838,WCWP 100,A00,886494,Young; Mark T,0,6,15,15
1746578466955,AAS 10,A01,886199,Childs; Dennis R.,0,3,0,0
1746578467984,ANAR 104,A01,886940,Shtienberg; Gilad,27,0,30,3
1746578469009,ANAR 120,A00,886953,Staff,12,0,20,8
1746578470037,ANBI 148,A01,886955,Wilder; Linnea Lorene,30,0,40,10
1746578472090,ANSC 122,A00,886957,Staff,25,0,30,5
1746578473116,ANSC 150,A00,886958,Sloane; Julia Kathryn,2,0,15,13
1746578474145,ANSC 156,A00,886959,Jenkins; Janis A.,0,1,15,15
1746578475172,ANSC 180,A00,886960,Staff,11,0,17,6
1746578476209,ANSC 188,A00,886961,Jassal; Aftab,9,0,25,16
1746578477238,ANSC 190,A00,886962,Jassal; Aftab,14,0,25,11
1746578478263,ANSC 191,A00,886963,Staff,18,0,20,2
1746578479287,ANTH 3,A01,891689,Staff,17,0,20,3
1746578480315,ANTH 5,A00,886933,Semendeferi; Ekaterini,16,0,20,4
1746578481339,ANTH 10,A00,886934,Staff,0,12,30,30
1746578482365,ANTH 21,A01,886936,Staff,41,0,60,19
1746578483391,ANTH 23,A01,886938,Staff,92,0,100,8
1746578484420,ANTH 105,A00,886964,Stewart; Alexander B,84,0,100,16
1746578485444,ANTH 108,A00,886965,Pedersen; David,9,0,20,11
1746578486472,AWP 10,001,886147,Staff,0,0,0,0
1746578486472,AWP 10,002,886148,Staff,0,0,0,0
1746578486472,AWP 10,003,886149,Staff,0,0,0,0
1746578486472,AWP 10,004,886150,Staff,0,0,0,0
1746578486472,AWP 10,005,886151,Staff,0,0,0,0
1746578486472,AWP 10,006,886152,Staff,0,0,0,0
1746578486472,AWP 10,007,886153,Staff,0,0,0,0
1746578486472,AWP 10,008,886154,Staff,0,0,0,0
1746578486472,AWP 10,009,886155,Staff,0,0,0,0
1746578486472,AWP 10,010,886156,Staff,0,0,0,0
1746578486472,AWP 10,011,886158,Staff,0,0,0,0
1746578486472,AWP 10,012,886160,Staff,0,0,0,0
1746578486472,AWP 10,013,886161,Staff,0,0,0,0
1746578486472,AWP 10,014,886162,Staff,0,0,0,0
1746578486472,AWP 10,015,886163,Staff,0,0,0,0
1746578486472,AWP 10,016,886164,Staff,0,0,0,0
1746578486472,AWP 10,017,886165,Staff,0,0,0,0
1746578486472,AWP 10,018,886166,Staff,0,0,0,0
1746578486472,AWP 10,019,886168,Staff,0,0,0,0
1746578486472,AWP 10,020,886170,Staff,0,0,0,0
1746578486472,AWP 10,021,886172,Staff,0,0,0,0
1746578487499,AWP 10R,001,886173,Staff,0,1,0,0
1746578487499,AWP 10R,002,886174,Staff,0,1,0,0
1746578487499,AWP 10R,003,886175,Staff,0,0,0,0
1746578487499,AWP 10R,004,886176,Staff,0,0,0,0
1746578487499,AWP 10R,005,886177,Staff,0,0,0,0
1746578487499,AWP 10R,006,886178,Staff,0,0,0,0
1746578487499,AWP 10R,007,886179,Staff,0,0,0,0
1746578487499,AWP 10R,008,886181,Staff,0,0,0,0
1746578487499,AWP 10R,009,886182,Staff,0,0,0,0
1746578487499,AWP 10R,010,886183,Staff,0,0,0,0
1746578487499,AWP 10R,011,886184,Staff,0,0,0,0
1746578487499,AWP 10R,012,886185,Staff,0,0,0,0
1746578487499,AWP 10R,013,886186,Staff,0,0,0,0
1746578487499,AWP 10R,014,886187,Staff,0,0,0,0
1746578487499,AWP 10R,015,886188,Staff,0,0,0,0
1746578487499,AWP 10R,016,886189,Staff,0,0,0,0
1746578487499,AWP 10R,017,960532,Staff,0,0,0,0
1746578487499,AWP 10R,018,960533,Staff,0,0,0,0
1746578487499,AWP 10R,019,960534,Staff,0,0,0,0
1746578487499,AWP 10R,020,960538,Staff,0,0,0,0
1746578487499,AWP 10R,021,960540,Staff,0,0,0,0
1746578487499,AWP 10R,022,960541,Staff,0,0,0,0
1746578487499,AWP 10R,023,960542,Staff,0,0,0,0
1746578487499,AWP 10R,024,960544,Staff,0,0,0,0
1746578487499,AWP 10R,025,960545,Staff,0,0,0,0
1746578487499,AWP 10R,026,960548,Staff,0,0,0,0
1746578488527,AWP 102R,A00,886190,Staff,0,0,0,0
1746578488527,AWP 102R,B00,886191,Staff,0,0,0,0
1746578489556,BENG 100,A01,886193,Staff,17,0,30,13
1746578490582,BENG 122A,A01,886195,Hasty; Jeff M,13,0,30,17
1746578491606,BENG 166A,A00,886196,Sah; Robert Lie-Yuan,0,3,30,30
1746578492632,BENG 190,A00,958050,Khojah; Reem I,19,0,25,6
1746578493661,BIBC 102,A01,894320,Staff,0,0,46,46
1746578493661,BIBC 102,A02,894321,Staff,0,0,46,46
1746578493661,BIBC 102,A03,894344,Staff,6,0,46,40
1746578493661,BIBC 102,A04,894345,Staff,27,0,47,20
1746578494693,BICD 100R,A01,894365,Smith; Laurie,0,3,58,58
1746578494693,BICD 100R,A02,894366,Smith; Laurie,0,5,58,58
1746578494693,BICD 100R,A03,894367,Smith; Laurie,0,0,59,59
1746578494693,BICD 100R,A04,959869,Smith; Laurie,40,0,59,19
1746578495721,BICD 136,A01,894383,Gustafson-Brown; Cindy,14,0,50,36
1746578496746,BIEB 102,A01,894494,Butler; Shannon Rhey,51,0,130,79
1746578498799,BIEB 150,A01,894617,Wills; Christopher,3,0,20,17
1746578498799,BIEB 150,A02,894631,Wills; Christopher,3,0,20,17
1746578498799,BIEB 150,A03,894937,Wills; Christopher,3,0,20,17
1746578498799,BIEB 150,A04,894946,Wills; Christopher,5,0,20,15
1746578499823,BIEB 194,A00,906141,Kurle; Carolyn M.,6,0,20,14
1746578500849,BILD 1,A01,894154,Staff,3,0,19,16
1746578500849,BILD 1,A02,894155,Staff,14,0,19,5
1746578500849,BILD 1,A03,894160,Staff,13,0,19,6
1746578500849,BILD 1,A04,894161,Staff,15,0,18,3
1746578501878,BILD 2,A01,894168,Staff,0,0,50,50
1746578501878,BILD 2,A02,894169,Staff,0,0,50,50
1746578501878,BILD 2,A03,894179,Staff,0,0,50,50
1746578501878,BILD 2,A04,894203,Staff,24,0,50,26
1746578502902,BILD 3,A01,894213,Staff,23,0,31,8
1746578502902,BILD 3,A02,894214,Staff,26,0,31,5
1746578502902,BILD 3,A03,894235,Staff,28,0,31,3
1746578502902,BILD 3,A04,894236,Staff,28,0,32,4
1746578503931,BILD 4,A01,894253,Reuther; Keefe,5,0,24,19
1746578503931,BILD 4,A02,894258,Reuther; Keefe,16,0,24,8
1746578504961,BILD 5,A01,894276,Reuther; Keefe,35,0,50,15
1746578504961,BILD 5,A02,894277,Reuther; Keefe,45,0,50,5
1746578504961,BILD 5,A03,894290,Reuther; Keefe,44,0,50,6
1746578504961,BILD 5,A04,894291,Reuther; Keefe,48,0,50,2
1746578505985,BILD 24,A01,894297,Pirino; Giorgia,40,0,60,20
1746578507010,BIMM 100,B01,958915,Staff,71,0,100,29
1746578508036,BIMM 101,A01,895017,McDonnell; Lisa Marie,0,5,24,24
1746578508036,BIMM 101,A02,895018,McDonnell; Lisa Marie,0,5,24,24
1746578508036,BIMM 101,B01,895020,McDonnell; Lisa Marie,0,6,24,24
1746578508036,BIMM 101,B02,895021,McDonnell; Lisa Marie,0,4,24,24
1746578509061,BIMM 110,A01,895023,Staff,1,0,25,24
1746578509061,BIMM 110,A02,895024,Staff,9,0,25,16
1746578509061,BIMM 110,A03,895025,Staff,18,0,25,7
1746578509061,BIMM 110,A04,895031,Staff,20,0,25,5
1746578510087,BIMM 120,A01,895114,Gustafson-Brown; Cindy,14,0,28,14
1746578510087,BIMM 120,A02,895126,Gustafson-Brown; Cindy,21,0,27,6
1746578511117,BIPN 100,A01,895130,Yang; Mingyu,0,0,38,38
1746578511117,BIPN 100,A02,895131,Yang; Mingyu,32,0,38,6
1746578511117,BIPN 100,A03,895132,Yang; Mingyu,32,0,38,6
1746578511117,BIPN 100,A04,895133,Yang; Mingyu,27,0,36,9
1746578512144,BIPN 120,A01,895135,Cooke; James Edward,0,3,13,13
1746578512144,BIPN 120,A02,895136,Cooke; James Edward,0,1,13,13
1746578512144,BIPN 120,A03,895137,Cooke; James Edward,0,3,13,13
1746578512144,BIPN 120,A04,895156,Cooke; James Edward,0,2,11,11
1746578513169,BIPN 134,A01,895235,Cooke; James Edward,0,2,25,25
1746578513169,BIPN 134,A02,895237,Cooke; James Edward,0,0,25,25
1746578513169,BIPN 134,A03,895240,Cooke; James Edward,3,0,25,22
1746578513169,BIPN 134,A04,895270,Cooke; James Edward,20,0,25,5
1746578514197,BIPN 189,A00,892103,Staff,0,14,14,14
1746578516244,BISP 194,A00,958008,Staff,0,2,0,0
1746578517268,CAT 124,A01,922009,Staff,0,5,20,20
1746578518296,CAT 125R,A00,886390,Morales; Celeste Georgianna,0,2,20,20
1746578518296,CAT 125R,B00,886391,Irwin; Matthew Joseph,0,4,20,20
1746578518296,CAT 125R,C00,886392,Smith; Lauryn Alissa,0,2,20,20
1746578518296,CAT 125R,D00,886393,Vanderschuit; Maya Alysia,0,3,20,20
1746578518296,CAT 125R,E00,886394,Marchisotto; Jennifer Anne,0,3,20,20
1746578519320,CENG 15,A01,886218,Drews; Aaron,3,0,8,5
1746578520348,CENG 113,A00,886219,Opatkiewicz; Justin Paul,15,0,25,10
1746578521373,CGS 101,A00,887044,Staff,7,0,20,13
1746578522409,CGS 105,A01,887046,Staff,14,0,25,11
1746578523434,CGS 112,A00,887047,Cuong; Marisol,12,0,15,3
1746578524458,CGS 113,A00,887048,Staff,23,0,30,7
1746578525483,CGS 120,A00,887049,Staff,10,0,17,7
1746578526512,CHEM 6A,A01,886336,Lam; Tin Yiu,38,0,50,12
1746578526512,CHEM 6A,A02,886338,Lam; Tin Yiu,37,0,50,13
1746578527539,CHEM 6B,A01,886341,Hopkins; Patrycja Anna,16,0,50,34
1746578527539,CHEM 6B,A02,886343,Hopkins; Patrycja Anna,42,0,50,8
1746578528568,CHEM 6C,A01,886346,Albizati; Kim F.,0,2,50,50
1746578528568,CHEM 6C,A02,886348,Albizati; Kim F.,23,0,50,27
1746578529594,CHEM 40A,A01,886352,Klosterman; Jeremy K,65,0,100,35
1746578530628,CHEM 40B,A01,886356,Klosterman; Jeremy K,0,24,100,100
1746578531653,CHEM 41B,A01,886360,Theodorakis; Emmanuel,25,0,50,25
1746578531653,CHEM 41B,A02,886362,Theodorakis; Emmanuel,47,0,50,3
1746578532678,CHIN 165A,A00,886382,Xu; Li,18,0,20,2
1746578533710,CLAS 120,A00,886387,Myerston Santana; Jacobo,33,0,40,7
1746578534734,COGS 9,A01,886967,Shannon; Kyle Michael,42,0,60,18
1746578535764,COGS 11,A01,886969,Staff,9,0,30,21
1746578536789,COGS 14A,A01,886971,Staff,6,0,60,54
1746578537814,COGS 14B,A01,886973,Hoffman; Drew Ellen,4,0,60,56
1746578538840,COGS 18,A01,886975,Morgan; Eric,35,0,60,25
1746578539864,COGS 20,A01,886977,Staff,4,0,8,4
1746578539864,COGS 20,A02,886978,Staff,5,0,7,2
1746578540893,COGS 100,A01,907783,Staff,1,2,30,29
1746578541918,COGS 101B,A01,886980,Staff,0,4,48,48
1746578542944,COGS 101C,A01,886982,Delgado; Tania,0,5,44,44
1746578543967,COGS 102A,A01,886984,Johnson; Christine M.,4,0,30,26
1746578544992,COGS 118B,A01,886986,Staff,1,4,88,87
1746578546021,COGS 150,A01,886988,Bergen; Benjamin,22,0,50,28
1746578547048,COGS 153,A00,886989,Delgado; Tania,0,2,41,41
1746578548085,COGS 186,A01,886991,Staff,0,0,32,32
1746578549111,COGS 187A,A01,886993,Boyle; Mary E. T.,7,0,30,23
1746578550138,COGS 189,A00,886994,Staff,0,1,30,30
1746578551166,COMM 10,A01,886996,Staff,0,0,20,21
1746578551166,COMM 10,A02,886997,Staff,10,0,20,10
1746578551166,COMM 10,A03,959845,Staff,19,0,20,1
1746578552192,COMM 20,A01,886999,Leuning; Grant Maurstad,24,0,40,16
1746578554244,COMM 100A,A01,887002,Staff,0,0,20,25
1746578554244,COMM 100A,A02,887003,Staff,6,0,20,14
1746578555272,COMM 100B,A01,887005,Staff,0,8,20,24
1746578556297,COMM 106D,A00,887006,Staff,13,0,40,27
1746578557326,COMM 110G,A00,887007,Whitworth-Smith; Andrew C,12,0,40,28
1746578558351,COMM 111B,A00,887008,Staff,31,0,40,9
1746578559376,COMM 113T,A00,887009,Abuelhiga; Soraya Jill,28,0,40,12
1746578559376,COMM 113T,B00,906733,Staff,40,0,40,0
1746578560404,COMM 145,A00,887010,Staff,12,0,40,28
1746578561429,COMM 146,A00,887054,Staff,31,0,40,9
1746578562455,COMM 190,A00,887012,Staff,8,0,23,15
1746578563483,CSE 8A,A50,887015,Cao; Yingjun,57,0,85,28
1746578564508,CSE 11,A01,887017,Cao; Yingjun,12,0,70,58
1746578565536,CSE 20,A01,887019,Staff,30,0,50,20
1746578566606,CSE 21,A01,887021,Staff,78,0,100,22
1746578566606,CSE 21,B01,892583,Braun; Oliver,45,0,50,5
1746578567631,CSE 30,A01,887025,Eldon; John,143,0,200,57
1746578568656,CSE 100,A01,887027,Staff,26,0,50,24
1746578568656,CSE 100,A02,887028,Staff,42,0,50,8
1746578569689,CSE 101,A01,887030,Braun; Oliver,74,0,100,26
1746578569689,CSE 101,B01,887032,Jones; Miles E,0,3,50,50
1746578569689,CSE 101,B02,887033,Jones; Miles E,0,2,50,50
1746578570715,CSE 105,A01,908084,Jones; Miles E,32,0,50,18
1746578570715,CSE 105,A02,908087,Jones; Miles E,31,0,50,19
1746578571740,CSE 135,A01,887035,Powell; Thomas Allan,0,5,50,50
1746578572766,CSE 142,A01,887037,Staff,8,0,60,52
1746578573792,CSE 142L,A01,887039,Staff,34,0,60,26
1746578574818,CSE 151A,A01,887041,Solares; Edwin A,47,0,100,53
1746578575843,CSE 175,A01,887043,Kumar; Rakesh,30,0,30,0
1746578576868,CSS 1,A01,886389,Staff,1,2,40,39
1746578577893,DSC 30,A01,908097,Liao; Soohyun Nam,47,0,75,28
1746578578921,DSC 40A,A01,908099,Shannon; Kyle Michael,30,0,50,20
1746578579951,DSC 40B,A01,908112,Staff,15,0,50,35
1746578580977,DSC 80,A01,908116,Staff,19,0,60,41
1746578582003,DSC 197,001,956863,Eldridge; Justin Matthew,9999,0,9999,0
1746578583028,ECE 5,A01,886400,Morris; Karcher William,1,0,6,5
1746578583028,ECE 5,A02,886401,Morris; Karcher William,3,0,6,3
1746578584056,ECE 148,A01,886403,Silberman; Jack,0,14,14,14
1746578585086,ECON 1,A01,887265,Crane; Meredith Helen,12,0,70,58
1746578585086,ECON 1,B01,887268,Staff,42,0,50,8
1746578586114,ECON 2,A01,887273,Crane; Meredith Helen,55,0,70,15
1746578587142,ECON 3,A01,887279,Rondina; Giacomo,32,0,70,38
1746578588168,ECON 4,A01,887282,Anderson; John Charles,0,2,10,10
1746578589193,ECON 5,A01,887285,Staff,34,0,45,11
1746578589193,ECON 5,B01,887292,Staff,41,0,45,4
1746578590218,ECON 100A,A01,887337,Newhouse; Herbert S,54,0,70,16
1746578590218,ECON 100A,B01,887349,Staff,45,0,50,5
1746578591241,ECON 100B,A01,887361,Du; Songzi,29,0,70,41
1746578592266,ECON 100C,A01,887445,Newhouse; Herbert S,59,0,70,11
1746578593293,ECON 105,A00,887488,Vespa; Emanuel Ignacio,23,0,35,12
1746578594318,ECON 109,A01,887506,Shishkin; Denis,28,0,35,7
1746578595344,ECON 110A,A01,887568,Alon; Titan Michael,0,3,35,35
1746578595344,ECON 110A,B01,907601,Alon; Titan Michael,20,0,35,15
1746578596371,ECON 110B,A01,887598,Levkoff; Steven B.,0,24,70,70
1746578597395,ECON 112,A00,887599,Rondina; Giacomo,19,0,35,16
1746578598419,ECON 120A,A01,887603,Dai; Yinlin,35,0,70,35
1746578599462,ECON 120C,A01,887608,Sun; Yixiao,0,1,35,35
1746578599462,ECON 120C,B01,887614,Sun; Yixiao,0,0,35,35
1746578600490,ECON 138,A00,887621,Bharadwaj; Prashant,0,21,20,20
1746578601518,ECON 144,A00,958007,Squires; Dale E,12,0,35,23
1746578602542,ECON 171,A01,907666,Staff,18,0,35,17
1746578603570,ECON 175,A00,887626,Wu; Pak Yeung,22,0,35,13
1746578604600,ECON 190,A00,887640,Vespa; Emanuel Ignacio,22,0,35,13
1746578605629,EDS 25,A01,888197,Staff,0,0,0,0
1746578605629,EDS 25,A02,888209,Staff,0,0,0,0
1746578605629,EDS 25,A03,888210,Staff,0,0,0,0
1746578605629,EDS 25,A04,888212,Staff,0,0,0,0
1746578605629,EDS 25,A05,888213,Staff,0,0,0,0
1746578605629,EDS 25,A06,888214,Staff,0,0,0,0
1746578605629,EDS 25,A07,888235,Staff,0,2,0,0
1746578605629,EDS 25,A08,888236,Staff,0,0,0,0
1746578605629,EDS 25,A09,888240,Staff,0,0,0,0
1746578605629,EDS 25,A10,888244,Staff,0,0,0,0
1746578605629,EDS 25,B01,888273,Staff,0,0,0,0
1746578605629,EDS 25,B02,888285,Staff,0,0,0,0
1746578605629,EDS 25,B03,888423,Staff,0,0,0,1
1746578605629,EDS 25,B04,888432,Staff,0,0,0,0
1746578605629,EDS 25,B05,888433,Staff,0,0,0,0
1746578605629,EDS 25,B06,888467,Staff,0,0,0,0
1746578605629,EDS 25,B07,888468,Staff,0,0,0,0
1746578605629,EDS 25,B08,888479,Staff,0,0,0,0
1746578605629,EDS 25,B09,888484,Staff,0,0,0,0
1746578605629,EDS 25,B10,888487,Staff,0,0,0,0
1746578606654,EDS 38,A01,907700,Choi; Bailey Miyeon,30,0,30,0
1746578607682,EDS 112,A01,888601,Chapman; Thandeka K,12,0,40,28
1746578608708,EDS 115,A00,888697,Mendez; Kathrina Mendoza,10,0,30,20
1746578609734,EDS 116,A01,888893,Staff,34,0,40,6
1746578611784,EDS 124AR,A00,889133,Staff,29,0,50,21
1746578611784,EDS 124AR,B00,907471,Simon; Elizabeth A,37,0,50,13
1746578612809,EDS 124BR,A00,889134,Simon; Elizabeth A,44,0,100,56
1746578613837,EDS 125,A00,889135,Staff,25,0,30,5
1746578614861,EDS 126,A01,889138,Staff,35,0,40,5
1746578615884,EDS 164R,A01,889142,Wishard Guerra; Alison G.,33,0,50,17
1746578616909,ENG 30,A01,886396,Staff,0,0,0,0
1746578616909,ENG 30,B01,886398,Staff,0,0,0,0
1746578617939,ENVR 102,A00,906150,Montejo; Carolina,23,0,25,2
1746578618965,ETHN 103A,A00,887236,Man; Simeon S,0,3,0,0
1746578619991,ETHN 113,A00,887239,Staff,16,0,30,14
1746578621016,ETHN 116,A00,887240,Staff,16,0,25,9
1746578622041,ETHN 117,A00,887241,Choi; Esther Min,28,0,30,2
1746578623068,ETHN 118,A00,887243,Staff,24,0,30,6
1746578624094,ETHN 127,A00,887248,Cuong; Marisol,11,0,15,4
1746578625118,ETHN 139,A00,887250,Staff,7,0,10,3
1746578626145,ETHN 142,A00,887252,Staff,10,0,30,20
1746578627174,ETHN 161,A00,887253,Browne; Errol Tsekani,24,0,30,6
1746578628203,ETHN 163FR,A00,887255,Burelle; Julie Sara Veronique,0,0,5,5
1746578629227,GLBH 20,A00,889149,Elwardani; Nile Regina,8,0,42,34
1746578631276,GLBH 111,A01,889152,Burgos; Jose L.,17,0,17,0
1746578632301,GLBH 150,A00,889181,Sloane; Julia Kathryn,0,5,15,15
1746578634354,HDS 60,A01,886406,Warstadt; Melissa Fawn,73,0,80,7
1746578635378,HIAF 111,A00,889324,Gyamfi; Bright,25,0,32,7
1746578636407,HIEA 131,A00,889328,Staff,15,0,32,17
1746578637430,HIEA 144,A00,889333,Henry; Todd A.,26,0,32,6
1746578638458,HIEA 154,A00,889336,Henry; Todd A.,24,0,32,8
1746578639482,HIEU 106,A00,889339,Staff,22,0,32,10
1746578641536,HIEU 114,A00,889340,Staff,4,0,32,28
1746578642565,HIEU 135GS,A00,889342,Patterson; Patrick H.,0,0,1,24
1746578643611,HIEU 137,A00,889343,Edington; Claire Ellen,10,0,25,15
1746578644636,HIEU 148,A00,889345,Staff,14,0,32,18
1746578645682,HIEU 154,A00,889346,Biess; Frank Peter,21,0,32,11
1746578646708,HILA 102,A00,889351,Staff,12,0,32,20
1746578647736,HILD 2A,A01,889221,Lewandoski; Julia Mavis,1,10,32,31
1746578648766,HILD 7B,A01,889225,Man; Simeon S,0,12,32,32
1746578649796,HILD 7C,A01,889288,Alvarez; Luis A,0,14,32,32
1746578650822,HILD 30,A01,889323,Staff,0,5,32,32
1746578652875,HISC 119,A00,889383,Golan; Tal,19,0,32,13
1746578653898,HIUS 103,A00,889384,Man; Simeon S,0,0,32,32
1746578654923,HIUS 117,A00,919797,Kwak; Nancy,19,0,32,13
1746578655951,HIUS 142A,A00,919788,Staff,22,0,32,10
1746578657999,HIUS 149,A00,889386,Gyamfi; Bright,26,0,32,6
1746578659027,HIUS 155,A00,889387,Alvarez; Luis A,15,0,32,17
1746578660058,HUM 3,A01,886499,Caldwell; Michael Alan,19,0,50,31
1746578661086,HUM 3GS,A00,886500,Rodriguez; Bretton Sigfred,0,0,0,28
1746578662111,HUM 3R,A01,886502,Markman; Kristina,0,36,50,50
1746578663139,HUM 4,A01,886504,Crum; Matthew Stephen,23,0,50,27
1746578663139,HUM 4,B01,886506,West; Geoffrey Scott,17,0,50,33
1746578664163,HUM 4GS,A00,886507,Staff,0,0,0,19
1746578665191,HUM 5,A01,886509,Staff,32,0,50,18
1746578666219,HUM 5R,A01,886511,Zavodny; Tatiana Sophia,0,39,50,50
1746578667246,JAPN 180,A00,886407,Staff,16,0,40,24
1746578668272,LATI 50,A01,886409,Martin-Cabrera; Luis,3,0,22,19
1746578668272,LATI 50,A02,886410,Martin-Cabrera; Luis,19,0,22,3
1746578668272,LATI 50,A03,886411,Martin-Cabrera; Luis,21,0,22,1
1746578668272,LATI 50,A04,886412,Martin-Cabrera; Luis,8,0,22,14
1746578669297,LAWS 101,A00,907664,Staff,28,0,60,32
1746578670337,LIAB 1A,A00,889388,Saab; Dima,17,0,20,3
1746578671361,LIAB 1AX,A00,889389,El Cheddadi; Youniss,18,0,20,2
1746578672386,LIFR 1C,A00,889391,Van Moer; Vinciane G,8,0,20,12
1746578673411,LIFR 1CX,A00,889392,Van Moer; Vinciane G,7,0,20,13
1746578674434,LIFR 1D,A00,889393,Van Moer; Vinciane G,7,0,20,13
1746578675463,LIFR 1DX,A00,889394,Van Moer; Vinciane G,8,0,20,12
1746578676488,LIGN 7,A00,886923,Staff,24,0,50,26
1746578677512,LIGN 17,A00,886924,Kehler; Andrew Scott,125,0,150,25
1746578678535,LTAM 110,A00,889395,Staff,15,0,30,15
1746578690638,LTAM 110GS,A00,958010,Rodriguez; Bretton Sigfred,0,0,0,28
1746578691665,LTCH 101,A00,889397,Staff,23,0,25,2
1746578692692,LTCS 130,A00,889398,Staff,23,0,25,2
1746578693718,LTEA 138,A00,889399,Staff,24,0,40,16
1746578694747,LTEN 149,A00,889400,Wesling; Megan E.,0,3,25,25
1746578695771,LTEN 169,A00,889401,Staff,20,0,25,5
1746578696798,LTEN 180,A00,889402,Staff,10,0,15,5
1746578697826,LTEN 181,A00,889403,Staff,21,0,25,4
1746578698855,LTWL 100,A00,889404,Myerston Santana; Jacobo,2,0,25,23
1746578699879,LTWL 180GS,A00,889405,Staff,0,0,20,20
1746578700908,LTWL 181,A00,889406,Staff,16,0,25,9
1746578701935,LTWL 184,A00,889475,Mukherjee; Silpa,22,0,25,3
1746578702963,LTWR 102C,A00,889486,Staff,29,0,30,1
1746578703988,LTWR 115W,A00,889491,Staff,0,2,15,15
1746578705013,MAE 8,A01,886905,Staff,0,2,0,0
1746578706037,MAE 11,A00,886906,Bandaru; Prabhakar,0,7,50,50
1746578707060,MAE 20,A00,886907,Evdokimenko; Ekaterina,43,0,70,27
1746578708083,MAE 30B,A00,886909,Ghazinejad; Maziar,26,0,45,19
1746578709109,MAE 101B,A00,886910,Saintillan; David,29,0,45,16
1746578710133,MAE 105,A00,886911,Bandaru; Prabhakar,18,0,50,32
1746578711157,MAE 107,B00,958024,Staff,8,0,50,42
1746578712183,MAE 143B,A00,886913,Bewley; Thomas R,3,0,40,37
1746578713207,MAE 148,A01,886915,Silberman; Jack,0,3,14,14
1746578714236,MAE 160,A00,886916,Evdokimenko; Ekaterina,31,0,60,29
1746578715262,MATH 3C,A01,889681,Staff,0,2,30,30
1746578715262,MATH 3C,A02,960048,Staff,24,0,30,6
1746578716288,MATH 10A,A01,889760,Staff,26,0,30,4
1746578716288,MATH 10A,A02,889783,Staff,29,0,30,1
1746578717316,MATH 10B,A01,889785,Verstraete; Jacques Allan,2,0,35,33
1746578717316,MATH 10B,A02,889795,Verstraete; Jacques Allan,4,0,35,31
1746578717316,MATH 10B,B01,889797,Verstraete; Jacques Allan,3,0,35,32
1746578717316,MATH 10B,B02,889828,Verstraete; Jacques Allan,3,0,35,32
1746578718347,MATH 10C,A01,889849,Habib; Yousaf,7,0,30,23
1746578718347,MATH 10C,A02,889852,Habib; Yousaf,14,0,30,16
1746578718347,MATH 10C,A03,889853,Habib; Yousaf,22,0,30,8
1746578718347,MATH 10C,A04,889858,Habib; Yousaf,20,0,30,10
1746578718347,MATH 10C,B01,889861,Staff,1,0,30,29
1746578718347,MATH 10C,B02,889862,Staff,24,0,30,6
1746578718347,MATH 10C,B03,889863,Staff,27,0,30,3
1746578718347,MATH 10C,B04,889967,Staff,23,0,30,7
1746578719371,MATH 18,A01,889974,Staff,7,0,30,23
1746578719371,MATH 18,A02,889977,Staff,20,0,30,10
1746578719371,MATH 18,B01,889984,Hardiman; Liam,20,0,30,10
1746578719371,MATH 18,B02,889985,Hardiman; Liam,25,0,30,5
1746578720395,MATH 20A,A01,889990,Suk; Andrew Hoon,30,0,35,5
1746578721421,MATH 20B,A01,889993,Ohm; Ko Woon,22,0,30,8
1746578721421,MATH 20B,A02,889994,Ohm; Ko Woon,30,0,30,0
1746578721421,MATH 20B,B01,889996,Ohm; Ko Woon,22,0,30,8
1746578721421,MATH 20B,B02,889997,Ohm; Ko Woon,23,0,30,7
1746578722447,MATH 20C,A01,889999,Hammock; Frances H,17,0,30,13
1746578722447,MATH 20C,A02,890003,Hammock; Frances H,23,0,30,7
1746578722447,MATH 20C,B01,890006,Hammock; Frances H,3,0,30,27
1746578722447,MATH 20C,B02,890007,Hammock; Frances H,12,0,30,18
1746578723479,MATH 20D,A01,890011,Cheng; Hsiao-Bing,1,1,30,29
1746578723479,MATH 20D,A02,890012,Cheng; Hsiao-Bing,14,0,30,16
1746578723479,MATH 20D,B01,890016,Cheng; Hsiao-Bing,13,0,30,17
1746578723479,MATH 20D,B02,890017,Cheng; Hsiao-Bing,13,0,30,17
1746578724504,MATH 20E,A01,890026,Harel; Guershon,1,0,30,29
1746578724504,MATH 20E,A02,890029,Harel; Guershon,23,0,30,7
1746578724504,MATH 20E,B01,890033,Harel; Guershon,7,0,30,23
1746578724504,MATH 20E,B02,890101,Harel; Guershon,21,0,30,9
1746578725533,MATH 102,A01,890104,Staff,18,0,30,12
1746578725533,MATH 102,A02,890105,Staff,27,0,30,3
1746578726558,MATH 103B,A01,890116,Salehi Golsefidy; Alireza,3,0,30,27
1746578726558,MATH 103B,B01,890118,Staff,0,3,34,34
1746578727587,MATH 109,A01,890121,Aliabadi Sr.; Mohsen,0,0,30,30
1746578727587,MATH 109,B01,890124,Upadrashta; Pranav Kumar,18,0,30,12
1746578728612,MATH 120A,A01,890126,Eggers; John Dietrich,13,0,30,17
1746578729637,MATH 142B,A01,890128,Ioana; Adrian,19,0,30,11
1746578729637,MATH 142B,A02,890129,Ioana; Adrian,12,0,30,18
1746578730666,MATH 154,A01,890174,Staff,0,0,30,30
1746578730666,MATH 154,A02,890182,Staff,0,0,30,30
1746578731691,MATH 168A,A01,890197,Dumitriu; Ioana,21,0,35,14
1746578732722,MATH 170A,A01,890240,Nie; Jiawang,1,0,30,29
1746578732722,MATH 170A,A02,890241,Nie; Jiawang,11,0,30,19
1746578732722,MATH 170A,A03,890249,Nie; Jiawang,23,0,30,7
1746578733752,MATH 170B,A01,957891,Nag; Panchali,13,0,35,22
1746578735830,MATH 181A,A01,908025,Staff,0,3,35,35
1746578735830,MATH 181A,A02,960115,Staff,26,0,35,9
1746578736859,MATH 181B,A01,959874,Staff,25,0,30,5
1746578737885,MATH 193B,A01,890265,Staff,0,4,35,35
1746578738909,MGT 4,A01,890311,Anderson; John Charles,42,0,88,46
1746578739937,MGT 5,A00,907740,Staff,13,0,98,85
1746578740960,MGT 12,A00,890312,Lindenberger; Wade Douglas,67,0,98,31
1746578741984,MGT 16,A00,957883,Staff,78,0,98,20
1746578744038,MGT 45,A00,890314,Pecore; Joseph P.,45,0,98,53
1746578745063,MGT 71,A00,890315,Staff,0,12,98,98
1746578746091,MGT 100,A00,890316,Yavorsky; Daniel Ryan,44,0,98,54
1746578747115,MGT 103,A00,890317,Ehrich; Kristine R,73,0,98,25
1746578748144,MGT 105,A00,890356,Bates; Kenneth Walter,0,8,98,98
1746578749170,MGT 112,A00,890360,Ehrich; Kristine R,55,0,98,43
1746578750194,MGT 127R,A00,907732,Zhu; Kevin Xiaoguo,23,0,98,75
1746578751220,MGT 131B,A00,890361,Anderson; John Charles,59,0,98,39
1746578752248,MGT 137,A00,890362,Lindenberger; Wade Douglas,65,0,98,33
1746578753275,MGT 160,A00,890369,Johnson; Erik Barry,9,0,98,89
1746578755330,MGT 164,A00,890372,Zimmermann; Carsten,0,40,98,98
1746578756355,MGT 180,A00,890374,Bliss; Barbara Ann,12,0,98,86
1746578757381,MMW 15,A01,886414,Chang; Edmond Yi-Teh,0,12,28,28
1746578757381,MMW 15,A02,886415,Chang; Edmond Yi-Teh,0,8,28,28
1746578757381,MMW 15,A03,886416,Chang; Edmond Yi-Teh,0,9,28,28
1746578757381,MMW 15,A04,886417,Chang; Edmond Yi-Teh,0,8,28,28
1746578757381,MMW 15,B01,886419,Chang; Edmond Yi-Teh,0,7,28,28
1746578757381,MMW 15,B02,886420,Chang; Edmond Yi-Teh,0,8,28,28
1746578757381,MMW 15,B03,886421,Chang; Edmond Yi-Teh,0,7,28,28
1746578757381,MMW 15,B04,886422,Chang; Edmond Yi-Teh,0,8,28,28
1746578757381,MMW 15,C01,886424,Staff,0,9,28,28
1746578757381,MMW 15,C02,886425,Staff,0,8,28,28
1746578757381,MMW 15,C03,886426,Staff,0,8,28,28
1746578757381,MMW 15,C04,886427,Staff,0,8,28,28
1746578757381,MMW 15,C05,958038,Staff,0,8,28,28
1746578757381,MMW 15,C06,958039,Staff,1,8,28,27
1746578758408,MMW 15GS,A00,906910,Patterson; Patrick H.,4,0,28,24
1746578759432,MMW 122R,A01,886429,Rahimi; Babak,0,13,28,28
1746578759432,MMW 122R,A02,886430,Rahimi; Babak,0,12,28,28
1746578759432,MMW 122R,A03,958040,Rahimi; Babak,0,11,28,28
1746578760459,MUS 1A,A01,890937,Staff,2,0,25,23
1746578760459,MUS 1A,A02,891035,Staff,6,0,25,19
1746578760459,MUS 1A,C01,958912,Staff,24,0,25,1
1746578760459,MUS 1A,C02,958913,Staff,25,0,25,0
1746578762507,MUS 2AK,A00,957092,Ohnishi; Takae,15,0,15,0
1746578763532,MUS 4,A01,891044,Staff,1,0,25,24
1746578763532,MUS 4,A02,891045,Staff,23,0,25,2
1746578763532,MUS 4,B01,891048,Staff,17,0,25,8
1746578763532,MUS 4,B02,891050,Staff,25,0,25,0
1746578764557,MUS 5,A01,957506,Dubnov; Shlomo,0,0,25,25
1746578764557,MUS 5,A02,957622,Dubnov; Shlomo,13,0,25,12
1746578764557,MUS 5,A03,957623,Dubnov; Shlomo,20,0,25,5
1746578765586,MUS 6,A01,891053,Freitas Caetano; Marcelo,24,0,25,1
1746578765586,MUS 6,A02,891054,Freitas Caetano; Marcelo,23,0,25,2
1746578766612,MUS 7,A01,891081,Staff,1,0,25,24
1746578766612,MUS 7,A02,891082,Staff,3,0,25,22
1746578767639,MUS 8GS,A00,891118,Borgo; David Garcia,1,0,25,24
1746578768665,MUS 11,A01,891140,Staff,9,0,25,16
1746578768665,MUS 11,A02,891141,Staff,21,0,25,4
1746578769692,MUS 13,A01,891143,Staff,8,0,25,17
1746578769692,MUS 13,A02,891144,Staff,24,0,25,1
1746578770716,MUS 15,A01,891146,Staff,9,0,25,16
1746578770716,MUS 15,A02,891148,Staff,21,0,25,4
1746578770716,MUS 15,B01,891150,Staff,18,0,25,7
1746578770716,MUS 15,B02,891151,Staff,25,0,25,0
1746578771746,MUS 20,A01,891153,Staff,5,0,20,15
1746578771746,MUS 20,A02,891155,Staff,14,0,20,6
1746578772775,MUS 80,A00,891156,Staff,19,0,25,6
1746578772775,MUS 80,B00,891157,Staff,23,0,25,2
1746578773799,MUS 130,A00,891158,Ohnishi; Takae,35,0,35,0
1746578774826,MUS 150GS,A01,891160,Borgo; David Garcia,1,0,25,24
1746578775856,MUS 170,A01,891162,Freitas Caetano; Marcelo,20,0,25,5
1746578775856,MUS 170,A02,891164,Freitas Caetano; Marcelo,21,0,25,4
1746578776883,NANO 11,A00,886220,Vazquez Mena; Oscar,13,0,15,2
1746578777920,NANO 15,A01,886222,Drews; Aaron,4,0,7,3
1746578778946,NANO 104,A00,886224,Sirbuly; Donald,17,0,25,8
1746578779980,PH 40,A00,886528,Staff,24,0,40,16
1746578781004,PH 45,A01,886799,Staff,35,0,40,5
1746578782032,PH 110,A00,886802,Staff,0,7,40,40
1746578783061,PH 172,A00,906716,Staff,19,0,35,16
1746578784088,PH 191,A00,886803,Staff,6,0,40,34
1746578785113,PHIL 1,A00,889500,Staff,20,0,30,10
1746578786137,PHIL 10,A01,889549,Grush; Rick Scott,16,0,22,6
1746578786137,PHIL 10,A02,889551,Grush; Rick Scott,22,0,22,0
1746578787163,PHIL 28,A01,889559,Lamey; Andy M.,0,2,31,31
1746578787163,PHIL 28,A02,889561,Lamey; Andy M.,0,1,30,30
1746578787163,PHIL 28,A03,889572,Lamey; Andy M.,0,1,30,30
1746578788188,PHIL 35,A00,907839,Staff,13,0,15,2
1746578789217,PHIL 60,A00,889574,Staff,73,0,90,17
1746578790244,PHIL 101,A00,958004,Staff,12,0,15,3
1746578792298,PHIL 136,A00,889582,Fulkerson; Matthew Todd,26,0,45,19
1746578793322,PHIL 163,A01,889601,Staff,21,0,30,9
1746578793322,PHIL 163,B01,889606,Brandt; Reuven A,0,3,0,0
1746578794347,PHIL 164,A00,889610,Staff,16,0,30,14
1746578795371,PHIL 165,A00,889613,Staff,22,0,30,8
1746578796400,PHYS 1A,A00,886431,Staff,28,0,70,42
1746578797427,PHYS 1AL,001,886432,Tsai; Philbert S,1,2,30,29
1746578797427,PHYS 1AL,002,886436,Tsai; Philbert S,11,0,30,19
1746578798455,PHYS 1B,A00,886439,Staff,184,0,240,56
1746578799479,PHYS 1BL,001,886441,Tsai; Philbert S,0,4,30,30
1746578799479,PHYS 1BL,002,886444,Tsai; Philbert S,2,0,30,28
1746578800504,PHYS 1C,A00,896092,Arnold; Kam S,78,0,146,68
1746578801529,PHYS 1CL,001,886448,Tsai; Philbert S,0,0,30,30
1746578801529,PHYS 1CL,002,886449,Tsai; Philbert S,1,0,30,29
1746578801529,PHYS 1CL,003,886450,Tsai; Philbert S,16,0,30,14
1746578801529,PHYS 1CL,004,886451,Tsai; Philbert S,15,0,30,15
1746578802557,PHYS 2B,A01,886457,Staff,68,0,115,47
1746578803583,PHYS 2C,A01,886460,Shotwell; Brian,0,9,65,65
1746578804626,PHYS 2CL,A01,886467,Staff,0,4,28,28
1746578804626,PHYS 2CL,A02,886468,Staff,0,3,28,28
1746578805653,PHYS 2D,A01,886470,Staff,10,0,50,40
1746578806678,PHYS 4B,A01,886475,Grinstein; Benjamin,22,0,40,18
1746578807707,POLI 5,A00,891173,Desposato; Scott,7,0,25,18
1746578808735,POLI 5D,A01,891175,Staff,5,0,5,0
1746578808735,POLI 5D,B01,891178,Staff,5,0,5,0
1746578809761,POLI 11,A00,891179,Ferree; Karen E,2,0,35,33
1746578810784,POLI 12,A00,891180,Staff,16,0,30,14
1746578811810,POLI 27,A01,891182,Staff,12,0,75,63
1746578812837,POLI 30,A00,891183,Staff,8,0,50,42
1746578813866,POLI 100B,A00,891244,Staff,5,1,35,30
1746578814894,POLI 100I,A00,891247,Staff,7,0,30,23
1746578815917,POLI 104J,A00,891248,Nichter; Maysa,14,0,30,16
1746578816946,POLI 104U,A00,891250,Nichter; Maysa,1,0,30,29
1746578819002,POLI 110B,A00,891255,Wiens; David,19,0,25,6
1746578820029,POLI 112A,A00,891256,Wiens; David,6,0,25,19
1746578821052,POLI 114BR,A00,891261,Staff,19,0,30,11
1746578822076,POLI 117R,A00,891262,Forman; Fonna,0,6,50,50
1746578823100,POLI 118,A00,891264,Ingham; Sean,17,0,25,8
1746578824124,POLI 124A,A00,891265,Staff,18,0,20,2
1746578825153,POLI 125D,A00,891266,Nichter; Simeon C,2,0,25,23
1746578826178,POLI 126,A00,891268,Nichter; Simeon C,7,0,25,18
1746578827203,POLI 126AA,A00,891272,Staff,15,0,25,10
1746578828227,POLI 130AA,A00,891273,Staff,15,0,20,5
1746578829255,POLI 134AA,A00,891274,Staff,4,0,20,16
1746578831310,POLI 138,A00,891278,Staff,21,0,25,4
1746578832337,POLI 142K,A00,891280,Staff,10,0,25,15
1746578833365,POLI 142M,A00,891281,Gartzke; Erik,16,0,30,14
1746578834390,POLI 142P,A00,891284,Staff,20,0,30,10
1746578835415,POLI 143,A00,891285,Gartzke; Erik,12,0,30,18
1746578836442,POLI 153,A00,891286,Staff,19,0,20,1
1746578838495,POLI 175,A00,891290,Staff,15,0,20,5
1746578839519,PSYC 1,A00,890674,Steiner; Eric Tomas,0,11,45,45
1746578840548,PSYC 2,A00,890676,Albright; Thomas D,21,0,35,14
1746578841572,PSYC 3,A00,890679,Staff,17,0,20,3
1746578842598,PSYC 6,A00,959858,Staff,19,0,20,1
1746578843627,PSYC 60,A01,890684,Rickard; Timothy C.,0,5,45,45
1746578844651,PSYC 70,A01,890689,Geller; Emma Harlan,7,0,30,23
1746578845679,PSYC 71,A01,959860,Staff,21,0,25,4
1746578846707,PSYC 100,A00,890690,Lacefield; Katharine I,0,50,180,180
1746578847735,PSYC 102,A00,890695,Staff,18,0,40,22
1746578848760,PSYC 105,A00,890699,Geller; Emma Harlan,70,0,100,30
1746578849785,PSYC 106,A00,890701,Gorman; Michael R.,6,0,30,24
1746578850818,PSYC 108,A00,890704,Adrian; Julia Anna,0,28,50,50
1746578851846,PSYC 118,A01,890712,Staff,11,0,30,19
1746578852873,PSYC 124,A00,890716,Chapman; Eddie Nathaniel,25,0,60,35
1746578853897,PSYC 131,A00,890717,Anagnostaras; Stephan,0,7,80,80
1746578854924,PSYC 137,A00,890719,Winkielman; Piotr,0,11,30,30
1746578855948,PSYC 144,A00,890721,Adrian; Julia Anna,0,9,45,45
1746578856973,PSYC 162,A00,890805,Staff,0,0,75,75
1746578857998,PSYC 169,A00,890810,Staff,0,14,30,30
1746578859022,PSYC 172,A00,890814,Gorman; Michael R.,9,0,30,21
1746578860046,PSYC 181,A00,890818,Anagnostaras; Stephan,8,0,200,192
1746578861078,PSYC 184,A00,959861,Staff,164,0,175,11
1746578862102,PSYC 189,A00,890823,Staff,0,2,30,30
1746578863129,PSYC 191,A00,890884,Rickard; Timothy C.,0,12,35,35
1746578864153,PSYC 193,A00,890913,Staff,19,0,30,11
1746578864153,PSYC 193,B00,890914,Chapman; Eddie Nathaniel,24,0,30,6
1746578865179,PSYC 193L,A01,890918,Lowe; Angela Beth,20,0,30,10
1746578865179,PSYC 193L,B01,890921,Hurwitz; Ethan Scott,20,0,30,10
1746578865179,PSYC 193L,C01,890928,Staff,30,0,30,0
1746578866223,RELI 149,A00,886806,Rahimi; Babak,23,0,40,17
1746578867254,SE 9,A01,886814,Staff,7,0,20,13
1746578868279,SE 101B,A01,886816,Chadha; Mayank,4,0,35,31
1746578869304,SE 110B,A00,886818,Zhu; Qiang,4,0,75,71
1746578870327,SE 125,A01,886830,Staff,10,0,30,20
1746578871358,SE 130B,A01,886835,Staff,14,0,40,26
1746578872382,SE 131A,A01,886838,Krysl; Petr,34,0,55,21
1746578873411,SE 154,A00,886840,Staff,29,0,50,21
1746578874439,SE 164GS,A01,886849,Staff,6,0,20,14
1746578875468,SE 167GS,A01,886853,Staff,6,0,20,14
1746578876496,SIO 25,A01,890107,Staff,19,0,30,11
1746578877523,SIO 45,A00,890109,Cook; Geoffrey W,116,0,200,84
1746578878548,SIO 109R,A00,890110,Forman; Fonna,0,16,20,20
1746578879572,SIO 187,A01,890114,Kacev; David,15,0,40,25
1746578880597,SOCI 1,A01,890431,Thorpe; Charles Robert,14,0,30,16
1746578880597,SOCI 1,A02,890518,Thorpe; Charles Robert,30,0,30,0
1746578881622,SOCI 2,A01,957978,Staff,25,0,25,0
1746578881622,SOCI 2,A02,957979,Staff,23,0,25,2
1746578882648,SOCI 20,A01,890523,Calderon-Zaks; Michael Aar,21,0,30,9
1746578882648,SOCI 20,A02,890526,Calderon-Zaks; Michael Aar,29,0,30,1
1746578883674,SOCI 30,A01,890533,Pardo Guerra; Juan Pablo,37,0,40,3
1746578884703,SOCI 40,A01,890535,Staff,27,0,45,18
1746578885727,SOCI 104Q,A00,890559,Staff,18,0,30,12
1746578886754,SOCI 106,A00,890560,Arnal; Maud Marie Leonie,20,0,30,10
1746578887779,SOCI 110,A00,890567,Holkenbrink-Monk; Charlene,19,0,30,11
1746578888806,SOCI 112,A00,890568,Victoria Torres; Pablo,2,0,55,53
1746578889832,SOCI 115,A00,890597,Arnal; Maud Marie Leonie,28,0,45,17
1746578891888,SOCI 121,A00,890604,Pardo Guerra; Juan Pablo,38,0,45,7
1746578892914,SOCI 126,A01,890608,Staff,8,0,10,2
1746578893939,SOCI 127,A00,890609,Staff,18,0,30,12
1746578894967,SOCI 131,A00,890610,Thorpe; Charles Robert,37,0,45,8
1746578895992,SOCI 135,A00,890615,Payne; Christine Anna,13,0,45,32
1746578897020,SOCI 139,A00,890620,Staff,38,0,45,7
1746578898045,SOCI 148E,A00,890622,Calderon-Zaks; Michael Aar,36,0,45,9
1746578899070,SOCI 150,A00,890623,Kohler; Kristopher M.,31,0,45,14
1746578900095,SOCI 157,A00,890625,Jules-Rosette; Bennetta W.,18,0,20,2
1746578901125,SOCI 160,A00,890627,Payne; Christine Anna,21,0,45,24
1746578902151,SYN 1,A00,886855,Fish; Gwendolyn Anne,0,1,0,0
1746578902151,SYN 1,B00,906086,Fish; Gwendolyn Anne,0,2,0,2
1746578903178,SYN 2R,A00,886860,Staff,0,17,15,15
1746578903178,SYN 2R,B00,906106,Atkinson; Arthur Laird,0,16,15,15
1746578904205,SYN 100,A01,886866,Browne; Emily,0,28,20,20
1746578904205,SYN 100,B01,906128,Rock; Martin,0,4,20,20
1746578904205,SYN 100,C01,906140,Deavenport; James Cary,0,3,20,20
1746578904205,SYN 100,D01,907816,Deavenport; James Cary,0,5,20,20
1746578905230,TDAC 1,A00,890286,Walsh; Kim C.,7,0,20,13
1746578906253,TDAC 101,A00,890296,Basso; Beatrice,15,0,20,5
1746578907281,TDDE 131,A00,890297,Staff,47,0,50,3
1746578908306,TDDM 1,A00,890287,Weinberg; Sadie,25,0,30,5
1746578909332,TDGE 11,A00,890288,Fulton; Julia,138,0,200,62
1746578909332,TDGE 11,B00,890289,Castro; Robert Jess,184,0,200,16
1746578910360,TDGE 25,B00,957359,Walsh; Kim C.,5,0,20,15
1746578911387,TDGE 40,A01,890292,Power; Jade Yukana,27,0,30,3
1746578912426,TDGE 124,A00,890298,Havis; Allan,0,1,50,50
1746578913450,TDGE 131R,A00,890299,Burelle; Julie Sara Veronique,15,0,42,27
1746578914479,TDHT 101,A00,890300,Staff,10,0,20,10
1746578915503,TDHT 109,A01,890302,Anderson; Mysia Anyse,31,0,40,9
1746578916526,TDMV 1,A00,890293,Arcidiacono; Kristin,18,0,30,12
1746578917593,TDMV 2,A00,890294,Weinberg; Sadie,23,0,30,7
1746578918619,TDMV 3,A00,957878,Arcidiacono; Kristin,28,0,30,2
1746578920675,TDMV 138,A00,890304,Jun; Grace Shin Hae,25,0,40,15
1746578921702,TDMV 140,A00,890305,Corrales; Joseph Bernales,25,0,30,5
1746578922731,TDMV 142,A00,890307,Caligagan; Tony,32,0,40,8
1746578923761,TDMV 144,A00,890308,Camaya; Michelle Ann,25,0,30,5
1746578924789,TDPW 1,A00,890295,Stein; Deborah Isobel,3,0,20,17
1746578925818,USP 2,A01,890272,Lerner; Amy M,7,0,20,13
1746578926846,USP 3,A01,890274,Staff,12,0,30,18
1746578927879,USP 15,A01,890276,Sun; Feiyang,16,0,30,14
1746578928908,USP 25,A00,890277,Shenkman; Michael Thomas,18,0,25,7
1746578929936,USP 138,A00,890278,Staff,14,0,25,11
1746578930961,USP 143,A00,890279,Staff,22,0,70,48
1746578931987,USP 144,A00,890280,Chowdhury; Muhammed Zohir,16,0,30,14
1746578933023,USP 150,A00,890281,Boomhower; Matthew Charles,4,0,30,26
1746578934048,USP 151,A00,890282,Staff,16,0,20,4
1746578935073,USP 162,A00,890283,Andrews; Abigail Leslie,16,0,20,4
1746578936101,USP 168,A00,920477,Kwak; Nancy,0,0,5,5
1746578937125,USP 181,A00,890284,Staff,3,0,20,17
1746578938153,USP 191A,A00,890285,Staff,12,0,20,8
1746578939183,VIS 101,A00,886512,Staff,25,0,75,50
1746578940207,VIS 103,A00,886513,Cruz; Edwin Teddy,61,0,75,14
1746578941239,VIS 108,A00,886514,Staff,3,0,15,12
1746578942267,VIS 127P,A00,886515,Shen; Kuiyi,80,0,146,66
1746578943292,VIS 149,A00,886516,Yoldas; Pinar,0,0,15,15
1746578944319,VIS 164,A00,886526,Erdmann; Dean,19,0,22,3
1746578945345,VIS 194S,A00,886527,Staff,61,0,75,14
1746578946372,WCWP 10A,C00,886484,Martiniuk; Jill,12,0,15,3
1746578947397,WCWP 10B,A00,886490,Uriarte; Emma,0,0,15,15
1746578947397,WCWP 10B,B00,886491,Dhir; Simrita,8,0,15,7
1746578947397,WCWP 10B,C00,886492,Ornelas; Tricia,0,0,15,15
1746578948424,WCWP 100,A00,886494,Young; Mark T,0,6,15,15
1746578950525,AAS 10,A01,886199,Childs; Dennis R.,0,3,0,0
1746578951549,ANAR 104,A01,886940,Shtienberg; Gilad,27,0,30,3
1746578952575,ANAR 120,A00,886953,Staff,12,0,20,8
1746578953603,ANBI 148,A01,886955,Wilder; Linnea Lorene,30,0,40,10
1746578955650,ANSC 122,A00,886957,Staff,25,0,30,5
1746578956674,ANSC 150,A00,886958,Sloane; Julia Kathryn,2,0,15,13
1746578957701,ANSC 156,A00,886959,Jenkins; Janis A.,0,1,15,15
1746578958726,ANSC 180,A00,886960,Staff,11,0,17,6
1746578959749,ANSC 188,A00,886961,Jassal; Aftab,9,0,25,16
1746578960791,ANSC 190,A00,886962,Jassal; Aftab,14,0,25,11
1746578961815,ANSC 191,A00,886963,Staff,18,0,20,2
1746578962840,ANTH 3,A01,891689,Staff,17,0,20,3
1746578963867,ANTH 5,A00,886933,Semendeferi; Ekaterini,16,0,20,4
1746578964897,ANTH 10,A00,886934,Staff,0,12,30,30
1746578965924,ANTH 21,A01,886936,Staff,41,0,60,19
1746578966952,ANTH 23,A01,886938,Staff,92,0,100,8
1746578967976,ANTH 105,A00,886964,Stewart; Alexander B,84,0,100,16
1746578969004,ANTH 108,A00,886965,Pedersen; David,9,0,20,11
1746578970035,AWP 10,001,886147,Staff,0,0,0,0
1746578970035,AWP 10,002,886148,Staff,0,0,0,0
1746578970035,AWP 10,003,886149,Staff,0,0,0,0
1746578970035,AWP 10,004,886150,Staff,0,0,0,0
1746578970035,AWP 10,005,886151,Staff,0,0,0,0
1746578970035,AWP 10,006,886152,Staff,0,0,0,0
1746578970035,AWP 10,007,886153,Staff,0,0,0,0
1746578970035,AWP 10,008,886154,Staff,0,0,0,0
1746578970035,AWP 10,009,886155,Staff,0,0,0,0
1746578970035,AWP 10,010,886156,Staff,0,0,0,0
1746578970035,AWP 10,011,886158,Staff,0,0,0,0
1746578970035,AWP 10,012,886160,Staff,0,0,0,0
1746578970035,AWP 10,013,886161,Staff,0,0,0,0
1746578970035,AWP 10,014,886162,Staff,0,0,0,0
1746578970035,AWP 10,015,886163,Staff,0,0,0,0
1746578970035,AWP 10,016,886164,Staff,0,0,0,0
1746578970035,AWP 10,017,886165,Staff,0,0,0,0
1746578970035,AWP 10,018,886166,Staff,0,0,0,0
1746578970035,AWP 10,019,886168,Staff,0,0,0,0
1746578970035,AWP 10,020,886170,Staff,0,0,0,0
1746578970035,AWP 10,021,886172,Staff,0,0,0,0
1746578971064,AWP 10R,001,886173,Staff,0,1,0,0
1746578971064,AWP 10R,002,886174,Staff,0,1,0,0
1746578971064,AWP 10R,003,886175,Staff,0,0,0,0
1746578971064,AWP 10R,004,886176,Staff,0,0,0,0
1746578971064,AWP 10R,005,886177,Staff,0,0,0,0
1746578971064,AWP 10R,006,886178,Staff,0,0,0,0
1746578971064,AWP 10R,007,886179,Staff,0,0,0,0
1746578971064,AWP 10R,008,886181,Staff,0,0,0,0
1746578971064,AWP 10R,009,886182,Staff,0,0,0,0
1746578971064,AWP 10R,010,886183,Staff,0,0,0,0
1746578971064,AWP 10R,011,886184,Staff,0,0,0,0
1746578971064,AWP 10R,012,886185,Staff,0,0,0,0
1746578971064,AWP 10R,013,886186,Staff,0,0,0,0
1746578971064,AWP 10R,014,886187,Staff,0,0,0,0
1746578971064,AWP 10R,015,886188,Staff,0,0,0,0
1746578971064,AWP 10R,016,886189,Staff,0,0,0,0
1746578971064,AWP 10R,017,960532,Staff,0,0,0,0
1746578971064,AWP 10R,018,960533,Staff,0,0,0,0
1746578971064,AWP 10R,019,960534,Staff,0,0,0,0
1746578971064,AWP 10R,020,960538,Staff,0,0,0,0
1746578971064,AWP 10R,021,960540,Staff,0,0,0,0
1746578971064,AWP 10R,022,960541,Staff,0,0,0,0
1746578971064,AWP 10R,023,960542,Staff,0,0,0,0
1746578971064,AWP 10R,024,960544,Staff,0,0,0,0
1746578971064,AWP 10R,025,960545,Staff,0,0,0,0
1746578971064,AWP 10R,026,960548,Staff,0,0,0,0
1746578972088,AWP 102R,A00,886190,Staff,0,0,0,0
1746578972088,AWP 102R,B00,886191,Staff,0,0,0,0
1746578973119,BENG 100,A01,886193,Staff,17,0,30,13
1746578974144,BENG 122A,A01,886195,Hasty; Jeff M,13,0,30,17
1746578975172,BENG 166A,A00,886196,Sah; Robert Lie-Yuan,0,3,30,30
1746578976198,BENG 190,A00,958050,Khojah; Reem I,19,0,25,6
1746578977223,BIBC 102,A01,894320,Staff,0,0,46,46
1746578977223,BIBC 102,A02,894321,Staff,0,0,46,46
1746578977223,BIBC 102,A03,894344,Staff,6,0,46,40
1746578977223,BIBC 102,A04,894345,Staff,27,0,47,20
1746578978250,BICD 100R,A01,894365,Smith; Laurie,0,3,58,58
1746578978250,BICD 100R,A02,894366,Smith; Laurie,0,5,58,58
1746578978250,BICD 100R,A03,894367,Smith; Laurie,0,0,59,59
1746578978250,BICD 100R,A04,959869,Smith; Laurie,40,0,59,19
1746578979280,BICD 136,A01,894383,Gustafson-Brown; Cindy,14,0,50,36
1746578980305,BIEB 102,A01,894494,Butler; Shannon Rhey,51,0,130,79
1746578982358,BIEB 150,A01,894617,Wills; Christopher,3,0,20,17
1746578982358,BIEB 150,A02,894631,Wills; Christopher,3,0,20,17
1746578982358,BIEB 150,A03,894937,Wills; Christopher,3,0,20,17
1746578982358,BIEB 150,A04,894946,Wills; Christopher,5,0,20,15
1746578983381,BIEB 194,A00,906141,Kurle; Carolyn M.,6,0,20,14
1746578984405,BILD 1,A01,894154,Staff,3,0,19,16
1746578984405,BILD 1,A02,894155,Staff,14,0,19,5
1746578984405,BILD 1,A03,894160,Staff,13,0,19,6
1746578984405,BILD 1,A04,894161,Staff,15,0,18,3
1746578985430,BILD 2,A01,894168,Staff,0,0,50,50
1746578985430,BILD 2,A02,894169,Staff,0,0,50,50
1746578985430,BILD 2,A03,894179,Staff,0,0,50,50
1746578985430,BILD 2,A04,894203,Staff,24,0,50,26
1746578986455,BILD 3,A01,894213,Staff,23,0,31,8
1746578986455,BILD 3,A02,894214,Staff,26,0,31,5
1746578986455,BILD 3,A03,894235,Staff,28,0,31,3
1746578986455,BILD 3,A04,894236,Staff,28,0,32,4
1746578987481,BILD 4,A01,894253,Reuther; Keefe,5,0,24,19
1746578987481,BILD 4,A02,894258,Reuther; Keefe,16,0,24,8
1746578988507,BILD 5,A01,894276,Reuther; Keefe,35,0,50,15
1746578988507,BILD 5,A02,894277,Reuther; Keefe,45,0,50,5
1746578988507,BILD 5,A03,894290,Reuther; Keefe,44,0,50,6
1746578988507,BILD 5,A04,894291,Reuther; Keefe,48,0,50,2
1746578989530,BILD 24,A01,894297,Pirino; Giorgia,40,0,60,20
1746578990560,BIMM 100,B01,958915,Staff,71,0,100,29
1746578991586,BIMM 101,A01,895017,McDonnell; Lisa Marie,0,5,24,24
1746578991586,BIMM 101,A02,895018,McDonnell; Lisa Marie,0,5,24,24
1746578991586,BIMM 101,B01,895020,McDonnell; Lisa Marie,0,6,24,24
1746578991586,BIMM 101,B02,895021,McDonnell; Lisa Marie,0,4,24,24
1746578992612,BIMM 110,A01,895023,Staff,1,0,25,24
1746578992612,BIMM 110,A02,895024,Staff,9,0,25,16
1746578992612,BIMM 110,A03,895025,Staff,18,0,25,7
1746578992612,BIMM 110,A04,895031,Staff,20,0,25,5
1746578993641,BIMM 120,A01,895114,Gustafson-Brown; Cindy,14,0,28,14
1746578993641,BIMM 120,A02,895126,Gustafson-Brown; Cindy,21,0,27,6
1746578994669,BIPN 100,A01,895130,Yang; Mingyu,0,0,38,38
1746578994669,BIPN 100,A02,895131,Yang; Mingyu,32,0,38,6
1746578994669,BIPN 100,A03,895132,Yang; Mingyu,32,0,38,6
1746578994669,BIPN 100,A04,895133,Yang; Mingyu,27,0,36,9
1746578995694,BIPN 120,A01,895135,Cooke; James Edward,0,3,13,13
1746578995694,BIPN 120,A02,895136,Cooke; James Edward,0,1,13,13
1746578995694,BIPN 120,A03,895137,Cooke; James Edward,0,3,13,13
1746578995694,BIPN 120,A04,895156,Cooke; James Edward,0,2,11,11
1746578996724,BIPN 134,A01,895235,Cooke; James Edward,0,2,25,25
1746578996724,BIPN 134,A02,895237,Cooke; James Edward,0,0,25,25
1746578996724,BIPN 134,A03,895240,Cooke; James Edward,3,0,25,22
1746578996724,BIPN 134,A04,895270,Cooke; James Edward,20,0,25,5
1746578997768,BIPN 189,A00,892103,Staff,0,14,14,14
1746578999820,BISP 194,A00,958008,Staff,0,2,0,0
1746579000845,CAT 124,A01,922009,Staff,0,5,20,20
1746579001875,CAT 125R,A00,886390,Morales; Celeste Georgianna,0,2,20,20
1746579001875,CAT 125R,B00,886391,Irwin; Matthew Joseph,0,4,20,20
1746579001875,CAT 125R,C00,886392,Smith; Lauryn Alissa,0,2,20,20
1746579001875,CAT 125R,D00,886393,Vanderschuit; Maya Alysia,0,3,20,20
1746579001875,CAT 125R,E00,886394,Marchisotto; Jennifer Anne,0,3,20,20
1746579002900,CENG 15,A01,886218,Drews; Aaron,3,0,8,5
1746579003930,CENG 113,A00,886219,Opatkiewicz; Justin Paul,15,0,25,10
1746579004956,CGS 101,A00,887044,Staff,7,0,20,13
1746579005981,CGS 105,A01,887046,Staff,14,0,25,11
1746579007005,CGS 112,A00,887047,Cuong; Marisol,12,0,15,3
1746579008033,CGS 113,A00,887048,Staff,23,0,30,7
1746579009060,CGS 120,A00,887049,Staff,10,0,17,7
1746579010083,CHEM 6A,A01,886336,Lam; Tin Yiu,38,0,50,12
1746579010083,CHEM 6A,A02,886338,Lam; Tin Yiu,37,0,50,13
1746579011108,CHEM 6B,A01,886341,Hopkins; Patrycja Anna,16,0,50,34
1746579011108,CHEM 6B,A02,886343,Hopkins; Patrycja Anna,42,0,50,8
1746579012136,CHEM 6C,A01,886346,Albizati; Kim F.,0,2,50,50
1746579012136,CHEM 6C,A02,886348,Albizati; Kim F.,23,0,50,27
1746579013161,CHEM 40A,A01,886352,Klosterman; Jeremy K,65,0,100,35
1746579014185,CHEM 40B,A01,886356,Klosterman; Jeremy K,0,24,100,100
1746579015212,CHEM 41B,A01,886360,Theodorakis; Emmanuel,25,0,50,25
1746579015212,CHEM 41B,A02,886362,Theodorakis; Emmanuel,47,0,50,3
1746579016241,CHIN 165A,A00,886382,Xu; Li,18,0,20,2
1746579017267,CLAS 120,A00,886387,Myerston Santana; Jacobo,33,0,40,7
1746579018298,COGS 9,A01,886967,Shannon; Kyle Michael,42,0,60,18
1746579019324,COGS 11,A01,886969,Staff,9,0,30,21
1746579020356,COGS 14A,A01,886971,Staff,6,0,60,54
1746579021384,COGS 14B,A01,886973,Hoffman; Drew Ellen,4,0,60,56
1746579022411,COGS 18,A01,886975,Morgan; Eric,35,0,60,25
1746579023435,COGS 20,A01,886977,Staff,4,0,8,4
1746579023435,COGS 20,A02,886978,Staff,5,0,7,2
1746579024463,COGS 100,A01,907783,Staff,1,2,30,29
1746579025488,COGS 101B,A01,886980,Staff,0,4,48,48
1746579026517,COGS 101C,A01,886982,Delgado; Tania,0,5,44,44
1746579027545,COGS 102A,A01,886984,Johnson; Christine M.,4,0,30,26
1746579028573,COGS 118B,A01,886986,Staff,1,4,88,87
1746579029598,COGS 150,A01,886988,Bergen; Benjamin,22,0,50,28
1746579030624,COGS 153,A00,886989,Delgado; Tania,0,2,41,41
1746579031653,COGS 186,A01,886991,Staff,0,0,32,32
1746579032739,COGS 187A,A01,886993,Boyle; Mary E. T.,7,0,30,23
1746579033766,COGS 189,A00,886994,Staff,0,1,30,30
1746579034792,COMM 10,A01,886996,Staff,0,0,20,21
1746579034792,COMM 10,A02,886997,Staff,10,0,20,10
1746579034792,COMM 10,A03,959845,Staff,19,0,20,1
1746579035820,COMM 20,A01,886999,Leuning; Grant Maurstad,24,0,40,16
1746579037874,COMM 100A,A01,887002,Staff,0,0,20,25
1746579037874,COMM 100A,A02,887003,Staff,6,0,20,14
1746579038904,COMM 100B,A01,887005,Staff,0,8,20,24
1746579039933,COMM 106D,A00,887006,Staff,13,0,40,27
1746579040959,COMM 110G,A00,887007,Whitworth-Smith; Andrew C,12,0,40,28
1746579041983,COMM 111B,A00,887008,Staff,31,0,40,9
1746579043009,COMM 113T,A00,887009,Abuelhiga; Soraya Jill,28,0,40,12
1746579043009,COMM 113T,B00,906733,Staff,40,0,40,0
1746579044033,COMM 145,A00,887010,Staff,12,0,40,28
1746579045063,COMM 146,A00,887054,Staff,31,0,40,9
1746579046088,COMM 190,A00,887012,Staff,8,0,23,15
1746579047116,CSE 8A,A50,887015,Cao; Yingjun,57,0,85,28
1746579048146,CSE 11,A01,887017,Cao; Yingjun,12,0,70,58
1746579049176,CSE 20,A01,887019,Staff,30,0,50,20
1746579050203,CSE 21,A01,887021,Staff,78,0,100,22
1746579050203,CSE 21,B01,892583,Braun; Oliver,45,0,50,5
1746579051231,CSE 30,A01,887025,Eldon; John,143,0,200,57
1746579052260,CSE 100,A01,887027,Staff,26,0,50,24
1746579052260,CSE 100,A02,887028,Staff,42,0,50,8
1746579053285,CSE 101,A01,887030,Braun; Oliver,74,0,100,26
1746579053285,CSE 101,B01,887032,Jones; Miles E,0,3,50,50
1746579053285,CSE 101,B02,887033,Jones; Miles E,0,2,50,50
1746579054315,CSE 105,A01,908084,Jones; Miles E,32,0,50,18
1746579054315,CSE 105,A02,908087,Jones; Miles E,31,0,50,19
1746579055338,CSE 135,A01,887035,Powell; Thomas Allan,0,5,50,50
1746579056364,CSE 142,A01,887037,Staff,8,0,60,52
1746579057389,CSE 142L,A01,887039,Staff,34,0,60,26
1746579058415,CSE 151A,A01,887041,Solares; Edwin A,47,0,100,53
1746579059445,CSE 175,A01,887043,Kumar; Rakesh,30,0,30,0
1746579060470,CSS 1,A01,886389,Staff,1,2,40,39
1746579061499,DSC 30,A01,908097,Liao; Soohyun Nam,47,0,75,28
1746579062525,DSC 40A,A01,908099,Shannon; Kyle Michael,30,0,50,20
1746579063549,DSC 40B,A01,908112,Staff,15,0,50,35
1746579064575,DSC 80,A01,908116,Staff,19,0,60,41
1746579065601,DSC 197,001,956863,Eldridge; Justin Matthew,9999,0,9999,0
1746579066627,ECE 5,A01,886400,Morris; Karcher William,1,0,6,5
1746579066627,ECE 5,A02,886401,Morris; Karcher William,3,0,6,3
1746579067652,ECE 148,A01,886403,Silberman; Jack,0,14,14,14
1746579068677,ECON 1,A01,887265,Crane; Meredith Helen,12,0,70,58
1746579068677,ECON 1,B01,887268,Staff,42,0,50,8
1746579069703,ECON 2,A01,887273,Crane; Meredith Helen,55,0,70,15
1746579070732,ECON 3,A01,887279,Rondina; Giacomo,32,0,70,38
1746579071760,ECON 4,A01,887282,Anderson; John Charles,0,2,10,10
1746579072787,ECON 5,A01,887285,Staff,34,0,45,11
1746579072787,ECON 5,B01,887292,Staff,41,0,45,4
1746579073813,ECON 100A,A01,887337,Newhouse; Herbert S,54,0,70,16
1746579073813,ECON 100A,B01,887349,Staff,45,0,50,5
1746579074840,ECON 100B,A01,887361,Du; Songzi,29,0,70,41
1746579075870,ECON 100C,A01,887445,Newhouse; Herbert S,59,0,70,11
1746579076897,ECON 105,A00,887488,Vespa; Emanuel Ignacio,23,0,35,12
1746579077927,ECON 109,A01,887506,Shishkin; Denis,28,0,35,7
1746579078956,ECON 110A,A01,887568,Alon; Titan Michael,0,3,35,35
1746579078956,ECON 110A,B01,907601,Alon; Titan Michael,20,0,35,15
1746579079984,ECON 110B,A01,887598,Levkoff; Steven B.,0,24,70,70
1746579081010,ECON 112,A00,887599,Rondina; Giacomo,19,0,35,16
1746579082035,ECON 120A,A01,887603,Dai; Yinlin,35,0,70,35
1746579083065,ECON 120C,A01,887608,Sun; Yixiao,0,1,35,35
1746579083065,ECON 120C,B01,887614,Sun; Yixiao,0,0,35,35
1746579084098,ECON 138,A00,887621,Bharadwaj; Prashant,0,21,20,20
1746579085123,ECON 144,A00,958007,Squires; Dale E,12,0,35,23
1746579086152,ECON 171,A01,907666,Staff,18,0,35,17
1746579087179,ECON 175,A00,887626,Wu; Pak Yeung,22,0,35,13
1746579088207,ECON 190,A00,887640,Vespa; Emanuel Ignacio,22,0,35,13
1746579089240,EDS 25,A01,888197,Staff,0,0,0,0
1746579089240,EDS 25,A02,888209,Staff,0,0,0,0
1746579089240,EDS 25,A03,888210,Staff,0,0,0,0
1746579089240,EDS 25,A04,888212,Staff,0,0,0,0
1746579089240,EDS 25,A05,888213,Staff,0,0,0,0
1746579089240,EDS 25,A06,888214,Staff,0,0,0,0
1746579089240,EDS 25,A07,888235,Staff,0,2,0,0
1746579089240,EDS 25,A08,888236,Staff,0,0,0,0
1746579089240,EDS 25,A09,888240,Staff,0,0,0,0
1746579089240,EDS 25,A10,888244,Staff,0,0,0,0
1746579089240,EDS 25,B01,888273,Staff,0,0,0,0
1746579089240,EDS 25,B02,888285,Staff,0,0,0,0
1746579089240,EDS 25,B03,888423,Staff,0,0,0,1
1746579089240,EDS 25,B04,888432,Staff,0,0,0,0
1746579089240,EDS 25,B05,888433,Staff,0,0,0,0
1746579089240,EDS 25,B06,888467,Staff,0,0,0,0
1746579089240,EDS 25,B07,888468,Staff,0,0,0,0
1746579089240,EDS 25,B08,888479,Staff,0,0,0,0
1746579089240,EDS 25,B09,888484,Staff,0,0,0,0
1746579089240,EDS 25,B10,888487,Staff,0,0,0,0
1746579090265,EDS 38,A01,907700,Choi; Bailey Miyeon,30,0,30,0
1746579091290,EDS 112,A01,888601,Chapman; Thandeka K,12,0,40,28
1746579092317,EDS 115,A00,888697,Mendez; Kathrina Mendoza,10,0,30,20
1746579093343,EDS 116,A01,888893,Staff,34,0,40,6
1746579095399,EDS 124AR,A00,889133,Staff,29,0,50,21
1746579095399,EDS 124AR,B00,907471,Simon; Elizabeth A,37,0,50,13
1746579096426,EDS 124BR,A00,889134,Simon; Elizabeth A,44,0,100,56
1746579097451,EDS 125,A00,889135,Staff,25,0,30,5
1746579098474,EDS 126,A01,889138,Staff,35,0,40,5
1746579099499,EDS 164R,A01,889142,Wishard Guerra; Alison G.,33,0,50,17
1746579100526,ENG 30,A01,886396,Staff,0,0,0,0
1746579100526,ENG 30,B01,886398,Staff,0,0,0,0
1746579101552,ENVR 102,A00,906150,Montejo; Carolina,23,0,25,2
1746579102576,ETHN 103A,A00,887236,Man; Simeon S,0,3,0,0
1746579103605,ETHN 113,A00,887239,Staff,16,0,30,14
1746579104633,ETHN 116,A00,887240,Staff,16,0,25,9
1746579105663,ETHN 117,A00,887241,Choi; Esther Min,28,0,30,2
1746579106691,ETHN 118,A00,887243,Staff,24,0,30,6
1746579107716,ETHN 127,A00,887248,Cuong; Marisol,11,0,15,4
1746579108745,ETHN 139,A00,887250,Staff,7,0,10,3
1746579109771,ETHN 142,A00,887252,Staff,10,0,30,20
1746579110802,ETHN 161,A00,887253,Browne; Errol Tsekani,24,0,30,6
1746579111826,ETHN 163FR,A00,887255,Burelle; Julie Sara Veronique,0,0,5,5
1746579112854,GLBH 20,A00,889149,Elwardani; Nile Regina,8,0,42,34
1746579114903,GLBH 111,A01,889152,Burgos; Jose L.,17,0,17,0
1746579115932,GLBH 150,A00,889181,Sloane; Julia Kathryn,0,5,15,15
1746579117982,HDS 60,A01,886406,Warstadt; Melissa Fawn,73,0,80,7
1746579119007,HIAF 111,A00,889324,Gyamfi; Bright,25,0,32,7
1746579120039,HIEA 131,A00,889328,Staff,15,0,32,17
1746579121164,HIEA 144,A00,889333,Henry; Todd A.,26,0,32,6
1746579122221,HIEA 154,A00,889336,Henry; Todd A.,24,0,32,8
1746579123324,HIEU 106,A00,889339,Staff,22,0,32,10
1746579125375,HIEU 114,A00,889340,Staff,4,0,32,28
1746579126402,HIEU 135GS,A00,889342,Patterson; Patrick H.,0,0,1,24
1746579127428,HIEU 137,A00,889343,Edington; Claire Ellen,10,0,25,15
1746579128453,HIEU 148,A00,889345,Staff,14,0,32,18
1746579129476,HIEU 154,A00,889346,Biess; Frank Peter,21,0,32,11
1746579130504,HILA 102,A00,889351,Staff,12,0,32,20
1746579131531,HILD 2A,A01,889221,Lewandoski; Julia Mavis,1,10,32,31
1746579132558,HILD 7B,A01,889225,Man; Simeon S,0,12,32,32
1746579133586,HILD 7C,A01,889288,Alvarez; Luis A,0,14,32,32
1746579134614,HILD 30,A01,889323,Staff,0,5,32,32
1746579136666,HISC 119,A00,889383,Golan; Tal,19,0,32,13
1746579137689,HIUS 103,A00,889384,Man; Simeon S,0,0,32,32
1746579138714,HIUS 117,A00,919797,Kwak; Nancy,19,0,32,13
1746579139742,HIUS 142A,A00,919788,Staff,22,0,32,10
1746579141795,HIUS 149,A00,889386,Gyamfi; Bright,26,0,32,6
1746579142820,HIUS 155,A00,889387,Alvarez; Luis A,15,0,32,17
1746579143849,HUM 3,A01,886499,Caldwell; Michael Alan,19,0,50,31
1746579144876,HUM 3GS,A00,886500,Rodriguez; Bretton Sigfred,0,0,0,28
1746579145902,HUM 3R,A01,886502,Markman; Kristina,0,36,50,50
1746579146932,HUM 4,A01,886504,Crum; Matthew Stephen,23,0,50,27
1746579146932,HUM 4,B01,886506,West; Geoffrey Scott,17,0,50,33
1746579147959,HUM 4GS,A00,886507,Staff,0,0,0,19
1746579148983,HUM 5,A01,886509,Staff,32,0,50,18
1746579150015,HUM 5R,A01,886511,Zavodny; Tatiana Sophia,0,39,50,50
1746579151039,JAPN 180,A00,886407,Staff,16,0,40,24
1746579152065,LATI 50,A01,886409,Martin-Cabrera; Luis,3,0,22,19
1746579152065,LATI 50,A02,886410,Martin-Cabrera; Luis,19,0,22,3
1746579152065,LATI 50,A03,886411,Martin-Cabrera; Luis,21,0,22,1
1746579152065,LATI 50,A04,886412,Martin-Cabrera; Luis,8,0,22,14
1746579153091,LAWS 101,A00,907664,Staff,28,0,60,32
1746579154120,LIAB 1A,A00,889388,Saab; Dima,17,0,20,3
1746579155144,LIAB 1AX,A00,889389,El Cheddadi; Youniss,18,0,20,2
1746579156169,LIFR 1C,A00,889391,Van Moer; Vinciane G,8,0,20,12
1746579157194,LIFR 1CX,A00,889392,Van Moer; Vinciane G,7,0,20,13
1746579158219,LIFR 1D,A00,889393,Van Moer; Vinciane G,7,0,20,13
1746579159257,LIFR 1DX,A00,889394,Van Moer; Vinciane G,8,0,20,12
1746579160286,LIGN 7,A00,886923,Staff,24,0,50,26
1746579161310,LIGN 17,A00,886924,Kehler; Andrew Scott,125,0,150,25
1746579162335,LTAM 110,A00,889395,Staff,15,0,30,15
1746579163358,LTAM 110GS,A00,958010,Rodriguez; Bretton Sigfred,0,0,0,28
1746579164387,LTCH 101,A00,889397,Staff,23,0,25,2
1746579165411,LTCS 130,A00,889398,Staff,23,0,25,2
1746579166435,LTEA 138,A00,889399,Staff,24,0,40,16
1746579167459,LTEN 149,A00,889400,Wesling; Megan E.,0,3,25,25
1746579168483,LTEN 169,A00,889401,Staff,20,0,25,5
1746579169507,LTEN 180,A00,889402,Staff,10,0,15,5
1746579170534,LTEN 181,A00,889403,Staff,21,0,25,4
1746579171558,LTWL 100,A00,889404,Myerston Santana; Jacobo,2,0,25,23
1746579172582,LTWL 180GS,A00,889405,Staff,0,0,20,20
1746579173606,LTWL 181,A00,889406,Staff,16,0,25,9
1746579174631,LTWL 184,A00,889475,Mukherjee; Silpa,22,0,25,3
1746579175655,LTWR 102C,A00,889486,Staff,29,0,30,1
1746579176681,LTWR 115W,A00,889491,Staff,0,2,15,15
1746579177708,MAE 8,A01,886905,Staff,0,2,0,0
1746579178736,MAE 11,A00,886906,Bandaru; Prabhakar,0,7,50,50
1746579179767,MAE 20,A00,886907,Evdokimenko; Ekaterina,43,0,70,27
1746579180792,MAE 30B,A00,886909,Ghazinejad; Maziar,26,0,45,19
1746579181819,MAE 101B,A00,886910,Saintillan; David,29,0,45,16
1746579182843,MAE 105,A00,886911,Bandaru; Prabhakar,18,0,50,32
1746579183876,MAE 107,B00,958024,Staff,8,0,50,42
1746579184900,MAE 143B,A00,886913,Bewley; Thomas R,3,0,40,37
1746579185929,MAE 148,A01,886915,Silberman; Jack,0,3,14,14
1746579186953,MAE 160,A00,886916,Evdokimenko; Ekaterina,31,0,60,29
1746579187978,MATH 3C,A01,889681,Staff,0,2,30,30
1746579187978,MATH 3C,A02,960048,Staff,24,0,30,6
1746579189002,MATH 10A,A01,889760,Staff,26,0,30,4
1746579189002,MATH 10A,A02,889783,Staff,29,0,30,1
1746579190034,MATH 10B,A01,889785,Verstraete; Jacques Allan,2,0,35,33
1746579190034,MATH 10B,A02,889795,Verstraete; Jacques Allan,4,0,35,31
1746579190034,MATH 10B,B01,889797,Verstraete; Jacques Allan,3,0,35,32
1746579190034,MATH 10B,B02,889828,Verstraete; Jacques Allan,3,0,35,32
1746579191059,MATH 10C,A01,889849,Habib; Yousaf,7,0,30,23
1746579191059,MATH 10C,A02,889852,Habib; Yousaf,14,0,30,16
1746579191059,MATH 10C,A03,889853,Habib; Yousaf,22,0,30,8
1746579191059,MATH 10C,A04,889858,Habib; Yousaf,20,0,30,10
1746579191059,MATH 10C,B01,889861,Staff,1,0,30,29
1746579191059,MATH 10C,B02,889862,Staff,24,0,30,6
1746579191059,MATH 10C,B03,889863,Staff,27,0,30,3
1746579191059,MATH 10C,B04,889967,Staff,23,0,30,7
1746579192084,MATH 18,A01,889974,Staff,7,0,30,23
1746579192084,MATH 18,A02,889977,Staff,20,0,30,10
1746579192084,MATH 18,B01,889984,Hardiman; Liam,20,0,30,10
1746579192084,MATH 18,B02,889985,Hardiman; Liam,25,0,30,5
1746579193114,MATH 20A,A01,889990,Suk; Andrew Hoon,30,0,35,5
1746579194139,MATH 20B,A01,889993,Ohm; Ko Woon,22,0,30,8
1746579194139,MATH 20B,A02,889994,Ohm; Ko Woon,30,0,30,0
1746579194139,MATH 20B,B01,889996,Ohm; Ko Woon,22,0,30,8
1746579194139,MATH 20B,B02,889997,Ohm; Ko Woon,23,0,30,7
1746579195165,MATH 20C,A01,889999,Hammock; Frances H,17,0,30,13
1746579195165,MATH 20C,A02,890003,Hammock; Frances H,23,0,30,7
1746579195165,MATH 20C,B01,890006,Hammock; Frances H,3,0,30,27
1746579195165,MATH 20C,B02,890007,Hammock; Frances H,12,0,30,18
1746579196190,MATH 20D,A01,890011,Cheng; Hsiao-Bing,1,1,30,29
1746579196190,MATH 20D,A02,890012,Cheng; Hsiao-Bing,14,0,30,16
1746579196190,MATH 20D,B01,890016,Cheng; Hsiao-Bing,13,0,30,17
1746579196190,MATH 20D,B02,890017,Cheng; Hsiao-Bing,13,0,30,17
1746579197218,MATH 20E,A01,890026,Harel; Guershon,1,0,30,29
1746579197218,MATH 20E,A02,890029,Harel; Guershon,23,0,30,7
1746579197218,MATH 20E,B01,890033,Harel; Guershon,7,0,30,23
1746579197218,MATH 20E,B02,890101,Harel; Guershon,21,0,30,9
1746579198242,MATH 102,A01,890104,Staff,18,0,30,12
1746579198242,MATH 102,A02,890105,Staff,27,0,30,3
1746579199278,MATH 103B,A01,890116,Salehi Golsefidy; Alireza,3,0,30,27
1746579199278,MATH 103B,B01,890118,Staff,0,3,34,34
1746579200310,MATH 109,A01,890121,Aliabadi Sr.; Mohsen,0,0,30,30
1746579200310,MATH 109,B01,890124,Upadrashta; Pranav Kumar,18,0,30,12
1746579201335,MATH 120A,A01,890126,Eggers; John Dietrich,13,0,30,17
1746579202359,MATH 142B,A01,890128,Ioana; Adrian,19,0,30,11
1746579202359,MATH 142B,A02,890129,Ioana; Adrian,12,0,30,18
1746579203388,MATH 154,A01,890174,Staff,0,0,30,30
1746579203388,MATH 154,A02,890182,Staff,0,0,30,30
1746579204414,MATH 168A,A01,890197,Dumitriu; Ioana,21,0,35,14
1746579205440,MATH 170A,A01,890240,Nie; Jiawang,1,0,30,29
1746579205440,MATH 170A,A02,890241,Nie; Jiawang,11,0,30,19
1746579205440,MATH 170A,A03,890249,Nie; Jiawang,23,0,30,7
1746579206465,MATH 170B,A01,957891,Nag; Panchali,13,0,35,22
1746579208516,MATH 181A,A01,908025,Staff,0,3,35,35
1746579208516,MATH 181A,A02,960115,Staff,26,0,35,9
1746579209541,MATH 181B,A01,959874,Staff,25,0,30,5
1746579210566,MATH 193B,A01,890265,Staff,0,4,35,35
1746579211592,MGT 4,A01,890311,Anderson; John Charles,42,0,88,46
1746579212620,MGT 5,A00,907740,Staff,13,0,98,85
1746579213648,MGT 12,A00,890312,Lindenberger; Wade Douglas,67,0,98,31
1746579214677,MGT 16,A00,957883,Staff,78,0,98,20
1746579216731,MGT 45,A00,890314,Pecore; Joseph P.,45,0,98,53
1746579217755,MGT 71,A00,890315,Staff,0,12,98,98
1746579218780,MGT 100,A00,890316,Yavorsky; Daniel Ryan,44,0,98,54
1746579219809,MGT 103,A00,890317,Ehrich; Kristine R,73,0,98,25
1746579220834,MGT 105,A00,890356,Bates; Kenneth Walter,0,8,98,98
1746579221861,MGT 112,A00,890360,Ehrich; Kristine R,55,0,98,43
1746579222885,MGT 127R,A00,907732,Zhu; Kevin Xiaoguo,23,0,98,75
1746579223909,MGT 131B,A00,890361,Anderson; John Charles,59,0,98,39
1746579224934,MGT 137,A00,890362,Lindenberger; Wade Douglas,65,0,98,33
1746579225961,MGT 160,A00,890369,Johnson; Erik Barry,9,0,98,89
1746579228015,MGT 164,A00,890372,Zimmermann; Carsten,0,40,98,98
1746579229042,MGT 180,A00,890374,Bliss; Barbara Ann,12,0,98,86
1746579230069,MMW 15,A01,886414,Chang; Edmond Yi-Teh,0,12,28,28
1746579230069,MMW 15,A02,886415,Chang; Edmond Yi-Teh,0,8,28,28
1746579230069,MMW 15,A03,886416,Chang; Edmond Yi-Teh,0,9,28,28
1746579230069,MMW 15,A04,886417,Chang; Edmond Yi-Teh,0,8,28,28
1746579230069,MMW 15,B01,886419,Chang; Edmond Yi-Teh,0,7,28,28
1746579230069,MMW 15,B02,886420,Chang; Edmond Yi-Teh,0,8,28,28
1746579230069,MMW 15,B03,886421,Chang; Edmond Yi-Teh,0,7,28,28
1746579230069,MMW 15,B04,886422,Chang; Edmond Yi-Teh,0,8,28,28
1746579230069,MMW 15,C01,886424,Staff,0,9,28,28
1746579230069,MMW 15,C02,886425,Staff,0,8,28,28
1746579230069,MMW 15,C03,886426,Staff,0,8,28,28
1746579230069,MMW 15,C04,886427,Staff,0,8,28,28
1746579230069,MMW 15,C05,958038,Staff,0,8,28,28
1746579230069,MMW 15,C06,958039,Staff,1,8,28,27
1746579231093,MMW 15GS,A00,906910,Patterson; Patrick H.,4,0,28,24
1746579232119,MMW 122R,A01,886429,Rahimi; Babak,0,13,28,28
1746579232119,MMW 122R,A02,886430,Rahimi; Babak,0,12,28,28
1746579232119,MMW 122R,A03,958040,Rahimi; Babak,0,11,28,28
1746579233148,MUS 1A,A01,890937,Staff,2,0,25,23
1746579233148,MUS 1A,A02,891035,Staff,6,0,25,19
1746579233148,MUS 1A,C01,958912,Staff,24,0,25,1
1746579233148,MUS 1A,C02,958913,Staff,25,0,25,0
1746579235205,MUS 2AK,A00,957092,Ohnishi; Takae,15,0,15,0
1746579236230,MUS 4,A01,891044,Staff,1,0,25,24
1746579236230,MUS 4,A02,891045,Staff,23,0,25,2
1746579236230,MUS 4,B01,891048,Staff,17,0,25,8
1746579236230,MUS 4,B02,891050,Staff,25,0,25,0
1746579237261,MUS 5,A01,957506,Dubnov; Shlomo,0,0,25,25
1746579237261,MUS 5,A02,957622,Dubnov; Shlomo,13,0,25,12
1746579237261,MUS 5,A03,957623,Dubnov; Shlomo,20,0,25,5
1746579238289,MUS 6,A01,891053,Freitas Caetano; Marcelo,24,0,25,1
1746579238289,MUS 6,A02,891054,Freitas Caetano; Marcelo,23,0,25,2
1746579239317,MUS 7,A01,891081,Staff,1,0,25,24
1746579239317,MUS 7,A02,891082,Staff,3,0,25,22
1746579240342,MUS 8GS,A00,891118,Borgo; David Garcia,1,0,25,24
1746579241373,MUS 11,A01,891140,Staff,9,0,25,16
1746579241373,MUS 11,A02,891141,Staff,21,0,25,4
1746579242399,MUS 13,A01,891143,Staff,8,0,25,17
1746579242399,MUS 13,A02,891144,Staff,24,0,25,1
1746579243428,MUS 15,A01,891146,Staff,9,0,25,16
1746579243428,MUS 15,A02,891148,Staff,21,0,25,4
1746579243428,MUS 15,B01,891150,Staff,18,0,25,7
1746579243428,MUS 15,B02,891151,Staff,25,0,25,0
1746579244453,MUS 20,A01,891153,Staff,5,0,20,15
1746579244453,MUS 20,A02,891155,Staff,14,0,20,6
1746579245481,MUS 80,A00,891156,Staff,19,0,25,6
1746579245481,MUS 80,B00,891157,Staff,23,0,25,2
1746579246510,MUS 130,A00,891158,Ohnishi; Takae,35,0,35,0
1746579247534,MUS 150GS,A01,891160,Borgo; David Garcia,1,0,25,24
1746579248561,MUS 170,A01,891162,Freitas Caetano; Marcelo,20,0,25,5
1746579248561,MUS 170,A02,891164,Freitas Caetano; Marcelo,21,0,25,4
1746579249589,NANO 11,A00,886220,Vazquez Mena; Oscar,13,0,15,2
1746579250617,NANO 15,A01,886222,Drews; Aaron,4,0,7,3
1746579251645,NANO 104,A00,886224,Sirbuly; Donald,17,0,25,8
1746579252670,PH 40,A00,886528,Staff,24,0,40,16
1746579253699,PH 45,A01,886799,Staff,35,0,40,5
1746579254727,PH 110,A00,886802,Staff,0,7,40,40
1746579255754,PH 172,A00,906716,Staff,19,0,35,16
1746579256782,PH 191,A00,886803,Staff,6,0,40,34
1746579257809,PHIL 1,A00,889500,Staff,20,0,30,10
1746579258837,PHIL 10,A01,889549,Grush; Rick Scott,16,0,22,6
1746579258837,PHIL 10,A02,889551,Grush; Rick Scott,22,0,22,0
1746579259869,PHIL 28,A01,889559,Lamey; Andy M.,0,2,31,31
1746579259869,PHIL 28,A02,889561,Lamey; Andy M.,0,1,30,30
1746579259869,PHIL 28,A03,889572,Lamey; Andy M.,0,1,30,30
1746579260898,PHIL 35,A00,907839,Staff,13,0,15,2
1746579261926,PHIL 60,A00,889574,Staff,73,0,90,17
1746579262952,PHIL 101,A00,958004,Staff,12,0,15,3
1746579265009,PHIL 136,A00,889582,Fulkerson; Matthew Todd,26,0,45,19
1746579266036,PHIL 163,A01,889601,Staff,21,0,30,9
1746579266036,PHIL 163,B01,889606,Brandt; Reuven A,0,3,0,0
1746579267060,PHIL 164,A00,889610,Staff,16,0,30,14
1746579268086,PHIL 165,A00,889613,Staff,22,0,30,8
1746579269116,PHYS 1A,A00,886431,Staff,28,0,70,42
1746579270145,PHYS 1AL,001,886432,Tsai; Philbert S,1,2,30,29
1746579270145,PHYS 1AL,002,886436,Tsai; Philbert S,11,0,30,19
1746579271168,PHYS 1B,A00,886439,Staff,184,0,240,56
1746579272196,PHYS 1BL,001,886441,Tsai; Philbert S,0,4,30,30
1746579272196,PHYS 1BL,002,886444,Tsai; Philbert S,2,0,30,28
1746579273225,PHYS 1C,A00,896092,Arnold; Kam S,78,0,146,68
1746579274254,PHYS 1CL,001,886448,Tsai; Philbert S,0,0,30,30
1746579274254,PHYS 1CL,002,886449,Tsai; Philbert S,1,0,30,29
1746579274254,PHYS 1CL,003,886450,Tsai; Philbert S,16,0,30,14
1746579274254,PHYS 1CL,004,886451,Tsai; Philbert S,15,0,30,15
1746579275283,PHYS 2B,A01,886457,Staff,68,0,115,47
1746579276314,PHYS 2C,A01,886460,Shotwell; Brian,0,9,65,65
1746579277341,PHYS 2CL,A01,886467,Staff,0,4,28,28
1746579277341,PHYS 2CL,A02,886468,Staff,0,3,28,28
1746579278366,PHYS 2D,A01,886470,Staff,10,0,50,40
1746579279393,PHYS 4B,A01,886475,Grinstein; Benjamin,22,0,40,18
1746579280417,POLI 5,A00,891173,Desposato; Scott,7,0,25,18
1746579281447,POLI 5D,A01,891175,Staff,5,0,5,0
1746579281447,POLI 5D,B01,891178,Staff,5,0,5,0
1746579282473,POLI 11,A00,891179,Ferree; Karen E,2,0,35,33
1746579283502,POLI 12,A00,891180,Staff,16,0,30,14
1746579284532,POLI 27,A01,891182,Staff,12,0,75,63
1746579285558,POLI 30,A00,891183,Staff,8,0,50,42
1746579286588,POLI 100B,A00,891244,Staff,5,1,35,30
1746579287615,POLI 100I,A00,891247,Staff,7,0,30,23
1746579288643,POLI 104J,A00,891248,Nichter; Maysa,14,0,30,16
1746579289670,POLI 104U,A00,891250,Nichter; Maysa,1,0,30,29
1746579291727,POLI 110B,A00,891255,Wiens; David,19,0,25,6
1746579292756,POLI 112A,A00,891256,Wiens; David,6,0,25,19
1746579293783,POLI 114BR,A00,891261,Staff,19,0,30,11
1746579294809,POLI 117R,A00,891262,Forman; Fonna,0,6,50,50
1746579295837,POLI 118,A00,891264,Ingham; Sean,17,0,25,8
1746579296866,POLI 124A,A00,891265,Staff,18,0,20,2
1746579297894,POLI 125D,A00,891266,Nichter; Simeon C,2,0,25,23
1746579298920,POLI 126,A00,891268,Nichter; Simeon C,7,0,25,18
1746579299949,POLI 126AA,A00,891272,Staff,15,0,25,10
1746579300980,POLI 130AA,A00,891273,Staff,15,0,20,5
1746579302007,POLI 134AA,A00,891274,Staff,4,0,20,16
1746579304063,POLI 138,A00,891278,Staff,21,0,25,4
1746579305089,POLI 142K,A00,891280,Staff,10,0,25,15
1746579306116,POLI 142M,A00,891281,Gartzke; Erik,16,0,30,14
1746579307140,POLI 142P,A00,891284,Staff,20,0,30,10
1746579308165,POLI 143,A00,891285,Gartzke; Erik,12,0,30,18
1746579309192,POLI 153,A00,891286,Staff,19,0,20,1
1746579311243,POLI 175,A00,891290,Staff,15,0,20,5
1746579312270,PSYC 1,A00,890674,Steiner; Eric Tomas,0,11,45,45
1746579313295,PSYC 2,A00,890676,Albright; Thomas D,21,0,35,14
1746579314325,PSYC 3,A00,890679,Staff,17,0,20,3
1746579315349,PSYC 6,A00,959858,Staff,19,0,20,1
1746579316377,PSYC 60,A01,890684,Rickard; Timothy C.,0,5,45,45
1746579317402,PSYC 70,A01,890689,Geller; Emma Harlan,7,0,30,23
1746579318431,PSYC 71,A01,959860,Staff,21,0,25,4
1746579319460,PSYC 100,A00,890690,Lacefield; Katharine I,0,50,180,180
1746579320487,PSYC 102,A00,890695,Staff,18,0,40,22
1746579321514,PSYC 105,A00,890699,Geller; Emma Harlan,70,0,100,30
1746579322540,PSYC 106,A00,890701,Gorman; Michael R.,5,0,30,25
1746579323569,PSYC 108,A00,890704,Adrian; Julia Anna,0,28,50,50
1746579324596,PSYC 118,A01,890712,Staff,11,0,30,19
1746579325622,PSYC 124,A00,890716,Chapman; Eddie Nathaniel,25,0,60,35
1746579326649,PSYC 131,A00,890717,Anagnostaras; Stephan,0,7,80,80
1746579327675,PSYC 137,A00,890719,Winkielman; Piotr,0,11,30,30
1746579328700,PSYC 144,A00,890721,Adrian; Julia Anna,0,9,45,45
1746579329734,PSYC 162,A00,890805,Staff,0,0,75,75
1746579330760,PSYC 169,A00,890810,Staff,0,14,30,30
1746579331788,PSYC 172,A00,890814,Gorman; Michael R.,9,0,30,21
1746579332812,PSYC 181,A00,890818,Anagnostaras; Stephan,8,0,200,192
1746579333837,PSYC 184,A00,959861,Staff,164,0,175,11
1746579334868,PSYC 189,A00,890823,Staff,0,2,30,30
1746579335894,PSYC 191,A00,890884,Rickard; Timothy C.,0,12,35,35
1746579336920,PSYC 193,A00,890913,Staff,19,0,30,11
1746579336920,PSYC 193,B00,890914,Chapman; Eddie Nathaniel,24,0,30,6
1746579337947,PSYC 193L,A01,890918,Lowe; Angela Beth,20,0,30,10
1746579337947,PSYC 193L,B01,890921,Hurwitz; Ethan Scott,20,0,30,10
1746579337947,PSYC 193L,C01,890928,Staff,30,0,30,0
1746579338973,RELI 149,A00,886806,Rahimi; Babak,23,0,40,17
1746579340002,SE 9,A01,886814,Staff,7,0,20,13
1746579341029,SE 101B,A01,886816,Chadha; Mayank,4,0,35,31
1746579342054,SE 110B,A00,886818,Zhu; Qiang,4,0,75,71
1746579343085,SE 125,A01,886830,Staff,10,0,30,20
1746579344114,SE 130B,A01,886835,Staff,14,0,40,26
1746579345140,SE 131A,A01,886838,Krysl; Petr,34,0,55,21
1746579346166,SE 154,A00,886840,Staff,29,0,50,21
1746579347195,SE 164GS,A01,886849,Staff,6,0,20,14
1746579348223,SE 167GS,A01,886853,Staff,6,0,20,14
1746579349250,SIO 25,A01,890107,Staff,19,0,30,11
1746579350276,SIO 45,A00,890109,Cook; Geoffrey W,116,0,200,84
1746579351305,SIO 109R,A00,890110,Forman; Fonna,0,16,20,20
1746579352330,SIO 187,A01,890114,Kacev; David,15,0,40,25
1746579353356,SOCI 1,A01,890431,Thorpe; Charles Robert,14,0,30,16
1746579353356,SOCI 1,A02,890518,Thorpe; Charles Robert,30,0,30,0
1746579354384,SOCI 2,A01,957978,Staff,25,0,25,0
1746579354384,SOCI 2,A02,957979,Staff,23,0,25,2
1746579355413,SOCI 20,A01,890523,Calderon-Zaks; Michael Aar,21,0,30,9
1746579355413,SOCI 20,A02,890526,Calderon-Zaks; Michael Aar,29,0,30,1
1746579356442,SOCI 30,A01,890533,Pardo Guerra; Juan Pablo,37,0,40,3
1746579357466,SOCI 40,A01,890535,Staff,27,0,45,18
1746579358494,SOCI 104Q,A00,890559,Staff,18,0,30,12
1746579359525,SOCI 106,A00,890560,Arnal; Maud Marie Leonie,20,0,30,10
1746579360548,SOCI 110,A00,890567,Holkenbrink-Monk; Charlene,19,0,30,11
1746579361574,SOCI 112,A00,890568,Victoria Torres; Pablo,2,0,55,53
1746579362601,SOCI 115,A00,890597,Arnal; Maud Marie Leonie,28,0,45,17
1746579364658,SOCI 121,A00,890604,Pardo Guerra; Juan Pablo,38,0,45,7
1746579365683,SOCI 126,A01,890608,Staff,8,0,10,2
1746579366708,SOCI 127,A00,890609,Staff,18,0,30,12
1746579367734,SOCI 131,A00,890610,Thorpe; Charles Robert,37,0,45,8
1746579368761,SOCI 135,A00,890615,Payne; Christine Anna,13,0,45,32
1746579369787,SOCI 139,A00,890620,Staff,38,0,45,7
1746579370815,SOCI 148E,A00,890622,Calderon-Zaks; Michael Aar,36,0,45,9
1746579371840,SOCI 150,A00,890623,Kohler; Kristopher M.,31,0,45,14
1746579372867,SOCI 157,A00,890625,Jules-Rosette; Bennetta W.,18,0,20,2
1746579373892,SOCI 160,A00,890627,Payne; Christine Anna,21,0,45,24
1746579374922,SYN 1,A00,886855,Fish; Gwendolyn Anne,0,1,0,0
1746579374922,SYN 1,B00,906086,Fish; Gwendolyn Anne,0,2,0,2
1746579375947,SYN 2R,A00,886860,Staff,0,17,15,15
1746579375947,SYN 2R,B00,906106,Atkinson; Arthur Laird,0,16,15,15
1746579376979,SYN 100,A01,886866,Browne; Emily,0,28,20,20
1746579376979,SYN 100,B01,906128,Rock; Martin,0,4,20,20
1746579376979,SYN 100,C01,906140,Deavenport; James Cary,0,3,20,20
1746579376979,SYN 100,D01,907816,Deavenport; James Cary,0,5,20,20
1746579378017,TDAC 1,A00,890286,Walsh; Kim C.,7,0,20,13
1746579379041,TDAC 101,A00,890296,Basso; Beatrice,15,0,20,5
1746579380075,TDDE 131,A00,890297,Staff,47,0,50,3
1746579381105,TDDM 1,A00,890287,Weinberg; Sadie,25,0,30,5
1746579382132,TDGE 11,A00,890288,Fulton; Julia,138,0,200,62
1746579382132,TDGE 11,B00,890289,Castro; Robert Jess,184,0,200,16
1746579383157,TDGE 25,B00,957359,Walsh; Kim C.,5,0,20,15
1746579384187,TDGE 40,A01,890292,Power; Jade Yukana,27,0,30,3
1746579385212,TDGE 124,A00,890298,Havis; Allan,0,1,50,50
1746579386240,TDGE 131R,A00,890299,Burelle; Julie Sara Veronique,15,0,42,27
1746579387268,TDHT 101,A00,890300,Staff,10,0,20,10
1746579388295,TDHT 109,A01,890302,Anderson; Mysia Anyse,31,0,40,9
1746579389322,TDMV 1,A00,890293,Arcidiacono; Kristin,18,0,30,12
1746579390347,TDMV 2,A00,890294,Weinberg; Sadie,23,0,30,7
1746579391371,TDMV 3,A00,957878,Arcidiacono; Kristin,28,0,30,2
1746579393437,TDMV 138,A00,890304,Jun; Grace Shin Hae,25,0,40,15
1746579394462,TDMV 140,A00,890305,Corrales; Joseph Bernales,25,0,30,5
1746579395488,TDMV 142,A00,890307,Caligagan; Tony,32,0,40,8
1746579396516,TDMV 144,A00,890308,Camaya; Michelle Ann,25,0,30,5
1746579397545,TDPW 1,A00,890295,Stein; Deborah Isobel,3,0,20,17
1746579398572,USP 2,A01,890272,Lerner; Amy M,7,0,20,13
1746579399600,USP 3,A01,890274,Staff,12,0,30,18
1746579400626,USP 15,A01,890276,Sun; Feiyang,16,0,30,14
1746579401654,USP 25,A00,890277,Shenkman; Michael Thomas,18,0,25,7
1746579402681,USP 138,A00,890278,Staff,14,0,25,11
1746579403707,USP 143,A00,890279,Staff,22,0,70,48
1746579404731,USP 144,A00,890280,Chowdhury; Muhammed Zohir,16,0,30,14
1746579405758,USP 150,A00,890281,Boomhower; Matthew Charles,4,0,30,26
1746579406786,USP 151,A00,890282,Staff,16,0,20,4
1746579407813,USP 162,A00,890283,Andrews; Abigail Leslie,16,0,20,4
1746579408838,USP 168,A00,920477,Kwak; Nancy,0,0,5,5
1746579409862,USP 181,A00,890284,Staff,3,0,20,17
1746579410889,USP 191A,A00,890285,Staff,12,0,20,8
1746579411917,VIS 101,A00,886512,Staff,25,0,75,50
1746579412942,VIS 103,A00,886513,Cruz; Edwin Teddy,61,0,75,14
1746579413967,VIS 108,A00,886514,Staff,3,0,15,12
1746579414992,VIS 127P,A00,886515,Shen; Kuiyi,80,0,146,66
1746579416020,VIS 149,A00,886516,Yoldas; Pinar,0,0,15,15
1746579417044,VIS 164,A00,886526,Erdmann; Dean,19,0,22,3
1746579418072,VIS 194S,A00,886527,Staff,61,0,75,14
1746579419101,WCWP 10A,C00,886484,Martiniuk; Jill,12,0,15,3
1746579420131,WCWP 10B,A00,886490,Uriarte; Emma,0,0,15,15
1746579420131,WCWP 10B,B00,886491,Dhir; Simrita,8,0,15,7
1746579420131,WCWP 10B,C00,886492,Ornelas; Tricia,0,0,15,15
1746579421160,WCWP 100,A00,886494,Young; Mark T,0,6,15,15
1746579423264,AAS 10,A01,886199,Childs; Dennis R.,0,3,0,0
1746579424289,ANAR 104,A01,886940,Shtienberg; Gilad,27,0,30,3
1746579425317,ANAR 120,A00,886953,Staff,12,0,20,8
1746579426344,ANBI 148,A01,886955,Wilder; Linnea Lorene,30,0,40,10
1746579428397,ANSC 122,A00,886957,Staff,25,0,30,5
1746579429421,ANSC 150,A00,886958,Sloane; Julia Kathryn,2,0,15,13
1746579430447,ANSC 156,A00,886959,Jenkins; Janis A.,0,1,15,15
1746579431473,ANSC 180,A00,886960,Staff,11,0,17,6
1746579432503,ANSC 188,A00,886961,Jassal; Aftab,9,0,25,16
1746579433530,ANSC 190,A00,886962,Jassal; Aftab,14,0,25,11
1746579434558,ANSC 191,A00,886963,Staff,18,0,20,2
1746579435582,ANTH 3,A01,891689,Staff,17,0,20,3
1746579436607,ANTH 5,A00,886933,Semendeferi; Ekaterini,16,0,20,4
1746579437635,ANTH 10,A00,886934,Staff,0,12,30,30
1746579438665,ANTH 21,A01,886936,Staff,41,0,60,19
1746579439691,ANTH 23,A01,886938,Staff,92,0,100,8
1746579440714,ANTH 105,A00,886964,Stewart; Alexander B,84,0,100,16
1746579441740,ANTH 108,A00,886965,Pedersen; David,9,0,20,11
1746579442772,AWP 10,001,886147,Staff,0,0,0,0
1746579442772,AWP 10,002,886148,Staff,0,0,0,0
1746579442772,AWP 10,003,886149,Staff,0,0,0,0
1746579442772,AWP 10,004,886150,Staff,0,0,0,0
1746579442772,AWP 10,005,886151,Staff,0,0,0,0
1746579442772,AWP 10,006,886152,Staff,0,0,0,0
1746579442772,AWP 10,007,886153,Staff,0,0,0,0
1746579442772,AWP 10,008,886154,Staff,0,0,0,0
1746579442772,AWP 10,009,886155,Staff,0,0,0,0
1746579442772,AWP 10,010,886156,Staff,0,0,0,0
1746579442772,AWP 10,011,886158,Staff,0,0,0,0
1746579442772,AWP 10,012,886160,Staff,0,0,0,0
1746579442772,AWP 10,013,886161,Staff,0,0,0,0
1746579442772,AWP 10,014,886162,Staff,0,0,0,0
1746579442772,AWP 10,015,886163,Staff,0,0,0,0
1746579442772,AWP 10,016,886164,Staff,0,0,0,0
1746579442772,AWP 10,017,886165,Staff,0,0,0,0
1746579442772,AWP 10,018,886166,Staff,0,0,0,0
1746579442772,AWP 10,019,886168,Staff,0,0,0,0
1746579442772,AWP 10,020,886170,Staff,0,0,0,0
1746579442772,AWP 10,021,886172,Staff,0,0,0,0
1746579443806,AWP 10R,001,886173,Staff,0,1,0,0
1746579443806,AWP 10R,002,886174,Staff,0,1,0,0
1746579443806,AWP 10R,003,886175,Staff,0,0,0,0
1746579443806,AWP 10R,004,886176,Staff,0,0,0,0
1746579443806,AWP 10R,005,886177,Staff,0,0,0,0
1746579443806,AWP 10R,006,886178,Staff,0,0,0,0
1746579443806,AWP 10R,007,886179,Staff,0,0,0,0
1746579443806,AWP 10R,008,886181,Staff,0,0,0,0
1746579443806,AWP 10R,009,886182,Staff,0,0,0,0
1746579443806,AWP 10R,010,886183,Staff,0,0,0,0
1746579443806,AWP 10R,011,886184,Staff,0,0,0,0
1746579443806,AWP 10R,012,886185,Staff,0,0,0,0
1746579443806,AWP 10R,013,886186,Staff,0,0,0,0
1746579443806,AWP 10R,014,886187,Staff,0,0,0,0
1746579443806,AWP 10R,015,886188,Staff,0,0,0,0
1746579443806,AWP 10R,016,886189,Staff,0,0,0,0
1746579443806,AWP 10R,017,960532,Staff,0,0,0,0
1746579443806,AWP 10R,018,960533,Staff,0,0,0,0
1746579443806,AWP 10R,019,960534,Staff,0,0,0,0
1746579443806,AWP 10R,020,960538,Staff,0,0,0,0
1746579443806,AWP 10R,021,960540,Staff,0,0,0,0
1746579443806,AWP 10R,022,960541,Staff,0,0,0,0
1746579443806,AWP 10R,023,960542,Staff,0,0,0,0
1746579443806,AWP 10R,024,960544,Staff,0,0,0,0
1746579443806,AWP 10R,025,960545,Staff,0,0,0,0
1746579443806,AWP 10R,026,960548,Staff,0,0,0,0
1746579444830,AWP 102R,A00,886190,Staff,0,0,0,0
1746579444830,AWP 102R,B00,886191,Staff,0,0,0,0
1746579445857,BENG 100,A01,886193,Staff,17,0,30,13
1746579446882,BENG 122A,A01,886195,Hasty; Jeff M,13,0,30,17
1746579447908,BENG 166A,A00,886196,Sah; Robert Lie-Yuan,0,3,30,30
1746579448932,BENG 190,A00,958050,Khojah; Reem I,19,0,25,6
1746579449961,BIBC 102,A01,894320,Staff,0,0,46,46
1746579449961,BIBC 102,A02,894321,Staff,0,0,46,46
1746579449961,BIBC 102,A03,894344,Staff,6,0,46,40
1746579449961,BIBC 102,A04,894345,Staff,27,0,47,20
1746579450987,BICD 100R,A01,894365,Smith; Laurie,0,3,58,58
1746579450987,BICD 100R,A02,894366,Smith; Laurie,0,5,58,58
1746579450987,BICD 100R,A03,894367,Smith; Laurie,0,0,59,59
1746579450987,BICD 100R,A04,959869,Smith; Laurie,40,0,59,19
1746579452018,BICD 136,A01,894383,Gustafson-Brown; Cindy,14,0,50,36
1746579453045,BIEB 102,A01,894494,Butler; Shannon Rhey,51,0,130,79
1746579455101,BIEB 150,A01,894617,Wills; Christopher,3,0,20,17
1746579455101,BIEB 150,A02,894631,Wills; Christopher,3,0,20,17
1746579455101,BIEB 150,A03,894937,Wills; Christopher,3,0,20,17
1746579455101,BIEB 150,A04,894946,Wills; Christopher,5,0,20,15
1746579456127,BIEB 194,A00,906141,Kurle; Carolyn M.,6,0,20,14
1746579457152,BILD 1,A01,894154,Staff,3,0,19,16
1746579457152,BILD 1,A02,894155,Staff,14,0,19,5
1746579457152,BILD 1,A03,894160,Staff,13,0,19,6
1746579457152,BILD 1,A04,894161,Staff,15,0,18,3
1746579458177,BILD 2,A01,894168,Staff,0,0,50,50
1746579458177,BILD 2,A02,894169,Staff,0,0,50,50
1746579458177,BILD 2,A03,894179,Staff,0,0,50,50
1746579458177,BILD 2,A04,894203,Staff,24,0,50,26
1746579459203,BILD 3,A01,894213,Staff,23,0,31,8
1746579459203,BILD 3,A02,894214,Staff,26,0,31,5
1746579459203,BILD 3,A03,894235,Staff,28,0,31,3
1746579459203,BILD 3,A04,894236,Staff,28,0,32,4
1746579460228,BILD 4,A01,894253,Reuther; Keefe,5,0,24,19
1746579460228,BILD 4,A02,894258,Reuther; Keefe,16,0,24,8
1746579461253,BILD 5,A01,894276,Reuther; Keefe,35,0,50,15
1746579461253,BILD 5,A02,894277,Reuther; Keefe,45,0,50,5
1746579461253,BILD 5,A03,894290,Reuther; Keefe,44,0,50,6
1746579461253,BILD 5,A04,894291,Reuther; Keefe,48,0,50,2
1746579462280,BILD 24,A01,894297,Pirino; Giorgia,40,0,60,20
1746579463308,BIMM 100,B01,958915,Staff,71,0,100,29
1746579464337,BIMM 101,A01,895017,McDonnell; Lisa Marie,0,5,24,24
1746579464337,BIMM 101,A02,895018,McDonnell; Lisa Marie,0,5,24,24
1746579464337,BIMM 101,B01,895020,McDonnell; Lisa Marie,0,6,24,24
1746579464337,BIMM 101,B02,895021,McDonnell; Lisa Marie,0,4,24,24
1746579465365,BIMM 110,A01,895023,Staff,1,0,25,24
1746579465365,BIMM 110,A02,895024,Staff,9,0,25,16
1746579465365,BIMM 110,A03,895025,Staff,18,0,25,7
1746579465365,BIMM 110,A04,895031,Staff,20,0,25,5
1746579466444,BIMM 120,A01,895114,Gustafson-Brown; Cindy,14,0,28,14
1746579466444,BIMM 120,A02,895126,Gustafson-Brown; Cindy,21,0,27,6
1746579467471,BIPN 100,A01,895130,Yang; Mingyu,0,0,38,38
1746579467471,BIPN 100,A02,895131,Yang; Mingyu,32,0,38,6
1746579467471,BIPN 100,A03,895132,Yang; Mingyu,32,0,38,6
1746579467471,BIPN 100,A04,895133,Yang; Mingyu,27,0,36,9
1746579468501,BIPN 120,A01,895135,Cooke; James Edward,0,3,13,13
1746579468501,BIPN 120,A02,895136,Cooke; James Edward,0,1,13,13
1746579468501,BIPN 120,A03,895137,Cooke; James Edward,0,3,13,13
1746579468501,BIPN 120,A04,895156,Cooke; James Edward,0,2,11,11
1746579469527,BIPN 134,A01,895235,Cooke; James Edward,0,2,25,25
1746579469527,BIPN 134,A02,895237,Cooke; James Edward,0,0,25,25
1746579469527,BIPN 134,A03,895240,Cooke; James Edward,3,0,25,22
1746579469527,BIPN 134,A04,895270,Cooke; James Edward,20,0,25,5
1746579470554,BIPN 189,A00,892103,Staff,0,14,14,14
1746579472607,BISP 194,A00,958008,Staff,0,2,0,0
1746579473635,CAT 124,A01,922009,Staff,0,5,20,20
1746579474662,CAT 125R,A00,886390,Morales; Celeste Georgianna,0,2,20,20
1746579474662,CAT 125R,B00,886391,Irwin; Matthew Joseph,0,4,20,20
1746579474662,CAT 125R,C00,886392,Smith; Lauryn Alissa,0,2,20,20
1746579474662,CAT 125R,D00,886393,Vanderschuit; Maya Alysia,0,3,20,20
1746579474662,CAT 125R,E00,886394,Marchisotto; Jennifer Anne,0,3,20,20
1746579475687,CENG 15,A01,886218,Drews; Aaron,3,0,8,5
1746579476715,CENG 113,A00,886219,Opatkiewicz; Justin Paul,15,0,25,10
1746579477741,CGS 101,A00,887044,Staff,7,0,20,13
1746579478770,CGS 105,A01,887046,Staff,14,0,25,11
1746579479796,CGS 112,A00,887047,Cuong; Marisol,12,0,15,3
1746579480822,CGS 113,A00,887048,Staff,23,0,30,7
1746579481849,CGS 120,A00,887049,Staff,10,0,17,7
1746579482881,CHEM 6A,A01,886336,Lam; Tin Yiu,38,0,50,12
1746579482881,CHEM 6A,A02,886338,Lam; Tin Yiu,37,0,50,13
1746579483905,CHEM 6B,A01,886341,Hopkins; Patrycja Anna,16,0,50,34
1746579483905,CHEM 6B,A02,886343,Hopkins; Patrycja Anna,42,0,50,8
1746579484931,CHEM 6C,A01,886346,Albizati; Kim F.,0,2,50,50
1746579484931,CHEM 6C,A02,886348,Albizati; Kim F.,23,0,50,27
1746579485959,CHEM 40A,A01,886352,Klosterman; Jeremy K,65,0,100,35
1746579486989,CHEM 40B,A01,886356,Klosterman; Jeremy K,0,24,100,100
1746579488014,CHEM 41B,A01,886360,Theodorakis; Emmanuel,25,0,50,25
1746579488014,CHEM 41B,A02,886362,Theodorakis; Emmanuel,47,0,50,3
1746579489041,CHIN 165A,A00,886382,Xu; Li,18,0,20,2
1746579490072,CLAS 120,A00,886387,Myerston Santana; Jacobo,33,0,40,7
1746579491101,COGS 9,A01,886967,Shannon; Kyle Michael,42,0,60,18
1746579492127,COGS 11,A01,886969,Staff,9,0,30,21
1746579493153,COGS 14A,A01,886971,Staff,6,0,60,54
1746579494180,COGS 14B,A01,886973,Hoffman; Drew Ellen,4,0,60,56
1746579495204,COGS 18,A01,886975,Morgan; Eric,35,0,60,25
1746579496232,COGS 20,A01,886977,Staff,4,0,8,4
1746579496232,COGS 20,A02,886978,Staff,5,0,7,2
1746579497258,COGS 100,A01,907783,Staff,1,2,30,29
1746579498289,COGS 101B,A01,886980,Staff,0,4,48,48
1746579499317,COGS 101C,A01,886982,Delgado; Tania,0,5,44,44
1746579500343,COGS 102A,A01,886984,Johnson; Christine M.,4,0,30,26
1746579501368,COGS 118B,A01,886986,Staff,1,4,88,87
1746579502406,COGS 150,A01,886988,Bergen; Benjamin,22,0,50,28
1746579503433,COGS 153,A00,886989,Delgado; Tania,0,2,41,41
1746579504458,COGS 186,A01,886991,Staff,0,0,32,32
1746579505486,COGS 187A,A01,886993,Boyle; Mary E. T.,7,0,30,23
1746579506513,COGS 189,A00,886994,Staff,0,1,30,30
1746579507542,COMM 10,A01,886996,Staff,0,0,20,21
1746579507542,COMM 10,A02,886997,Staff,10,0,20,10
1746579507542,COMM 10,A03,959845,Staff,19,0,20,1
1746579508570,COMM 20,A01,886999,Leuning; Grant Maurstad,24,0,40,16
1746579510623,COMM 100A,A01,887002,Staff,0,0,20,25
1746579510623,COMM 100A,A02,887003,Staff,6,0,20,14
1746579511648,COMM 100B,A01,887005,Staff,0,8,20,24
1746579512674,COMM 106D,A00,887006,Staff,13,0,40,27
1746579513703,COMM 110G,A00,887007,Whitworth-Smith; Andrew C,12,0,40,28
1746579514733,COMM 111B,A00,887008,Staff,31,0,40,9
1746579515762,COMM 113T,A00,887009,Abuelhiga; Soraya Jill,28,0,40,12
1746579515762,COMM 113T,B00,906733,Staff,40,0,40,0
1746579516792,COMM 145,A00,887010,Staff,12,0,40,28
1746579517818,COMM 146,A00,887054,Staff,31,0,40,9
1746579518843,COMM 190,A00,887012,Staff,8,0,23,15
1746579519868,CSE 8A,A50,887015,Cao; Yingjun,57,0,85,28
1746579520892,CSE 11,A01,887017,Cao; Yingjun,12,0,70,58
1746579521921,CSE 20,A01,887019,Staff,30,0,50,20
1746579522948,CSE 21,A01,887021,Staff,78,0,100,22
1746579522948,CSE 21,B01,892583,Braun; Oliver,45,0,50,5
1746579523977,CSE 30,A01,887025,Eldon; John,143,0,200,57
1746579525006,CSE 100,A01,887027,Staff,26,0,50,24
1746579525006,CSE 100,A02,887028,Staff,42,0,50,8
1746579526039,CSE 101,A01,887030,Braun; Oliver,74,0,100,26
1746579526039,CSE 101,B01,887032,Jones; Miles E,0,3,50,50
1746579526039,CSE 101,B02,887033,Jones; Miles E,0,2,50,50
1746579527063,CSE 105,A01,908084,Jones; Miles E,32,0,50,18
1746579527063,CSE 105,A02,908087,Jones; Miles E,31,0,50,19
1746579528092,CSE 135,A01,887035,Powell; Thomas Allan,0,5,50,50
1746579529118,CSE 142,A01,887037,Staff,8,0,60,52
1746579530155,CSE 142L,A01,887039,Staff,34,0,60,26
1746579531185,CSE 151A,A01,887041,Solares; Edwin A,47,0,100,53
1746579532214,CSE 175,A01,887043,Kumar; Rakesh,30,0,30,0
1746579533244,CSS 1,A01,886389,Staff,1,2,40,39
1746579534270,DSC 30,A01,908097,Liao; Soohyun Nam,47,0,75,28
1746579535297,DSC 40A,A01,908099,Shannon; Kyle Michael,30,0,50,20
1746579536322,DSC 40B,A01,908112,Staff,15,0,50,35
1746579537347,DSC 80,A01,908116,Staff,19,0,60,41
1746579538371,DSC 197,001,956863,Eldridge; Justin Matthew,9999,0,9999,0
1746579539402,ECE 5,A01,886400,Morris; Karcher William,1,0,6,5
1746579539402,ECE 5,A02,886401,Morris; Karcher William,3,0,6,3
1746579540428,ECE 148,A01,886403,Silberman; Jack,0,14,14,14
1746579541453,ECON 1,A01,887265,Crane; Meredith Helen,12,0,70,58
1746579541453,ECON 1,B01,887268,Staff,42,0,50,8
1746579542483,ECON 2,A01,887273,Crane; Meredith Helen,55,0,70,15
1746579543512,ECON 3,A01,887279,Rondina; Giacomo,32,0,70,38
1746579544545,ECON 4,A01,887282,Anderson; John Charles,0,2,10,10
1746579545573,ECON 5,A01,887285,Staff,34,0,45,11
1746579545573,ECON 5,B01,887292,Staff,41,0,45,4
1746579546598,ECON 100A,A01,887337,Newhouse; Herbert S,54,0,70,16
1746579546598,ECON 100A,B01,887349,Staff,45,0,50,5
1746579547623,ECON 100B,A01,887361,Du; Songzi,29,0,70,41
1746579548651,ECON 100C,A01,887445,Newhouse; Herbert S,59,0,70,11
1746579549679,ECON 105,A00,887488,Vespa; Emanuel Ignacio,23,0,35,12
1746579550707,ECON 109,A01,887506,Shishkin; Denis,28,0,35,7
1746579551738,ECON 110A,A01,887568,Alon; Titan Michael,0,3,35,35
1746579551738,ECON 110A,B01,907601,Alon; Titan Michael,20,0,35,15
1746579552767,ECON 110B,A01,887598,Levkoff; Steven B.,0,24,70,70
1746579553791,ECON 112,A00,887599,Rondina; Giacomo,19,0,35,16
1746579554820,ECON 120A,A01,887603,Dai; Yinlin,35,0,70,35
1746579555851,ECON 120C,A01,887608,Sun; Yixiao,0,1,35,35
1746579555851,ECON 120C,B01,887614,Sun; Yixiao,0,0,35,35
1746579556878,ECON 138,A00,887621,Bharadwaj; Prashant,0,21,20,20
1746579557905,ECON 144,A00,958007,Squires; Dale E,12,0,35,23
1746579558934,ECON 171,A01,907666,Staff,18,0,35,17
1746579559958,ECON 175,A00,887626,Wu; Pak Yeung,22,0,35,13
1746579560983,ECON 190,A00,887640,Vespa; Emanuel Ignacio,22,0,35,13
1746579562012,EDS 25,A01,888197,Staff,0,0,0,0
1746579562012,EDS 25,A02,888209,Staff,0,0,0,0
1746579562012,EDS 25,A03,888210,Staff,0,0,0,0
1746579562012,EDS 25,A04,888212,Staff,0,0,0,0
1746579562012,EDS 25,A05,888213,Staff,0,0,0,0
1746579562012,EDS 25,A06,888214,Staff,0,0,0,0
1746579562012,EDS 25,A07,888235,Staff,0,2,0,0
1746579562012,EDS 25,A08,888236,Staff,0,0,0,0
1746579562012,EDS 25,A09,888240,Staff,0,0,0,0
1746579562012,EDS 25,A10,888244,Staff,0,0,0,0
1746579562012,EDS 25,B01,888273,Staff,0,0,0,0
1746579562012,EDS 25,B02,888285,Staff,0,0,0,0
1746579562012,EDS 25,B03,888423,Staff,0,0,0,1
1746579562012,EDS 25,B04,888432,Staff,0,0,0,0
1746579562012,EDS 25,B05,888433,Staff,0,0,0,0
1746579562012,EDS 25,B06,888467,Staff,0,0,0,0
1746579562012,EDS 25,B07,888468,Staff,0,0,0,0
1746579562012,EDS 25,B08,888479,Staff,0,0,0,0
1746579562012,EDS 25,B09,888484,Staff,0,0,0,0
1746579562012,EDS 25,B10,888487,Staff,0,0,0,0
1746579563036,EDS 38,A01,907700,Choi; Bailey Miyeon,30,0,30,0
1746579564062,EDS 112,A01,888601,Chapman; Thandeka K,12,0,40,28
1746579565092,EDS 115,A00,888697,Mendez; Kathrina Mendoza,10,0,30,20
1746579566118,EDS 116,A01,888893,Staff,34,0,40,6
1746579568172,EDS 124AR,A00,889133,Staff,29,0,50,21
1746579568172,EDS 124AR,B00,907471,Simon; Elizabeth A,37,0,50,13
1746579569195,EDS 124BR,A00,889134,Simon; Elizabeth A,44,0,100,56
1746579570224,EDS 125,A00,889135,Staff,25,0,30,5
1746579571250,EDS 126,A01,889138,Staff,35,0,40,5
1746579572278,EDS 164R,A01,889142,Wishard Guerra; Alison G.,33,0,50,17
1746579573303,ENG 30,A01,886396,Staff,0,0,0,0
1746579573303,ENG 30,B01,886398,Staff,0,0,0,0
1746579574331,ENVR 102,A00,906150,Montejo; Carolina,23,0,25,2
1746579575361,ETHN 103A,A00,887236,Man; Simeon S,0,3,0,0
1746579576388,ETHN 113,A00,887239,Staff,16,0,30,14
1746579577415,ETHN 116,A00,887240,Staff,16,0,25,9
1746579578439,ETHN 117,A00,887241,Choi; Esther Min,28,0,30,2
1746579579464,ETHN 118,A00,887243,Staff,24,0,30,6
1746579580488,ETHN 127,A00,887248,Cuong; Marisol,11,0,15,4
1746579581514,ETHN 139,A00,887250,Staff,7,0,10,3
1746579582539,ETHN 142,A00,887252,Staff,10,0,30,20
1746579583565,ETHN 161,A00,887253,Browne; Errol Tsekani,24,0,30,6
1746579584590,ETHN 163FR,A00,887255,Burelle; Julie Sara Veronique,0,0,5,5
1746579585619,GLBH 20,A00,889149,Elwardani; Nile Regina,8,0,42,34
1746579587672,GLBH 111,A01,889152,Burgos; Jose L.,17,0,17,0
1746579588698,GLBH 150,A00,889181,Sloane; Julia Kathryn,0,5,15,15
1746579590754,HDS 60,A01,886406,Warstadt; Melissa Fawn,73,0,80,7
1746579591778,HIAF 111,A00,889324,Gyamfi; Bright,25,0,32,7
1746579592803,HIEA 131,A00,889328,Staff,15,0,32,17
1746579593828,HIEA 144,A00,889333,Henry; Todd A.,26,0,32,6
1746579594853,HIEA 154,A00,889336,Henry; Todd A.,24,0,32,8
1746579595880,HIEU 106,A00,889339,Staff,22,0,32,10
1746579597938,HIEU 114,A00,889340,Staff,4,0,32,28
1746579598964,HIEU 135GS,A00,889342,Patterson; Patrick H.,0,0,1,24
1746579599994,HIEU 137,A00,889343,Edington; Claire Ellen,10,0,25,15
1746579601021,HIEU 148,A00,889345,Staff,14,0,32,18
1746579602047,HIEU 154,A00,889346,Biess; Frank Peter,21,0,32,11
1746579603074,HILA 102,A00,889351,Staff,12,0,32,20
1746579604103,HILD 2A,A01,889221,Lewandoski; Julia Mavis,1,10,32,31
1746579605132,HILD 7B,A01,889225,Man; Simeon S,0,12,32,32
1746579606157,HILD 7C,A01,889288,Alvarez; Luis A,0,14,32,32
1746579607184,HILD 30,A01,889323,Staff,0,5,32,32
1746579609235,HISC 119,A00,889383,Golan; Tal,19,0,32,13
1746579610265,HIUS 103,A00,889384,Man; Simeon S,0,0,32,32
1746579611290,HIUS 117,A00,919797,Kwak; Nancy,19,0,32,13
1746579612316,HIUS 142A,A00,919788,Staff,22,0,32,10
1746579614396,HIUS 149,A00,889386,Gyamfi; Bright,26,0,32,6
1746579615420,HIUS 155,A00,889387,Alvarez; Luis A,15,0,32,17
1746579616444,HUM 3,A01,886499,Caldwell; Michael Alan,19,0,50,31
1746579617469,HUM 3GS,A00,886500,Rodriguez; Bretton Sigfred,0,0,0,28
1746579618497,HUM 3R,A01,886502,Markman; Kristina,0,36,50,50
1746579619526,HUM 4,A01,886504,Crum; Matthew Stephen,23,0,50,27
1746579619526,HUM 4,B01,886506,West; Geoffrey Scott,17,0,50,33
1746579620551,HUM 4GS,A00,886507,Staff,0,0,0,19
1746579621579,HUM 5,A01,886509,Staff,32,0,50,18
1746579622603,HUM 5R,A01,886511,Zavodny; Tatiana Sophia,0,39,50,50
1746579623627,JAPN 180,A00,886407,Staff,16,0,40,24
1746579624652,LATI 50,A01,886409,Martin-Cabrera; Luis,3,0,22,19
1746579624652,LATI 50,A02,886410,Martin-Cabrera; Luis,19,0,22,3
1746579624652,LATI 50,A03,886411,Martin-Cabrera; Luis,21,0,22,1
1746579624652,LATI 50,A04,886412,Martin-Cabrera; Luis,8,0,22,14
1746579625681,LAWS 101,A00,907664,Staff,28,0,60,32
1746579626710,LIAB 1A,A00,889388,Saab; Dima,17,0,20,3
1746579627735,LIAB 1AX,A00,889389,El Cheddadi; Youniss,18,0,20,2
1746579628761,LIFR 1C,A00,889391,Van Moer; Vinciane G,8,0,20,12
1746579630340,LIFR 1CX,A00,889392,Van Moer; Vinciane G,7,0,20,13
1746579631368,LIFR 1D,A00,889393,Van Moer; Vinciane G,7,0,20,13
1746579632411,LIFR 1DX,A00,889394,Van Moer; Vinciane G,8,0,20,12
1746579633437,LIGN 7,A00,886923,Staff,24,0,50,26
1746579634464,LIGN 17,A00,886924,Kehler; Andrew Scott,125,0,150,25
1746579635490,LTAM 110,A00,889395,Staff,15,0,30,15
1746579636519,LTAM 110GS,A00,958010,Rodriguez; Bretton Sigfred,0,0,0,28
1746579637547,LTCH 101,A00,889397,Staff,23,0,25,2
1746579638575,LTCS 130,A00,889398,Staff,23,0,25,2
1746579639599,LTEA 138,A00,889399,Staff,24,0,40,16
1746579640625,LTEN 149,A00,889400,Wesling; Megan E.,0,3,25,25
1746579641650,LTEN 169,A00,889401,Staff,20,0,25,5
1746579642675,LTEN 180,A00,889402,Staff,10,0,15,5
1746579643698,LTEN 181,A00,889403,Staff,21,0,25,4
1746579644729,LTWL 100,A00,889404,Myerston Santana; Jacobo,2,0,25,23
1746579645755,LTWL 180GS,A00,889405,Staff,0,0,20,20
1746579646783,LTWL 181,A00,889406,Staff,16,0,25,9
1746579647808,LTWL 184,A00,889475,Mukherjee; Silpa,22,0,25,3
1746579648835,LTWR 102C,A00,889486,Staff,29,0,30,1
1746579649860,LTWR 115W,A00,889491,Staff,0,2,15,15
1746579650888,MAE 8,A01,886905,Staff,0,2,0,0
1746579651918,MAE 11,A00,886906,Bandaru; Prabhakar,0,7,50,50
1746579652943,MAE 20,A00,886907,Evdokimenko; Ekaterina,43,0,70,27
1746579653972,MAE 30B,A00,886909,Ghazinejad; Maziar,26,0,45,19
1746579655000,MAE 101B,A00,886910,Saintillan; David,29,0,45,16
1746579656030,MAE 105,A00,886911,Bandaru; Prabhakar,18,0,50,32
1746579657060,MAE 107,B00,958024,Staff,8,0,50,42
1746579658090,MAE 143B,A00,886913,Bewley; Thomas R,3,0,40,37
1746579659148,MAE 148,A01,886915,Silberman; Jack,0,3,14,14
1746579660175,MAE 160,A00,886916,Evdokimenko; Ekaterina,31,0,60,29
1746579661259,MATH 3C,A01,889681,Staff,0,2,30,30
1746579661259,MATH 3C,A02,960048,Staff,24,0,30,6
1746579662307,MATH 10A,A01,889760,Staff,26,0,30,4
1746579662307,MATH 10A,A02,889783,Staff,29,0,30,1
1746579663331,MATH 10B,A01,889785,Verstraete; Jacques Allan,2,0,35,33
1746579663331,MATH 10B,A02,889795,Verstraete; Jacques Allan,4,0,35,31
1746579663331,MATH 10B,B01,889797,Verstraete; Jacques Allan,3,0,35,32
1746579663331,MATH 10B,B02,889828,Verstraete; Jacques Allan,3,0,35,32
1746579664357,MATH 10C,A01,889849,Habib; Yousaf,7,0,30,23
1746579664357,MATH 10C,A02,889852,Habib; Yousaf,14,0,30,16
1746579664357,MATH 10C,A03,889853,Habib; Yousaf,22,0,30,8
1746579664357,MATH 10C,A04,889858,Habib; Yousaf,20,0,30,10
1746579664357,MATH 10C,B01,889861,Staff,1,0,30,29
1746579664357,MATH 10C,B02,889862,Staff,24,0,30,6
1746579664357,MATH 10C,B03,889863,Staff,27,0,30,3
1746579664357,MATH 10C,B04,889967,Staff,23,0,30,7
1746579665384,MATH 18,A01,889974,Staff,7,0,30,23
1746579665384,MATH 18,A02,889977,Staff,20,0,30,10
1746579665384,MATH 18,B01,889984,Hardiman; Liam,20,0,30,10
1746579665384,MATH 18,B02,889985,Hardiman; Liam,25,0,30,5
1746579666412,MATH 20A,A01,889990,Suk; Andrew Hoon,30,0,35,5
1746579667446,MATH 20B,A01,889993,Ohm; Ko Woon,22,0,30,8
1746579667446,MATH 20B,A02,889994,Ohm; Ko Woon,30,0,30,0
1746579667446,MATH 20B,B01,889996,Ohm; Ko Woon,22,0,30,8
1746579667446,MATH 20B,B02,889997,Ohm; Ko Woon,23,0,30,7
1746579668472,MATH 20C,A01,889999,Hammock; Frances H,17,0,30,13
1746579668472,MATH 20C,A02,890003,Hammock; Frances H,23,0,30,7
1746579668472,MATH 20C,B01,890006,Hammock; Frances H,3,0,30,27
1746579668472,MATH 20C,B02,890007,Hammock; Frances H,12,0,30,18
1746579669505,MATH 20D,A01,890011,Cheng; Hsiao-Bing,1,1,30,29
1746579669505,MATH 20D,A02,890012,Cheng; Hsiao-Bing,14,0,30,16
1746579669505,MATH 20D,B01,890016,Cheng; Hsiao-Bing,13,0,30,17
1746579669505,MATH 20D,B02,890017,Cheng; Hsiao-Bing,13,0,30,17
1746579670532,MATH 20E,A01,890026,Harel; Guershon,1,0,30,29
1746579670532,MATH 20E,A02,890029,Harel; Guershon,23,0,30,7
1746579670532,MATH 20E,B01,890033,Harel; Guershon,7,0,30,23
1746579670532,MATH 20E,B02,890101,Harel; Guershon,21,0,30,9
1746579671558,MATH 102,A01,890104,Staff,18,0,30,12
1746579671558,MATH 102,A02,890105,Staff,27,0,30,3
1746579672593,MATH 103B,A01,890116,Salehi Golsefidy; Alireza,3,0,30,27
1746579672593,MATH 103B,B01,890118,Staff,0,3,34,34
1746579673619,MATH 109,A01,890121,Aliabadi Sr.; Mohsen,0,0,30,30
1746579673619,MATH 109,B01,890124,Upadrashta; Pranav Kumar,18,0,30,12
1746579674649,MATH 120A,A01,890126,Eggers; John Dietrich,13,0,30,17
1746579675682,MATH 142B,A01,890128,Ioana; Adrian,19,0,30,11
1746579675682,MATH 142B,A02,890129,Ioana; Adrian,12,0,30,18
1746579676709,MATH 154,A01,890174,Staff,0,0,30,30
1746579676709,MATH 154,A02,890182,Staff,0,0,30,30
1746579677737,MATH 168A,A01,890197,Dumitriu; Ioana,21,0,35,14
1746579678762,MATH 170A,A01,890240,Nie; Jiawang,1,0,30,29
1746579678762,MATH 170A,A02,890241,Nie; Jiawang,11,0,30,19
1746579678762,MATH 170A,A03,890249,Nie; Jiawang,23,0,30,7
1746579679788,MATH 170B,A01,957891,Nag; Panchali,13,0,35,22
1746579681881,MATH 181A,A01,908025,Staff,0,3,35,35
1746579681881,MATH 181A,A02,960115,Staff,26,0,35,9
1746579682907,MATH 181B,A01,959874,Staff,25,0,30,5
1746579683932,MATH 193B,A01,890265,Staff,0,4,35,35
1746579684962,MGT 4,A01,890311,Anderson; John Charles,42,0,88,46
1746579685990,MGT 5,A00,907740,Staff,13,0,98,85
1746579687020,MGT 12,A00,890312,Lindenberger; Wade Douglas,67,0,98,31
1746579688045,MGT 16,A00,957883,Staff,78,0,98,20
1746579690096,MGT 45,A00,890314,Pecore; Joseph P.,45,0,98,53
1746579691123,MGT 71,A00,890315,Staff,0,12,98,98
1746579692147,MGT 100,A00,890316,Yavorsky; Daniel Ryan,44,0,98,54
1746579693174,MGT 103,A00,890317,Ehrich; Kristine R,73,0,98,25
1746579694204,MGT 105,A00,890356,Bates; Kenneth Walter,0,8,98,98
1746579695231,MGT 112,A00,890360,Ehrich; Kristine R,55,0,98,43
1746579696257,MGT 127R,A00,907732,Zhu; Kevin Xiaoguo,23,0,98,75
1746579697280,MGT 131B,A00,890361,Anderson; John Charles,59,0,98,39
1746579698308,MGT 137,A00,890362,Lindenberger; Wade Douglas,65,0,98,33
1746579699334,MGT 160,A00,890369,Johnson; Erik Barry,9,0,98,89
1746579701388,MGT 164,A00,890372,Zimmermann; Carsten,0,40,98,98
1746579702423,MGT 180,A00,890374,Bliss; Barbara Ann,12,0,98,86
1746579703453,MMW 15,A01,886414,Chang; Edmond Yi-Teh,0,12,28,28
1746579703453,MMW 15,A02,886415,Chang; Edmond Yi-Teh,0,8,28,28
1746579703453,MMW 15,A03,886416,Chang; Edmond Yi-Teh,0,9,28,28
1746579703453,MMW 15,A04,886417,Chang; Edmond Yi-Teh,0,8,28,28
1746579703453,MMW 15,B01,886419,Chang; Edmond Yi-Teh,0,7,28,28
1746579703453,MMW 15,B02,886420,Chang; Edmond Yi-Teh,0,8,28,28
1746579703453,MMW 15,B03,886421,Chang; Edmond Yi-Teh,0,7,28,28
1746579703453,MMW 15,B04,886422,Chang; Edmond Yi-Teh,0,8,28,28
1746579703453,MMW 15,C01,886424,Staff,0,9,28,28
1746579703453,MMW 15,C02,886425,Staff,0,8,28,28
1746579703453,MMW 15,C03,886426,Staff,0,8,28,28
1746579703453,MMW 15,C04,886427,Staff,0,8,28,28
1746579703453,MMW 15,C05,958038,Staff,0,8,28,28
1746579703453,MMW 15,C06,958039,Staff,1,8,28,27
1746579704480,MMW 15GS,A00,906910,Patterson; Patrick H.,4,0,28,24
1746579705505,MMW 122R,A01,886429,Rahimi; Babak,0,13,28,28
1746579705505,MMW 122R,A02,886430,Rahimi; Babak,0,12,28,28
1746579705505,MMW 122R,A03,958040,Rahimi; Babak,0,11,28,28
1746579706531,MUS 1A,A01,890937,Staff,2,0,25,23
1746579706531,MUS 1A,A02,891035,Staff,6,0,25,19
1746579706531,MUS 1A,C01,958912,Staff,24,0,25,1
1746579706531,MUS 1A,C02,958913,Staff,25,0,25,0
1746579708581,MUS 2AK,A00,957092,Ohnishi; Takae,15,0,15,0
1746579709605,MUS 4,A01,891044,Staff,1,0,25,24
1746579709605,MUS 4,A02,891045,Staff,23,0,25,2
1746579709605,MUS 4,B01,891048,Staff,17,0,25,8
1746579709605,MUS 4,B02,891050,Staff,25,0,25,0
1746579710635,MUS 5,A01,957506,Dubnov; Shlomo,0,0,25,25
1746579710635,MUS 5,A02,957622,Dubnov; Shlomo,13,0,25,12
1746579710635,MUS 5,A03,957623,Dubnov; Shlomo,20,0,25,5
1746579711681,MUS 6,A01,891053,Freitas Caetano; Marcelo,24,0,25,1
1746579711681,MUS 6,A02,891054,Freitas Caetano; Marcelo,23,0,25,2
1746579712707,MUS 7,A01,891081,Staff,1,0,25,24
1746579712707,MUS 7,A02,891082,Staff,3,0,25,22
1746579713734,MUS 8GS,A00,891118,Borgo; David Garcia,1,0,25,24
1746579714762,MUS 11,A01,891140,Staff,9,0,25,16
1746579714762,MUS 11,A02,891141,Staff,21,0,25,4
1746579715788,MUS 13,A01,891143,Staff,8,0,25,17
1746579715788,MUS 13,A02,891144,Staff,24,0,25,1
1746579716813,MUS 15,A01,891146,Staff,9,0,25,16
1746579716813,MUS 15,A02,891148,Staff,21,0,25,4
1746579716813,MUS 15,B01,891150,Staff,18,0,25,7
1746579716813,MUS 15,B02,891151,Staff,25,0,25,0
1746579717837,MUS 20,A01,891153,Staff,5,0,20,15
1746579717837,MUS 20,A02,891155,Staff,14,0,20,6
1746579718865,MUS 80,A00,891156,Staff,19,0,25,6
1746579718865,MUS 80,B00,891157,Staff,23,0,25,2
1746579719891,MUS 130,A00,891158,Ohnishi; Takae,35,0,35,0
1746579720918,MUS 150GS,A01,891160,Borgo; David Garcia,1,0,25,24
1746579721946,MUS 170,A01,891162,Freitas Caetano; Marcelo,20,0,25,5
1746579721946,MUS 170,A02,891164,Freitas Caetano; Marcelo,21,0,25,4
1746579722971,NANO 11,A00,886220,Vazquez Mena; Oscar,13,0,15,2
1746579723996,NANO 15,A01,886222,Drews; Aaron,4,0,7,3
1746579725021,NANO 104,A00,886224,Sirbuly; Donald,17,0,25,8
1746579726046,PH 40,A00,886528,Staff,24,0,40,16
1746579727071,PH 45,A01,886799,Staff,35,0,40,5
1746579728096,PH 110,A00,886802,Staff,0,7,40,40
1746579729123,PH 172,A00,906716,Staff,19,0,35,16
1746579730148,PH 191,A00,886803,Staff,6,0,40,34
1746579731177,PHIL 1,A00,889500,Staff,20,0,30,10
1746579732202,PHIL 10,A01,889549,Grush; Rick Scott,16,0,22,6
1746579732202,PHIL 10,A02,889551,Grush; Rick Scott,22,0,22,0
1746579733228,PHIL 28,A01,889559,Lamey; Andy M.,0,2,31,31
1746579733228,PHIL 28,A02,889561,Lamey; Andy M.,0,1,30,30
1746579733228,PHIL 28,A03,889572,Lamey; Andy M.,0,1,30,30
1746579734257,PHIL 35,A00,907839,Staff,13,0,15,2
1746579735283,PHIL 60,A00,889574,Staff,73,0,90,17
1746579736310,PHIL 101,A00,958004,Staff,12,0,15,3
1746579738367,PHIL 136,A00,889582,Fulkerson; Matthew Todd,26,0,45,19
1746579739398,PHIL 163,A01,889601,Staff,21,0,30,9
1746579739398,PHIL 163,B01,889606,Brandt; Reuven A,0,3,0,0
1746579740421,PHIL 164,A00,889610,Staff,16,0,30,14
1746579741447,PHIL 165,A00,889613,Staff,22,0,30,8
1746579742475,PHYS 1A,A00,886431,Staff,28,0,70,42
1746579743503,PHYS 1AL,001,886432,Tsai; Philbert S,1,2,30,29
1746579743503,PHYS 1AL,002,886436,Tsai; Philbert S,11,0,30,19
1746579744529,PHYS 1B,A00,886439,Staff,184,0,240,56
1746579745556,PHYS 1BL,001,886441,Tsai; Philbert S,0,4,30,30
1746579745556,PHYS 1BL,002,886444,Tsai; Philbert S,2,0,30,28
1746579746584,PHYS 1C,A00,896092,Arnold; Kam S,78,0,146,68
1746579747611,PHYS 1CL,001,886448,Tsai; Philbert S,0,0,30,30
1746579747611,PHYS 1CL,002,886449,Tsai; Philbert S,1,0,30,29
1746579747611,PHYS 1CL,003,886450,Tsai; Philbert S,16,0,30,14
1746579747611,PHYS 1CL,004,886451,Tsai; Philbert S,15,0,30,15
1746579748636,PHYS 2B,A01,886457,Staff,68,0,115,47
1746579749664,PHYS 2C,A01,886460,Shotwell; Brian,0,9,65,65
1746579750689,PHYS 2CL,A01,886467,Staff,0,4,28,28
1746579750689,PHYS 2CL,A02,886468,Staff,0,3,28,28
1746579751714,PHYS 2D,A01,886470,Staff,10,0,50,40
1746579752739,PHYS 4B,A01,886475,Grinstein; Benjamin,22,0,40,18
1746579753765,POLI 5,A00,891173,Desposato; Scott,7,0,25,18
1746579754996,POLI 5D,A01,891175,Staff,5,0,5,0
1746579754996,POLI 5D,B01,891178,Staff,5,0,5,0
1746579756026,POLI 11,A00,891179,Ferree; Karen E,2,0,35,33
1746579757050,POLI 12,A00,891180,Staff,16,0,30,14
1746579758080,POLI 27,A01,891182,Staff,12,0,75,63
1746579759110,POLI 30,A00,891183,Staff,8,0,50,42
1746579760136,POLI 100B,A00,891244,Staff,5,1,35,30
1746579761161,POLI 100I,A00,891247,Staff,7,0,30,23
1746579762192,POLI 104J,A00,891248,Nichter; Maysa,14,0,30,16
1746579763222,POLI 104U,A00,891250,Nichter; Maysa,1,0,30,29
1746579765276,POLI 110B,A00,891255,Wiens; David,19,0,25,6
1746579766305,POLI 112A,A00,891256,Wiens; David,6,0,25,19
1746579767330,POLI 114BR,A00,891261,Staff,19,0,30,11
1746579768359,POLI 117R,A00,891262,Forman; Fonna,0,6,50,50
1746579769385,POLI 118,A00,891264,Ingham; Sean,17,0,25,8
1746579770412,POLI 124A,A00,891265,Staff,18,0,20,2
1746579771438,POLI 125D,A00,891266,Nichter; Simeon C,2,0,25,23
1746579772467,POLI 126,A00,891268,Nichter; Simeon C,7,0,25,18
1746579773495,POLI 126AA,A00,891272,Staff,15,0,25,10
1746579774521,POLI 130AA,A00,891273,Staff,15,0,20,5
1746579775545,POLI 134AA,A00,891274,Staff,4,0,20,16
1746579777599,POLI 138,A00,891278,Staff,21,0,25,4
1746579778626,POLI 142K,A00,891280,Staff,10,0,25,15
1746579779651,POLI 142M,A00,891281,Gartzke; Erik,16,0,30,14
1746579780677,POLI 142P,A00,891284,Staff,20,0,30,10
1746579781706,POLI 143,A00,891285,Gartzke; Erik,12,0,30,18
1746579782731,POLI 153,A00,891286,Staff,19,0,20,1
1746579784788,POLI 175,A00,891290,Staff,15,0,20,5
1746579785815,PSYC 1,A00,890674,Steiner; Eric Tomas,0,11,45,45
1746579786843,PSYC 2,A00,890676,Albright; Thomas D,21,0,35,14
1746579787906,PSYC 3,A00,890679,Staff,17,0,20,3
1746579788932,PSYC 6,A00,959858,Staff,19,0,20,1
1746579789961,PSYC 60,A01,890684,Rickard; Timothy C.,0,5,45,45
1746579790986,PSYC 70,A01,890689,Geller; Emma Harlan,7,0,30,23
1746579792011,PSYC 71,A01,959860,Staff,21,0,25,4
1746579793036,PSYC 100,A00,890690,Lacefield; Katharine I,0,50,180,180
1746579794061,PSYC 102,A00,890695,Staff,18,0,40,22
1746579795086,PSYC 105,A00,890699,Geller; Emma Harlan,70,0,100,30
1746579796115,PSYC 106,A00,890701,Gorman; Michael R.,5,0,30,25
1746579797144,PSYC 108,A00,890704,Adrian; Julia Anna,0,28,50,50
1746579798168,PSYC 118,A01,890712,Staff,11,0,30,19
1746579799193,PSYC 124,A00,890716,Chapman; Eddie Nathaniel,25,0,60,35
1746579800219,PSYC 131,A00,890717,Anagnostaras; Stephan,0,7,80,80
1746579801244,PSYC 137,A00,890719,Winkielman; Piotr,0,11,30,30
1746579802273,PSYC 144,A00,890721,Adrian; Julia Anna,0,9,45,45
1746579803297,PSYC 162,A00,890805,Staff,0,0,75,75
1746579804325,PSYC 169,A00,890810,Staff,0,14,30,30
1746579805349,PSYC 172,A00,890814,Gorman; Michael R.,9,0,30,21
1746579806378,PSYC 181,A00,890818,Anagnostaras; Stephan,7,0,200,193
1746579807406,PSYC 184,A00,959861,Staff,164,0,175,11
1746579808435,PSYC 189,A00,890823,Staff,0,2,30,30
1746579809463,PSYC 191,A00,890884,Rickard; Timothy C.,0,12,35,35
1746579810493,PSYC 193,A00,890913,Staff,19,0,30,11
1746579810493,PSYC 193,B00,890914,Chapman; Eddie Nathaniel,24,0,30,6
1746579811517,PSYC 193L,A01,890918,Lowe; Angela Beth,20,0,30,10
1746579811517,PSYC 193L,B01,890921,Hurwitz; Ethan Scott,20,0,30,10
1746579811517,PSYC 193L,C01,890928,Staff,30,0,30,0
1746579812546,RELI 149,A00,886806,Rahimi; Babak,23,0,40,17
1746579813575,SE 9,A01,886814,Staff,7,0,20,13
1746579814603,SE 101B,A01,886816,Chadha; Mayank,4,0,35,31
1746579815633,SE 110B,A00,886818,Zhu; Qiang,4,0,75,71
1746579816661,SE 125,A01,886830,Staff,10,0,30,20
1746579817686,SE 130B,A01,886835,Staff,14,0,40,26
1746579818715,SE 131A,A01,886838,Krysl; Petr,34,0,55,21
1746579819744,SE 154,A00,886840,Staff,29,0,50,21
1746579820769,SE 164GS,A01,886849,Staff,6,0,20,14
1746579821797,SE 167GS,A01,886853,Staff,6,0,20,14
1746579822824,SIO 25,A01,890107,Staff,19,0,30,11
1746579823851,SIO 45,A00,890109,Cook; Geoffrey W,116,0,200,84
1746579824875,SIO 109R,A00,890110,Forman; Fonna,0,16,20,20
1746579825899,SIO 187,A01,890114,Kacev; David,15,0,40,25
1746579826926,SOCI 1,A01,890431,Thorpe; Charles Robert,14,0,30,16
1746579826926,SOCI 1,A02,890518,Thorpe; Charles Robert,30,0,30,0
1746579827953,SOCI 2,A01,957978,Staff,25,0,25,0
1746579827953,SOCI 2,A02,957979,Staff,23,0,25,2
1746579828979,SOCI 20,A01,890523,Calderon-Zaks; Michael Aar,21,0,30,9
1746579828979,SOCI 20,A02,890526,Calderon-Zaks; Michael Aar,29,0,30,1
1746579830005,SOCI 30,A01,890533,Pardo Guerra; Juan Pablo,37,0,40,3
1746579831030,SOCI 40,A01,890535,Staff,27,0,45,18
1746579832056,SOCI 104Q,A00,890559,Staff,18,0,30,12
1746579833081,SOCI 106,A00,890560,Arnal; Maud Marie Leonie,20,0,30,10
1746579834107,SOCI 110,A00,890567,Holkenbrink-Monk; Charlene,19,0,30,11
1746579835133,SOCI 112,A00,890568,Victoria Torres; Pablo,2,0,55,53
1746579836164,SOCI 115,A00,890597,Arnal; Maud Marie Leonie,28,0,45,17
1746579838218,SOCI 121,A00,890604,Pardo Guerra; Juan Pablo,38,0,45,7
1746579839243,SOCI 126,A01,890608,Staff,8,0,10,2
1746579840269,SOCI 127,A00,890609,Staff,18,0,30,12
1746579841293,SOCI 131,A00,890610,Thorpe; Charles Robert,37,0,45,8
1746579842319,SOCI 135,A00,890615,Payne; Christine Anna,13,0,45,32
1746579843345,SOCI 139,A00,890620,Staff,38,0,45,7
1746579844376,SOCI 148E,A00,890622,Calderon-Zaks; Michael Aar,36,0,45,9
1746579845401,SOCI 150,A00,890623,Kohler; Kristopher M.,31,0,45,14
1746579846426,SOCI 157,A00,890625,Jules-Rosette; Bennetta W.,18,0,20,2
1746579847457,SOCI 160,A00,890627,Payne; Christine Anna,21,0,45,24
1746579848486,SYN 1,A00,886855,Fish; Gwendolyn Anne,0,1,0,0
1746579848486,SYN 1,B00,906086,Fish; Gwendolyn Anne,0,2,0,2
1746579849514,SYN 2R,A00,886860,Staff,0,17,15,15
1746579849514,SYN 2R,B00,906106,Atkinson; Arthur Laird,0,16,15,15
1746579850547,SYN 100,A01,886866,Browne; Emily,0,28,20,20
1746579850547,SYN 100,B01,906128,Rock; Martin,0,4,20,20
1746579850547,SYN 100,C01,906140,Deavenport; James Cary,0,3,20,20
1746579850547,SYN 100,D01,907816,Deavenport; James Cary,0,5,20,20
1746579851573,TDAC 1,A00,890286,Walsh; Kim C.,7,0,20,13
1746579852600,TDAC 101,A00,890296,Basso; Beatrice,15,0,20,5
1746579853629,TDDE 131,A00,890297,Staff,47,0,50,3
1746579854655,TDDM 1,A00,890287,Weinberg; Sadie,25,0,30,5
1746579855679,TDGE 11,A00,890288,Fulton; Julia,138,0,200,62
1746579855679,TDGE 11,B00,890289,Castro; Robert Jess,184,0,200,16
1746579856704,TDGE 25,B00,957359,Walsh; Kim C.,5,0,20,15
1746579857733,TDGE 40,A01,890292,Power; Jade Yukana,27,0,30,3
1746579858759,TDGE 124,A00,890298,Havis; Allan,0,1,50,50
1746579859783,TDGE 131R,A00,890299,Burelle; Julie Sara Veronique,15,0,42,27
1746579860811,TDHT 101,A00,890300,Staff,10,0,20,10
1746579861835,TDHT 109,A01,890302,Anderson; Mysia Anyse,31,0,40,9
1746579862860,TDMV 1,A00,890293,Arcidiacono; Kristin,18,0,30,12
1746579863886,TDMV 2,A00,890294,Weinberg; Sadie,23,0,30,7
1746579864917,TDMV 3,A00,957878,Arcidiacono; Kristin,28,0,30,2
1746579866967,TDMV 138,A00,890304,Jun; Grace Shin Hae,25,0,40,15
1746579867997,TDMV 140,A00,890305,Corrales; Joseph Bernales,25,0,30,5
1746579869021,TDMV 142,A00,890307,Caligagan; Tony,32,0,40,8
1746579870047,TDMV 144,A00,890308,Camaya; Michelle Ann,25,0,30,5
1746579871076,TDPW 1,A00,890295,Stein; Deborah Isobel,3,0,20,17
1746579872105,USP 2,A01,890272,Lerner; Amy M,7,0,20,13
1746579873133,USP 3,A01,890274,Staff,12,0,30,18
1746579874159,USP 15,A01,890276,Sun; Feiyang,16,0,30,14
1746579875184,USP 25,A00,890277,Shenkman; Michael Thomas,18,0,25,7
1746579876213,USP 138,A00,890278,Staff,14,0,25,11
1746579877237,USP 143,A00,890279,Staff,22,0,70,48
1746579878262,USP 144,A00,890280,Chowdhury; Muhammed Zohir,16,0,30,14
1746579879288,USP 150,A00,890281,Boomhower; Matthew Charles,4,0,30,26
1746579880318,USP 151,A00,890282,Staff,16,0,20,4
1746579881343,USP 162,A00,890283,Andrews; Abigail Leslie,16,0,20,4
1746579882368,USP 168,A00,920477,Kwak; Nancy,0,0,5,5
1746579883396,USP 181,A00,890284,Staff,3,0,20,17
1746579884421,USP 191A,A00,890285,Staff,12,0,20,8
1746579885450,VIS 101,A00,886512,Staff,25,0,75,50
1746579886478,VIS 103,A00,886513,Cruz; Edwin Teddy,61,0,75,14
1746579887506,VIS 108,A00,886514,Staff,3,0,15,12
1746579888532,VIS 127P,A00,886515,Shen; Kuiyi,80,0,146,66
1746579889562,VIS 149,A00,886516,Yoldas; Pinar,0,0,15,15
1746579890587,VIS 164,A00,886526,Erdmann; Dean,19,0,22,3
1746579891611,VIS 194S,A00,886527,Staff,61,0,75,14
1746579892638,WCWP 10A,C00,886484,Martiniuk; Jill,12,0,15,3
1746579893664,WCWP 10B,A00,886490,Uriarte; Emma,0,0,15,15
1746579893664,WCWP 10B,B00,886491,Dhir; Simrita,8,0,15,7
1746579893664,WCWP 10B,C00,886492,Ornelas; Tricia,0,0,15,15
1746579894689,WCWP 100,A00,886494,Young; Mark T,0,6,15,15
1746579896811,AAS 10,A01,886199,Childs; Dennis R.,0,3,0,0
1746579897837,ANAR 104,A01,886940,Shtienberg; Gilad,27,0,30,3
1746579898865,ANAR 120,A00,886953,Staff,12,0,20,8
1746579899903,ANBI 148,A01,886955,Wilder; Linnea Lorene,30,0,40,10
1746579901960,ANSC 122,A00,886957,Staff,25,0,30,5
1746579902990,ANSC 150,A00,886958,Sloane; Julia Kathryn,2,0,15,13
1746579904016,ANSC 156,A00,886959,Jenkins; Janis A.,0,1,15,15
1746579905043,ANSC 180,A00,886960,Staff,11,0,17,6
1746579906068,ANSC 188,A00,886961,Jassal; Aftab,9,0,25,16
1746579907098,ANSC 190,A00,886962,Jassal; Aftab,14,0,25,11
1746579908124,ANSC 191,A00,886963,Staff,18,0,20,2
1746579909152,ANTH 3,A01,891689,Staff,17,0,20,3
1746579910179,ANTH 5,A00,886933,Semendeferi; Ekaterini,16,0,20,4
1746579911204,ANTH 10,A00,886934,Staff,0,12,30,30
1746579912231,ANTH 21,A01,886936,Staff,41,0,60,19
1746579913256,ANTH 23,A01,886938,Staff,92,0,100,8
1746579914284,ANTH 105,A00,886964,Stewart; Alexander B,84,0,100,16
1746579915310,ANTH 108,A00,886965,Pedersen; David,9,0,20,11
1746579916548,AWP 10,001,886147,Staff,0,0,0,0
1746579916548,AWP 10,002,886148,Staff,0,0,0,0
1746579916548,AWP 10,003,886149,Staff,0,0,0,0
1746579916548,AWP 10,004,886150,Staff,0,0,0,0
1746579916548,AWP 10,005,886151,Staff,0,0,0,0
1746579916548,AWP 10,006,886152,Staff,0,0,0,0
1746579916548,AWP 10,007,886153,Staff,0,0,0,0
1746579916548,AWP 10,008,886154,Staff,0,0,0,0
1746579916548,AWP 10,009,886155,Staff,0,0,0,0
1746579916548,AWP 10,010,886156,Staff,0,0,0,0
1746579916548,AWP 10,011,886158,Staff,0,0,0,0
1746579916548,AWP 10,012,886160,Staff,0,0,0,0
1746579916548,AWP 10,013,886161,Staff,0,0,0,0
1746579916548,AWP 10,014,886162,Staff,0,0,0,0
1746579916548,AWP 10,015,886163,Staff,0,0,0,0
1746579916548,AWP 10,016,886164,Staff,0,0,0,0
1746579916548,AWP 10,017,886165,Staff,0,0,0,0
1746579916548,AWP 10,018,886166,Staff,0,0,0,0
1746579916548,AWP 10,019,886168,Staff,0,0,0,0
1746579916548,AWP 10,020,886170,Staff,0,0,0,0
1746579916548,AWP 10,021,886172,Staff,0,0,0,0
1746579917580,AWP 10R,001,886173,Staff,0,1,0,0
1746579917580,AWP 10R,002,886174,Staff,0,1,0,0
1746579917580,AWP 10R,003,886175,Staff,0,0,0,0
1746579917580,AWP 10R,004,886176,Staff,0,0,0,0
1746579917580,AWP 10R,005,886177,Staff,0,0,0,0
1746579917580,AWP 10R,006,886178,Staff,0,0,0,0
1746579917580,AWP 10R,007,886179,Staff,0,0,0,0
1746579917580,AWP 10R,008,886181,Staff,0,0,0,0
1746579917580,AWP 10R,009,886182,Staff,0,0,0,0
1746579917580,AWP 10R,010,886183,Staff,0,0,0,0
1746579917580,AWP 10R,011,886184,Staff,0,0,0,0
1746579917580,AWP 10R,012,886185,Staff,0,0,0,0
1746579917580,AWP 10R,013,886186,Staff,0,0,0,0
1746579917580,AWP 10R,014,886187,Staff,0,0,0,0
1746579917580,AWP 10R,015,886188,Staff,0,0,0,0
1746579917580,AWP 10R,016,886189,Staff,0,0,0,0
1746579917580,AWP 10R,017,960532,Staff,0,0,0,0
1746579917580,AWP 10R,018,960533,Staff,0,0,0,0
1746579917580,AWP 10R,019,960534,Staff,0,0,0,0
1746579917580,AWP 10R,020,960538,Staff,0,0,0,0
1746579917580,AWP 10R,021,960540,Staff,0,0,0,0
1746579917580,AWP 10R,022,960541,Staff,0,0,0,0
1746579917580,AWP 10R,023,960542,Staff,0,0,0,0
1746579917580,AWP 10R,024,960544,Staff,0,0,0,0
1746579917580,AWP 10R,025,960545,Staff,0,0,0,0
1746579917580,AWP 10R,026,960548,Staff,0,0,0,0
1746579918606,AWP 102R,A00,886190,Staff,0,0,0,0
1746579918606,AWP 102R,B00,886191,Staff,0,0,0,0
1746579919636,BENG 100,A01,886193,Staff,17,0,30,13
1746579920665,BENG 122A,A01,886195,Hasty; Jeff M,13,0,30,17
1746579921690,BENG 166A,A00,886196,Sah; Robert Lie-Yuan,0,3,30,30
1746579922716,BENG 190,A00,958050,Khojah; Reem I,19,0,25,6
1746579923748,BIBC 102,A01,894320,Staff,0,0,46,46
1746579923748,BIBC 102,A02,894321,Staff,0,0,46,46
1746579923748,BIBC 102,A03,894344,Staff,6,0,46,40
1746579923748,BIBC 102,A04,894345,Staff,27,0,47,20
1746579924774,BICD 100R,A01,894365,Smith; Laurie,0,3,58,58
1746579924774,BICD 100R,A02,894366,Smith; Laurie,0,5,58,58
1746579924774,BICD 100R,A03,894367,Smith; Laurie,0,0,59,59
1746579924774,BICD 100R,A04,959869,Smith; Laurie,40,0,59,19
1746579925806,BICD 136,A01,894383,Gustafson-Brown; Cindy,14,0,50,36
1746579926832,BIEB 102,A01,894494,Butler; Shannon Rhey,51,0,130,79
1746579928887,BIEB 150,A01,894617,Wills; Christopher,3,0,20,17
1746579928887,BIEB 150,A02,894631,Wills; Christopher,3,0,20,17
1746579928887,BIEB 150,A03,894937,Wills; Christopher,3,0,20,17
1746579928887,BIEB 150,A04,894946,Wills; Christopher,5,0,20,15
1746579929914,BIEB 194,A00,906141,Kurle; Carolyn M.,6,0,20,14
1746579931142,BILD 1,A01,894154,Staff,3,0,19,16
1746579931142,BILD 1,A02,894155,Staff,14,0,19,5
1746579931142,BILD 1,A03,894160,Staff,13,0,19,6
1746579931142,BILD 1,A04,894161,Staff,15,0,18,3
1746579932168,BILD 2,A01,894168,Staff,0,0,50,50
1746579932168,BILD 2,A02,894169,Staff,0,0,50,50
1746579932168,BILD 2,A03,894179,Staff,0,0,50,50
1746579932168,BILD 2,A04,894203,Staff,24,0,50,26
1746579933197,BILD 3,A01,894213,Staff,23,0,31,8
1746579933197,BILD 3,A02,894214,Staff,26,0,31,5
1746579933197,BILD 3,A03,894235,Staff,28,0,31,3
1746579933197,BILD 3,A04,894236,Staff,28,0,32,4
1746579934221,BILD 4,A01,894253,Reuther; Keefe,5,0,24,19
1746579934221,BILD 4,A02,894258,Reuther; Keefe,16,0,24,8
1746579935252,BILD 5,A01,894276,Reuther; Keefe,35,0,50,15
1746579935252,BILD 5,A02,894277,Reuther; Keefe,45,0,50,5
1746579935252,BILD 5,A03,894290,Reuther; Keefe,44,0,50,6
1746579935252,BILD 5,A04,894291,Reuther; Keefe,48,0,50,2
1746579936280,BILD 24,A01,894297,Pirino; Giorgia,40,0,60,20
1746579937306,BIMM 100,B01,958915,Staff,71,0,100,29
1746579938337,BIMM 101,A01,895017,McDonnell; Lisa Marie,0,5,24,24
1746579938337,BIMM 101,A02,895018,McDonnell; Lisa Marie,0,5,24,24
1746579938337,BIMM 101,B01,895020,McDonnell; Lisa Marie,0,6,24,24
1746579938337,BIMM 101,B02,895021,McDonnell; Lisa Marie,0,4,24,24
1746579939365,BIMM 110,A01,895023,Staff,1,0,25,24
1746579939365,BIMM 110,A02,895024,Staff,9,0,25,16
1746579939365,BIMM 110,A03,895025,Staff,18,0,25,7
1746579939365,BIMM 110,A04,895031,Staff,20,0,25,5
1746579940391,BIMM 120,A01,895114,Gustafson-Brown; Cindy,14,0,28,14
1746579940391,BIMM 120,A02,895126,Gustafson-Brown; Cindy,21,0,27,6
1746579941417,BIPN 100,A01,895130,Yang; Mingyu,0,0,38,38
1746579941417,BIPN 100,A02,895131,Yang; Mingyu,32,0,38,6
1746579941417,BIPN 100,A03,895132,Yang; Mingyu,32,0,38,6
1746579941417,BIPN 100,A04,895133,Yang; Mingyu,27,0,36,9
1746579942443,BIPN 120,A01,895135,Cooke; James Edward,0,3,13,13
1746579942443,BIPN 120,A02,895136,Cooke; James Edward,0,1,13,13
1746579942443,BIPN 120,A03,895137,Cooke; James Edward,0,3,13,13
1746579942443,BIPN 120,A04,895156,Cooke; James Edward,0,2,11,11
1746579943472,BIPN 134,A01,895235,Cooke; James Edward,0,2,25,25
1746579943472,BIPN 134,A02,895237,Cooke; James Edward,0,0,25,25
1746579943472,BIPN 134,A03,895240,Cooke; James Edward,3,0,25,22
1746579943472,BIPN 134,A04,895270,Cooke; James Edward,20,0,25,5
1746579944499,BIPN 189,A00,892103,Staff,0,14,14,14
1746579946552,BISP 194,A00,958008,Staff,0,2,0,0
1746579947579,CAT 124,A01,922009,Staff,0,5,20,20
1746579948605,CAT 125R,A00,886390,Morales; Celeste Georgianna,0,2,20,20
1746579948605,CAT 125R,B00,886391,Irwin; Matthew Joseph,0,4,20,20
1746579948605,CAT 125R,C00,886392,Smith; Lauryn Alissa,0,2,20,20
1746579948605,CAT 125R,D00,886393,Vanderschuit; Maya Alysia,0,3,20,20
1746579948605,CAT 125R,E00,886394,Marchisotto; Jennifer Anne,0,3,20,20
1746579949634,CENG 15,A01,886218,Drews; Aaron,3,0,8,5
1746579950661,CENG 113,A00,886219,Opatkiewicz; Justin Paul,15,0,25,10
1746579951687,CGS 101,A00,887044,Staff,7,0,20,13
1746579952716,CGS 105,A01,887046,Staff,14,0,25,11
1746579953745,CGS 112,A00,887047,Cuong; Marisol,12,0,15,3
1746579954771,CGS 113,A00,887048,Staff,23,0,30,7
1746579955802,CGS 120,A00,887049,Staff,10,0,17,7
1746579956827,CHEM 6A,A01,886336,Lam; Tin Yiu,38,0,50,12
1746579956827,CHEM 6A,A02,886338,Lam; Tin Yiu,37,0,50,13
1746579957852,CHEM 6B,A01,886341,Hopkins; Patrycja Anna,16,0,50,34
1746579957852,CHEM 6B,A02,886343,Hopkins; Patrycja Anna,42,0,50,8
1746579958879,CHEM 6C,A01,886346,Albizati; Kim F.,0,2,50,50
1746579958879,CHEM 6C,A02,886348,Albizati; Kim F.,23,0,50,27
1746579959909,CHEM 40A,A01,886352,Klosterman; Jeremy K,65,0,100,35
1746579960940,CHEM 40B,A01,886356,Klosterman; Jeremy K,0,24,100,100
1746579961966,CHEM 41B,A01,886360,Theodorakis; Emmanuel,25,0,50,25
1746579961966,CHEM 41B,A02,886362,Theodorakis; Emmanuel,47,0,50,3
1746579962996,CHIN 165A,A00,886382,Xu; Li,18,0,20,2
1746579964024,CLAS 120,A00,886387,Myerston Santana; Jacobo,33,0,40,7
1746579965055,COGS 9,A01,886967,Shannon; Kyle Michael,42,0,60,18
1746579966079,COGS 11,A01,886969,Staff,9,0,30,21
1746579967105,COGS 14A,A01,886971,Staff,6,0,60,54
1746579968134,COGS 14B,A01,886973,Hoffman; Drew Ellen,4,0,60,56
1746579969165,COGS 18,A01,886975,Morgan; Eric,35,0,60,25
1746579970190,COGS 20,A01,886977,Staff,4,0,8,4
1746579970190,COGS 20,A02,886978,Staff,5,0,7,2
1746579971215,COGS 100,A01,907783,Staff,1,2,30,29
1746579972244,COGS 101B,A01,886980,Staff,0,4,48,48
1746579973269,COGS 101C,A01,886982,Delgado; Tania,0,5,44,44
1746579974295,COGS 102A,A01,886984,Johnson; Christine M.,4,0,30,26
1746579975326,COGS 118B,A01,886986,Staff,1,4,88,87
1746579976350,COGS 150,A01,886988,Bergen; Benjamin,22,0,50,28
1746579977376,COGS 153,A00,886989,Delgado; Tania,0,2,41,41
1746579978401,COGS 186,A01,886991,Staff,0,0,32,32
1746579979427,COGS 187A,A01,886993,Boyle; Mary E. T.,7,0,30,23
1746579980457,COGS 189,A00,886994,Staff,0,1,30,30
1746579981482,COMM 10,A01,886996,Staff,0,0,20,21
1746579981482,COMM 10,A02,886997,Staff,10,0,20,10
1746579981482,COMM 10,A03,959845,Staff,19,0,20,1
1746579982509,COMM 20,A01,886999,Leuning; Grant Maurstad,24,0,40,16
1746579984562,COMM 100A,A01,887002,Staff,0,0,20,25
1746579984562,COMM 100A,A02,887003,Staff,6,0,20,14
1746579985591,COMM 100B,A01,887005,Staff,0,8,20,24
1746579986623,COMM 106D,A00,887006,Staff,13,0,40,27
1746579987649,COMM 110G,A00,887007,Whitworth-Smith; Andrew C,12,0,40,28
1746579988675,COMM 111B,A00,887008,Staff,31,0,40,9
1746579989701,COMM 113T,A00,887009,Abuelhiga; Soraya Jill,28,0,40,12
1746579989701,COMM 113T,B00,906733,Staff,40,0,40,0
1746579990727,COMM 145,A00,887010,Staff,12,0,40,28
1746579991755,COMM 146,A00,887054,Staff,31,0,40,9
1746579992785,COMM 190,A00,887012,Staff,8,0,23,15
1746579993810,CSE 8A,A50,887015,Cao; Yingjun,57,0,85,28
1746579994840,CSE 11,A01,887017,Cao; Yingjun,12,0,70,58
1746579995871,CSE 20,A01,887019,Staff,30,0,50,20
1746579996958,CSE 21,A01,887021,Staff,78,0,100,22
1746579996958,CSE 21,B01,892583,Braun; Oliver,45,0,50,5
1746579997987,CSE 30,A01,887025,Eldon; John,143,0,200,57
1746579999016,CSE 100,A01,887027,Staff,26,0,50,24
1746579999016,CSE 100,A02,887028,Staff,42,0,50,8
1746580000043,CSE 101,A01,887030,Braun; Oliver,74,0,100,26
1746580000043,CSE 101,B01,887032,Jones; Miles E,0,3,50,50
1746580000043,CSE 101,B02,887033,Jones; Miles E,0,2,50,50
1746580001075,CSE 105,A01,908084,Jones; Miles E,32,0,50,18
1746580001075,CSE 105,A02,908087,Jones; Miles E,31,0,50,19
1746580002105,CSE 135,A01,887035,Powell; Thomas Allan,0,5,50,50
1746580003136,CSE 142,A01,887037,Staff,8,0,60,52
1746580004161,CSE 142L,A01,887039,Staff,34,0,60,26
1746580005186,CSE 151A,A01,887041,Solares; Edwin A,47,0,100,53
1746580006213,CSE 175,A01,887043,Kumar; Rakesh,30,0,30,0
1746580007240,CSS 1,A01,886389,Staff,1,2,40,39
1746580008270,DSC 30,A01,908097,Liao; Soohyun Nam,47,0,75,28
1746580009295,DSC 40A,A01,908099,Shannon; Kyle Michael,30,0,50,20
1746580010324,DSC 40B,A01,908112,Staff,15,0,50,35
1746580011355,DSC 80,A01,908116,Staff,19,0,60,41
1746580012385,DSC 197,001,956863,Eldridge; Justin Matthew,9999,0,9999,0
1746580013414,ECE 5,A01,886400,Morris; Karcher William,1,0,6,5
1746580013414,ECE 5,A02,886401,Morris; Karcher William,3,0,6,3
1746580014443,ECE 148,A01,886403,Silberman; Jack,0,14,14,14
1746580015473,ECON 1,A01,887265,Crane; Meredith Helen,12,0,70,58
1746580015473,ECON 1,B01,887268,Staff,42,0,50,8
1746580016498,ECON 2,A01,887273,Crane; Meredith Helen,55,0,70,15
1746580017525,ECON 3,A01,887279,Rondina; Giacomo,32,0,70,38
1746580018552,ECON 4,A01,887282,Anderson; John Charles,0,2,10,10
1746580019581,ECON 5,A01,887285,Staff,34,0,45,11
1746580019581,ECON 5,B01,887292,Staff,41,0,45,4
1746580020608,ECON 100A,A01,887337,Newhouse; Herbert S,54,0,70,16
1746580020608,ECON 100A,B01,887349,Staff,45,0,50,5
1746580021632,ECON 100B,A01,887361,Du; Songzi,29,0,70,41
1746580022663,ECON 100C,A01,887445,Newhouse; Herbert S,59,0,70,11
1746580023690,ECON 105,A00,887488,Vespa; Emanuel Ignacio,23,0,35,12
1746580024720,ECON 109,A01,887506,Shishkin; Denis,28,0,35,7
1746580025745,ECON 110A,A01,887568,Alon; Titan Michael,0,3,35,35
1746580025745,ECON 110A,B01,907601,Alon; Titan Michael,20,0,35,15
1746580026769,ECON 110B,A01,887598,Levkoff; Steven B.,0,24,70,70
1746580027794,ECON 112,A00,887599,Rondina; Giacomo,19,0,35,16
1746580028820,ECON 120A,A01,887603,Dai; Yinlin,35,0,70,35
1746580029846,ECON 120C,A01,887608,Sun; Yixiao,0,1,35,35
1746580029846,ECON 120C,B01,887614,Sun; Yixiao,0,0,35,35
1746580030872,ECON 138,A00,887621,Bharadwaj; Prashant,0,21,20,20
1746580031899,ECON 144,A00,958007,Squires; Dale E,12,0,35,23
1746580032924,ECON 171,A01,907666,Staff,18,0,35,17
1746580033950,ECON 175,A00,887626,Wu; Pak Yeung,22,0,35,13
1746580034978,ECON 190,A00,887640,Vespa; Emanuel Ignacio,22,0,35,13
1746580036006,EDS 25,A01,888197,Staff,0,0,0,0
1746580036006,EDS 25,A02,888209,Staff,0,0,0,0
1746580036006,EDS 25,A03,888210,Staff,0,0,0,0
1746580036006,EDS 25,A04,888212,Staff,0,0,0,0
1746580036006,EDS 25,A05,888213,Staff,0,0,0,0
1746580036006,EDS 25,A06,888214,Staff,0,0,0,0
1746580036006,EDS 25,A07,888235,Staff,0,2,0,0
1746580036006,EDS 25,A08,888236,Staff,0,0,0,0
1746580036006,EDS 25,A09,888240,Staff,0,0,0,0
1746580036006,EDS 25,A10,888244,Staff,0,0,0,0
1746580036006,EDS 25,B01,888273,Staff,0,0,0,0
1746580036006,EDS 25,B02,888285,Staff,0,0,0,0
1746580036006,EDS 25,B03,888423,Staff,0,0,0,1
1746580036006,EDS 25,B04,888432,Staff,0,0,0,0
1746580036006,EDS 25,B05,888433,Staff,0,0,0,0
1746580036006,EDS 25,B06,888467,Staff,0,0,0,0
1746580036006,EDS 25,B07,888468,Staff,0,0,0,0
1746580036006,EDS 25,B08,888479,Staff,0,0,0,0
1746580036006,EDS 25,B09,888484,Staff,0,0,0,0
1746580036006,EDS 25,B10,888487,Staff,0,0,0,0
1746580037035,EDS 38,A01,907700,Choi; Bailey Miyeon,30,0,30,0
1746580038065,EDS 112,A01,888601,Chapman; Thandeka K,12,0,40,28
1746580039096,EDS 115,A00,888697,Mendez; Kathrina Mendoza,10,0,30,20
1746580040124,EDS 116,A01,888893,Staff,34,0,40,6
1746580042175,EDS 124AR,A00,889133,Staff,29,0,50,21
1746580042175,EDS 124AR,B00,907471,Simon; Elizabeth A,37,0,50,13
1746580043202,EDS 124BR,A00,889134,Simon; Elizabeth A,44,0,100,56
1746580044229,EDS 125,A00,889135,Staff,25,0,30,5
1746580045259,EDS 126,A01,889138,Staff,35,0,40,5
1746580046288,EDS 164R,A01,889142,Wishard Guerra; Alison G.,33,0,50,17
1746580047354,ENG 30,A01,886396,Staff,0,0,0,0
1746580047354,ENG 30,B01,886398,Staff,0,0,0,0
1746580048380,ENVR 102,A00,906150,Montejo; Carolina,23,0,25,2
1746580049408,ETHN 103A,A00,887236,Man; Simeon S,0,3,0,0
1746580050433,ETHN 113,A00,887239,Staff,16,0,30,14
1746580051459,ETHN 116,A00,887240,Staff,16,0,25,9
1746580052490,ETHN 117,A00,887241,Choi; Esther Min,28,0,30,2
1746580053521,ETHN 118,A00,887243,Staff,24,0,30,6
1746580054546,ETHN 127,A00,887248,Cuong; Marisol,11,0,15,4
1746580055572,ETHN 139,A00,887250,Staff,7,0,10,3
1746580056597,ETHN 142,A00,887252,Staff,10,0,30,20
1746580057629,ETHN 161,A00,887253,Browne; Errol Tsekani,24,0,30,6
1746580058654,ETHN 163FR,A00,887255,Burelle; Julie Sara Veronique,0,0,5,5
1746580059680,GLBH 20,A00,889149,Elwardani; Nile Regina,8,0,42,34
1746580061735,GLBH 111,A01,889152,Burgos; Jose L.,17,0,17,0
1746580062761,GLBH 150,A00,889181,Sloane; Julia Kathryn,0,5,15,15
1746580064815,HDS 60,A01,886406,Warstadt; Melissa Fawn,73,0,80,7
1746580065840,HIAF 111,A00,889324,Gyamfi; Bright,25,0,32,7
1746580066869,HIEA 131,A00,889328,Staff,15,0,32,17
1746580067894,HIEA 144,A00,889333,Henry; Todd A.,26,0,32,6
1746580068920,HIEA 154,A00,889336,Henry; Todd A.,24,0,32,8
1746580069948,HIEU 106,A00,889339,Staff,22,0,32,10
1746580072000,HIEU 114,A00,889340,Staff,4,0,32,28
1746580073029,HIEU 135GS,A00,889342,Patterson; Patrick H.,0,0,1,24
1746580074058,HIEU 137,A00,889343,Edington; Claire Ellen,10,0,25,15
1746580075083,HIEU 148,A00,889345,Staff,14,0,32,18
1746580076108,HIEU 154,A00,889346,Biess; Frank Peter,21,0,32,11
1746580077133,HILA 102,A00,889351,Staff,12,0,32,20
1746580078159,HILD 2A,A01,889221,Lewandoski; Julia Mavis,1,10,32,31
1746580079188,HILD 7B,A01,889225,Man; Simeon S,0,12,32,32
1746580080213,HILD 7C,A01,889288,Alvarez; Luis A,0,14,32,32
1746580081238,HILD 30,A01,889323,Staff,0,5,32,32
1746580083296,HISC 119,A00,889383,Golan; Tal,19,0,32,13
1746580084325,HIUS 103,A00,889384,Man; Simeon S,0,0,32,32
1746580085356,HIUS 117,A00,919797,Kwak; Nancy,19,0,32,13
1746580086382,HIUS 142A,A00,919788,Staff,22,0,32,10
1746580088430,HIUS 149,A00,889386,Gyamfi; Bright,26,0,32,6
1746580089459,HIUS 155,A00,889387,Alvarez; Luis A,15,0,32,17
1746580090486,HUM 3,A01,886499,Caldwell; Michael Alan,19,0,50,31
1746580091512,HUM 3GS,A00,886500,Rodriguez; Bretton Sigfred,0,0,0,28
1746580092539,HUM 3R,A01,886502,Markman; Kristina,0,36,50,50
1746580093570,HUM 4,A01,886504,Crum; Matthew Stephen,23,0,50,27
1746580093570,HUM 4,B01,886506,West; Geoffrey Scott,17,0,50,33
1746580094593,HUM 4GS,A00,886507,Staff,0,0,0,19
1746580095619,HUM 5,A01,886509,Staff,32,0,50,18
1746580096648,HUM 5R,A01,886511,Zavodny; Tatiana Sophia,0,39,50,50
1746580097673,JAPN 180,A00,886407,Staff,16,0,40,24
1746580098704,LATI 50,A01,886409,Martin-Cabrera; Luis,3,0,22,19
1746580098704,LATI 50,A02,886410,Martin-Cabrera; Luis,19,0,22,3
1746580098704,LATI 50,A03,886411,Martin-Cabrera; Luis,21,0,22,1
1746580098704,LATI 50,A04,886412,Martin-Cabrera; Luis,8,0,22,14
1746580099729,LAWS 101,A00,907664,Staff,28,0,60,32
1746580100809,LIAB 1A,A00,889388,Saab; Dima,17,0,20,3
1746580101835,LIAB 1AX,A00,889389,El Cheddadi; Youniss,18,0,20,2
1746580102864,LIFR 1C,A00,889391,Van Moer; Vinciane G,8,0,20,12
1746580103892,LIFR 1CX,A00,889392,Van Moer; Vinciane G,7,0,20,13
1746580104921,LIFR 1D,A00,889393,Van Moer; Vinciane G,7,0,20,13
1746580105946,LIFR 1DX,A00,889394,Van Moer; Vinciane G,8,0,20,12
1746580106971,LIGN 7,A00,886923,Staff,24,0,50,26
1746580107997,LIGN 17,A00,886924,Kehler; Andrew Scott,125,0,150,25
1746580109023,LTAM 110,A00,889395,Staff,15,0,30,15
1746580110051,LTAM 110GS,A00,958010,Rodriguez; Bretton Sigfred,0,0,0,28
1746580111076,LTCH 101,A00,889397,Staff,23,0,25,2
1746580112104,LTCS 130,A00,889398,Staff,23,0,25,2
1746580113129,LTEA 138,A00,889399,Staff,24,0,40,16
1746580114155,LTEN 149,A00,889400,Wesling; Megan E.,0,3,25,25
1746580115186,LTEN 169,A00,889401,Staff,20,0,25,5
1746580116211,LTEN 180,A00,889402,Staff,10,0,15,5
1746580117239,LTEN 181,A00,889403,Staff,21,0,25,4
1746580118267,LTWL 100,A00,889404,Myerston Santana; Jacobo,2,0,25,23
1746580119293,LTWL 180GS,A00,889405,Staff,0,0,20,20
1746580120318,LTWL 181,A00,889406,Staff,16,0,25,9
1746580121346,LTWL 184,A00,889475,Mukherjee; Silpa,22,0,25,3
1746580122372,LTWR 102C,A00,889486,Staff,29,0,30,1
1746580123399,LTWR 115W,A00,889491,Staff,0,2,15,15
1746580124423,MAE 8,A01,886905,Staff,0,2,0,0
1746580125450,MAE 11,A00,886906,Bandaru; Prabhakar,0,7,50,50
1746580126477,MAE 20,A00,886907,Evdokimenko; Ekaterina,43,0,70,27
1746580127503,MAE 30B,A00,886909,Ghazinejad; Maziar,26,0,45,19
1746580128529,MAE 101B,A00,886910,Saintillan; David,29,0,45,16
1746580129555,MAE 105,A00,886911,Bandaru; Prabhakar,18,0,50,32
1746580130580,MAE 107,B00,958024,Staff,8,0,50,42
1746580131609,MAE 143B,A00,886913,Bewley; Thomas R,3,0,40,37
1746580132633,MAE 148,A01,886915,Silberman; Jack,0,3,14,14
1746580133659,MAE 160,A00,886916,Evdokimenko; Ekaterina,31,0,60,29
1746580134688,MATH 3C,A01,889681,Staff,0,2,30,30
1746580134688,MATH 3C,A02,960048,Staff,24,0,30,6
1746580135716,MATH 10A,A01,889760,Staff,26,0,30,4
1746580135716,MATH 10A,A02,889783,Staff,29,0,30,1
1746580136748,MATH 10B,A01,889785,Verstraete; Jacques Allan,2,0,35,33
1746580136748,MATH 10B,A02,889795,Verstraete; Jacques Allan,4,0,35,31
1746580136748,MATH 10B,B01,889797,Verstraete; Jacques Allan,3,0,35,32
1746580136748,MATH 10B,B02,889828,Verstraete; Jacques Allan,3,0,35,32
1746580137779,MATH 10C,A01,889849,Habib; Yousaf,7,0,30,23
1746580137779,MATH 10C,A02,889852,Habib; Yousaf,14,0,30,16
1746580137779,MATH 10C,A03,889853,Habib; Yousaf,22,0,30,8
1746580137779,MATH 10C,A04,889858,Habib; Yousaf,20,0,30,10
1746580137779,MATH 10C,B01,889861,Staff,1,0,30,29
1746580137779,MATH 10C,B02,889862,Staff,24,0,30,6
1746580137779,MATH 10C,B03,889863,Staff,27,0,30,3
1746580137779,MATH 10C,B04,889967,Staff,23,0,30,7
1746580138805,MATH 18,A01,889974,Staff,7,0,30,23
1746580138805,MATH 18,A02,889977,Staff,20,0,30,10
1746580138805,MATH 18,B01,889984,Hardiman; Liam,20,0,30,10
1746580138805,MATH 18,B02,889985,Hardiman; Liam,25,0,30,5
1746580139834,MATH 20A,A01,889990,Suk; Andrew Hoon,30,0,35,5
1746580140864,MATH 20B,A01,889993,Ohm; Ko Woon,22,0,30,8
1746580140864,MATH 20B,A02,889994,Ohm; Ko Woon,30,0,30,0
1746580140864,MATH 20B,B01,889996,Ohm; Ko Woon,22,0,30,8
1746580140864,MATH 20B,B02,889997,Ohm; Ko Woon,23,0,30,7
1746580141891,MATH 20C,A01,889999,Hammock; Frances H,17,0,30,13
1746580141891,MATH 20C,A02,890003,Hammock; Frances H,23,0,30,7
1746580141891,MATH 20C,B01,890006,Hammock; Frances H,3,0,30,27
1746580141891,MATH 20C,B02,890007,Hammock; Frances H,12,0,30,18
1746580142917,MATH 20D,A01,890011,Cheng; Hsiao-Bing,1,1,30,29
1746580142917,MATH 20D,A02,890012,Cheng; Hsiao-Bing,14,0,30,16
1746580142917,MATH 20D,B01,890016,Cheng; Hsiao-Bing,13,0,30,17
1746580142917,MATH 20D,B02,890017,Cheng; Hsiao-Bing,13,0,30,17
1746580143944,MATH 20E,A01,890026,Harel; Guershon,1,0,30,29
1746580143944,MATH 20E,A02,890029,Harel; Guershon,23,0,30,7
1746580143944,MATH 20E,B01,890033,Harel; Guershon,7,0,30,23
1746580143944,MATH 20E,B02,890101,Harel; Guershon,21,0,30,9
1746580144973,MATH 102,A01,890104,Staff,18,0,30,12
1746580144973,MATH 102,A02,890105,Staff,27,0,30,3
1746580146001,MATH 103B,A01,890116,Salehi Golsefidy; Alireza,3,0,30,27
1746580146001,MATH 103B,B01,890118,Staff,0,3,34,34
1746580147031,MATH 109,A01,890121,Aliabadi Sr.; Mohsen,0,0,30,30
1746580147031,MATH 109,B01,890124,Upadrashta; Pranav Kumar,18,0,30,12
1746580148057,MATH 120A,A01,890126,Eggers; John Dietrich,13,0,30,17
1746580149083,MATH 142B,A01,890128,Ioana; Adrian,19,0,30,11
1746580149083,MATH 142B,A02,890129,Ioana; Adrian,12,0,30,18
1746580150110,MATH 154,A01,890174,Staff,0,0,30,30
1746580150110,MATH 154,A02,890182,Staff,0,0,30,30
1746580151140,MATH 168A,A01,890197,Dumitriu; Ioana,21,0,35,14
1746580152165,MATH 170A,A01,890240,Nie; Jiawang,1,0,30,29
1746580152165,MATH 170A,A02,890241,Nie; Jiawang,11,0,30,19
1746580152165,MATH 170A,A03,890249,Nie; Jiawang,23,0,30,7
1746580153190,MATH 170B,A01,957891,Nag; Panchali,13,0,35,22
1746580155242,MATH 181A,A01,908025,Staff,0,3,35,35
1746580155242,MATH 181A,A02,960115,Staff,26,0,35,9
1746580156266,MATH 181B,A01,959874,Staff,25,0,30,5
1746580157295,MATH 193B,A01,890265,Staff,0,4,35,35
1746580158321,MGT 4,A01,890311,Anderson; John Charles,42,0,88,46
1746580159349,MGT 5,A00,907740,Staff,13,0,98,85
1746580160377,MGT 12,A00,890312,Lindenberger; Wade Douglas,67,0,98,31
1746580161403,MGT 16,A00,957883,Staff,78,0,98,20
1746580163456,MGT 45,A00,890314,Pecore; Joseph P.,45,0,98,53
1746580164487,MGT 71,A00,890315,Staff,0,12,98,98
1746580165516,MGT 100,A00,890316,Yavorsky; Daniel Ryan,44,0,98,54
1746580166603,MGT 103,A00,890317,Ehrich; Kristine R,73,0,98,25
1746580167628,MGT 105,A00,890356,Bates; Kenneth Walter,0,8,98,98
1746580168657,MGT 112,A00,890360,Ehrich; Kristine R,55,0,98,43
1746580169681,MGT 127R,A00,907732,Zhu; Kevin Xiaoguo,23,0,98,75
1746580170707,MGT 131B,A00,890361,Anderson; John Charles,59,0,98,39
1746580171735,MGT 137,A00,890362,Lindenberger; Wade Douglas,65,0,98,33
1746580172762,MGT 160,A00,890369,Johnson; Erik Barry,9,0,98,89
1746580174815,MGT 164,A00,890372,Zimmermann; Carsten,0,40,98,98
1746580175839,MGT 180,A00,890374,Bliss; Barbara Ann,12,0,98,86
1746580176866,MMW 15,A01,886414,Chang; Edmond Yi-Teh,0,12,28,28
1746580176866,MMW 15,A02,886415,Chang; Edmond Yi-Teh,0,8,28,28
1746580176866,MMW 15,A03,886416,Chang; Edmond Yi-Teh,0,9,28,28
1746580176866,MMW 15,A04,886417,Chang; Edmond Yi-Teh,0,8,28,28
1746580176866,MMW 15,B01,886419,Chang; Edmond Yi-Teh,0,7,28,28
1746580176866,MMW 15,B02,886420,Chang; Edmond Yi-Teh,0,8,28,28
1746580176866,MMW 15,B03,886421,Chang; Edmond Yi-Teh,0,7,28,28
1746580176866,MMW 15,B04,886422,Chang; Edmond Yi-Teh,0,8,28,28
1746580176866,MMW 15,C01,886424,Staff,0,9,28,28
1746580176866,MMW 15,C02,886425,Staff,0,8,28,28
1746580176866,MMW 15,C03,886426,Staff,0,8,28,28
1746580176866,MMW 15,C04,886427,Staff,0,8,28,28
1746580176866,MMW 15,C05,958038,Staff,0,8,28,28
1746580176866,MMW 15,C06,958039,Staff,1,8,28,27
1746580177892,MMW 15GS,A00,906910,Patterson; Patrick H.,4,0,28,24
1746580178915,MMW 122R,A01,886429,Rahimi; Babak,0,13,28,28
1746580178915,MMW 122R,A02,886430,Rahimi; Babak,0,12,28,28
1746580178915,MMW 122R,A03,958040,Rahimi; Babak,0,11,28,28
1746580179942,MUS 1A,A01,890937,Staff,2,0,25,23
1746580179942,MUS 1A,A02,891035,Staff,6,0,25,19
1746580179942,MUS 1A,C01,958912,Staff,24,0,25,1
1746580179942,MUS 1A,C02,958913,Staff,25,0,25,0
1746580181992,MUS 2AK,A00,957092,Ohnishi; Takae,15,0,15,0
1746580183021,MUS 4,A01,891044,Staff,1,0,25,24
1746580183021,MUS 4,A02,891045,Staff,23,0,25,2
1746580183021,MUS 4,B01,891048,Staff,17,0,25,8
1746580183021,MUS 4,B02,891050,Staff,25,0,25,0
1746580184046,MUS 5,A01,957506,Dubnov; Shlomo,0,0,25,25
1746580184046,MUS 5,A02,957622,Dubnov; Shlomo,13,0,25,12
1746580184046,MUS 5,A03,957623,Dubnov; Shlomo,20,0,25,5
1746580185074,MUS 6,A01,891053,Freitas Caetano; Marcelo,24,0,25,1
1746580185074,MUS 6,A02,891054,Freitas Caetano; Marcelo,23,0,25,2
1746580186100,MUS 7,A01,891081,Staff,1,0,25,24
1746580186100,MUS 7,A02,891082,Staff,3,0,25,22
1746580187130,MUS 8GS,A00,891118,Borgo; David Garcia,1,0,25,24
1746580188155,MUS 11,A01,891140,Staff,9,0,25,16
1746580188155,MUS 11,A02,891141,Staff,21,0,25,4
1746580189181,MUS 13,A01,891143,Staff,8,0,25,17
1746580189181,MUS 13,A02,891144,Staff,24,0,25,1
1746580190206,MUS 15,A01,891146,Staff,9,0,25,16
1746580190206,MUS 15,A02,891148,Staff,21,0,25,4
1746580190206,MUS 15,B01,891150,Staff,18,0,25,7
1746580190206,MUS 15,B02,891151,Staff,25,0,25,0
1746580191232,MUS 20,A01,891153,Staff,5,0,20,15
1746580191232,MUS 20,A02,891155,Staff,14,0,20,6
1746580192261,MUS 80,A00,891156,Staff,19,0,25,6
1746580192261,MUS 80,B00,891157,Staff,23,0,25,2
1746580193287,MUS 130,A00,891158,Ohnishi; Takae,35,0,35,0
1746580194317,MUS 150GS,A01,891160,Borgo; David Garcia,1,0,25,24
1746580195340,MUS 170,A01,891162,Freitas Caetano; Marcelo,20,0,25,5
1746580195340,MUS 170,A02,891164,Freitas Caetano; Marcelo,21,0,25,4
1746580196368,NANO 11,A00,886220,Vazquez Mena; Oscar,13,0,15,2
1746580197394,NANO 15,A01,886222,Drews; Aaron,4,0,7,3
1746580198419,NANO 104,A00,886224,Sirbuly; Donald,17,0,25,8
1746580199447,PH 40,A00,886528,Staff,24,0,40,16
1746580200473,PH 45,A01,886799,Staff,35,0,40,5
1746580201499,PH 110,A00,886802,Staff,0,7,40,40
1746580202523,PH 172,A00,906716,Staff,19,0,35,16
1746580203552,PH 191,A00,886803,Staff,6,0,40,34
1746580204579,PHIL 1,A00,889500,Staff,20,0,30,10
1746580205610,PHIL 10,A01,889549,Grush; Rick Scott,16,0,22,6
1746580205610,PHIL 10,A02,889551,Grush; Rick Scott,22,0,22,0
1746580206640,PHIL 28,A01,889559,Lamey; Andy M.,0,2,31,31
1746580206640,PHIL 28,A02,889561,Lamey; Andy M.,0,1,30,30
1746580206640,PHIL 28,A03,889572,Lamey; Andy M.,0,1,30,30
1746580207664,PHIL 35,A00,907839,Staff,13,0,15,2
1746580208693,PHIL 60,A00,889574,Staff,73,0,90,17
1746580209717,PHIL 101,A00,958004,Staff,12,0,15,3
1746580211769,PHIL 136,A00,889582,Fulkerson; Matthew Todd,26,0,45,19
1746580212798,PHIL 163,A01,889601,Staff,21,0,30,9
1746580212798,PHIL 163,B01,889606,Brandt; Reuven A,0,3,0,0
1746580213825,PHIL 164,A00,889610,Staff,16,0,30,14
1746580214851,PHIL 165,A00,889613,Staff,22,0,30,8
1746580215876,PHYS 1A,A00,886431,Staff,28,0,70,42
1746580216906,PHYS 1AL,001,886432,Tsai; Philbert S,1,2,30,29
1746580216906,PHYS 1AL,002,886436,Tsai; Philbert S,11,0,30,19
1746580217930,PHYS 1B,A00,886439,Staff,184,0,240,56
1746580218955,PHYS 1BL,001,886441,Tsai; Philbert S,0,4,30,30
1746580218955,PHYS 1BL,002,886444,Tsai; Philbert S,2,0,30,28
1746580219981,PHYS 1C,A00,896092,Arnold; Kam S,78,0,146,68
1746580221007,PHYS 1CL,001,886448,Tsai; Philbert S,0,0,30,30
1746580221007,PHYS 1CL,002,886449,Tsai; Philbert S,1,0,30,29
1746580221007,PHYS 1CL,003,886450,Tsai; Philbert S,16,0,30,14
1746580221007,PHYS 1CL,004,886451,Tsai; Philbert S,15,0,30,15
1746580222035,PHYS 2B,A01,886457,Staff,68,0,115,47
1746580223062,PHYS 2C,A01,886460,Shotwell; Brian,0,9,65,65
1746580224087,PHYS 2CL,A01,886467,Staff,0,4,28,28
1746580224087,PHYS 2CL,A02,886468,Staff,0,3,28,28
1746580225112,PHYS 2D,A01,886470,Staff,10,0,50,40
1746580226142,PHYS 4B,A01,886475,Grinstein; Benjamin,22,0,40,18
1746580227167,POLI 5,A00,891173,Desposato; Scott,7,0,25,18
1746580228196,POLI 5D,A01,891175,Staff,5,0,5,0
1746580228196,POLI 5D,B01,891178,Staff,5,0,5,0
1746580229230,POLI 11,A00,891179,Ferree; Karen E,2,0,35,33
1746580230256,POLI 12,A00,891180,Staff,16,0,30,14
1746580231280,POLI 27,A01,891182,Staff,12,0,75,63
1746580232304,POLI 30,A00,891183,Staff,8,0,50,42
1746580233332,POLI 100B,A00,891244,Staff,5,1,35,30
1746580234359,POLI 100I,A00,891247,Staff,7,0,30,23
1746580235385,POLI 104J,A00,891248,Nichter; Maysa,14,0,30,16
1746580236414,POLI 104U,A00,891250,Nichter; Maysa,1,0,30,29
1746580238467,POLI 110B,A00,891255,Wiens; David,19,0,25,6
1746580239494,POLI 112A,A00,891256,Wiens; David,6,0,25,19
1746580240522,POLI 114BR,A00,891261,Staff,19,0,30,11
1746580241548,POLI 117R,A00,891262,Forman; Fonna,0,6,50,50
1746580242573,POLI 118,A00,891264,Ingham; Sean,17,0,25,8
1746580243597,POLI 124A,A00,891265,Staff,18,0,20,2
1746580244621,POLI 125D,A00,891266,Nichter; Simeon C,2,0,25,23
1746580245648,POLI 126,A00,891268,Nichter; Simeon C,7,0,25,18
1746580246675,POLI 126AA,A00,891272,Staff,15,0,25,10
1746580247699,POLI 130AA,A00,891273,Staff,15,0,20,5
1746580248727,POLI 134AA,A00,891274,Staff,4,0,20,16
1746580250780,POLI 138,A00,891278,Staff,21,0,25,4
1746580251809,POLI 142K,A00,891280,Staff,10,0,25,15
1746580252838,POLI 142M,A00,891281,Gartzke; Erik,16,0,30,14
1746580253875,POLI 142P,A00,891284,Staff,20,0,30,10
1746580254901,POLI 143,A00,891285,Gartzke; Erik,12,0,30,18
1746580255928,POLI 153,A00,891286,Staff,19,0,20,1
1746580257986,POLI 175,A00,891290,Staff,15,0,20,5
1746580259015,PSYC 1,A00,890674,Steiner; Eric Tomas,0,11,45,45
1746580260038,PSYC 2,A00,890676,Albright; Thomas D,21,0,35,14
1746580261070,PSYC 3,A00,890679,Staff,17,0,20,3
1746580262095,PSYC 6,A00,959858,Staff,19,0,20,1
1746580263122,PSYC 60,A01,890684,Rickard; Timothy C.,0,5,45,45
1746580264147,PSYC 70,A01,890689,Geller; Emma Harlan,7,0,30,23
1746580265173,PSYC 71,A01,959860,Staff,21,0,25,4
1746580266202,PSYC 100,A00,890690,Lacefield; Katharine I,0,50,180,180
1746580267230,PSYC 102,A00,890695,Staff,18,0,40,22
1746580268255,PSYC 105,A00,890699,Geller; Emma Harlan,70,0,100,30
1746580269282,PSYC 106,A00,890701,Gorman; Michael R.,5,0,30,25
1746580270309,PSYC 108,A00,890704,Adrian; Julia Anna,0,28,50,50
1746580271337,PSYC 118,A01,890712,Staff,11,0,30,19
1746580272363,PSYC 124,A00,890716,Chapman; Eddie Nathaniel,25,0,60,35
1746580273387,PSYC 131,A00,890717,Anagnostaras; Stephan,0,7,80,80
1746580274413,PSYC 137,A00,890719,Winkielman; Piotr,0,11,30,30
1746580275442,PSYC 144,A00,890721,Adrian; Julia Anna,0,9,45,45
1746580276466,PSYC 162,A00,890805,Staff,0,0,75,75
1746580277491,PSYC 169,A00,890810,Staff,0,14,30,30
1746580278522,PSYC 172,A00,890814,Gorman; Michael R.,9,0,30,21
1746580279551,PSYC 181,A00,890818,Anagnostaras; Stephan,7,0,200,193
1746580280579,PSYC 184,A00,959861,Staff,164,0,175,11
1746580281605,PSYC 189,A00,890823,Staff,0,2,30,30
1746580282636,PSYC 191,A00,890884,Rickard; Timothy C.,0,12,35,35
1746580283660,PSYC 193,A00,890913,Staff,19,0,30,11
1746580283660,PSYC 193,B00,890914,Chapman; Eddie Nathaniel,24,0,30,6
1746580284687,PSYC 193L,A01,890918,Lowe; Angela Beth,20,0,30,10
1746580284687,PSYC 193L,B01,890921,Hurwitz; Ethan Scott,20,0,30,10
1746580284687,PSYC 193L,C01,890928,Staff,30,0,30,0
1746580285711,RELI 149,A00,886806,Rahimi; Babak,23,0,40,17
1746580286759,SE 9,A01,886814,Staff,7,0,20,13
1746580287790,SE 101B,A01,886816,Chadha; Mayank,4,0,35,31
1746580288814,SE 110B,A00,886818,Zhu; Qiang,4,0,75,71
1746580289839,SE 125,A01,886830,Staff,10,0,30,20
1746580290864,SE 130B,A01,886835,Staff,14,0,40,26
1746580291892,SE 131A,A01,886838,Krysl; Petr,34,0,55,21
1746580292920,SE 154,A00,886840,Staff,29,0,50,21
1746580293946,SE 164GS,A01,886849,Staff,6,0,20,14
1746580294975,SE 167GS,A01,886853,Staff,6,0,20,14
1746580295999,SIO 25,A01,890107,Staff,19,0,30,11
1746580297028,SIO 45,A00,890109,Cook; Geoffrey W,116,0,200,84
1746580298053,SIO 109R,A00,890110,Forman; Fonna,0,16,20,20
1746580299079,SIO 187,A01,890114,Kacev; David,15,0,40,25
1746580300104,SOCI 1,A01,890431,Thorpe; Charles Robert,14,0,30,16
1746580300104,SOCI 1,A02,890518,Thorpe; Charles Robert,30,0,30,0
1746580301133,SOCI 2,A01,957978,Staff,25,0,25,0
1746580301133,SOCI 2,A02,957979,Staff,23,0,25,2
1746580302173,SOCI 20,A01,890523,Calderon-Zaks; Michael Aar,21,0,30,9
1746580302173,SOCI 20,A02,890526,Calderon-Zaks; Michael Aar,29,0,30,1
1746580303200,SOCI 30,A01,890533,Pardo Guerra; Juan Pablo,37,0,40,3
1746580304227,SOCI 40,A01,890535,Staff,27,0,45,18
1746580305255,SOCI 104Q,A00,890559,Staff,18,0,30,12
1746580306278,SOCI 106,A00,890560,Arnal; Maud Marie Leonie,20,0,30,10
1746580307306,SOCI 110,A00,890567,Holkenbrink-Monk; Charlene,19,0,30,11
1746580308335,SOCI 112,A00,890568,Victoria Torres; Pablo,2,0,55,53
1746580309363,SOCI 115,A00,890597,Arnal; Maud Marie Leonie,28,0,45,17
1746580311415,SOCI 121,A00,890604,Pardo Guerra; Juan Pablo,38,0,45,7
1746580312440,SOCI 126,A01,890608,Staff,8,0,10,2
1746580313466,SOCI 127,A00,890609,Staff,18,0,30,12
1746580314493,SOCI 131,A00,890610,Thorpe; Charles Robert,37,0,45,8
1746580315518,SOCI 135,A00,890615,Payne; Christine Anna,13,0,45,32
1746580316544,SOCI 139,A00,890620,Staff,38,0,45,7
1746580317570,SOCI 148E,A00,890622,Calderon-Zaks; Michael Aar,36,0,45,9
1746580318598,SOCI 150,A00,890623,Kohler; Kristopher M.,31,0,45,14
1746580319623,SOCI 157,A00,890625,Jules-Rosette; Bennetta W.,18,0,20,2
1746580320649,SOCI 160,A00,890627,Payne; Christine Anna,21,0,45,24
1746580321674,SYN 1,A00,886855,Fish; Gwendolyn Anne,0,1,0,0
1746580321674,SYN 1,B00,906086,Fish; Gwendolyn Anne,0,2,0,2
1746580322703,SYN 2R,A00,886860,Staff,0,17,15,15
1746580322703,SYN 2R,B00,906106,Atkinson; Arthur Laird,0,16,15,15
1746580323729,SYN 100,A01,886866,Browne; Emily,0,28,20,20
1746580323729,SYN 100,B01,906128,Rock; Martin,0,4,20,20
1746580323729,SYN 100,C01,906140,Deavenport; James Cary,0,3,20,20
1746580323729,SYN 100,D01,907816,Deavenport; James Cary,0,5,20,20
1746580324757,TDAC 1,A00,890286,Walsh; Kim C.,7,0,20,13
1746580325785,TDAC 101,A00,890296,Basso; Beatrice,15,0,20,5
1746580326811,TDDE 131,A00,890297,Staff,47,0,50,3
1746580327835,TDDM 1,A00,890287,Weinberg; Sadie,25,0,30,5
1746580328861,TDGE 11,A00,890288,Fulton; Julia,138,0,200,62
1746580328861,TDGE 11,B00,890289,Castro; Robert Jess,184,0,200,16
1746580329888,TDGE 25,B00,957359,Walsh; Kim C.,5,0,20,15
1746580330913,TDGE 40,A01,890292,Power; Jade Yukana,27,0,30,3
1746580331937,TDGE 124,A00,890298,Havis; Allan,0,1,50,50
1746580332968,TDGE 131R,A00,890299,Burelle; Julie Sara Veronique,15,0,42,27
1746580333996,TDHT 101,A00,890300,Staff,10,0,20,10
1746580335021,TDHT 109,A01,890302,Anderson; Mysia Anyse,31,0,40,9
1746580336046,TDMV 1,A00,890293,Arcidiacono; Kristin,18,0,30,12
1746580337074,TDMV 2,A00,890294,Weinberg; Sadie,23,0,30,7
1746580338102,TDMV 3,A00,957878,Arcidiacono; Kristin,28,0,30,2
1746580340156,TDMV 138,A00,890304,Jun; Grace Shin Hae,25,0,40,15
1746580341185,TDMV 140,A00,890305,Corrales; Joseph Bernales,25,0,30,5
1746580342215,TDMV 142,A00,890307,Caligagan; Tony,32,0,40,8
1746580343239,TDMV 144,A00,890308,Camaya; Michelle Ann,25,0,30,5
1746580344266,TDPW 1,A00,890295,Stein; Deborah Isobel,3,0,20,17
1746580345497,USP 2,A01,890272,Lerner; Amy M,7,0,20,13
1746580346523,USP 3,A01,890274,Staff,12,0,30,18
1746580347549,USP 15,A01,890276,Sun; Feiyang,16,0,30,14
1746580348575,USP 25,A00,890277,Shenkman; Michael Thomas,18,0,25,7
1746580349600,USP 138,A00,890278,Staff,14,0,25,11
1746580350627,USP 143,A00,890279,Staff,22,0,70,48
1746580351656,USP 144,A00,890280,Chowdhury; Muhammed Zohir,16,0,30,14
1746580352683,USP 150,A00,890281,Boomhower; Matthew Charles,4,0,30,26
1746580353710,USP 151,A00,890282,Staff,16,0,20,4
1746580354738,USP 162,A00,890283,Andrews; Abigail Leslie,16,0,20,4
1746580355763,USP 168,A00,920477,Kwak; Nancy,0,0,5,5
1746580356790,USP 181,A00,890284,Staff,3,0,20,17
1746580357818,USP 191A,A00,890285,Staff,12,0,20,8
1746580358844,VIS 101,A00,886512,Staff,26,0,75,49
1746580359870,VIS 103,A00,886513,Cruz; Edwin Teddy,61,0,75,14
1746580360895,VIS 108,A00,886514,Staff,3,0,15,12
1746580361920,VIS 127P,A00,886515,Shen; Kuiyi,80,0,146,66
1746580362953,VIS 149,A00,886516,Yoldas; Pinar,0,0,15,15
1746580363978,VIS 164,A00,886526,Erdmann; Dean,19,0,22,3
1746580365008,VIS 194S,A00,886527,Staff,61,0,75,14
1746580366034,WCWP 10A,C00,886484,Martiniuk; Jill,12,0,15,3
1746580367070,WCWP 10B,A00,886490,Uriarte; Emma,0,0,15,15
1746580367070,WCWP 10B,B00,886491,Dhir; Simrita,8,0,15,7
1746580367070,WCWP 10B,C00,886492,Ornelas; Tricia,0,0,15,15
1746580368100,WCWP 100,A00,886494,Young; Mark T,0,6,15,15
1746580370254,AAS 10,A01,886199,Childs; Dennis R.,0,3,0,0
1746580371283,ANAR 104,A01,886940,Shtienberg; Gilad,27,0,30,3
1746580372309,ANAR 120,A00,886953,Staff,12,0,20,8
1746580373337,ANBI 148,A01,886955,Wilder; Linnea Lorene,30,0,40,10
1746580375394,ANSC 122,A00,886957,Staff,25,0,30,5
1746580376418,ANSC 150,A00,886958,Sloane; Julia Kathryn,2,0,15,13
1746580377447,ANSC 156,A00,886959,Jenkins; Janis A.,0,1,15,15
1746580378475,ANSC 180,A00,886960,Staff,11,0,17,6
1746580379504,ANSC 188,A00,886961,Jassal; Aftab,9,0,25,16
1746580380535,ANSC 190,A00,886962,Jassal; Aftab,14,0,25,11
1746580381566,ANSC 191,A00,886963,Staff,18,0,20,2
1746580382594,ANTH 3,A01,891689,Staff,17,0,20,3
1746580383620,ANTH 5,A00,886933,Semendeferi; Ekaterini,16,0,20,4
1746580384646,ANTH 10,A00,886934,Staff,0,12,30,30
1746580385675,ANTH 21,A01,886936,Staff,41,0,60,19
1746580386700,ANTH 23,A01,886938,Staff,92,0,100,8
1746580387725,ANTH 105,A00,886964,Stewart; Alexander B,84,0,100,16
1746580388751,ANTH 108,A00,886965,Pedersen; David,9,0,20,11
1746580389780,AWP 10,001,886147,Staff,0,0,0,0
1746580389780,AWP 10,002,886148,Staff,0,0,0,0
1746580389780,AWP 10,003,886149,Staff,0,0,0,0
1746580389780,AWP 10,004,886150,Staff,0,0,0,0
1746580389780,AWP 10,005,886151,Staff,0,0,0,0
1746580389780,AWP 10,006,886152,Staff,0,0,0,0
1746580389780,AWP 10,007,886153,Staff,0,0,0,0
1746580389780,AWP 10,008,886154,Staff,0,0,0,0
1746580389780,AWP 10,009,886155,Staff,0,0,0,0
1746580389780,AWP 10,010,886156,Staff,0,0,0,0
1746580389780,AWP 10,011,886158,Staff,0,0,0,0
1746580389780,AWP 10,012,886160,Staff,0,0,0,0
1746580389780,AWP 10,013,886161,Staff,0,0,0,0
1746580389780,AWP 10,014,886162,Staff,0,0,0,0
1746580389780,AWP 10,015,886163,Staff,0,0,0,0
1746580389780,AWP 10,016,886164,Staff,0,0,0,0
1746580389780,AWP 10,017,886165,Staff,0,0,0,0
1746580389780,AWP 10,018,886166,Staff,0,0,0,0
1746580389780,AWP 10,019,886168,Staff,0,0,0,0
1746580389780,AWP 10,020,886170,Staff,0,0,0,0
1746580389780,AWP 10,021,886172,Staff,0,0,0,0
1746580390817,AWP 10R,001,886173,Staff,0,1,0,0
1746580390817,AWP 10R,002,886174,Staff,0,1,0,0
1746580390817,AWP 10R,003,886175,Staff,0,0,0,0
1746580390817,AWP 10R,004,886176,Staff,0,0,0,0
1746580390817,AWP 10R,005,886177,Staff,0,0,0,0
1746580390817,AWP 10R,006,886178,Staff,0,0,0,0
1746580390817,AWP 10R,007,886179,Staff,0,0,0,0
1746580390817,AWP 10R,008,886181,Staff,0,0,0,0
1746580390817,AWP 10R,009,886182,Staff,0,0,0,0
1746580390817,AWP 10R,010,886183,Staff,0,0,0,0
1746580390817,AWP 10R,011,886184,Staff,0,0,0,0
1746580390817,AWP 10R,012,886185,Staff,0,0,0,0
1746580390817,AWP 10R,013,886186,Staff,0,0,0,0
1746580390817,AWP 10R,014,886187,Staff,0,0,0,0
1746580390817,AWP 10R,015,886188,Staff,0,0,0,0
1746580390817,AWP 10R,016,886189,Staff,0,0,0,0
1746580390817,AWP 10R,017,960532,Staff,0,0,0,0
1746580390817,AWP 10R,018,960533,Staff,0,0,0,0
1746580390817,AWP 10R,019,960534,Staff,0,0,0,0
1746580390817,AWP 10R,020,960538,Staff,0,0,0,0
1746580390817,AWP 10R,021,960540,Staff,0,0,0,0
1746580390817,AWP 10R,022,960541,Staff,0,0,0,0
1746580390817,AWP 10R,023,960542,Staff,0,0,0,0
1746580390817,AWP 10R,024,960544,Staff,0,0,0,0
1746580390817,AWP 10R,025,960545,Staff,0,0,0,0
1746580390817,AWP 10R,026,960548,Staff,0,0,0,0
1746580391844,AWP 102R,A00,886190,Staff,0,0,0,0
1746580391844,AWP 102R,B00,886191,Staff,0,0,0,0
1746580392873,BENG 100,A01,886193,Staff,17,0,30,13
1746580393899,BENG 122A,A01,886195,Hasty; Jeff M,13,0,30,17
1746580394924,BENG 166A,A00,886196,Sah; Robert Lie-Yuan,0,3,30,30
1746580395951,BENG 190,A00,958050,Khojah; Reem I,19,0,25,6
1746580396977,BIBC 102,A01,894320,Staff,0,0,46,46
1746580396977,BIBC 102,A02,894321,Staff,0,0,46,46
1746580396977,BIBC 102,A03,894344,Staff,6,0,46,40
1746580396977,BIBC 102,A04,894345,Staff,27,0,47,20
1746580398003,BICD 100R,A01,894365,Smith; Laurie,0,3,58,58
1746580398003,BICD 100R,A02,894366,Smith; Laurie,0,5,58,58
1746580398003,BICD 100R,A03,894367,Smith; Laurie,0,0,59,59
1746580398003,BICD 100R,A04,959869,Smith; Laurie,40,0,59,19
1746580399093,BICD 136,A01,894383,Gustafson-Brown; Cindy,14,0,50,36
1746580400124,BIEB 102,A01,894494,Butler; Shannon Rhey,51,0,130,79
1746580402180,BIEB 150,A01,894617,Wills; Christopher,3,0,20,17
1746580402180,BIEB 150,A02,894631,Wills; Christopher,3,0,20,17
1746580402180,BIEB 150,A03,894937,Wills; Christopher,3,0,20,17
1746580402180,BIEB 150,A04,894946,Wills; Christopher,5,0,20,15
1746580403204,BIEB 194,A00,906141,Kurle; Carolyn M.,6,0,20,14
1746580404235,BILD 1,A01,894154,Staff,3,0,19,16
1746580404235,BILD 1,A02,894155,Staff,14,0,19,5
1746580404235,BILD 1,A03,894160,Staff,13,0,19,6
1746580404235,BILD 1,A04,894161,Staff,15,0,18,3
1746580405263,BILD 2,A01,894168,Staff,0,0,50,50
1746580405263,BILD 2,A02,894169,Staff,0,0,50,50
1746580405263,BILD 2,A03,894179,Staff,0,0,50,50
1746580405263,BILD 2,A04,894203,Staff,24,0,50,26
1746580406288,BILD 3,A01,894213,Staff,23,0,31,8
1746580406288,BILD 3,A02,894214,Staff,26,0,31,5
1746580406288,BILD 3,A03,894235,Staff,28,0,31,3
1746580406288,BILD 3,A04,894236,Staff,28,0,32,4
1746580407313,BILD 4,A01,894253,Reuther; Keefe,5,0,24,19
1746580407313,BILD 4,A02,894258,Reuther; Keefe,16,0,24,8
1746580408338,BILD 5,A01,894276,Reuther; Keefe,35,0,50,15
1746580408338,BILD 5,A02,894277,Reuther; Keefe,45,0,50,5
1746580408338,BILD 5,A03,894290,Reuther; Keefe,44,0,50,6
1746580408338,BILD 5,A04,894291,Reuther; Keefe,48,0,50,2
1746580409367,BILD 24,A01,894297,Pirino; Giorgia,40,0,60,20
1746580410393,BIMM 100,B01,958915,Staff,71,0,100,29
1746580411418,BIMM 101,A01,895017,McDonnell; Lisa Marie,0,5,24,24
1746580411418,BIMM 101,A02,895018,McDonnell; Lisa Marie,0,5,24,24
1746580411418,BIMM 101,B01,895020,McDonnell; Lisa Marie,0,6,24,24
1746580411418,BIMM 101,B02,895021,McDonnell; Lisa Marie,0,4,24,24
1746580412445,BIMM 110,A01,895023,Staff,1,0,25,24
1746580412445,BIMM 110,A02,895024,Staff,9,0,25,16
1746580412445,BIMM 110,A03,895025,Staff,18,0,25,7
1746580412445,BIMM 110,A04,895031,Staff,20,0,25,5
1746580413474,BIMM 120,A01,895114,Gustafson-Brown; Cindy,14,0,28,14
1746580413474,BIMM 120,A02,895126,Gustafson-Brown; Cindy,21,0,27,6
1746580414503,BIPN 100,A01,895130,Yang; Mingyu,0,0,38,38
1746580414503,BIPN 100,A02,895131,Yang; Mingyu,32,0,38,6
1746580414503,BIPN 100,A03,895132,Yang; Mingyu,32,0,38,6
1746580414503,BIPN 100,A04,895133,Yang; Mingyu,27,0,36,9
1746580415528,BIPN 120,A01,895135,Cooke; James Edward,0,3,13,13
1746580415528,BIPN 120,A02,895136,Cooke; James Edward,0,1,13,13
1746580415528,BIPN 120,A03,895137,Cooke; James Edward,0,3,13,13
1746580415528,BIPN 120,A04,895156,Cooke; James Edward,0,2,11,11
1746580416555,BIPN 134,A01,895235,Cooke; James Edward,0,2,25,25
1746580416555,BIPN 134,A02,895237,Cooke; James Edward,0,0,25,25
1746580416555,BIPN 134,A03,895240,Cooke; James Edward,3,0,25,22
1746580416555,BIPN 134,A04,895270,Cooke; James Edward,20,0,25,5
1746580417585,BIPN 189,A00,892103,Staff,0,14,14,14
1746580419640,BISP 194,A00,958008,Staff,0,2,0,0
1746580420669,CAT 124,A01,922009,Staff,0,5,20,20
1746580421695,CAT 125R,A00,886390,Morales; Celeste Georgianna,0,2,20,20
1746580421695,CAT 125R,B00,886391,Irwin; Matthew Joseph,0,4,20,20
1746580421695,CAT 125R,C00,886392,Smith; Lauryn Alissa,0,2,20,20
1746580421695,CAT 125R,D00,886393,Vanderschuit; Maya Alysia,0,3,20,20
1746580421695,CAT 125R,E00,886394,Marchisotto; Jennifer Anne,0,3,20,20
1746580422721,CENG 15,A01,886218,Drews; Aaron,3,0,8,5
1746580423747,CENG 113,A00,886219,Opatkiewicz; Justin Paul,15,0,25,10
1746580424772,CGS 101,A00,887044,Staff,7,0,20,13
1746580425797,CGS 105,A01,887046,Staff,14,0,25,11
1746580426823,CGS 112,A00,887047,Cuong; Marisol,12,0,15,3
1746580427848,CGS 113,A00,887048,Staff,23,0,30,7
1746580428876,CGS 120,A00,887049,Staff,10,0,17,7
1746580429903,CHEM 6A,A01,886336,Lam; Tin Yiu,38,0,50,12
1746580429903,CHEM 6A,A02,886338,Lam; Tin Yiu,37,0,50,13
1746580430929,CHEM 6B,A01,886341,Hopkins; Patrycja Anna,16,0,50,34
1746580430929,CHEM 6B,A02,886343,Hopkins; Patrycja Anna,42,0,50,8
1746580431954,CHEM 6C,A01,886346,Albizati; Kim F.,0,2,50,50
1746580431954,CHEM 6C,A02,886348,Albizati; Kim F.,23,0,50,27
1746580432984,CHEM 40A,A01,886352,Klosterman; Jeremy K,65,0,100,35
1746580434009,CHEM 40B,A01,886356,Klosterman; Jeremy K,0,24,100,100
1746580435036,CHEM 41B,A01,886360,Theodorakis; Emmanuel,25,0,50,25
1746580435036,CHEM 41B,A02,886362,Theodorakis; Emmanuel,47,0,50,3
1746580436064,CHIN 165A,A00,886382,Xu; Li,18,0,20,2
1746580437089,CLAS 120,A00,886387,Myerston Santana; Jacobo,33,0,40,7
1746580438114,COGS 9,A01,886967,Shannon; Kyle Michael,42,0,60,18
1746580439143,COGS 11,A01,886969,Staff,9,0,30,21
1746580440169,COGS 14A,A01,886971,Staff,6,0,60,54
1746580441194,COGS 14B,A01,886973,Hoffman; Drew Ellen,4,0,60,56
1746580442223,COGS 18,A01,886975,Morgan; Eric,35,0,60,25
1746580443248,COGS 20,A01,886977,Staff,4,0,8,4
1746580443248,COGS 20,A02,886978,Staff,5,0,7,2
1746580444283,COGS 100,A01,907783,Staff,1,2,30,29
1746580445306,COGS 101B,A01,886980,Staff,0,4,48,48
1746580446455,COGS 101C,A01,886982,Delgado; Tania,0,5,44,44
1746580447487,COGS 102A,A01,886984,Johnson; Christine M.,4,0,30,26
1746580448512,COGS 118B,A01,886986,Staff,1,4,88,87
1746580449540,COGS 150,A01,886988,Bergen; Benjamin,22,0,50,28
1746580450566,COGS 153,A00,886989,Delgado; Tania,0,2,41,41
1746580451592,COGS 186,A01,886991,Staff,0,0,32,32
1746580452616,COGS 187A,A01,886993,Boyle; Mary E. T.,7,0,30,23
1746580453641,COGS 189,A00,886994,Staff,0,1,30,30
1746580454668,COMM 10,A01,886996,Staff,0,0,20,21
1746580454668,COMM 10,A02,886997,Staff,10,0,20,10
1746580454668,COMM 10,A03,959845,Staff,19,0,20,1
1746580455698,COMM 20,A01,886999,Leuning; Grant Maurstad,24,0,40,16
1746580457750,COMM 100A,A01,887002,Staff,0,0,20,25
1746580457750,COMM 100A,A02,887003,Staff,6,0,20,14
1746580458778,COMM 100B,A01,887005,Staff,0,8,20,24
1746580459804,COMM 106D,A00,887006,Staff,13,0,40,27
1746580460831,COMM 110G,A00,887007,Whitworth-Smith; Andrew C,12,0,40,28
1746580461858,COMM 111B,A00,887008,Staff,31,0,40,9
1746580462883,COMM 113T,A00,887009,Abuelhiga; Soraya Jill,28,0,40,12
1746580462883,COMM 113T,B00,906733,Staff,40,0,40,0
1746580463908,COMM 145,A00,887010,Staff,12,0,40,28
1746580464932,COMM 146,A00,887054,Staff,31,0,40,9
1746580465961,COMM 190,A00,887012,Staff,8,0,23,15
1746580466990,CSE 8A,A50,887015,Cao; Yingjun,57,0,85,28
1746580468020,CSE 11,A01,887017,Cao; Yingjun,12,0,70,58
1746580469043,CSE 20,A01,887019,Staff,30,0,50,20
1746580470074,CSE 21,A01,887021,Staff,78,0,100,22
1746580470074,CSE 21,B01,892583,Braun; Oliver,45,0,50,5
1746580471101,CSE 30,A01,887025,Eldon; John,143,0,200,57
1746580472126,CSE 100,A01,887027,Staff,26,0,50,24
1746580472126,CSE 100,A02,887028,Staff,42,0,50,8
1746580473152,CSE 101,A01,887030,Braun; Oliver,74,0,100,26
1746580473152,CSE 101,B01,887032,Jones; Miles E,0,3,50,50
1746580473152,CSE 101,B02,887033,Jones; Miles E,0,2,50,50
1746580474175,CSE 105,A01,908084,Jones; Miles E,32,0,50,18
1746580474175,CSE 105,A02,908087,Jones; Miles E,31,0,50,19
1746580475201,CSE 135,A01,887035,Powell; Thomas Allan,0,5,50,50
1746580476229,CSE 142,A01,887037,Staff,8,0,60,52
1746580477254,CSE 142L,A01,887039,Staff,34,0,60,26
1746580478280,CSE 151A,A01,887041,Solares; Edwin A,47,0,100,53
1746580479304,CSE 175,A01,887043,Kumar; Rakesh,30,0,30,0
1746580480335,CSS 1,A01,886389,Staff,1,2,40,39
1746580481363,DSC 30,A01,908097,Liao; Soohyun Nam,47,0,75,28
1746580482392,DSC 40A,A01,908099,Shannon; Kyle Michael,30,0,50,20
1746580483418,DSC 40B,A01,908112,Staff,15,0,50,35
1746580484443,DSC 80,A01,908116,Staff,19,0,60,41
1746580485473,DSC 197,001,956863,Eldridge; Justin Matthew,9999,0,9999,0
1746580486499,ECE 5,A01,886400,Morris; Karcher William,1,0,6,5
1746580486499,ECE 5,A02,886401,Morris; Karcher William,3,0,6,3
1746580487526,ECE 148,A01,886403,Silberman; Jack,0,14,14,14
1746580488551,ECON 1,A01,887265,Crane; Meredith Helen,12,0,70,58
1746580488551,ECON 1,B01,887268,Staff,42,0,50,8
1746580489578,ECON 2,A01,887273,Crane; Meredith Helen,55,0,70,15
1746580490605,ECON 3,A01,887279,Rondina; Giacomo,32,0,70,38
1746580491630,ECON 4,A01,887282,Anderson; John Charles,0,2,10,10
1746580492654,ECON 5,A01,887285,Staff,34,0,45,11
1746580492654,ECON 5,B01,887292,Staff,41,0,45,4
1746580493686,ECON 100A,A01,887337,Newhouse; Herbert S,54,0,70,16
1746580493686,ECON 100A,B01,887349,Staff,45,0,50,5
1746580494711,ECON 100B,A01,887361,Du; Songzi,29,0,70,41
1746580495736,ECON 100C,A01,887445,Newhouse; Herbert S,59,0,70,11
1746580496760,ECON 105,A00,887488,Vespa; Emanuel Ignacio,23,0,35,12
1746580497785,ECON 109,A01,887506,Shishkin; Denis,28,0,35,7
1746580498816,ECON 110A,A01,887568,Alon; Titan Michael,0,3,35,35
1746580498816,ECON 110A,B01,907601,Alon; Titan Michael,20,0,35,15
1746580499842,ECON 110B,A01,887598,Levkoff; Steven B.,0,24,70,70
1746580500870,ECON 112,A00,887599,Rondina; Giacomo,19,0,35,16
1746580501894,ECON 120A,A01,887603,Dai; Yinlin,35,0,70,35
1746580502963,ECON 120C,A01,887608,Sun; Yixiao,0,1,35,35
1746580502963,ECON 120C,B01,887614,Sun; Yixiao,0,0,35,35
1746580503988,ECON 138,A00,887621,Bharadwaj; Prashant,0,21,20,20
1746580505014,ECON 144,A00,958007,Squires; Dale E,12,0,35,23
1746580506043,ECON 171,A01,907666,Staff,18,0,35,17
1746580507070,ECON 175,A00,887626,Wu; Pak Yeung,22,0,35,13
1746580508095,ECON 190,A00,887640,Vespa; Emanuel Ignacio,22,0,35,13
1746580509123,EDS 25,A01,888197,Staff,0,0,0,0
1746580509123,EDS 25,A02,888209,Staff,0,0,0,0
1746580509123,EDS 25,A03,888210,Staff,0,0,0,0
1746580509123,EDS 25,A04,888212,Staff,0,0,0,0
1746580509123,EDS 25,A05,888213,Staff,0,0,0,0
1746580509123,EDS 25,A06,888214,Staff,0,0,0,0
1746580509123,EDS 25,A07,888235,Staff,0,2,0,0
1746580509123,EDS 25,A08,888236,Staff,0,0,0,0
1746580509123,EDS 25,A09,888240,Staff,0,0,0,0
1746580509123,EDS 25,A10,888244,Staff,0,0,0,0
1746580509123,EDS 25,B01,888273,Staff,0,0,0,0
1746580509123,EDS 25,B02,888285,Staff,0,0,0,0
1746580509123,EDS 25,B03,888423,Staff,0,0,0,1
1746580509123,EDS 25,B04,888432,Staff,0,0,0,0
1746580509123,EDS 25,B05,888433,Staff,0,0,0,0
1746580509123,EDS 25,B06,888467,Staff,0,0,0,0
1746580509123,EDS 25,B07,888468,Staff,0,0,0,0
1746580509123,EDS 25,B08,888479,Staff,0,0,0,0
1746580509123,EDS 25,B09,888484,Staff,0,0,0,0
1746580509123,EDS 25,B10,888487,Staff,0,0,0,0
1746580510152,EDS 38,A01,907700,Choi; Bailey Miyeon,30,0,30,0
1746580511176,EDS 112,A01,888601,Chapman; Thandeka K,12,0,40,28
1746580512201,EDS 115,A00,888697,Mendez; Kathrina Mendoza,10,0,30,20
1746580513227,EDS 116,A01,888893,Staff,34,0,40,6
1746580515282,EDS 124AR,A00,889133,Staff,29,0,50,21
1746580515282,EDS 124AR,B00,907471,Simon; Elizabeth A,37,0,50,13
1746580516308,EDS 124BR,A00,889134,Simon; Elizabeth A,44,0,100,56
1746580517340,EDS 125,A00,889135,Staff,25,0,30,5
1746580518368,EDS 126,A01,889138,Staff,35,0,40,5
1746580519396,EDS 164R,A01,889142,Wishard Guerra; Alison G.,33,0,50,17
1746580520426,ENG 30,A01,886396,Staff,0,0,0,0
1746580520426,ENG 30,B01,886398,Staff,0,0,0,0
1746580521452,ENVR 102,A00,906150,Montejo; Carolina,23,0,25,2
1746580522481,ETHN 103A,A00,887236,Man; Simeon S,0,3,0,0
1746580523508,ETHN 113,A00,887239,Staff,16,0,30,14
1746580524534,ETHN 116,A00,887240,Staff,16,0,25,9
1746580525559,ETHN 117,A00,887241,Choi; Esther Min,28,0,30,2
1746580526586,ETHN 118,A00,887243,Staff,24,0,30,6
1746580527617,ETHN 127,A00,887248,Cuong; Marisol,11,0,15,4
1746580528644,ETHN 139,A00,887250,Staff,7,0,10,3
1746580529674,ETHN 142,A00,887252,Staff,10,0,30,20
1746580530702,ETHN 161,A00,887253,Browne; Errol Tsekani,24,0,30,6
1746580531731,ETHN 163FR,A00,887255,Burelle; Julie Sara Veronique,0,0,5,5
1746580532759,GLBH 20,A00,889149,Elwardani; Nile Regina,8,0,42,34
1746580534819,GLBH 111,A01,889152,Burgos; Jose L.,17,0,17,0
1746580535845,GLBH 150,A00,889181,Sloane; Julia Kathryn,0,5,15,15
1746580537899,HDS 60,A01,886406,Warstadt; Melissa Fawn,73,0,80,7
1746580538927,HIAF 111,A00,889324,Gyamfi; Bright,25,0,32,7
1746580539952,HIEA 131,A00,889328,Staff,15,0,32,17
1746580540978,HIEA 144,A00,889333,Henry; Todd A.,26,0,32,6
1746580542006,HIEA 154,A00,889336,Henry; Todd A.,24,0,32,8
1746580543033,HIEU 106,A00,889339,Staff,22,0,32,10
1746580545087,HIEU 114,A00,889340,Staff,4,0,32,28
1746580546111,HIEU 135GS,A00,889342,Patterson; Patrick H.,0,0,1,24
1746580547137,HIEU 137,A00,889343,Edington; Claire Ellen,10,0,25,15
1746580548162,HIEU 148,A00,889345,Staff,14,0,32,18
1746580549188,HIEU 154,A00,889346,Biess; Frank Peter,21,0,32,11
1746580550217,HILA 102,A00,889351,Staff,12,0,32,20
1746580551246,HILD 2A,A01,889221,Lewandoski; Julia Mavis,1,10,32,31
1746580552271,HILD 7B,A01,889225,Man; Simeon S,0,12,32,32
1746580553296,HILD 7C,A01,889288,Alvarez; Luis A,0,14,32,32
1746580554322,HILD 30,A01,889323,Staff,0,5,32,32
1746580556376,HISC 119,A00,889383,Golan; Tal,19,0,32,13
1746580557401,HIUS 103,A00,889384,Man; Simeon S,0,0,32,32
1746580558431,HIUS 117,A00,919797,Kwak; Nancy,19,0,32,13
1746580559457,HIUS 142A,A00,919788,Staff,22,0,32,10
1746580561508,HIUS 149,A00,889386,Gyamfi; Bright,26,0,32,6
1746580562535,HIUS 155,A00,889387,Alvarez; Luis A,15,0,32,17
1746580563560,HUM 3,A01,886499,Caldwell; Michael Alan,19,0,50,31
1746580564589,HUM 3GS,A00,886500,Rodriguez; Bretton Sigfred,0,0,0,28
1746580565614,HUM 3R,A01,886502,Markman; Kristina,0,36,50,50
1746580566637,HUM 4,A01,886504,Crum; Matthew Stephen,23,0,50,27
1746580566637,HUM 4,B01,886506,West; Geoffrey Scott,17,0,50,33
1746580567663,HUM 4GS,A00,886507,Staff,0,0,0,19
1746580568691,HUM 5,A01,886509,Staff,32,0,50,18
1746580569719,HUM 5R,A01,886511,Zavodny; Tatiana Sophia,0,39,50,50
1746580570744,JAPN 180,A00,886407,Staff,16,0,40,24
1746580571771,LATI 50,A01,886409,Martin-Cabrera; Luis,3,0,22,19
1746580571771,LATI 50,A02,886410,Martin-Cabrera; Luis,19,0,22,3
1746580571771,LATI 50,A03,886411,Martin-Cabrera; Luis,21,0,22,1
1746580571771,LATI 50,A04,886412,Martin-Cabrera; Luis,8,0,22,14
1746580572796,LAWS 101,A00,907664,Staff,28,0,60,32
1746580573824,LIAB 1A,A00,889388,Saab; Dima,17,0,20,3
1746580574849,LIAB 1AX,A00,889389,El Cheddadi; Youniss,18,0,20,2
1746580575873,LIFR 1C,A00,889391,Van Moer; Vinciane G,8,0,20,12
1746580576900,LIFR 1CX,A00,889392,Van Moer; Vinciane G,7,0,20,13
1746580577927,LIFR 1D,A00,889393,Van Moer; Vinciane G,7,0,20,13
1746580578951,LIFR 1DX,A00,889394,Van Moer; Vinciane G,8,0,20,12
1746580579980,LIGN 7,A00,886923,Staff,24,0,50,26
1746580581005,LIGN 17,A00,886924,Kehler; Andrew Scott,125,0,150,25
1746580582030,LTAM 110,A00,889395,Staff,15,0,30,15
1746580583060,LTAM 110GS,A00,958010,Rodriguez; Bretton Sigfred,0,0,0,28
1746580584088,LTCH 101,A00,889397,Staff,23,0,25,2
1746580585118,LTCS 130,A00,889398,Staff,23,0,25,2
1746580586143,LTEA 138,A00,889399,Staff,24,0,40,16
1746580587168,LTEN 149,A00,889400,Wesling; Megan E.,0,3,25,25
1746580588195,LTEN 169,A00,889401,Staff,20,0,25,5
1746580589219,LTEN 180,A00,889402,Staff,10,0,15,5
1746580590246,LTEN 181,A00,889403,Staff,21,0,25,4
1746580591271,LTWL 100,A00,889404,Myerston Santana; Jacobo,2,0,25,23
1746580592295,LTWL 180GS,A00,889405,Staff,0,0,20,20
1746580593321,LTWL 181,A00,889406,Staff,16,0,25,9
1746580594347,LTWL 184,A00,889475,Mukherjee; Silpa,22,0,25,3
1746580595372,LTWR 102C,A00,889486,Staff,29,0,30,1
1746580596396,LTWR 115W,A00,889491,Staff,0,2,15,15
1746580597426,MAE 8,A01,886905,Staff,0,2,0,0
1746580598456,MAE 11,A00,886906,Bandaru; Prabhakar,0,7,50,50
1746580599485,MAE 20,A00,886907,Evdokimenko; Ekaterina,43,0,70,27
1746580600509,MAE 30B,A00,886909,Ghazinejad; Maziar,26,0,45,19
1746580601539,MAE 101B,A00,886910,Saintillan; David,29,0,45,16
1746580602563,MAE 105,A00,886911,Bandaru; Prabhakar,18,0,50,32
1746580603589,MAE 107,B00,958024,Staff,8,0,50,42
1746580604616,MAE 143B,A00,886913,Bewley; Thomas R,3,0,40,37
1746580605643,MAE 148,A01,886915,Silberman; Jack,0,3,14,14
1746580606711,MAE 160,A00,886916,Evdokimenko; Ekaterina,31,0,60,29
1746580607737,MATH 3C,A01,889681,Staff,0,2,30,30
1746580607737,MATH 3C,A02,960048,Staff,24,0,30,6
1746580608763,MATH 10A,A01,889760,Staff,26,0,30,4
1746580608763,MATH 10A,A02,889783,Staff,29,0,30,1
1746580609790,MATH 10B,A01,889785,Verstraete; Jacques Allan,2,0,35,33
1746580609790,MATH 10B,A02,889795,Verstraete; Jacques Allan,4,0,35,31
1746580609790,MATH 10B,B01,889797,Verstraete; Jacques Allan,3,0,35,32
1746580609790,MATH 10B,B02,889828,Verstraete; Jacques Allan,3,0,35,32
1746580610817,MATH 10C,A01,889849,Habib; Yousaf,7,0,30,23
1746580610817,MATH 10C,A02,889852,Habib; Yousaf,14,0,30,16
1746580610817,MATH 10C,A03,889853,Habib; Yousaf,22,0,30,8
1746580610817,MATH 10C,A04,889858,Habib; Yousaf,20,0,30,10
1746580610817,MATH 10C,B01,889861,Staff,1,0,30,29
1746580610817,MATH 10C,B02,889862,Staff,24,0,30,6
1746580610817,MATH 10C,B03,889863,Staff,27,0,30,3
1746580610817,MATH 10C,B04,889967,Staff,23,0,30,7
1746580611847,MATH 18,A01,889974,Staff,7,0,30,23
1746580611847,MATH 18,A02,889977,Staff,20,0,30,10
1746580611847,MATH 18,B01,889984,Hardiman; Liam,20,0,30,10
1746580611847,MATH 18,B02,889985,Hardiman; Liam,25,0,30,5
1746580612876,MATH 20A,A01,889990,Suk; Andrew Hoon,30,0,35,5
1746580613908,MATH 20B,A01,889993,Ohm; Ko Woon,22,0,30,8
1746580613908,MATH 20B,A02,889994,Ohm; Ko Woon,30,0,30,0
1746580613908,MATH 20B,B01,889996,Ohm; Ko Woon,22,0,30,8
1746580613908,MATH 20B,B02,889997,Ohm; Ko Woon,23,0,30,7
1746580614935,MATH 20C,A01,889999,Hammock; Frances H,17,0,30,13
1746580614935,MATH 20C,A02,890003,Hammock; Frances H,23,0,30,7
1746580614935,MATH 20C,B01,890006,Hammock; Frances H,3,0,30,27
1746580614935,MATH 20C,B02,890007,Hammock; Frances H,12,0,30,18
1746580615963,MATH 20D,A01,890011,Cheng; Hsiao-Bing,1,1,30,29
1746580615963,MATH 20D,A02,890012,Cheng; Hsiao-Bing,14,0,30,16
1746580615963,MATH 20D,B01,890016,Cheng; Hsiao-Bing,13,0,30,17
1746580615963,MATH 20D,B02,890017,Cheng; Hsiao-Bing,13,0,30,17
1746580616994,MATH 20E,A01,890026,Harel; Guershon,1,0,30,29
1746580616994,MATH 20E,A02,890029,Harel; Guershon,23,0,30,7
1746580616994,MATH 20E,B01,890033,Harel; Guershon,7,0,30,23
1746580616994,MATH 20E,B02,890101,Harel; Guershon,21,0,30,9
1746580618023,MATH 102,A01,890104,Staff,18,0,30,12
1746580618023,MATH 102,A02,890105,Staff,27,0,30,3
1746580619052,MATH 103B,A01,890116,Salehi Golsefidy; Alireza,3,0,30,27
1746580619052,MATH 103B,B01,890118,Staff,0,3,34,34
1746580620083,MATH 109,A01,890121,Aliabadi Sr.; Mohsen,0,0,30,30
1746580620083,MATH 109,B01,890124,Upadrashta; Pranav Kumar,18,0,30,12
1746580621108,MATH 120A,A01,890126,Eggers; John Dietrich,13,0,30,17
1746580622136,MATH 142B,A01,890128,Ioana; Adrian,19,0,30,11
1746580622136,MATH 142B,A02,890129,Ioana; Adrian,12,0,30,18
1746580623166,MATH 154,A01,890174,Staff,0,0,30,30
1746580623166,MATH 154,A02,890182,Staff,0,0,30,30
1746580624191,MATH 168A,A01,890197,Dumitriu; Ioana,21,0,35,14
1746580625219,MATH 170A,A01,890240,Nie; Jiawang,1,0,30,29
1746580625219,MATH 170A,A02,890241,Nie; Jiawang,11,0,30,19
1746580625219,MATH 170A,A03,890249,Nie; Jiawang,23,0,30,7
1746580626244,MATH 170B,A01,957891,Nag; Panchali,13,0,35,22
1746580628295,MATH 181A,A01,908025,Staff,0,3,35,35
1746580628295,MATH 181A,A02,960115,Staff,26,0,35,9
1746580629323,MATH 181B,A01,959874,Staff,25,0,30,5
1746580630353,MATH 193B,A01,890265,Staff,0,4,35,35
1746580631382,MGT 4,A01,890311,Anderson; John Charles,42,0,88,46
1746580632415,MGT 5,A00,907740,Staff,13,0,98,85
1746580633442,MGT 12,A00,890312,Lindenberger; Wade Douglas,67,0,98,31
1746580634467,MGT 16,A00,957883,Staff,78,0,98,20
1746580636515,MGT 45,A00,890314,Pecore; Joseph P.,45,0,98,53
1746580637544,MGT 71,A00,890315,Staff,0,12,98,98
1746580638569,MGT 100,A00,890316,Yavorsky; Daniel Ryan,44,0,98,54
1746580639600,MGT 103,A00,890317,Ehrich; Kristine R,73,0,98,25
1746580640625,MGT 105,A00,890356,Bates; Kenneth Walter,0,8,98,98
1746580641651,MGT 112,A00,890360,Ehrich; Kristine R,55,0,98,43
1746580642682,MGT 127R,A00,907732,Zhu; Kevin Xiaoguo,23,0,98,75
1746580643710,MGT 131B,A00,890361,Anderson; John Charles,59,0,98,39
1746580644734,MGT 137,A00,890362,Lindenberger; Wade Douglas,65,0,98,33
1746580645765,MGT 160,A00,890369,Johnson; Erik Barry,9,0,98,89
1746580647814,MGT 164,A00,890372,Zimmermann; Carsten,0,40,98,98
1746580648849,MGT 180,A00,890374,Bliss; Barbara Ann,12,0,98,86
1746580649875,MMW 15,A01,886414,Chang; Edmond Yi-Teh,0,12,28,28
1746580649875,MMW 15,A02,886415,Chang; Edmond Yi-Teh,0,8,28,28
1746580649875,MMW 15,A03,886416,Chang; Edmond Yi-Teh,0,9,28,28
1746580649875,MMW 15,A04,886417,Chang; Edmond Yi-Teh,0,8,28,28
1746580649875,MMW 15,B01,886419,Chang; Edmond Yi-Teh,0,7,28,28
1746580649875,MMW 15,B02,886420,Chang; Edmond Yi-Teh,0,8,28,28
1746580649875,MMW 15,B03,886421,Chang; Edmond Yi-Teh,0,7,28,28
1746580649875,MMW 15,B04,886422,Chang; Edmond Yi-Teh,0,8,28,28
1746580649875,MMW 15,C01,886424,Staff,0,9,28,28
1746580649875,MMW 15,C02,886425,Staff,0,8,28,28
1746580649875,MMW 15,C03,886426,Staff,0,8,28,28
1746580649875,MMW 15,C04,886427,Staff,0,8,28,28
1746580649875,MMW 15,C05,958038,Staff,0,8,28,28
1746580649875,MMW 15,C06,958039,Staff,1,8,28,27
1746580650902,MMW 15GS,A00,906910,Patterson; Patrick H.,4,0,28,24
1746580651931,MMW 122R,A01,886429,Rahimi; Babak,0,13,28,28
1746580651931,MMW 122R,A02,886430,Rahimi; Babak,0,12,28,28
1746580651931,MMW 122R,A03,958040,Rahimi; Babak,0,11,28,28
1746580652958,MUS 1A,A01,890937,Staff,2,0,25,23
1746580652958,MUS 1A,A02,891035,Staff,6,0,25,19
1746580652958,MUS 1A,C01,958912,Staff,24,0,25,1
1746580652958,MUS 1A,C02,958913,Staff,25,0,25,0
1746580655013,MUS 2AK,A00,957092,Ohnishi; Takae,15,0,15,0
1746580656041,MUS 4,A01,891044,Staff,1,0,25,24
1746580656041,MUS 4,A02,891045,Staff,23,0,25,2
1746580656041,MUS 4,B01,891048,Staff,17,0,25,8
1746580656041,MUS 4,B02,891050,Staff,25,0,25,0
1746580657067,MUS 5,A01,957506,Dubnov; Shlomo,0,0,25,25
1746580657067,MUS 5,A02,957622,Dubnov; Shlomo,13,0,25,12
1746580657067,MUS 5,A03,957623,Dubnov; Shlomo,20,0,25,5
1746580658094,MUS 6,A01,891053,Freitas Caetano; Marcelo,24,0,25,1
1746580658094,MUS 6,A02,891054,Freitas Caetano; Marcelo,23,0,25,2
1746580659120,MUS 7,A01,891081,Staff,1,0,25,24
1746580659120,MUS 7,A02,891082,Staff,3,0,25,22
1746580660149,MUS 8GS,A00,891118,Borgo; David Garcia,1,0,25,24
1746580661178,MUS 11,A01,891140,Staff,9,0,25,16
1746580661178,MUS 11,A02,891141,Staff,21,0,25,4
1746580662203,MUS 13,A01,891143,Staff,8,0,25,17
1746580662203,MUS 13,A02,891144,Staff,24,0,25,1
1746580663227,MUS 15,A01,891146,Staff,9,0,25,16
1746580663227,MUS 15,A02,891148,Staff,21,0,25,4
1746580663227,MUS 15,B01,891150,Staff,18,0,25,7
1746580663227,MUS 15,B02,891151,Staff,25,0,25,0
1746580664254,MUS 20,A01,891153,Staff,5,0,20,15
1746580664254,MUS 20,A02,891155,Staff,14,0,20,6
1746580665280,MUS 80,A00,891156,Staff,19,0,25,6
1746580665280,MUS 80,B00,891157,Staff,23,0,25,2
1746580666308,MUS 130,A00,891158,Ohnishi; Takae,35,0,35,0
1746580667334,MUS 150GS,A01,891160,Borgo; David Garcia,1,0,25,24
1746580668359,MUS 170,A01,891162,Freitas Caetano; Marcelo,20,0,25,5
1746580668359,MUS 170,A02,891164,Freitas Caetano; Marcelo,21,0,25,4
1746580669387,NANO 11,A00,886220,Vazquez Mena; Oscar,13,0,15,2
1746580670413,NANO 15,A01,886222,Drews; Aaron,4,0,7,3
1746580671439,NANO 104,A00,886224,Sirbuly; Donald,17,0,25,8
1746580672464,PH 40,A00,886528,Staff,24,0,40,16
1746580673489,PH 45,A01,886799,Staff,35,0,40,5
1746580674518,PH 110,A00,886802,Staff,0,7,40,40
1746580675547,PH 172,A00,906716,Staff,19,0,35,16
1746580676572,PH 191,A00,886803,Staff,6,0,40,34
1746580677601,PHIL 1,A00,889500,Staff,20,0,30,10
1746580678628,PHIL 10,A01,889549,Grush; Rick Scott,16,0,22,6
1746580678628,PHIL 10,A02,889551,Grush; Rick Scott,22,0,22,0
1746580679657,PHIL 28,A01,889559,Lamey; Andy M.,0,2,31,31
1746580679657,PHIL 28,A02,889561,Lamey; Andy M.,0,1,30,30
1746580679657,PHIL 28,A03,889572,Lamey; Andy M.,0,1,30,30
1746580680684,PHIL 35,A00,907839,Staff,13,0,15,2
1746580681709,PHIL 60,A00,889574,Staff,73,0,90,17
1746580682735,PHIL 101,A00,958004,Staff,12,0,15,3
1746580684789,PHIL 136,A00,889582,Fulkerson; Matthew Todd,26,0,45,19
1746580685816,PHIL 163,A01,889601,Staff,21,0,30,9
1746580685816,PHIL 163,B01,889606,Brandt; Reuven A,0,3,0,0
1746580686844,PHIL 164,A00,889610,Staff,16,0,30,14
1746580687869,PHIL 165,A00,889613,Staff,22,0,30,8
1746580688894,PHYS 1A,A00,886431,Staff,28,0,70,42
1746580689924,PHYS 1AL,001,886432,Tsai; Philbert S,1,2,30,29
1746580689924,PHYS 1AL,002,886436,Tsai; Philbert S,11,0,30,19
1746580690954,PHYS 1B,A00,886439,Staff,184,0,240,56
1746580691980,PHYS 1BL,001,886441,Tsai; Philbert S,0,4,30,30
1746580691980,PHYS 1BL,002,886444,Tsai; Philbert S,2,0,30,28
1746580693005,PHYS 1C,A00,896092,Arnold; Kam S,78,0,146,68
1746580694031,PHYS 1CL,001,886448,Tsai; Philbert S,0,0,30,30
1746580694031,PHYS 1CL,002,886449,Tsai; Philbert S,1,0,30,29
1746580694031,PHYS 1CL,003,886450,Tsai; Philbert S,16,0,30,14
1746580694031,PHYS 1CL,004,886451,Tsai; Philbert S,15,0,30,15
1746580695055,PHYS 2B,A01,886457,Staff,68,0,115,47
1746580696084,PHYS 2C,A01,886460,Shotwell; Brian,0,9,65,65
1746580697109,PHYS 2CL,A01,886467,Staff,0,4,28,28
1746580697109,PHYS 2CL,A02,886468,Staff,0,3,28,28
1746580698140,PHYS 2D,A01,886470,Staff,10,0,50,40
1746580699169,PHYS 4B,A01,886475,Grinstein; Benjamin,22,0,40,18
1746580700193,POLI 5,A00,891173,Desposato; Scott,7,0,25,18
1746580701220,POLI 5D,A01,891175,Staff,5,0,5,0
1746580701220,POLI 5D,B01,891178,Staff,5,0,5,0
1746580702250,POLI 11,A00,891179,Ferree; Karen E,2,0,35,33
1746580703279,POLI 12,A00,891180,Staff,16,0,30,14
1746580704308,POLI 27,A01,891182,Staff,12,0,75,63
1746580705336,POLI 30,A00,891183,Staff,8,0,50,42
1746580706366,POLI 100B,A00,891244,Staff,5,1,35,30
1746580707391,POLI 100I,A00,891247,Staff,7,0,30,23
1746580708420,POLI 104J,A00,891248,Nichter; Maysa,14,0,30,16
1746580709448,POLI 104U,A00,891250,Nichter; Maysa,1,0,30,29
1746580711554,POLI 110B,A00,891255,Wiens; David,19,0,25,6
1746580712583,POLI 112A,A00,891256,Wiens; David,6,0,25,19
1746580713610,POLI 114BR,A00,891261,Staff,19,0,30,11
1746580714635,POLI 117R,A00,891262,Forman; Fonna,0,6,50,50
1746580715660,POLI 118,A00,891264,Ingham; Sean,17,0,25,8
1746580716687,POLI 124A,A00,891265,Staff,18,0,20,2
1746580717716,POLI 125D,A00,891266,Nichter; Simeon C,2,0,25,23
1746580718746,POLI 126,A00,891268,Nichter; Simeon C,7,0,25,18
1746580719773,POLI 126AA,A00,891272,Staff,15,0,25,10
1746580720797,POLI 130AA,A00,891273,Staff,15,0,20,5
1746580721826,POLI 134AA,A00,891274,Staff,4,0,20,16
1746580723876,POLI 138,A00,891278,Staff,21,0,25,4
1746580724901,POLI 142K,A00,891280,Staff,10,0,25,15
1746580725930,POLI 142M,A00,891281,Gartzke; Erik,16,0,30,14
1746580726959,POLI 142P,A00,891284,Staff,20,0,30,10
1746580727987,POLI 143,A00,891285,Gartzke; Erik,12,0,30,18
1746580729017,POLI 153,A00,891286,Staff,19,0,20,1
1746580731068,POLI 175,A00,891290,Staff,15,0,20,5
1746580732095,PSYC 1,A00,890674,Steiner; Eric Tomas,0,11,45,45
1746580733125,PSYC 2,A00,890676,Albright; Thomas D,20,0,35,15
1746580734154,PSYC 3,A00,890679,Staff,17,0,20,3
1746580735179,PSYC 6,A00,959858,Staff,19,0,20,1
1746580736209,PSYC 60,A01,890684,Rickard; Timothy C.,0,5,45,45
1746580737234,PSYC 70,A01,890689,Geller; Emma Harlan,6,0,30,24
1746580738259,PSYC 71,A01,959860,Staff,21,0,25,4
1746580739289,PSYC 100,A00,890690,Lacefield; Katharine I,0,50,180,180
1746580740315,PSYC 102,A00,890695,Staff,18,0,40,22
1746580741341,PSYC 105,A00,890699,Geller; Emma Harlan,70,0,100,30
1746580742367,PSYC 106,A00,890701,Gorman; Michael R.,5,0,30,25
1746580743393,PSYC 108,A00,890704,Adrian; Julia Anna,0,28,50,50
1746580744421,PSYC 118,A01,890712,Staff,11,0,30,19
1746580745448,PSYC 124,A00,890716,Chapman; Eddie Nathaniel,25,0,60,35
1746580746477,PSYC 131,A00,890717,Anagnostaras; Stephan,0,7,80,80
1746580747503,PSYC 137,A00,890719,Winkielman; Piotr,0,11,30,30
1746580748527,PSYC 144,A00,890721,Adrian; Julia Anna,0,9,45,45
1746580749553,PSYC 162,A00,890805,Staff,0,0,75,75
1746580750582,PSYC 169,A00,890810,Staff,0,14,30,30
1746580751607,PSYC 172,A00,890814,Gorman; Michael R.,9,0,30,21
1746580752636,PSYC 181,A00,890818,Anagnostaras; Stephan,7,0,200,193
1746580753660,PSYC 184,A00,959861,Staff,164,0,175,11
1746580754685,PSYC 189,A00,890823,Staff,0,2,30,30
1746580755711,PSYC 191,A00,890884,Rickard; Timothy C.,0,12,35,35
1746580756741,PSYC 193,A00,890913,Staff,19,0,30,11
1746580756741,PSYC 193,B00,890914,Chapman; Eddie Nathaniel,24,0,30,6
1746580757765,PSYC 193L,A01,890918,Lowe; Angela Beth,20,0,30,10
1746580757765,PSYC 193L,B01,890921,Hurwitz; Ethan Scott,20,0,30,10
1746580757765,PSYC 193L,C01,890928,Staff,30,0,30,0
1746580758790,RELI 149,A00,886806,Rahimi; Babak,23,0,40,17
1746580759818,SE 9,A01,886814,Staff,7,0,20,13
1746580760843,SE 101B,A01,886816,Chadha; Mayank,4,0,35,31
1746580761871,SE 110B,A00,886818,Zhu; Qiang,4,0,75,71
1746580762900,SE 125,A01,886830,Staff,10,0,30,20
1746580763925,SE 130B,A01,886835,Staff,14,0,40,26
1746580764953,SE 131A,A01,886838,Krysl; Petr,34,0,55,21
1746580765981,SE 154,A00,886840,Staff,29,0,50,21
1746580767006,SE 164GS,A01,886849,Staff,6,0,20,14
1746580768034,SE 167GS,A01,886853,Staff,6,0,20,14
1746580769061,SIO 25,A01,890107,Staff,19,0,30,11
1746580770088,SIO 45,A00,890109,Cook; Geoffrey W,116,0,200,84
1746580771118,SIO 109R,A00,890110,Forman; Fonna,0,16,20,20
1746580772143,SIO 187,A01,890114,Kacev; David,15,0,40,25
1746580773169,SOCI 1,A01,890431,Thorpe; Charles Robert,14,0,30,16
1746580773169,SOCI 1,A02,890518,Thorpe; Charles Robert,30,0,30,0
1746580774194,SOCI 2,A01,957978,Staff,25,0,25,0
1746580774194,SOCI 2,A02,957979,Staff,23,0,25,2
1746580775218,SOCI 20,A01,890523,Calderon-Zaks; Michael Aar,21,0,30,9
1746580775218,SOCI 20,A02,890526,Calderon-Zaks; Michael Aar,29,0,30,1
1746580776248,SOCI 30,A01,890533,Pardo Guerra; Juan Pablo,37,0,40,3
1746580777275,SOCI 40,A01,890535,Staff,27,0,45,18
1746580778300,SOCI 104Q,A00,890559,Staff,18,0,30,12
1746580779327,SOCI 106,A00,890560,Arnal; Maud Marie Leonie,20,0,30,10
1746580780352,SOCI 110,A00,890567,Holkenbrink-Monk; Charlene,19,0,30,11
1746580781381,SOCI 112,A00,890568,Victoria Torres; Pablo,2,0,55,53
1746580782465,SOCI 115,A00,890597,Arnal; Maud Marie Leonie,28,0,45,17
1746580784520,SOCI 121,A00,890604,Pardo Guerra; Juan Pablo,38,0,45,7
1746580785546,SOCI 126,A01,890608,Staff,8,0,10,2
1746580786579,SOCI 127,A00,890609,Staff,18,0,30,12
1746580787605,SOCI 131,A00,890610,Thorpe; Charles Robert,37,0,45,8
1746580788629,SOCI 135,A00,890615,Payne; Christine Anna,13,0,45,32
1746580789655,SOCI 139,A00,890620,Staff,38,0,45,7
1746580790681,SOCI 148E,A00,890622,Calderon-Zaks; Michael Aar,36,0,45,9
1746580791708,SOCI 150,A00,890623,Kohler; Kristopher M.,31,0,45,14
1746580792736,SOCI 157,A00,890625,Jules-Rosette; Bennetta W.,18,0,20,2
1746580793761,SOCI 160,A00,890627,Payne; Christine Anna,21,0,45,24
1746580794790,SYN 1,A00,886855,Fish; Gwendolyn Anne,0,1,0,0
1746580794790,SYN 1,B00,906086,Fish; Gwendolyn Anne,0,2,0,2
1746580795816,SYN 2R,A00,886860,Staff,0,17,15,15
1746580795816,SYN 2R,B00,906106,Atkinson; Arthur Laird,0,16,15,15
1746580796850,SYN 100,A01,886866,Browne; Emily,0,28,20,20
1746580796850,SYN 100,B01,906128,Rock; Martin,0,4,20,20
1746580796850,SYN 100,C01,906140,Deavenport; James Cary,0,3,20,20
1746580796850,SYN 100,D01,907816,Deavenport; James Cary,0,5,20,20
1746580797875,TDAC 1,A00,890286,Walsh; Kim C.,7,0,20,13
1746580798900,TDAC 101,A00,890296,Basso; Beatrice,15,0,20,5
1746580799925,TDDE 131,A00,890297,Staff,47,0,50,3
1746580800950,TDDM 1,A00,890287,Weinberg; Sadie,25,0,30,5
1746580801981,TDGE 11,A00,890288,Fulton; Julia,138,0,200,62
1746580801981,TDGE 11,B00,890289,Castro; Robert Jess,184,0,200,16
1746580803010,TDGE 25,B00,957359,Walsh; Kim C.,5,0,20,15
1746580804038,TDGE 40,A01,890292,Power; Jade Yukana,27,0,30,3
1746580805065,TDGE 124,A00,890298,Havis; Allan,0,1,50,50
1746580806091,TDGE 131R,A00,890299,Burelle; Julie Sara Veronique,15,0,42,27
1746580807116,TDHT 101,A00,890300,Staff,10,0,20,10
1746580808141,TDHT 109,A01,890302,Anderson; Mysia Anyse,31,0,40,9
1746580809171,TDMV 1,A00,890293,Arcidiacono; Kristin,18,0,30,12
1746580810197,TDMV 2,A00,890294,Weinberg; Sadie,23,0,30,7
1746580811222,TDMV 3,A00,957878,Arcidiacono; Kristin,28,0,30,2
1746580813274,TDMV 138,A00,890304,Jun; Grace Shin Hae,25,0,40,15
1746580814341,TDMV 140,A00,890305,Corrales; Joseph Bernales,25,0,30,5
1746580815367,TDMV 142,A00,890307,Caligagan; Tony,32,0,40,8
1746580816396,TDMV 144,A00,890308,Camaya; Michelle Ann,25,0,30,5
1746580817421,TDPW 1,A00,890295,Stein; Deborah Isobel,3,0,20,17
1746580818448,USP 2,A01,890272,Lerner; Amy M,7,0,20,13
1746580819473,USP 3,A01,890274,Staff,12,0,30,18
1746580820501,USP 15,A01,890276,Sun; Feiyang,16,0,30,14
1746580821526,USP 25,A00,890277,Shenkman; Michael Thomas,18,0,25,7
1746580822551,USP 138,A00,890278,Staff,14,0,25,11
1746580823577,USP 143,A00,890279,Staff,22,0,70,48
1746580824607,USP 144,A00,890280,Chowdhury; Muhammed Zohir,16,0,30,14
1746580825634,USP 150,A00,890281,Boomhower; Matthew Charles,4,0,30,26
1746580826661,USP 151,A00,890282,Staff,16,0,20,4
1746580827687,USP 162,A00,890283,Andrews; Abigail Leslie,16,0,20,4
1746580828715,USP 168,A00,920477,Kwak; Nancy,0,0,5,5
1746580829740,USP 181,A00,890284,Staff,3,0,20,17
1746580830767,USP 191A,A00,890285,Staff,12,0,20,8
1746580831793,VIS 101,A00,886512,Staff,26,0,75,49
1746580832818,VIS 103,A00,886513,Cruz; Edwin Teddy,61,0,75,14
1746580833851,VIS 108,A00,886514,Staff,3,0,15,12
1746580834880,VIS 127P,A00,886515,Shen; Kuiyi,79,0,146,67
1746580835906,VIS 149,A00,886516,Yoldas; Pinar,0,0,15,15
1746580836932,VIS 164,A00,886526,Erdmann; Dean,19,0,22,3
1746580837957,VIS 194S,A00,886527,Staff,61,0,75,14
1746580838984,WCWP 10A,C00,886484,Martiniuk; Jill,12,0,15,3
1746580840016,WCWP 10B,A00,886490,Uriarte; Emma,0,0,15,15
1746580840016,WCWP 10B,B00,886491,Dhir; Simrita,8,0,15,7
1746580840016,WCWP 10B,C00,886492,Ornelas; Tricia,0,0,15,15
1746580841046,WCWP 100,A00,886494,Young; Mark T,0,6,15,15
1746580843129,AAS 10,A01,886199,Childs; Dennis R.,0,3,0,0
1746580844158,ANAR 104,A01,886940,Shtienberg; Gilad,27,0,30,3
1746580845183,ANAR 120,A00,886953,Staff,13,0,20,7
1746580846210,ANBI 148,A01,886955,Wilder; Linnea Lorene,30,0,40,10
1746580848261,ANSC 122,A00,886957,Staff,25,0,30,5
1746580849288,ANSC 150,A00,886958,Sloane; Julia Kathryn,2,0,15,13
1746580850315,ANSC 156,A00,886959,Jenkins; Janis A.,0,1,15,15
1746580851340,ANSC 180,A00,886960,Staff,11,0,17,6
1746580852365,ANSC 188,A00,886961,Jassal; Aftab,9,0,25,16
1746580853394,ANSC 190,A00,886962,Jassal; Aftab,14,0,25,11
1746580854422,ANSC 191,A00,886963,Staff,18,0,20,2
1746580855447,ANTH 3,A01,891689,Staff,17,0,20,3
1746580856473,ANTH 5,A00,886933,Semendeferi; Ekaterini,16,0,20,4
1746580857497,ANTH 10,A00,886934,Staff,0,12,30,30
1746580858527,ANTH 21,A01,886936,Staff,41,0,60,19
1746580859554,ANTH 23,A01,886938,Staff,92,0,100,8
1746580860578,ANTH 105,A00,886964,Stewart; Alexander B,84,0,100,16
1746580861607,ANTH 108,A00,886965,Pedersen; David,9,0,20,11
1746580862635,AWP 10,001,886147,Staff,0,0,0,0
1746580862635,AWP 10,002,886148,Staff,0,0,0,0
1746580862635,AWP 10,003,886149,Staff,0,0,0,0
1746580862635,AWP 10,004,886150,Staff,0,0,0,0
1746580862635,AWP 10,005,886151,Staff,0,0,0,0
1746580862635,AWP 10,006,886152,Staff,0,0,0,0
1746580862635,AWP 10,007,886153,Staff,0,0,0,0
1746580862635,AWP 10,008,886154,Staff,0,0,0,0
1746580862635,AWP 10,009,886155,Staff,0,0,0,0
1746580862635,AWP 10,010,886156,Staff,0,0,0,0
1746580862635,AWP 10,011,886158,Staff,0,0,0,0
1746580862635,AWP 10,012,886160,Staff,0,0,0,0
1746580862635,AWP 10,013,886161,Staff,0,0,0,0
1746580862635,AWP 10,014,886162,Staff,0,0,0,0
1746580862635,AWP 10,015,886163,Staff,0,0,0,0
1746580862635,AWP 10,016,886164,Staff,0,0,0,0
1746580862635,AWP 10,017,886165,Staff,0,0,0,0
1746580862635,AWP 10,018,886166,Staff,0,0,0,0
1746580862635,AWP 10,019,886168,Staff,0,0,0,0
1746580862635,AWP 10,020,886170,Staff,0,0,0,0
1746580862635,AWP 10,021,886172,Staff,0,0,0,0
1746580863664,AWP 10R,001,886173,Staff,0,1,0,0
1746580863664,AWP 10R,002,886174,Staff,0,1,0,0
1746580863664,AWP 10R,003,886175,Staff,0,0,0,0
1746580863664,AWP 10R,004,886176,Staff,0,0,0,0
1746580863664,AWP 10R,005,886177,Staff,0,0,0,0
1746580863664,AWP 10R,006,886178,Staff,0,0,0,0
1746580863664,AWP 10R,007,886179,Staff,0,0,0,0
1746580863664,AWP 10R,008,886181,Staff,0,0,0,0
1746580863664,AWP 10R,009,886182,Staff,0,0,0,0
1746580863664,AWP 10R,010,886183,Staff,0,0,0,0
1746580863664,AWP 10R,011,886184,Staff,0,0,0,0
1746580863664,AWP 10R,012,886185,Staff,0,0,0,0
1746580863664,AWP 10R,013,886186,Staff,0,0,0,0
1746580863664,AWP 10R,014,886187,Staff,0,0,0,0
1746580863664,AWP 10R,015,886188,Staff,0,0,0,0
1746580863664,AWP 10R,016,886189,Staff,0,0,0,0
1746580863664,AWP 10R,017,960532,Staff,0,0,0,0
1746580863664,AWP 10R,018,960533,Staff,0,0,0,0
1746580863664,AWP 10R,019,960534,Staff,0,0,0,0
1746580863664,AWP 10R,020,960538,Staff,0,0,0,0
1746580863664,AWP 10R,021,960540,Staff,0,0,0,0
1746580863664,AWP 10R,022,960541,Staff,0,0,0,0
1746580863664,AWP 10R,023,960542,Staff,0,0,0,0
1746580863664,AWP 10R,024,960544,Staff,0,0,0,0
1746580863664,AWP 10R,025,960545,Staff,0,0,0,0
1746580863664,AWP 10R,026,960548,Staff,0,0,0,0
1746580864689,AWP 102R,A00,886190,Staff,0,0,0,0
1746580864689,AWP 102R,B00,886191,Staff,0,0,0,0
1746580865715,BENG 100,A01,886193,Staff,17,0,30,13
1746580866747,BENG 122A,A01,886195,Hasty; Jeff M,13,0,30,17
1746580867772,BENG 166A,A00,886196,Sah; Robert Lie-Yuan,0,3,30,30
1746580868799,BENG 190,A00,958050,Khojah; Reem I,18,0,25,7
1746580869827,BIBC 102,A01,894320,Staff,0,0,46,46
1746580869827,BIBC 102,A02,894321,Staff,0,0,46,46
1746580869827,BIBC 102,A03,894344,Staff,6,0,46,40
1746580869827,BIBC 102,A04,894345,Staff,27,0,47,20
1746580870859,BICD 100R,A01,894365,Smith; Laurie,0,3,58,58
1746580870859,BICD 100R,A02,894366,Smith; Laurie,0,5,58,58
1746580870859,BICD 100R,A03,894367,Smith; Laurie,0,0,59,59
1746580870859,BICD 100R,A04,959869,Smith; Laurie,40,0,59,19
1746580871889,BICD 136,A01,894383,Gustafson-Brown; Cindy,14,0,50,36
1746580872919,BIEB 102,A01,894494,Butler; Shannon Rhey,51,0,130,79
1746580874970,BIEB 150,A01,894617,Wills; Christopher,3,0,20,17
1746580874970,BIEB 150,A02,894631,Wills; Christopher,3,0,20,17
1746580874970,BIEB 150,A03,894937,Wills; Christopher,3,0,20,17
1746580874970,BIEB 150,A04,894946,Wills; Christopher,5,0,20,15
1746580875996,BIEB 194,A00,906141,Kurle; Carolyn M.,6,0,20,14
1746580877023,BILD 1,A01,894154,Staff,3,0,19,16
1746580877023,BILD 1,A02,894155,Staff,14,0,19,5
1746580877023,BILD 1,A03,894160,Staff,13,0,19,6
1746580877023,BILD 1,A04,894161,Staff,15,0,18,3
1746580878049,BILD 2,A01,894168,Staff,0,0,50,50
1746580878049,BILD 2,A02,894169,Staff,0,0,50,50
1746580878049,BILD 2,A03,894179,Staff,0,0,50,50
1746580878049,BILD 2,A04,894203,Staff,24,0,50,26
1746580879078,BILD 3,A01,894213,Staff,23,0,31,8
1746580879078,BILD 3,A02,894214,Staff,26,0,31,5
1746580879078,BILD 3,A03,894235,Staff,28,0,31,3
1746580879078,BILD 3,A04,894236,Staff,28,0,32,4
1746580880106,BILD 4,A01,894253,Reuther; Keefe,5,0,24,19
1746580880106,BILD 4,A02,894258,Reuther; Keefe,16,0,24,8
1746580881132,BILD 5,A01,894276,Reuther; Keefe,35,0,50,15
1746580881132,BILD 5,A02,894277,Reuther; Keefe,45,0,50,5
1746580881132,BILD 5,A03,894290,Reuther; Keefe,44,0,50,6
1746580881132,BILD 5,A04,894291,Reuther; Keefe,48,0,50,2
1746580882158,BILD 24,A01,894297,Pirino; Giorgia,40,0,60,20
1746580883184,BIMM 100,B01,958915,Staff,71,0,100,29
1746580884215,BIMM 101,A01,895017,McDonnell; Lisa Marie,0,5,24,24
1746580884215,BIMM 101,A02,895018,McDonnell; Lisa Marie,0,5,24,24
1746580884215,BIMM 101,B01,895020,McDonnell; Lisa Marie,0,6,24,24
1746580884215,BIMM 101,B02,895021,McDonnell; Lisa Marie,0,4,24,24
1746580885240,BIMM 110,A01,895023,Staff,1,0,25,24
1746580885240,BIMM 110,A02,895024,Staff,9,0,25,16
1746580885240,BIMM 110,A03,895025,Staff,18,0,25,7
1746580885240,BIMM 110,A04,895031,Staff,20,0,25,5
1746580886270,BIMM 120,A01,895114,Gustafson-Brown; Cindy,14,0,28,14
1746580886270,BIMM 120,A02,895126,Gustafson-Brown; Cindy,21,0,27,6
1746580887299,BIPN 100,A01,895130,Yang; Mingyu,0,0,38,38
1746580887299,BIPN 100,A02,895131,Yang; Mingyu,32,0,38,6
1746580887299,BIPN 100,A03,895132,Yang; Mingyu,32,0,38,6
1746580887299,BIPN 100,A04,895133,Yang; Mingyu,27,0,36,9
1746580888328,BIPN 120,A01,895135,Cooke; James Edward,0,3,13,13
1746580888328,BIPN 120,A02,895136,Cooke; James Edward,0,1,13,13
1746580888328,BIPN 120,A03,895137,Cooke; James Edward,0,3,13,13
1746580888328,BIPN 120,A04,895156,Cooke; James Edward,0,2,11,11
1746580889353,BIPN 134,A01,895235,Cooke; James Edward,0,2,25,25
1746580889353,BIPN 134,A02,895237,Cooke; James Edward,0,0,25,25
1746580889353,BIPN 134,A03,895240,Cooke; James Edward,3,0,25,22
1746580889353,BIPN 134,A04,895270,Cooke; James Edward,20,0,25,5
1746580890377,BIPN 189,A00,892103,Staff,0,14,14,14
1746580892431,BISP 194,A00,958008,Staff,0,2,0,0
1746580893460,CAT 124,A01,922009,Staff,0,5,20,20
1746580894487,CAT 125R,A00,886390,Morales; Celeste Georgianna,0,2,20,20
1746580894487,CAT 125R,B00,886391,Irwin; Matthew Joseph,0,4,20,20
1746580894487,CAT 125R,C00,886392,Smith; Lauryn Alissa,0,2,20,20
1746580894487,CAT 125R,D00,886393,Vanderschuit; Maya Alysia,0,3,20,20
1746580894487,CAT 125R,E00,886394,Marchisotto; Jennifer Anne,0,3,20,20
1746580895510,CENG 15,A01,886218,Drews; Aaron,3,0,8,5
1746580896540,CENG 113,A00,886219,Opatkiewicz; Justin Paul,15,0,25,10
1746580897565,CGS 101,A00,887044,Staff,7,0,20,13
1746580898593,CGS 105,A01,887046,Staff,14,0,25,11
1746580899620,CGS 112,A00,887047,Cuong; Marisol,12,0,15,3
1746580900648,CGS 113,A00,887048,Staff,23,0,30,7
1746580901673,CGS 120,A00,887049,Staff,10,0,17,7
1746580902699,CHEM 6A,A01,886336,Lam; Tin Yiu,38,0,50,12
1746580902699,CHEM 6A,A02,886338,Lam; Tin Yiu,37,0,50,13
1746580903726,CHEM 6B,A01,886341,Hopkins; Patrycja Anna,16,0,50,34
1746580903726,CHEM 6B,A02,886343,Hopkins; Patrycja Anna,42,0,50,8
1746580904757,CHEM 6C,A01,886346,Albizati; Kim F.,0,2,50,50
1746580904757,CHEM 6C,A02,886348,Albizati; Kim F.,23,0,50,27
1746580905782,CHEM 40A,A01,886352,Klosterman; Jeremy K,65,0,100,35
1746580906812,CHEM 40B,A01,886356,Klosterman; Jeremy K,0,24,100,100
1746580907837,CHEM 41B,A01,886360,Theodorakis; Emmanuel,25,0,50,25
1746580907837,CHEM 41B,A02,886362,Theodorakis; Emmanuel,47,0,50,3
1746580908863,CHIN 165A,A00,886382,Xu; Li,18,0,20,2
1746580909891,CLAS 120,A00,886387,Myerston Santana; Jacobo,33,0,40,7
1746580910915,COGS 9,A01,886967,Shannon; Kyle Michael,42,0,60,18
1746580911940,COGS 11,A01,886969,Staff,9,0,30,21
1746580912965,COGS 14A,A01,886971,Staff,6,0,60,54
1746580913994,COGS 14B,A01,886973,Hoffman; Drew Ellen,4,0,60,56
1746580915024,COGS 18,A01,886975,Morgan; Eric,35,0,60,25
1746580916053,COGS 20,A01,886977,Staff,4,0,8,4
1746580916053,COGS 20,A02,886978,Staff,5,0,7,2
1746580917082,COGS 100,A01,907783,Staff,1,2,30,29
1746580918160,COGS 101B,A01,886980,Staff,0,4,48,48
1746580919185,COGS 101C,A01,886982,Delgado; Tania,0,5,44,44
1746580920216,COGS 102A,A01,886984,Johnson; Christine M.,4,0,30,26
1746580921253,COGS 118B,A01,886986,Staff,1,4,88,87
1746580922279,COGS 150,A01,886988,Bergen; Benjamin,22,0,50,28
1746580923306,COGS 153,A00,886989,Delgado; Tania,0,2,41,41
1746580924334,COGS 186,A01,886991,Staff,0,0,32,32
1746580925360,COGS 187A,A01,886993,Boyle; Mary E. T.,7,0,30,23
1746580926390,COGS 189,A00,886994,Staff,0,1,30,30
1746580927419,COMM 10,A01,886996,Staff,0,0,20,21
1746580927419,COMM 10,A02,886997,Staff,10,0,20,10
1746580927419,COMM 10,A03,959845,Staff,19,0,20,1
1746580928448,COMM 20,A01,886999,Leuning; Grant Maurstad,24,0,40,16
1746580930506,COMM 100A,A01,887002,Staff,0,0,20,25
1746580930506,COMM 100A,A02,887003,Staff,6,0,20,14
1746580931534,COMM 100B,A01,887005,Staff,0,8,20,24
1746580932559,COMM 106D,A00,887006,Staff,13,0,40,27
1746580933588,COMM 110G,A00,887007,Whitworth-Smith; Andrew C,12,0,40,28
1746580934616,COMM 111B,A00,887008,Staff,31,0,40,9
1746580935641,COMM 113T,A00,887009,Abuelhiga; Soraya Jill,28,0,40,12
1746580935641,COMM 113T,B00,906733,Staff,40,0,40,0
1746580936669,COMM 145,A00,887010,Staff,12,0,40,28
1746580937697,COMM 146,A00,887054,Staff,31,0,40,9
1746580938721,COMM 190,A00,887012,Staff,8,0,23,15
1746580939747,CSE 8A,A50,887015,Cao; Yingjun,57,0,85,28
1746580940773,CSE 11,A01,887017,Cao; Yingjun,12,0,70,58
1746580941799,CSE 20,A01,887019,Staff,30,0,50,20
1746580942825,CSE 21,A01,887021,Staff,78,0,100,22
1746580942825,CSE 21,B01,892583,Braun; Oliver,45,0,50,5
1746580943852,CSE 30,A01,887025,Eldon; John,143,0,200,57
1746580944882,CSE 100,A01,887027,Staff,26,0,50,24
1746580944882,CSE 100,A02,887028,Staff,42,0,50,8
1746580945908,CSE 101,A01,887030,Braun; Oliver,74,0,100,26
1746580945908,CSE 101,B01,887032,Jones; Miles E,0,3,50,50
1746580945908,CSE 101,B02,887033,Jones; Miles E,0,2,50,50
1746580946935,CSE 105,A01,908084,Jones; Miles E,32,0,50,18
1746580946935,CSE 105,A02,908087,Jones; Miles E,31,0,50,19
1746580947961,CSE 135,A01,887035,Powell; Thomas Allan,0,5,50,50
1746580948992,CSE 142,A01,887037,Staff,8,0,60,52
1746580950023,CSE 142L,A01,887039,Staff,34,0,60,26
1746580951054,CSE 151A,A01,887041,Solares; Edwin A,47,0,100,53
1746580952083,CSE 175,A01,887043,Kumar; Rakesh,30,0,30,0
1746580953109,CSS 1,A01,886389,Staff,1,2,40,39
1746580954136,DSC 30,A01,908097,Liao; Soohyun Nam,47,0,75,28
1746580955162,DSC 40A,A01,908099,Shannon; Kyle Michael,30,0,50,20
1746580956190,DSC 40B,A01,908112,Staff,15,0,50,35
1746580957215,DSC 80,A01,908116,Staff,19,0,60,41
1746580958240,DSC 197,001,956863,Eldridge; Justin Matthew,9999,0,9999,0
1746580959270,ECE 5,A01,886400,Morris; Karcher William,1,0,6,5
1746580959270,ECE 5,A02,886401,Morris; Karcher William,3,0,6,3
1746580960299,ECE 148,A01,886403,Silberman; Jack,0,14,14,14
1746580961325,ECON 1,A01,887265,Crane; Meredith Helen,12,0,70,58
1746580961325,ECON 1,B01,887268,Staff,42,0,50,8
1746580962358,ECON 2,A01,887273,Crane; Meredith Helen,55,0,70,15
1746580963388,ECON 3,A01,887279,Rondina; Giacomo,32,0,70,38
1746580964415,ECON 4,A01,887282,Anderson; John Charles,0,2,10,10
1746580965445,ECON 5,A01,887285,Staff,34,0,45,11
1746580965445,ECON 5,B01,887292,Staff,41,0,45,4
1746580966474,ECON 100A,A01,887337,Newhouse; Herbert S,54,0,70,16
1746580966474,ECON 100A,B01,887349,Staff,45,0,50,5
1746580967499,ECON 100B,A01,887361,Du; Songzi,29,0,70,41
1746580968525,ECON 100C,A01,887445,Newhouse; Herbert S,59,0,70,11
1746580969549,ECON 105,A00,887488,Vespa; Emanuel Ignacio,23,0,35,12
1746580970579,ECON 109,A01,887506,Shishkin; Denis,28,0,35,7
1746580971604,ECON 110A,A01,887568,Alon; Titan Michael,0,3,35,35
1746580971604,ECON 110A,B01,907601,Alon; Titan Michael,20,0,35,15
1746580972628,ECON 110B,A01,887598,Levkoff; Steven B.,0,24,70,70
1746580973658,ECON 112,A00,887599,Rondina; Giacomo,19,0,35,16
1746580974685,ECON 120A,A01,887603,Dai; Yinlin,35,0,70,35
1746580975711,ECON 120C,A01,887608,Sun; Yixiao,0,1,35,35
1746580975711,ECON 120C,B01,887614,Sun; Yixiao,0,0,35,35
1746580976738,ECON 138,A00,887621,Bharadwaj; Prashant,0,21,20,20
1746580977763,ECON 144,A00,958007,Squires; Dale E,12,0,35,23
1746580978788,ECON 171,A01,907666,Staff,18,0,35,17
1746580979817,ECON 175,A00,887626,Wu; Pak Yeung,22,0,35,13
1746580980845,ECON 190,A00,887640,Vespa; Emanuel Ignacio,22,0,35,13
1746580981871,EDS 25,A01,888197,Staff,0,0,0,0
1746580981871,EDS 25,A02,888209,Staff,0,0,0,0
1746580981871,EDS 25,A03,888210,Staff,0,0,0,0
1746580981871,EDS 25,A04,888212,Staff,0,0,0,0
1746580981871,EDS 25,A05,888213,Staff,0,0,0,0
1746580981871,EDS 25,A06,888214,Staff,0,0,0,0
1746580981871,EDS 25,A07,888235,Staff,0,2,0,0
1746580981871,EDS 25,A08,888236,Staff,0,0,0,0
1746580981871,EDS 25,A09,888240,Staff,0,0,0,0
1746580981871,EDS 25,A10,888244,Staff,0,0,0,0
1746580981871,EDS 25,B01,888273,Staff,0,0,0,0
1746580981871,EDS 25,B02,888285,Staff,0,0,0,0
1746580981871,EDS 25,B03,888423,Staff,0,0,0,1
1746580981871,EDS 25,B04,888432,Staff,0,0,0,0
1746580981871,EDS 25,B05,888433,Staff,0,0,0,0
1746580981871,EDS 25,B06,888467,Staff,0,0,0,0
1746580981871,EDS 25,B07,888468,Staff,0,0,0,0
1746580981871,EDS 25,B08,888479,Staff,0,0,0,0
1746580981871,EDS 25,B09,888484,Staff,0,0,0,0
1746580981871,EDS 25,B10,888487,Staff,0,0,0,0
1746580982895,EDS 38,A01,907700,Choi; Bailey Miyeon,30,0,30,0
1746580983920,EDS 112,A01,888601,Chapman; Thandeka K,12,0,40,28
1746580984946,EDS 115,A00,888697,Mendez; Kathrina Mendoza,10,0,30,20
1746580985971,EDS 116,A01,888893,Staff,34,0,40,6
1746580988022,EDS 124AR,A00,889133,Staff,29,0,50,21
1746580988022,EDS 124AR,B00,907471,Simon; Elizabeth A,37,0,50,13
1746580989047,EDS 124BR,A00,889134,Simon; Elizabeth A,44,0,100,56
1746580990072,EDS 125,A00,889135,Staff,25,0,30,5
1746580991099,EDS 126,A01,889138,Staff,35,0,40,5
1746580992124,EDS 164R,A01,889142,Wishard Guerra; Alison G.,33,0,50,17
1746580993152,ENG 30,A01,886396,Staff,0,0,0,0
1746580993152,ENG 30,B01,886398,Staff,0,0,0,0
1746580994178,ENVR 102,A00,906150,Montejo; Carolina,23,0,25,2
1746580995203,ETHN 103A,A00,887236,Man; Simeon S,0,3,0,0
1746580996231,ETHN 113,A00,887239,Staff,16,0,30,14
1746580997258,ETHN 116,A00,887240,Staff,16,0,25,9
1746580998286,ETHN 117,A00,887241,Choi; Esther Min,28,0,30,2
1746580999311,ETHN 118,A00,887243,Staff,24,0,30,6
1746581000340,ETHN 127,A00,887248,Cuong; Marisol,11,0,15,4
1746581001365,ETHN 139,A00,887250,Staff,7,0,10,3
1746581002394,ETHN 142,A00,887252,Staff,10,0,30,20
1746581003423,ETHN 161,A00,887253,Browne; Errol Tsekani,24,0,30,6
1746581004448,ETHN 163FR,A00,887255,Burelle; Julie Sara Veronique,0,0,5,5
1746581005478,GLBH 20,A00,889149,Elwardani; Nile Regina,8,0,42,34
1746581007529,GLBH 111,A01,889152,Burgos; Jose L.,17,0,17,0
1746581008558,GLBH 150,A00,889181,Sloane; Julia Kathryn,0,5,15,15
1746581010613,HDS 60,A01,886406,Warstadt; Melissa Fawn,73,0,80,7
1746581011642,HIAF 111,A00,889324,Gyamfi; Bright,25,0,32,7
1746581012667,HIEA 131,A00,889328,Staff,15,0,32,17
1746581013691,HIEA 144,A00,889333,Henry; Todd A.,26,0,32,6
1746581014722,HIEA 154,A00,889336,Henry; Todd A.,24,0,32,8
1746581015746,HIEU 106,A00,889339,Staff,22,0,32,10
1746581017796,HIEU 114,A00,889340,Staff,4,0,32,28
1746581018821,HIEU 135GS,A00,889342,Patterson; Patrick H.,0,0,1,24
1746581019847,HIEU 137,A00,889343,Edington; Claire Ellen,10,0,25,15
1746581020873,HIEU 148,A00,889345,Staff,14,0,32,18
1746581021937,HIEU 154,A00,889346,Biess; Frank Peter,21,0,32,11
1746581022961,HILA 102,A00,889351,Staff,12,0,32,20
1746581023987,HILD 2A,A01,889221,Lewandoski; Julia Mavis,1,10,32,31
1746581025011,HILD 7B,A01,889225,Man; Simeon S,0,12,32,32
1746581026040,HILD 7C,A01,889288,Alvarez; Luis A,0,14,32,32
1746581027066,HILD 30,A01,889323,Staff,0,5,32,32
1746581029120,HISC 119,A00,889383,Golan; Tal,19,0,32,13
1746581030145,HIUS 103,A00,889384,Man; Simeon S,0,0,32,32
1746581031174,HIUS 117,A00,919797,Kwak; Nancy,19,0,32,13
1746581032202,HIUS 142A,A00,919788,Staff,22,0,32,10
1746581034256,HIUS 149,A00,889386,Gyamfi; Bright,26,0,32,6
1746581035280,HIUS 155,A00,889387,Alvarez; Luis A,15,0,32,17
1746581036309,HUM 3,A01,886499,Caldwell; Michael Alan,19,0,50,31
1746581037337,HUM 3GS,A00,886500,Rodriguez; Bretton Sigfred,0,0,0,28
1746581038362,HUM 3R,A01,886502,Markman; Kristina,0,36,50,50
1746581039389,HUM 4,A01,886504,Crum; Matthew Stephen,23,0,50,27
1746581039389,HUM 4,B01,886506,West; Geoffrey Scott,17,0,50,33
1746581040417,HUM 4GS,A00,886507,Staff,0,0,0,19
1746581041445,HUM 5,A01,886509,Staff,32,0,50,18
1746581042469,HUM 5R,A01,886511,Zavodny; Tatiana Sophia,0,39,50,50
1746581043497,JAPN 180,A00,886407,Staff,16,0,40,24
1746581044527,LATI 50,A01,886409,Martin-Cabrera; Luis,3,0,22,19
1746581044527,LATI 50,A02,886410,Martin-Cabrera; Luis,19,0,22,3
1746581044527,LATI 50,A03,886411,Martin-Cabrera; Luis,21,0,22,1
1746581044527,LATI 50,A04,886412,Martin-Cabrera; Luis,8,0,22,14
1746581045553,LAWS 101,A00,907664,Staff,28,0,60,32
1746581046580,LIAB 1A,A00,889388,Saab; Dima,17,0,20,3
1746581047609,LIAB 1AX,A00,889389,El Cheddadi; Youniss,18,0,20,2
1746581048638,LIFR 1C,A00,889391,Van Moer; Vinciane G,8,0,20,12
1746581049662,LIFR 1CX,A00,889392,Van Moer; Vinciane G,7,0,20,13
1746581050688,LIFR 1D,A00,889393,Van Moer; Vinciane G,7,0,20,13
1746581051715,LIFR 1DX,A00,889394,Van Moer; Vinciane G,8,0,20,12
1746581052739,LIGN 7,A00,886923,Staff,24,0,50,26
1746581053768,LIGN 17,A00,886924,Kehler; Andrew Scott,125,0,150,25
1746581054792,LTAM 110,A00,889395,Staff,15,0,30,15
1746581055818,LTAM 110GS,A00,958010,Rodriguez; Bretton Sigfred,0,0,0,28
1746581056843,LTCH 101,A00,889397,Staff,23,0,25,2
1746581057872,LTCS 130,A00,889398,Staff,23,0,25,2
1746581058896,LTEA 138,A00,889399,Staff,24,0,40,16
1746581059923,LTEN 149,A00,889400,Wesling; Megan E.,0,3,25,25
1746581060949,LTEN 169,A00,889401,Staff,20,0,25,5
1746581061974,LTEN 180,A00,889402,Staff,10,0,15,5
1746581063000,LTEN 181,A00,889403,Staff,21,0,25,4
1746581064026,LTWL 100,A00,889404,Myerston Santana; Jacobo,2,0,25,23
1746581065054,LTWL 180GS,A00,889405,Staff,0,0,20,20
1746581066083,LTWL 181,A00,889406,Staff,16,0,25,9
1746581067111,LTWL 184,A00,889475,Mukherjee; Silpa,22,0,25,3
1746581068138,LTWR 102C,A00,889486,Staff,29,0,30,1
1746581069166,LTWR 115W,A00,889491,Staff,0,2,15,15
1746581070191,MAE 8,A01,886905,Staff,0,2,0,0
1746581071217,MAE 11,A00,886906,Bandaru; Prabhakar,0,7,50,50
1746581072244,MAE 20,A00,886907,Evdokimenko; Ekaterina,43,0,70,27
1746581073269,MAE 30B,A00,886909,Ghazinejad; Maziar,26,0,45,19
1746581074296,MAE 101B,A00,886910,Saintillan; David,29,0,45,16
1746581075321,MAE 105,A00,886911,Bandaru; Prabhakar,18,0,50,32
1746581076352,MAE 107,B00,958024,Staff,8,0,50,42
1746581077381,MAE 143B,A00,886913,Bewley; Thomas R,3,0,40,37
1746581078405,MAE 148,A01,886915,Silberman; Jack,0,3,14,14
1746581079434,MAE 160,A00,886916,Evdokimenko; Ekaterina,31,0,60,29
1746581080461,MATH 3C,A01,889681,Staff,0,2,30,30
1746581080461,MATH 3C,A02,960048,Staff,24,0,30,6
1746581081486,MATH 10A,A01,889760,Staff,26,0,30,4
1746581081486,MATH 10A,A02,889783,Staff,29,0,30,1
1746581082515,MATH 10B,A01,889785,Verstraete; Jacques Allan,2,0,35,33
1746581082515,MATH 10B,A02,889795,Verstraete; Jacques Allan,4,0,35,31
1746581082515,MATH 10B,B01,889797,Verstraete; Jacques Allan,3,0,35,32
1746581082515,MATH 10B,B02,889828,Verstraete; Jacques Allan,3,0,35,32
1746581083545,MATH 10C,A01,889849,Habib; Yousaf,7,0,30,23
1746581083545,MATH 10C,A02,889852,Habib; Yousaf,14,0,30,16
1746581083545,MATH 10C,A03,889853,Habib; Yousaf,22,0,30,8
1746581083545,MATH 10C,A04,889858,Habib; Yousaf,20,0,30,10
1746581083545,MATH 10C,B01,889861,Staff,1,0,30,29
1746581083545,MATH 10C,B02,889862,Staff,24,0,30,6
1746581083545,MATH 10C,B03,889863,Staff,27,0,30,3
1746581083545,MATH 10C,B04,889967,Staff,23,0,30,7
1746581084575,MATH 18,A01,889974,Staff,7,0,30,23
1746581084575,MATH 18,A02,889977,Staff,20,0,30,10
1746581084575,MATH 18,B01,889984,Hardiman; Liam,20,0,30,10
1746581084575,MATH 18,B02,889985,Hardiman; Liam,25,0,30,5
1746581085598,MATH 20A,A01,889990,Suk; Andrew Hoon,30,0,35,5
1746581086626,MATH 20B,A01,889993,Ohm; Ko Woon,22,0,30,8
1746581086626,MATH 20B,A02,889994,Ohm; Ko Woon,30,0,30,0
1746581086626,MATH 20B,B01,889996,Ohm; Ko Woon,22,0,30,8
1746581086626,MATH 20B,B02,889997,Ohm; Ko Woon,23,0,30,7
1746581087656,MATH 20C,A01,889999,Hammock; Frances H,17,0,30,13
1746581087656,MATH 20C,A02,890003,Hammock; Frances H,23,0,30,7
1746581087656,MATH 20C,B01,890006,Hammock; Frances H,3,0,30,27
1746581087656,MATH 20C,B02,890007,Hammock; Frances H,12,0,30,18
1746581088682,MATH 20D,A01,890011,Cheng; Hsiao-Bing,1,1,30,29
1746581088682,MATH 20D,A02,890012,Cheng; Hsiao-Bing,14,0,30,16
1746581088682,MATH 20D,B01,890016,Cheng; Hsiao-Bing,13,0,30,17
1746581088682,MATH 20D,B02,890017,Cheng; Hsiao-Bing,13,0,30,17
1746581089708,MATH 20E,A01,890026,Harel; Guershon,1,0,30,29
1746581089708,MATH 20E,A02,890029,Harel; Guershon,22,0,30,8
1746581089708,MATH 20E,B01,890033,Harel; Guershon,7,0,30,23
1746581089708,MATH 20E,B02,890101,Harel; Guershon,21,0,30,9
1746581090733,MATH 102,A01,890104,Staff,18,0,30,12
1746581090733,MATH 102,A02,890105,Staff,27,0,30,3
1746581091762,MATH 103B,A01,890116,Salehi Golsefidy; Alireza,3,0,30,27
1746581091762,MATH 103B,B01,890118,Staff,0,3,34,34
1746581092792,MATH 109,A01,890121,Aliabadi Sr.; Mohsen,0,0,30,30
1746581092792,MATH 109,B01,890124,Upadrashta; Pranav Kumar,18,0,30,12
1746581093818,MATH 120A,A01,890126,Eggers; John Dietrich,13,0,30,17
1746581094844,MATH 142B,A01,890128,Ioana; Adrian,19,0,30,11
1746581094844,MATH 142B,A02,890129,Ioana; Adrian,12,0,30,18
1746581095869,MATH 154,A01,890174,Staff,0,0,30,30
1746581095869,MATH 154,A02,890182,Staff,0,0,30,30
1746581096898,MATH 168A,A01,890197,Dumitriu; Ioana,21,0,35,14
1746581097923,MATH 170A,A01,890240,Nie; Jiawang,1,0,30,29
1746581097923,MATH 170A,A02,890241,Nie; Jiawang,11,0,30,19
1746581097923,MATH 170A,A03,890249,Nie; Jiawang,23,0,30,7
1746581098947,MATH 170B,A01,957891,Nag; Panchali,13,0,35,22
1746581101002,MATH 181A,A01,908025,Staff,0,3,35,35
1746581101002,MATH 181A,A02,960115,Staff,26,0,35,9
1746581102030,MATH 181B,A01,959874,Staff,25,0,30,5
1746581103059,MATH 193B,A01,890265,Staff,0,4,35,35
1746581104086,MGT 4,A01,890311,Anderson; John Charles,42,0,88,46
1746581105111,MGT 5,A00,907740,Staff,13,0,98,85
1746581106135,MGT 12,A00,890312,Lindenberger; Wade Douglas,67,0,98,31
1746581107160,MGT 16,A00,957883,Staff,78,0,98,20
1746581109216,MGT 45,A00,890314,Pecore; Joseph P.,45,0,98,53
1746581110240,MGT 71,A00,890315,Staff,0,12,98,98
1746581111269,MGT 100,A00,890316,Yavorsky; Daniel Ryan,44,0,98,54
1746581112299,MGT 103,A00,890317,Ehrich; Kristine R,73,0,98,25
1746581113323,MGT 105,A00,890356,Bates; Kenneth Walter,0,8,98,98
1746581114348,MGT 112,A00,890360,Ehrich; Kristine R,55,0,98,43
1746581115377,MGT 127R,A00,907732,Zhu; Kevin Xiaoguo,23,0,98,75
1746581116405,MGT 131B,A00,890361,Anderson; John Charles,59,0,98,39
1746581117431,MGT 137,A00,890362,Lindenberger; Wade Douglas,65,0,98,33
1746581118460,MGT 160,A00,890369,Johnson; Erik Barry,9,0,98,89
1746581120514,MGT 164,A00,890372,Zimmermann; Carsten,0,40,98,98
1746581121540,MGT 180,A00,890374,Bliss; Barbara Ann,12,0,98,86
1746581122567,MMW 15,A01,886414,Chang; Edmond Yi-Teh,0,12,28,28
1746581122567,MMW 15,A02,886415,Chang; Edmond Yi-Teh,0,8,28,28
1746581122567,MMW 15,A03,886416,Chang; Edmond Yi-Teh,0,9,28,28
1746581122567,MMW 15,A04,886417,Chang; Edmond Yi-Teh,0,8,28,28
1746581122567,MMW 15,B01,886419,Chang; Edmond Yi-Teh,0,7,28,28
1746581122567,MMW 15,B02,886420,Chang; Edmond Yi-Teh,0,8,28,28
1746581122567,MMW 15,B03,886421,Chang; Edmond Yi-Teh,0,7,28,28
1746581122567,MMW 15,B04,886422,Chang; Edmond Yi-Teh,0,8,28,28
1746581122567,MMW 15,C01,886424,Staff,0,9,28,28
1746581122567,MMW 15,C02,886425,Staff,0,8,28,28
1746581122567,MMW 15,C03,886426,Staff,0,8,28,28
1746581122567,MMW 15,C04,886427,Staff,0,8,28,28
1746581122567,MMW 15,C05,958038,Staff,0,8,28,28
1746581122567,MMW 15,C06,958039,Staff,1,8,28,27
1746581123592,MMW 15GS,A00,906910,Patterson; Patrick H.,4,0,28,24
1746581124616,MMW 122R,A01,886429,Rahimi; Babak,0,13,28,28
1746581124616,MMW 122R,A02,886430,Rahimi; Babak,0,12,28,28
1746581124616,MMW 122R,A03,958040,Rahimi; Babak,0,11,28,28
1746581125685,MUS 1A,A01,890937,Staff,2,0,25,23
1746581125685,MUS 1A,A02,891035,Staff,6,0,25,19
1746581125685,MUS 1A,C01,958912,Staff,24,0,25,1
1746581125685,MUS 1A,C02,958913,Staff,25,0,25,0
1746581127738,MUS 2AK,A00,957092,Ohnishi; Takae,15,0,15,0
1746581128767,MUS 4,A01,891044,Staff,1,0,25,24
1746581128767,MUS 4,A02,891045,Staff,23,0,25,2
1746581128767,MUS 4,B01,891048,Staff,17,0,25,8
1746581128767,MUS 4,B02,891050,Staff,25,0,25,0
1746581129796,MUS 5,A01,957506,Dubnov; Shlomo,0,0,25,25
1746581129796,MUS 5,A02,957622,Dubnov; Shlomo,13,0,25,12
1746581129796,MUS 5,A03,957623,Dubnov; Shlomo,20,0,25,5
1746581130821,MUS 6,A01,891053,Freitas Caetano; Marcelo,24,0,25,1
1746581130821,MUS 6,A02,891054,Freitas Caetano; Marcelo,23,0,25,2
1746581131846,MUS 7,A01,891081,Staff,1,0,25,24
1746581131846,MUS 7,A02,891082,Staff,3,0,25,22
1746581132873,MUS 8GS,A00,891118,Borgo; David Garcia,1,0,25,24
1746581133900,MUS 11,A01,891140,Staff,9,0,25,16
1746581133900,MUS 11,A02,891141,Staff,21,0,25,4
1746581134924,MUS 13,A01,891143,Staff,8,0,25,17
1746581134924,MUS 13,A02,891144,Staff,24,0,25,1
1746581135949,MUS 15,A01,891146,Staff,9,0,25,16
1746581135949,MUS 15,A02,891148,Staff,21,0,25,4
1746581135949,MUS 15,B01,891150,Staff,18,0,25,7
1746581135949,MUS 15,B02,891151,Staff,25,0,25,0
1746581136973,MUS 20,A01,891153,Staff,5,0,20,15
1746581136973,MUS 20,A02,891155,Staff,14,0,20,6
1746581137999,MUS 80,A00,891156,Staff,19,0,25,6
1746581137999,MUS 80,B00,891157,Staff,23,0,25,2
1746581139027,MUS 130,A00,891158,Ohnishi; Takae,35,0,35,0
1746581140057,MUS 150GS,A01,891160,Borgo; David Garcia,1,0,25,24
1746581141083,MUS 170,A01,891162,Freitas Caetano; Marcelo,20,0,25,5
1746581141083,MUS 170,A02,891164,Freitas Caetano; Marcelo,21,0,25,4
1746581142111,NANO 11,A00,886220,Vazquez Mena; Oscar,13,0,15,2
1746581143143,NANO 15,A01,886222,Drews; Aaron,4,0,7,3
1746581144171,NANO 104,A00,886224,Sirbuly; Donald,17,0,25,8
1746581145200,PH 40,A00,886528,Staff,24,0,40,16
1746581146228,PH 45,A01,886799,Staff,35,0,40,5
1746581147254,PH 110,A00,886802,Staff,0,7,40,40
1746581148278,PH 172,A00,906716,Staff,19,0,35,16
1746581149306,PH 191,A00,886803,Staff,6,0,40,34
1746581150335,PHIL 1,A00,889500,Staff,20,0,30,10
1746581151359,PHIL 10,A01,889549,Grush; Rick Scott,16,0,22,6
1746581151359,PHIL 10,A02,889551,Grush; Rick Scott,22,0,22,0
1746581152398,PHIL 28,A01,889559,Lamey; Andy M.,0,2,31,31
1746581152398,PHIL 28,A02,889561,Lamey; Andy M.,0,1,30,30
1746581152398,PHIL 28,A03,889572,Lamey; Andy M.,0,1,30,30
1746581153426,PHIL 35,A00,907839,Staff,13,0,15,2
1746581154453,PHIL 60,A00,889574,Staff,73,0,90,17
1746581155478,PHIL 101,A00,958004,Staff,12,0,15,3
1746581157533,PHIL 136,A00,889582,Fulkerson; Matthew Todd,26,0,45,19
1746581158559,PHIL 163,A01,889601,Staff,21,0,30,9
1746581158559,PHIL 163,B01,889606,Brandt; Reuven A,0,3,0,0
1746581159589,PHIL 164,A00,889610,Staff,16,0,30,14
1746581160617,PHIL 165,A00,889613,Staff,22,0,30,8
1746581161642,PHYS 1A,A00,886431,Staff,28,0,70,42
1746581162668,PHYS 1AL,001,886432,Tsai; Philbert S,1,2,30,29
1746581162668,PHYS 1AL,002,886436,Tsai; Philbert S,11,0,30,19
1746581163695,PHYS 1B,A00,886439,Staff,184,0,240,56
1746581164720,PHYS 1BL,001,886441,Tsai; Philbert S,0,4,30,30
1746581164720,PHYS 1BL,002,886444,Tsai; Philbert S,2,0,30,28
1746581165748,PHYS 1C,A00,896092,Arnold; Kam S,78,0,146,68
1746581166778,PHYS 1CL,001,886448,Tsai; Philbert S,0,0,30,30
1746581166778,PHYS 1CL,002,886449,Tsai; Philbert S,1,0,30,29
1746581166778,PHYS 1CL,003,886450,Tsai; Philbert S,16,0,30,14
1746581166778,PHYS 1CL,004,886451,Tsai; Philbert S,15,0,30,15
1746581167802,PHYS 2B,A01,886457,Staff,67,0,115,48
1746581168828,PHYS 2C,A01,886460,Shotwell; Brian,0,9,65,65
1746581169857,PHYS 2CL,A01,886467,Staff,0,4,28,28
1746581169857,PHYS 2CL,A02,886468,Staff,0,3,28,28
1746581170898,PHYS 2D,A01,886470,Staff,10,0,50,40
1746581171924,PHYS 4B,A01,886475,Grinstein; Benjamin,22,0,40,18
1746581172951,POLI 5,A00,891173,Desposato; Scott,7,0,25,18
1746581173976,POLI 5D,A01,891175,Staff,5,0,5,0
1746581173976,POLI 5D,B01,891178,Staff,5,0,5,0
1746581175002,POLI 11,A00,891179,Ferree; Karen E,2,0,35,33
1746581176026,POLI 12,A00,891180,Staff,16,0,30,14
1746581177052,POLI 27,A01,891182,Staff,12,0,75,63
1746581178080,POLI 30,A00,891183,Staff,8,0,50,42
1746581179108,POLI 100B,A00,891244,Staff,5,1,35,30
1746581180136,POLI 100I,A00,891247,Staff,7,0,30,23
1746581181162,POLI 104J,A00,891248,Nichter; Maysa,14,0,30,16
1746581182188,POLI 104U,A00,891250,Nichter; Maysa,1,0,30,29
1746581184239,POLI 110B,A00,891255,Wiens; David,19,0,25,6
1746581185268,POLI 112A,A00,891256,Wiens; David,6,0,25,19
1746581186293,POLI 114BR,A00,891261,Staff,19,0,30,11
1746581187319,POLI 117R,A00,891262,Forman; Fonna,0,6,50,50
1746581188344,POLI 118,A00,891264,Ingham; Sean,17,0,25,8
1746581189373,POLI 124A,A00,891265,Staff,18,0,20,2
1746581190399,POLI 125D,A00,891266,Nichter; Simeon C,2,0,25,23
1746581191428,POLI 126,A00,891268,Nichter; Simeon C,7,0,25,18
1746581192456,POLI 126AA,A00,891272,Staff,15,0,25,10
1746581193482,POLI 130AA,A00,891273,Staff,15,0,20,5
1746581194507,POLI 134AA,A00,891274,Staff,4,0,20,16
1746581196560,POLI 138,A00,891278,Staff,21,0,25,4
1746581197590,POLI 142K,A00,891280,Staff,10,0,25,15
1746581198616,POLI 142M,A00,891281,Gartzke; Erik,16,0,30,14
1746581199642,POLI 142P,A00,891284,Staff,20,0,30,10
1746581200668,POLI 143,A00,891285,Gartzke; Erik,12,0,30,18
1746581201697,POLI 153,A00,891286,Staff,19,0,20,1
1746581203747,POLI 175,A00,891290,Staff,15,0,20,5
1746581204778,PSYC 1,A00,890674,Steiner; Eric Tomas,0,11,45,45
1746581205804,PSYC 2,A00,890676,Albright; Thomas D,20,0,35,15
1746581206830,PSYC 3,A00,890679,Staff,17,0,20,3
1746581207860,PSYC 6,A00,959858,Staff,19,0,20,1
1746581208886,PSYC 60,A01,890684,Rickard; Timothy C.,0,5,45,45
1746581209914,PSYC 70,A01,890689,Geller; Emma Harlan,6,0,30,24
1746581210941,PSYC 71,A01,959860,Staff,21,0,25,4
1746581211969,PSYC 100,A00,890690,Lacefield; Katharine I,0,50,180,180
1746581212995,PSYC 102,A00,890695,Staff,18,0,40,22
1746581214021,PSYC 105,A00,890699,Geller; Emma Harlan,70,0,100,30
1746581215045,PSYC 106,A00,890701,Gorman; Michael R.,5,0,30,25
1746581216073,PSYC 108,A00,890704,Adrian; Julia Anna,0,28,50,50
1746581217100,PSYC 118,A01,890712,Staff,11,0,30,19
1746581218127,PSYC 124,A00,890716,Chapman; Eddie Nathaniel,25,0,60,35
1746581219152,PSYC 131,A00,890717,Anagnostaras; Stephan,0,7,80,80
1746581220178,PSYC 137,A00,890719,Winkielman; Piotr,0,11,30,30
1746581221202,PSYC 144,A00,890721,Adrian; Julia Anna,0,9,45,45
1746581222228,PSYC 162,A00,890805,Staff,0,0,75,75
1746581223253,PSYC 169,A00,890810,Staff,0,14,30,30
1746581224282,PSYC 172,A00,890814,Gorman; Michael R.,9,0,30,21
1746581225307,PSYC 181,A00,890818,Anagnostaras; Stephan,7,0,200,193
1746581226336,PSYC 184,A00,959861,Staff,164,0,175,11
1746581227364,PSYC 189,A00,890823,Staff,0,2,30,30
1746581228387,PSYC 191,A00,890884,Rickard; Timothy C.,0,12,35,35
1746581229470,PSYC 193,A00,890913,Staff,19,0,30,11
1746581229470,PSYC 193,B00,890914,Chapman; Eddie Nathaniel,24,0,30,6
1746581230495,PSYC 193L,A01,890918,Lowe; Angela Beth,20,0,30,10
1746581230495,PSYC 193L,B01,890921,Hurwitz; Ethan Scott,20,0,30,10
1746581230495,PSYC 193L,C01,890928,Staff,30,0,30,0
1746581231520,RELI 149,A00,886806,Rahimi; Babak,23,0,40,17
1746581232549,SE 9,A01,886814,Staff,7,0,20,13
1746581233573,SE 101B,A01,886816,Chadha; Mayank,4,0,35,31
1746581234597,SE 110B,A00,886818,Zhu; Qiang,4,0,75,71
1746581235622,SE 125,A01,886830,Staff,10,0,30,20
1746581236646,SE 130B,A01,886835,Staff,14,0,40,26
1746581237671,SE 131A,A01,886838,Krysl; Petr,34,0,55,21
1746581238899,SE 154,A00,886840,Staff,29,0,50,21
1746581239928,SE 164GS,A01,886849,Staff,6,0,20,14
1746581240956,SE 167GS,A01,886853,Staff,6,0,20,14
1746581241985,SIO 25,A01,890107,Staff,19,0,30,11
1746581243014,SIO 45,A00,890109,Cook; Geoffrey W,116,0,200,84
1746581244042,SIO 109R,A00,890110,Forman; Fonna,0,16,20,20
1746581245071,SIO 187,A01,890114,Kacev; David,15,0,40,25
1746581246100,SOCI 1,A01,890431,Thorpe; Charles Robert,14,0,30,16
1746581246100,SOCI 1,A02,890518,Thorpe; Charles Robert,30,0,30,0
1746581247128,SOCI 2,A01,957978,Staff,25,0,25,0
1746581247128,SOCI 2,A02,957979,Staff,23,0,25,2
1746581248154,SOCI 20,A01,890523,Calderon-Zaks; Michael Aar,21,0,30,9
1746581248154,SOCI 20,A02,890526,Calderon-Zaks; Michael Aar,29,0,30,1
1746581249181,SOCI 30,A01,890533,Pardo Guerra; Juan Pablo,37,0,40,3
1746581250208,SOCI 40,A01,890535,Staff,27,0,45,18
1746581251240,SOCI 104Q,A00,890559,Staff,18,0,30,12
1746581252270,SOCI 106,A00,890560,Arnal; Maud Marie Leonie,20,0,30,10
1746581253298,SOCI 110,A00,890567,Holkenbrink-Monk; Charlene,19,0,30,11
1746581254322,SOCI 112,A00,890568,Victoria Torres; Pablo,2,0,55,53
1746581255348,SOCI 115,A00,890597,Arnal; Maud Marie Leonie,28,0,45,17
1746581257399,SOCI 121,A00,890604,Pardo Guerra; Juan Pablo,38,0,45,7
1746581258426,SOCI 126,A01,890608,Staff,8,0,10,2
1746581259455,SOCI 127,A00,890609,Staff,18,0,30,12
1746581260480,SOCI 131,A00,890610,Thorpe; Charles Robert,37,0,45,8
1746581261510,SOCI 135,A00,890615,Payne; Christine Anna,13,0,45,32
1746581262534,SOCI 139,A00,890620,Staff,38,0,45,7
1746581263561,SOCI 148E,A00,890622,Calderon-Zaks; Michael Aar,36,0,45,9
1746581264589,SOCI 150,A00,890623,Kohler; Kristopher M.,31,0,45,14
1746581265619,SOCI 157,A00,890625,Jules-Rosette; Bennetta W.,18,0,20,2
1746581266644,SOCI 160,A00,890627,Payne; Christine Anna,21,0,45,24
1746581267670,SYN 1,A00,886855,Fish; Gwendolyn Anne,0,1,0,0
1746581267670,SYN 1,B00,906086,Fish; Gwendolyn Anne,0,2,0,2
1746581268696,SYN 2R,A00,886860,Staff,0,17,15,15
1746581268696,SYN 2R,B00,906106,Atkinson; Arthur Laird,0,16,15,15
1746581269722,SYN 100,A01,886866,Browne; Emily,0,28,20,20
1746581269722,SYN 100,B01,906128,Rock; Martin,0,4,20,20
1746581269722,SYN 100,C01,906140,Deavenport; James Cary,0,3,20,20
1746581269722,SYN 100,D01,907816,Deavenport; James Cary,0,5,20,20
1746581270747,TDAC 1,A00,890286,Walsh; Kim C.,7,0,20,13
1746581271777,TDAC 101,A00,890296,Basso; Beatrice,15,0,20,5
1746581272805,TDDE 131,A00,890297,Staff,47,0,50,3
1746581273831,TDDM 1,A00,890287,Weinberg; Sadie,25,0,30,5
1746581274855,TDGE 11,A00,890288,Fulton; Julia,138,0,200,62
1746581274855,TDGE 11,B00,890289,Castro; Robert Jess,184,0,200,16
1746581275880,TDGE 25,B00,957359,Walsh; Kim C.,5,0,20,15
1746581276909,TDGE 40,A01,890292,Power; Jade Yukana,27,0,30,3
1746581277934,TDGE 124,A00,890298,Havis; Allan,0,1,50,50
1746581278958,TDGE 131R,A00,890299,Burelle; Julie Sara Veronique,15,0,42,27
1746581279989,TDHT 101,A00,890300,Staff,10,0,20,10
1746581281019,TDHT 109,A01,890302,Anderson; Mysia Anyse,31,0,40,9
1746581282044,TDMV 1,A00,890293,Arcidiacono; Kristin,18,0,30,12
1746581283069,TDMV 2,A00,890294,Weinberg; Sadie,23,0,30,7
1746581284094,TDMV 3,A00,957878,Arcidiacono; Kristin,28,0,30,2
1746581286150,TDMV 138,A00,890304,Jun; Grace Shin Hae,25,0,40,15
1746581287176,TDMV 140,A00,890305,Corrales; Joseph Bernales,25,0,30,5
1746581288200,TDMV 142,A00,890307,Caligagan; Tony,32,0,40,8
1746581289230,TDMV 144,A00,890308,Camaya; Michelle Ann,25,0,30,5
1746581290255,TDPW 1,A00,890295,Stein; Deborah Isobel,3,0,20,17
1746581291286,USP 2,A01,890272,Lerner; Amy M,7,0,20,13
1746581292310,USP 3,A01,890274,Staff,12,0,30,18
1746581293339,USP 15,A01,890276,Sun; Feiyang,16,0,30,14
1746581294364,USP 25,A00,890277,Shenkman; Michael Thomas,18,0,25,7
1746581295389,USP 138,A00,890278,Staff,14,0,25,11
1746581296415,USP 143,A00,890279,Staff,22,0,70,48
1746581297444,USP 144,A00,890280,Chowdhury; Muhammed Zohir,16,0,30,14
1746581298473,USP 150,A00,890281,Boomhower; Matthew Charles,4,0,30,26
1746581299497,USP 151,A00,890282,Staff,16,0,20,4
1746581300522,USP 162,A00,890283,Andrews; Abigail Leslie,16,0,20,4
1746581301550,USP 168,A00,920477,Kwak; Nancy,0,0,5,5
1746581302578,USP 181,A00,890284,Staff,3,0,20,17
1746581303603,USP 191A,A00,890285,Staff,12,0,20,8
1746581304631,VIS 101,A00,886512,Staff,26,0,75,49
1746581305661,VIS 103,A00,886513,Cruz; Edwin Teddy,61,0,75,14
1746581306689,VIS 108,A00,886514,Staff,3,0,15,12
1746581307715,VIS 127P,A00,886515,Shen; Kuiyi,79,0,146,67
1746581308742,VIS 149,A00,886516,Yoldas; Pinar,0,0,15,15
1746581309770,VIS 164,A00,886526,Erdmann; Dean,19,0,22,3
1746581310798,VIS 194S,A00,886527,Staff,61,0,75,14
1746581311822,WCWP 10A,C00,886484,Martiniuk; Jill,12,0,15,3
1746581312853,WCWP 10B,A00,886490,Uriarte; Emma,0,0,15,15
1746581312853,WCWP 10B,B00,886491,Dhir; Simrita,8,0,15,7
1746581312853,WCWP 10B,C00,886492,Ornelas; Tricia,0,0,15,15
1746581313879,WCWP 100,A00,886494,Young; Mark T,0,6,15,15
1746581315970,AAS 10,A01,886199,Childs; Dennis R.,0,3,0,0
1746581316996,ANAR 104,A01,886940,Shtienberg; Gilad,27,0,30,3
1746581318021,ANAR 120,A00,886953,Staff,13,0,20,7
1746581319051,ANBI 148,A01,886955,Wilder; Linnea Lorene,30,0,40,10
1746581321109,ANSC 122,A00,886957,Staff,25,0,30,5
1746581322135,ANSC 150,A00,886958,Sloane; Julia Kathryn,2,0,15,13
1746581323163,ANSC 156,A00,886959,Jenkins; Janis A.,0,1,15,15
1746581324192,ANSC 180,A00,886960,Staff,11,0,17,6
1746581325222,ANSC 188,A00,886961,Jassal; Aftab,9,0,25,16
1746581326247,ANSC 190,A00,886962,Jassal; Aftab,14,0,25,11
1746581327274,ANSC 191,A00,886963,Staff,18,0,20,2
1746581328300,ANTH 3,A01,891689,Staff,17,0,20,3
1746581329328,ANTH 5,A00,886933,Semendeferi; Ekaterini,16,0,20,4
1746581330354,ANTH 10,A00,886934,Staff,0,12,30,30
1746581331382,ANTH 21,A01,886936,Staff,41,0,60,19
1746581332415,ANTH 23,A01,886938,Staff,92,0,100,8
1746581333484,ANTH 105,A00,886964,Stewart; Alexander B,84,0,100,16
1746581334509,ANTH 108,A00,886965,Pedersen; David,9,0,20,11
1746581335543,AWP 10,001,886147,Staff,0,0,0,0
1746581335543,AWP 10,002,886148,Staff,0,0,0,0
1746581335543,AWP 10,003,886149,Staff,0,0,0,0
1746581335543,AWP 10,004,886150,Staff,0,0,0,0
1746581335543,AWP 10,005,886151,Staff,0,0,0,0
1746581335543,AWP 10,006,886152,Staff,0,0,0,0
1746581335543,AWP 10,007,886153,Staff,0,0,0,0
1746581335543,AWP 10,008,886154,Staff,0,0,0,0
1746581335543,AWP 10,009,886155,Staff,0,0,0,0
1746581335543,AWP 10,010,886156,Staff,0,0,0,0
1746581335543,AWP 10,011,886158,Staff,0,0,0,0
1746581335543,AWP 10,012,886160,Staff,0,0,0,0
1746581335543,AWP 10,013,886161,Staff,0,0,0,0
1746581335543,AWP 10,014,886162,Staff,0,0,0,0
1746581335543,AWP 10,015,886163,Staff,0,0,0,0
1746581335543,AWP 10,016,886164,Staff,0,0,0,0
1746581335543,AWP 10,017,886165,Staff,0,0,0,0
1746581335543,AWP 10,018,886166,Staff,0,0,0,0
1746581335543,AWP 10,019,886168,Staff,0,0,0,0
1746581335543,AWP 10,020,886170,Staff,0,0,0,0
1746581335543,AWP 10,021,886172,Staff,0,0,0,0
1746581336574,AWP 10R,001,886173,Staff,0,1,0,0
1746581336574,AWP 10R,002,886174,Staff,0,1,0,0
1746581336574,AWP 10R,003,886175,Staff,0,0,0,0
1746581336574,AWP 10R,004,886176,Staff,0,0,0,0
1746581336574,AWP 10R,005,886177,Staff,0,0,0,0
1746581336574,AWP 10R,006,886178,Staff,0,0,0,0
1746581336574,AWP 10R,007,886179,Staff,0,0,0,0
1746581336574,AWP 10R,008,886181,Staff,0,0,0,0
1746581336574,AWP 10R,009,886182,Staff,0,0,0,0
1746581336574,AWP 10R,010,886183,Staff,0,0,0,0
1746581336574,AWP 10R,011,886184,Staff,0,0,0,0
1746581336574,AWP 10R,012,886185,Staff,0,0,0,0
1746581336574,AWP 10R,013,886186,Staff,0,0,0,0
1746581336574,AWP 10R,014,886187,Staff,0,0,0,0
1746581336574,AWP 10R,015,886188,Staff,0,0,0,0
1746581336574,AWP 10R,016,886189,Staff,0,0,0,0
1746581336574,AWP 10R,017,960532,Staff,0,0,0,0
1746581336574,AWP 10R,018,960533,Staff,0,0,0,0
1746581336574,AWP 10R,019,960534,Staff,0,0,0,0
1746581336574,AWP 10R,020,960538,Staff,0,0,0,0
1746581336574,AWP 10R,021,960540,Staff,0,0,0,0
1746581336574,AWP 10R,022,960541,Staff,0,0,0,0
1746581336574,AWP 10R,023,960542,Staff,0,0,0,0
1746581336574,AWP 10R,024,960544,Staff,0,0,0,0
1746581336574,AWP 10R,025,960545,Staff,0,0,0,0
1746581336574,AWP 10R,026,960548,Staff,0,0,0,0
1746581337604,AWP 102R,A00,886190,Staff,0,0,0,0
1746581337604,AWP 102R,B00,886191,Staff,0,0,0,0
1746581338633,BENG 100,A01,886193,Staff,17,0,30,13
1746581339657,BENG 122A,A01,886195,Hasty; Jeff M,13,0,30,17
1746581340683,BENG 166A,A00,886196,Sah; Robert Lie-Yuan,0,3,30,30
1746581341709,BENG 190,A00,958050,Khojah; Reem I,18,0,25,7
1746581342738,BIBC 102,A01,894320,Staff,0,0,46,46
1746581342738,BIBC 102,A02,894321,Staff,0,0,46,46
1746581342738,BIBC 102,A03,894344,Staff,6,0,46,40
1746581342738,BIBC 102,A04,894345,Staff,27,0,47,20
1746581343767,BICD 100R,A01,894365,Smith; Laurie,0,3,58,58
1746581343767,BICD 100R,A02,894366,Smith; Laurie,0,5,58,58
1746581343767,BICD 100R,A03,894367,Smith; Laurie,0,0,59,59
1746581343767,BICD 100R,A04,959869,Smith; Laurie,40,0,59,19
1746581344792,BICD 136,A01,894383,Gustafson-Brown; Cindy,14,0,50,36
1746581345825,BIEB 102,A01,894494,Butler; Shannon Rhey,51,0,130,79
1746581347876,BIEB 150,A01,894617,Wills; Christopher,3,0,20,17
1746581347876,BIEB 150,A02,894631,Wills; Christopher,3,0,20,17
1746581347876,BIEB 150,A03,894937,Wills; Christopher,3,0,20,17
1746581347876,BIEB 150,A04,894946,Wills; Christopher,5,0,20,15
1746581348906,BIEB 194,A00,906141,Kurle; Carolyn M.,6,0,20,14
1746581349931,BILD 1,A01,894154,Staff,3,0,19,16
1746581349931,BILD 1,A02,894155,Staff,14,0,19,5
1746581349931,BILD 1,A03,894160,Staff,13,0,19,6
1746581349931,BILD 1,A04,894161,Staff,15,0,18,3
1746581350957,BILD 2,A01,894168,Staff,0,0,50,50
1746581350957,BILD 2,A02,894169,Staff,0,0,50,50
1746581350957,BILD 2,A03,894179,Staff,0,0,50,50
1746581350957,BILD 2,A04,894203,Staff,24,0,50,26
1746581351986,BILD 3,A01,894213,Staff,23,0,31,8
1746581351986,BILD 3,A02,894214,Staff,26,0,31,5
1746581351986,BILD 3,A03,894235,Staff,28,0,31,3
1746581351986,BILD 3,A04,894236,Staff,28,0,32,4
1746581353011,BILD 4,A01,894253,Reuther; Keefe,5,0,24,19
1746581353011,BILD 4,A02,894258,Reuther; Keefe,16,0,24,8
1746581354037,BILD 5,A01,894276,Reuther; Keefe,35,0,50,15
1746581354037,BILD 5,A02,894277,Reuther; Keefe,45,0,50,5
1746581354037,BILD 5,A03,894290,Reuther; Keefe,44,0,50,6
1746581354037,BILD 5,A04,894291,Reuther; Keefe,48,0,50,2
1746581355063,BILD 24,A01,894297,Pirino; Giorgia,40,0,60,20
1746581356089,BIMM 100,B01,958915,Staff,71,0,100,29
1746581357115,BIMM 101,A01,895017,McDonnell; Lisa Marie,0,5,24,24
1746581357115,BIMM 101,A02,895018,McDonnell; Lisa Marie,0,5,24,24
1746581357115,BIMM 101,B01,895020,McDonnell; Lisa Marie,0,6,24,24
1746581357115,BIMM 101,B02,895021,McDonnell; Lisa Marie,0,4,24,24
1746581358142,BIMM 110,A01,895023,Staff,1,0,25,24
1746581358142,BIMM 110,A02,895024,Staff,9,0,25,16
1746581358142,BIMM 110,A03,895025,Staff,18,0,25,7
1746581358142,BIMM 110,A04,895031,Staff,20,0,25,5
1746581359168,BIMM 120,A01,895114,Gustafson-Brown; Cindy,14,0,28,14
1746581359168,BIMM 120,A02,895126,Gustafson-Brown; Cindy,21,0,27,6
1746581360200,BIPN 100,A01,895130,Yang; Mingyu,0,0,38,38
1746581360200,BIPN 100,A02,895131,Yang; Mingyu,31,0,38,7
1746581360200,BIPN 100,A03,895132,Yang; Mingyu,32,0,38,6
1746581360200,BIPN 100,A04,895133,Yang; Mingyu,27,0,36,9
1746581361225,BIPN 120,A01,895135,Cooke; James Edward,0,3,13,13
1746581361225,BIPN 120,A02,895136,Cooke; James Edward,0,1,13,13
1746581361225,BIPN 120,A03,895137,Cooke; James Edward,0,3,13,13
1746581361225,BIPN 120,A04,895156,Cooke; James Edward,0,2,11,11
1746581362251,BIPN 134,A01,895235,Cooke; James Edward,0,2,25,25
1746581362251,BIPN 134,A02,895237,Cooke; James Edward,0,0,25,25
1746581362251,BIPN 134,A03,895240,Cooke; James Edward,3,0,25,22
1746581362251,BIPN 134,A04,895270,Cooke; James Edward,20,0,25,5
1746581363278,BIPN 189,A00,892103,Staff,0,14,14,14
1746581365332,BISP 194,A00,958008,Staff,0,2,0,0
1746581366359,CAT 124,A01,922009,Staff,0,5,20,20
1746581367385,CAT 125R,A00,886390,Morales; Celeste Georgianna,0,2,20,20
1746581367385,CAT 125R,B00,886391,Irwin; Matthew Joseph,0,4,20,20
1746581367385,CAT 125R,C00,886392,Smith; Lauryn Alissa,0,2,20,20
1746581367385,CAT 125R,D00,886393,Vanderschuit; Maya Alysia,0,3,20,20
1746581367385,CAT 125R,E00,886394,Marchisotto; Jennifer Anne,0,3,20,20
1746581368414,CENG 15,A01,886218,Drews; Aaron,3,0,8,5
1746581369445,CENG 113,A00,886219,Opatkiewicz; Justin Paul,15,0,25,10
1746581370471,CGS 101,A00,887044,Staff,7,0,20,13
1746581371496,CGS 105,A01,887046,Staff,14,0,25,11
1746581372522,CGS 112,A00,887047,Cuong; Marisol,12,0,15,3
1746581373548,CGS 113,A00,887048,Staff,23,0,30,7
1746581374576,CGS 120,A00,887049,Staff,10,0,17,7
1746581375601,CHEM 6A,A01,886336,Lam; Tin Yiu,38,0,50,12
1746581375601,CHEM 6A,A02,886338,Lam; Tin Yiu,37,0,50,13
1746581376634,CHEM 6B,A01,886341,Hopkins; Patrycja Anna,16,0,50,34
1746581376634,CHEM 6B,A02,886343,Hopkins; Patrycja Anna,42,0,50,8
1746581377661,CHEM 6C,A01,886346,Albizati; Kim F.,0,2,50,50
1746581377661,CHEM 6C,A02,886348,Albizati; Kim F.,23,0,50,27
1746581378689,CHEM 40A,A01,886352,Klosterman; Jeremy K,65,0,100,35
1746581379718,CHEM 40B,A01,886356,Klosterman; Jeremy K,0,24,100,100
1746581380747,CHEM 41B,A01,886360,Theodorakis; Emmanuel,25,0,50,25
1746581380747,CHEM 41B,A02,886362,Theodorakis; Emmanuel,47,0,50,3
1746581381775,CHIN 165A,A00,886382,Xu; Li,18,0,20,2
1746581382803,CLAS 120,A00,886387,Myerston Santana; Jacobo,33,0,40,7
1746581383835,COGS 9,A01,886967,Shannon; Kyle Michael,42,0,60,18
1746581384863,COGS 11,A01,886969,Staff,9,0,30,21
1746581385892,COGS 14A,A01,886971,Staff,6,0,60,54
1746581386916,COGS 14B,A01,886973,Hoffman; Drew Ellen,4,0,60,56
1746581387941,COGS 18,A01,886975,Morgan; Eric,35,0,60,25
1746581388967,COGS 20,A01,886977,Staff,4,0,8,4
1746581388967,COGS 20,A02,886978,Staff,5,0,7,2
1746581389994,COGS 100,A01,907783,Staff,1,2,30,29
1746581391020,COGS 101B,A01,886980,Staff,0,4,48,48
1746581392047,COGS 101C,A01,886982,Delgado; Tania,0,5,44,44
1746581393076,COGS 102A,A01,886984,Johnson; Christine M.,4,0,30,26
1746581394105,COGS 118B,A01,886986,Staff,1,4,88,87
1746581395130,COGS 150,A01,886988,Bergen; Benjamin,22,0,50,28
1746581396156,COGS 153,A00,886989,Delgado; Tania,0,2,41,41
1746581397182,COGS 186,A01,886991,Staff,0,0,32,32
1746581398212,COGS 187A,A01,886993,Boyle; Mary E. T.,7,0,30,23
1746581399238,COGS 189,A00,886994,Staff,0,1,30,30
1746581400269,COMM 10,A01,886996,Staff,0,0,20,21
1746581400269,COMM 10,A02,886997,Staff,10,0,20,10
1746581400269,COMM 10,A03,959845,Staff,19,0,20,1
1746581401299,COMM 20,A01,886999,Leuning; Grant Maurstad,24,0,40,16
1746581403359,COMM 100A,A01,887002,Staff,0,0,20,25
1746581403359,COMM 100A,A02,887003,Staff,6,0,20,14
1746581404384,COMM 100B,A01,887005,Staff,0,8,20,24
1746581405409,COMM 106D,A00,887006,Staff,13,0,40,27
1746581406436,COMM 110G,A00,887007,Whitworth-Smith; Andrew C,12,0,40,28
1746581407463,COMM 111B,A00,887008,Staff,31,0,40,9
1746581408488,COMM 113T,A00,887009,Abuelhiga; Soraya Jill,28,0,40,12
1746581408488,COMM 113T,B00,906733,Staff,40,0,40,0
1746581409517,COMM 145,A00,887010,Staff,12,0,40,28
1746581410543,COMM 146,A00,887054,Staff,31,0,40,9
1746581411571,COMM 190,A00,887012,Staff,8,0,23,15
1746581412602,CSE 8A,A50,887015,Cao; Yingjun,57,0,85,28
1746581413626,CSE 11,A01,887017,Cao; Yingjun,12,0,70,58
1746581414653,CSE 20,A01,887019,Staff,30,0,50,20
1746581415683,CSE 21,A01,887021,Staff,78,0,100,22
1746581415683,CSE 21,B01,892583,Braun; Oliver,45,0,50,5
1746581416712,CSE 30,A01,887025,Eldon; John,142,0,200,58
1746581417738,CSE 100,A01,887027,Staff,26,0,50,24
1746581417738,CSE 100,A02,887028,Staff,42,0,50,8
1746581418763,CSE 101,A01,887030,Braun; Oliver,74,0,100,26
1746581418763,CSE 101,B01,887032,Jones; Miles E,0,3,50,50
1746581418763,CSE 101,B02,887033,Jones; Miles E,0,2,50,50
1746581419788,CSE 105,A01,908084,Jones; Miles E,32,0,50,18
1746581419788,CSE 105,A02,908087,Jones; Miles E,31,0,50,19
1746581420813,CSE 135,A01,887035,Powell; Thomas Allan,0,5,50,50
1746581421842,CSE 142,A01,887037,Staff,8,0,60,52
1746581422867,CSE 142L,A01,887039,Staff,34,0,60,26
1746581423896,CSE 151A,A01,887041,Solares; Edwin A,47,0,100,53
1746581424922,CSE 175,A01,887043,Kumar; Rakesh,30,0,30,0
1746581425947,CSS 1,A01,886389,Staff,1,2,40,39
1746581426972,DSC 30,A01,908097,Liao; Soohyun Nam,47,0,75,28
1746581427997,DSC 40A,A01,908099,Shannon; Kyle Michael,30,0,50,20
1746581429023,DSC 40B,A01,908112,Staff,15,0,50,35
1746581430054,DSC 80,A01,908116,Staff,19,0,60,41
1746581431099,DSC 197,001,956863,Eldridge; Justin Matthew,9999,0,9999,0
1746581432125,ECE 5,A01,886400,Morris; Karcher William,1,0,6,5
1746581432125,ECE 5,A02,886401,Morris; Karcher William,3,0,6,3
1746581433149,ECE 148,A01,886403,Silberman; Jack,0,14,14,14
1746581434177,ECON 1,A01,887265,Crane; Meredith Helen,12,0,70,58
1746581434177,ECON 1,B01,887268,Staff,42,0,50,8
1746581435206,ECON 2,A01,887273,Crane; Meredith Helen,55,0,70,15
1746581436232,ECON 3,A01,887279,Rondina; Giacomo,32,0,70,38
1746581437296,ECON 4,A01,887282,Anderson; John Charles,0,2,10,10
1746581438326,ECON 5,A01,887285,Staff,34,0,45,11
1746581438326,ECON 5,B01,887292,Staff,41,0,45,4
1746581439356,ECON 100A,A01,887337,Newhouse; Herbert S,54,0,70,16
1746581439356,ECON 100A,B01,887349,Staff,45,0,50,5
1746581440381,ECON 100B,A01,887361,Du; Songzi,29,0,70,41
1746581441407,ECON 100C,A01,887445,Newhouse; Herbert S,59,0,70,11
1746581442435,ECON 105,A00,887488,Vespa; Emanuel Ignacio,23,0,35,12
1746581443461,ECON 109,A01,887506,Shishkin; Denis,28,0,35,7
1746581444487,ECON 110A,A01,887568,Alon; Titan Michael,0,3,35,35
1746581444487,ECON 110A,B01,907601,Alon; Titan Michael,20,0,35,15
1746581445512,ECON 110B,A01,887598,Levkoff; Steven B.,0,24,70,70
1746581446539,ECON 112,A00,887599,Rondina; Giacomo,19,0,35,16
1746581447568,ECON 120A,A01,887603,Dai; Yinlin,35,0,70,35
1746581448593,ECON 120C,A01,887608,Sun; Yixiao,0,1,35,35
1746581448593,ECON 120C,B01,887614,Sun; Yixiao,0,0,35,35
1746581449622,ECON 138,A00,887621,Bharadwaj; Prashant,0,21,20,20
1746581450648,ECON 144,A00,958007,Squires; Dale E,12,0,35,23
1746581451676,ECON 171,A01,907666,Staff,18,0,35,17
1746581452702,ECON 175,A00,887626,Wu; Pak Yeung,22,0,35,13
1746581453729,ECON 190,A00,887640,Vespa; Emanuel Ignacio,22,0,35,13
1746581454758,EDS 25,A01,888197,Staff,0,0,0,0
1746581454758,EDS 25,A02,888209,Staff,0,0,0,0
1746581454758,EDS 25,A03,888210,Staff,0,0,0,0
1746581454758,EDS 25,A04,888212,Staff,0,0,0,0
1746581454758,EDS 25,A05,888213,Staff,0,0,0,0
1746581454758,EDS 25,A06,888214,Staff,0,0,0,0
1746581454758,EDS 25,A07,888235,Staff,0,2,0,0
1746581454758,EDS 25,A08,888236,Staff,0,0,0,0
1746581454758,EDS 25,A09,888240,Staff,0,0,0,0
1746581454758,EDS 25,A10,888244,Staff,0,0,0,0
1746581454758,EDS 25,B01,888273,Staff,0,0,0,0
1746581454758,EDS 25,B02,888285,Staff,0,0,0,0
1746581454758,EDS 25,B03,888423,Staff,0,0,0,1
1746581454758,EDS 25,B04,888432,Staff,0,0,0,0
1746581454758,EDS 25,B05,888433,Staff,0,0,0,0
1746581454758,EDS 25,B06,888467,Staff,0,0,0,0
1746581454758,EDS 25,B07,888468,Staff,0,0,0,0
1746581454758,EDS 25,B08,888479,Staff,0,0,0,0
1746581454758,EDS 25,B09,888484,Staff,0,0,0,0
1746581454758,EDS 25,B10,888487,Staff,0,0,0,0
1746581455785,EDS 38,A01,907700,Choi; Bailey Miyeon,30,0,30,0
1746581456810,EDS 112,A01,888601,Chapman; Thandeka K,12,0,40,28
1746581457838,EDS 115,A00,888697,Mendez; Kathrina Mendoza,10,0,30,20
1746581458865,EDS 116,A01,888893,Staff,34,0,40,6
1746581460918,EDS 124AR,A00,889133,Staff,29,0,50,21
1746581460918,EDS 124AR,B00,907471,Simon; Elizabeth A,37,0,50,13
1746581461942,EDS 124BR,A00,889134,Simon; Elizabeth A,44,0,100,56
1746581462972,EDS 125,A00,889135,Staff,25,0,30,5
1746581463998,EDS 126,A01,889138,Staff,35,0,40,5
1746581465025,EDS 164R,A01,889142,Wishard Guerra; Alison G.,33,0,50,17
1746581466050,ENG 30,A01,886396,Staff,0,0,0,0
1746581466050,ENG 30,B01,886398,Staff,0,0,0,0
1746581467079,ENVR 102,A00,906150,Montejo; Carolina,23,0,25,2
1746581468103,ETHN 103A,A00,887236,Man; Simeon S,0,3,0,0
1746581469129,ETHN 113,A00,887239,Staff,16,0,30,14
1746581470155,ETHN 116,A00,887240,Staff,16,0,25,9
1746581471182,ETHN 117,A00,887241,Choi; Esther Min,28,0,30,2
1746581472206,ETHN 118,A00,887243,Staff,24,0,30,6
1746581473232,ETHN 127,A00,887248,Cuong; Marisol,11,0,15,4
1746581474259,ETHN 139,A00,887250,Staff,7,0,10,3
1746581475285,ETHN 142,A00,887252,Staff,10,0,30,20
1746581476311,ETHN 161,A00,887253,Browne; Errol Tsekani,24,0,30,6
1746581477336,ETHN 163FR,A00,887255,Burelle; Julie Sara Veronique,0,0,5,5
1746581478366,GLBH 20,A00,889149,Elwardani; Nile Regina,8,0,42,34
1746581480418,GLBH 111,A01,889152,Burgos; Jose L.,17,0,17,0
1746581481443,GLBH 150,A00,889181,Sloane; Julia Kathryn,0,5,15,15
1746581483498,HDS 60,A01,886406,Warstadt; Melissa Fawn,73,0,80,7
1746581484526,HIAF 111,A00,889324,Gyamfi; Bright,25,0,32,7
1746581485556,HIEA 131,A00,889328,Staff,15,0,32,17
1746581486582,HIEA 144,A00,889333,Henry; Todd A.,26,0,32,6
1746581487611,HIEA 154,A00,889336,Henry; Todd A.,24,0,32,8
1746581488640,HIEU 106,A00,889339,Staff,22,0,32,10
1746581490690,HIEU 114,A00,889340,Staff,4,0,32,28
1746581491716,HIEU 135GS,A00,889342,Patterson; Patrick H.,0,0,1,24
1746581492742,HIEU 137,A00,889343,Edington; Claire Ellen,10,0,25,15
1746581493766,HIEU 148,A00,889345,Staff,14,0,32,18
1746581494793,HIEU 154,A00,889346,Biess; Frank Peter,21,0,32,11
1746581495817,HILA 102,A00,889351,Staff,12,0,32,20
1746581496843,HILD 2A,A01,889221,Lewandoski; Julia Mavis,1,10,32,31
1746581497872,HILD 7B,A01,889225,Man; Simeon S,0,12,32,32
1746581498899,HILD 7C,A01,889288,Alvarez; Luis A,0,14,32,32
1746581499924,HILD 30,A01,889323,Staff,0,5,32,32
1746581501980,HISC 119,A00,889383,Golan; Tal,19,0,32,13
1746581503005,HIUS 103,A00,889384,Man; Simeon S,0,0,32,32
1746581504033,HIUS 117,A00,919797,Kwak; Nancy,19,0,32,13
1746581505062,HIUS 142A,A00,919788,Staff,22,0,32,10
1746581507115,HIUS 149,A00,889386,Gyamfi; Bright,26,0,32,6
1746581508140,HIUS 155,A00,889387,Alvarez; Luis A,15,0,32,17
1746581509165,HUM 3,A01,886499,Caldwell; Michael Alan,19,0,50,31
1746581510192,HUM 3GS,A00,886500,Rodriguez; Bretton Sigfred,0,0,0,28
1746581511222,HUM 3R,A01,886502,Markman; Kristina,0,36,50,50
1746581512247,HUM 4,A01,886504,Crum; Matthew Stephen,23,0,50,27
1746581512247,HUM 4,B01,886506,West; Geoffrey Scott,17,0,50,33
1746581513271,HUM 4GS,A00,886507,Staff,0,0,0,19
1746581514303,HUM 5,A01,886509,Staff,32,0,50,18
1746581515328,HUM 5R,A01,886511,Zavodny; Tatiana Sophia,0,39,50,50
1746581516357,JAPN 180,A00,886407,Staff,16,0,40,24
1746581517389,LATI 50,A01,886409,Martin-Cabrera; Luis,3,0,22,19
1746581517389,LATI 50,A02,886410,Martin-Cabrera; Luis,19,0,22,3
1746581517389,LATI 50,A03,886411,Martin-Cabrera; Luis,21,0,22,1
1746581517389,LATI 50,A04,886412,Martin-Cabrera; Luis,8,0,22,14
1746581518414,LAWS 101,A00,907664,Staff,28,0,60,32
1746581519443,LIAB 1A,A00,889388,Saab; Dima,17,0,20,3
1746581520471,LIAB 1AX,A00,889389,El Cheddadi; Youniss,18,0,20,2
1746581521497,LIFR 1C,A00,889391,Van Moer; Vinciane G,8,0,20,12
1746581522523,LIFR 1CX,A00,889392,Van Moer; Vinciane G,7,0,20,13
1746581523548,LIFR 1D,A00,889393,Van Moer; Vinciane G,7,0,20,13
1746581524573,LIFR 1DX,A00,889394,Van Moer; Vinciane G,8,0,20,12
1746581525620,LIGN 7,A00,886923,Staff,24,0,50,26
1746581526646,LIGN 17,A00,886924,Kehler; Andrew Scott,125,0,150,25
1746581527673,LTAM 110,A00,889395,Staff,15,0,30,15
1746581528698,LTAM 110GS,A00,958010,Rodriguez; Bretton Sigfred,0,0,0,28
1746581529724,LTCH 101,A00,889397,Staff,23,0,25,2
1746581530748,LTCS 130,A00,889398,Staff,23,0,25,2
1746581531853,LTEA 138,A00,889399,Staff,24,0,40,16
1746581532881,LTEN 149,A00,889400,Wesling; Megan E.,0,3,25,25
1746581533906,LTEN 169,A00,889401,Staff,20,0,25,5
1746581534937,LTEN 180,A00,889402,Staff,10,0,15,5
1746581535966,LTEN 181,A00,889403,Staff,21,0,25,4
1746581536997,LTWL 100,A00,889404,Myerston Santana; Jacobo,2,0,25,23
1746581538023,LTWL 180GS,A00,889405,Staff,0,0,20,20
1746581539052,LTWL 181,A00,889406,Staff,16,0,25,9
1746581540078,LTWL 184,A00,889475,Mukherjee; Silpa,22,0,25,3
1746581541146,LTWR 102C,A00,889486,Staff,29,0,30,1
1746581542172,LTWR 115W,A00,889491,Staff,0,2,15,15
1746581543199,MAE 8,A01,886905,Staff,0,2,0,0
1746581544229,MAE 11,A00,886906,Bandaru; Prabhakar,0,7,50,50
1746581545253,MAE 20,A00,886907,Evdokimenko; Ekaterina,43,0,70,27
1746581546279,MAE 30B,A00,886909,Ghazinejad; Maziar,26,0,45,19
1746581547307,MAE 101B,A00,886910,Saintillan; David,29,0,45,16
1746581548332,MAE 105,A00,886911,Bandaru; Prabhakar,18,0,50,32
1746581549357,MAE 107,B00,958024,Staff,8,0,50,42
1746581550382,MAE 143B,A00,886913,Bewley; Thomas R,3,0,40,37
1746581551407,MAE 148,A01,886915,Silberman; Jack,0,3,14,14
1746581552432,MAE 160,A00,886916,Evdokimenko; Ekaterina,31,0,60,29
1746581553460,MATH 3C,A01,889681,Staff,0,2,30,30
1746581553460,MATH 3C,A02,960048,Staff,24,0,30,6
1746581554486,MATH 10A,A01,889760,Staff,26,0,30,4
1746581554486,MATH 10A,A02,889783,Staff,29,0,30,1
1746581555517,MATH 10B,A01,889785,Verstraete; Jacques Allan,1,0,35,34
1746581555517,MATH 10B,A02,889795,Verstraete; Jacques Allan,4,0,35,31
1746581555517,MATH 10B,B01,889797,Verstraete; Jacques Allan,3,0,35,32
1746581555517,MATH 10B,B02,889828,Verstraete; Jacques Allan,3,0,35,32
1746581556544,MATH 10C,A01,889849,Habib; Yousaf,7,0,30,23
1746581556544,MATH 10C,A02,889852,Habib; Yousaf,14,0,30,16
1746581556544,MATH 10C,A03,889853,Habib; Yousaf,22,0,30,8
1746581556544,MATH 10C,A04,889858,Habib; Yousaf,20,0,30,10
1746581556544,MATH 10C,B01,889861,Staff,1,0,30,29
1746581556544,MATH 10C,B02,889862,Staff,24,0,30,6
1746581556544,MATH 10C,B03,889863,Staff,27,0,30,3
1746581556544,MATH 10C,B04,889967,Staff,23,0,30,7
1746581557575,MATH 18,A01,889974,Staff,7,0,30,23
1746581557575,MATH 18,A02,889977,Staff,20,0,30,10
1746581557575,MATH 18,B01,889984,Hardiman; Liam,20,0,30,10
1746581557575,MATH 18,B02,889985,Hardiman; Liam,25,0,30,5
1746581558600,MATH 20A,A01,889990,Suk; Andrew Hoon,30,0,35,5
1746581559626,MATH 20B,A01,889993,Ohm; Ko Woon,22,0,30,8
1746581559626,MATH 20B,A02,889994,Ohm; Ko Woon,30,0,30,0
1746581559626,MATH 20B,B01,889996,Ohm; Ko Woon,22,0,30,8
1746581559626,MATH 20B,B02,889997,Ohm; Ko Woon,23,0,30,7
1746581560651,MATH 20C,A01,889999,Hammock; Frances H,17,0,30,13
1746581560651,MATH 20C,A02,890003,Hammock; Frances H,23,0,30,7
1746581560651,MATH 20C,B01,890006,Hammock; Frances H,3,0,30,27
1746581560651,MATH 20C,B02,890007,Hammock; Frances H,12,0,30,18
1746581561681,MATH 20D,A01,890011,Cheng; Hsiao-Bing,1,1,30,29
1746581561681,MATH 20D,A02,890012,Cheng; Hsiao-Bing,14,0,30,16
1746581561681,MATH 20D,B01,890016,Cheng; Hsiao-Bing,13,0,30,17
1746581561681,MATH 20D,B02,890017,Cheng; Hsiao-Bing,13,0,30,17
1746581562712,MATH 20E,A01,890026,Harel; Guershon,1,0,30,29
1746581562712,MATH 20E,A02,890029,Harel; Guershon,22,0,30,8
1746581562712,MATH 20E,B01,890033,Harel; Guershon,7,0,30,23
1746581562712,MATH 20E,B02,890101,Harel; Guershon,21,0,30,9
1746581563741,MATH 102,A01,890104,Staff,18,0,30,12
1746581563741,MATH 102,A02,890105,Staff,27,0,30,3
1746581564770,MATH 103B,A01,890116,Salehi Golsefidy; Alireza,3,0,30,27
1746581564770,MATH 103B,B01,890118,Staff,0,3,34,34
1746581565800,MATH 109,A01,890121,Aliabadi Sr.; Mohsen,0,0,30,30
1746581565800,MATH 109,B01,890124,Upadrashta; Pranav Kumar,18,0,30,12
1746581566826,MATH 120A,A01,890126,Eggers; John Dietrich,13,0,30,17
1746581567852,MATH 142B,A01,890128,Ioana; Adrian,19,0,30,11
1746581567852,MATH 142B,A02,890129,Ioana; Adrian,12,0,30,18
1746581568881,MATH 154,A01,890174,Staff,0,0,30,30
1746581568881,MATH 154,A02,890182,Staff,0,0,30,30
1746581569906,MATH 168A,A01,890197,Dumitriu; Ioana,21,0,35,14
1746581570932,MATH 170A,A01,890240,Nie; Jiawang,1,0,30,29
1746581570932,MATH 170A,A02,890241,Nie; Jiawang,11,0,30,19
1746581570932,MATH 170A,A03,890249,Nie; Jiawang,23,0,30,7
1746581571958,MATH 170B,A01,957891,Nag; Panchali,13,0,35,22
1746581574008,MATH 181A,A01,908025,Staff,0,3,35,35
1746581574008,MATH 181A,A02,960115,Staff,26,0,35,9
1746581575033,MATH 181B,A01,959874,Staff,25,0,30,5
1746581576063,MATH 193B,A01,890265,Staff,0,4,35,35
1746581577091,MGT 4,A01,890311,Anderson; John Charles,42,0,88,46
1746581578120,MGT 5,A00,907740,Staff,13,0,98,85
1746581579147,MGT 12,A00,890312,Lindenberger; Wade Douglas,67,0,98,31
1746581580173,MGT 16,A00,957883,Staff,78,0,98,20
1746581582238,MGT 45,A00,890314,Pecore; Joseph P.,45,0,98,53
1746581583268,MGT 71,A00,890315,Staff,0,12,98,98
1746581584292,MGT 100,A00,890316,Yavorsky; Daniel Ryan,44,0,98,54
1746581585322,MGT 103,A00,890317,Ehrich; Kristine R,73,0,98,25
1746581586348,MGT 105,A00,890356,Bates; Kenneth Walter,0,8,98,98
1746581587372,MGT 112,A00,890360,Ehrich; Kristine R,55,0,98,43
1746581588399,MGT 127R,A00,907732,Zhu; Kevin Xiaoguo,23,0,98,75
1746581589424,MGT 131B,A00,890361,Anderson; John Charles,59,0,98,39
1746581590449,MGT 137,A00,890362,Lindenberger; Wade Douglas,65,0,98,33
1746581591477,MGT 160,A00,890369,Johnson; Erik Barry,9,0,98,89
1746581593529,MGT 164,A00,890372,Zimmermann; Carsten,0,40,98,98
1746581594555,MGT 180,A00,890374,Bliss; Barbara Ann,12,0,98,86
1746581595581,MMW 15,A01,886414,Chang; Edmond Yi-Teh,0,12,28,28
1746581595581,MMW 15,A02,886415,Chang; Edmond Yi-Teh,0,8,28,28
1746581595581,MMW 15,A03,886416,Chang; Edmond Yi-Teh,0,9,28,28
1746581595581,MMW 15,A04,886417,Chang; Edmond Yi-Teh,0,8,28,28
1746581595581,MMW 15,B01,886419,Chang; Edmond Yi-Teh,0,7,28,28
1746581595581,MMW 15,B02,886420,Chang; Edmond Yi-Teh,0,8,28,28
1746581595581,MMW 15,B03,886421,Chang; Edmond Yi-Teh,0,7,28,28
1746581595581,MMW 15,B04,886422,Chang; Edmond Yi-Teh,0,8,28,28
1746581595581,MMW 15,C01,886424,Staff,0,9,28,28
1746581595581,MMW 15,C02,886425,Staff,0,8,28,28
1746581595581,MMW 15,C03,886426,Staff,0,8,28,28
1746581595581,MMW 15,C04,886427,Staff,0,8,28,28
1746581595581,MMW 15,C05,958038,Staff,0,8,28,28
1746581595581,MMW 15,C06,958039,Staff,1,8,28,27
1746581596607,MMW 15GS,A00,906910,Patterson; Patrick H.,4,0,28,24
1746581597635,MMW 122R,A01,886429,Rahimi; Babak,0,13,28,28
1746581597635,MMW 122R,A02,886430,Rahimi; Babak,0,12,28,28
1746581597635,MMW 122R,A03,958040,Rahimi; Babak,0,11,28,28
1746581598661,MUS 1A,A01,890937,Staff,2,0,25,23
1746581598661,MUS 1A,A02,891035,Staff,6,0,25,19
1746581598661,MUS 1A,C01,958912,Staff,24,0,25,1
1746581598661,MUS 1A,C02,958913,Staff,25,0,25,0
1746581600713,MUS 2AK,A00,957092,Ohnishi; Takae,15,0,15,0
1746581601746,MUS 4,A01,891044,Staff,1,0,25,24
1746581601746,MUS 4,A02,891045,Staff,23,0,25,2
1746581601746,MUS 4,B01,891048,Staff,17,0,25,8
1746581601746,MUS 4,B02,891050,Staff,25,0,25,0
1746581602771,MUS 5,A01,957506,Dubnov; Shlomo,0,0,25,25
1746581602771,MUS 5,A02,957622,Dubnov; Shlomo,13,0,25,12
1746581602771,MUS 5,A03,957623,Dubnov; Shlomo,20,0,25,5
1746581603796,MUS 6,A01,891053,Freitas Caetano; Marcelo,24,0,25,1
1746581603796,MUS 6,A02,891054,Freitas Caetano; Marcelo,23,0,25,2
1746581604822,MUS 7,A01,891081,Staff,0,0,25,25
1746581604822,MUS 7,A02,891082,Staff,3,0,25,22
1746581605851,MUS 8GS,A00,891118,Borgo; David Garcia,1,0,25,24
1746581606878,MUS 11,A01,891140,Staff,9,0,25,16
1746581606878,MUS 11,A02,891141,Staff,21,0,25,4
1746581607907,MUS 13,A01,891143,Staff,8,0,25,17
1746581607907,MUS 13,A02,891144,Staff,24,0,25,1
1746581608934,MUS 15,A01,891146,Staff,9,0,25,16
1746581608934,MUS 15,A02,891148,Staff,21,0,25,4
1746581608934,MUS 15,B01,891150,Staff,18,0,25,7
1746581608934,MUS 15,B02,891151,Staff,25,0,25,0
1746581609958,MUS 20,A01,891153,Staff,5,0,20,15
1746581609958,MUS 20,A02,891155,Staff,14,0,20,6
1746581610987,MUS 80,A00,891156,Staff,19,0,25,6
1746581610987,MUS 80,B00,891157,Staff,23,0,25,2
1746581612012,MUS 130,A00,891158,Ohnishi; Takae,35,0,35,0
1746581613039,MUS 150GS,A01,891160,Borgo; David Garcia,1,0,25,24
1746581614067,MUS 170,A01,891162,Freitas Caetano; Marcelo,20,0,25,5
1746581614067,MUS 170,A02,891164,Freitas Caetano; Marcelo,21,0,25,4
1746581615097,NANO 11,A00,886220,Vazquez Mena; Oscar,13,0,15,2
1746581616125,NANO 15,A01,886222,Drews; Aaron,4,0,7,3
1746581617153,NANO 104,A00,886224,Sirbuly; Donald,17,0,25,8
1746581618178,PH 40,A00,886528,Staff,24,0,40,16
1746581619215,PH 45,A01,886799,Staff,35,0,40,5
1746581620239,PH 110,A00,886802,Staff,0,7,40,40
1746581621264,PH 172,A00,906716,Staff,19,0,35,16
1746581622291,PH 191,A00,886803,Staff,6,0,40,34
1746581623317,PHIL 1,A00,889500,Staff,20,0,30,10
1746581624343,PHIL 10,A01,889549,Grush; Rick Scott,16,0,22,6
1746581624343,PHIL 10,A02,889551,Grush; Rick Scott,22,0,22,0
1746581625372,PHIL 28,A01,889559,Lamey; Andy M.,0,2,31,31
1746581625372,PHIL 28,A02,889561,Lamey; Andy M.,0,1,30,30
1746581625372,PHIL 28,A03,889572,Lamey; Andy M.,0,1,30,30
1746581626399,PHIL 35,A00,907839,Staff,13,0,15,2
1746581627429,PHIL 60,A00,889574,Staff,73,0,90,17
1746581628454,PHIL 101,A00,958004,Staff,12,0,15,3
1746581630516,PHIL 136,A00,889582,Fulkerson; Matthew Todd,26,0,45,19
1746581631541,PHIL 163,A01,889601,Staff,21,0,30,9
1746581631541,PHIL 163,B01,889606,Brandt; Reuven A,0,3,0,0
1746581632566,PHIL 164,A00,889610,Staff,16,0,30,14
1746581633595,PHIL 165,A00,889613,Staff,22,0,30,8
1746581634619,PHYS 1A,A00,886431,Staff,28,0,70,42
1746581635648,PHYS 1AL,001,886432,Tsai; Philbert S,1,2,30,29
1746581635648,PHYS 1AL,002,886436,Tsai; Philbert S,11,0,30,19
1746581636677,PHYS 1B,A00,886439,Staff,184,0,240,56
1746581637702,PHYS 1BL,001,886441,Tsai; Philbert S,0,4,30,30
1746581637702,PHYS 1BL,002,886444,Tsai; Philbert S,2,0,30,28
1746581638727,PHYS 1C,A00,896092,Arnold; Kam S,78,0,146,68
1746581639753,PHYS 1CL,001,886448,Tsai; Philbert S,0,0,30,30
1746581639753,PHYS 1CL,002,886449,Tsai; Philbert S,1,0,30,29
1746581639753,PHYS 1CL,003,886450,Tsai; Philbert S,16,0,30,14
1746581639753,PHYS 1CL,004,886451,Tsai; Philbert S,15,0,30,15
1746581640779,PHYS 2B,A01,886457,Staff,67,0,115,48
1746581641804,PHYS 2C,A01,886460,Shotwell; Brian,0,9,65,65
1746581642828,PHYS 2CL,A01,886467,Staff,0,4,28,28
1746581642828,PHYS 2CL,A02,886468,Staff,0,3,28,28
1746581643859,PHYS 2D,A01,886470,Staff,10,0,50,40
1746581644927,PHYS 4B,A01,886475,Grinstein; Benjamin,22,0,40,18
1746581645958,POLI 5,A00,891173,Desposato; Scott,7,0,25,18
1746581646987,POLI 5D,A01,891175,Staff,5,0,5,0
1746581646987,POLI 5D,B01,891178,Staff,5,0,5,0
1746581648016,POLI 11,A00,891179,Ferree; Karen E,2,0,35,33
1746581649045,POLI 12,A00,891180,Staff,16,0,30,14
1746581650075,POLI 27,A01,891182,Staff,12,0,75,63
1746581651101,POLI 30,A00,891183,Staff,8,0,50,42
1746581652129,POLI 100B,A00,891244,Staff,5,1,35,30
1746581653157,POLI 100I,A00,891247,Staff,7,0,30,23
1746581654183,POLI 104J,A00,891248,Nichter; Maysa,14,0,30,16
1746581655209,POLI 104U,A00,891250,Nichter; Maysa,1,0,30,29
1746581657261,POLI 110B,A00,891255,Wiens; David,19,0,25,6
1746581658284,POLI 112A,A00,891256,Wiens; David,6,0,25,19
1746581659309,POLI 114BR,A00,891261,Staff,19,0,30,11
1746581660334,POLI 117R,A00,891262,Forman; Fonna,0,6,50,50
1746581661364,POLI 118,A00,891264,Ingham; Sean,17,0,25,8
1746581662398,POLI 124A,A00,891265,Staff,18,0,20,2
1746581663424,POLI 125D,A00,891266,Nichter; Simeon C,2,0,25,23
1746581664448,POLI 126,A00,891268,Nichter; Simeon C,7,0,25,18
1746581665473,POLI 126AA,A00,891272,Staff,15,0,25,10
1746581666502,POLI 130AA,A00,891273,Staff,15,0,20,5
1746581667526,POLI 134AA,A00,891274,Staff,4,0,20,16
1746581669580,POLI 138,A00,891278,Staff,21,0,25,4
1746581670606,POLI 142K,A00,891280,Staff,10,0,25,15
1746581671633,POLI 142M,A00,891281,Gartzke; Erik,16,0,30,14
1746581672659,POLI 142P,A00,891284,Staff,20,0,30,10
1746581673688,POLI 143,A00,891285,Gartzke; Erik,12,0,30,18
1746581674713,POLI 153,A00,891286,Staff,19,0,20,1
1746581676767,POLI 175,A00,891290,Staff,15,0,20,5
1746581677791,PSYC 1,A00,890674,Steiner; Eric Tomas,0,11,45,45
1746581678824,PSYC 2,A00,890676,Albright; Thomas D,20,0,35,15
1746581679852,PSYC 3,A00,890679,Staff,17,0,20,3
1746581680879,PSYC 6,A00,959858,Staff,19,0,20,1
1746581681904,PSYC 60,A01,890684,Rickard; Timothy C.,0,5,45,45
1746581682931,PSYC 70,A01,890689,Geller; Emma Harlan,6,0,30,24
1746581683961,PSYC 71,A01,959860,Staff,21,0,25,4
1746581684986,PSYC 100,A00,890690,Lacefield; Katharine I,0,50,180,180
1746581686012,PSYC 102,A00,890695,Staff,18,0,40,22
1746581687038,PSYC 105,A00,890699,Geller; Emma Harlan,70,0,100,30
1746581688063,PSYC 106,A00,890701,Gorman; Michael R.,5,0,30,25
1746581689087,PSYC 108,A00,890704,Adrian; Julia Anna,0,28,50,50
1746581690117,PSYC 118,A01,890712,Staff,11,0,30,19
1746581691143,PSYC 124,A00,890716,Chapman; Eddie Nathaniel,25,0,60,35
1746581692170,PSYC 131,A00,890717,Anagnostaras; Stephan,0,7,80,80
1746581693199,PSYC 137,A00,890719,Winkielman; Piotr,0,11,30,30
1746581694225,PSYC 144,A00,890721,Adrian; Julia Anna,0,9,45,45
1746581695249,PSYC 162,A00,890805,Staff,0,0,75,75
1746581696278,PSYC 169,A00,890810,Staff,0,14,30,30
1746581697302,PSYC 172,A00,890814,Gorman; Michael R.,9,0,30,21
1746581698326,PSYC 181,A00,890818,Anagnostaras; Stephan,7,0,200,193
1746581699352,PSYC 184,A00,959861,Staff,164,0,175,11
1746581700379,PSYC 189,A00,890823,Staff,0,2,30,30
1746581701409,PSYC 191,A00,890884,Rickard; Timothy C.,0,12,35,35
1746581702436,PSYC 193,A00,890913,Staff,19,0,30,11
1746581702436,PSYC 193,B00,890914,Chapman; Eddie Nathaniel,24,0,30,6
1746581703464,PSYC 193L,A01,890918,Lowe; Angela Beth,20,0,30,10
1746581703464,PSYC 193L,B01,890921,Hurwitz; Ethan Scott,20,0,30,10
1746581703464,PSYC 193L,C01,890928,Staff,30,0,30,0
1746581704489,RELI 149,A00,886806,Rahimi; Babak,23,0,40,17
1746581705518,SE 9,A01,886814,Staff,7,0,20,13
1746581706543,SE 101B,A01,886816,Chadha; Mayank,4,0,35,31
1746581707568,SE 110B,A00,886818,Zhu; Qiang,4,0,75,71
1746581708594,SE 125,A01,886830,Staff,10,0,30,20
1746581709622,SE 130B,A01,886835,Staff,14,0,40,26
1746581710648,SE 131A,A01,886838,Krysl; Petr,34,0,55,21
1746581711673,SE 154,A00,886840,Staff,29,0,50,21
1746581712715,SE 164GS,A01,886849,Staff,6,0,20,14
1746581713741,SE 167GS,A01,886853,Staff,6,0,20,14
1746581714772,SIO 25,A01,890107,Staff,19,0,30,11
1746581715800,SIO 45,A00,890109,Cook; Geoffrey W,116,0,200,84
1746581716825,SIO 109R,A00,890110,Forman; Fonna,0,16,20,20
1746581717854,SIO 187,A01,890114,Kacev; David,15,0,40,25
1746581718879,SOCI 1,A01,890431,Thorpe; Charles Robert,14,0,30,16
1746581718879,SOCI 1,A02,890518,Thorpe; Charles Robert,30,0,30,0
1746581719903,SOCI 2,A01,957978,Staff,25,0,25,0
1746581719903,SOCI 2,A02,957979,Staff,23,0,25,2
1746581720933,SOCI 20,A01,890523,Calderon-Zaks; Michael Aar,21,0,30,9
1746581720933,SOCI 20,A02,890526,Calderon-Zaks; Michael Aar,29,0,30,1
1746581721957,SOCI 30,A01,890533,Pardo Guerra; Juan Pablo,37,0,40,3
1746581722981,SOCI 40,A01,890535,Staff,27,0,45,18
1746581724011,SOCI 104Q,A00,890559,Staff,18,0,30,12
1746581725105,SOCI 106,A00,890560,Arnal; Maud Marie Leonie,20,0,30,10
1746581726133,SOCI 110,A00,890567,Holkenbrink-Monk; Charlene,19,0,30,11
1746581727158,SOCI 112,A00,890568,Victoria Torres; Pablo,2,0,55,53
1746581728183,SOCI 115,A00,890597,Arnal; Maud Marie Leonie,28,0,45,17
1746581730232,SOCI 121,A00,890604,Pardo Guerra; Juan Pablo,38,0,45,7
1746581731260,SOCI 126,A01,890608,Staff,8,0,10,2
1746581732285,SOCI 127,A00,890609,Staff,18,0,30,12
1746581733309,SOCI 131,A00,890610,Thorpe; Charles Robert,37,0,45,8
1746581734337,SOCI 135,A00,890615,Payne; Christine Anna,13,0,45,32
1746581735366,SOCI 139,A00,890620,Staff,38,0,45,7
1746581736395,SOCI 148E,A00,890622,Calderon-Zaks; Michael Aar,36,0,45,9
1746581737419,SOCI 150,A00,890623,Kohler; Kristopher M.,31,0,45,14
1746581738444,SOCI 157,A00,890625,Jules-Rosette; Bennetta W.,18,0,20,2
1746581739468,SOCI 160,A00,890627,Payne; Christine Anna,21,0,45,24
1746581740495,SYN 1,A00,886855,Fish; Gwendolyn Anne,0,1,0,0
1746581740495,SYN 1,B00,906086,Fish; Gwendolyn Anne,0,2,0,2
1746581741525,SYN 2R,A00,886860,Staff,0,17,15,15
1746581741525,SYN 2R,B00,906106,Atkinson; Arthur Laird,0,16,15,15
1746581742556,SYN 100,A01,886866,Browne; Emily,0,28,20,20
1746581742556,SYN 100,B01,906128,Rock; Martin,0,4,20,20
1746581742556,SYN 100,C01,906140,Deavenport; James Cary,0,3,20,20
1746581742556,SYN 100,D01,907816,Deavenport; James Cary,0,5,20,20
1746581743584,TDAC 1,A00,890286,Walsh; Kim C.,7,0,20,13
1746581744612,TDAC 101,A00,890296,Basso; Beatrice,15,0,20,5
1746581745637,TDDE 131,A00,890297,Staff,47,0,50,3
1746581746660,TDDM 1,A00,890287,Weinberg; Sadie,25,0,30,5
1746581747689,TDGE 11,A00,890288,Fulton; Julia,138,0,200,62
1746581747689,TDGE 11,B00,890289,Castro; Robert Jess,184,0,200,16
1746581748717,TDGE 25,B00,957359,Walsh; Kim C.,5,0,20,15
1746581749745,TDGE 40,A01,890292,Power; Jade Yukana,27,0,30,3
1746581750771,TDGE 124,A00,890298,Havis; Allan,0,1,50,50
1746581751834,TDGE 131R,A00,890299,Burelle; Julie Sara Veronique,15,0,42,27
1746581752862,TDHT 101,A00,890300,Staff,10,0,20,10
1746581753887,TDHT 109,A01,890302,Anderson; Mysia Anyse,31,0,40,9
1746581754911,TDMV 1,A00,890293,Arcidiacono; Kristin,18,0,30,12
1746581755937,TDMV 2,A00,890294,Weinberg; Sadie,23,0,30,7
1746581756964,TDMV 3,A00,957878,Arcidiacono; Kristin,28,0,30,2
1746581759015,TDMV 138,A00,890304,Jun; Grace Shin Hae,25,0,40,15
1746581760040,TDMV 140,A00,890305,Corrales; Joseph Bernales,25,0,30,5
1746581761064,TDMV 142,A00,890307,Caligagan; Tony,32,0,40,8
1746581762093,TDMV 144,A00,890308,Camaya; Michelle Ann,25,0,30,5
1746581763118,TDPW 1,A00,890295,Stein; Deborah Isobel,3,0,20,17
1746581764145,USP 2,A01,890272,Lerner; Amy M,7,0,20,13
1746581765170,USP 3,A01,890274,Staff,12,0,30,18
1746581766195,USP 15,A01,890276,Sun; Feiyang,16,0,30,14
1746581767221,USP 25,A00,890277,Shenkman; Michael Thomas,18,0,25,7
1746581768245,USP 138,A00,890278,Staff,14,0,25,11
1746581769271,USP 143,A00,890279,Staff,22,0,70,48
1746581770303,USP 144,A00,890280,Chowdhury; Muhammed Zohir,16,0,30,14
1746581771330,USP 150,A00,890281,Boomhower; Matthew Charles,4,0,30,26
1746581772357,USP 151,A00,890282,Staff,16,0,20,4
1746581773381,USP 162,A00,890283,Andrews; Abigail Leslie,16,0,20,4
1746581774408,USP 168,A00,920477,Kwak; Nancy,0,0,5,5
1746581775434,USP 181,A00,890284,Staff,3,0,20,17
1746581776462,USP 191A,A00,890285,Staff,12,0,20,8
1746581777489,VIS 101,A00,886512,Staff,26,0,75,49
1746581778516,VIS 103,A00,886513,Cruz; Edwin Teddy,61,0,75,14
1746581779542,VIS 108,A00,886514,Staff,3,0,15,12
1746581780571,VIS 127P,A00,886515,Shen; Kuiyi,79,0,146,67
1746581781597,VIS 149,A00,886516,Yoldas; Pinar,0,0,15,15
1746581782623,VIS 164,A00,886526,Erdmann; Dean,19,0,22,3
1746581783648,VIS 194S,A00,886527,Staff,61,0,75,14
1746581784676,WCWP 10A,C00,886484,Martiniuk; Jill,12,0,15,3
1746581785703,WCWP 10B,A00,886490,Uriarte; Emma,0,0,15,15
1746581785703,WCWP 10B,B00,886491,Dhir; Simrita,8,0,15,7
1746581785703,WCWP 10B,C00,886492,Ornelas; Tricia,0,0,15,15
1746581786732,WCWP 100,A00,886494,Young; Mark T,0,6,15,15
1746581788844,AAS 10,A01,886199,Childs; Dennis R.,0,3,0,0
1746581789873,ANAR 104,A01,886940,Shtienberg; Gilad,27,0,30,3
1746581790900,ANAR 120,A00,886953,Staff,13,0,20,7
1746581791926,ANBI 148,A01,886955,Wilder; Linnea Lorene,30,0,40,10
1746581793976,ANSC 122,A00,886957,Staff,25,0,30,5
1746581795002,ANSC 150,A00,886958,Sloane; Julia Kathryn,2,0,15,13
1746581796028,ANSC 156,A00,886959,Jenkins; Janis A.,0,1,15,15
1746581797052,ANSC 180,A00,886960,Staff,11,0,17,6
1746581798080,ANSC 188,A00,886961,Jassal; Aftab,9,0,25,16
1746581799105,ANSC 190,A00,886962,Jassal; Aftab,14,0,25,11
1746581800132,ANSC 191,A00,886963,Staff,18,0,20,2
1746581801158,ANTH 3,A01,891689,Staff,17,0,20,3
1746581802184,ANTH 5,A00,886933,Semendeferi; Ekaterini,16,0,20,4
1746581803208,ANTH 10,A00,886934,Staff,0,12,30,30
1746581804231,ANTH 21,A01,886936,Staff,41,0,60,19
1746581805261,ANTH 23,A01,886938,Staff,92,0,100,8
1746581806289,ANTH 105,A00,886964,Stewart; Alexander B,84,0,100,16
1746581807314,ANTH 108,A00,886965,Pedersen; David,9,0,20,11
1746581808341,AWP 10,001,886147,Staff,0,0,0,0
1746581808341,AWP 10,002,886148,Staff,0,0,0,0
1746581808341,AWP 10,003,886149,Staff,0,0,0,0
1746581808341,AWP 10,004,886150,Staff,0,0,0,0
1746581808341,AWP 10,005,886151,Staff,0,0,0,0
1746581808341,AWP 10,006,886152,Staff,0,0,0,0
1746581808341,AWP 10,007,886153,Staff,0,0,0,0
1746581808341,AWP 10,008,886154,Staff,0,0,0,0
1746581808341,AWP 10,009,886155,Staff,0,0,0,0
1746581808341,AWP 10,010,886156,Staff,0,0,0,0
1746581808341,AWP 10,011,886158,Staff,0,0,0,0
1746581808341,AWP 10,012,886160,Staff,0,0,0,0
1746581808341,AWP 10,013,886161,Staff,0,0,0,0
1746581808341,AWP 10,014,886162,Staff,0,0,0,0
1746581808341,AWP 10,015,886163,Staff,0,0,0,0
1746581808341,AWP 10,016,886164,Staff,0,0,0,0
1746581808341,AWP 10,017,886165,Staff,0,0,0,0
1746581808341,AWP 10,018,886166,Staff,0,0,0,0
1746581808341,AWP 10,019,886168,Staff,0,0,0,0
1746581808341,AWP 10,020,886170,Staff,0,0,0,0
1746581808341,AWP 10,021,886172,Staff,0,0,0,0
1746581809375,AWP 10R,001,886173,Staff,0,1,0,0
1746581809375,AWP 10R,002,886174,Staff,0,1,0,0
1746581809375,AWP 10R,003,886175,Staff,0,0,0,0
1746581809375,AWP 10R,004,886176,Staff,0,0,0,0
1746581809375,AWP 10R,005,886177,Staff,0,0,0,0
1746581809375,AWP 10R,006,886178,Staff,0,0,0,0
1746581809375,AWP 10R,007,886179,Staff,0,0,0,0
1746581809375,AWP 10R,008,886181,Staff,0,0,0,0
1746581809375,AWP 10R,009,886182,Staff,0,0,0,0
1746581809375,AWP 10R,010,886183,Staff,0,0,0,0
1746581809375,AWP 10R,011,886184,Staff,0,0,0,0
1746581809375,AWP 10R,012,886185,Staff,0,0,0,0
1746581809375,AWP 10R,013,886186,Staff,0,0,0,0
1746581809375,AWP 10R,014,886187,Staff,0,0,0,0
1746581809375,AWP 10R,015,886188,Staff,0,0,0,0
1746581809375,AWP 10R,016,886189,Staff,0,0,0,0
1746581809375,AWP 10R,017,960532,Staff,0,0,0,0
1746581809375,AWP 10R,018,960533,Staff,0,0,0,0
1746581809375,AWP 10R,019,960534,Staff,0,0,0,0
1746581809375,AWP 10R,020,960538,Staff,0,0,0,0
1746581809375,AWP 10R,021,960540,Staff,0,0,0,0
1746581809375,AWP 10R,022,960541,Staff,0,0,0,0
1746581809375,AWP 10R,023,960542,Staff,0,0,0,0
1746581809375,AWP 10R,024,960544,Staff,0,0,0,0
1746581809375,AWP 10R,025,960545,Staff,0,0,0,0
1746581809375,AWP 10R,026,960548,Staff,0,0,0,0
1746581810404,AWP 102R,A00,886190,Staff,0,0,0,0
1746581810404,AWP 102R,B00,886191,Staff,0,0,0,0
1746581811429,BENG 100,A01,886193,Staff,17,0,30,13
1746581812456,BENG 122A,A01,886195,Hasty; Jeff M,13,0,30,17
1746581813485,BENG 166A,A00,886196,Sah; Robert Lie-Yuan,0,3,30,30
1746581814511,BENG 190,A00,958050,Khojah; Reem I,18,0,25,7
1746581815539,BIBC 102,A01,894320,Staff,0,0,46,46
1746581815539,BIBC 102,A02,894321,Staff,0,0,46,46
1746581815539,BIBC 102,A03,894344,Staff,6,0,46,40
1746581815539,BIBC 102,A04,894345,Staff,27,0,47,20
1746581816565,BICD 100R,A01,894365,Smith; Laurie,0,3,58,58
1746581816565,BICD 100R,A02,894366,Smith; Laurie,0,5,58,58
1746581816565,BICD 100R,A03,894367,Smith; Laurie,0,0,59,59
1746581816565,BICD 100R,A04,959869,Smith; Laurie,40,0,59,19
1746581817590,BICD 136,A01,894383,Gustafson-Brown; Cindy,14,0,50,36
1746581818614,BIEB 102,A01,894494,Butler; Shannon Rhey,51,0,130,79
1746581820670,BIEB 150,A01,894617,Wills; Christopher,3,0,20,17
1746581820670,BIEB 150,A02,894631,Wills; Christopher,3,0,20,17
1746581820670,BIEB 150,A03,894937,Wills; Christopher,3,0,20,17
1746581820670,BIEB 150,A04,894946,Wills; Christopher,5,0,20,15
1746581821697,BIEB 194,A00,906141,Kurle; Carolyn M.,6,0,20,14
1746581822723,BILD 1,A01,894154,Staff,3,0,19,16
1746581822723,BILD 1,A02,894155,Staff,14,0,19,5
1746581822723,BILD 1,A03,894160,Staff,13,0,19,6
1746581822723,BILD 1,A04,894161,Staff,15,0,18,3
1746581823749,BILD 2,A01,894168,Staff,0,0,50,50
1746581823749,BILD 2,A02,894169,Staff,0,0,50,50
1746581823749,BILD 2,A03,894179,Staff,0,0,50,50
1746581823749,BILD 2,A04,894203,Staff,24,0,50,26
1746581824773,BILD 3,A01,894213,Staff,23,0,31,8
1746581824773,BILD 3,A02,894214,Staff,26,0,31,5
1746581824773,BILD 3,A03,894235,Staff,28,0,31,3
1746581824773,BILD 3,A04,894236,Staff,28,0,32,4
1746581825798,BILD 4,A01,894253,Reuther; Keefe,5,0,24,19
1746581825798,BILD 4,A02,894258,Reuther; Keefe,16,0,24,8
1746581826827,BILD 5,A01,894276,Reuther; Keefe,35,0,50,15
1746581826827,BILD 5,A02,894277,Reuther; Keefe,45,0,50,5
1746581826827,BILD 5,A03,894290,Reuther; Keefe,44,0,50,6
1746581826827,BILD 5,A04,894291,Reuther; Keefe,48,0,50,2
1746581827853,BILD 24,A01,894297,Pirino; Giorgia,40,0,60,20
1746581828877,BIMM 100,B01,958915,Staff,71,0,100,29
1746581829907,BIMM 101,A01,895017,McDonnell; Lisa Marie,0,5,24,24
1746581829907,BIMM 101,A02,895018,McDonnell; Lisa Marie,0,5,24,24
1746581829907,BIMM 101,B01,895020,McDonnell; Lisa Marie,0,6,24,24
1746581829907,BIMM 101,B02,895021,McDonnell; Lisa Marie,0,4,24,24
1746581830932,BIMM 110,A01,895023,Staff,1,0,25,24
1746581830932,BIMM 110,A02,895024,Staff,9,0,25,16
1746581830932,BIMM 110,A03,895025,Staff,18,0,25,7
1746581830932,BIMM 110,A04,895031,Staff,20,0,25,5
1746581831958,BIMM 120,A01,895114,Gustafson-Brown; Cindy,14,0,28,14
1746581831958,BIMM 120,A02,895126,Gustafson-Brown; Cindy,21,0,27,6
1746581832988,BIPN 100,A01,895130,Yang; Mingyu,0,0,38,38
1746581832988,BIPN 100,A02,895131,Yang; Mingyu,31,0,38,7
1746581832988,BIPN 100,A03,895132,Yang; Mingyu,32,0,38,6
1746581832988,BIPN 100,A04,895133,Yang; Mingyu,27,0,36,9
1746581834013,BIPN 120,A01,895135,Cooke; James Edward,0,3,13,13
1746581834013,BIPN 120,A02,895136,Cooke; James Edward,0,1,13,13
1746581834013,BIPN 120,A03,895137,Cooke; James Edward,0,3,13,13
1746581834013,BIPN 120,A04,895156,Cooke; James Edward,0,2,11,11
1746581835045,BIPN 134,A01,895235,Cooke; James Edward,0,2,25,25
1746581835045,BIPN 134,A02,895237,Cooke; James Edward,0,0,25,25
1746581835045,BIPN 134,A03,895240,Cooke; James Edward,3,0,25,22
1746581835045,BIPN 134,A04,895270,Cooke; James Edward,20,0,25,5
1746581836070,BIPN 189,A00,892103,Staff,0,14,14,14
1746581838120,BISP 194,A00,958008,Staff,0,2,0,0
1746581839146,CAT 124,A01,922009,Staff,0,5,20,20
1746581840172,CAT 125R,A00,886390,Morales; Celeste Georgianna,0,2,20,20
1746581840172,CAT 125R,B00,886391,Irwin; Matthew Joseph,0,4,20,20
1746581840172,CAT 125R,C00,886392,Smith; Lauryn Alissa,0,2,20,20
1746581840172,CAT 125R,D00,886393,Vanderschuit; Maya Alysia,0,3,20,20
1746581840172,CAT 125R,E00,886394,Marchisotto; Jennifer Anne,0,3,20,20
1746581841197,CENG 15,A01,886218,Drews; Aaron,3,0,8,5
1746581842227,CENG 113,A00,886219,Opatkiewicz; Justin Paul,15,0,25,10
1746581843255,CGS 101,A00,887044,Staff,7,0,20,13
1746581844280,CGS 105,A01,887046,Staff,14,0,25,11
1746581845304,CGS 112,A00,887047,Cuong; Marisol,12,0,15,3
1746581846328,CGS 113,A00,887048,Staff,23,0,30,7
1746581847357,CGS 120,A00,887049,Staff,10,0,17,7
1746581848387,CHEM 6A,A01,886336,Lam; Tin Yiu,38,0,50,12
1746581848387,CHEM 6A,A02,886338,Lam; Tin Yiu,37,0,50,13
1746581849413,CHEM 6B,A01,886341,Hopkins; Patrycja Anna,16,0,50,34
1746581849413,CHEM 6B,A02,886343,Hopkins; Patrycja Anna,42,0,50,8
1746581850442,CHEM 6C,A01,886346,Albizati; Kim F.,0,2,50,50
1746581850442,CHEM 6C,A02,886348,Albizati; Kim F.,23,0,50,27
1746581851522,CHEM 40A,A01,886352,Klosterman; Jeremy K,65,0,100,35
1746581852551,CHEM 40B,A01,886356,Klosterman; Jeremy K,0,24,100,100
1746581853580,CHEM 41B,A01,886360,Theodorakis; Emmanuel,25,0,50,25
1746581853580,CHEM 41B,A02,886362,Theodorakis; Emmanuel,47,0,50,3
1746581854608,CHIN 165A,A00,886382,Xu; Li,18,0,20,2
1746581855632,CLAS 120,A00,886387,Myerston Santana; Jacobo,33,0,40,7
1746581856659,COGS 9,A01,886967,Shannon; Kyle Michael,42,0,60,18
1746581857683,COGS 11,A01,886969,Staff,9,0,30,21
1746581858709,COGS 14A,A01,886971,Staff,6,0,60,54
1746581859735,COGS 14B,A01,886973,Hoffman; Drew Ellen,4,0,60,56
1746581860765,COGS 18,A01,886975,Morgan; Eric,35,0,60,25
1746581861790,COGS 20,A01,886977,Staff,4,0,8,4
1746581861790,COGS 20,A02,886978,Staff,5,0,7,2
1746581862817,COGS 100,A01,907783,Staff,1,2,30,29
1746581863841,COGS 101B,A01,886980,Staff,0,4,48,48
1746581864866,COGS 101C,A01,886982,Delgado; Tania,0,5,44,44
1746581865896,COGS 102A,A01,886984,Johnson; Christine M.,4,0,30,26
1746581866922,COGS 118B,A01,886986,Staff,1,4,88,87
1746581867951,COGS 150,A01,886988,Bergen; Benjamin,22,0,50,28
1746581868976,COGS 153,A00,886989,Delgado; Tania,0,2,41,41
1746581870001,COGS 186,A01,886991,Staff,0,0,32,32
1746581871028,COGS 187A,A01,886993,Boyle; Mary E. T.,7,0,30,23
1746581872055,COGS 189,A00,886994,Staff,0,1,30,30
1746581873084,COMM 10,A01,886996,Staff,0,0,20,21
1746581873084,COMM 10,A02,886997,Staff,10,0,20,10
1746581873084,COMM 10,A03,959845,Staff,19,0,20,1
1746581874113,COMM 20,A01,886999,Leuning; Grant Maurstad,24,0,40,16
1746581876170,COMM 100A,A01,887002,Staff,0,0,20,25
1746581876170,COMM 100A,A02,887003,Staff,6,0,20,14
1746581877194,COMM 100B,A01,887005,Staff,0,8,20,24
1746581878219,COMM 106D,A00,887006,Staff,13,0,40,27
1746581879244,COMM 110G,A00,887007,Whitworth-Smith; Andrew C,12,0,40,28
1746581880274,COMM 111B,A00,887008,Staff,31,0,40,9
1746581881300,COMM 113T,A00,887009,Abuelhiga; Soraya Jill,28,0,40,12
1746581881300,COMM 113T,B00,906733,Staff,40,0,40,0
1746581882324,COMM 145,A00,887010,Staff,12,0,40,28
1746581883353,COMM 146,A00,887054,Staff,31,0,40,9
1746581884376,COMM 190,A00,887012,Staff,8,0,23,15
1746581885407,CSE 8A,A50,887015,Cao; Yingjun,57,0,85,28
1746581886432,CSE 11,A01,887017,Cao; Yingjun,12,0,70,58
1746581887459,CSE 20,A01,887019,Staff,30,0,50,20
1746581888486,CSE 21,A01,887021,Staff,78,0,100,22
1746581888486,CSE 21,B01,892583,Braun; Oliver,45,0,50,5
1746581889514,CSE 30,A01,887025,Eldon; John,142,0,200,58
1746581890581,CSE 100,A01,887027,Staff,26,0,50,24
1746581890581,CSE 100,A02,887028,Staff,42,0,50,8
1746581891627,CSE 101,A01,887030,Braun; Oliver,74,0,100,26
1746581891627,CSE 101,B01,887032,Jones; Miles E,0,3,50,50
1746581891627,CSE 101,B02,887033,Jones; Miles E,0,2,50,50
1746581892658,CSE 105,A01,908084,Jones; Miles E,32,0,50,18
1746581892658,CSE 105,A02,908087,Jones; Miles E,31,0,50,19
1746581893686,CSE 135,A01,887035,Powell; Thomas Allan,0,5,50,50
1746581894710,CSE 142,A01,887037,Staff,8,0,60,52
1746581895739,CSE 142L,A01,887039,Staff,34,0,60,26
1746581896768,CSE 151A,A01,887041,Solares; Edwin A,47,0,100,53
1746581897791,CSE 175,A01,887043,Kumar; Rakesh,30,0,30,0
1746581898816,CSS 1,A01,886389,Staff,1,2,40,39
1746581899840,DSC 30,A01,908097,Liao; Soohyun Nam,47,0,75,28
1746581900867,DSC 40A,A01,908099,Shannon; Kyle Michael,30,0,50,20
1746581901891,DSC 40B,A01,908112,Staff,15,0,50,35
1746581902918,DSC 80,A01,908116,Staff,19,0,60,41
1746581903945,DSC 197,001,956863,Eldridge; Justin Matthew,9999,0,9999,0
1746581904974,ECE 5,A01,886400,Morris; Karcher William,1,0,6,5
1746581904974,ECE 5,A02,886401,Morris; Karcher William,3,0,6,3
1746581906003,ECE 148,A01,886403,Silberman; Jack,0,14,14,14
1746581907031,ECON 1,A01,887265,Crane; Meredith Helen,12,0,70,58
1746581907031,ECON 1,B01,887268,Staff,42,0,50,8
1746581908056,ECON 2,A01,887273,Crane; Meredith Helen,55,0,70,15
1746581909081,ECON 3,A01,887279,Rondina; Giacomo,32,0,70,38
1746581910106,ECON 4,A01,887282,Anderson; John Charles,0,2,10,10
1746581911133,ECON 5,A01,887285,Staff,34,0,45,11
1746581911133,ECON 5,B01,887292,Staff,41,0,45,4
1746581912162,ECON 100A,A01,887337,Newhouse; Herbert S,54,0,70,16
1746581912162,ECON 100A,B01,887349,Staff,45,0,50,5
1746581913192,ECON 100B,A01,887361,Du; Songzi,29,0,70,41
1746581914218,ECON 100C,A01,887445,Newhouse; Herbert S,59,0,70,11
1746581915245,ECON 105,A00,887488,Vespa; Emanuel Ignacio,23,0,35,12
1746581916271,ECON 109,A01,887506,Shishkin; Denis,28,0,35,7
1746581917298,ECON 110A,A01,887568,Alon; Titan Michael,0,3,35,35
1746581917298,ECON 110A,B01,907601,Alon; Titan Michael,20,0,35,15
1746581918324,ECON 110B,A01,887598,Levkoff; Steven B.,0,24,70,70
1746581919350,ECON 112,A00,887599,Rondina; Giacomo,19,0,35,16
1746581920378,ECON 120A,A01,887603,Dai; Yinlin,35,0,70,35
1746581921404,ECON 120C,A01,887608,Sun; Yixiao,0,1,35,35
1746581921404,ECON 120C,B01,887614,Sun; Yixiao,0,0,35,35
1746581922430,ECON 138,A00,887621,Bharadwaj; Prashant,0,21,20,20
1746581923459,ECON 144,A00,958007,Squires; Dale E,12,0,35,23
1746581924488,ECON 171,A01,907666,Staff,18,0,35,17
1746581925516,ECON 175,A00,887626,Wu; Pak Yeung,22,0,35,13
1746581926544,ECON 190,A00,887640,Vespa; Emanuel Ignacio,22,0,35,13
1746581927576,EDS 25,A01,888197,Staff,0,0,0,0
1746581927576,EDS 25,A02,888209,Staff,0,0,0,0
1746581927576,EDS 25,A03,888210,Staff,0,0,0,0
1746581927576,EDS 25,A04,888212,Staff,0,0,0,0
1746581927576,EDS 25,A05,888213,Staff,0,0,0,0
1746581927576,EDS 25,A06,888214,Staff,0,0,0,0
1746581927576,EDS 25,A07,888235,Staff,0,2,0,0
1746581927576,EDS 25,A08,888236,Staff,0,0,0,0
1746581927576,EDS 25,A09,888240,Staff,0,0,0,0
1746581927576,EDS 25,A10,888244,Staff,0,0,0,0
1746581927576,EDS 25,B01,888273,Staff,0,0,0,0
1746581927576,EDS 25,B02,888285,Staff,0,0,0,0
1746581927576,EDS 25,B03,888423,Staff,0,0,0,1
1746581927576,EDS 25,B04,888432,Staff,0,0,0,0
1746581927576,EDS 25,B05,888433,Staff,0,0,0,0
1746581927576,EDS 25,B06,888467,Staff,0,0,0,0
1746581927576,EDS 25,B07,888468,Staff,0,0,0,0
1746581927576,EDS 25,B08,888479,Staff,0,0,0,0
1746581927576,EDS 25,B09,888484,Staff,0,0,0,0
1746581927576,EDS 25,B10,888487,Staff,0,0,0,0
1746581928603,EDS 38,A01,907700,Choi; Bailey Miyeon,30,0,30,0
1746581929632,EDS 112,A01,888601,Chapman; Thandeka K,12,0,40,28
1746581930657,EDS 115,A00,888697,Mendez; Kathrina Mendoza,10,0,30,20
1746581931683,EDS 116,A01,888893,Staff,34,0,40,6
1746581933737,EDS 124AR,A00,889133,Staff,29,0,50,21
1746581933737,EDS 124AR,B00,907471,Simon; Elizabeth A,37,0,50,13
1746581934762,EDS 124BR,A00,889134,Simon; Elizabeth A,44,0,100,56
1746581935787,EDS 125,A00,889135,Staff,25,0,30,5
1746581936817,EDS 126,A01,889138,Staff,35,0,40,5
1746581937843,EDS 164R,A01,889142,Wishard Guerra; Alison G.,32,0,50,18
1746581938868,ENG 30,A01,886396,Staff,0,0,0,0
1746581938868,ENG 30,B01,886398,Staff,0,0,0,0
1746581939895,ENVR 102,A00,906150,Montejo; Carolina,23,0,25,2
1746581940919,ETHN 103A,A00,887236,Man; Simeon S,0,3,0,0
1746581941947,ETHN 113,A00,887239,Staff,16,0,30,14
1746581942974,ETHN 116,A00,887240,Staff,16,0,25,9
1746581944005,ETHN 117,A00,887241,Choi; Esther Min,28,0,30,2
1746581945031,ETHN 118,A00,887243,Staff,24,0,30,6
1746581946057,ETHN 127,A00,887248,Cuong; Marisol,11,0,15,4
1746581947085,ETHN 139,A00,887250,Staff,7,0,10,3
1746581948110,ETHN 142,A00,887252,Staff,10,0,30,20
1746581949136,ETHN 161,A00,887253,Browne; Errol Tsekani,24,0,30,6
1746581950163,ETHN 163FR,A00,887255,Burelle; Julie Sara Veronique,0,0,5,5
1746581951191,GLBH 20,A00,889149,Elwardani; Nile Regina,8,0,42,34
1746581953248,GLBH 111,A01,889152,Burgos; Jose L.,17,0,17,0
1746581954273,GLBH 150,A00,889181,Sloane; Julia Kathryn,0,5,15,15
1746581956322,HDS 60,A01,886406,Warstadt; Melissa Fawn,73,0,80,7
1746581957347,HIAF 111,A00,889324,Gyamfi; Bright,25,0,32,7
1746581958372,HIEA 131,A00,889328,Staff,15,0,32,17
1746581959395,HIEA 144,A00,889333,Henry; Todd A.,26,0,32,6
1746581960421,HIEA 154,A00,889336,Henry; Todd A.,24,0,32,8
1746581961449,HIEU 106,A00,889339,Staff,22,0,32,10
1746581963503,HIEU 114,A00,889340,Staff,4,0,32,28
1746581964529,HIEU 135GS,A00,889342,Patterson; Patrick H.,0,0,1,24
1746581965558,HIEU 137,A00,889343,Edington; Claire Ellen,10,0,25,15
1746581966584,HIEU 148,A00,889345,Staff,14,0,32,18
1746581967608,HIEU 154,A00,889346,Biess; Frank Peter,21,0,32,11
1746581968634,HILA 102,A00,889351,Staff,12,0,32,20
1746581969659,HILD 2A,A01,889221,Lewandoski; Julia Mavis,1,10,32,31
1746581970685,HILD 7B,A01,889225,Man; Simeon S,0,12,32,32
1746581971710,HILD 7C,A01,889288,Alvarez; Luis A,0,14,32,32
1746581972739,HILD 30,A01,889323,Staff,0,5,32,32
1746581974794,HISC 119,A00,889383,Golan; Tal,19,0,32,13
1746581975821,HIUS 103,A00,889384,Man; Simeon S,0,0,32,32
1746581976849,HIUS 117,A00,919797,Kwak; Nancy,19,0,32,13
1746581977873,HIUS 142A,A00,919788,Staff,22,0,32,10
1746581979932,HIUS 149,A00,889386,Gyamfi; Bright,26,0,32,6
1746581980960,HIUS 155,A00,889387,Alvarez; Luis A,15,0,32,17
1746581981986,HUM 3,A01,886499,Caldwell; Michael Alan,19,0,50,31
1746581983010,HUM 3GS,A00,886500,Rodriguez; Bretton Sigfred,0,0,0,28
1746581984034,HUM 3R,A01,886502,Markman; Kristina,0,36,50,50
1746581985064,HUM 4,A01,886504,Crum; Matthew Stephen,23,0,50,27
1746581985064,HUM 4,B01,886506,West; Geoffrey Scott,17,0,50,33
1746581986092,HUM 4GS,A00,886507,Staff,0,0,0,19
1746581987119,HUM 5,A01,886509,Staff,32,0,50,18
1746581988145,HUM 5R,A01,886511,Zavodny; Tatiana Sophia,0,39,50,50
1746581989169,JAPN 180,A00,886407,Staff,16,0,40,24
1746581990198,LATI 50,A01,886409,Martin-Cabrera; Luis,3,0,22,19
1746581990198,LATI 50,A02,886410,Martin-Cabrera; Luis,19,0,22,3
1746581990198,LATI 50,A03,886411,Martin-Cabrera; Luis,21,0,22,1
1746581990198,LATI 50,A04,886412,Martin-Cabrera; Luis,8,0,22,14
1746581991223,LAWS 101,A00,907664,Staff,28,0,60,32
1746581992247,LIAB 1A,A00,889388,Saab; Dima,17,0,20,3
1746581993275,LIAB 1AX,A00,889389,El Cheddadi; Youniss,18,0,20,2
1746581994303,LIFR 1C,A00,889391,Van Moer; Vinciane G,8,0,20,12
1746581995331,LIFR 1CX,A00,889392,Van Moer; Vinciane G,7,0,20,13
1746581996360,LIFR 1D,A00,889393,Van Moer; Vinciane G,7,0,20,13
1746581997385,LIFR 1DX,A00,889394,Van Moer; Vinciane G,8,0,20,12
1746581998409,LIGN 7,A00,886923,Staff,24,0,50,26
1746581999438,LIGN 17,A00,886924,Kehler; Andrew Scott,125,0,150,25
1746582000463,LTAM 110,A00,889395,Staff,15,0,30,15
1746582001505,LTAM 110GS,A00,958010,Rodriguez; Bretton Sigfred,0,0,0,28
1746582002530,LTCH 101,A00,889397,Staff,23,0,25,2
1746582003559,LTCS 130,A00,889398,Staff,23,0,25,2
1746582004588,LTEA 138,A00,889399,Staff,24,0,40,16
1746582005616,LTEN 149,A00,889400,Wesling; Megan E.,0,3,25,25
1746582006644,LTEN 169,A00,889401,Staff,20,0,25,5
1746582007673,LTEN 180,A00,889402,Staff,10,0,15,5
1746582008698,LTEN 181,A00,889403,Staff,21,0,25,4
1746582009722,LTWL 100,A00,889404,Myerston Santana; Jacobo,2,0,25,23
1746582010745,LTWL 180GS,A00,889405,Staff,0,0,20,20
1746582011773,LTWL 181,A00,889406,Staff,16,0,25,9
1746582012801,LTWL 184,A00,889475,Mukherjee; Silpa,22,0,25,3
1746582013830,LTWR 102C,A00,889486,Staff,29,0,30,1
1746582014855,LTWR 115W,A00,889491,Staff,0,2,15,15
1746582015880,MAE 8,A01,886905,Staff,0,2,0,0
1746582016906,MAE 11,A00,886906,Bandaru; Prabhakar,0,7,50,50
1746582017932,MAE 20,A00,886907,Evdokimenko; Ekaterina,43,0,70,27
1746582018958,MAE 30B,A00,886909,Ghazinejad; Maziar,26,0,45,19
1746582019984,MAE 101B,A00,886910,Saintillan; David,29,0,45,16
1746582021012,MAE 105,A00,886911,Bandaru; Prabhakar,18,0,50,32
1746582022037,MAE 107,B00,958024,Staff,8,0,50,42
1746582023063,MAE 143B,A00,886913,Bewley; Thomas R,3,0,40,37
1746582024093,MAE 148,A01,886915,Silberman; Jack,0,3,14,14
1746582025121,MAE 160,A00,886916,Evdokimenko; Ekaterina,31,0,60,29
1746582026145,MATH 3C,A01,889681,Staff,0,2,30,30
1746582026145,MATH 3C,A02,960048,Staff,24,0,30,6
1746582027238,MATH 10A,A01,889760,Staff,26,0,30,4
1746582027238,MATH 10A,A02,889783,Staff,29,0,30,1
1746582028262,MATH 10B,A01,889785,Verstraete; Jacques Allan,1,0,35,34
1746582028262,MATH 10B,A02,889795,Verstraete; Jacques Allan,4,0,35,31
1746582028262,MATH 10B,B01,889797,Verstraete; Jacques Allan,3,0,35,32
1746582028262,MATH 10B,B02,889828,Verstraete; Jacques Allan,3,0,35,32
1746582029287,MATH 10C,A01,889849,Habib; Yousaf,7,0,30,23
1746582029287,MATH 10C,A02,889852,Habib; Yousaf,14,0,30,16
1746582029287,MATH 10C,A03,889853,Habib; Yousaf,22,0,30,8
1746582029287,MATH 10C,A04,889858,Habib; Yousaf,20,0,30,10
1746582029287,MATH 10C,B01,889861,Staff,1,0,30,29
1746582029287,MATH 10C,B02,889862,Staff,24,0,30,6
1746582029287,MATH 10C,B03,889863,Staff,27,0,30,3
1746582029287,MATH 10C,B04,889967,Staff,23,0,30,7
1746582030315,MATH 18,A01,889974,Staff,7,0,30,23
1746582030315,MATH 18,A02,889977,Staff,20,0,30,10
1746582030315,MATH 18,B01,889984,Hardiman; Liam,20,0,30,10
1746582030315,MATH 18,B02,889985,Hardiman; Liam,25,0,30,5
1746582031342,MATH 20A,A01,889990,Suk; Andrew Hoon,30,0,35,5
1746582032368,MATH 20B,A01,889993,Ohm; Ko Woon,21,0,30,9
1746582032368,MATH 20B,A02,889994,Ohm; Ko Woon,30,0,30,0
1746582032368,MATH 20B,B01,889996,Ohm; Ko Woon,22,0,30,8
1746582032368,MATH 20B,B02,889997,Ohm; Ko Woon,23,0,30,7
1746582033394,MATH 20C,A01,889999,Hammock; Frances H,17,0,30,13
1746582033394,MATH 20C,A02,890003,Hammock; Frances H,23,0,30,7
1746582033394,MATH 20C,B01,890006,Hammock; Frances H,3,0,30,27
1746582033394,MATH 20C,B02,890007,Hammock; Frances H,12,0,30,18
1746582034420,MATH 20D,A01,890011,Cheng; Hsiao-Bing,1,1,30,29
1746582034420,MATH 20D,A02,890012,Cheng; Hsiao-Bing,14,0,30,16
1746582034420,MATH 20D,B01,890016,Cheng; Hsiao-Bing,13,0,30,17
1746582034420,MATH 20D,B02,890017,Cheng; Hsiao-Bing,13,0,30,17
1746582035447,MATH 20E,A01,890026,Harel; Guershon,1,0,30,29
1746582035447,MATH 20E,A02,890029,Harel; Guershon,22,0,30,8
1746582035447,MATH 20E,B01,890033,Harel; Guershon,7,0,30,23
1746582035447,MATH 20E,B02,890101,Harel; Guershon,21,0,30,9
1746582036473,MATH 102,A01,890104,Staff,18,0,30,12
1746582036473,MATH 102,A02,890105,Staff,27,0,30,3
1746582037504,MATH 103B,A01,890116,Salehi Golsefidy; Alireza,3,0,30,27
1746582037504,MATH 103B,B01,890118,Staff,0,3,34,34
1746582038530,MATH 109,A01,890121,Aliabadi Sr.; Mohsen,0,0,30,30
1746582038530,MATH 109,B01,890124,Upadrashta; Pranav Kumar,18,0,30,12
1746582039560,MATH 120A,A01,890126,Eggers; John Dietrich,13,0,30,17
1746582040590,MATH 142B,A01,890128,Ioana; Adrian,19,0,30,11
1746582040590,MATH 142B,A02,890129,Ioana; Adrian,12,0,30,18
1746582041616,MATH 154,A01,890174,Staff,0,0,30,30
1746582041616,MATH 154,A02,890182,Staff,0,0,30,30
1746582042640,MATH 168A,A01,890197,Dumitriu; Ioana,21,0,35,14
1746582043667,MATH 170A,A01,890240,Nie; Jiawang,1,0,30,29
1746582043667,MATH 170A,A02,890241,Nie; Jiawang,11,0,30,19
1746582043667,MATH 170A,A03,890249,Nie; Jiawang,23,0,30,7
1746582044692,MATH 170B,A01,957891,Nag; Panchali,13,0,35,22
1746582046741,MATH 181A,A01,908025,Staff,0,3,35,35
1746582046741,MATH 181A,A02,960115,Staff,26,0,35,9
1746582047766,MATH 181B,A01,959874,Staff,25,0,30,5
1746582048791,MATH 193B,A01,890265,Staff,0,4,35,35
1746582049815,MGT 4,A01,890311,Anderson; John Charles,42,0,88,46
1746582050844,MGT 5,A00,907740,Staff,13,0,98,85
1746582051869,MGT 12,A00,890312,Lindenberger; Wade Douglas,67,0,98,31
1746582052896,MGT 16,A00,957883,Staff,78,0,98,20
1746582054952,MGT 45,A00,890314,Pecore; Joseph P.,45,0,98,53
1746582055978,MGT 71,A00,890315,Staff,0,12,98,98
1746582057004,MGT 100,A00,890316,Yavorsky; Daniel Ryan,44,0,98,54
1746582058029,MGT 103,A00,890317,Ehrich; Kristine R,73,0,98,25
1746582059055,MGT 105,A00,890356,Bates; Kenneth Walter,0,8,98,98
1746582060086,MGT 112,A00,890360,Ehrich; Kristine R,55,0,98,43
1746582061117,MGT 127R,A00,907732,Zhu; Kevin Xiaoguo,23,0,98,75
1746582062146,MGT 131B,A00,890361,Anderson; John Charles,59,0,98,39
1746582063173,MGT 137,A00,890362,Lindenberger; Wade Douglas,65,0,98,33
1746582064203,MGT 160,A00,890369,Johnson; Erik Barry,9,0,98,89
1746582066254,MGT 164,A00,890372,Zimmermann; Carsten,0,40,98,98
1746582067283,MGT 180,A00,890374,Bliss; Barbara Ann,12,0,98,86
1746582068314,MMW 15,A01,886414,Chang; Edmond Yi-Teh,0,12,28,28
1746582068314,MMW 15,A02,886415,Chang; Edmond Yi-Teh,0,8,28,28
1746582068314,MMW 15,A03,886416,Chang; Edmond Yi-Teh,0,9,28,28
1746582068314,MMW 15,A04,886417,Chang; Edmond Yi-Teh,0,8,28,28
1746582068314,MMW 15,B01,886419,Chang; Edmond Yi-Teh,0,7,28,28
1746582068314,MMW 15,B02,886420,Chang; Edmond Yi-Teh,0,8,28,28
1746582068314,MMW 15,B03,886421,Chang; Edmond Yi-Teh,0,7,28,28
1746582068314,MMW 15,B04,886422,Chang; Edmond Yi-Teh,0,8,28,28
1746582068314,MMW 15,C01,886424,Staff,0,9,28,28
1746582068314,MMW 15,C02,886425,Staff,0,8,28,28
1746582068314,MMW 15,C03,886426,Staff,0,8,28,28
1746582068314,MMW 15,C04,886427,Staff,0,8,28,28
1746582068314,MMW 15,C05,958038,Staff,0,8,28,28
1746582068314,MMW 15,C06,958039,Staff,1,8,28,27
1746582069343,MMW 15GS,A00,906910,Patterson; Patrick H.,4,0,28,24
1746582070373,MMW 122R,A01,886429,Rahimi; Babak,0,13,28,28
1746582070373,MMW 122R,A02,886430,Rahimi; Babak,0,12,28,28
1746582070373,MMW 122R,A03,958040,Rahimi; Babak,0,11,28,28
1746582071401,MUS 1A,A01,890937,Staff,2,0,25,23
1746582071401,MUS 1A,A02,891035,Staff,6,0,25,19
1746582071401,MUS 1A,C01,958912,Staff,24,0,25,1
1746582071401,MUS 1A,C02,958913,Staff,25,0,25,0
1746582073455,MUS 2AK,A00,957092,Ohnishi; Takae,15,0,15,0
1746582074483,MUS 4,A01,891044,Staff,1,0,25,24
1746582074483,MUS 4,A02,891045,Staff,23,0,25,2
1746582074483,MUS 4,B01,891048,Staff,17,0,25,8
1746582074483,MUS 4,B02,891050,Staff,25,0,25,0
1746582075509,MUS 5,A01,957506,Dubnov; Shlomo,0,0,25,25
1746582075509,MUS 5,A02,957622,Dubnov; Shlomo,13,0,25,12
1746582075509,MUS 5,A03,957623,Dubnov; Shlomo,20,0,25,5
1746582076535,MUS 6,A01,891053,Freitas Caetano; Marcelo,24,0,25,1
1746582076535,MUS 6,A02,891054,Freitas Caetano; Marcelo,23,0,25,2
1746582077564,MUS 7,A01,891081,Staff,0,0,25,25
1746582077564,MUS 7,A02,891082,Staff,3,0,25,22
1746582078592,MUS 8GS,A00,891118,Borgo; David Garcia,1,0,25,24
1746582079617,MUS 11,A01,891140,Staff,9,0,25,16
1746582079617,MUS 11,A02,891141,Staff,21,0,25,4
1746582080648,MUS 13,A01,891143,Staff,8,0,25,17
1746582080648,MUS 13,A02,891144,Staff,24,0,25,1
1746582081673,MUS 15,A01,891146,Staff,9,0,25,16
1746582081673,MUS 15,A02,891148,Staff,21,0,25,4
1746582081673,MUS 15,B01,891150,Staff,18,0,25,7
1746582081673,MUS 15,B02,891151,Staff,25,0,25,0
1746582082701,MUS 20,A01,891153,Staff,5,0,20,15
1746582082701,MUS 20,A02,891155,Staff,14,0,20,6
1746582083727,MUS 80,A00,891156,Staff,19,0,25,6
1746582083727,MUS 80,B00,891157,Staff,23,0,25,2
1746582084758,MUS 130,A00,891158,Ohnishi; Takae,35,0,35,0
1746582085786,MUS 150GS,A01,891160,Borgo; David Garcia,1,0,25,24
1746582086812,MUS 170,A01,891162,Freitas Caetano; Marcelo,20,0,25,5
1746582086812,MUS 170,A02,891164,Freitas Caetano; Marcelo,21,0,25,4
1746582087838,NANO 11,A00,886220,Vazquez Mena; Oscar,13,0,15,2
1746582088866,NANO 15,A01,886222,Drews; Aaron,4,0,7,3
1746582089894,NANO 104,A00,886224,Sirbuly; Donald,17,0,25,8
1746582090922,PH 40,A00,886528,Staff,24,0,40,16
1746582091951,PH 45,A01,886799,Staff,35,0,40,5
1746582092978,PH 110,A00,886802,Staff,0,7,40,40
1746582094003,PH 172,A00,906716,Staff,19,0,35,16
1746582095032,PH 191,A00,886803,Staff,6,0,40,34
1746582096056,PHIL 1,A00,889500,Staff,20,0,30,10
1746582097081,PHIL 10,A01,889549,Grush; Rick Scott,16,0,22,6
1746582097081,PHIL 10,A02,889551,Grush; Rick Scott,22,0,22,0
1746582098112,PHIL 28,A01,889559,Lamey; Andy M.,0,2,31,31
1746582098112,PHIL 28,A02,889561,Lamey; Andy M.,0,1,30,30
1746582098112,PHIL 28,A03,889572,Lamey; Andy M.,0,1,30,30
1746582099138,PHIL 35,A00,907839,Staff,13,0,15,2
1746582100168,PHIL 60,A00,889574,Staff,73,0,90,17
1746582101192,PHIL 101,A00,958004,Staff,12,0,15,3
1746582103249,PHIL 136,A00,889582,Fulkerson; Matthew Todd,26,0,45,19
1746582104276,PHIL 163,A01,889601,Staff,21,0,30,9
1746582104276,PHIL 163,B01,889606,Brandt; Reuven A,0,3,0,0
1746582105302,PHIL 164,A00,889610,Staff,16,0,30,14
1746582106327,PHIL 165,A00,889613,Staff,22,0,30,8
1746582107353,PHYS 1A,A00,886431,Staff,29,0,70,41
1746582108382,PHYS 1AL,001,886432,Tsai; Philbert S,1,2,30,29
1746582108382,PHYS 1AL,002,886436,Tsai; Philbert S,12,0,30,18
1746582109411,PHYS 1B,A00,886439,Staff,184,0,240,56
1746582110437,PHYS 1BL,001,886441,Tsai; Philbert S,0,4,30,30
1746582110437,PHYS 1BL,002,886444,Tsai; Philbert S,2,0,30,28
1746582111464,PHYS 1C,A00,896092,Arnold; Kam S,78,0,146,68
1746582112489,PHYS 1CL,001,886448,Tsai; Philbert S,0,0,30,30
1746582112489,PHYS 1CL,002,886449,Tsai; Philbert S,1,0,30,29
1746582112489,PHYS 1CL,003,886450,Tsai; Philbert S,16,0,30,14
1746582112489,PHYS 1CL,004,886451,Tsai; Philbert S,15,0,30,15
1746582113520,PHYS 2B,A01,886457,Staff,67,0,115,48
1746582114548,PHYS 2C,A01,886460,Shotwell; Brian,0,9,65,65
1746582115574,PHYS 2CL,A01,886467,Staff,0,4,28,28
1746582115574,PHYS 2CL,A02,886468,Staff,0,3,28,28
1746582116604,PHYS 2D,A01,886470,Staff,10,0,50,40
1746582117632,PHYS 4B,A01,886475,Grinstein; Benjamin,22,0,40,18
1746582118658,POLI 5,A00,891173,Desposato; Scott,7,0,25,18
1746582119685,POLI 5D,A01,891175,Staff,5,0,5,0
1746582119685,POLI 5D,B01,891178,Staff,5,0,5,0
1746582120711,POLI 11,A00,891179,Ferree; Karen E,2,0,35,33
1746582121739,POLI 12,A00,891180,Staff,16,0,30,14
1746582122766,POLI 27,A01,891182,Staff,12,0,75,63
1746582123790,POLI 30,A00,891183,Staff,8,0,50,42
1746582124821,POLI 100B,A00,891244,Staff,5,1,35,30
1746582125849,POLI 100I,A00,891247,Staff,7,0,30,23
1746582126875,POLI 104J,A00,891248,Nichter; Maysa,14,0,30,16
1746582127904,POLI 104U,A00,891250,Nichter; Maysa,1,0,30,29
1746582129956,POLI 110B,A00,891255,Wiens; David,19,0,25,6
1746582130982,POLI 112A,A00,891256,Wiens; David,6,0,25,19
1746582132010,POLI 114BR,A00,891261,Staff,19,0,30,11
1746582133034,POLI 117R,A00,891262,Forman; Fonna,0,6,50,50
1746582134060,POLI 118,A00,891264,Ingham; Sean,17,0,25,8
1746582135087,POLI 124A,A00,891265,Staff,18,0,20,2
1746582136116,POLI 125D,A00,891266,Nichter; Simeon C,2,0,25,23
1746582137145,POLI 126,A00,891268,Nichter; Simeon C,7,0,25,18
1746582138170,POLI 126AA,A00,891272,Staff,15,0,25,10
1746582139194,POLI 130AA,A00,891273,Staff,15,0,20,5
1746582140219,POLI 134AA,A00,891274,Staff,4,0,20,16
1746582142270,POLI 138,A00,891278,Staff,21,0,25,4
1746582143294,POLI 142K,A00,891280,Staff,10,0,25,15
1746582144323,POLI 142M,A00,891281,Gartzke; Erik,16,0,30,14
1746582145352,POLI 142P,A00,891284,Staff,20,0,30,10
1746582146380,POLI 143,A00,891285,Gartzke; Erik,12,0,30,18
1746582147407,POLI 153,A00,891286,Staff,19,0,20,1
1746582149460,POLI 175,A00,891290,Staff,15,0,20,5
1746582150484,PSYC 1,A00,890674,Steiner; Eric Tomas,0,11,45,45
1746582151510,PSYC 2,A00,890676,Albright; Thomas D,20,0,35,15
1746582152537,PSYC 3,A00,890679,Staff,17,0,20,3
1746582153563,PSYC 6,A00,959858,Staff,19,0,20,1
1746582154593,PSYC 60,A01,890684,Rickard; Timothy C.,0,5,45,45
1746582155617,PSYC 70,A01,890689,Geller; Emma Harlan,6,0,30,24
1746582156643,PSYC 71,A01,959860,Staff,21,0,25,4
1746582157672,PSYC 100,A00,890690,Lacefield; Katharine I,0,50,180,180
1746582158696,PSYC 102,A00,890695,Staff,18,0,40,22
1746582159723,PSYC 105,A00,890699,Geller; Emma Harlan,70,0,100,30
1746582160751,PSYC 106,A00,890701,Gorman; Michael R.,5,0,30,25
1746582161777,PSYC 108,A00,890704,Adrian; Julia Anna,0,28,50,50
1746582162802,PSYC 118,A01,890712,Staff,11,0,30,19
1746582163828,PSYC 124,A00,890716,Chapman; Eddie Nathaniel,25,0,60,35
1746582164857,PSYC 131,A00,890717,Anagnostaras; Stephan,0,7,80,80
1746582165883,PSYC 137,A00,890719,Winkielman; Piotr,0,11,30,30
1746582166910,PSYC 144,A00,890721,Adrian; Julia Anna,0,9,45,45
1746582167936,PSYC 162,A00,890805,Staff,1,0,75,74
1746582168960,PSYC 169,A00,890810,Staff,0,14,30,30
1746582169984,PSYC 172,A00,890814,Gorman; Michael R.,9,0,30,21
1746582171012,PSYC 181,A00,890818,Anagnostaras; Stephan,7,0,200,193
1746582172040,PSYC 184,A00,959861,Staff,164,0,175,11
1746582173065,PSYC 189,A00,890823,Staff,0,2,30,30
1746582174091,PSYC 191,A00,890884,Rickard; Timothy C.,0,12,35,35
1746582175116,PSYC 193,A00,890913,Staff,19,0,30,11
1746582175116,PSYC 193,B00,890914,Chapman; Eddie Nathaniel,24,0,30,6
1746582176144,PSYC 193L,A01,890918,Lowe; Angela Beth,20,0,30,10
1746582176144,PSYC 193L,B01,890921,Hurwitz; Ethan Scott,20,0,30,10
1746582176144,PSYC 193L,C01,890928,Staff,30,0,30,0
1746582177175,RELI 149,A00,886806,Rahimi; Babak,23,0,40,17
1746582178199,SE 9,A01,886814,Staff,7,0,20,13
1746582179225,SE 101B,A01,886816,Chadha; Mayank,4,0,35,31
1746582180253,SE 110B,A00,886818,Zhu; Qiang,4,0,75,71
1746582181303,SE 125,A01,886830,Staff,10,0,30,20
1746582182329,SE 130B,A01,886835,Staff,14,0,40,26
1746582183355,SE 131A,A01,886838,Krysl; Petr,34,0,55,21
1746582184378,SE 154,A00,886840,Staff,29,0,50,21
1746582185406,SE 164GS,A01,886849,Staff,6,0,20,14
1746582186434,SE 167GS,A01,886853,Staff,6,0,20,14
1746582187464,SIO 25,A01,890107,Staff,19,0,30,11
1746582188490,SIO 45,A00,890109,Cook; Geoffrey W,116,0,200,84
1746582189519,SIO 109R,A00,890110,Forman; Fonna,0,16,20,20
1746582190548,SIO 187,A01,890114,Kacev; David,15,0,40,25
1746582191575,SOCI 1,A01,890431,Thorpe; Charles Robert,14,0,30,16
1746582191575,SOCI 1,A02,890518,Thorpe; Charles Robert,30,0,30,0
1746582192600,SOCI 2,A01,957978,Staff,25,0,25,0
1746582192600,SOCI 2,A02,957979,Staff,23,0,25,2
1746582193625,SOCI 20,A01,890523,Calderon-Zaks; Michael Aar,21,0,30,9
1746582193625,SOCI 20,A02,890526,Calderon-Zaks; Michael Aar,29,0,30,1
1746582194650,SOCI 30,A01,890533,Pardo Guerra; Juan Pablo,37,0,40,3
1746582195678,SOCI 40,A01,890535,Staff,27,0,45,18
1746582196706,SOCI 104Q,A00,890559,Staff,18,0,30,12
1746582197735,SOCI 106,A00,890560,Arnal; Maud Marie Leonie,20,0,30,10
1746582198760,SOCI 110,A00,890567,Holkenbrink-Monk; Charlene,19,0,30,11
1746582199785,SOCI 112,A00,890568,Victoria Torres; Pablo,2,0,55,53
1746582200810,SOCI 115,A00,890597,Arnal; Maud Marie Leonie,28,0,45,17
1746582202860,SOCI 121,A00,890604,Pardo Guerra; Juan Pablo,38,0,45,7
1746582203883,SOCI 126,A01,890608,Staff,8,0,10,2
1746582204911,SOCI 127,A00,890609,Staff,18,0,30,12
1746582205936,SOCI 131,A00,890610,Thorpe; Charles Robert,37,0,45,8
1746582206962,SOCI 135,A00,890615,Payne; Christine Anna,13,0,45,32
1746582207990,SOCI 139,A00,890620,Staff,38,0,45,7
1746582209013,SOCI 148E,A00,890622,Calderon-Zaks; Michael Aar,36,0,45,9
1746582210039,SOCI 150,A00,890623,Kohler; Kristopher M.,31,0,45,14
1746582211064,SOCI 157,A00,890625,Jules-Rosette; Bennetta W.,18,0,20,2
1746582212090,SOCI 160,A00,890627,Payne; Christine Anna,21,0,45,24
1746582213118,SYN 1,A00,886855,Fish; Gwendolyn Anne,0,1,0,0
1746582213118,SYN 1,B00,906086,Fish; Gwendolyn Anne,0,2,0,2
1746582214147,SYN 2R,A00,886860,Staff,0,17,15,15
1746582214147,SYN 2R,B00,906106,Atkinson; Arthur Laird,0,16,15,15
1746582215180,SYN 100,A01,886866,Browne; Emily,0,28,20,20
1746582215180,SYN 100,B01,906128,Rock; Martin,0,4,20,20
1746582215180,SYN 100,C01,906140,Deavenport; James Cary,0,3,20,20
1746582215180,SYN 100,D01,907816,Deavenport; James Cary,0,5,20,20
1746582216209,TDAC 1,A00,890286,Walsh; Kim C.,7,0,20,13
1746582217234,TDAC 101,A00,890296,Basso; Beatrice,15,0,20,5
1746582218260,TDDE 131,A00,890297,Staff,47,0,50,3
1746582219289,TDDM 1,A00,890287,Weinberg; Sadie,25,0,30,5
1746582220315,TDGE 11,A00,890288,Fulton; Julia,138,0,200,62
1746582220315,TDGE 11,B00,890289,Castro; Robert Jess,184,0,200,16
1746582221340,TDGE 25,B00,957359,Walsh; Kim C.,5,0,20,15
1746582222367,TDGE 40,A01,890292,Power; Jade Yukana,27,0,30,3
1746582223394,TDGE 124,A00,890298,Havis; Allan,0,1,50,50
1746582224420,TDGE 131R,A00,890299,Burelle; Julie Sara Veronique,15,0,42,27
1746582225448,TDHT 101,A00,890300,Staff,10,0,20,10
1746582226473,TDHT 109,A01,890302,Anderson; Mysia Anyse,31,0,40,9
1746582227500,TDMV 1,A00,890293,Arcidiacono; Kristin,18,0,30,12
1746582228528,TDMV 2,A00,890294,Weinberg; Sadie,23,0,30,7
1746582229555,TDMV 3,A00,957878,Arcidiacono; Kristin,28,0,30,2
1746582231611,TDMV 138,A00,890304,Jun; Grace Shin Hae,25,0,40,15
1746582232636,TDMV 140,A00,890305,Corrales; Joseph Bernales,25,0,30,5
1746582233663,TDMV 142,A00,890307,Caligagan; Tony,32,0,40,8
1746582234689,TDMV 144,A00,890308,Camaya; Michelle Ann,25,0,30,5
1746582235714,TDPW 1,A00,890295,Stein; Deborah Isobel,3,0,20,17
1746582236743,USP 2,A01,890272,Lerner; Amy M,7,0,20,13
1746582237768,USP 3,A01,890274,Staff,12,0,30,18
1746582238797,USP 15,A01,890276,Sun; Feiyang,16,0,30,14
1746582239822,USP 25,A00,890277,Shenkman; Michael Thomas,18,0,25,7
1746582240848,USP 138,A00,890278,Staff,14,0,25,11
1746582241878,USP 143,A00,890279,Staff,22,0,70,48
1746582242907,USP 144,A00,890280,Chowdhury; Muhammed Zohir,16,0,30,14
1746582243934,USP 150,A00,890281,Boomhower; Matthew Charles,4,0,30,26
1746582244960,USP 151,A00,890282,Staff,16,0,20,4
1746582245985,USP 162,A00,890283,Andrews; Abigail Leslie,16,0,20,4
1746582247014,USP 168,A00,920477,Kwak; Nancy,0,0,5,5
1746582248038,USP 181,A00,890284,Staff,3,0,20,17
1746582249064,USP 191A,A00,890285,Staff,12,0,20,8
1746582250096,VIS 101,A00,886512,Staff,26,0,75,49
1746582251121,VIS 103,A00,886513,Cruz; Edwin Teddy,61,0,75,14
1746582252219,VIS 108,A00,886514,Staff,3,0,15,12
1746582253246,VIS 127P,A00,886515,Shen; Kuiyi,79,0,146,67
1746582254274,VIS 149,A00,886516,Yoldas; Pinar,0,0,15,15
1746582255298,VIS 164,A00,886526,Erdmann; Dean,19,0,22,3
1746582256325,VIS 194S,A00,886527,Staff,61,0,75,14
1746582257351,WCWP 10A,C00,886484,Martiniuk; Jill,12,0,15,3
1746582258376,WCWP 10B,A00,886490,Uriarte; Emma,0,0,15,15
1746582258376,WCWP 10B,B00,886491,Dhir; Simrita,8,0,15,7
1746582258376,WCWP 10B,C00,886492,Ornelas; Tricia,0,0,15,15
1746582259404,WCWP 100,A00,886494,Young; Mark T,0,6,15,15
1746582261513,AAS 10,A01,886199,Childs; Dennis R.,0,3,0,0
1746582262541,ANAR 104,A01,886940,Shtienberg; Gilad,27,0,30,3
1746582263567,ANAR 120,A00,886953,Staff,13,0,20,7
1746582264596,ANBI 148,A01,886955,Wilder; Linnea Lorene,30,0,40,10
1746582266650,ANSC 122,A00,886957,Staff,24,0,30,6
1746582267676,ANSC 150,A00,886958,Sloane; Julia Kathryn,2,0,15,13
1746582268705,ANSC 156,A00,886959,Jenkins; Janis A.,0,1,15,15
1746582269729,ANSC 180,A00,886960,Staff,11,0,17,6
1746582270755,ANSC 188,A00,886961,Jassal; Aftab,9,0,25,16
1746582271781,ANSC 190,A00,886962,Jassal; Aftab,14,0,25,11
1746582272806,ANSC 191,A00,886963,Staff,18,0,20,2
1746582273833,ANTH 3,A01,891689,Staff,17,0,20,3
1746582274863,ANTH 5,A00,886933,Semendeferi; Ekaterini,16,0,20,4
1746582275891,ANTH 10,A00,886934,Staff,0,12,30,30
1746582276920,ANTH 21,A01,886936,Staff,41,0,60,19
1746582277950,ANTH 23,A01,886938,Staff,92,0,100,8
1746582278975,ANTH 105,A00,886964,Stewart; Alexander B,84,0,100,16
1746582280000,ANTH 108,A00,886965,Pedersen; David,9,0,20,11
1746582281032,AWP 10,001,886147,Staff,0,0,0,0
1746582281032,AWP 10,002,886148,Staff,0,0,0,0
1746582281032,AWP 10,003,886149,Staff,0,0,0,0
1746582281032,AWP 10,004,886150,Staff,0,0,0,0
1746582281032,AWP 10,005,886151,Staff,0,0,0,0
1746582281032,AWP 10,006,886152,Staff,0,0,0,0
1746582281032,AWP 10,007,886153,Staff,0,0,0,0
1746582281032,AWP 10,008,886154,Staff,0,0,0,0
1746582281032,AWP 10,009,886155,Staff,0,0,0,0
1746582281032,AWP 10,010,886156,Staff,0,0,0,0
1746582281032,AWP 10,011,886158,Staff,0,0,0,0
1746582281032,AWP 10,012,886160,Staff,0,0,0,0
1746582281032,AWP 10,013,886161,Staff,0,0,0,0
1746582281032,AWP 10,014,886162,Staff,0,0,0,0
1746582281032,AWP 10,015,886163,Staff,0,0,0,0
1746582281032,AWP 10,016,886164,Staff,0,0,0,0
1746582281032,AWP 10,017,886165,Staff,0,0,0,0
1746582281032,AWP 10,018,886166,Staff,0,0,0,0
1746582281032,AWP 10,019,886168,Staff,0,0,0,0
1746582281032,AWP 10,020,886170,Staff,0,0,0,0
1746582281032,AWP 10,021,886172,Staff,0,0,0,0
1746582282061,AWP 10R,001,886173,Staff,0,1,0,0
1746582282061,AWP 10R,002,886174,Staff,0,1,0,0
1746582282061,AWP 10R,003,886175,Staff,0,0,0,0
1746582282061,AWP 10R,004,886176,Staff,0,0,0,0
1746582282061,AWP 10R,005,886177,Staff,0,0,0,0
1746582282061,AWP 10R,006,886178,Staff,0,0,0,0
1746582282061,AWP 10R,007,886179,Staff,0,0,0,0
1746582282061,AWP 10R,008,886181,Staff,0,0,0,0
1746582282061,AWP 10R,009,886182,Staff,0,0,0,0
1746582282061,AWP 10R,010,886183,Staff,0,0,0,0
1746582282061,AWP 10R,011,886184,Staff,0,0,0,0
1746582282061,AWP 10R,012,886185,Staff,0,0,0,0
1746582282061,AWP 10R,013,886186,Staff,0,0,0,0
1746582282061,AWP 10R,014,886187,Staff,0,0,0,0
1746582282061,AWP 10R,015,886188,Staff,0,0,0,0
1746582282061,AWP 10R,016,886189,Staff,0,0,0,0
1746582282061,AWP 10R,017,960532,Staff,0,0,0,0
1746582282061,AWP 10R,018,960533,Staff,0,0,0,0
1746582282061,AWP 10R,019,960534,Staff,0,0,0,0
1746582282061,AWP 10R,020,960538,Staff,0,0,0,0
1746582282061,AWP 10R,021,960540,Staff,0,0,0,0
1746582282061,AWP 10R,022,960541,Staff,0,0,0,0
1746582282061,AWP 10R,023,960542,Staff,0,0,0,0
1746582282061,AWP 10R,024,960544,Staff,0,0,0,0
1746582282061,AWP 10R,025,960545,Staff,0,0,0,0
1746582282061,AWP 10R,026,960548,Staff,0,0,0,0
1746582283088,AWP 102R,A00,886190,Staff,0,0,0,0
1746582283088,AWP 102R,B00,886191,Staff,0,0,0,0
1746582284112,BENG 100,A01,886193,Staff,17,0,30,13
1746582285139,BENG 122A,A01,886195,Hasty; Jeff M,13,0,30,17
1746582286163,BENG 166A,A00,886196,Sah; Robert Lie-Yuan,0,3,30,30
1746582287189,BENG 190,A00,958050,Khojah; Reem I,18,0,25,7
1746582288217,BIBC 102,A01,894320,Staff,0,0,46,46
1746582288217,BIBC 102,A02,894321,Staff,0,0,46,46
1746582288217,BIBC 102,A03,894344,Staff,6,0,46,40
1746582288217,BIBC 102,A04,894345,Staff,27,0,47,20
1746582289244,BICD 100R,A01,894365,Smith; Laurie,0,3,58,58
1746582289244,BICD 100R,A02,894366,Smith; Laurie,0,5,58,58
1746582289244,BICD 100R,A03,894367,Smith; Laurie,0,0,59,59
1746582289244,BICD 100R,A04,959869,Smith; Laurie,40,0,59,19
1746582290269,BICD 136,A01,894383,Gustafson-Brown; Cindy,14,0,50,36
1746582291301,BIEB 102,A01,894494,Butler; Shannon Rhey,51,0,130,79
1746582293357,BIEB 150,A01,894617,Wills; Christopher,3,0,20,17
1746582293357,BIEB 150,A02,894631,Wills; Christopher,3,0,20,17
1746582293357,BIEB 150,A03,894937,Wills; Christopher,3,0,20,17
1746582293357,BIEB 150,A04,894946,Wills; Christopher,5,0,20,15
1746582294383,BIEB 194,A00,906141,Kurle; Carolyn M.,6,0,20,14
1746582295409,BILD 1,A01,894154,Staff,3,0,19,16
1746582295409,BILD 1,A02,894155,Staff,14,0,19,5
1746582295409,BILD 1,A03,894160,Staff,13,0,19,6
1746582295409,BILD 1,A04,894161,Staff,15,0,18,3
1746582296435,BILD 2,A01,894168,Staff,0,0,50,50
1746582296435,BILD 2,A02,894169,Staff,0,0,50,50
1746582296435,BILD 2,A03,894179,Staff,0,0,50,50
1746582296435,BILD 2,A04,894203,Staff,24,0,50,26
1746582297465,BILD 3,A01,894213,Staff,23,0,31,8
1746582297465,BILD 3,A02,894214,Staff,26,0,31,5
1746582297465,BILD 3,A03,894235,Staff,28,0,31,3
1746582297465,BILD 3,A04,894236,Staff,28,0,32,4
1746582298491,BILD 4,A01,894253,Reuther; Keefe,5,0,24,19
1746582298491,BILD 4,A02,894258,Reuther; Keefe,16,0,24,8
1746582299517,BILD 5,A01,894276,Reuther; Keefe,35,0,50,15
1746582299517,BILD 5,A02,894277,Reuther; Keefe,45,0,50,5
1746582299517,BILD 5,A03,894290,Reuther; Keefe,44,0,50,6
1746582299517,BILD 5,A04,894291,Reuther; Keefe,48,0,50,2
1746582300542,BILD 24,A01,894297,Pirino; Giorgia,40,0,60,20
1746582301569,BIMM 100,B01,958915,Staff,71,0,100,29
1746582302597,BIMM 101,A01,895017,McDonnell; Lisa Marie,0,5,24,24
1746582302597,BIMM 101,A02,895018,McDonnell; Lisa Marie,0,5,24,24
1746582302597,BIMM 101,B01,895020,McDonnell; Lisa Marie,0,6,24,24
1746582302597,BIMM 101,B02,895021,McDonnell; Lisa Marie,0,4,24,24
1746582303623,BIMM 110,A01,895023,Staff,1,0,25,24
1746582303623,BIMM 110,A02,895024,Staff,9,0,25,16
1746582303623,BIMM 110,A03,895025,Staff,18,0,25,7
1746582303623,BIMM 110,A04,895031,Staff,20,0,25,5
1746582304651,BIMM 120,A01,895114,Gustafson-Brown; Cindy,14,0,28,14
1746582304651,BIMM 120,A02,895126,Gustafson-Brown; Cindy,21,0,27,6
1746582305680,BIPN 100,A01,895130,Yang; Mingyu,0,0,38,38
1746582305680,BIPN 100,A02,895131,Yang; Mingyu,31,0,38,7
1746582305680,BIPN 100,A03,895132,Yang; Mingyu,32,0,38,6
1746582305680,BIPN 100,A04,895133,Yang; Mingyu,27,0,36,9
1746582306709,BIPN 120,A01,895135,Cooke; James Edward,0,3,13,13
1746582306709,BIPN 120,A02,895136,Cooke; James Edward,0,1,13,13
1746582306709,BIPN 120,A03,895137,Cooke; James Edward,0,3,13,13
1746582306709,BIPN 120,A04,895156,Cooke; James Edward,0,2,11,11
1746582307735,BIPN 134,A01,895235,Cooke; James Edward,0,2,25,25
1746582307735,BIPN 134,A02,895237,Cooke; James Edward,0,0,25,25
1746582307735,BIPN 134,A03,895240,Cooke; James Edward,3,0,25,22
1746582307735,BIPN 134,A04,895270,Cooke; James Edward,20,0,25,5
1746582308761,BIPN 189,A00,892103,Staff,0,14,14,14
1746582310811,BISP 194,A00,958008,Staff,0,2,0,0
1746582311839,CAT 124,A01,922009,Staff,0,5,20,20
1746582312867,CAT 125R,A00,886390,Morales; Celeste Georgianna,0,2,20,20
1746582312867,CAT 125R,B00,886391,Irwin; Matthew Joseph,0,4,20,20
1746582312867,CAT 125R,C00,886392,Smith; Lauryn Alissa,0,2,20,20
1746582312867,CAT 125R,D00,886393,Vanderschuit; Maya Alysia,0,3,20,20
1746582312867,CAT 125R,E00,886394,Marchisotto; Jennifer Anne,0,3,20,20
1746582313892,CENG 15,A01,886218,Drews; Aaron,3,0,8,5
1746582314920,CENG 113,A00,886219,Opatkiewicz; Justin Paul,15,0,25,10
1746582315946,CGS 101,A00,887044,Staff,7,0,20,13
1746582316973,CGS 105,A01,887046,Staff,14,0,25,11
1746582317999,CGS 112,A00,887047,Cuong; Marisol,12,0,15,3
1746582319023,CGS 113,A00,887048,Staff,23,0,30,7
1746582320049,CGS 120,A00,887049,Staff,10,0,17,7
1746582321078,CHEM 6A,A01,886336,Lam; Tin Yiu,38,0,50,12
1746582321078,CHEM 6A,A02,886338,Lam; Tin Yiu,37,0,50,13
1746582322107,CHEM 6B,A01,886341,Hopkins; Patrycja Anna,16,0,50,34
1746582322107,CHEM 6B,A02,886343,Hopkins; Patrycja Anna,42,0,50,8
1746582323132,CHEM 6C,A01,886346,Albizati; Kim F.,0,2,50,50
1746582323132,CHEM 6C,A02,886348,Albizati; Kim F.,24,0,50,26
1746582324163,CHEM 40A,A01,886352,Klosterman; Jeremy K,65,0,100,35
1746582325191,CHEM 40B,A01,886356,Klosterman; Jeremy K,0,24,100,100
1746582326219,CHEM 41B,A01,886360,Theodorakis; Emmanuel,25,0,50,25
1746582326219,CHEM 41B,A02,886362,Theodorakis; Emmanuel,47,0,50,3
1746582327245,CHIN 165A,A00,886382,Xu; Li,18,0,20,2
1746582328271,CLAS 120,A00,886387,Myerston Santana; Jacobo,33,0,40,7
1746582329297,COGS 9,A01,886967,Shannon; Kyle Michael,42,0,60,18
1746582330327,COGS 11,A01,886969,Staff,9,0,30,21
1746582331352,COGS 14A,A01,886971,Staff,6,0,60,54
1746582332379,COGS 14B,A01,886973,Hoffman; Drew Ellen,4,0,60,56
1746582333406,COGS 18,A01,886975,Morgan; Eric,35,0,60,25
1746582334434,COGS 20,A01,886977,Staff,4,0,8,4
1746582334434,COGS 20,A02,886978,Staff,5,0,7,2
1746582335461,COGS 100,A01,907783,Staff,1,2,30,29
1746582336485,COGS 101B,A01,886980,Staff,0,4,48,48
1746582337515,COGS 101C,A01,886982,Delgado; Tania,0,5,44,44
1746582338541,COGS 102A,A01,886984,Johnson; Christine M.,4,0,30,26
1746582339566,COGS 118B,A01,886986,Staff,1,4,88,87
1746582340592,COGS 150,A01,886988,Bergen; Benjamin,22,0,50,28
1746582341621,COGS 153,A00,886989,Delgado; Tania,0,2,41,41
1746582342648,COGS 186,A01,886991,Staff,0,0,32,32
1746582343676,COGS 187A,A01,886993,Boyle; Mary E. T.,7,0,30,23
1746582344703,COGS 189,A00,886994,Staff,0,1,30,30
1746582345730,COMM 10,A01,886996,Staff,0,0,20,21
1746582345730,COMM 10,A02,886997,Staff,10,0,20,10
1746582345730,COMM 10,A03,959845,Staff,19,0,20,1
1746582346759,COMM 20,A01,886999,Leuning; Grant Maurstad,24,0,40,16
1746582348812,COMM 100A,A01,887002,Staff,0,0,20,25
1746582348812,COMM 100A,A02,887003,Staff,6,0,20,14
1746582349836,COMM 100B,A01,887005,Staff,0,8,20,24
1746582350863,COMM 106D,A00,887006,Staff,13,0,40,27
1746582351890,COMM 110G,A00,887007,Whitworth-Smith; Andrew C,12,0,40,28
1746582352919,COMM 111B,A00,887008,Staff,31,0,40,9
1746582353943,COMM 113T,A00,887009,Abuelhiga; Soraya Jill,28,0,40,12
1746582353943,COMM 113T,B00,906733,Staff,40,0,40,0
1746582354972,COMM 145,A00,887010,Staff,12,0,40,28
1746582356000,COMM 146,A00,887054,Staff,31,0,40,9
1746582357079,COMM 190,A00,887012,Staff,8,0,23,15
1746582358103,CSE 8A,A50,887015,Cao; Yingjun,57,0,85,28
1746582359132,CSE 11,A01,887017,Cao; Yingjun,12,0,70,58
1746582360160,CSE 20,A01,887019,Staff,30,0,50,20
1746582361185,CSE 21,A01,887021,Staff,78,0,100,22
1746582361185,CSE 21,B01,892583,Braun; Oliver,45,0,50,5
1746582362214,CSE 30,A01,887025,Eldon; John,142,0,200,58
1746582363243,CSE 100,A01,887027,Staff,26,0,50,24
1746582363243,CSE 100,A02,887028,Staff,42,0,50,8
1746582364273,CSE 101,A01,887030,Braun; Oliver,74,0,100,26
1746582364273,CSE 101,B01,887032,Jones; Miles E,0,3,50,50
1746582364273,CSE 101,B02,887033,Jones; Miles E,0,2,50,50
1746582365299,CSE 105,A01,908084,Jones; Miles E,32,0,50,18
1746582365299,CSE 105,A02,908087,Jones; Miles E,31,0,50,19
1746582366323,CSE 135,A01,887035,Powell; Thomas Allan,0,5,50,50
1746582367349,CSE 142,A01,887037,Staff,8,0,60,52
1746582368376,CSE 142L,A01,887039,Staff,34,0,60,26
1746582369405,CSE 151A,A01,887041,Solares; Edwin A,47,0,100,53
1746582370430,CSE 175,A01,887043,Kumar; Rakesh,30,0,30,0
1746582371458,CSS 1,A01,886389,Staff,1,2,40,39
1746582372483,DSC 30,A01,908097,Liao; Soohyun Nam,47,0,75,28
1746582373508,DSC 40A,A01,908099,Shannon; Kyle Michael,30,0,50,20
1746582374533,DSC 40B,A01,908112,Staff,15,0,50,35
1746582375560,DSC 80,A01,908116,Staff,19,0,60,41
1746582376587,DSC 197,001,956863,Eldridge; Justin Matthew,9999,0,9999,0
1746582377614,ECE 5,A01,886400,Morris; Karcher William,1,0,6,5
1746582377614,ECE 5,A02,886401,Morris; Karcher William,3,0,6,3
1746582378644,ECE 148,A01,886403,Silberman; Jack,0,14,14,14
1746582379674,ECON 1,A01,887265,Crane; Meredith Helen,12,0,70,58
1746582379674,ECON 1,B01,887268,Staff,42,0,50,8
1746582380701,ECON 2,A01,887273,Crane; Meredith Helen,55,0,70,15
1746582381725,ECON 3,A01,887279,Rondina; Giacomo,32,0,70,38
1746582382752,ECON 4,A01,887282,Anderson; John Charles,0,2,10,10
1746582383780,ECON 5,A01,887285,Staff,34,0,45,11
1746582383780,ECON 5,B01,887292,Staff,41,0,45,4
1746582384809,ECON 100A,A01,887337,Newhouse; Herbert S,54,0,70,16
1746582384809,ECON 100A,B01,887349,Staff,45,0,50,5
1746582385835,ECON 100B,A01,887361,Du; Songzi,29,0,70,41
1746582386864,ECON 100C,A01,887445,Newhouse; Herbert S,59,0,70,11
1746582387888,ECON 105,A00,887488,Vespa; Emanuel Ignacio,23,0,35,12
1746582388918,ECON 109,A01,887506,Shishkin; Denis,28,0,35,7
1746582389946,ECON 110A,A01,887568,Alon; Titan Michael,0,3,35,35
1746582389946,ECON 110A,B01,907601,Alon; Titan Michael,20,0,35,15
1746582390972,ECON 110B,A01,887598,Levkoff; Steven B.,0,24,70,70
1746582391999,ECON 112,A00,887599,Rondina; Giacomo,19,0,35,16
1746582393026,ECON 120A,A01,887603,Dai; Yinlin,35,0,70,35
1746582394055,ECON 120C,A01,887608,Sun; Yixiao,0,1,35,35
1746582394055,ECON 120C,B01,887614,Sun; Yixiao,0,0,35,35
1746582395083,ECON 138,A00,887621,Bharadwaj; Prashant,0,21,20,20
1746582396109,ECON 144,A00,958007,Squires; Dale E,12,0,35,23
1746582397133,ECON 171,A01,907666,Staff,18,0,35,17
1746582398163,ECON 175,A00,887626,Wu; Pak Yeung,22,0,35,13
1746582399191,ECON 190,A00,887640,Vespa; Emanuel Ignacio,22,0,35,13
1746582400218,EDS 25,A01,888197,Staff,0,0,0,0
1746582400218,EDS 25,A02,888209,Staff,0,0,0,0
1746582400218,EDS 25,A03,888210,Staff,0,0,0,0
1746582400218,EDS 25,A04,888212,Staff,0,0,0,0
1746582400218,EDS 25,A05,888213,Staff,0,0,0,0
1746582400218,EDS 25,A06,888214,Staff,0,0,0,0
1746582400218,EDS 25,A07,888235,Staff,0,2,0,0
1746582400218,EDS 25,A08,888236,Staff,0,0,0,0
1746582400218,EDS 25,A09,888240,Staff,0,0,0,0
1746582400218,EDS 25,A10,888244,Staff,0,0,0,0
1746582400218,EDS 25,B01,888273,Staff,0,0,0,0
1746582400218,EDS 25,B02,888285,Staff,0,0,0,0
1746582400218,EDS 25,B03,888423,Staff,0,0,0,1
1746582400218,EDS 25,B04,888432,Staff,0,0,0,0
1746582400218,EDS 25,B05,888433,Staff,0,0,0,0
1746582400218,EDS 25,B06,888467,Staff,0,0,0,0
1746582400218,EDS 25,B07,888468,Staff,0,0,0,0
1746582400218,EDS 25,B08,888479,Staff,0,0,0,0
1746582400218,EDS 25,B09,888484,Staff,0,0,0,0
1746582400218,EDS 25,B10,888487,Staff,0,0,0,0
1746582401247,EDS 38,A01,907700,Choi; Bailey Miyeon,30,0,30,0
1746582402272,EDS 112,A01,888601,Chapman; Thandeka K,12,0,40,28
1746582403299,EDS 115,A00,888697,Mendez; Kathrina Mendoza,10,0,30,20
1746582404327,EDS 116,A01,888893,Staff,34,0,40,6
1746582406383,EDS 124AR,A00,889133,Staff,29,0,50,21
1746582406383,EDS 124AR,B00,907471,Simon; Elizabeth A,37,0,50,13
1746582407409,EDS 124BR,A00,889134,Simon; Elizabeth A,44,0,100,56
1746582408434,EDS 125,A00,889135,Staff,25,0,30,5
1746582409459,EDS 126,A01,889138,Staff,35,0,40,5
1746582410488,EDS 164R,A01,889142,Wishard Guerra; Alison G.,32,0,50,18
1746582411518,ENG 30,A01,886396,Staff,0,0,0,0
1746582411518,ENG 30,B01,886398,Staff,0,0,0,0
1746582412549,ENVR 102,A00,906150,Montejo; Carolina,23,0,25,2
1746582413575,ETHN 103A,A00,887236,Man; Simeon S,0,3,0,0
1746582414600,ETHN 113,A00,887239,Staff,16,0,30,14
1746582415625,ETHN 116,A00,887240,Staff,16,0,25,9
1746582416651,ETHN 117,A00,887241,Choi; Esther Min,28,0,30,2
1746582417679,ETHN 118,A00,887243,Staff,24,0,30,6
1746582418707,ETHN 127,A00,887248,Cuong; Marisol,11,0,15,4
1746582419738,ETHN 139,A00,887250,Staff,7,0,10,3
1746582420766,ETHN 142,A00,887252,Staff,10,0,30,20
1746582421791,ETHN 161,A00,887253,Browne; Errol Tsekani,24,0,30,6
1746582422820,ETHN 163FR,A00,887255,Burelle; Julie Sara Veronique,0,0,5,5
1746582423847,GLBH 20,A00,889149,Elwardani; Nile Regina,8,0,42,34
1746582425900,GLBH 111,A01,889152,Burgos; Jose L.,17,0,17,0
1746582426925,GLBH 150,A00,889181,Sloane; Julia Kathryn,0,5,15,15
1746582428977,HDS 60,A01,886406,Warstadt; Melissa Fawn,73,0,80,7
1746582430001,HIAF 111,A00,889324,Gyamfi; Bright,25,0,32,7
1746582431027,HIEA 131,A00,889328,Staff,15,0,32,17
1746582432056,HIEA 144,A00,889333,Henry; Todd A.,26,0,32,6
1746582433080,HIEA 154,A00,889336,Henry; Todd A.,24,0,32,8
1746582434106,HIEU 106,A00,889339,Staff,22,0,32,10
1746582436160,HIEU 114,A00,889340,Staff,4,0,32,28
1746582437184,HIEU 135GS,A00,889342,Patterson; Patrick H.,0,0,1,24
1746582438211,HIEU 137,A00,889343,Edington; Claire Ellen,10,0,25,15
1746582439235,HIEU 148,A00,889345,Staff,14,0,32,18
1746582440264,HIEU 154,A00,889346,Biess; Frank Peter,21,0,32,11
1746582441288,HILA 102,A00,889351,Staff,12,0,32,20
1746582442318,HILD 2A,A01,889221,Lewandoski; Julia Mavis,1,10,32,31
1746582443346,HILD 7B,A01,889225,Man; Simeon S,0,12,32,32
1746582444372,HILD 7C,A01,889288,Alvarez; Luis A,0,14,32,32
1746582445397,HILD 30,A01,889323,Staff,0,5,32,32
1746582447451,HISC 119,A00,889383,Golan; Tal,19,0,32,13
1746582448481,HIUS 103,A00,889384,Man; Simeon S,0,0,32,32
1746582449510,HIUS 117,A00,919797,Kwak; Nancy,19,0,32,13
1746582450535,HIUS 142A,A00,919788,Staff,22,0,32,10
1746582452587,HIUS 149,A00,889386,Gyamfi; Bright,26,0,32,6
1746582453611,HIUS 155,A00,889387,Alvarez; Luis A,15,0,32,17
1746582454636,HUM 3,A01,886499,Caldwell; Michael Alan,19,0,50,31
1746582455661,HUM 3GS,A00,886500,Rodriguez; Bretton Sigfred,0,0,0,28
1746582456690,HUM 3R,A01,886502,Markman; Kristina,0,36,50,50
1746582457717,HUM 4,A01,886504,Crum; Matthew Stephen,23,0,50,27
1746582457717,HUM 4,B01,886506,West; Geoffrey Scott,17,0,50,33
1746582458741,HUM 4GS,A00,886507,Staff,0,0,0,19
1746582459771,HUM 5,A01,886509,Staff,32,0,50,18
1746582460837,HUM 5R,A01,886511,Zavodny; Tatiana Sophia,0,39,50,50
1746582461865,JAPN 180,A00,886407,Staff,16,0,40,24
1746582462897,LATI 50,A01,886409,Martin-Cabrera; Luis,3,0,22,19
1746582462897,LATI 50,A02,886410,Martin-Cabrera; Luis,19,0,22,3
1746582462897,LATI 50,A03,886411,Martin-Cabrera; Luis,21,0,22,1
1746582462897,LATI 50,A04,886412,Martin-Cabrera; Luis,8,0,22,14
1746582463926,LAWS 101,A00,907664,Staff,28,0,60,32
1746582464951,LIAB 1A,A00,889388,Saab; Dima,17,0,20,3
1746582465980,LIAB 1AX,A00,889389,El Cheddadi; Youniss,18,0,20,2
1746582467009,LIFR 1C,A00,889391,Van Moer; Vinciane G,8,0,20,12
1746582468033,LIFR 1CX,A00,889392,Van Moer; Vinciane G,7,0,20,13
1746582469059,LIFR 1D,A00,889393,Van Moer; Vinciane G,7,0,20,13
1746582470085,LIFR 1DX,A00,889394,Van Moer; Vinciane G,8,0,20,12
1746582471113,LIGN 7,A00,886923,Staff,24,0,50,26
1746582472139,LIGN 17,A00,886924,Kehler; Andrew Scott,125,0,150,25
1746582473163,LTAM 110,A00,889395,Staff,15,0,30,15
1746582474192,LTAM 110GS,A00,958010,Rodriguez; Bretton Sigfred,0,0,0,28
1746582475217,LTCH 101,A00,889397,Staff,23,0,25,2
1746582476241,LTCS 130,A00,889398,Staff,23,0,25,2
1746582477270,LTEA 138,A00,889399,Staff,24,0,40,16
1746582478295,LTEN 149,A00,889400,Wesling; Megan E.,0,3,25,25
1746582479322,LTEN 169,A00,889401,Staff,20,0,25,5
1746582480348,LTEN 180,A00,889402,Staff,10,0,15,5
1746582481374,LTEN 181,A00,889403,Staff,21,0,25,4
1746582482401,LTWL 100,A00,889404,Myerston Santana; Jacobo,2,0,25,23
1746582483425,LTWL 180GS,A00,889405,Staff,0,0,20,20
1746582484450,LTWL 181,A00,889406,Staff,16,0,25,9
1746582485479,LTWL 184,A00,889475,Mukherjee; Silpa,22,0,25,3
1746582486506,LTWR 102C,A00,889486,Staff,29,0,30,1
1746582487534,LTWR 115W,A00,889491,Staff,0,2,15,15
1746582488563,MAE 8,A01,886905,Staff,0,2,0,0
1746582489588,MAE 11,A00,886906,Bandaru; Prabhakar,0,7,50,50
1746582490614,MAE 20,A00,886907,Evdokimenko; Ekaterina,43,0,70,27
1746582491643,MAE 30B,A00,886909,Ghazinejad; Maziar,26,0,45,19
1746582492668,MAE 101B,A00,886910,Saintillan; David,29,0,45,16
1746582493697,MAE 105,A00,886911,Bandaru; Prabhakar,18,0,50,32
1746582494725,MAE 107,B00,958024,Staff,8,0,50,42
1746582495751,MAE 143B,A00,886913,Bewley; Thomas R,2,0,40,38
1746582496777,MAE 148,A01,886915,Silberman; Jack,0,3,14,14
1746582497806,MAE 160,A00,886916,Evdokimenko; Ekaterina,31,0,60,29
1746582498834,MATH 3C,A01,889681,Staff,0,2,30,30
1746582498834,MATH 3C,A02,960048,Staff,24,0,30,6
1746582499860,MATH 10A,A01,889760,Staff,26,0,30,4
1746582499860,MATH 10A,A02,889783,Staff,29,0,30,1
1746582500888,MATH 10B,A01,889785,Verstraete; Jacques Allan,1,0,35,34
1746582500888,MATH 10B,A02,889795,Verstraete; Jacques Allan,4,0,35,31
1746582500888,MATH 10B,B01,889797,Verstraete; Jacques Allan,3,0,35,32
1746582500888,MATH 10B,B02,889828,Verstraete; Jacques Allan,3,0,35,32
1746582501919,MATH 10C,A01,889849,Habib; Yousaf,7,0,30,23
1746582501919,MATH 10C,A02,889852,Habib; Yousaf,14,0,30,16
1746582501919,MATH 10C,A03,889853,Habib; Yousaf,22,0,30,8
1746582501919,MATH 10C,A04,889858,Habib; Yousaf,20,0,30,10
1746582501919,MATH 10C,B01,889861,Staff,1,0,30,29
1746582501919,MATH 10C,B02,889862,Staff,24,0,30,6
1746582501919,MATH 10C,B03,889863,Staff,27,0,30,3
1746582501919,MATH 10C,B04,889967,Staff,23,0,30,7
1746582502946,MATH 18,A01,889974,Staff,7,0,30,23
1746582502946,MATH 18,A02,889977,Staff,20,0,30,10
1746582502946,MATH 18,B01,889984,Hardiman; Liam,20,0,30,10
1746582502946,MATH 18,B02,889985,Hardiman; Liam,25,0,30,5
1746582503973,MATH 20A,A01,889990,Suk; Andrew Hoon,30,0,35,5
1746582504999,MATH 20B,A01,889993,Ohm; Ko Woon,21,0,30,9
1746582504999,MATH 20B,A02,889994,Ohm; Ko Woon,30,0,30,0
1746582504999,MATH 20B,B01,889996,Ohm; Ko Woon,22,0,30,8
1746582504999,MATH 20B,B02,889997,Ohm; Ko Woon,23,0,30,7
1746582506025,MATH 20C,A01,889999,Hammock; Frances H,17,0,30,13
1746582506025,MATH 20C,A02,890003,Hammock; Frances H,23,0,30,7
1746582506025,MATH 20C,B01,890006,Hammock; Frances H,3,0,30,27
1746582506025,MATH 20C,B02,890007,Hammock; Frances H,12,0,30,18
1746582507058,MATH 20D,A01,890011,Cheng; Hsiao-Bing,1,1,30,29
1746582507058,MATH 20D,A02,890012,Cheng; Hsiao-Bing,14,0,30,16
1746582507058,MATH 20D,B01,890016,Cheng; Hsiao-Bing,13,0,30,17
1746582507058,MATH 20D,B02,890017,Cheng; Hsiao-Bing,13,0,30,17
1746582508083,MATH 20E,A01,890026,Harel; Guershon,1,0,30,29
1746582508083,MATH 20E,A02,890029,Harel; Guershon,22,0,30,8
1746582508083,MATH 20E,B01,890033,Harel; Guershon,7,0,30,23
1746582508083,MATH 20E,B02,890101,Harel; Guershon,21,0,30,9
1746582509111,MATH 102,A01,890104,Staff,18,0,30,12
1746582509111,MATH 102,A02,890105,Staff,27,0,30,3
1746582510138,MATH 103B,A01,890116,Salehi Golsefidy; Alireza,3,0,30,27
1746582510138,MATH 103B,B01,890118,Staff,0,3,34,34
1746582511169,MATH 109,A01,890121,Aliabadi Sr.; Mohsen,0,0,30,30
1746582511169,MATH 109,B01,890124,Upadrashta; Pranav Kumar,18,0,30,12
1746582512200,MATH 120A,A01,890126,Eggers; John Dietrich,13,0,30,17
1746582513231,MATH 142B,A01,890128,Ioana; Adrian,19,0,30,11
1746582513231,MATH 142B,A02,890129,Ioana; Adrian,12,0,30,18
1746582514257,MATH 154,A01,890174,Staff,0,0,30,30
1746582514257,MATH 154,A02,890182,Staff,0,0,30,30
1746582515287,MATH 168A,A01,890197,Dumitriu; Ioana,21,0,35,14
1746582516313,MATH 170A,A01,890240,Nie; Jiawang,1,0,30,29
1746582516313,MATH 170A,A02,890241,Nie; Jiawang,11,0,30,19
1746582516313,MATH 170A,A03,890249,Nie; Jiawang,23,0,30,7
1746582517338,MATH 170B,A01,957891,Nag; Panchali,13,0,35,22
1746582519393,MATH 181A,A01,908025,Staff,0,3,35,35
1746582519393,MATH 181A,A02,960115,Staff,26,0,35,9
1746582520418,MATH 181B,A01,959874,Staff,25,0,30,5
1746582521444,MATH 193B,A01,890265,Staff,0,4,35,35
1746582522469,MGT 4,A01,890311,Anderson; John Charles,42,0,88,46
1746582523496,MGT 5,A00,907740,Staff,13,0,98,85
1746582524525,MGT 12,A00,890312,Lindenberger; Wade Douglas,67,0,98,31
1746582525554,MGT 16,A00,957883,Staff,78,0,98,20
1746582527606,MGT 45,A00,890314,Pecore; Joseph P.,45,0,98,53
1746582528636,MGT 71,A00,890315,Staff,0,12,98,98
1746582529662,MGT 100,A00,890316,Yavorsky; Daniel Ryan,44,0,98,54
1746582530691,MGT 103,A00,890317,Ehrich; Kristine R,73,0,98,25
1746582531717,MGT 105,A00,890356,Bates; Kenneth Walter,0,8,98,98
1746582532746,MGT 112,A00,890360,Ehrich; Kristine R,55,0,98,43
1746582533772,MGT 127R,A00,907732,Zhu; Kevin Xiaoguo,23,0,98,75
1746582534800,MGT 131B,A00,890361,Anderson; John Charles,59,0,98,39
1746582535825,MGT 137,A00,890362,Lindenberger; Wade Douglas,65,0,98,33
1746582536855,MGT 160,A00,890369,Johnson; Erik Barry,9,0,98,89
1746582538913,MGT 164,A00,890372,Zimmermann; Carsten,0,40,98,98
1746582539938,MGT 180,A00,890374,Bliss; Barbara Ann,12,0,98,86
1746582540965,MMW 15,A01,886414,Chang; Edmond Yi-Teh,0,12,28,28
1746582540965,MMW 15,A02,886415,Chang; Edmond Yi-Teh,0,8,28,28
1746582540965,MMW 15,A03,886416,Chang; Edmond Yi-Teh,0,9,28,28
1746582540965,MMW 15,A04,886417,Chang; Edmond Yi-Teh,0,8,28,28
1746582540965,MMW 15,B01,886419,Chang; Edmond Yi-Teh,0,7,28,28
1746582540965,MMW 15,B02,886420,Chang; Edmond Yi-Teh,0,8,28,28
1746582540965,MMW 15,B03,886421,Chang; Edmond Yi-Teh,0,7,28,28
1746582540965,MMW 15,B04,886422,Chang; Edmond Yi-Teh,0,8,28,28
1746582540965,MMW 15,C01,886424,Staff,0,9,28,28
1746582540965,MMW 15,C02,886425,Staff,0,8,28,28
1746582540965,MMW 15,C03,886426,Staff,0,8,28,28
1746582540965,MMW 15,C04,886427,Staff,0,8,28,28
1746582540965,MMW 15,C05,958038,Staff,0,8,28,28
1746582540965,MMW 15,C06,958039,Staff,1,8,28,27
1746582541993,MMW 15GS,A00,906910,Patterson; Patrick H.,4,0,28,24
1746582543020,MMW 122R,A01,886429,Rahimi; Babak,0,13,28,28
1746582543020,MMW 122R,A02,886430,Rahimi; Babak,0,12,28,28
1746582543020,MMW 122R,A03,958040,Rahimi; Babak,0,11,28,28
1746582544050,MUS 1A,A01,890937,Staff,2,0,25,23
1746582544050,MUS 1A,A02,891035,Staff,6,0,25,19
1746582544050,MUS 1A,C01,958912,Staff,24,0,25,1
1746582544050,MUS 1A,C02,958913,Staff,25,0,25,0
1746582546104,MUS 2AK,A00,957092,Ohnishi; Takae,15,0,15,0
1746582547133,MUS 4,A01,891044,Staff,1,0,25,24
1746582547133,MUS 4,A02,891045,Staff,23,0,25,2
1746582547133,MUS 4,B01,891048,Staff,17,0,25,8
1746582547133,MUS 4,B02,891050,Staff,25,0,25,0
1746582548158,MUS 5,A01,957506,Dubnov; Shlomo,0,0,25,25
1746582548158,MUS 5,A02,957622,Dubnov; Shlomo,13,0,25,12
1746582548158,MUS 5,A03,957623,Dubnov; Shlomo,20,0,25,5
1746582549185,MUS 6,A01,891053,Freitas Caetano; Marcelo,24,0,25,1
1746582549185,MUS 6,A02,891054,Freitas Caetano; Marcelo,23,0,25,2
1746582550209,MUS 7,A01,891081,Staff,0,0,25,25
1746582550209,MUS 7,A02,891082,Staff,3,0,25,22
1746582551238,MUS 8GS,A00,891118,Borgo; David Garcia,1,0,25,24
1746582552267,MUS 11,A01,891140,Staff,9,0,25,16
1746582552267,MUS 11,A02,891141,Staff,21,0,25,4
1746582553294,MUS 13,A01,891143,Staff,8,0,25,17
1746582553294,MUS 13,A02,891144,Staff,24,0,25,1
1746582554319,MUS 15,A01,891146,Staff,9,0,25,16
1746582554319,MUS 15,A02,891148,Staff,21,0,25,4
1746582554319,MUS 15,B01,891150,Staff,18,0,25,7
1746582554319,MUS 15,B02,891151,Staff,25,0,25,0
1746582555345,MUS 20,A01,891153,Staff,5,0,20,15
1746582555345,MUS 20,A02,891155,Staff,14,0,20,6
1746582556377,MUS 80,A00,891156,Staff,19,0,25,6
1746582556377,MUS 80,B00,891157,Staff,23,0,25,2
1746582557403,MUS 130,A00,891158,Ohnishi; Takae,35,0,35,0
1746582558430,MUS 150GS,A01,891160,Borgo; David Garcia,1,0,25,24
1746582559456,MUS 170,A01,891162,Freitas Caetano; Marcelo,20,0,25,5
1746582559456,MUS 170,A02,891164,Freitas Caetano; Marcelo,21,0,25,4
1746582560480,NANO 11,A00,886220,Vazquez Mena; Oscar,13,0,15,2
1746582561505,NANO 15,A01,886222,Drews; Aaron,4,0,7,3
1746582562533,NANO 104,A00,886224,Sirbuly; Donald,17,0,25,8
1746582563562,PH 40,A00,886528,Staff,24,0,40,16
1746582564623,PH 45,A01,886799,Staff,35,0,40,5
1746582565649,PH 110,A00,886802,Staff,0,7,40,40
1746582566678,PH 172,A00,906716,Staff,19,0,35,16
1746582567706,PH 191,A00,886803,Staff,6,0,40,34
1746582568735,PHIL 1,A00,889500,Staff,20,0,30,10
1746582569764,PHIL 10,A01,889549,Grush; Rick Scott,16,0,22,6
1746582569764,PHIL 10,A02,889551,Grush; Rick Scott,22,0,22,0
1746582570789,PHIL 28,A01,889559,Lamey; Andy M.,0,2,31,31
1746582570789,PHIL 28,A02,889561,Lamey; Andy M.,0,1,30,30
1746582570789,PHIL 28,A03,889572,Lamey; Andy M.,0,1,30,30
1746582571818,PHIL 35,A00,907839,Staff,13,0,15,2
1746582572847,PHIL 60,A00,889574,Staff,73,0,90,17
1746582573873,PHIL 101,A00,958004,Staff,12,0,15,3
1746582575925,PHIL 136,A00,889582,Fulkerson; Matthew Todd,26,0,45,19
1746582576950,PHIL 163,A01,889601,Staff,21,0,30,9
1746582576950,PHIL 163,B01,889606,Brandt; Reuven A,0,3,0,0
1746582577973,PHIL 164,A00,889610,Staff,16,0,30,14
1746582579002,PHIL 165,A00,889613,Staff,22,0,30,8
1746582580032,PHYS 1A,A00,886431,Staff,29,0,70,41
1746582581061,PHYS 1AL,001,886432,Tsai; Philbert S,1,2,30,29
1746582581061,PHYS 1AL,002,886436,Tsai; Philbert S,12,0,30,18
1746582582089,PHYS 1B,A00,886439,Staff,184,0,240,56
1746582583114,PHYS 1BL,001,886441,Tsai; Philbert S,0,4,30,30
1746582583114,PHYS 1BL,002,886444,Tsai; Philbert S,2,0,30,28
1746582584142,PHYS 1C,A00,896092,Arnold; Kam S,78,0,146,68
1746582585174,PHYS 1CL,001,886448,Tsai; Philbert S,0,0,30,30
1746582585174,PHYS 1CL,002,886449,Tsai; Philbert S,1,0,30,29
1746582585174,PHYS 1CL,003,886450,Tsai; Philbert S,16,0,30,14
1746582585174,PHYS 1CL,004,886451,Tsai; Philbert S,15,0,30,15
1746582586199,PHYS 2B,A01,886457,Staff,67,0,115,48
1746582587229,PHYS 2C,A01,886460,Shotwell; Brian,0,9,65,65
1746582588252,PHYS 2CL,A01,886467,Staff,0,4,28,28
1746582588252,PHYS 2CL,A02,886468,Staff,0,3,28,28
1746582589282,PHYS 2D,A01,886470,Staff,10,0,50,40
1746582590312,PHYS 4B,A01,886475,Grinstein; Benjamin,22,0,40,18
1746582591340,POLI 5,A00,891173,Desposato; Scott,7,0,25,18
1746582592365,POLI 5D,A01,891175,Staff,5,0,5,0
1746582592365,POLI 5D,B01,891178,Staff,5,0,5,0
1746582593390,POLI 11,A00,891179,Ferree; Karen E,2,0,35,33
1746582594415,POLI 12,A00,891180,Staff,16,0,30,14
1746582595440,POLI 27,A01,891182,Staff,12,0,75,63
1746582596469,POLI 30,A00,891183,Staff,8,0,50,42
1746582597493,POLI 100B,A00,891244,Staff,5,1,35,30
1746582598522,POLI 100I,A00,891247,Staff,7,0,30,23
1746582599547,POLI 104J,A00,891248,Nichter; Maysa,14,0,30,16
1746582600571,POLI 104U,A00,891250,Nichter; Maysa,1,0,30,29
1746582602624,POLI 110B,A00,891255,Wiens; David,19,0,25,6
1746582603649,POLI 112A,A00,891256,Wiens; David,6,0,25,19
1746582604673,POLI 114BR,A00,891261,Staff,19,0,30,11
1746582605699,POLI 117R,A00,891262,Forman; Fonna,0,6,50,50
1746582606724,POLI 118,A00,891264,Ingham; Sean,17,0,25,8
1746582607756,POLI 124A,A00,891265,Staff,18,0,20,2
1746582608784,POLI 125D,A00,891266,Nichter; Simeon C,2,0,25,23
1746582609808,POLI 126,A00,891268,Nichter; Simeon C,7,0,25,18
1746582610833,POLI 126AA,A00,891272,Staff,15,0,25,10
1746582611861,POLI 130AA,A00,891273,Staff,15,0,20,5
1746582612886,POLI 134AA,A00,891274,Staff,4,0,20,16
1746582614938,POLI 138,A00,891278,Staff,21,0,25,4
1746582616024,POLI 142K,A00,891280,Staff,10,0,25,15
1746582617051,POLI 142M,A00,891281,Gartzke; Erik,16,0,30,14
1746582618077,POLI 142P,A00,891284,Staff,20,0,30,10
1746582619105,POLI 143,A00,891285,Gartzke; Erik,12,0,30,18
1746582620129,POLI 153,A00,891286,Staff,19,0,20,1
1746582622177,POLI 175,A00,891290,Staff,15,0,20,5
1746582623201,PSYC 1,A00,890674,Steiner; Eric Tomas,0,11,45,45
1746582624229,PSYC 2,A00,890676,Albright; Thomas D,20,0,35,15
1746582625257,PSYC 3,A00,890679,Staff,17,0,20,3
1746582626282,PSYC 6,A00,959858,Staff,19,0,20,1
1746582627307,PSYC 60,A01,890684,Rickard; Timothy C.,0,5,45,45
1746582628334,PSYC 70,A01,890689,Geller; Emma Harlan,6,0,30,24
1746582629360,PSYC 71,A01,959860,Staff,21,0,25,4
1746582630385,PSYC 100,A00,890690,Lacefield; Katharine I,0,50,180,180
1746582631410,PSYC 102,A00,890695,Staff,18,0,40,22
1746582632436,PSYC 105,A00,890699,Geller; Emma Harlan,70,0,100,30
1746582633462,PSYC 106,A00,890701,Gorman; Michael R.,5,0,30,25
1746582634489,PSYC 108,A00,890704,Adrian; Julia Anna,0,28,50,50
1746582635514,PSYC 118,A01,890712,Staff,11,0,30,19
1746582636542,PSYC 124,A00,890716,Chapman; Eddie Nathaniel,25,0,60,35
1746582637570,PSYC 131,A00,890717,Anagnostaras; Stephan,0,7,80,80
1746582638594,PSYC 137,A00,890719,Winkielman; Piotr,0,11,30,30
1746582639623,PSYC 144,A00,890721,Adrian; Julia Anna,0,9,45,45
1746582640648,PSYC 162,A00,890805,Staff,0,0,75,75
1746582641674,PSYC 169,A00,890810,Staff,0,14,30,30
1746582642704,PSYC 172,A00,890814,Gorman; Michael R.,9,0,30,21
1746582643731,PSYC 181,A00,890818,Anagnostaras; Stephan,6,0,200,194
1746582644758,PSYC 184,A00,959861,Staff,164,0,175,11
1746582645783,PSYC 189,A00,890823,Staff,0,2,30,30
1746582646809,PSYC 191,A00,890884,Rickard; Timothy C.,0,12,35,35
1746582647838,PSYC 193,A00,890913,Staff,19,0,30,11
1746582647838,PSYC 193,B00,890914,Chapman; Eddie Nathaniel,24,0,30,6
1746582648866,PSYC 193L,A01,890918,Lowe; Angela Beth,20,0,30,10
1746582648866,PSYC 193L,B01,890921,Hurwitz; Ethan Scott,20,0,30,10
1746582648866,PSYC 193L,C01,890928,Staff,30,0,30,0
1746582649893,RELI 149,A00,886806,Rahimi; Babak,23,0,40,17
1746582650920,SE 9,A01,886814,Staff,7,0,20,13
1746582651947,SE 101B,A01,886816,Chadha; Mayank,4,0,35,31
1746582652972,SE 110B,A00,886818,Zhu; Qiang,4,0,75,71
1746582653998,SE 125,A01,886830,Staff,10,0,30,20
1746582655023,SE 130B,A01,886835,Staff,14,0,40,26
1746582656052,SE 131A,A01,886838,Krysl; Petr,34,0,55,21
1746582657078,SE 154,A00,886840,Staff,29,0,50,21
1746582658102,SE 164GS,A01,886849,Staff,6,0,20,14
1746582659129,SE 167GS,A01,886853,Staff,6,0,20,14
1746582660155,SIO 25,A01,890107,Staff,19,0,30,11
1746582661181,SIO 45,A00,890109,Cook; Geoffrey W,116,0,200,84
1746582662209,SIO 109R,A00,890110,Forman; Fonna,0,16,20,20
1746582663239,SIO 187,A01,890114,Kacev; David,15,0,40,25
1746582664264,SOCI 1,A01,890431,Thorpe; Charles Robert,14,0,30,16
1746582664264,SOCI 1,A02,890518,Thorpe; Charles Robert,30,0,30,0
1746582665291,SOCI 2,A01,957978,Staff,25,0,25,0
1746582665291,SOCI 2,A02,957979,Staff,23,0,25,2
1746582666319,SOCI 20,A01,890523,Calderon-Zaks; Michael Aar,21,0,30,9
1746582666319,SOCI 20,A02,890526,Calderon-Zaks; Michael Aar,29,0,30,1
1746582667344,SOCI 30,A01,890533,Pardo Guerra; Juan Pablo,37,0,40,3
1746582668370,SOCI 40,A01,890535,Staff,27,0,45,18
1746582669398,SOCI 104Q,A00,890559,Staff,18,0,30,12
1746582670423,SOCI 106,A00,890560,Arnal; Maud Marie Leonie,20,0,30,10
1746582671448,SOCI 110,A00,890567,Holkenbrink-Monk; Charlene,19,0,30,11
1746582672475,SOCI 112,A00,890568,Victoria Torres; Pablo,2,0,55,53
1746582673501,SOCI 115,A00,890597,Arnal; Maud Marie Leonie,28,0,45,17
1746582675557,SOCI 121,A00,890604,Pardo Guerra; Juan Pablo,38,0,45,7
1746582676582,SOCI 126,A01,890608,Staff,8,0,10,2
1746582677607,SOCI 127,A00,890609,Staff,18,0,30,12
1746582678632,SOCI 131,A00,890610,Thorpe; Charles Robert,37,0,45,8
1746582679658,SOCI 135,A00,890615,Payne; Christine Anna,13,0,45,32
1746582680690,SOCI 139,A00,890620,Staff,38,0,45,7
1746582681715,SOCI 148E,A00,890622,Calderon-Zaks; Michael Aar,36,0,45,9
1746582682741,SOCI 150,A00,890623,Kohler; Kristopher M.,31,0,45,14
1746582683771,SOCI 157,A00,890625,Jules-Rosette; Bennetta W.,18,0,20,2
1746582684800,SOCI 160,A00,890627,Payne; Christine Anna,21,0,45,24
1746582685829,SYN 1,A00,886855,Fish; Gwendolyn Anne,0,1,0,0
1746582685829,SYN 1,B00,906086,Fish; Gwendolyn Anne,0,2,0,2
1746582686857,SYN 2R,A00,886860,Staff,0,17,15,15
1746582686857,SYN 2R,B00,906106,Atkinson; Arthur Laird,0,16,15,15
1746582687883,SYN 100,A01,886866,Browne; Emily,0,28,20,20
1746582687883,SYN 100,B01,906128,Rock; Martin,0,4,20,20
1746582687883,SYN 100,C01,906140,Deavenport; James Cary,0,3,20,20
1746582687883,SYN 100,D01,907816,Deavenport; James Cary,0,5,20,20
1746582688908,TDAC 1,A00,890286,Walsh; Kim C.,7,0,20,13
1746582689936,TDAC 101,A00,890296,Basso; Beatrice,15,0,20,5
1746582690960,TDDE 131,A00,890297,Staff,47,0,50,3
1746582691989,TDDM 1,A00,890287,Weinberg; Sadie,25,0,30,5
1746582693014,TDGE 11,A00,890288,Fulton; Julia,138,0,200,62
1746582693014,TDGE 11,B00,890289,Castro; Robert Jess,184,0,200,16
1746582694039,TDGE 25,B00,957359,Walsh; Kim C.,5,0,20,15
1746582695068,TDGE 40,A01,890292,Power; Jade Yukana,27,0,30,3
1746582696093,TDGE 124,A00,890298,Havis; Allan,0,1,50,50
1746582697118,TDGE 131R,A00,890299,Burelle; Julie Sara Veronique,15,0,42,27
1746582698145,TDHT 101,A00,890300,Staff,10,0,20,10
1746582699169,TDHT 109,A01,890302,Anderson; Mysia Anyse,31,0,40,9
1746582700196,TDMV 1,A00,890293,Arcidiacono; Kristin,18,0,30,12
1746582701223,TDMV 2,A00,890294,Weinberg; Sadie,23,0,30,7
1746582702253,TDMV 3,A00,957878,Arcidiacono; Kristin,28,0,30,2
1746582704304,TDMV 138,A00,890304,Jun; Grace Shin Hae,25,0,40,15
1746582705329,TDMV 140,A00,890305,Corrales; Joseph Bernales,25,0,30,5
1746582706355,TDMV 142,A00,890307,Caligagan; Tony,32,0,40,8
1746582707384,TDMV 144,A00,890308,Camaya; Michelle Ann,25,0,30,5
1746582708409,TDPW 1,A00,890295,Stein; Deborah Isobel,3,0,20,17
1746582709434,USP 2,A01,890272,Lerner; Amy M,7,0,20,13
1746582710462,USP 3,A01,890274,Staff,12,0,30,18
1746582711491,USP 15,A01,890276,Sun; Feiyang,16,0,30,14
1746582712519,USP 25,A00,890277,Shenkman; Michael Thomas,18,0,25,7
1746582713546,USP 138,A00,890278,Staff,14,0,25,11
1746582714571,USP 143,A00,890279,Staff,22,0,70,48
1746582715595,USP 144,A00,890280,Chowdhury; Muhammed Zohir,16,0,30,14
1746582716624,USP 150,A00,890281,Boomhower; Matthew Charles,4,0,30,26
1746582717650,USP 151,A00,890282,Staff,16,0,20,4
1746582718675,USP 162,A00,890283,Andrews; Abigail Leslie,16,0,20,4
1746582719703,USP 168,A00,920477,Kwak; Nancy,0,0,5,5
1746582720731,USP 181,A00,890284,Staff,3,0,20,17
1746582721756,USP 191A,A00,890285,Staff,12,0,20,8
1746582722781,VIS 101,A00,886512,Staff,26,0,75,49
1746582723812,VIS 103,A00,886513,Cruz; Edwin Teddy,61,0,75,14
1746582724840,VIS 108,A00,886514,Staff,3,0,15,12
1746582725868,VIS 127P,A00,886515,Shen; Kuiyi,79,0,146,67
1746582726893,VIS 149,A00,886516,Yoldas; Pinar,0,0,15,15
1746582727922,VIS 164,A00,886526,Erdmann; Dean,19,0,22,3
1746582728950,VIS 194S,A00,886527,Staff,61,0,75,14
1746582729979,WCWP 10A,C00,886484,Martiniuk; Jill,12,0,15,3
1746582731009,WCWP 10B,A00,886490,Uriarte; Emma,0,0,15,15
1746582731009,WCWP 10B,B00,886491,Dhir; Simrita,8,0,15,7
1746582731009,WCWP 10B,C00,886492,Ornelas; Tricia,0,0,15,15
1746582732039,WCWP 100,A00,886494,Young; Mark T,0,6,15,15
1746582734135,AAS 10,A01,886199,Childs; Dennis R.,0,3,0,0
1746582735165,ANAR 104,A01,886940,Shtienberg; Gilad,27,0,30,3
1746582736189,ANAR 120,A00,886953,Staff,13,0,20,7
1746582737218,ANBI 148,A01,886955,Wilder; Linnea Lorene,30,0,40,10
1746582739266,ANSC 122,A00,886957,Staff,24,0,30,6
1746582740296,ANSC 150,A00,886958,Sloane; Julia Kathryn,2,0,15,13
1746582741321,ANSC 156,A00,886959,Jenkins; Janis A.,0,1,15,15
1746582742346,ANSC 180,A00,886960,Staff,11,0,17,6
1746582743372,ANSC 188,A00,886961,Jassal; Aftab,9,0,25,16
1746582744397,ANSC 190,A00,886962,Jassal; Aftab,14,0,25,11
1746582745422,ANSC 191,A00,886963,Staff,18,0,20,2
1746582746448,ANTH 3,A01,891689,Staff,17,0,20,3
1746582747472,ANTH 5,A00,886933,Semendeferi; Ekaterini,16,0,20,4
1746582748497,ANTH 10,A00,886934,Staff,0,12,30,30
1746582749522,ANTH 21,A01,886936,Staff,41,0,60,19
1746582750551,ANTH 23,A01,886938,Staff,92,0,100,8
1746582751581,ANTH 105,A00,886964,Stewart; Alexander B,84,0,100,16
1746582752606,ANTH 108,A00,886965,Pedersen; David,9,0,20,11
1746582753633,AWP 10,001,886147,Staff,0,0,0,0
1746582753633,AWP 10,002,886148,Staff,0,0,0,0
1746582753633,AWP 10,003,886149,Staff,0,0,0,0
1746582753633,AWP 10,004,886150,Staff,0,0,0,0
1746582753633,AWP 10,005,886151,Staff,0,0,0,0
1746582753633,AWP 10,006,886152,Staff,0,0,0,0
1746582753633,AWP 10,007,886153,Staff,0,0,0,0
1746582753633,AWP 10,008,886154,Staff,0,0,0,0
1746582753633,AWP 10,009,886155,Staff,0,0,0,0
1746582753633,AWP 10,010,886156,Staff,0,0,0,0
1746582753633,AWP 10,011,886158,Staff,0,0,0,0
1746582753633,AWP 10,012,886160,Staff,0,0,0,0
1746582753633,AWP 10,013,886161,Staff,0,0,0,0
1746582753633,AWP 10,014,886162,Staff,0,0,0,0
1746582753633,AWP 10,015,886163,Staff,0,0,0,0
1746582753633,AWP 10,016,886164,Staff,0,0,0,0
1746582753633,AWP 10,017,886165,Staff,0,0,0,0
1746582753633,AWP 10,018,886166,Staff,0,0,0,0
1746582753633,AWP 10,019,886168,Staff,0,0,0,0
1746582753633,AWP 10,020,886170,Staff,0,0,0,0
1746582753633,AWP 10,021,886172,Staff,0,0,0,0
1746582754668,AWP 10R,001,886173,Staff,0,1,0,0
1746582754668,AWP 10R,002,886174,Staff,0,1,0,0
1746582754668,AWP 10R,003,886175,Staff,0,0,0,0
1746582754668,AWP 10R,004,886176,Staff,0,0,0,0
1746582754668,AWP 10R,005,886177,Staff,0,0,0,0
1746582754668,AWP 10R,006,886178,Staff,0,0,0,0
1746582754668,AWP 10R,007,886179,Staff,0,0,0,0
1746582754668,AWP 10R,008,886181,Staff,0,0,0,0
1746582754668,AWP 10R,009,886182,Staff,0,0,0,0
1746582754668,AWP 10R,010,886183,Staff,0,0,0,0
1746582754668,AWP 10R,011,886184,Staff,0,0,0,0
1746582754668,AWP 10R,012,886185,Staff,0,0,0,0
1746582754668,AWP 10R,013,886186,Staff,0,0,0,0
1746582754668,AWP 10R,014,886187,Staff,0,0,0,0
1746582754668,AWP 10R,015,886188,Staff,0,0,0,0
1746582754668,AWP 10R,016,886189,Staff,0,0,0,0
1746582754668,AWP 10R,017,960532,Staff,0,0,0,0
1746582754668,AWP 10R,018,960533,Staff,0,0,0,0
1746582754668,AWP 10R,019,960534,Staff,0,0,0,0
1746582754668,AWP 10R,020,960538,Staff,0,0,0,0
1746582754668,AWP 10R,021,960540,Staff,0,0,0,0
1746582754668,AWP 10R,022,960541,Staff,0,0,0,0
1746582754668,AWP 10R,023,960542,Staff,0,0,0,0
1746582754668,AWP 10R,024,960544,Staff,0,0,0,0
1746582754668,AWP 10R,025,960545,Staff,0,0,0,0
1746582754668,AWP 10R,026,960548,Staff,0,0,0,0
1746582755694,AWP 102R,A00,886190,Staff,0,0,0,0
1746582755694,AWP 102R,B00,886191,Staff,0,0,0,0
1746582756722,BENG 100,A01,886193,Staff,17,0,30,13
1746582757747,BENG 122A,A01,886195,Hasty; Jeff M,13,0,30,17
1746582758772,BENG 166A,A00,886196,Sah; Robert Lie-Yuan,0,3,30,30
1746582759797,BENG 190,A00,958050,Khojah; Reem I,17,0,25,8
1746582760822,BIBC 102,A01,894320,Staff,0,0,46,46
1746582760822,BIBC 102,A02,894321,Staff,0,0,46,46
1746582760822,BIBC 102,A03,894344,Staff,6,0,46,40
1746582760822,BIBC 102,A04,894345,Staff,27,0,47,20
1746582761849,BICD 100R,A01,894365,Smith; Laurie,0,3,58,58
1746582761849,BICD 100R,A02,894366,Smith; Laurie,0,5,58,58
1746582761849,BICD 100R,A03,894367,Smith; Laurie,0,0,59,59
1746582761849,BICD 100R,A04,959869,Smith; Laurie,40,0,59,19
1746582762878,BICD 136,A01,894383,Gustafson-Brown; Cindy,14,0,50,36
1746582763903,BIEB 102,A01,894494,Butler; Shannon Rhey,51,0,130,79
1746582765954,BIEB 150,A01,894617,Wills; Christopher,3,0,20,17
1746582765954,BIEB 150,A02,894631,Wills; Christopher,3,0,20,17
1746582765954,BIEB 150,A03,894937,Wills; Christopher,3,0,20,17
1746582765954,BIEB 150,A04,894946,Wills; Christopher,5,0,20,15
1746582766980,BIEB 194,A00,906141,Kurle; Carolyn M.,6,0,20,14
1746582768007,BILD 1,A01,894154,Staff,3,0,19,16
1746582768007,BILD 1,A02,894155,Staff,14,0,19,5
1746582768007,BILD 1,A03,894160,Staff,13,0,19,6
1746582768007,BILD 1,A04,894161,Staff,15,0,18,3
1746582769033,BILD 2,A01,894168,Staff,0,0,50,50
1746582769033,BILD 2,A02,894169,Staff,0,0,50,50
1746582769033,BILD 2,A03,894179,Staff,0,0,50,50
1746582769033,BILD 2,A04,894203,Staff,24,0,50,26
1746582770064,BILD 3,A01,894213,Staff,23,0,31,8
1746582770064,BILD 3,A02,894214,Staff,26,0,31,5
1746582770064,BILD 3,A03,894235,Staff,28,0,31,3
1746582770064,BILD 3,A04,894236,Staff,28,0,32,4
1746582771089,BILD 4,A01,894253,Reuther; Keefe,5,0,24,19
1746582771089,BILD 4,A02,894258,Reuther; Keefe,16,0,24,8
1746582772118,BILD 5,A01,894276,Reuther; Keefe,35,0,50,15
1746582772118,BILD 5,A02,894277,Reuther; Keefe,45,0,50,5
1746582772118,BILD 5,A03,894290,Reuther; Keefe,44,0,50,6
1746582772118,BILD 5,A04,894291,Reuther; Keefe,48,0,50,2
1746582773142,BILD 24,A01,894297,Pirino; Giorgia,40,0,60,20
1746582774167,BIMM 100,B01,958915,Staff,71,0,100,29
1746582775192,BIMM 101,A01,895017,McDonnell; Lisa Marie,0,5,24,24
1746582775192,BIMM 101,A02,895018,McDonnell; Lisa Marie,0,5,24,24
1746582775192,BIMM 101,B01,895020,McDonnell; Lisa Marie,0,6,24,24
1746582775192,BIMM 101,B02,895021,McDonnell; Lisa Marie,0,4,24,24
1746582776218,BIMM 110,A01,895023,Staff,1,0,25,24
1746582776218,BIMM 110,A02,895024,Staff,9,0,25,16
1746582776218,BIMM 110,A03,895025,Staff,18,0,25,7
1746582776218,BIMM 110,A04,895031,Staff,20,0,25,5
1746582777248,BIMM 120,A01,895114,Gustafson-Brown; Cindy,14,0,28,14
1746582777248,BIMM 120,A02,895126,Gustafson-Brown; Cindy,21,0,27,6
1746582778279,BIPN 100,A01,895130,Yang; Mingyu,0,0,38,38
1746582778279,BIPN 100,A02,895131,Yang; Mingyu,31,0,38,7
1746582778279,BIPN 100,A03,895132,Yang; Mingyu,32,0,38,6
1746582778279,BIPN 100,A04,895133,Yang; Mingyu,27,0,36,9
1746582779308,BIPN 120,A01,895135,Cooke; James Edward,0,3,13,13
1746582779308,BIPN 120,A02,895136,Cooke; James Edward,0,1,13,13
1746582779308,BIPN 120,A03,895137,Cooke; James Edward,0,3,13,13
1746582779308,BIPN 120,A04,895156,Cooke; James Edward,0,2,11,11
1746582780334,BIPN 134,A01,895235,Cooke; James Edward,0,2,25,25
1746582780334,BIPN 134,A02,895237,Cooke; James Edward,0,0,25,25
1746582780334,BIPN 134,A03,895240,Cooke; James Edward,3,0,25,22
1746582780334,BIPN 134,A04,895270,Cooke; James Edward,20,0,25,5
1746582781361,BIPN 189,A00,892103,Staff,0,14,14,14
1746582783418,BISP 194,A00,958008,Staff,0,2,0,0
1746582784446,CAT 124,A01,922009,Staff,0,5,20,20
1746582785473,CAT 125R,A00,886390,Morales; Celeste Georgianna,0,2,20,20
1746582785473,CAT 125R,B00,886391,Irwin; Matthew Joseph,0,4,20,20
1746582785473,CAT 125R,C00,886392,Smith; Lauryn Alissa,0,2,20,20
1746582785473,CAT 125R,D00,886393,Vanderschuit; Maya Alysia,0,3,20,20
1746582785473,CAT 125R,E00,886394,Marchisotto; Jennifer Anne,0,3,20,20
1746582786499,CENG 15,A01,886218,Drews; Aaron,3,0,8,5
1746582787529,CENG 113,A00,886219,Opatkiewicz; Justin Paul,15,0,25,10
1746582788569,CGS 101,A00,887044,Staff,7,0,20,13
1746582789595,CGS 105,A01,887046,Staff,14,0,25,11
1746582790624,CGS 112,A00,887047,Cuong; Marisol,12,0,15,3
1746582791650,CGS 113,A00,887048,Staff,23,0,30,7
1746582792675,CGS 120,A00,887049,Staff,10,0,17,7
1746582793706,CHEM 6A,A01,886336,Lam; Tin Yiu,38,0,50,12
1746582793706,CHEM 6A,A02,886338,Lam; Tin Yiu,37,0,50,13
1746582794732,CHEM 6B,A01,886341,Hopkins; Patrycja Anna,16,0,50,34
1746582794732,CHEM 6B,A02,886343,Hopkins; Patrycja Anna,42,0,50,8
1746582795756,CHEM 6C,A01,886346,Albizati; Kim F.,0,2,50,50
1746582795756,CHEM 6C,A02,886348,Albizati; Kim F.,24,0,50,26
1746582796783,CHEM 40A,A01,886352,Klosterman; Jeremy K,65,0,100,35
1746582797809,CHEM 40B,A01,886356,Klosterman; Jeremy K,0,24,100,100
1746582798833,CHEM 41B,A01,886360,Theodorakis; Emmanuel,25,0,50,25
1746582798833,CHEM 41B,A02,886362,Theodorakis; Emmanuel,47,0,50,3
1746582799861,CHIN 165A,A00,886382,Xu; Li,18,0,20,2
1746582800890,CLAS 120,A00,886387,Myerston Santana; Jacobo,33,0,40,7
1746582801915,COGS 9,A01,886967,Shannon; Kyle Michael,42,0,60,18
1746582802939,COGS 11,A01,886969,Staff,9,0,30,21
1746582803964,COGS 14A,A01,886971,Staff,6,0,60,54
1746582804990,COGS 14B,A01,886973,Hoffman; Drew Ellen,4,0,60,56
1746582806016,COGS 18,A01,886975,Morgan; Eric,35,0,60,25
1746582807040,COGS 20,A01,886977,Staff,4,0,8,4
1746582807040,COGS 20,A02,886978,Staff,5,0,7,2
1746582808069,COGS 100,A01,907783,Staff,1,2,30,29
1746582809097,COGS 101B,A01,886980,Staff,0,4,48,48
1746582810124,COGS 101C,A01,886982,Delgado; Tania,0,5,44,44
1746582811149,COGS 102A,A01,886984,Johnson; Christine M.,3,0,30,27
1746582812179,COGS 118B,A01,886986,Staff,1,4,88,87
1746582813204,COGS 150,A01,886988,Bergen; Benjamin,22,0,50,28
1746582814229,COGS 153,A00,886989,Delgado; Tania,0,3,41,41
1746582815254,COGS 186,A01,886991,Staff,0,0,32,32
1746582816280,COGS 187A,A01,886993,Boyle; Mary E. T.,7,0,30,23
1746582817306,COGS 189,A00,886994,Staff,0,1,30,30
1746582818336,COMM 10,A01,886996,Staff,0,0,20,21
1746582818336,COMM 10,A02,886997,Staff,10,0,20,10
1746582818336,COMM 10,A03,959845,Staff,19,0,20,1
1746582819366,COMM 20,A01,886999,Leuning; Grant Maurstad,24,0,40,16
1746582821418,COMM 100A,A01,887002,Staff,0,0,20,25
1746582821418,COMM 100A,A02,887003,Staff,6,0,20,14
1746582822447,COMM 100B,A01,887005,Staff,0,8,20,24
1746582823476,COMM 106D,A00,887006,Staff,13,0,40,27
1746582824502,COMM 110G,A00,887007,Whitworth-Smith; Andrew C,12,0,40,28
1746582825528,COMM 111B,A00,887008,Staff,31,0,40,9
1746582826558,COMM 113T,A00,887009,Abuelhiga; Soraya Jill,28,0,40,12
1746582826558,COMM 113T,B00,906733,Staff,40,0,40,0
1746582827585,COMM 145,A00,887010,Staff,12,0,40,28
1746582828617,COMM 146,A00,887054,Staff,31,0,40,9
1746582829642,COMM 190,A00,887012,Staff,8,0,23,15
1746582830672,CSE 8A,A50,887015,Cao; Yingjun,57,0,85,28
1746582831697,CSE 11,A01,887017,Cao; Yingjun,12,0,70,58
1746582832723,CSE 20,A01,887019,Staff,30,0,50,20
1746582833753,CSE 21,A01,887021,Staff,78,0,100,22
1746582833753,CSE 21,B01,892583,Braun; Oliver,45,0,50,5
1746582834777,CSE 30,A01,887025,Eldon; John,142,0,200,58
1746582835805,CSE 100,A01,887027,Staff,26,0,50,24
1746582835805,CSE 100,A02,887028,Staff,42,0,50,8
1746582836832,CSE 101,A01,887030,Braun; Oliver,74,0,100,26
1746582836832,CSE 101,B01,887032,Jones; Miles E,0,3,50,50
1746582836832,CSE 101,B02,887033,Jones; Miles E,0,2,50,50
1746582837862,CSE 105,A01,908084,Jones; Miles E,32,0,50,18
1746582837862,CSE 105,A02,908087,Jones; Miles E,31,0,50,19
1746582838886,CSE 135,A01,887035,Powell; Thomas Allan,0,5,50,50
1746582839916,CSE 142,A01,887037,Staff,8,0,60,52
1746582840943,CSE 142L,A01,887039,Staff,34,0,60,26
1746582841972,CSE 151A,A01,887041,Solares; Edwin A,47,0,100,53
1746582843001,CSE 175,A01,887043,Kumar; Rakesh,30,0,30,0
1746582844027,CSS 1,A01,886389,Staff,1,2,40,39
1746582845053,DSC 30,A01,908097,Liao; Soohyun Nam,47,0,75,28
1746582846078,DSC 40A,A01,908099,Shannon; Kyle Michael,30,0,50,20
1746582847103,DSC 40B,A01,908112,Staff,15,0,50,35
1746582848131,DSC 80,A01,908116,Staff,19,0,60,41
1746582849159,DSC 197,001,956863,Eldridge; Justin Matthew,9999,0,9999,0
1746582850185,ECE 5,A01,886400,Morris; Karcher William,1,0,6,5
1746582850185,ECE 5,A02,886401,Morris; Karcher William,3,0,6,3
1746582851210,ECE 148,A01,886403,Silberman; Jack,0,14,14,14
1746582852265,ECON 1,A01,887265,Crane; Meredith Helen,12,0,70,58
1746582852265,ECON 1,B01,887268,Staff,42,0,50,8
1746582853292,ECON 2,A01,887273,Crane; Meredith Helen,55,0,70,15
1746582854321,ECON 3,A01,887279,Rondina; Giacomo,32,0,70,38
1746582855352,ECON 4,A01,887282,Anderson; John Charles,0,2,10,10
1746582856376,ECON 5,A01,887285,Staff,34,0,45,11
1746582856376,ECON 5,B01,887292,Staff,41,0,45,4
1746582857403,ECON 100A,A01,887337,Newhouse; Herbert S,54,0,70,16
1746582857403,ECON 100A,B01,887349,Staff,45,0,50,5
1746582858428,ECON 100B,A01,887361,Du; Songzi,29,0,70,41
1746582859454,ECON 100C,A01,887445,Newhouse; Herbert S,59,0,70,11
1746582860478,ECON 105,A00,887488,Vespa; Emanuel Ignacio,23,0,35,12
1746582861503,ECON 109,A01,887506,Shishkin; Denis,28,0,35,7
1746582862534,ECON 110A,A01,887568,Alon; Titan Michael,0,3,35,35
1746582862534,ECON 110A,B01,907601,Alon; Titan Michael,20,0,35,15
1746582863562,ECON 110B,A01,887598,Levkoff; Steven B.,0,24,70,70
1746582864590,ECON 112,A00,887599,Rondina; Giacomo,19,0,35,16
1746582865621,ECON 120A,A01,887603,Dai; Yinlin,35,0,70,35
1746582866652,ECON 120C,A01,887608,Sun; Yixiao,0,1,35,35
1746582866652,ECON 120C,B01,887614,Sun; Yixiao,0,0,35,35
1746582867684,ECON 138,A00,887621,Bharadwaj; Prashant,0,21,20,20
1746582868708,ECON 144,A00,958007,Squires; Dale E,12,0,35,23
1746582869734,ECON 171,A01,907666,Staff,18,0,35,17
1746582870759,ECON 175,A00,887626,Wu; Pak Yeung,22,0,35,13
1746582871786,ECON 190,A00,887640,Vespa; Emanuel Ignacio,22,0,35,13
1746582872812,EDS 25,A01,888197,Staff,0,0,0,0
1746582872812,EDS 25,A02,888209,Staff,0,0,0,0
1746582872812,EDS 25,A03,888210,Staff,0,0,0,0
1746582872812,EDS 25,A04,888212,Staff,0,0,0,0
1746582872812,EDS 25,A05,888213,Staff,0,0,0,0
1746582872812,EDS 25,A06,888214,Staff,0,0,0,0
1746582872812,EDS 25,A07,888235,Staff,0,2,0,0
1746582872812,EDS 25,A08,888236,Staff,0,0,0,0
1746582872812,EDS 25,A09,888240,Staff,0,0,0,0
1746582872812,EDS 25,A10,888244,Staff,0,0,0,0
1746582872812,EDS 25,B01,888273,Staff,0,0,0,0
1746582872812,EDS 25,B02,888285,Staff,0,0,0,0
1746582872812,EDS 25,B03,888423,Staff,0,0,0,1
1746582872812,EDS 25,B04,888432,Staff,0,0,0,0
1746582872812,EDS 25,B05,888433,Staff,0,0,0,0
1746582872812,EDS 25,B06,888467,Staff,0,0,0,0
1746582872812,EDS 25,B07,888468,Staff,0,0,0,0
1746582872812,EDS 25,B08,888479,Staff,0,0,0,0
1746582872812,EDS 25,B09,888484,Staff,0,0,0,0
1746582872812,EDS 25,B10,888487,Staff,0,0,0,0
1746582873837,EDS 38,A01,907700,Choi; Bailey Miyeon,30,0,30,0
1746582874864,EDS 112,A01,888601,Chapman; Thandeka K,12,0,40,28
1746582875893,EDS 115,A00,888697,Mendez; Kathrina Mendoza,10,0,30,20
1746582876920,EDS 116,A01,888893,Staff,34,0,40,6
1746582878970,EDS 124AR,A00,889133,Staff,29,0,50,21
1746582878970,EDS 124AR,B00,907471,Simon; Elizabeth A,37,0,50,13
1746582880003,EDS 124BR,A00,889134,Simon; Elizabeth A,44,0,100,56
1746582881032,EDS 125,A00,889135,Staff,25,0,30,5
1746582882062,EDS 126,A01,889138,Staff,35,0,40,5
1746582883087,EDS 164R,A01,889142,Wishard Guerra; Alison G.,32,0,50,18
1746582884113,ENG 30,A01,886396,Staff,0,0,0,0
1746582884113,ENG 30,B01,886398,Staff,0,0,0,0
1746582885143,ENVR 102,A00,906150,Montejo; Carolina,23,0,25,2
1746582886168,ETHN 103A,A00,887236,Man; Simeon S,0,3,0,0
1746582887194,ETHN 113,A00,887239,Staff,16,0,30,14
1746582888219,ETHN 116,A00,887240,Staff,16,0,25,9
1746582889248,ETHN 117,A00,887241,Choi; Esther Min,28,0,30,2
1746582890273,ETHN 118,A00,887243,Staff,24,0,30,6
1746582891298,ETHN 127,A00,887248,Cuong; Marisol,11,0,15,4
1746582892323,ETHN 139,A00,887250,Staff,7,0,10,3
1746582893352,ETHN 142,A00,887252,Staff,10,0,30,20
1746582894383,ETHN 161,A00,887253,Browne; Errol Tsekani,24,0,30,6
1746582895408,ETHN 163FR,A00,887255,Burelle; Julie Sara Veronique,0,0,5,5
1746582896434,GLBH 20,A00,889149,Elwardani; Nile Regina,8,0,42,34
1746582898546,GLBH 111,A01,889152,Burgos; Jose L.,17,0,17,0
1746582899573,GLBH 150,A00,889181,Sloane; Julia Kathryn,0,5,15,15
1746582901624,HDS 60,A01,886406,Warstadt; Melissa Fawn,73,0,80,7
1746582902650,HIAF 111,A00,889324,Gyamfi; Bright,25,0,32,7
1746582903681,HIEA 131,A00,889328,Staff,15,0,32,17
1746582904711,HIEA 144,A00,889333,Henry; Todd A.,26,0,32,6
1746582905741,HIEA 154,A00,889336,Henry; Todd A.,24,0,32,8
1746582906770,HIEU 106,A00,889339,Staff,22,0,32,10
1746582908827,HIEU 114,A00,889340,Staff,4,0,32,28
1746582909854,HIEU 135GS,A00,889342,Patterson; Patrick H.,0,0,1,24
1746582910880,HIEU 137,A00,889343,Edington; Claire Ellen,10,0,25,15
1746582911909,HIEU 148,A00,889345,Staff,14,0,32,18
1746582912935,HIEU 154,A00,889346,Biess; Frank Peter,21,0,32,11
1746582913964,HILA 102,A00,889351,Staff,12,0,32,20
1746582914992,HILD 2A,A01,889221,Lewandoski; Julia Mavis,1,10,32,31
1746582916023,HILD 7B,A01,889225,Man; Simeon S,0,12,32,32
1746582917052,HILD 7C,A01,889288,Alvarez; Luis A,0,14,32,32
1746582918078,HILD 30,A01,889323,Staff,0,5,32,32
1746582920132,HISC 119,A00,889383,Golan; Tal,19,0,32,13
1746582921161,HIUS 103,A00,889384,Man; Simeon S,0,0,32,32
1746582922188,HIUS 117,A00,919797,Kwak; Nancy,19,0,32,13
1746582923216,HIUS 142A,A00,919788,Staff,22,0,32,10
1746582925266,HIUS 149,A00,889386,Gyamfi; Bright,26,0,32,6
1746582926292,HIUS 155,A00,889387,Alvarez; Luis A,15,0,32,17
1746582927322,HUM 3,A01,886499,Caldwell; Michael Alan,19,0,50,31
1746582928350,HUM 3GS,A00,886500,Rodriguez; Bretton Sigfred,0,0,0,28
1746582929376,HUM 3R,A01,886502,Markman; Kristina,0,36,50,50
1746582930407,HUM 4,A01,886504,Crum; Matthew Stephen,23,0,50,27
1746582930407,HUM 4,B01,886506,West; Geoffrey Scott,17,0,50,33
1746582931431,HUM 4GS,A00,886507,Staff,0,0,0,19
1746582932462,HUM 5,A01,886509,Staff,32,0,50,18
1746582933489,HUM 5R,A01,886511,Zavodny; Tatiana Sophia,0,39,50,50
1746582934517,JAPN 180,A00,886407,Staff,16,0,40,24
1746582935543,LATI 50,A01,886409,Martin-Cabrera; Luis,3,0,22,19
1746582935543,LATI 50,A02,886410,Martin-Cabrera; Luis,19,0,22,3
1746582935543,LATI 50,A03,886411,Martin-Cabrera; Luis,21,0,22,1
1746582935543,LATI 50,A04,886412,Martin-Cabrera; Luis,8,0,22,14
1746582936573,LAWS 101,A00,907664,Staff,28,0,60,32
1746582937599,LIAB 1A,A00,889388,Saab; Dima,17,0,20,3
1746582938624,LIAB 1AX,A00,889389,El Cheddadi; Youniss,18,0,20,2
1746582939649,LIFR 1C,A00,889391,Van Moer; Vinciane G,8,0,20,12
1746582940675,LIFR 1CX,A00,889392,Van Moer; Vinciane G,7,0,20,13
1746582941701,LIFR 1D,A00,889393,Van Moer; Vinciane G,7,0,20,13
1746582942726,LIFR 1DX,A00,889394,Van Moer; Vinciane G,8,0,20,12
1746582943751,LIGN 7,A00,886923,Staff,24,0,50,26
1746582944777,LIGN 17,A00,886924,Kehler; Andrew Scott,125,0,150,25
1746582945806,LTAM 110,A00,889395,Staff,15,0,30,15
1746582946830,LTAM 110GS,A00,958010,Rodriguez; Bretton Sigfred,0,0,0,28
1746582947858,LTCH 101,A00,889397,Staff,23,0,25,2
1746582948886,LTCS 130,A00,889398,Staff,23,0,25,2
1746582949915,LTEA 138,A00,889399,Staff,24,0,40,16
1746582950939,LTEN 149,A00,889400,Wesling; Megan E.,0,3,25,25
1746582951964,LTEN 169,A00,889401,Staff,20,0,25,5
1746582952993,LTEN 180,A00,889402,Staff,10,0,15,5
1746582954021,LTEN 181,A00,889403,Staff,21,0,25,4
1746582955047,LTWL 100,A00,889404,Myerston Santana; Jacobo,2,0,25,23
1746582956076,LTWL 180GS,A00,889405,Staff,0,0,20,20
1746582957103,LTWL 181,A00,889406,Staff,16,0,25,9
1746582958129,LTWL 184,A00,889475,Mukherjee; Silpa,22,0,25,3
1746582959155,LTWR 102C,A00,889486,Staff,29,0,30,1
1746582960185,LTWR 115W,A00,889491,Staff,0,2,15,15
1746582961209,MAE 8,A01,886905,Staff,0,2,0,0
1746582962238,MAE 11,A00,886906,Bandaru; Prabhakar,0,7,50,50
1746582963266,MAE 20,A00,886907,Evdokimenko; Ekaterina,43,0,70,27
1746582964291,MAE 30B,A00,886909,Ghazinejad; Maziar,26,0,45,19
1746582965317,MAE 101B,A00,886910,Saintillan; David,29,0,45,16
1746582966358,MAE 105,A00,886911,Bandaru; Prabhakar,18,0,50,32
1746582967383,MAE 107,B00,958024,Staff,7,0,50,43
1746582968411,MAE 143B,A00,886913,Bewley; Thomas R,2,0,40,38
1746582969440,MAE 148,A01,886915,Silberman; Jack,0,3,14,14
1746582970470,MAE 160,A00,886916,Evdokimenko; Ekaterina,31,0,60,29
1746582971495,MATH 3C,A01,889681,Staff,0,2,30,30
1746582971495,MATH 3C,A02,960048,Staff,24,0,30,6
1746582972521,MATH 10A,A01,889760,Staff,26,0,30,4
1746582972521,MATH 10A,A02,889783,Staff,29,0,30,1
1746582973554,MATH 10B,A01,889785,Verstraete; Jacques Allan,1,0,35,34
1746582973554,MATH 10B,A02,889795,Verstraete; Jacques Allan,4,0,35,31
1746582973554,MATH 10B,B01,889797,Verstraete; Jacques Allan,3,0,35,32
1746582973554,MATH 10B,B02,889828,Verstraete; Jacques Allan,3,0,35,32
1746582974584,MATH 10C,A01,889849,Habib; Yousaf,7,0,30,23
1746582974584,MATH 10C,A02,889852,Habib; Yousaf,14,0,30,16
1746582974584,MATH 10C,A03,889853,Habib; Yousaf,22,0,30,8
1746582974584,MATH 10C,A04,889858,Habib; Yousaf,20,0,30,10
1746582974584,MATH 10C,B01,889861,Staff,1,0,30,29
1746582974584,MATH 10C,B02,889862,Staff,24,0,30,6
1746582974584,MATH 10C,B03,889863,Staff,27,0,30,3
1746582974584,MATH 10C,B04,889967,Staff,23,0,30,7
1746582975615,MATH 18,A01,889974,Staff,7,0,30,23
1746582975615,MATH 18,A02,889977,Staff,20,0,30,10
1746582975615,MATH 18,B01,889984,Hardiman; Liam,20,0,30,10
1746582975615,MATH 18,B02,889985,Hardiman; Liam,25,0,30,5
1746582976641,MATH 20A,A01,889990,Suk; Andrew Hoon,30,0,35,5
1746582977670,MATH 20B,A01,889993,Ohm; Ko Woon,21,0,30,9
1746582977670,MATH 20B,A02,889994,Ohm; Ko Woon,30,0,30,0
1746582977670,MATH 20B,B01,889996,Ohm; Ko Woon,22,0,30,8
1746582977670,MATH 20B,B02,889997,Ohm; Ko Woon,23,0,30,7
1746582978696,MATH 20C,A01,889999,Hammock; Frances H,17,0,30,13
1746582978696,MATH 20C,A02,890003,Hammock; Frances H,23,0,30,7
1746582978696,MATH 20C,B01,890006,Hammock; Frances H,3,0,30,27
1746582978696,MATH 20C,B02,890007,Hammock; Frances H,12,0,30,18
1746582979743,MATH 20D,A01,890011,Cheng; Hsiao-Bing,1,1,30,29
1746582979743,MATH 20D,A02,890012,Cheng; Hsiao-Bing,14,0,30,16
1746582979743,MATH 20D,B01,890016,Cheng; Hsiao-Bing,13,0,30,17
1746582979743,MATH 20D,B02,890017,Cheng; Hsiao-Bing,13,0,30,17
1746582980768,MATH 20E,A01,890026,Harel; Guershon,1,0,30,29
1746582980768,MATH 20E,A02,890029,Harel; Guershon,22,0,30,8
1746582980768,MATH 20E,B01,890033,Harel; Guershon,7,0,30,23
1746582980768,MATH 20E,B02,890101,Harel; Guershon,21,0,30,9
1746582981798,MATH 102,A01,890104,Staff,18,0,30,12
1746582981798,MATH 102,A02,890105,Staff,27,0,30,3
1746582982826,MATH 103B,A01,890116,Salehi Golsefidy; Alireza,3,0,30,27
1746582982826,MATH 103B,B01,890118,Staff,0,3,34,34
1746582983853,MATH 109,A01,890121,Aliabadi Sr.; Mohsen,0,0,30,30
1746582983853,MATH 109,B01,890124,Upadrashta; Pranav Kumar,18,0,30,12
1746582984880,MATH 120A,A01,890126,Eggers; John Dietrich,13,0,30,17
1746582985907,MATH 142B,A01,890128,Ioana; Adrian,19,0,30,11
1746582985907,MATH 142B,A02,890129,Ioana; Adrian,12,0,30,18
1746582986933,MATH 154,A01,890174,Staff,0,1,30,30
1746582986933,MATH 154,A02,890182,Staff,0,0,30,30
1746582987959,MATH 168A,A01,890197,Dumitriu; Ioana,21,0,35,14
1746582988989,MATH 170A,A01,890240,Nie; Jiawang,1,0,30,29
1746582988989,MATH 170A,A02,890241,Nie; Jiawang,11,0,30,19
1746582988989,MATH 170A,A03,890249,Nie; Jiawang,23,0,30,7
1746582990014,MATH 170B,A01,957891,Nag; Panchali,13,0,35,22
1746582992074,MATH 181A,A01,908025,Staff,0,3,35,35
1746582992074,MATH 181A,A02,960115,Staff,26,0,35,9
1746582993102,MATH 181B,A01,959874,Staff,25,0,30,5
1746582994128,MATH 193B,A01,890265,Staff,0,4,35,35
1746582995157,MGT 4,A01,890311,Anderson; John Charles,42,0,88,46
1746582996182,MGT 5,A00,907740,Staff,13,0,98,85
1746582997208,MGT 12,A00,890312,Lindenberger; Wade Douglas,67,0,98,31
1746582998234,MGT 16,A00,957883,Staff,78,0,98,20
1746583000284,MGT 45,A00,890314,Pecore; Joseph P.,45,0,98,53
1746583001310,MGT 71,A00,890315,Staff,0,12,98,98
1746583002338,MGT 100,A00,890316,Yavorsky; Daniel Ryan,44,0,98,54
1746583003367,MGT 103,A00,890317,Ehrich; Kristine R,73,0,98,25
1746583004393,MGT 105,A00,890356,Bates; Kenneth Walter,0,8,98,98
1746583005421,MGT 112,A00,890360,Ehrich; Kristine R,55,0,98,43
1746583006449,MGT 127R,A00,907732,Zhu; Kevin Xiaoguo,23,0,98,75
1746583007478,MGT 131B,A00,890361,Anderson; John Charles,59,0,98,39
1746583008504,MGT 137,A00,890362,Lindenberger; Wade Douglas,65,0,98,33
1746583009529,MGT 160,A00,890369,Johnson; Erik Barry,9,0,98,89
1746583011583,MGT 164,A00,890372,Zimmermann; Carsten,0,40,98,98
1746583012610,MGT 180,A00,890374,Bliss; Barbara Ann,12,0,98,86
1746583013634,MMW 15,A01,886414,Chang; Edmond Yi-Teh,0,12,28,28
1746583013634,MMW 15,A02,886415,Chang; Edmond Yi-Teh,0,8,28,28
1746583013634,MMW 15,A03,886416,Chang; Edmond Yi-Teh,0,9,28,28
1746583013634,MMW 15,A04,886417,Chang; Edmond Yi-Teh,0,8,28,28
1746583013634,MMW 15,B01,886419,Chang; Edmond Yi-Teh,0,7,28,28
1746583013634,MMW 15,B02,886420,Chang; Edmond Yi-Teh,0,8,28,28
1746583013634,MMW 15,B03,886421,Chang; Edmond Yi-Teh,0,7,28,28
1746583013634,MMW 15,B04,886422,Chang; Edmond Yi-Teh,0,8,28,28
1746583013634,MMW 15,C01,886424,Staff,0,9,28,28
1746583013634,MMW 15,C02,886425,Staff,0,8,28,28
1746583013634,MMW 15,C03,886426,Staff,0,8,28,28
1746583013634,MMW 15,C04,886427,Staff,0,8,28,28
1746583013634,MMW 15,C05,958038,Staff,0,8,28,28
1746583013634,MMW 15,C06,958039,Staff,1,8,28,27
1746583014663,MMW 15GS,A00,906910,Patterson; Patrick H.,4,0,28,24
1746583015689,MMW 122R,A01,886429,Rahimi; Babak,0,13,28,28
1746583015689,MMW 122R,A02,886430,Rahimi; Babak,0,12,28,28
1746583015689,MMW 122R,A03,958040,Rahimi; Babak,0,11,28,28
1746583016719,MUS 1A,A01,890937,Staff,2,0,25,23
1746583016719,MUS 1A,A02,891035,Staff,6,0,25,19
1746583016719,MUS 1A,C01,958912,Staff,24,0,25,1
1746583016719,MUS 1A,C02,958913,Staff,25,0,25,0
1746583018769,MUS 2AK,A00,957092,Ohnishi; Takae,15,0,15,0
1746583019796,MUS 4,A01,891044,Staff,1,0,25,24
1746583019796,MUS 4,A02,891045,Staff,23,0,25,2
1746583019796,MUS 4,B01,891048,Staff,17,0,25,8
1746583019796,MUS 4,B02,891050,Staff,25,0,25,0
1746583020823,MUS 5,A01,957506,Dubnov; Shlomo,0,0,25,25
1746583020823,MUS 5,A02,957622,Dubnov; Shlomo,13,0,25,12
1746583020823,MUS 5,A03,957623,Dubnov; Shlomo,20,0,25,5
1746583021852,MUS 6,A01,891053,Freitas Caetano; Marcelo,24,0,25,1
1746583021852,MUS 6,A02,891054,Freitas Caetano; Marcelo,23,0,25,2
1746583022877,MUS 7,A01,891081,Staff,0,0,25,25
1746583022877,MUS 7,A02,891082,Staff,3,0,25,22
1746583023903,MUS 8GS,A00,891118,Borgo; David Garcia,1,0,25,24
1746583024928,MUS 11,A01,891140,Staff,9,0,25,16
1746583024928,MUS 11,A02,891141,Staff,21,0,25,4
1746583025956,MUS 13,A01,891143,Staff,8,0,25,17
1746583025956,MUS 13,A02,891144,Staff,24,0,25,1
1746583026986,MUS 15,A01,891146,Staff,9,0,25,16
1746583026986,MUS 15,A02,891148,Staff,21,0,25,4
1746583026986,MUS 15,B01,891150,Staff,18,0,25,7
1746583026986,MUS 15,B02,891151,Staff,25,0,25,0
1746583028011,MUS 20,A01,891153,Staff,5,0,20,15
1746583028011,MUS 20,A02,891155,Staff,14,0,20,6
1746583029039,MUS 80,A00,891156,Staff,19,0,25,6
1746583029039,MUS 80,B00,891157,Staff,23,0,25,2
1746583030064,MUS 130,A00,891158,Ohnishi; Takae,35,0,35,0
1746583031092,MUS 150GS,A01,891160,Borgo; David Garcia,1,0,25,24
1746583032116,MUS 170,A01,891162,Freitas Caetano; Marcelo,20,0,25,5
1746583032116,MUS 170,A02,891164,Freitas Caetano; Marcelo,21,0,25,4
1746583033142,NANO 11,A00,886220,Vazquez Mena; Oscar,13,0,15,2
1746583034168,NANO 15,A01,886222,Drews; Aaron,4,0,7,3
1746583035192,NANO 104,A00,886224,Sirbuly; Donald,17,0,25,8
1746583036218,PH 40,A00,886528,Staff,24,0,40,16
1746583037246,PH 45,A01,886799,Staff,35,0,40,5
1746583038274,PH 110,A00,886802,Staff,0,7,40,40
1746583039300,PH 172,A00,906716,Staff,19,0,35,16
1746583040326,PH 191,A00,886803,Staff,6,0,40,34
1746583041354,PHIL 1,A00,889500,Staff,20,0,30,10
1746583042382,PHIL 10,A01,889549,Grush; Rick Scott,16,0,22,6
1746583042382,PHIL 10,A02,889551,Grush; Rick Scott,22,0,22,0
1746583043407,PHIL 28,A01,889559,Lamey; Andy M.,0,2,31,31
1746583043407,PHIL 28,A02,889561,Lamey; Andy M.,0,1,30,30
1746583043407,PHIL 28,A03,889572,Lamey; Andy M.,0,1,30,30
1746583044436,PHIL 35,A00,907839,Staff,13,0,15,2
1746583045459,PHIL 60,A00,889574,Staff,73,0,90,17
1746583046486,PHIL 101,A00,958004,Staff,12,0,15,3
1746583048536,PHIL 136,A00,889582,Fulkerson; Matthew Todd,26,0,45,19
1746583049561,PHIL 163,A01,889601,Staff,21,0,30,9
1746583049561,PHIL 163,B01,889606,Brandt; Reuven A,0,3,0,0
1746583050587,PHIL 164,A00,889610,Staff,16,0,30,14
1746583051612,PHIL 165,A00,889613,Staff,22,0,30,8
1746583052637,PHYS 1A,A00,886431,Staff,29,0,70,41
1746583053663,PHYS 1AL,001,886432,Tsai; Philbert S,1,2,30,29
1746583053663,PHYS 1AL,002,886436,Tsai; Philbert S,12,0,30,18
1746583054690,PHYS 1B,A00,886439,Staff,184,0,240,56
1746583055717,PHYS 1BL,001,886441,Tsai; Philbert S,0,4,30,30
1746583055717,PHYS 1BL,002,886444,Tsai; Philbert S,2,0,30,28
1746583056743,PHYS 1C,A00,896092,Arnold; Kam S,78,0,146,68
1746583057774,PHYS 1CL,001,886448,Tsai; Philbert S,0,0,30,30
1746583057774,PHYS 1CL,002,886449,Tsai; Philbert S,1,0,30,29
1746583057774,PHYS 1CL,003,886450,Tsai; Philbert S,16,0,30,14
1746583057774,PHYS 1CL,004,886451,Tsai; Philbert S,15,0,30,15
1746583058801,PHYS 2B,A01,886457,Staff,67,0,115,48
1746583059830,PHYS 2C,A01,886460,Shotwell; Brian,0,9,65,65
1746583060859,PHYS 2CL,A01,886467,Staff,0,4,28,28
1746583060859,PHYS 2CL,A02,886468,Staff,0,3,28,28
1746583061883,PHYS 2D,A01,886470,Staff,10,0,50,40
1746583062909,PHYS 4B,A01,886475,Grinstein; Benjamin,22,0,40,18
1746583063937,POLI 5,A00,891173,Desposato; Scott,7,0,25,18
1746583064966,POLI 5D,A01,891175,Staff,5,0,5,0
1746583064966,POLI 5D,B01,891178,Staff,5,0,5,0
1746583065994,POLI 11,A00,891179,Ferree; Karen E,2,0,35,33
1746583067020,POLI 12,A00,891180,Staff,16,0,30,14
1746583068045,POLI 27,A01,891182,Staff,12,0,75,63
1746583069071,POLI 30,A00,891183,Staff,8,0,50,42
1746583070101,POLI 100B,A00,891244,Staff,5,1,35,30
1746583071128,POLI 100I,A00,891247,Staff,7,0,30,23
1746583072158,POLI 104J,A00,891248,Nichter; Maysa,14,0,30,16
1746583073197,POLI 104U,A00,891250,Nichter; Maysa,1,0,30,29
1746583075248,POLI 110B,A00,891255,Wiens; David,19,0,25,6
1746583076274,POLI 112A,A00,891256,Wiens; David,6,0,25,19
1746583077300,POLI 114BR,A00,891261,Staff,19,0,30,11
1746583078327,POLI 117R,A00,891262,Forman; Fonna,0,6,50,50
1746583079354,POLI 118,A00,891264,Ingham; Sean,17,0,25,8
1746583080382,POLI 124A,A00,891265,Staff,18,0,20,2
1746583081406,POLI 125D,A00,891266,Nichter; Simeon C,2,0,25,23
1746583082432,POLI 126,A00,891268,Nichter; Simeon C,7,0,25,18
1746583083458,POLI 126AA,A00,891272,Staff,15,0,25,10
1746583084482,POLI 130AA,A00,891273,Staff,15,0,20,5
1746583085510,POLI 134AA,A00,891274,Staff,4,0,20,16
1746583087565,POLI 138,A00,891278,Staff,21,0,25,4
1746583088591,POLI 142K,A00,891280,Staff,10,0,25,15
1746583089618,POLI 142M,A00,891281,Gartzke; Erik,16,0,30,14
1746583090643,POLI 142P,A00,891284,Staff,20,0,30,10
1746583091669,POLI 143,A00,891285,Gartzke; Erik,12,0,30,18
1746583092696,POLI 153,A00,891286,Staff,19,0,20,1
1746583094750,POLI 175,A00,891290,Staff,15,0,20,5
1746583095779,PSYC 1,A00,890674,Steiner; Eric Tomas,0,11,45,45
1746583096803,PSYC 2,A00,890676,Albright; Thomas D,20,0,35,15
1746583097832,PSYC 3,A00,890679,Staff,17,0,20,3
1746583098862,PSYC 6,A00,959858,Staff,19,0,20,1
1746583099891,PSYC 60,A01,890684,Rickard; Timothy C.,0,5,45,45
1746583100915,PSYC 70,A01,890689,Geller; Emma Harlan,6,0,30,24
1746583101941,PSYC 71,A01,959860,Staff,21,0,25,4
1746583102966,PSYC 100,A00,890690,Lacefield; Katharine I,0,50,180,180
1746583103992,PSYC 102,A00,890695,Staff,18,0,40,22
1746583105018,PSYC 105,A00,890699,Geller; Emma Harlan,70,0,100,30
1746583106046,PSYC 106,A00,890701,Gorman; Michael R.,5,0,30,25
1746583107071,PSYC 108,A00,890704,Adrian; Julia Anna,0,28,50,50
1746583108098,PSYC 118,A01,890712,Staff,11,0,30,19
1746583109122,PSYC 124,A00,890716,Chapman; Eddie Nathaniel,25,0,60,35
1746583110148,PSYC 131,A00,890717,Anagnostaras; Stephan,0,7,80,80
1746583111176,PSYC 137,A00,890719,Winkielman; Piotr,0,11,30,30
1746583112202,PSYC 144,A00,890721,Adrian; Julia Anna,0,9,45,45
1746583113225,PSYC 162,A00,890805,Staff,0,0,75,75
1746583114250,PSYC 169,A00,890810,Staff,0,14,30,30
1746583115274,PSYC 172,A00,890814,Gorman; Michael R.,9,0,30,21
1746583116298,PSYC 181,A00,890818,Anagnostaras; Stephan,7,0,200,193
1746583117324,PSYC 184,A00,959861,Staff,164,0,175,11
1746583118350,PSYC 189,A00,890823,Staff,0,2,30,30
1746583119377,PSYC 191,A00,890884,Rickard; Timothy C.,0,12,35,35
1746583120404,PSYC 193,A00,890913,Staff,19,0,30,11
1746583120404,PSYC 193,B00,890914,Chapman; Eddie Nathaniel,24,0,30,6
1746583121434,PSYC 193L,A01,890918,Lowe; Angela Beth,20,0,30,10
1746583121434,PSYC 193L,B01,890921,Hurwitz; Ethan Scott,20,0,30,10
1746583121434,PSYC 193L,C01,890928,Staff,30,0,30,0
1746583122458,RELI 149,A00,886806,Rahimi; Babak,23,0,40,17
1746583123485,SE 9,A01,886814,Staff,7,0,20,13
1746583124515,SE 101B,A01,886816,Chadha; Mayank,4,0,35,31
1746583125544,SE 110B,A00,886818,Zhu; Qiang,4,0,75,71
1746583126573,SE 125,A01,886830,Staff,10,0,30,20
1746583127599,SE 130B,A01,886835,Staff,14,0,40,26
1746583128625,SE 131A,A01,886838,Krysl; Petr,34,0,55,21
1746583129653,SE 154,A00,886840,Staff,28,0,50,22
1746583130679,SE 164GS,A01,886849,Staff,6,0,20,14
1746583131708,SE 167GS,A01,886853,Staff,6,0,20,14
1746583132735,SIO 25,A01,890107,Staff,19,0,30,11
1746583133766,SIO 45,A00,890109,Cook; Geoffrey W,116,0,200,84
1746583134791,SIO 109R,A00,890110,Forman; Fonna,0,16,20,20
1746583135820,SIO 187,A01,890114,Kacev; David,15,0,40,25
1746583136848,SOCI 1,A01,890431,Thorpe; Charles Robert,14,0,30,16
1746583136848,SOCI 1,A02,890518,Thorpe; Charles Robert,30,0,30,0
1746583137874,SOCI 2,A01,957978,Staff,25,0,25,0
1746583137874,SOCI 2,A02,957979,Staff,23,0,25,2
1746583138904,SOCI 20,A01,890523,Calderon-Zaks; Michael Aar,21,0,30,9
1746583138904,SOCI 20,A02,890526,Calderon-Zaks; Michael Aar,29,0,30,1
1746583139933,SOCI 30,A01,890533,Pardo Guerra; Juan Pablo,37,0,40,3
1746583140961,SOCI 40,A01,890535,Staff,27,0,45,18
1746583141988,SOCI 104Q,A00,890559,Staff,18,0,30,12
1746583143013,SOCI 106,A00,890560,Arnal; Maud Marie Leonie,20,0,30,10
1746583144039,SOCI 110,A00,890567,Holkenbrink-Monk; Charlene,19,0,30,11
1746583145068,SOCI 112,A00,890568,Victoria Torres; Pablo,2,0,55,53
1746583146098,SOCI 115,A00,890597,Arnal; Maud Marie Leonie,28,0,45,17
1746583148150,SOCI 121,A00,890604,Pardo Guerra; Juan Pablo,38,0,45,7
1746583149179,SOCI 126,A01,890608,Staff,8,0,10,2
1746583150203,SOCI 127,A00,890609,Staff,18,0,30,12
1746583151229,SOCI 131,A00,890610,Thorpe; Charles Robert,37,0,45,8
1746583152258,SOCI 135,A00,890615,Payne; Christine Anna,13,0,45,32
1746583153283,SOCI 139,A00,890620,Staff,38,0,45,7
1746583154307,SOCI 148E,A00,890622,Calderon-Zaks; Michael Aar,36,0,45,9
1746583155334,SOCI 150,A00,890623,Kohler; Kristopher M.,31,0,45,14
1746583156357,SOCI 157,A00,890625,Jules-Rosette; Bennetta W.,18,0,20,2
1746583157394,SOCI 160,A00,890627,Payne; Christine Anna,21,0,45,24
1746583158419,SYN 1,A00,886855,Fish; Gwendolyn Anne,0,1,0,0
1746583158419,SYN 1,B00,906086,Fish; Gwendolyn Anne,0,2,0,2
1746583159451,SYN 2R,A00,886860,Staff,0,17,15,15
1746583159451,SYN 2R,B00,906106,Atkinson; Arthur Laird,0,16,15,15
1746583160483,SYN 100,A01,886866,Browne; Emily,0,28,20,20
1746583160483,SYN 100,B01,906128,Rock; Martin,0,4,20,20
1746583160483,SYN 100,C01,906140,Deavenport; James Cary,0,3,20,20
1746583160483,SYN 100,D01,907816,Deavenport; James Cary,0,5,20,20
1746583161510,TDAC 1,A00,890286,Walsh; Kim C.,7,0,20,13
1746583162539,TDAC 101,A00,890296,Basso; Beatrice,15,0,20,5
1746583163570,TDDE 131,A00,890297,Staff,47,0,50,3
1746583164596,TDDM 1,A00,890287,Weinberg; Sadie,25,0,30,5
1746583165625,TDGE 11,A00,890288,Fulton; Julia,138,0,200,62
1746583165625,TDGE 11,B00,890289,Castro; Robert Jess,184,0,200,16
1746583166649,TDGE 25,B00,957359,Walsh; Kim C.,5,0,20,15
1746583167679,TDGE 40,A01,890292,Power; Jade Yukana,27,0,30,3
1746583168708,TDGE 124,A00,890298,Havis; Allan,0,1,50,50
1746583169735,TDGE 131R,A00,890299,Burelle; Julie Sara Veronique,15,0,42,27
1746583170762,TDHT 101,A00,890300,Staff,10,0,20,10
1746583171792,TDHT 109,A01,890302,Anderson; Mysia Anyse,31,0,40,9
1746583172816,TDMV 1,A00,890293,Arcidiacono; Kristin,18,0,30,12
1746583173840,TDMV 2,A00,890294,Weinberg; Sadie,23,0,30,7
1746583174870,TDMV 3,A00,957878,Arcidiacono; Kristin,28,0,30,2
1746583176921,TDMV 138,A00,890304,Jun; Grace Shin Hae,25,0,40,15
1746583177949,TDMV 140,A00,890305,Corrales; Joseph Bernales,25,0,30,5
1746583178978,TDMV 142,A00,890307,Caligagan; Tony,32,0,40,8
1746583180006,TDMV 144,A00,890308,Camaya; Michelle Ann,25,0,30,5
1746583181031,TDPW 1,A00,890295,Stein; Deborah Isobel,3,0,20,17
1746583182056,USP 2,A01,890272,Lerner; Amy M,7,0,20,13
1746583183082,USP 3,A01,890274,Staff,12,0,30,18
1746583184110,USP 15,A01,890276,Sun; Feiyang,16,0,30,14
1746583185138,USP 25,A00,890277,Shenkman; Michael Thomas,18,0,25,7
1746583186165,USP 138,A00,890278,Staff,14,0,25,11
1746583187194,USP 143,A00,890279,Staff,22,0,70,48
1746583188223,USP 144,A00,890280,Chowdhury; Muhammed Zohir,16,0,30,14
1746583189248,USP 150,A00,890281,Boomhower; Matthew Charles,4,0,30,26
1746583190273,USP 151,A00,890282,Staff,16,0,20,4
1746583191301,USP 162,A00,890283,Andrews; Abigail Leslie,16,0,20,4
1746583192330,USP 168,A00,920477,Kwak; Nancy,0,0,5,5
1746583193359,USP 181,A00,890284,Staff,3,0,20,17
1746583194386,USP 191A,A00,890285,Staff,12,0,20,8
1746583195412,VIS 101,A00,886512,Staff,26,0,75,49
1746583196441,VIS 103,A00,886513,Cruz; Edwin Teddy,61,0,75,14
1746583197471,VIS 108,A00,886514,Staff,3,0,15,12
1746583198498,VIS 127P,A00,886515,Shen; Kuiyi,79,0,146,67
1746583199525,VIS 149,A00,886516,Yoldas; Pinar,0,0,15,15
1746583200554,VIS 164,A00,886526,Erdmann; Dean,19,0,22,3
1746583201583,VIS 194S,A00,886527,Staff,61,0,75,14
1746583202613,WCWP 10A,C00,886484,Martiniuk; Jill,12,0,15,3
1746583203644,WCWP 10B,A00,886490,Uriarte; Emma,0,0,15,15
1746583203644,WCWP 10B,B00,886491,Dhir; Simrita,8,0,15,7
1746583203644,WCWP 10B,C00,886492,Ornelas; Tricia,0,0,15,15
1746583204673,WCWP 100,A00,886494,Young; Mark T,0,6,15,15
1746583206840,AAS 10,A01,886199,Childs; Dennis R.,0,3,0,0
1746583207866,ANAR 104,A01,886940,Shtienberg; Gilad,27,0,30,3
1746583208895,ANAR 120,A00,886953,Staff,13,0,20,7
1746583209919,ANBI 148,A01,886955,Wilder; Linnea Lorene,30,0,40,10
1746583211971,ANSC 122,A00,886957,Staff,24,0,30,6
1746583213001,ANSC 150,A00,886958,Sloane; Julia Kathryn,2,0,15,13
1746583214027,ANSC 156,A00,886959,Jenkins; Janis A.,0,1,15,15
1746583215051,ANSC 180,A00,886960,Staff,11,0,17,6
1746583216077,ANSC 188,A00,886961,Jassal; Aftab,9,0,25,16
1746583217104,ANSC 190,A00,886962,Jassal; Aftab,14,0,25,11
1746583218133,ANSC 191,A00,886963,Staff,18,0,20,2
1746583219160,ANTH 3,A01,891689,Staff,17,0,20,3
1746583220187,ANTH 5,A00,886933,Semendeferi; Ekaterini,16,0,20,4
1746583221213,ANTH 10,A00,886934,Staff,0,12,30,30
1746583222241,ANTH 21,A01,886936,Staff,41,0,60,19
1746583223265,ANTH 23,A01,886938,Staff,92,0,100,8
1746583224294,ANTH 105,A00,886964,Stewart; Alexander B,84,0,100,16
1746583225318,ANTH 108,A00,886965,Pedersen; David,9,0,20,11
1746583226345,AWP 10,001,886147,Staff,0,0,0,0
1746583226345,AWP 10,002,886148,Staff,0,0,0,0
1746583226345,AWP 10,003,886149,Staff,0,0,0,0
1746583226345,AWP 10,004,886150,Staff,0,0,0,0
1746583226345,AWP 10,005,886151,Staff,0,0,0,0
1746583226345,AWP 10,006,886152,Staff,0,0,0,0
1746583226345,AWP 10,007,886153,Staff,0,0,0,0
1746583226345,AWP 10,008,886154,Staff,0,0,0,0
1746583226345,AWP 10,009,886155,Staff,0,0,0,0
1746583226345,AWP 10,010,886156,Staff,0,0,0,0
1746583226345,AWP 10,011,886158,Staff,0,0,0,0
1746583226345,AWP 10,012,886160,Staff,0,0,0,0
1746583226345,AWP 10,013,886161,Staff,0,0,0,0
1746583226345,AWP 10,014,886162,Staff,0,0,0,0
1746583226345,AWP 10,015,886163,Staff,0,0,0,0
1746583226345,AWP 10,016,886164,Staff,0,0,0,0
1746583226345,AWP 10,017,886165,Staff,0,0,0,0
1746583226345,AWP 10,018,886166,Staff,0,0,0,0
1746583226345,AWP 10,019,886168,Staff,0,0,0,0
1746583226345,AWP 10,020,886170,Staff,0,0,0,0
1746583226345,AWP 10,021,886172,Staff,0,0,0,0
1746583227375,AWP 10R,001,886173,Staff,0,1,0,0
1746583227375,AWP 10R,002,886174,Staff,0,1,0,0
1746583227375,AWP 10R,003,886175,Staff,0,0,0,0
1746583227375,AWP 10R,004,886176,Staff,0,0,0,0
1746583227375,AWP 10R,005,886177,Staff,0,0,0,0
1746583227375,AWP 10R,006,886178,Staff,0,0,0,0
1746583227375,AWP 10R,007,886179,Staff,0,0,0,0
1746583227375,AWP 10R,008,886181,Staff,0,0,0,0
1746583227375,AWP 10R,009,886182,Staff,0,0,0,0
1746583227375,AWP 10R,010,886183,Staff,0,0,0,0
1746583227375,AWP 10R,011,886184,Staff,0,0,0,0
1746583227375,AWP 10R,012,886185,Staff,0,0,0,0
1746583227375,AWP 10R,013,886186,Staff,0,0,0,0
1746583227375,AWP 10R,014,886187,Staff,0,0,0,0
1746583227375,AWP 10R,015,886188,Staff,0,0,0,0
1746583227375,AWP 10R,016,886189,Staff,0,0,0,0
1746583227375,AWP 10R,017,960532,Staff,0,0,0,0
1746583227375,AWP 10R,018,960533,Staff,0,0,0,0
1746583227375,AWP 10R,019,960534,Staff,0,0,0,0
1746583227375,AWP 10R,020,960538,Staff,0,0,0,0
1746583227375,AWP 10R,021,960540,Staff,0,0,0,0
1746583227375,AWP 10R,022,960541,Staff,0,0,0,0
1746583227375,AWP 10R,023,960542,Staff,0,0,0,0
1746583227375,AWP 10R,024,960544,Staff,0,0,0,0
1746583227375,AWP 10R,025,960545,Staff,0,0,0,0
1746583227375,AWP 10R,026,960548,Staff,0,0,0,0
1746583228400,AWP 102R,A00,886190,Staff,0,0,0,0
1746583228400,AWP 102R,B00,886191,Staff,0,0,0,0
1746583229427,BENG 100,A01,886193,Staff,17,0,30,13
1746583230453,BENG 122A,A01,886195,Hasty; Jeff M,13,0,30,17
1746583231480,BENG 166A,A00,886196,Sah; Robert Lie-Yuan,0,3,30,30
1746583232506,BENG 190,A00,958050,Khojah; Reem I,17,0,25,8
1746583233533,BIBC 102,A01,894320,Staff,0,0,46,46
1746583233533,BIBC 102,A02,894321,Staff,0,0,46,46
1746583233533,BIBC 102,A03,894344,Staff,6,0,46,40
1746583233533,BIBC 102,A04,894345,Staff,27,0,47,20
1746583234560,BICD 100R,A01,894365,Smith; Laurie,0,3,58,58
1746583234560,BICD 100R,A02,894366,Smith; Laurie,0,5,58,58
1746583234560,BICD 100R,A03,894367,Smith; Laurie,0,0,59,59
1746583234560,BICD 100R,A04,959869,Smith; Laurie,40,0,59,19
1746583235585,BICD 136,A01,894383,Gustafson-Brown; Cindy,14,0,50,36
1746583236610,BIEB 102,A01,894494,Butler; Shannon Rhey,51,0,130,79
1746583238668,BIEB 150,A01,894617,Wills; Christopher,3,0,20,17
1746583238668,BIEB 150,A02,894631,Wills; Christopher,3,0,20,17
1746583238668,BIEB 150,A03,894937,Wills; Christopher,3,0,20,17
1746583238668,BIEB 150,A04,894946,Wills; Christopher,5,0,20,15
1746583239697,BIEB 194,A00,906141,Kurle; Carolyn M.,5,0,20,15
1746583240724,BILD 1,A01,894154,Staff,3,0,19,16
1746583240724,BILD 1,A02,894155,Staff,14,0,19,5
1746583240724,BILD 1,A03,894160,Staff,13,0,19,6
1746583240724,BILD 1,A04,894161,Staff,15,0,18,3
1746583241753,BILD 2,A01,894168,Staff,0,0,50,50
1746583241753,BILD 2,A02,894169,Staff,0,0,50,50
1746583241753,BILD 2,A03,894179,Staff,0,0,50,50
1746583241753,BILD 2,A04,894203,Staff,24,0,50,26
1746583242779,BILD 3,A01,894213,Staff,23,0,31,8
1746583242779,BILD 3,A02,894214,Staff,26,0,31,5
1746583242779,BILD 3,A03,894235,Staff,28,0,31,3
1746583242779,BILD 3,A04,894236,Staff,28,0,32,4
1746583243806,BILD 4,A01,894253,Reuther; Keefe,5,0,24,19
1746583243806,BILD 4,A02,894258,Reuther; Keefe,16,0,24,8
1746583244830,BILD 5,A01,894276,Reuther; Keefe,35,0,50,15
1746583244830,BILD 5,A02,894277,Reuther; Keefe,45,0,50,5
1746583244830,BILD 5,A03,894290,Reuther; Keefe,44,0,50,6
1746583244830,BILD 5,A04,894291,Reuther; Keefe,48,0,50,2
1746583245855,BILD 24,A01,894297,Pirino; Giorgia,40,0,60,20
1746583246882,BIMM 100,B01,958915,Staff,71,0,100,29
1746583247907,BIMM 101,A01,895017,McDonnell; Lisa Marie,0,5,24,24
1746583247907,BIMM 101,A02,895018,McDonnell; Lisa Marie,0,5,24,24
1746583247907,BIMM 101,B01,895020,McDonnell; Lisa Marie,0,6,24,24
1746583247907,BIMM 101,B02,895021,McDonnell; Lisa Marie,0,4,24,24
1746583248934,BIMM 110,A01,895023,Staff,1,0,25,24
1746583248934,BIMM 110,A02,895024,Staff,9,0,25,16
1746583248934,BIMM 110,A03,895025,Staff,18,0,25,7
1746583248934,BIMM 110,A04,895031,Staff,20,0,25,5
1746583249964,BIMM 120,A01,895114,Gustafson-Brown; Cindy,14,0,28,14
1746583249964,BIMM 120,A02,895126,Gustafson-Brown; Cindy,21,0,27,6
1746583250990,BIPN 100,A01,895130,Yang; Mingyu,0,0,38,38
1746583250990,BIPN 100,A02,895131,Yang; Mingyu,31,0,38,7
1746583250990,BIPN 100,A03,895132,Yang; Mingyu,32,0,38,6
1746583250990,BIPN 100,A04,895133,Yang; Mingyu,27,0,36,9
1746583252015,BIPN 120,A01,895135,Cooke; James Edward,0,3,13,13
1746583252015,BIPN 120,A02,895136,Cooke; James Edward,0,1,13,13
1746583252015,BIPN 120,A03,895137,Cooke; James Edward,0,3,13,13
1746583252015,BIPN 120,A04,895156,Cooke; James Edward,0,2,11,11
1746583253040,BIPN 134,A01,895235,Cooke; James Edward,0,2,25,25
1746583253040,BIPN 134,A02,895237,Cooke; James Edward,0,0,25,25
1746583253040,BIPN 134,A03,895240,Cooke; James Edward,3,0,25,22
1746583253040,BIPN 134,A04,895270,Cooke; James Edward,20,0,25,5
1746583254068,BIPN 189,A00,892103,Staff,0,14,14,14
1746583256120,BISP 194,A00,958008,Staff,0,2,0,0
1746583257148,CAT 124,A01,922009,Staff,0,5,20,20
1746583258175,CAT 125R,A00,886390,Morales; Celeste Georgianna,0,2,20,20
1746583258175,CAT 125R,B00,886391,Irwin; Matthew Joseph,0,4,20,20
1746583258175,CAT 125R,C00,886392,Smith; Lauryn Alissa,0,2,20,20
1746583258175,CAT 125R,D00,886393,Vanderschuit; Maya Alysia,0,3,20,20
1746583258175,CAT 125R,E00,886394,Marchisotto; Jennifer Anne,0,3,20,20
1746583259200,CENG 15,A01,886218,Drews; Aaron,3,0,8,5
1746583260227,CENG 113,A00,886219,Opatkiewicz; Justin Paul,15,0,25,10
1746583261254,CGS 101,A00,887044,Staff,7,0,20,13
1746583262283,CGS 105,A01,887046,Staff,14,0,25,11
1746583263310,CGS 112,A00,887047,Cuong; Marisol,12,0,15,3
1746583264340,CGS 113,A00,887048,Staff,23,0,30,7
1746583265367,CGS 120,A00,887049,Staff,10,0,17,7
1746583266392,CHEM 6A,A01,886336,Lam; Tin Yiu,38,0,50,12
1746583266392,CHEM 6A,A02,886338,Lam; Tin Yiu,37,0,50,13
1746583267416,CHEM 6B,A01,886341,Hopkins; Patrycja Anna,16,0,50,34
1746583267416,CHEM 6B,A02,886343,Hopkins; Patrycja Anna,42,0,50,8
1746583268445,CHEM 6C,A01,886346,Albizati; Kim F.,0,2,50,50
1746583268445,CHEM 6C,A02,886348,Albizati; Kim F.,24,0,50,26
1746583269476,CHEM 40A,A01,886352,Klosterman; Jeremy K,65,0,100,35
1746583270501,CHEM 40B,A01,886356,Klosterman; Jeremy K,0,24,100,100
1746583271528,CHEM 41B,A01,886360,Theodorakis; Emmanuel,25,0,50,25
1746583271528,CHEM 41B,A02,886362,Theodorakis; Emmanuel,47,0,50,3
1746583272552,CHIN 165A,A00,886382,Xu; Li,18,0,20,2
1746583273579,CLAS 120,A00,886387,Myerston Santana; Jacobo,33,0,40,7
1746583274606,COGS 9,A01,886967,Shannon; Kyle Michael,42,0,60,18
1746583275632,COGS 11,A01,886969,Staff,9,0,30,21
1746583276657,COGS 14A,A01,886971,Staff,6,0,60,54
1746583277681,COGS 14B,A01,886973,Hoffman; Drew Ellen,4,0,60,56
1746583278708,COGS 18,A01,886975,Morgan; Eric,35,0,60,25
1746583279735,COGS 20,A01,886977,Staff,4,0,8,4
1746583279735,COGS 20,A02,886978,Staff,5,0,7,2
1746583280764,COGS 100,A01,907783,Staff,1,2,30,29
1746583281793,COGS 101B,A01,886980,Staff,0,4,48,48
1746583282821,COGS 101C,A01,886982,Delgado; Tania,0,5,44,44
1746583283846,COGS 102A,A01,886984,Johnson; Christine M.,3,0,30,27
1746583284887,COGS 118B,A01,886986,Staff,1,4,88,87
1746583285912,COGS 150,A01,886988,Bergen; Benjamin,22,0,50,28
1746583286940,COGS 153,A00,886989,Delgado; Tania,0,3,41,41
1746583287965,COGS 186,A01,886991,Staff,0,0,32,32
1746583288991,COGS 187A,A01,886993,Boyle; Mary E. T.,7,0,30,23
1746583290018,COGS 189,A00,886994,Staff,0,1,30,30
1746583291047,COMM 10,A01,886996,Staff,0,0,20,21
1746583291047,COMM 10,A02,886997,Staff,10,0,20,10
1746583291047,COMM 10,A03,959845,Staff,19,0,20,1
1746583292074,COMM 20,A01,886999,Leuning; Grant Maurstad,24,0,40,16
1746583294126,COMM 100A,A01,887002,Staff,0,0,20,25
1746583294126,COMM 100A,A02,887003,Staff,6,0,20,14
1746583295154,COMM 100B,A01,887005,Staff,0,8,20,24
1746583296180,COMM 106D,A00,887006,Staff,13,0,40,27
1746583297204,COMM 110G,A00,887007,Whitworth-Smith; Andrew C,12,0,40,28
1746583298234,COMM 111B,A00,887008,Staff,31,0,40,9
1746583299259,COMM 113T,A00,887009,Abuelhiga; Soraya Jill,28,0,40,12
1746583299259,COMM 113T,B00,906733,Staff,40,0,40,0
1746583300283,COMM 145,A00,887010,Staff,12,0,40,28
1746583301310,COMM 146,A00,887054,Staff,31,0,40,9
1746583302336,COMM 190,A00,887012,Staff,8,0,23,15
1746583303365,CSE 8A,A50,887015,Cao; Yingjun,57,0,85,28
1746583304389,CSE 11,A01,887017,Cao; Yingjun,12,0,70,58
1746583305417,CSE 20,A01,887019,Staff,30,0,50,20
1746583306442,CSE 21,A01,887021,Staff,78,0,100,22
1746583306442,CSE 21,B01,892583,Braun; Oliver,45,0,50,5
1746583307469,CSE 30,A01,887025,Eldon; John,142,0,200,58
1746583308497,CSE 100,A01,887027,Staff,26,0,50,24
1746583308497,CSE 100,A02,887028,Staff,42,0,50,8
1746583309523,CSE 101,A01,887030,Braun; Oliver,74,0,100,26
1746583309523,CSE 101,B01,887032,Jones; Miles E,0,3,50,50
1746583309523,CSE 101,B02,887033,Jones; Miles E,0,2,50,50
1746583310552,CSE 105,A01,908084,Jones; Miles E,32,0,50,18
1746583310552,CSE 105,A02,908087,Jones; Miles E,31,0,50,19
1746583311577,CSE 135,A01,887035,Powell; Thomas Allan,0,5,50,50
1746583312606,CSE 142,A01,887037,Staff,8,0,60,52
1746583313637,CSE 142L,A01,887039,Staff,34,0,60,26
1746583314663,CSE 151A,A01,887041,Solares; Edwin A,47,0,100,53
1746583315693,CSE 175,A01,887043,Kumar; Rakesh,30,0,30,0
1746583316717,CSS 1,A01,886389,Staff,1,2,40,39
1746583317746,DSC 30,A01,908097,Liao; Soohyun Nam,47,0,75,28
1746583318773,DSC 40A,A01,908099,Shannon; Kyle Michael,30,0,50,20
1746583319799,DSC 40B,A01,908112,Staff,15,0,50,35
1746583320827,DSC 80,A01,908116,Staff,19,0,60,41
1746583321852,DSC 197,001,956863,Eldridge; Justin Matthew,9999,0,9999,0
1746583322878,ECE 5,A01,886400,Morris; Karcher William,1,0,6,5
1746583322878,ECE 5,A02,886401,Morris; Karcher William,3,0,6,3
1746583323902,ECE 148,A01,886403,Silberman; Jack,0,14,14,14
1746583324928,ECON 1,A01,887265,Crane; Meredith Helen,12,0,70,58
1746583324928,ECON 1,B01,887268,Staff,42,0,50,8
1746583325993,ECON 2,A01,887273,Crane; Meredith Helen,55,0,70,15
1746583327018,ECON 3,A01,887279,Rondina; Giacomo,32,0,70,38
1746583328047,ECON 4,A01,887282,Anderson; John Charles,0,2,10,10
1746583329073,ECON 5,A01,887285,Staff,34,0,45,11
1746583329073,ECON 5,B01,887292,Staff,41,0,45,4
1746583330105,ECON 100A,A01,887337,Newhouse; Herbert S,54,0,70,16
1746583330105,ECON 100A,B01,887349,Staff,45,0,50,5
1746583331132,ECON 100B,A01,887361,Du; Songzi,29,0,70,41
1746583332159,ECON 100C,A01,887445,Newhouse; Herbert S,59,0,70,11
1746583333184,ECON 105,A00,887488,Vespa; Emanuel Ignacio,23,0,35,12
1746583334209,ECON 109,A01,887506,Shishkin; Denis,28,0,35,7
1746583335240,ECON 110A,A01,887568,Alon; Titan Michael,0,3,35,35
1746583335240,ECON 110A,B01,907601,Alon; Titan Michael,20,0,35,15
1746583336263,ECON 110B,A01,887598,Levkoff; Steven B.,0,24,70,70
1746583337288,ECON 112,A00,887599,Rondina; Giacomo,19,0,35,16
1746583338313,ECON 120A,A01,887603,Dai; Yinlin,35,0,70,35
1746583339342,ECON 120C,A01,887608,Sun; Yixiao,0,1,35,35
1746583339342,ECON 120C,B01,887614,Sun; Yixiao,0,0,35,35
1746583340369,ECON 138,A00,887621,Bharadwaj; Prashant,0,21,20,20
1746583341395,ECON 144,A00,958007,Squires; Dale E,12,0,35,23
1746583342419,ECON 171,A01,907666,Staff,18,0,35,17
1746583343445,ECON 175,A00,887626,Wu; Pak Yeung,22,0,35,13
1746583344469,ECON 190,A00,887640,Vespa; Emanuel Ignacio,22,0,35,13
1746583345499,EDS 25,A01,888197,Staff,0,0,0,0
1746583345499,EDS 25,A02,888209,Staff,0,0,0,0
1746583345499,EDS 25,A03,888210,Staff,0,0,0,0
1746583345499,EDS 25,A04,888212,Staff,0,0,0,0
1746583345499,EDS 25,A05,888213,Staff,0,0,0,0
1746583345499,EDS 25,A06,888214,Staff,0,0,0,0
1746583345499,EDS 25,A07,888235,Staff,0,2,0,0
1746583345499,EDS 25,A08,888236,Staff,0,0,0,0
1746583345499,EDS 25,A09,888240,Staff,0,0,0,0
1746583345499,EDS 25,A10,888244,Staff,0,0,0,0
1746583345499,EDS 25,B01,888273,Staff,0,0,0,0
1746583345499,EDS 25,B02,888285,Staff,0,0,0,0
1746583345499,EDS 25,B03,888423,Staff,0,0,0,1
1746583345499,EDS 25,B04,888432,Staff,0,0,0,0
1746583345499,EDS 25,B05,888433,Staff,0,0,0,0
1746583345499,EDS 25,B06,888467,Staff,0,0,0,0
1746583345499,EDS 25,B07,888468,Staff,0,0,0,0
1746583345499,EDS 25,B08,888479,Staff,0,0,0,0
1746583345499,EDS 25,B09,888484,Staff,0,0,0,0
1746583345499,EDS 25,B10,888487,Staff,0,0,0,0
1746583346581,EDS 38,A01,907700,Choi; Bailey Miyeon,30,0,30,0
1746583347605,EDS 112,A01,888601,Chapman; Thandeka K,12,0,40,28
1746583348632,EDS 115,A00,888697,Mendez; Kathrina Mendoza,10,0,30,20
1746583349659,EDS 116,A01,888893,Staff,34,0,40,6
1746583351713,EDS 124AR,A00,889133,Staff,29,0,50,21
1746583351713,EDS 124AR,B00,907471,Simon; Elizabeth A,37,0,50,13
1746583352738,EDS 124BR,A00,889134,Simon; Elizabeth A,44,0,100,56
1746583353763,EDS 125,A00,889135,Staff,25,0,30,5
1746583354788,EDS 126,A01,889138,Staff,35,0,40,5
1746583355816,EDS 164R,A01,889142,Wishard Guerra; Alison G.,32,0,50,18
1746583356845,ENG 30,A01,886396,Staff,0,0,0,0
1746583356845,ENG 30,B01,886398,Staff,0,0,0,0
1746583357871,ENVR 102,A00,906150,Montejo; Carolina,23,0,25,2
1746583358897,ETHN 103A,A00,887236,Man; Simeon S,0,3,0,0
1746583359922,ETHN 113,A00,887239,Staff,16,0,30,14
1746583360952,ETHN 116,A00,887240,Staff,16,0,25,9
1746583361977,ETHN 117,A00,887241,Choi; Esther Min,28,0,30,2
1746583363006,ETHN 118,A00,887243,Staff,24,0,30,6
1746583364030,ETHN 127,A00,887248,Cuong; Marisol,11,0,15,4
1746583365060,ETHN 139,A00,887250,Staff,7,0,10,3
1746583366086,ETHN 142,A00,887252,Staff,10,0,30,20
1746583367114,ETHN 161,A00,887253,Browne; Errol Tsekani,24,0,30,6
1746583368140,ETHN 163FR,A00,887255,Burelle; Julie Sara Veronique,0,0,5,5
1746583369167,GLBH 20,A00,889149,Elwardani; Nile Regina,8,0,42,34
1746583371219,GLBH 111,A01,889152,Burgos; Jose L.,17,0,17,0
1746583372245,GLBH 150,A00,889181,Sloane; Julia Kathryn,0,5,15,15
1746583374301,HDS 60,A01,886406,Warstadt; Melissa Fawn,73,0,80,7
1746583375329,HIAF 111,A00,889324,Gyamfi; Bright,25,0,32,7
1746583376354,HIEA 131,A00,889328,Staff,15,0,32,17
1746583377381,HIEA 144,A00,889333,Henry; Todd A.,26,0,32,6
1746583378406,HIEA 154,A00,889336,Henry; Todd A.,24,0,32,8
1746583379430,HIEU 106,A00,889339,Staff,22,0,32,10
1746583381482,HIEU 114,A00,889340,Staff,4,0,32,28
1746583382511,HIEU 135GS,A00,889342,Patterson; Patrick H.,0,0,1,24
1746583383541,HIEU 137,A00,889343,Edington; Claire Ellen,10,0,25,15
1746583384566,HIEU 148,A00,889345,Staff,14,0,32,18
1746583385595,HIEU 154,A00,889346,Biess; Frank Peter,21,0,32,11
1746583386619,HILA 102,A00,889351,Staff,12,0,32,20
1746583387645,HILD 2A,A01,889221,Lewandoski; Julia Mavis,1,10,32,31
1746583388670,HILD 7B,A01,889225,Man; Simeon S,0,12,32,32
1746583389699,HILD 7C,A01,889288,Alvarez; Luis A,0,14,32,32
1746583390724,HILD 30,A01,889323,Staff,0,5,32,32
1746583392777,HISC 119,A00,889383,Golan; Tal,19,0,32,13
1746583393803,HIUS 103,A00,889384,Man; Simeon S,0,0,32,32
1746583394829,HIUS 117,A00,919797,Kwak; Nancy,19,0,32,13
1746583395854,HIUS 142A,A00,919788,Staff,22,0,32,10
1746583397908,HIUS 149,A00,889386,Gyamfi; Bright,26,0,32,6
1746583398937,HIUS 155,A00,889387,Alvarez; Luis A,15,0,32,17
1746583399963,HUM 3,A01,886499,Caldwell; Michael Alan,19,0,50,31
1746583400990,HUM 3GS,A00,886500,Rodriguez; Bretton Sigfred,0,0,0,28
1746583402016,HUM 3R,A01,886502,Markman; Kristina,0,36,50,50
1746583403041,HUM 4,A01,886504,Crum; Matthew Stephen,23,0,50,27
1746583403041,HUM 4,B01,886506,West; Geoffrey Scott,17,0,50,33
1746583404069,HUM 4GS,A00,886507,Staff,0,0,0,19
1746583405096,HUM 5,A01,886509,Staff,32,0,50,18
1746583406120,HUM 5R,A01,886511,Zavodny; Tatiana Sophia,0,39,50,50
1746583407145,JAPN 180,A00,886407,Staff,16,0,40,24
1746583408174,LATI 50,A01,886409,Martin-Cabrera; Luis,3,0,22,19
1746583408174,LATI 50,A02,886410,Martin-Cabrera; Luis,19,0,22,3
1746583408174,LATI 50,A03,886411,Martin-Cabrera; Luis,21,0,22,1
1746583408174,LATI 50,A04,886412,Martin-Cabrera; Luis,8,0,22,14
1746583409201,LAWS 101,A00,907664,Staff,28,0,60,32
1746583410226,LIAB 1A,A00,889388,Saab; Dima,17,0,20,3
1746583411251,LIAB 1AX,A00,889389,El Cheddadi; Youniss,18,0,20,2
1746583412277,LIFR 1C,A00,889391,Van Moer; Vinciane G,8,0,20,12
1746583413301,LIFR 1CX,A00,889392,Van Moer; Vinciane G,7,0,20,13
1746583414326,LIFR 1D,A00,889393,Van Moer; Vinciane G,7,0,20,13
1746583415354,LIFR 1DX,A00,889394,Van Moer; Vinciane G,8,0,20,12
1746583416378,LIGN 7,A00,886923,Staff,24,0,50,26
1746583417403,LIGN 17,A00,886924,Kehler; Andrew Scott,125,0,150,25
1746583418430,LTAM 110,A00,889395,Staff,15,0,30,15
1746583419456,LTAM 110GS,A00,958010,Rodriguez; Bretton Sigfred,0,0,0,28
1746583420484,LTCH 101,A00,889397,Staff,23,0,25,2
1746583421509,LTCS 130,A00,889398,Staff,23,0,25,2
1746583422534,LTEA 138,A00,889399,Staff,24,0,40,16
1746583423564,LTEN 149,A00,889400,Wesling; Megan E.,0,3,25,25
1746583424588,LTEN 169,A00,889401,Staff,20,0,25,5
1746583425615,LTEN 180,A00,889402,Staff,10,0,15,5
1746583426700,LTEN 181,A00,889403,Staff,21,0,25,4
1746583427725,LTWL 100,A00,889404,Myerston Santana; Jacobo,2,0,25,23
1746583428752,LTWL 180GS,A00,889405,Staff,0,0,20,20
1746583429778,LTWL 181,A00,889406,Staff,16,0,25,9
1746583430808,LTWL 184,A00,889475,Mukherjee; Silpa,22,0,25,3
1746583431836,LTWR 102C,A00,889486,Staff,29,0,30,1
1746583432862,LTWR 115W,A00,889491,Staff,0,2,15,15
1746583433888,MAE 8,A01,886905,Staff,0,2,0,0
1746583434914,MAE 11,A00,886906,Bandaru; Prabhakar,0,7,50,50
1746583435941,MAE 20,A00,886907,Evdokimenko; Ekaterina,43,0,70,27
1746583436972,MAE 30B,A00,886909,Ghazinejad; Maziar,26,0,45,19
1746583438000,MAE 101B,A00,886910,Saintillan; David,29,0,45,16
1746583439029,MAE 105,A00,886911,Bandaru; Prabhakar,18,0,50,32
1746583440054,MAE 107,B00,958024,Staff,7,0,50,43
1746583441080,MAE 143B,A00,886913,Bewley; Thomas R,3,0,40,37
1746583442105,MAE 148,A01,886915,Silberman; Jack,0,3,14,14
1746583443131,MAE 160,A00,886916,Evdokimenko; Ekaterina,31,0,60,29
1746583444160,MATH 3C,A01,889681,Staff,0,2,30,30
1746583444160,MATH 3C,A02,960048,Staff,24,0,30,6
1746583445187,MATH 10A,A01,889760,Staff,26,0,30,4
1746583445187,MATH 10A,A02,889783,Staff,29,0,30,1
1746583446217,MATH 10B,A01,889785,Verstraete; Jacques Allan,1,0,35,34
1746583446217,MATH 10B,A02,889795,Verstraete; Jacques Allan,4,0,35,31
1746583446217,MATH 10B,B01,889797,Verstraete; Jacques Allan,3,0,35,32
1746583446217,MATH 10B,B02,889828,Verstraete; Jacques Allan,3,0,35,32
1746583447245,MATH 10C,A01,889849,Habib; Yousaf,7,0,30,23
1746583447245,MATH 10C,A02,889852,Habib; Yousaf,14,0,30,16
1746583447245,MATH 10C,A03,889853,Habib; Yousaf,22,0,30,8
1746583447245,MATH 10C,A04,889858,Habib; Yousaf,20,0,30,10
1746583447245,MATH 10C,B01,889861,Staff,1,0,30,29
1746583447245,MATH 10C,B02,889862,Staff,24,0,30,6
1746583447245,MATH 10C,B03,889863,Staff,27,0,30,3
1746583447245,MATH 10C,B04,889967,Staff,23,0,30,7
1746583448271,MATH 18,A01,889974,Staff,7,0,30,23
1746583448271,MATH 18,A02,889977,Staff,20,0,30,10
1746583448271,MATH 18,B01,889984,Hardiman; Liam,20,0,30,10
1746583448271,MATH 18,B02,889985,Hardiman; Liam,25,0,30,5
1746583449296,MATH 20A,A01,889990,Suk; Andrew Hoon,30,0,35,5
1746583450326,MATH 20B,A01,889993,Ohm; Ko Woon,21,0,30,9
1746583450326,MATH 20B,A02,889994,Ohm; Ko Woon,30,0,30,0
1746583450326,MATH 20B,B01,889996,Ohm; Ko Woon,22,0,30,8
1746583450326,MATH 20B,B02,889997,Ohm; Ko Woon,23,0,30,7
1746583451359,MATH 20C,A01,889999,Hammock; Frances H,17,0,30,13
1746583451359,MATH 20C,A02,890003,Hammock; Frances H,23,0,30,7
1746583451359,MATH 20C,B01,890006,Hammock; Frances H,3,0,30,27
1746583451359,MATH 20C,B02,890007,Hammock; Frances H,12,0,30,18
1746583452386,MATH 20D,A01,890011,Cheng; Hsiao-Bing,1,1,30,29
1746583452386,MATH 20D,A02,890012,Cheng; Hsiao-Bing,14,0,30,16
1746583452386,MATH 20D,B01,890016,Cheng; Hsiao-Bing,13,0,30,17
1746583452386,MATH 20D,B02,890017,Cheng; Hsiao-Bing,13,0,30,17
1746583453410,MATH 20E,A01,890026,Harel; Guershon,1,0,30,29
1746583453410,MATH 20E,A02,890029,Harel; Guershon,22,0,30,8
1746583453410,MATH 20E,B01,890033,Harel; Guershon,7,0,30,23
1746583453410,MATH 20E,B02,890101,Harel; Guershon,21,0,30,9
1746583454439,MATH 102,A01,890104,Staff,18,0,30,12
1746583454439,MATH 102,A02,890105,Staff,27,0,30,3
1746583455464,MATH 103B,A01,890116,Salehi Golsefidy; Alireza,3,0,30,27
1746583455464,MATH 103B,B01,890118,Staff,0,3,34,34
1746583456490,MATH 109,A01,890121,Aliabadi Sr.; Mohsen,0,0,30,30
1746583456490,MATH 109,B01,890124,Upadrashta; Pranav Kumar,18,0,30,12
1746583457515,MATH 120A,A01,890126,Eggers; John Dietrich,13,0,30,17
1746583458540,MATH 142B,A01,890128,Ioana; Adrian,19,0,30,11
1746583458540,MATH 142B,A02,890129,Ioana; Adrian,12,0,30,18
1746583459566,MATH 154,A01,890174,Staff,0,1,30,30
1746583459566,MATH 154,A02,890182,Staff,0,0,30,30
1746583460594,MATH 168A,A01,890197,Dumitriu; Ioana,21,0,35,14
1746583461620,MATH 170A,A01,890240,Nie; Jiawang,1,0,30,29
1746583461620,MATH 170A,A02,890241,Nie; Jiawang,11,0,30,19
1746583461620,MATH 170A,A03,890249,Nie; Jiawang,23,0,30,7
1746583462646,MATH 170B,A01,957891,Nag; Panchali,13,0,35,22
1746583464740,MATH 181A,A01,908025,Staff,0,3,35,35
1746583464740,MATH 181A,A02,960115,Staff,26,0,35,9
1746583465766,MATH 181B,A01,959874,Staff,25,0,30,5
1746583466792,MATH 193B,A01,890265,Staff,0,4,35,35
1746583467821,MGT 4,A01,890311,Anderson; John Charles,42,0,88,46
1746583468846,MGT 5,A00,907740,Staff,13,0,98,85
1746583469872,MGT 12,A00,890312,Lindenberger; Wade Douglas,67,0,98,31
1746583470898,MGT 16,A00,957883,Staff,78,0,98,20
1746583472953,MGT 45,A00,890314,Pecore; Joseph P.,45,0,98,53
1746583473987,MGT 71,A00,890315,Staff,0,12,98,98
1746583475011,MGT 100,A00,890316,Yavorsky; Daniel Ryan,44,0,98,54
1746583476038,MGT 103,A00,890317,Ehrich; Kristine R,73,0,98,25
1746583477064,MGT 105,A00,890356,Bates; Kenneth Walter,0,8,98,98
1746583478088,MGT 112,A00,890360,Ehrich; Kristine R,55,0,98,43
1746583479119,MGT 127R,A00,907732,Zhu; Kevin Xiaoguo,23,0,98,75
1746583480144,MGT 131B,A00,890361,Anderson; John Charles,59,0,98,39
1746583481174,MGT 137,A00,890362,Lindenberger; Wade Douglas,65,0,98,33
1746583482204,MGT 160,A00,890369,Johnson; Erik Barry,9,0,98,89
1746583484258,MGT 164,A00,890372,Zimmermann; Carsten,0,40,98,98
1746583485281,MGT 180,A00,890374,Bliss; Barbara Ann,12,0,98,86
1746583486306,MMW 15,A01,886414,Chang; Edmond Yi-Teh,0,12,28,28
1746583486306,MMW 15,A02,886415,Chang; Edmond Yi-Teh,0,8,28,28
1746583486306,MMW 15,A03,886416,Chang; Edmond Yi-Teh,0,9,28,28
1746583486306,MMW 15,A04,886417,Chang; Edmond Yi-Teh,0,8,28,28
1746583486306,MMW 15,B01,886419,Chang; Edmond Yi-Teh,0,7,28,28
1746583486306,MMW 15,B02,886420,Chang; Edmond Yi-Teh,0,8,28,28
1746583486306,MMW 15,B03,886421,Chang; Edmond Yi-Teh,0,7,28,28
1746583486306,MMW 15,B04,886422,Chang; Edmond Yi-Teh,0,8,28,28
1746583486306,MMW 15,C01,886424,Staff,0,9,28,28
1746583486306,MMW 15,C02,886425,Staff,0,8,28,28
1746583486306,MMW 15,C03,886426,Staff,0,8,28,28
1746583486306,MMW 15,C04,886427,Staff,0,8,28,28
1746583486306,MMW 15,C05,958038,Staff,0,8,28,28
1746583486306,MMW 15,C06,958039,Staff,1,8,28,27
1746583487332,MMW 15GS,A00,906910,Patterson; Patrick H.,4,0,28,24
1746583488363,MMW 122R,A01,886429,Rahimi; Babak,0,13,28,28
1746583488363,MMW 122R,A02,886430,Rahimi; Babak,0,12,28,28
1746583488363,MMW 122R,A03,958040,Rahimi; Babak,0,11,28,28
1746583489392,MUS 1A,A01,890937,Staff,2,0,25,23
1746583489392,MUS 1A,A02,891035,Staff,6,0,25,19
1746583489392,MUS 1A,C01,958912,Staff,24,0,25,1
1746583489392,MUS 1A,C02,958913,Staff,25,0,25,0
1746583491445,MUS 2AK,A00,957092,Ohnishi; Takae,15,0,15,0
1746583492474,MUS 4,A01,891044,Staff,1,0,25,24
1746583492474,MUS 4,A02,891045,Staff,23,0,25,2
1746583492474,MUS 4,B01,891048,Staff,17,0,25,8
1746583492474,MUS 4,B02,891050,Staff,25,0,25,0
1746583493499,MUS 5,A01,957506,Dubnov; Shlomo,0,0,25,25
1746583493499,MUS 5,A02,957622,Dubnov; Shlomo,13,0,25,12
1746583493499,MUS 5,A03,957623,Dubnov; Shlomo,20,0,25,5
1746583494528,MUS 6,A01,891053,Freitas Caetano; Marcelo,24,0,25,1
1746583494528,MUS 6,A02,891054,Freitas Caetano; Marcelo,23,0,25,2
1746583495555,MUS 7,A01,891081,Staff,0,0,25,25
1746583495555,MUS 7,A02,891082,Staff,3,0,25,22
1746583496583,MUS 8GS,A00,891118,Borgo; David Garcia,1,0,25,24
1746583497608,MUS 11,A01,891140,Staff,9,0,25,16
1746583497608,MUS 11,A02,891141,Staff,21,0,25,4
1746583498653,MUS 13,A01,891143,Staff,8,0,25,17
1746583498653,MUS 13,A02,891144,Staff,24,0,25,1
1746583499677,MUS 15,A01,891146,Staff,9,0,25,16
1746583499677,MUS 15,A02,891148,Staff,21,0,25,4
1746583499677,MUS 15,B01,891150,Staff,18,0,25,7
1746583499677,MUS 15,B02,891151,Staff,25,0,25,0
1746583500905,MUS 20,A01,891153,Staff,5,0,20,15
1746583500905,MUS 20,A02,891155,Staff,14,0,20,6
1746583501930,MUS 80,A00,891156,Staff,19,0,25,6
1746583501930,MUS 80,B00,891157,Staff,23,0,25,2
1746583502961,MUS 130,A00,891158,Ohnishi; Takae,35,0,35,0
1746583503986,MUS 150GS,A01,891160,Borgo; David Garcia,1,0,25,24
1746583505014,MUS 170,A01,891162,Freitas Caetano; Marcelo,20,0,25,5
1746583505014,MUS 170,A02,891164,Freitas Caetano; Marcelo,21,0,25,4
1746583506047,NANO 11,A00,886220,Vazquez Mena; Oscar,13,0,15,2
1746583507076,NANO 15,A01,886222,Drews; Aaron,4,0,7,3
1746583508101,NANO 104,A00,886224,Sirbuly; Donald,17,0,25,8
1746583509127,PH 40,A00,886528,Staff,24,0,40,16
1746583510152,PH 45,A01,886799,Staff,35,0,40,5
1746583511182,PH 110,A00,886802,Staff,0,7,40,40
1746583512208,PH 172,A00,906716,Staff,19,0,35,16
1746583513237,PH 191,A00,886803,Staff,6,0,40,34
1746583514266,PHIL 1,A00,889500,Staff,20,0,30,10
1746583515291,PHIL 10,A01,889549,Grush; Rick Scott,16,0,22,6
1746583515291,PHIL 10,A02,889551,Grush; Rick Scott,22,0,22,0
1746583516359,PHIL 28,A01,889559,Lamey; Andy M.,0,2,31,31
1746583516359,PHIL 28,A02,889561,Lamey; Andy M.,0,1,30,30
1746583516359,PHIL 28,A03,889572,Lamey; Andy M.,0,1,30,30
1746583517388,PHIL 35,A00,907839,Staff,13,0,15,2
1746583518414,PHIL 60,A00,889574,Staff,73,0,90,17
1746583519438,PHIL 101,A00,958004,Staff,12,0,15,3
1746583521494,PHIL 136,A00,889582,Fulkerson; Matthew Todd,26,0,45,19
1746583522518,PHIL 163,A01,889601,Staff,21,0,30,9
1746583522518,PHIL 163,B01,889606,Brandt; Reuven A,0,3,0,0
1746583523544,PHIL 164,A00,889610,Staff,16,0,30,14
1746583524612,PHIL 165,A00,889613,Staff,22,0,30,8
1746583525638,PHYS 1A,A00,886431,Staff,29,0,70,41
1746583526663,PHYS 1AL,001,886432,Tsai; Philbert S,1,2,30,29
1746583526663,PHYS 1AL,002,886436,Tsai; Philbert S,12,0,30,18
1746583527692,PHYS 1B,A00,886439,Staff,184,0,240,56
1746583528722,PHYS 1BL,001,886441,Tsai; Philbert S,0,4,30,30
1746583528722,PHYS 1BL,002,886444,Tsai; Philbert S,2,0,30,28
1746583529751,PHYS 1C,A00,896092,Arnold; Kam S,78,0,146,68
1746583530777,PHYS 1CL,001,886448,Tsai; Philbert S,0,0,30,30
1746583530777,PHYS 1CL,002,886449,Tsai; Philbert S,1,0,30,29
1746583530777,PHYS 1CL,003,886450,Tsai; Philbert S,16,0,30,14
1746583530777,PHYS 1CL,004,886451,Tsai; Philbert S,15,0,30,15
1746583531808,PHYS 2B,A01,886457,Staff,67,0,115,48
1746583532833,PHYS 2C,A01,886460,Shotwell; Brian,0,9,65,65
1746583533857,PHYS 2CL,A01,886467,Staff,0,4,28,28
1746583533857,PHYS 2CL,A02,886468,Staff,0,3,28,28
1746583534887,PHYS 2D,A01,886470,Staff,10,0,50,40
1746583535912,PHYS 4B,A01,886475,Grinstein; Benjamin,22,0,40,18
1746583536940,POLI 5,A00,891173,Desposato; Scott,7,0,25,18
1746583537966,POLI 5D,A01,891175,Staff,5,0,5,0
1746583537966,POLI 5D,B01,891178,Staff,5,0,5,0
1746583538991,POLI 11,A00,891179,Ferree; Karen E,2,0,35,33
1746583540018,POLI 12,A00,891180,Staff,16,0,30,14
1746583541048,POLI 27,A01,891182,Staff,12,0,75,63
1746583542073,POLI 30,A00,891183,Staff,8,0,50,42
1746583543101,POLI 100B,A00,891244,Staff,5,1,35,30
1746583544125,POLI 100I,A00,891247,Staff,7,0,30,23
1746583545151,POLI 104J,A00,891248,Nichter; Maysa,14,0,30,16
1746583546181,POLI 104U,A00,891250,Nichter; Maysa,1,0,30,29
1746583548234,POLI 110B,A00,891255,Wiens; David,19,0,25,6
1746583549261,POLI 112A,A00,891256,Wiens; David,6,0,25,19
1746583550286,POLI 114BR,A00,891261,Staff,19,0,30,11
1746583551313,POLI 117R,A00,891262,Forman; Fonna,0,6,50,50
1746583552336,POLI 118,A00,891264,Ingham; Sean,17,0,25,8
1746583553364,POLI 124A,A00,891265,Staff,18,0,20,2
1746583554419,POLI 125D,A00,891266,Nichter; Simeon C,2,0,25,23
1746583555446,POLI 126,A00,891268,Nichter; Simeon C,7,0,25,18
1746583556471,POLI 126AA,A00,891272,Staff,15,0,25,10
1746583557497,POLI 130AA,A00,891273,Staff,15,0,20,5
1746583558526,POLI 134AA,A00,891274,Staff,4,0,20,16
1746583560579,POLI 138,A00,891278,Staff,21,0,25,4
1746583561605,POLI 142K,A00,891280,Staff,10,0,25,15
1746583562633,POLI 142M,A00,891281,Gartzke; Erik,16,0,30,14
1746583563658,POLI 142P,A00,891284,Staff,20,0,30,10
1746583564682,POLI 143,A00,891285,Gartzke; Erik,12,0,30,18
1746583565709,POLI 153,A00,891286,Staff,19,0,20,1
1746583567764,POLI 175,A00,891290,Staff,15,0,20,5
1746583568791,PSYC 1,A00,890674,Steiner; Eric Tomas,0,11,45,45
1746583569820,PSYC 2,A00,890676,Albright; Thomas D,20,0,35,15
1746583570846,PSYC 3,A00,890679,Staff,17,0,20,3
1746583571872,PSYC 6,A00,959858,Staff,19,0,20,1
1746583572901,PSYC 60,A01,890684,Rickard; Timothy C.,0,5,45,45
1746583573928,PSYC 70,A01,890689,Geller; Emma Harlan,6,0,30,24
1746583574957,PSYC 71,A01,959860,Staff,21,0,25,4
1746583575986,PSYC 100,A00,890690,Lacefield; Katharine I,0,50,180,180
1746583577013,PSYC 102,A00,890695,Staff,18,0,40,22
1746583578037,PSYC 105,A00,890699,Geller; Emma Harlan,70,0,100,30
1746583579062,PSYC 106,A00,890701,Gorman; Michael R.,5,0,30,25
1746583580088,PSYC 108,A00,890704,Adrian; Julia Anna,0,28,50,50
1746583581115,PSYC 118,A01,890712,Staff,11,0,30,19
1746583582139,PSYC 124,A00,890716,Chapman; Eddie Nathaniel,25,0,60,35
1746583583165,PSYC 131,A00,890717,Anagnostaras; Stephan,0,7,80,80
1746583584194,PSYC 137,A00,890719,Winkielman; Piotr,0,11,30,30
1746583585220,PSYC 144,A00,890721,Adrian; Julia Anna,0,9,45,45
1746583586247,PSYC 162,A00,890805,Staff,0,0,75,75
1746583587272,PSYC 169,A00,890810,Staff,0,14,30,30
1746583588297,PSYC 172,A00,890814,Gorman; Michael R.,9,0,30,21
1746583589325,PSYC 181,A00,890818,Anagnostaras; Stephan,7,0,200,193
1746583590349,PSYC 184,A00,959861,Staff,164,0,175,11
1746583591377,PSYC 189,A00,890823,Staff,0,2,30,30
1746583592411,PSYC 191,A00,890884,Rickard; Timothy C.,0,12,35,35
1746583593435,PSYC 193,A00,890913,Staff,19,0,30,11
1746583593435,PSYC 193,B00,890914,Chapman; Eddie Nathaniel,24,0,30,6
1746583594464,PSYC 193L,A01,890918,Lowe; Angela Beth,20,0,30,10
1746583594464,PSYC 193L,B01,890921,Hurwitz; Ethan Scott,20,0,30,10
1746583594464,PSYC 193L,C01,890928,Staff,30,0,30,0
1746583595494,RELI 149,A00,886806,Rahimi; Babak,23,0,40,17
1746583596520,SE 9,A01,886814,Staff,7,0,20,13
1746583597544,SE 101B,A01,886816,Chadha; Mayank,4,0,35,31
1746583598574,SE 110B,A00,886818,Zhu; Qiang,4,0,75,71
1746583599601,SE 125,A01,886830,Staff,10,0,30,20
1746583600629,SE 130B,A01,886835,Staff,14,0,40,26
1746583601655,SE 131A,A01,886838,Krysl; Petr,34,0,55,21
1746583602681,SE 154,A00,886840,Staff,28,0,50,22
1746583603706,SE 164GS,A01,886849,Staff,6,0,20,14
1746583604733,SE 167GS,A01,886853,Staff,6,0,20,14
1746583605763,SIO 25,A01,890107,Staff,19,0,30,11
1746583606787,SIO 45,A00,890109,Cook; Geoffrey W,116,0,200,84
1746583607816,SIO 109R,A00,890110,Forman; Fonna,0,16,20,20
1746583608844,SIO 187,A01,890114,Kacev; David,15,0,40,25
1746583609872,SOCI 1,A01,890431,Thorpe; Charles Robert,14,0,30,16
1746583609872,SOCI 1,A02,890518,Thorpe; Charles Robert,30,0,30,0
1746583610895,SOCI 2,A01,957978,Staff,25,0,25,0
1746583610895,SOCI 2,A02,957979,Staff,23,0,25,2
1746583611922,SOCI 20,A01,890523,Calderon-Zaks; Michael Aar,21,0,30,9
1746583611922,SOCI 20,A02,890526,Calderon-Zaks; Michael Aar,29,0,30,1
1746583612951,SOCI 30,A01,890533,Pardo Guerra; Juan Pablo,37,0,40,3
1746583613976,SOCI 40,A01,890535,Staff,27,0,45,18
1746583615001,SOCI 104Q,A00,890559,Staff,18,0,30,12
1746583616026,SOCI 106,A00,890560,Arnal; Maud Marie Leonie,20,0,30,10
1746583617052,SOCI 110,A00,890567,Holkenbrink-Monk; Charlene,19,0,30,11
1746583618077,SOCI 112,A00,890568,Victoria Torres; Pablo,2,0,55,53
1746583619102,SOCI 115,A00,890597,Arnal; Maud Marie Leonie,28,0,45,17
1746583621193,SOCI 121,A00,890604,Pardo Guerra; Juan Pablo,38,0,45,7
1746583622220,SOCI 126,A01,890608,Staff,8,0,10,2
1746583623247,SOCI 127,A00,890609,Staff,18,0,30,12
1746583624276,SOCI 131,A00,890610,Thorpe; Charles Robert,37,0,45,8
1746583625306,SOCI 135,A00,890615,Payne; Christine Anna,13,0,45,32
1746583626329,SOCI 139,A00,890620,Staff,38,0,45,7
1746583627357,SOCI 148E,A00,890622,Calderon-Zaks; Michael Aar,36,0,45,9
1746583628386,SOCI 150,A00,890623,Kohler; Kristopher M.,31,0,45,14
1746583629411,SOCI 157,A00,890625,Jules-Rosette; Bennetta W.,18,0,20,2
1746583630439,SOCI 160,A00,890627,Payne; Christine Anna,21,0,45,24
1746583631465,SYN 1,A00,886855,Fish; Gwendolyn Anne,0,1,0,0
1746583631465,SYN 1,B00,906086,Fish; Gwendolyn Anne,0,2,0,2
1746583632494,SYN 2R,A00,886860,Staff,0,17,15,15
1746583632494,SYN 2R,B00,906106,Atkinson; Arthur Laird,0,16,15,15
1746583633527,SYN 100,A01,886866,Browne; Emily,0,28,20,20
1746583633527,SYN 100,B01,906128,Rock; Martin,0,4,20,20
1746583633527,SYN 100,C01,906140,Deavenport; James Cary,0,3,20,20
1746583633527,SYN 100,D01,907816,Deavenport; James Cary,0,5,20,20
1746583634551,TDAC 1,A00,890286,Walsh; Kim C.,7,0,20,13
1746583635576,TDAC 101,A00,890296,Basso; Beatrice,15,0,20,5
1746583636605,TDDE 131,A00,890297,Staff,47,0,50,3
1746583637630,TDDM 1,A00,890287,Weinberg; Sadie,25,0,30,5
1746583638654,TDGE 11,A00,890288,Fulton; Julia,138,0,200,62
1746583638654,TDGE 11,B00,890289,Castro; Robert Jess,184,0,200,16
1746583639690,TDGE 25,B00,957359,Walsh; Kim C.,5,0,20,15
1746583640717,TDGE 40,A01,890292,Power; Jade Yukana,27,0,30,3
1746583641744,TDGE 124,A00,890298,Havis; Allan,0,1,50,50
1746583642774,TDGE 131R,A00,890299,Burelle; Julie Sara Veronique,15,0,42,27
1746583643799,TDHT 101,A00,890300,Staff,10,0,20,10
1746583644831,TDHT 109,A01,890302,Anderson; Mysia Anyse,31,0,40,9
1746583645855,TDMV 1,A00,890293,Arcidiacono; Kristin,18,0,30,12
1746583646881,TDMV 2,A00,890294,Weinberg; Sadie,23,0,30,7
1746583647909,TDMV 3,A00,957878,Arcidiacono; Kristin,28,0,30,2
1746583649966,TDMV 138,A00,890304,Jun; Grace Shin Hae,25,0,40,15
1746583650994,TDMV 140,A00,890305,Corrales; Joseph Bernales,25,0,30,5
1746583652021,TDMV 142,A00,890307,Caligagan; Tony,32,0,40,8
1746583653046,TDMV 144,A00,890308,Camaya; Michelle Ann,25,0,30,5
1746583654070,TDPW 1,A00,890295,Stein; Deborah Isobel,3,0,20,17
1746583655101,USP 2,A01,890272,Lerner; Amy M,7,0,20,13
1746583656130,USP 3,A01,890274,Staff,12,0,30,18
1746583657155,USP 15,A01,890276,Sun; Feiyang,16,0,30,14
1746583658181,USP 25,A00,890277,Shenkman; Michael Thomas,18,0,25,7
1746583659206,USP 138,A00,890278,Staff,13,0,25,12
1746583660234,USP 143,A00,890279,Staff,22,0,70,48
1746583661261,USP 144,A00,890280,Chowdhury; Muhammed Zohir,16,0,30,14
1746583662290,USP 150,A00,890281,Boomhower; Matthew Charles,4,0,30,26
1746583663316,USP 151,A00,890282,Staff,16,0,20,4
1746583664344,USP 162,A00,890283,Andrews; Abigail Leslie,16,0,20,4
1746583665369,USP 168,A00,920477,Kwak; Nancy,0,0,5,5
1746583666393,USP 181,A00,890284,Staff,3,0,20,17
1746583667418,USP 191A,A00,890285,Staff,12,0,20,8
1746583668444,VIS 101,A00,886512,Staff,26,0,75,49
1746583669469,VIS 103,A00,886513,Cruz; Edwin Teddy,61,0,75,14
1746583670493,VIS 108,A00,886514,Staff,3,0,15,12
1746583671521,VIS 127P,A00,886515,Shen; Kuiyi,79,0,146,67
1746583672546,VIS 149,A00,886516,Yoldas; Pinar,0,0,15,15
1746583673572,VIS 164,A00,886526,Erdmann; Dean,19,0,22,3
1746583674596,VIS 194S,A00,886527,Staff,61,0,75,14
1746583675626,WCWP 10A,C00,886484,Martiniuk; Jill,12,0,15,3
1746583676652,WCWP 10B,A00,886490,Uriarte; Emma,0,0,15,15
1746583676652,WCWP 10B,B00,886491,Dhir; Simrita,8,0,15,7
1746583676652,WCWP 10B,C00,886492,Ornelas; Tricia,0,0,15,15
1746583677681,WCWP 100,A00,886494,Young; Mark T,0,6,15,15
1746583679755,AAS 10,A01,886199,Childs; Dennis R.,0,3,0,0
1746583680779,ANAR 104,A01,886940,Shtienberg; Gilad,27,0,30,3
1746583681807,ANAR 120,A00,886953,Staff,13,0,20,7
1746583682832,ANBI 148,A01,886955,Wilder; Linnea Lorene,30,0,40,10
1746583684882,ANSC 122,A00,886957,Staff,24,0,30,6
1746583685909,ANSC 150,A00,886958,Sloane; Julia Kathryn,2,0,15,13
1746583686934,ANSC 156,A00,886959,Jenkins; Janis A.,0,1,15,15
1746583687959,ANSC 180,A00,886960,Staff,11,0,17,6
1746583688984,ANSC 188,A00,886961,Jassal; Aftab,9,0,25,16
1746583690017,ANSC 190,A00,886962,Jassal; Aftab,14,0,25,11
1746583691044,ANSC 191,A00,886963,Staff,18,0,20,2
1746583692069,ANTH 3,A01,891689,Staff,17,0,20,3
1746583693095,ANTH 5,A00,886933,Semendeferi; Ekaterini,16,0,20,4
1746583694124,ANTH 10,A00,886934,Staff,0,12,30,30
1746583695152,ANTH 21,A01,886936,Staff,41,0,60,19
1746583696176,ANTH 23,A01,886938,Staff,92,0,100,8
1746583697205,ANTH 105,A00,886964,Stewart; Alexander B,84,0,100,16
1746583698232,ANTH 108,A00,886965,Pedersen; David,9,0,20,11
1746583699265,AWP 10,001,886147,Staff,0,0,0,0
1746583699265,AWP 10,002,886148,Staff,0,0,0,0
1746583699265,AWP 10,003,886149,Staff,0,0,0,0
1746583699265,AWP 10,004,886150,Staff,0,0,0,0
1746583699265,AWP 10,005,886151,Staff,0,0,0,0
1746583699265,AWP 10,006,886152,Staff,0,0,0,0
1746583699265,AWP 10,007,886153,Staff,0,0,0,0
1746583699265,AWP 10,008,886154,Staff,0,0,0,0
1746583699265,AWP 10,009,886155,Staff,0,0,0,0
1746583699265,AWP 10,010,886156,Staff,0,0,0,0
1746583699265,AWP 10,011,886158,Staff,0,0,0,0
1746583699265,AWP 10,012,886160,Staff,0,0,0,0
1746583699265,AWP 10,013,886161,Staff,0,0,0,0
1746583699265,AWP 10,014,886162,Staff,0,0,0,0
1746583699265,AWP 10,015,886163,Staff,0,0,0,0
1746583699265,AWP 10,016,886164,Staff,0,0,0,0
1746583699265,AWP 10,017,886165,Staff,0,0,0,0
1746583699265,AWP 10,018,886166,Staff,0,0,0,0
1746583699265,AWP 10,019,886168,Staff,0,0,0,0
1746583699265,AWP 10,020,886170,Staff,0,0,0,0
1746583699265,AWP 10,021,886172,Staff,0,0,0,0
1746583700293,AWP 10R,001,886173,Staff,0,1,0,0
1746583700293,AWP 10R,002,886174,Staff,0,1,0,0
1746583700293,AWP 10R,003,886175,Staff,0,0,0,0
1746583700293,AWP 10R,004,886176,Staff,0,0,0,0
1746583700293,AWP 10R,005,886177,Staff,0,0,0,0
1746583700293,AWP 10R,006,886178,Staff,0,0,0,0
1746583700293,AWP 10R,007,886179,Staff,0,0,0,0
1746583700293,AWP 10R,008,886181,Staff,0,0,0,0
1746583700293,AWP 10R,009,886182,Staff,0,0,0,0
1746583700293,AWP 10R,010,886183,Staff,0,0,0,0
1746583700293,AWP 10R,011,886184,Staff,0,0,0,0
1746583700293,AWP 10R,012,886185,Staff,0,0,0,0
1746583700293,AWP 10R,013,886186,Staff,0,0,0,0
1746583700293,AWP 10R,014,886187,Staff,0,0,0,0
1746583700293,AWP 10R,015,886188,Staff,0,0,0,0
1746583700293,AWP 10R,016,886189,Staff,0,0,0,0
1746583700293,AWP 10R,017,960532,Staff,0,0,0,0
1746583700293,AWP 10R,018,960533,Staff,0,0,0,0
1746583700293,AWP 10R,019,960534,Staff,0,0,0,0
1746583700293,AWP 10R,020,960538,Staff,0,0,0,0
1746583700293,AWP 10R,021,960540,Staff,0,0,0,0
1746583700293,AWP 10R,022,960541,Staff,0,0,0,0
1746583700293,AWP 10R,023,960542,Staff,0,0,0,0
1746583700293,AWP 10R,024,960544,Staff,0,0,0,0
1746583700293,AWP 10R,025,960545,Staff,0,0,0,0
1746583700293,AWP 10R,026,960548,Staff,0,0,0,0
1746583701321,AWP 102R,A00,886190,Staff,0,0,0,0
1746583701321,AWP 102R,B00,886191,Staff,0,0,0,0
1746583702345,BENG 100,A01,886193,Staff,17,0,30,13
1746583703369,BENG 122A,A01,886195,Hasty; Jeff M,13,0,30,17
1746583704397,BENG 166A,A00,886196,Sah; Robert Lie-Yuan,0,3,30,30
1746583705428,BENG 190,A00,958050,Khojah; Reem I,17,0,25,8
1746583706452,BIBC 102,A01,894320,Staff,0,0,46,46
1746583706452,BIBC 102,A02,894321,Staff,0,0,46,46
1746583706452,BIBC 102,A03,894344,Staff,6,0,46,40
1746583706452,BIBC 102,A04,894345,Staff,27,0,47,20
1746583707478,BICD 100R,A01,894365,Smith; Laurie,0,3,58,58
1746583707478,BICD 100R,A02,894366,Smith; Laurie,0,5,58,58
1746583707478,BICD 100R,A03,894367,Smith; Laurie,0,0,59,59
1746583707478,BICD 100R,A04,959869,Smith; Laurie,40,0,59,19
1746583708508,BICD 136,A01,894383,Gustafson-Brown; Cindy,14,0,50,36
1746583709537,BIEB 102,A01,894494,Butler; Shannon Rhey,51,0,130,79
1746583711589,BIEB 150,A01,894617,Wills; Christopher,3,0,20,17
1746583711589,BIEB 150,A02,894631,Wills; Christopher,3,0,20,17
1746583711589,BIEB 150,A03,894937,Wills; Christopher,3,0,20,17
1746583711589,BIEB 150,A04,894946,Wills; Christopher,5,0,20,15
1746583712617,BIEB 194,A00,906141,Kurle; Carolyn M.,5,0,20,15
1746583713643,BILD 1,A01,894154,Staff,3,0,19,16
1746583713643,BILD 1,A02,894155,Staff,14,0,19,5
1746583713643,BILD 1,A03,894160,Staff,13,0,19,6
1746583713643,BILD 1,A04,894161,Staff,15,0,18,3
1746583714672,BILD 2,A01,894168,Staff,0,0,50,50
1746583714672,BILD 2,A02,894169,Staff,0,0,50,50
1746583714672,BILD 2,A03,894179,Staff,0,0,50,50
1746583714672,BILD 2,A04,894203,Staff,24,0,50,26
1746583715702,BILD 3,A01,894213,Staff,23,0,31,8
1746583715702,BILD 3,A02,894214,Staff,26,0,31,5
1746583715702,BILD 3,A03,894235,Staff,28,0,31,3
1746583715702,BILD 3,A04,894236,Staff,28,0,32,4
1746583716726,BILD 4,A01,894253,Reuther; Keefe,5,0,24,19
1746583716726,BILD 4,A02,894258,Reuther; Keefe,16,0,24,8
1746583717753,BILD 5,A01,894276,Reuther; Keefe,35,0,50,15
1746583717753,BILD 5,A02,894277,Reuther; Keefe,45,0,50,5
1746583717753,BILD 5,A03,894290,Reuther; Keefe,44,0,50,6
1746583717753,BILD 5,A04,894291,Reuther; Keefe,48,0,50,2
1746583718778,BILD 24,A01,894297,Pirino; Giorgia,40,0,60,20
1746583719805,BIMM 100,B01,958915,Staff,71,0,100,29
1746583720834,BIMM 101,A01,895017,McDonnell; Lisa Marie,0,5,24,24
1746583720834,BIMM 101,A02,895018,McDonnell; Lisa Marie,0,5,24,24
1746583720834,BIMM 101,B01,895020,McDonnell; Lisa Marie,0,6,24,24
1746583720834,BIMM 101,B02,895021,McDonnell; Lisa Marie,0,4,24,24
1746583721863,BIMM 110,A01,895023,Staff,1,0,25,24
1746583721863,BIMM 110,A02,895024,Staff,9,0,25,16
1746583721863,BIMM 110,A03,895025,Staff,18,0,25,7
1746583721863,BIMM 110,A04,895031,Staff,20,0,25,5
1746583722889,BIMM 120,A01,895114,Gustafson-Brown; Cindy,14,0,28,14
1746583722889,BIMM 120,A02,895126,Gustafson-Brown; Cindy,21,0,27,6
1746583723971,BIPN 100,A01,895130,Yang; Mingyu,0,0,38,38
1746583723971,BIPN 100,A02,895131,Yang; Mingyu,31,0,38,7
1746583723971,BIPN 100,A03,895132,Yang; Mingyu,32,0,38,6
1746583723971,BIPN 100,A04,895133,Yang; Mingyu,27,0,36,9
1746583725000,BIPN 120,A01,895135,Cooke; James Edward,0,3,13,13
1746583725000,BIPN 120,A02,895136,Cooke; James Edward,0,1,13,13
1746583725000,BIPN 120,A03,895137,Cooke; James Edward,0,3,13,13
1746583725000,BIPN 120,A04,895156,Cooke; James Edward,0,2,11,11
1746583726025,BIPN 134,A01,895235,Cooke; James Edward,0,2,25,25
1746583726025,BIPN 134,A02,895237,Cooke; James Edward,0,0,25,25
1746583726025,BIPN 134,A03,895240,Cooke; James Edward,3,0,25,22
1746583726025,BIPN 134,A04,895270,Cooke; James Edward,20,0,25,5
1746583727051,BIPN 189,A00,892103,Staff,0,14,14,14
1746583729106,BISP 194,A00,958008,Staff,0,2,0,0
1746583730135,CAT 124,A01,922009,Staff,0,5,20,20
1746583731162,CAT 125R,A00,886390,Morales; Celeste Georgianna,0,2,20,20
1746583731162,CAT 125R,B00,886391,Irwin; Matthew Joseph,0,4,20,20
1746583731162,CAT 125R,C00,886392,Smith; Lauryn Alissa,0,2,20,20
1746583731162,CAT 125R,D00,886393,Vanderschuit; Maya Alysia,0,3,20,20
1746583731162,CAT 125R,E00,886394,Marchisotto; Jennifer Anne,0,3,20,20
1746583732186,CENG 15,A01,886218,Drews; Aaron,3,0,8,5
1746583733212,CENG 113,A00,886219,Opatkiewicz; Justin Paul,15,0,25,10
1746583734239,CGS 101,A00,887044,Staff,7,0,20,13
1746583735267,CGS 105,A01,887046,Staff,14,0,25,11
1746583736291,CGS 112,A00,887047,Cuong; Marisol,12,0,15,3
1746583737316,CGS 113,A00,887048,Staff,23,0,30,7
1746583738342,CGS 120,A00,887049,Staff,10,0,17,7
1746583739372,CHEM 6A,A01,886336,Lam; Tin Yiu,38,0,50,12
1746583739372,CHEM 6A,A02,886338,Lam; Tin Yiu,37,0,50,13
1746583740398,CHEM 6B,A01,886341,Hopkins; Patrycja Anna,16,0,50,34
1746583740398,CHEM 6B,A02,886343,Hopkins; Patrycja Anna,42,0,50,8
1746583741423,CHEM 6C,A01,886346,Albizati; Kim F.,0,2,50,50
1746583741423,CHEM 6C,A02,886348,Albizati; Kim F.,24,0,50,26
1746583742450,CHEM 40A,A01,886352,Klosterman; Jeremy K,65,0,100,35
1746583743477,CHEM 40B,A01,886356,Klosterman; Jeremy K,0,24,100,100
1746583744514,CHEM 41B,A01,886360,Theodorakis; Emmanuel,25,0,50,25
1746583744514,CHEM 41B,A02,886362,Theodorakis; Emmanuel,47,0,50,3
1746583745543,CHIN 165A,A00,886382,Xu; Li,18,0,20,2
1746583746572,CLAS 120,A00,886387,Myerston Santana; Jacobo,33,0,40,7
1746583747599,COGS 9,A01,886967,Shannon; Kyle Michael,42,0,60,18
1746583748624,COGS 11,A01,886969,Staff,9,0,30,21
1746583749651,COGS 14A,A01,886971,Staff,6,0,60,54
1746583750678,COGS 14B,A01,886973,Hoffman; Drew Ellen,4,0,60,56
1746583751709,COGS 18,A01,886975,Morgan; Eric,35,0,60,25
1746583752736,COGS 20,A01,886977,Staff,4,0,8,4
1746583752736,COGS 20,A02,886978,Staff,5,0,7,2
1746583753764,COGS 100,A01,907783,Staff,1,2,30,29
1746583754793,COGS 101B,A01,886980,Staff,0,4,48,48
1746583755821,COGS 101C,A01,886982,Delgado; Tania,0,5,44,44
1746583756848,COGS 102A,A01,886984,Johnson; Christine M.,3,0,30,27
1746583757877,COGS 118B,A01,886986,Staff,1,4,88,87
1746583758902,COGS 150,A01,886988,Bergen; Benjamin,22,0,50,28
1746583759927,COGS 153,A00,886989,Delgado; Tania,0,3,41,41
1746583760953,COGS 186,A01,886991,Staff,0,0,32,32
1746583761978,COGS 187A,A01,886993,Boyle; Mary E. T.,7,0,30,23
1746583763004,COGS 189,A00,886994,Staff,0,1,30,30
1746583764031,COMM 10,A01,886996,Staff,0,0,20,21
1746583764031,COMM 10,A02,886997,Staff,10,0,20,10
1746583764031,COMM 10,A03,959845,Staff,19,0,20,1
1746583765054,COMM 20,A01,886999,Leuning; Grant Maurstad,24,0,40,16
1746583767104,COMM 100A,A01,887002,Staff,0,0,20,25
1746583767104,COMM 100A,A02,887003,Staff,6,0,20,14
1746583768129,COMM 100B,A01,887005,Staff,0,8,20,24
1746583769155,COMM 106D,A00,887006,Staff,13,0,40,27
1746583770179,COMM 110G,A00,887007,Whitworth-Smith; Andrew C,12,0,40,28
1746583771202,COMM 111B,A00,887008,Staff,31,0,40,9
1746583772228,COMM 113T,A00,887009,Abuelhiga; Soraya Jill,28,0,40,12
1746583772228,COMM 113T,B00,906733,Staff,40,0,40,0
1746583773255,COMM 145,A00,887010,Staff,12,0,40,28
1746583774280,COMM 146,A00,887054,Staff,31,0,40,9
1746583775309,COMM 190,A00,887012,Staff,8,0,23,15
1746583776337,CSE 8A,A50,887015,Cao; Yingjun,57,0,85,28
1746583777365,CSE 11,A01,887017,Cao; Yingjun,12,0,70,58
1746583778393,CSE 20,A01,887019,Staff,30,0,50,20
1746583779423,CSE 21,A01,887021,Staff,78,0,100,22
1746583779423,CSE 21,B01,892583,Braun; Oliver,45,0,50,5
1746583780448,CSE 30,A01,887025,Eldon; John,142,0,200,58
1746583781473,CSE 100,A01,887027,Staff,26,0,50,24
1746583781473,CSE 100,A02,887028,Staff,42,0,50,8
1746583782500,CSE 101,A01,887030,Braun; Oliver,74,0,100,26
1746583782500,CSE 101,B01,887032,Jones; Miles E,0,3,50,50
1746583782500,CSE 101,B02,887033,Jones; Miles E,0,2,50,50
1746583783524,CSE 105,A01,908084,Jones; Miles E,32,0,50,18
1746583783524,CSE 105,A02,908087,Jones; Miles E,31,0,50,19
1746583784552,CSE 135,A01,887035,Powell; Thomas Allan,0,5,50,50
1746583785577,CSE 142,A01,887037,Staff,8,0,60,52
1746583786603,CSE 142L,A01,887039,Staff,34,0,60,26
1746583787627,CSE 151A,A01,887041,Solares; Edwin A,47,0,100,53
1746583788650,CSE 175,A01,887043,Kumar; Rakesh,30,0,30,0
1746583789678,CSS 1,A01,886389,Staff,1,2,40,39
1746583790707,DSC 30,A01,908097,Liao; Soohyun Nam,47,0,75,28
1746583791732,DSC 40A,A01,908099,Shannon; Kyle Michael,30,0,50,20
1746583792758,DSC 40B,A01,908112,Staff,15,0,50,35
1746583793785,DSC 80,A01,908116,Staff,19,0,60,41
1746583794812,DSC 197,001,956863,Eldridge; Justin Matthew,9999,0,9999,0
1746583795838,ECE 5,A01,886400,Morris; Karcher William,1,0,6,5
1746583795838,ECE 5,A02,886401,Morris; Karcher William,3,0,6,3
1746583796861,ECE 148,A01,886403,Silberman; Jack,0,14,14,14
1746583797888,ECON 1,A01,887265,Crane; Meredith Helen,12,0,70,58
1746583797888,ECON 1,B01,887268,Staff,42,0,50,8
1746583798912,ECON 2,A01,887273,Crane; Meredith Helen,55,0,70,15
1746583799937,ECON 3,A01,887279,Rondina; Giacomo,32,0,70,38
1746583800964,ECON 4,A01,887282,Anderson; John Charles,0,2,10,10
1746583801993,ECON 5,A01,887285,Staff,34,0,45,11
1746583801993,ECON 5,B01,887292,Staff,41,0,45,4
1746583803017,ECON 100A,A01,887337,Newhouse; Herbert S,54,0,70,16
1746583803017,ECON 100A,B01,887349,Staff,45,0,50,5
1746583804047,ECON 100B,A01,887361,Du; Songzi,29,0,70,41
1746583805074,ECON 100C,A01,887445,Newhouse; Herbert S,59,0,70,11
1746583806102,ECON 105,A00,887488,Vespa; Emanuel Ignacio,23,0,35,12
1746583807127,ECON 109,A01,887506,Shishkin; Denis,28,0,35,7
1746583808151,ECON 110A,A01,887568,Alon; Titan Michael,0,3,35,35
1746583808151,ECON 110A,B01,907601,Alon; Titan Michael,20,0,35,15
1746583809177,ECON 110B,A01,887598,Levkoff; Steven B.,0,24,70,70
1746583810201,ECON 112,A00,887599,Rondina; Giacomo,19,0,35,16
1746583811228,ECON 120A,A01,887603,Dai; Yinlin,35,0,70,35
1746583812255,ECON 120C,A01,887608,Sun; Yixiao,0,1,35,35
1746583812255,ECON 120C,B01,887614,Sun; Yixiao,0,0,35,35
1746583813283,ECON 138,A00,887621,Bharadwaj; Prashant,0,21,20,20
1746583814311,ECON 144,A00,958007,Squires; Dale E,12,0,35,23
1746583815339,ECON 171,A01,907666,Staff,18,0,35,17
1746583816366,ECON 175,A00,887626,Wu; Pak Yeung,22,0,35,13
1746583817395,ECON 190,A00,887640,Vespa; Emanuel Ignacio,22,0,35,13
1746583818423,EDS 25,A01,888197,Staff,0,0,0,0
1746583818423,EDS 25,A02,888209,Staff,0,0,0,0
1746583818423,EDS 25,A03,888210,Staff,0,0,0,0
1746583818423,EDS 25,A04,888212,Staff,0,0,0,0
1746583818423,EDS 25,A05,888213,Staff,0,0,0,0
1746583818423,EDS 25,A06,888214,Staff,0,0,0,0
1746583818423,EDS 25,A07,888235,Staff,0,2,0,0
1746583818423,EDS 25,A08,888236,Staff,0,0,0,0
1746583818423,EDS 25,A09,888240,Staff,0,0,0,0
1746583818423,EDS 25,A10,888244,Staff,0,0,0,0
1746583818423,EDS 25,B01,888273,Staff,0,0,0,0
1746583818423,EDS 25,B02,888285,Staff,0,0,0,0
1746583818423,EDS 25,B03,888423,Staff,0,0,0,1
1746583818423,EDS 25,B04,888432,Staff,0,0,0,0
1746583818423,EDS 25,B05,888433,Staff,0,0,0,0
1746583818423,EDS 25,B06,888467,Staff,0,0,0,0
1746583818423,EDS 25,B07,888468,Staff,0,0,0,0
1746583818423,EDS 25,B08,888479,Staff,0,0,0,0
1746583818423,EDS 25,B09,888484,Staff,0,0,0,0
1746583818423,EDS 25,B10,888487,Staff,0,0,0,0
1746583819448,EDS 38,A01,907700,Choi; Bailey Miyeon,30,0,30,0
1746583820474,EDS 112,A01,888601,Chapman; Thandeka K,12,0,40,28
1746583821502,EDS 115,A00,888697,Mendez; Kathrina Mendoza,10,0,30,20
1746583822528,EDS 116,A01,888893,Staff,34,0,40,6
1746583824581,EDS 124AR,A00,889133,Staff,29,0,50,21
1746583824581,EDS 124AR,B00,907471,Simon; Elizabeth A,37,0,50,13
1746583825606,EDS 124BR,A00,889134,Simon; Elizabeth A,44,0,100,56
1746583826634,EDS 125,A00,889135,Staff,25,0,30,5
1746583827698,EDS 126,A01,889138,Staff,35,0,40,5
1746583828727,EDS 164R,A01,889142,Wishard Guerra; Alison G.,32,0,50,18
1746583829756,ENG 30,A01,886396,Staff,0,0,0,0
1746583829756,ENG 30,B01,886398,Staff,0,0,0,0
1746583830781,ENVR 102,A00,906150,Montejo; Carolina,23,0,25,2
1746583831808,ETHN 103A,A00,887236,Man; Simeon S,0,3,0,0
1746583832833,ETHN 113,A00,887239,Staff,16,0,30,14
1746583833858,ETHN 116,A00,887240,Staff,16,0,25,9
1746583834883,ETHN 117,A00,887241,Choi; Esther Min,28,0,30,2
1746583835911,ETHN 118,A00,887243,Staff,24,0,30,6
1746583836940,ETHN 127,A00,887248,Cuong; Marisol,11,0,15,4
1746583837969,ETHN 139,A00,887250,Staff,7,0,10,3
1746583838994,ETHN 142,A00,887252,Staff,10,0,30,20
1746583840020,ETHN 161,A00,887253,Browne; Errol Tsekani,24,0,30,6
1746583841046,ETHN 163FR,A00,887255,Burelle; Julie Sara Veronique,0,0,5,5
1746583842074,GLBH 20,A00,889149,Elwardani; Nile Regina,8,0,42,34
1746583844129,GLBH 111,A01,889152,Burgos; Jose L.,17,0,17,0
1746583845154,GLBH 150,A00,889181,Sloane; Julia Kathryn,0,5,15,15
1746583847203,HDS 60,A01,886406,Warstadt; Melissa Fawn,73,0,80,7
1746583848231,HIAF 111,A00,889324,Gyamfi; Bright,25,0,32,7
1746583849260,HIEA 131,A00,889328,Staff,15,0,32,17
1746583850283,HIEA 144,A00,889333,Henry; Todd A.,26,0,32,6
1746583851313,HIEA 154,A00,889336,Henry; Todd A.,24,0,32,8
1746583852340,HIEU 106,A00,889339,Staff,22,0,32,10
1746583854390,HIEU 114,A00,889340,Staff,4,0,32,28
1746583855414,HIEU 135GS,A00,889342,Patterson; Patrick H.,0,0,1,24
1746583856439,HIEU 137,A00,889343,Edington; Claire Ellen,10,0,25,15
1746583857465,HIEU 148,A00,889345,Staff,14,0,32,18
1746583858493,HIEU 154,A00,889346,Biess; Frank Peter,21,0,32,11
1746583859518,HILA 102,A00,889351,Staff,12,0,32,20
1746583860547,HILD 2A,A01,889221,Lewandoski; Julia Mavis,1,10,32,31
1746583861570,HILD 7B,A01,889225,Man; Simeon S,0,12,32,32
1746583862599,HILD 7C,A01,889288,Alvarez; Luis A,0,14,32,32
1746583863625,HILD 30,A01,889323,Staff,0,5,32,32
1746583865679,HISC 119,A00,889383,Golan; Tal,19,0,32,13
1746583866706,HIUS 103,A00,889384,Man; Simeon S,0,0,32,32
1746583867732,HIUS 117,A00,919797,Kwak; Nancy,19,0,32,13
1746583868760,HIUS 142A,A00,919788,Staff,22,0,32,10
1746583870814,HIUS 149,A00,889386,Gyamfi; Bright,26,0,32,6
1746583871838,HIUS 155,A00,889387,Alvarez; Luis A,15,0,32,17
1746583872867,HUM 3,A01,886499,Caldwell; Michael Alan,19,0,50,31
1746583873895,HUM 3GS,A00,886500,Rodriguez; Bretton Sigfred,0,0,0,28
1746583874923,HUM 3R,A01,886502,Markman; Kristina,0,36,50,50
1746583875947,HUM 4,A01,886504,Crum; Matthew Stephen,23,0,50,27
1746583875947,HUM 4,B01,886506,West; Geoffrey Scott,17,0,50,33
1746583876972,HUM 4GS,A00,886507,Staff,0,0,0,19
1746583877997,HUM 5,A01,886509,Staff,32,0,50,18
1746583879027,HUM 5R,A01,886511,Zavodny; Tatiana Sophia,0,39,50,50
1746583880050,JAPN 180,A00,886407,Staff,16,0,40,24
1746583881081,LATI 50,A01,886409,Martin-Cabrera; Luis,3,0,22,19
1746583881081,LATI 50,A02,886410,Martin-Cabrera; Luis,19,0,22,3
1746583881081,LATI 50,A03,886411,Martin-Cabrera; Luis,21,0,22,1
1746583881081,LATI 50,A04,886412,Martin-Cabrera; Luis,8,0,22,14
1746583882107,LAWS 101,A00,907664,Staff,28,0,60,32
1746583883133,LIAB 1A,A00,889388,Saab; Dima,17,0,20,3
1746583884159,LIAB 1AX,A00,889389,El Cheddadi; Youniss,18,0,20,2
1746583885184,LIFR 1C,A00,889391,Van Moer; Vinciane G,8,0,20,12
1746583886213,LIFR 1CX,A00,889392,Van Moer; Vinciane G,7,0,20,13
1746583887238,LIFR 1D,A00,889393,Van Moer; Vinciane G,7,0,20,13
1746583888263,LIFR 1DX,A00,889394,Van Moer; Vinciane G,8,0,20,12
1746583889289,LIGN 7,A00,886923,Staff,24,0,50,26
1746583890319,LIGN 17,A00,886924,Kehler; Andrew Scott,125,0,150,25
1746583891342,LTAM 110,A00,889395,Staff,15,0,30,15
1746583892368,LTAM 110GS,A00,958010,Rodriguez; Bretton Sigfred,0,0,0,28
1746583893395,LTCH 101,A00,889397,Staff,23,0,25,2
1746583894423,LTCS 130,A00,889398,Staff,23,0,25,2
1746583895451,LTEA 138,A00,889399,Staff,24,0,40,16
1746583896476,LTEN 149,A00,889400,Wesling; Megan E.,0,3,25,25
1746583897514,LTEN 169,A00,889401,Staff,20,0,25,5
1746583898541,LTEN 180,A00,889402,Staff,10,0,15,5
1746583899565,LTEN 181,A00,889403,Staff,21,0,25,4
1746583900592,LTWL 100,A00,889404,Myerston Santana; Jacobo,2,0,25,23
1746583901620,LTWL 180GS,A00,889405,Staff,0,0,20,20
1746583902644,LTWL 181,A00,889406,Staff,16,0,25,9
1746583903674,LTWL 184,A00,889475,Mukherjee; Silpa,22,0,25,3
1746583904703,LTWR 102C,A00,889486,Staff,29,0,30,1
1746583905727,LTWR 115W,A00,889491,Staff,0,2,15,15
1746583906757,MAE 8,A01,886905,Staff,0,2,0,0
1746583907784,MAE 11,A00,886906,Bandaru; Prabhakar,0,7,50,50
1746583908811,MAE 20,A00,886907,Evdokimenko; Ekaterina,43,0,70,27
1746583909841,MAE 30B,A00,886909,Ghazinejad; Maziar,26,0,45,19
1746583910870,MAE 101B,A00,886910,Saintillan; David,29,0,45,16
1746583911898,MAE 105,A00,886911,Bandaru; Prabhakar,18,0,50,32
1746583912926,MAE 107,B00,958024,Staff,7,0,50,43
1746583913955,MAE 143B,A00,886913,Bewley; Thomas R,3,0,40,37
1746583914979,MAE 148,A01,886915,Silberman; Jack,0,3,14,14
1746583916005,MAE 160,A00,886916,Evdokimenko; Ekaterina,31,0,60,29
1746583917030,MATH 3C,A01,889681,Staff,0,2,30,30
1746583917030,MATH 3C,A02,960048,Staff,24,0,30,6
1746583918055,MATH 10A,A01,889760,Staff,26,0,30,4
1746583918055,MATH 10A,A02,889783,Staff,29,0,30,1
1746583919082,MATH 10B,A01,889785,Verstraete; Jacques Allan,1,0,35,34
1746583919082,MATH 10B,A02,889795,Verstraete; Jacques Allan,4,0,35,31
1746583919082,MATH 10B,B01,889797,Verstraete; Jacques Allan,3,0,35,32
1746583919082,MATH 10B,B02,889828,Verstraete; Jacques Allan,3,0,35,32
1746583920113,MATH 10C,A01,889849,Habib; Yousaf,7,0,30,23
1746583920113,MATH 10C,A02,889852,Habib; Yousaf,14,0,30,16
1746583920113,MATH 10C,A03,889853,Habib; Yousaf,22,0,30,8
1746583920113,MATH 10C,A04,889858,Habib; Yousaf,20,0,30,10
1746583920113,MATH 10C,B01,889861,Staff,1,0,30,29
1746583920113,MATH 10C,B02,889862,Staff,24,0,30,6
1746583920113,MATH 10C,B03,889863,Staff,27,0,30,3
1746583920113,MATH 10C,B04,889967,Staff,23,0,30,7
1746583921140,MATH 18,A01,889974,Staff,7,0,30,23
1746583921140,MATH 18,A02,889977,Staff,20,0,30,10
1746583921140,MATH 18,B01,889984,Hardiman; Liam,20,0,30,10
1746583921140,MATH 18,B02,889985,Hardiman; Liam,25,0,30,5
1746583922168,MATH 20A,A01,889990,Suk; Andrew Hoon,30,0,35,5
1746583923195,MATH 20B,A01,889993,Ohm; Ko Woon,21,0,30,9
1746583923195,MATH 20B,A02,889994,Ohm; Ko Woon,30,0,30,0
1746583923195,MATH 20B,B01,889996,Ohm; Ko Woon,22,0,30,8
1746583923195,MATH 20B,B02,889997,Ohm; Ko Woon,23,0,30,7
1746583924221,MATH 20C,A01,889999,Hammock; Frances H,17,0,30,13
1746583924221,MATH 20C,A02,890003,Hammock; Frances H,23,0,30,7
1746583924221,MATH 20C,B01,890006,Hammock; Frances H,3,0,30,27
1746583924221,MATH 20C,B02,890007,Hammock; Frances H,12,0,30,18
1746583925246,MATH 20D,A01,890011,Cheng; Hsiao-Bing,1,1,30,29
1746583925246,MATH 20D,A02,890012,Cheng; Hsiao-Bing,14,0,30,16
1746583925246,MATH 20D,B01,890016,Cheng; Hsiao-Bing,13,0,30,17
1746583925246,MATH 20D,B02,890017,Cheng; Hsiao-Bing,13,0,30,17
1746583926278,MATH 20E,A01,890026,Harel; Guershon,1,0,30,29
1746583926278,MATH 20E,A02,890029,Harel; Guershon,22,0,30,8
1746583926278,MATH 20E,B01,890033,Harel; Guershon,7,0,30,23
1746583926278,MATH 20E,B02,890101,Harel; Guershon,21,0,30,9
1746583927303,MATH 102,A01,890104,Staff,18,0,30,12
1746583927303,MATH 102,A02,890105,Staff,27,0,30,3
1746583928329,MATH 103B,A01,890116,Salehi Golsefidy; Alireza,3,0,30,27
1746583928329,MATH 103B,B01,890118,Staff,0,3,34,34
1746583929358,MATH 109,A01,890121,Aliabadi Sr.; Mohsen,0,0,30,30
1746583929358,MATH 109,B01,890124,Upadrashta; Pranav Kumar,18,0,30,12
1746583930388,MATH 120A,A01,890126,Eggers; John Dietrich,13,0,30,17
1746583931468,MATH 142B,A01,890128,Ioana; Adrian,19,0,30,11
1746583931468,MATH 142B,A02,890129,Ioana; Adrian,12,0,30,18
1746583932494,MATH 154,A01,890174,Staff,0,1,30,30
1746583932494,MATH 154,A02,890182,Staff,0,0,30,30
1746583933523,MATH 168A,A01,890197,Dumitriu; Ioana,21,0,35,14
1746583934552,MATH 170A,A01,890240,Nie; Jiawang,1,0,30,29
1746583934552,MATH 170A,A02,890241,Nie; Jiawang,11,0,30,19
1746583934552,MATH 170A,A03,890249,Nie; Jiawang,23,0,30,7
1746583935579,MATH 170B,A01,957891,Nag; Panchali,13,0,35,22
1746583937628,MATH 181A,A01,908025,Staff,0,3,35,35
1746583937628,MATH 181A,A02,960115,Staff,26,0,35,9
1746583938654,MATH 181B,A01,959874,Staff,25,0,30,5
1746583939678,MATH 193B,A01,890265,Staff,0,4,35,35
1746583940704,MGT 4,A01,890311,Anderson; John Charles,42,0,88,46
1746583941732,MGT 5,A00,907740,Staff,13,0,98,85
1746583942757,MGT 12,A00,890312,Lindenberger; Wade Douglas,67,0,98,31
1746583943781,MGT 16,A00,957883,Staff,78,0,98,20
1746583945830,MGT 45,A00,890314,Pecore; Joseph P.,45,0,98,53
1746583946857,MGT 71,A00,890315,Staff,0,12,98,98
1746583947886,MGT 100,A00,890316,Yavorsky; Daniel Ryan,44,0,98,54
1746583948914,MGT 103,A00,890317,Ehrich; Kristine R,73,0,98,25
1746583949939,MGT 105,A00,890356,Bates; Kenneth Walter,0,8,98,98
1746583950967,MGT 112,A00,890360,Ehrich; Kristine R,55,0,98,43
1746583951997,MGT 127R,A00,907732,Zhu; Kevin Xiaoguo,23,0,98,75
1746583953022,MGT 131B,A00,890361,Anderson; John Charles,59,0,98,39
1746583954047,MGT 137,A00,890362,Lindenberger; Wade Douglas,65,0,98,33
1746583955072,MGT 160,A00,890369,Johnson; Erik Barry,9,0,98,89
1746583957130,MGT 164,A00,890372,Zimmermann; Carsten,0,40,98,98
1746583958157,MGT 180,A00,890374,Bliss; Barbara Ann,12,0,98,86
1746583959187,MMW 15,A01,886414,Chang; Edmond Yi-Teh,0,12,28,28
1746583959187,MMW 15,A02,886415,Chang; Edmond Yi-Teh,0,8,28,28
1746583959187,MMW 15,A03,886416,Chang; Edmond Yi-Teh,0,9,28,28
1746583959187,MMW 15,A04,886417,Chang; Edmond Yi-Teh,0,8,28,28
1746583959187,MMW 15,B01,886419,Chang; Edmond Yi-Teh,0,7,28,28
1746583959187,MMW 15,B02,886420,Chang; Edmond Yi-Teh,0,8,28,28
1746583959187,MMW 15,B03,886421,Chang; Edmond Yi-Teh,0,7,28,28
1746583959187,MMW 15,B04,886422,Chang; Edmond Yi-Teh,0,8,28,28
1746583959187,MMW 15,C01,886424,Staff,0,9,28,28
1746583959187,MMW 15,C02,886425,Staff,0,8,28,28
1746583959187,MMW 15,C03,886426,Staff,0,8,28,28
1746583959187,MMW 15,C04,886427,Staff,0,8,28,28
1746583959187,MMW 15,C05,958038,Staff,0,8,28,28
1746583959187,MMW 15,C06,958039,Staff,1,8,28,27
1746583960215,MMW 15GS,A00,906910,Patterson; Patrick H.,4,0,28,24
1746583961241,MMW 122R,A01,886429,Rahimi; Babak,0,13,28,28
1746583961241,MMW 122R,A02,886430,Rahimi; Babak,0,12,28,28
1746583961241,MMW 122R,A03,958040,Rahimi; Babak,0,11,28,28
1746583962267,MUS 1A,A01,890937,Staff,2,0,25,23
1746583962267,MUS 1A,A02,891035,Staff,6,0,25,19
1746583962267,MUS 1A,C01,958912,Staff,24,0,25,1
1746583962267,MUS 1A,C02,958913,Staff,25,0,25,0
1746583964318,MUS 2AK,A00,957092,Ohnishi; Takae,15,0,15,0
1746583965345,MUS 4,A01,891044,Staff,1,0,25,24
1746583965345,MUS 4,A02,891045,Staff,23,0,25,2
1746583965345,MUS 4,B01,891048,Staff,17,0,25,8
1746583965345,MUS 4,B02,891050,Staff,25,0,25,0
1746583966371,MUS 5,A01,957506,Dubnov; Shlomo,0,0,25,25
1746583966371,MUS 5,A02,957622,Dubnov; Shlomo,13,0,25,12
1746583966371,MUS 5,A03,957623,Dubnov; Shlomo,20,0,25,5
1746583967396,MUS 6,A01,891053,Freitas Caetano; Marcelo,24,0,25,1
1746583967396,MUS 6,A02,891054,Freitas Caetano; Marcelo,23,0,25,2
1746583968425,MUS 7,A01,891081,Staff,0,0,25,25
1746583968425,MUS 7,A02,891082,Staff,3,0,25,22
1746583969450,MUS 8GS,A00,891118,Borgo; David Garcia,1,0,25,24
1746583970475,MUS 11,A01,891140,Staff,9,0,25,16
1746583970475,MUS 11,A02,891141,Staff,21,0,25,4
1746583971505,MUS 13,A01,891143,Staff,8,0,25,17
1746583971505,MUS 13,A02,891144,Staff,24,0,25,1
1746583972532,MUS 15,A01,891146,Staff,9,0,25,16
1746583972532,MUS 15,A02,891148,Staff,21,0,25,4
1746583972532,MUS 15,B01,891150,Staff,18,0,25,7
1746583972532,MUS 15,B02,891151,Staff,25,0,25,0
1746583973558,MUS 20,A01,891153,Staff,5,0,20,15
1746583973558,MUS 20,A02,891155,Staff,14,0,20,6
1746583974584,MUS 80,A00,891156,Staff,19,0,25,6
1746583974584,MUS 80,B00,891157,Staff,23,0,25,2
1746583975609,MUS 130,A00,891158,Ohnishi; Takae,35,0,35,0
1746583976633,MUS 150GS,A01,891160,Borgo; David Garcia,1,0,25,24
1746583977658,MUS 170,A01,891162,Freitas Caetano; Marcelo,20,0,25,5
1746583977658,MUS 170,A02,891164,Freitas Caetano; Marcelo,21,0,25,4
1746583978682,NANO 11,A00,886220,Vazquez Mena; Oscar,13,0,15,2
1746583979706,NANO 15,A01,886222,Drews; Aaron,4,0,7,3
1746583980733,NANO 104,A00,886224,Sirbuly; Donald,17,0,25,8
1746583981757,PH 40,A00,886528,Staff,24,0,40,16
1746583982789,PH 45,A01,886799,Staff,35,0,40,5
1746583983818,PH 110,A00,886802,Staff,0,7,40,40
1746583984844,PH 172,A00,906716,Staff,19,0,35,16
1746583985869,PH 191,A00,886803,Staff,6,0,40,34
1746583986893,PHIL 1,A00,889500,Staff,20,0,30,10
1746583987918,PHIL 10,A01,889549,Grush; Rick Scott,16,0,22,6
1746583987918,PHIL 10,A02,889551,Grush; Rick Scott,22,0,22,0
1746583988947,PHIL 28,A01,889559,Lamey; Andy M.,0,2,31,31
1746583988947,PHIL 28,A02,889561,Lamey; Andy M.,0,1,30,30
1746583988947,PHIL 28,A03,889572,Lamey; Andy M.,0,1,30,30
1746583989971,PHIL 35,A00,907839,Staff,13,0,15,2
1746583991010,PHIL 60,A00,889574,Staff,73,0,90,17
1746583992037,PHIL 101,A00,958004,Staff,12,0,15,3
1746583994088,PHIL 136,A00,889582,Fulkerson; Matthew Todd,26,0,45,19
1746583995117,PHIL 163,A01,889601,Staff,21,0,30,9
1746583995117,PHIL 163,B01,889606,Brandt; Reuven A,0,3,0,0
1746583996146,PHIL 164,A00,889610,Staff,16,0,30,14
1746583997174,PHIL 165,A00,889613,Staff,22,0,30,8
1746583998203,PHYS 1A,A00,886431,Staff,29,0,70,41
1746583999227,PHYS 1AL,001,886432,Tsai; Philbert S,1,2,30,29
1746583999227,PHYS 1AL,002,886436,Tsai; Philbert S,12,0,30,18
1746584000256,PHYS 1B,A00,886439,Staff,184,0,240,56
1746584001283,PHYS 1BL,001,886441,Tsai; Philbert S,0,4,30,30
1746584001283,PHYS 1BL,002,886444,Tsai; Philbert S,2,0,30,28
1746584002309,PHYS 1C,A00,896092,Arnold; Kam S,78,0,146,68
1746584003336,PHYS 1CL,001,886448,Tsai; Philbert S,0,0,30,30
1746584003336,PHYS 1CL,002,886449,Tsai; Philbert S,1,0,30,29
1746584003336,PHYS 1CL,003,886450,Tsai; Philbert S,16,0,30,14
1746584003336,PHYS 1CL,004,886451,Tsai; Philbert S,15,0,30,15
1746584004364,PHYS 2B,A01,886457,Staff,67,0,115,48
1746584005390,PHYS 2C,A01,886460,Shotwell; Brian,0,9,65,65
1746584006416,PHYS 2CL,A01,886467,Staff,0,4,28,28
1746584006416,PHYS 2CL,A02,886468,Staff,0,3,28,28
1746584007441,PHYS 2D,A01,886470,Staff,10,0,50,40
1746584008470,PHYS 4B,A01,886475,Grinstein; Benjamin,22,0,40,18
1746584009497,POLI 5,A00,891173,Desposato; Scott,7,0,25,18
1746584010522,POLI 5D,A01,891175,Staff,5,0,5,0
1746584010522,POLI 5D,B01,891178,Staff,5,0,5,0
1746584011549,POLI 11,A00,891179,Ferree; Karen E,2,0,35,33
1746584012576,POLI 12,A00,891180,Staff,16,0,30,14
1746584013604,POLI 27,A01,891182,Staff,12,0,75,63
1746584014629,POLI 30,A00,891183,Staff,8,0,50,42
1746584015655,POLI 100B,A00,891244,Staff,5,1,35,30
1746584016681,POLI 100I,A00,891247,Staff,7,0,30,23
1746584017706,POLI 104J,A00,891248,Nichter; Maysa,14,0,30,16
1746584018732,POLI 104U,A00,891250,Nichter; Maysa,1,0,30,29
1746584020784,POLI 110B,A00,891255,Wiens; David,19,0,25,6
1746584021809,POLI 112A,A00,891256,Wiens; David,6,0,25,19
1746584022834,POLI 114BR,A00,891261,Staff,19,0,30,11
1746584023862,POLI 117R,A00,891262,Forman; Fonna,0,6,50,50
1746584024886,POLI 118,A00,891264,Ingham; Sean,17,0,25,8
1746584025910,POLI 124A,A00,891265,Staff,18,0,20,2
1746584026937,POLI 125D,A00,891266,Nichter; Simeon C,2,0,25,23
1746584027963,POLI 126,A00,891268,Nichter; Simeon C,7,0,25,18
1746584028990,POLI 126AA,A00,891272,Staff,15,0,25,10
1746584030016,POLI 130AA,A00,891273,Staff,15,0,20,5
1746584031041,POLI 134AA,A00,891274,Staff,4,0,20,16
1746584033094,POLI 138,A00,891278,Staff,21,0,25,4
1746584034122,POLI 142K,A00,891280,Staff,10,0,25,15
1746584035151,POLI 142M,A00,891281,Gartzke; Erik,16,0,30,14
1746584036177,POLI 142P,A00,891284,Staff,20,0,30,10
1746584037205,POLI 143,A00,891285,Gartzke; Erik,12,0,30,18
1746584038234,POLI 153,A00,891286,Staff,19,0,20,1
1746584040287,POLI 175,A00,891290,Staff,15,0,20,5
1746584041314,PSYC 1,A00,890674,Steiner; Eric Tomas,0,11,45,45
1746584042343,PSYC 2,A00,890676,Albright; Thomas D,20,0,35,15
1746584043370,PSYC 3,A00,890679,Staff,17,0,20,3
1746584044398,PSYC 6,A00,959858,Staff,19,0,20,1
1746584045424,PSYC 60,A01,890684,Rickard; Timothy C.,0,5,45,45
1746584046453,PSYC 70,A01,890689,Geller; Emma Harlan,6,0,30,24
1746584047478,PSYC 71,A01,959860,Staff,21,0,25,4
1746584048507,PSYC 100,A00,890690,Lacefield; Katharine I,0,50,180,180
1746584049535,PSYC 102,A00,890695,Staff,18,0,40,22
1746584050562,PSYC 105,A00,890699,Geller; Emma Harlan,70,0,100,30
1746584051588,PSYC 106,A00,890701,Gorman; Michael R.,5,0,30,25
1746584052617,PSYC 108,A00,890704,Adrian; Julia Anna,0,28,50,50
1746584053643,PSYC 118,A01,890712,Staff,11,0,30,19
1746584054668,PSYC 124,A00,890716,Chapman; Eddie Nathaniel,25,0,60,35
1746584055695,PSYC 131,A00,890717,Anagnostaras; Stephan,0,7,80,80
1746584056721,PSYC 137,A00,890719,Winkielman; Piotr,0,11,30,30
1746584057745,PSYC 144,A00,890721,Adrian; Julia Anna,0,9,45,45
1746584058769,PSYC 162,A00,890805,Staff,0,1,75,75
1746584059797,PSYC 169,A00,890810,Staff,0,15,30,30
1746584060823,PSYC 172,A00,890814,Gorman; Michael R.,9,0,30,21
1746584061849,PSYC 181,A00,890818,Anagnostaras; Stephan,7,0,200,193
1746584062874,PSYC 184,A00,959861,Staff,164,0,175,11
1746584063899,PSYC 189,A00,890823,Staff,0,2,30,30
1746584064925,PSYC 191,A00,890884,Rickard; Timothy C.,0,12,35,35
1746584065950,PSYC 193,A00,890913,Staff,19,0,30,11
1746584065950,PSYC 193,B00,890914,Chapman; Eddie Nathaniel,24,0,30,6
1746584066982,PSYC 193L,A01,890918,Lowe; Angela Beth,20,0,30,10
1746584066982,PSYC 193L,B01,890921,Hurwitz; Ethan Scott,20,0,30,10
1746584066982,PSYC 193L,C01,890928,Staff,30,0,30,0
1746584068007,RELI 149,A00,886806,Rahimi; Babak,23,0,40,17
1746584069034,SE 9,A01,886814,Staff,7,0,20,13
1746584070059,SE 101B,A01,886816,Chadha; Mayank,4,0,35,31
1746584071084,SE 110B,A00,886818,Zhu; Qiang,4,0,75,71
1746584072109,SE 125,A01,886830,Staff,10,0,30,20
1746584073147,SE 130B,A01,886835,Staff,14,0,40,26
1746584074177,SE 131A,A01,886838,Krysl; Petr,34,0,55,21
1746584075202,SE 154,A00,886840,Staff,28,0,50,22
1746584076228,SE 164GS,A01,886849,Staff,6,0,20,14
1746584077251,SE 167GS,A01,886853,Staff,6,0,20,14
1746584078278,SIO 25,A01,890107,Staff,19,0,30,11
1746584079305,SIO 45,A00,890109,Cook; Geoffrey W,116,0,200,84
1746584080330,SIO 109R,A00,890110,Forman; Fonna,0,16,20,20
1746584081355,SIO 187,A01,890114,Kacev; David,15,0,40,25
1746584082380,SOCI 1,A01,890431,Thorpe; Charles Robert,14,0,30,16
1746584082380,SOCI 1,A02,890518,Thorpe; Charles Robert,30,0,30,0
1746584083403,SOCI 2,A01,957978,Staff,25,0,25,0
1746584083403,SOCI 2,A02,957979,Staff,23,0,25,2
1746584084427,SOCI 20,A01,890523,Calderon-Zaks; Michael Aar,21,0,30,9
1746584084427,SOCI 20,A02,890526,Calderon-Zaks; Michael Aar,29,0,30,1
1746584085453,SOCI 30,A01,890533,Pardo Guerra; Juan Pablo,37,0,40,3
1746584086478,SOCI 40,A01,890535,Staff,27,0,45,18
1746584087505,SOCI 104Q,A00,890559,Staff,18,0,30,12
1746584088531,SOCI 106,A00,890560,Arnal; Maud Marie Leonie,20,0,30,10
1746584089558,SOCI 110,A00,890567,Holkenbrink-Monk; Charlene,19,0,30,11
1746584090588,SOCI 112,A00,890568,Victoria Torres; Pablo,2,0,55,53
1746584091613,SOCI 115,A00,890597,Arnal; Maud Marie Leonie,28,0,45,17
1746584093667,SOCI 121,A00,890604,Pardo Guerra; Juan Pablo,38,0,45,7
1746584094695,SOCI 126,A01,890608,Staff,8,0,10,2
1746584095722,SOCI 127,A00,890609,Staff,18,0,30,12
1746584096751,SOCI 131,A00,890610,Thorpe; Charles Robert,37,0,45,8
1746584097780,SOCI 135,A00,890615,Payne; Christine Anna,13,0,45,32
1746584098849,SOCI 139,A00,890620,Staff,38,0,45,7
1746584099874,SOCI 148E,A00,890622,Calderon-Zaks; Michael Aar,36,0,45,9
1746584100903,SOCI 150,A00,890623,Kohler; Kristopher M.,31,0,45,14
1746584101932,SOCI 157,A00,890625,Jules-Rosette; Bennetta W.,18,0,20,2
1746584102958,SOCI 160,A00,890627,Payne; Christine Anna,21,0,45,24
1746584103988,SYN 1,A00,886855,Fish; Gwendolyn Anne,0,1,0,0
1746584103988,SYN 1,B00,906086,Fish; Gwendolyn Anne,0,2,0,2
1746584105018,SYN 2R,A00,886860,Staff,0,17,15,15
1746584105018,SYN 2R,B00,906106,Atkinson; Arthur Laird,0,16,15,15
1746584106044,SYN 100,A01,886866,Browne; Emily,0,28,20,20
1746584106044,SYN 100,B01,906128,Rock; Martin,0,4,20,20
1746584106044,SYN 100,C01,906140,Deavenport; James Cary,0,3,20,20
1746584106044,SYN 100,D01,907816,Deavenport; James Cary,0,5,20,20
1746584107069,TDAC 1,A00,890286,Walsh; Kim C.,7,0,20,13
1746584108098,TDAC 101,A00,890296,Basso; Beatrice,15,0,20,5
1746584109124,TDDE 131,A00,890297,Staff,47,0,50,3
1746584110152,TDDM 1,A00,890287,Weinberg; Sadie,25,0,30,5
1746584111181,TDGE 11,A00,890288,Fulton; Julia,138,0,200,62
1746584111181,TDGE 11,B00,890289,Castro; Robert Jess,184,0,200,16
1746584112208,TDGE 25,B00,957359,Walsh; Kim C.,5,0,20,15
1746584113232,TDGE 40,A01,890292,Power; Jade Yukana,27,0,30,3
1746584114259,TDGE 124,A00,890298,Havis; Allan,0,1,50,50
1746584115287,TDGE 131R,A00,890299,Burelle; Julie Sara Veronique,15,0,42,27
1746584116315,TDHT 101,A00,890300,Staff,10,0,20,10
1746584117342,TDHT 109,A01,890302,Anderson; Mysia Anyse,31,0,40,9
1746584118366,TDMV 1,A00,890293,Arcidiacono; Kristin,18,0,30,12
1746584119392,TDMV 2,A00,890294,Weinberg; Sadie,23,0,30,7
1746584120424,TDMV 3,A00,957878,Arcidiacono; Kristin,28,0,30,2
1746584122479,TDMV 138,A00,890304,Jun; Grace Shin Hae,25,0,40,15
1746584123504,TDMV 140,A00,890305,Corrales; Joseph Bernales,25,0,30,5
1746584124529,TDMV 142,A00,890307,Caligagan; Tony,32,0,40,8
1746584125561,TDMV 144,A00,890308,Camaya; Michelle Ann,25,0,30,5
1746584126591,TDPW 1,A00,890295,Stein; Deborah Isobel,3,0,20,17
1746584127616,USP 2,A01,890272,Lerner; Amy M,7,0,20,13
1746584128640,USP 3,A01,890274,Staff,12,0,30,18
1746584129667,USP 15,A01,890276,Sun; Feiyang,16,0,30,14
1746584130693,USP 25,A00,890277,Shenkman; Michael Thomas,18,0,25,7
1746584131718,USP 138,A00,890278,Staff,13,0,25,12
1746584132742,USP 143,A00,890279,Staff,22,0,70,48
1746584133768,USP 144,A00,890280,Chowdhury; Muhammed Zohir,16,0,30,14
1746584134793,USP 150,A00,890281,Boomhower; Matthew Charles,4,0,30,26
1746584135819,USP 151,A00,890282,Staff,16,0,20,4
1746584136844,USP 162,A00,890283,Andrews; Abigail Leslie,16,0,20,4
1746584137868,USP 168,A00,920477,Kwak; Nancy,0,0,5,5
1746584138897,USP 181,A00,890284,Staff,3,0,20,17
1746584139923,USP 191A,A00,890285,Staff,12,0,20,8
1746584140949,VIS 101,A00,886512,Staff,26,0,75,49
1746584141977,VIS 103,A00,886513,Cruz; Edwin Teddy,61,0,75,14
1746584143006,VIS 108,A00,886514,Staff,3,0,15,12
1746584144035,VIS 127P,A00,886515,Shen; Kuiyi,79,0,146,67
1746584145065,VIS 149,A00,886516,Yoldas; Pinar,0,0,15,15
1746584146089,VIS 164,A00,886526,Erdmann; Dean,19,0,22,3
1746584147114,VIS 194S,A00,886527,Staff,61,0,75,14
1746584148141,WCWP 10A,C00,886484,Martiniuk; Jill,12,0,15,3
1746584149166,WCWP 10B,A00,886490,Uriarte; Emma,0,0,15,15
1746584149166,WCWP 10B,B00,886491,Dhir; Simrita,8,0,15,7
1746584149166,WCWP 10B,C00,886492,Ornelas; Tricia,0,0,15,15
1746584150197,WCWP 100,A00,886494,Young; Mark T,0,6,15,15
1746584152304,AAS 10,A01,886199,Childs; Dennis R.,0,3,0,0
1746584153331,ANAR 104,A01,886940,Shtienberg; Gilad,27,0,30,3
1746584154358,ANAR 120,A00,886953,Staff,13,0,20,7
1746584155383,ANBI 148,A01,886955,Wilder; Linnea Lorene,30,0,40,10
1746584157434,ANSC 122,A00,886957,Staff,24,0,30,6
1746584158460,ANSC 150,A00,886958,Sloane; Julia Kathryn,2,0,15,13
1746584159486,ANSC 156,A00,886959,Jenkins; Janis A.,0,1,15,15
1746584160512,ANSC 180,A00,886960,Staff,11,0,17,6
1746584161541,ANSC 188,A00,886961,Jassal; Aftab,9,0,25,16
1746584162569,ANSC 190,A00,886962,Jassal; Aftab,14,0,25,11
1746584163596,ANSC 191,A00,886963,Staff,18,0,20,2
1746584164624,ANTH 3,A01,891689,Staff,17,0,20,3
1746584165651,ANTH 5,A00,886933,Semendeferi; Ekaterini,16,0,20,4
1746584166676,ANTH 10,A00,886934,Staff,0,12,30,30
1746584167701,ANTH 21,A01,886936,Staff,41,0,60,19
1746584168729,ANTH 23,A01,886938,Staff,92,0,100,8
1746584169754,ANTH 105,A00,886964,Stewart; Alexander B,84,0,100,16
1746584170779,ANTH 108,A00,886965,Pedersen; David,9,0,20,11
1746584171813,AWP 10,001,886147,Staff,0,0,0,0
1746584171813,AWP 10,002,886148,Staff,0,0,0,0
1746584171813,AWP 10,003,886149,Staff,0,0,0,0
1746584171813,AWP 10,004,886150,Staff,0,0,0,0
1746584171813,AWP 10,005,886151,Staff,0,0,0,0
1746584171813,AWP 10,006,886152,Staff,0,0,0,0
1746584171813,AWP 10,007,886153,Staff,0,0,0,0
1746584171813,AWP 10,008,886154,Staff,0,0,0,0
1746584171813,AWP 10,009,886155,Staff,0,0,0,0
1746584171813,AWP 10,010,886156,Staff,0,0,0,0
1746584171813,AWP 10,011,886158,Staff,0,0,0,0
1746584171813,AWP 10,012,886160,Staff,0,0,0,0
1746584171813,AWP 10,013,886161,Staff,0,0,0,0
1746584171813,AWP 10,014,886162,Staff,0,0,0,0
1746584171813,AWP 10,015,886163,Staff,0,0,0,0
1746584171813,AWP 10,016,886164,Staff,0,0,0,0
1746584171813,AWP 10,017,886165,Staff,0,0,0,0
1746584171813,AWP 10,018,886166,Staff,0,0,0,0
1746584171813,AWP 10,019,886168,Staff,0,0,0,0
1746584171813,AWP 10,020,886170,Staff,0,0,0,0
1746584171813,AWP 10,021,886172,Staff,0,0,0,0
1746584172844,AWP 10R,001,886173,Staff,0,1,0,0
1746584172844,AWP 10R,002,886174,Staff,0,1,0,0
1746584172844,AWP 10R,003,886175,Staff,0,0,0,0
1746584172844,AWP 10R,004,886176,Staff,0,0,0,0
1746584172844,AWP 10R,005,886177,Staff,0,0,0,0
1746584172844,AWP 10R,006,886178,Staff,0,0,0,0
1746584172844,AWP 10R,007,886179,Staff,0,0,0,0
1746584172844,AWP 10R,008,886181,Staff,0,0,0,0
1746584172844,AWP 10R,009,886182,Staff,0,0,0,0
1746584172844,AWP 10R,010,886183,Staff,0,0,0,0
1746584172844,AWP 10R,011,886184,Staff,0,0,0,0
1746584172844,AWP 10R,012,886185,Staff,0,0,0,0
1746584172844,AWP 10R,013,886186,Staff,0,0,0,0
1746584172844,AWP 10R,014,886187,Staff,0,0,0,0
1746584172844,AWP 10R,015,886188,Staff,0,0,0,0
1746584172844,AWP 10R,016,886189,Staff,0,0,0,0
1746584172844,AWP 10R,017,960532,Staff,0,0,0,0
1746584172844,AWP 10R,018,960533,Staff,0,0,0,0
1746584172844,AWP 10R,019,960534,Staff,0,0,0,0
1746584172844,AWP 10R,020,960538,Staff,0,0,0,0
1746584172844,AWP 10R,021,960540,Staff,0,0,0,0
1746584172844,AWP 10R,022,960541,Staff,0,0,0,0
1746584172844,AWP 10R,023,960542,Staff,0,0,0,0
1746584172844,AWP 10R,024,960544,Staff,0,0,0,0
1746584172844,AWP 10R,025,960545,Staff,0,0,0,0
1746584172844,AWP 10R,026,960548,Staff,0,0,0,0
1746584173869,AWP 102R,A00,886190,Staff,0,0,0,0
1746584173869,AWP 102R,B00,886191,Staff,0,0,0,0
1746584174898,BENG 100,A01,886193,Staff,17,0,30,13
1746584175925,BENG 122A,A01,886195,Hasty; Jeff M,13,0,30,17
1746584176955,BENG 166A,A00,886196,Sah; Robert Lie-Yuan,0,3,30,30
1746584177980,BENG 190,A00,958050,Khojah; Reem I,17,0,25,8
1746584179010,BIBC 102,A01,894320,Staff,0,0,46,46
1746584179010,BIBC 102,A02,894321,Staff,0,0,46,46
1746584179010,BIBC 102,A03,894344,Staff,6,0,46,40
1746584179010,BIBC 102,A04,894345,Staff,27,0,47,20
1746584180040,BICD 100R,A01,894365,Smith; Laurie,0,3,58,58
1746584180040,BICD 100R,A02,894366,Smith; Laurie,0,5,58,58
1746584180040,BICD 100R,A03,894367,Smith; Laurie,0,0,59,59
1746584180040,BICD 100R,A04,959869,Smith; Laurie,40,0,59,19
1746584181065,BICD 136,A01,894383,Gustafson-Brown; Cindy,14,0,50,36
1746584182090,BIEB 102,A01,894494,Butler; Shannon Rhey,51,0,130,79
1746584184144,BIEB 150,A01,894617,Wills; Christopher,3,0,20,17
1746584184144,BIEB 150,A02,894631,Wills; Christopher,3,0,20,17
1746584184144,BIEB 150,A03,894937,Wills; Christopher,3,0,20,17
1746584184144,BIEB 150,A04,894946,Wills; Christopher,5,0,20,15
1746584185171,BIEB 194,A00,906141,Kurle; Carolyn M.,5,0,20,15
1746584186201,BILD 1,A01,894154,Staff,3,0,19,16
1746584186201,BILD 1,A02,894155,Staff,14,0,19,5
1746584186201,BILD 1,A03,894160,Staff,13,0,19,6
1746584186201,BILD 1,A04,894161,Staff,15,0,18,3
1746584187230,BILD 2,A01,894168,Staff,0,0,50,50
1746584187230,BILD 2,A02,894169,Staff,0,0,50,50
1746584187230,BILD 2,A03,894179,Staff,0,0,50,50
1746584187230,BILD 2,A04,894203,Staff,24,0,50,26
1746584188254,BILD 3,A01,894213,Staff,23,0,31,8
1746584188254,BILD 3,A02,894214,Staff,26,0,31,5
1746584188254,BILD 3,A03,894235,Staff,28,0,31,3
1746584188254,BILD 3,A04,894236,Staff,28,0,32,4
1746584189282,BILD 4,A01,894253,Reuther; Keefe,5,0,24,19
1746584189282,BILD 4,A02,894258,Reuther; Keefe,16,0,24,8
1746584190306,BILD 5,A01,894276,Reuther; Keefe,35,0,50,15
1746584190306,BILD 5,A02,894277,Reuther; Keefe,45,0,50,5
1746584190306,BILD 5,A03,894290,Reuther; Keefe,44,0,50,6
1746584190306,BILD 5,A04,894291,Reuther; Keefe,48,0,50,2
1746584191331,BILD 24,A01,894297,Pirino; Giorgia,40,0,60,20
1746584192360,BIMM 100,B01,958915,Staff,71,0,100,29
1746584193388,BIMM 101,A01,895017,McDonnell; Lisa Marie,0,5,24,24
1746584193388,BIMM 101,A02,895018,McDonnell; Lisa Marie,0,5,24,24
1746584193388,BIMM 101,B01,895020,McDonnell; Lisa Marie,0,6,24,24
1746584193388,BIMM 101,B02,895021,McDonnell; Lisa Marie,0,4,24,24
1746584194416,BIMM 110,A01,895023,Staff,1,0,25,24
1746584194416,BIMM 110,A02,895024,Staff,9,0,25,16
1746584194416,BIMM 110,A03,895025,Staff,18,0,25,7
1746584194416,BIMM 110,A04,895031,Staff,20,0,25,5
1746584195445,BIMM 120,A01,895114,Gustafson-Brown; Cindy,14,0,28,14
1746584195445,BIMM 120,A02,895126,Gustafson-Brown; Cindy,21,0,27,6
1746584196470,BIPN 100,A01,895130,Yang; Mingyu,0,0,38,38
1746584196470,BIPN 100,A02,895131,Yang; Mingyu,31,0,38,7
1746584196470,BIPN 100,A03,895132,Yang; Mingyu,32,0,38,6
1746584196470,BIPN 100,A04,895133,Yang; Mingyu,27,0,36,9
1746584197517,BIPN 120,A01,895135,Cooke; James Edward,0,3,13,13
1746584197517,BIPN 120,A02,895136,Cooke; James Edward,0,1,13,13
1746584197517,BIPN 120,A03,895137,Cooke; James Edward,0,3,13,13
1746584197517,BIPN 120,A04,895156,Cooke; James Edward,0,2,11,11
1746584198544,BIPN 134,A01,895235,Cooke; James Edward,0,2,25,25
1746584198544,BIPN 134,A02,895237,Cooke; James Edward,0,0,25,25
1746584198544,BIPN 134,A03,895240,Cooke; James Edward,3,0,25,22
1746584198544,BIPN 134,A04,895270,Cooke; James Edward,20,0,25,5
1746584199570,BIPN 189,A00,892103,Staff,0,14,14,14
1746584201622,BISP 194,A00,958008,Staff,0,2,0,0
1746584202651,CAT 124,A01,922009,Staff,0,5,20,20
1746584203678,CAT 125R,A00,886390,Morales; Celeste Georgianna,0,2,20,20
1746584203678,CAT 125R,B00,886391,Irwin; Matthew Joseph,0,4,20,20
1746584203678,CAT 125R,C00,886392,Smith; Lauryn Alissa,0,2,20,20
1746584203678,CAT 125R,D00,886393,Vanderschuit; Maya Alysia,0,3,20,20
1746584203678,CAT 125R,E00,886394,Marchisotto; Jennifer Anne,0,3,20,20
1746584204708,CENG 15,A01,886218,Drews; Aaron,3,0,8,5
1746584205736,CENG 113,A00,886219,Opatkiewicz; Justin Paul,15,0,25,10
1746584206765,CGS 101,A00,887044,Staff,7,0,20,13
1746584207792,CGS 105,A01,887046,Staff,14,0,25,11
1746584208818,CGS 112,A00,887047,Cuong; Marisol,12,0,15,3
1746584209844,CGS 113,A00,887048,Staff,23,0,30,7
1746584210867,CGS 120,A00,887049,Staff,10,0,17,7
1746584211893,CHEM 6A,A01,886336,Lam; Tin Yiu,38,0,50,12
1746584211893,CHEM 6A,A02,886338,Lam; Tin Yiu,37,0,50,13
1746584212923,CHEM 6B,A01,886341,Hopkins; Patrycja Anna,16,0,50,34
1746584212923,CHEM 6B,A02,886343,Hopkins; Patrycja Anna,42,0,50,8
1746584213951,CHEM 6C,A01,886346,Albizati; Kim F.,0,2,50,50
1746584213951,CHEM 6C,A02,886348,Albizati; Kim F.,24,0,50,26
1746584214977,CHEM 40A,A01,886352,Klosterman; Jeremy K,65,0,100,35
1746584216002,CHEM 40B,A01,886356,Klosterman; Jeremy K,0,24,100,100
1746584217028,CHEM 41B,A01,886360,Theodorakis; Emmanuel,25,0,50,25
1746584217028,CHEM 41B,A02,886362,Theodorakis; Emmanuel,47,0,50,3
1746584218057,CHIN 165A,A00,886382,Xu; Li,18,0,20,2
1746584219081,CLAS 120,A00,886387,Myerston Santana; Jacobo,33,0,40,7
1746584220111,COGS 9,A01,886967,Shannon; Kyle Michael,42,0,60,18
1746584221136,COGS 11,A01,886969,Staff,9,0,30,21
1746584222161,COGS 14A,A01,886971,Staff,6,0,60,54
1746584223186,COGS 14B,A01,886973,Hoffman; Drew Ellen,4,0,60,56
1746584224209,COGS 18,A01,886975,Morgan; Eric,34,0,60,26
1746584225238,COGS 20,A01,886977,Staff,4,0,8,4
1746584225238,COGS 20,A02,886978,Staff,5,0,7,2
1746584226263,COGS 100,A01,907783,Staff,1,2,30,29
1746584227287,COGS 101B,A01,886980,Staff,0,4,48,48
1746584228319,COGS 101C,A01,886982,Delgado; Tania,0,5,44,44
1746584229347,COGS 102A,A01,886984,Johnson; Christine M.,3,0,30,27
1746584230375,COGS 118B,A01,886986,Staff,1,5,88,87
1746584231403,COGS 150,A01,886988,Bergen; Benjamin,22,0,50,28
1746584232433,COGS 153,A00,886989,Delgado; Tania,0,3,41,41
1746584233461,COGS 186,A01,886991,Staff,0,0,32,32
1746584234490,COGS 187A,A01,886993,Boyle; Mary E. T.,7,0,30,23
1746584235514,COGS 189,A00,886994,Staff,0,1,30,30
1746584236543,COMM 10,A01,886996,Staff,0,0,20,21
1746584236543,COMM 10,A02,886997,Staff,10,0,20,10
1746584236543,COMM 10,A03,959845,Staff,19,0,20,1
1746584237572,COMM 20,A01,886999,Leuning; Grant Maurstad,24,0,40,16
1746584239623,COMM 100A,A01,887002,Staff,0,0,20,25
1746584239623,COMM 100A,A02,887003,Staff,6,0,20,14
1746584240656,COMM 100B,A01,887005,Staff,0,8,20,24
1746584241738,COMM 106D,A00,887006,Staff,13,0,40,27
1746584242767,COMM 110G,A00,887007,Whitworth-Smith; Andrew C,12,0,40,28
1746584243794,COMM 111B,A00,887008,Staff,31,0,40,9
1746584244823,COMM 113T,A00,887009,Abuelhiga; Soraya Jill,28,0,40,12
1746584244823,COMM 113T,B00,906733,Staff,40,0,40,0
1746584245848,COMM 145,A00,887010,Staff,12,0,40,28
1746584246874,COMM 146,A00,887054,Staff,31,0,40,9
1746584247897,COMM 190,A00,887012,Staff,8,0,23,15
1746584248924,CSE 8A,A50,887015,Cao; Yingjun,57,0,85,28
1746584249951,CSE 11,A01,887017,Cao; Yingjun,12,0,70,58
1746584250975,CSE 20,A01,887019,Staff,30,0,50,20
1746584252001,CSE 21,A01,887021,Staff,78,0,100,22
1746584252001,CSE 21,B01,892583,Braun; Oliver,45,0,50,5
1746584253033,CSE 30,A01,887025,Eldon; John,142,0,200,58
1746584254056,CSE 100,A01,887027,Staff,26,0,50,24
1746584254056,CSE 100,A02,887028,Staff,42,0,50,8
1746584255085,CSE 101,A01,887030,Braun; Oliver,74,0,100,26
1746584255085,CSE 101,B01,887032,Jones; Miles E,0,3,50,50
1746584255085,CSE 101,B02,887033,Jones; Miles E,0,2,50,50
1746584256113,CSE 105,A01,908084,Jones; Miles E,32,0,50,18
1746584256113,CSE 105,A02,908087,Jones; Miles E,31,0,50,19
1746584257137,CSE 135,A01,887035,Powell; Thomas Allan,0,5,50,50
1746584258163,CSE 142,A01,887037,Staff,8,0,60,52
1746584259187,CSE 142L,A01,887039,Staff,34,0,60,26
1746584260212,CSE 151A,A01,887041,Solares; Edwin A,47,0,100,53
1746584261238,CSE 175,A01,887043,Kumar; Rakesh,30,0,30,0
1746584262264,CSS 1,A01,886389,Staff,1,2,40,39
1746584263289,DSC 30,A01,908097,Liao; Soohyun Nam,47,0,75,28
1746584264316,DSC 40A,A01,908099,Shannon; Kyle Michael,30,0,50,20
1746584265345,DSC 40B,A01,908112,Staff,15,0,50,35
1746584266369,DSC 80,A01,908116,Staff,19,0,60,41
1746584267410,DSC 197,001,956863,Eldridge; Justin Matthew,9999,0,9999,0
1746584268439,ECE 5,A01,886400,Morris; Karcher William,1,0,6,5
1746584268439,ECE 5,A02,886401,Morris; Karcher William,3,0,6,3
1746584269466,ECE 148,A01,886403,Silberman; Jack,0,14,14,14
1746584270496,ECON 1,A01,887265,Crane; Meredith Helen,12,0,70,58
1746584270496,ECON 1,B01,887268,Staff,42,0,50,8
1746584271526,ECON 2,A01,887273,Crane; Meredith Helen,55,0,70,15
1746584272609,ECON 3,A01,887279,Rondina; Giacomo,32,0,70,38
1746584273638,ECON 4,A01,887282,Anderson; John Charles,0,2,10,10
1746584274665,ECON 5,A01,887285,Staff,34,0,45,11
1746584274665,ECON 5,B01,887292,Staff,41,0,45,4
1746584275693,ECON 100A,A01,887337,Newhouse; Herbert S,54,0,70,16
1746584275693,ECON 100A,B01,887349,Staff,45,0,50,5
1746584276719,ECON 100B,A01,887361,Du; Songzi,29,0,70,41
1746584277747,ECON 100C,A01,887445,Newhouse; Herbert S,59,0,70,11
1746584278772,ECON 105,A00,887488,Vespa; Emanuel Ignacio,23,0,35,12
1746584279802,ECON 109,A01,887506,Shishkin; Denis,28,0,35,7
1746584280833,ECON 110A,A01,887568,Alon; Titan Michael,0,3,35,35
1746584280833,ECON 110A,B01,907601,Alon; Titan Michael,20,0,35,15
1746584281865,ECON 110B,A01,887598,Levkoff; Steven B.,0,24,70,70
1746584282891,ECON 112,A00,887599,Rondina; Giacomo,19,0,35,16
1746584283916,ECON 120A,A01,887603,Dai; Yinlin,35,0,70,35
1746584284946,ECON 120C,A01,887608,Sun; Yixiao,0,1,35,35
1746584284946,ECON 120C,B01,887614,Sun; Yixiao,0,0,35,35
1746584285973,ECON 138,A00,887621,Bharadwaj; Prashant,0,21,20,20
1746584287002,ECON 144,A00,958007,Squires; Dale E,12,0,35,23
1746584288028,ECON 171,A01,907666,Staff,18,0,35,17
1746584289055,ECON 175,A00,887626,Wu; Pak Yeung,22,0,35,13
1746584290081,ECON 190,A00,887640,Vespa; Emanuel Ignacio,22,0,35,13
1746584291109,EDS 25,A01,888197,Staff,0,0,0,0
1746584291109,EDS 25,A02,888209,Staff,0,0,0,0
1746584291109,EDS 25,A03,888210,Staff,0,0,0,0
1746584291109,EDS 25,A04,888212,Staff,0,0,0,0
1746584291109,EDS 25,A05,888213,Staff,0,0,0,0
1746584291109,EDS 25,A06,888214,Staff,0,0,0,0
1746584291109,EDS 25,A07,888235,Staff,0,2,0,0
1746584291109,EDS 25,A08,888236,Staff,0,0,0,0
1746584291109,EDS 25,A09,888240,Staff,0,0,0,0
1746584291109,EDS 25,A10,888244,Staff,0,0,0,0
1746584291109,EDS 25,B01,888273,Staff,0,0,0,0
1746584291109,EDS 25,B02,888285,Staff,0,0,0,0
1746584291109,EDS 25,B03,888423,Staff,0,0,0,1
1746584291109,EDS 25,B04,888432,Staff,0,0,0,0
1746584291109,EDS 25,B05,888433,Staff,0,0,0,0
1746584291109,EDS 25,B06,888467,Staff,0,0,0,0
1746584291109,EDS 25,B07,888468,Staff,0,0,0,0
1746584291109,EDS 25,B08,888479,Staff,0,0,0,0
1746584291109,EDS 25,B09,888484,Staff,0,0,0,0
1746584291109,EDS 25,B10,888487,Staff,0,0,0,0
1746584292139,EDS 38,A01,907700,Choi; Bailey Miyeon,30,0,30,0
1746584293163,EDS 112,A01,888601,Chapman; Thandeka K,12,0,40,28
1746584294192,EDS 115,A00,888697,Mendez; Kathrina Mendoza,10,0,30,20
1746584295217,EDS 116,A01,888893,Staff,34,0,40,6
1746584297267,EDS 124AR,A00,889133,Staff,29,0,50,21
1746584297267,EDS 124AR,B00,907471,Simon; Elizabeth A,37,0,50,13
1746584298292,EDS 124BR,A00,889134,Simon; Elizabeth A,44,0,100,56
1746584299317,EDS 125,A00,889135,Staff,25,0,30,5
1746584300349,EDS 126,A01,889138,Staff,35,0,40,5
1746584301377,EDS 164R,A01,889142,Wishard Guerra; Alison G.,32,0,50,18
1746584302406,ENG 30,A01,886396,Staff,0,0,0,0
1746584302406,ENG 30,B01,886398,Staff,0,0,0,0
1746584303433,ENVR 102,A00,906150,Montejo; Carolina,23,0,25,2
1746584304457,ETHN 103A,A00,887236,Man; Simeon S,0,3,0,0
1746584305484,ETHN 113,A00,887239,Staff,16,0,30,14
1746584306508,ETHN 116,A00,887240,Staff,16,0,25,9
1746584307534,ETHN 117,A00,887241,Choi; Esther Min,28,0,30,2
1746584308560,ETHN 118,A00,887243,Staff,24,0,30,6
1746584309589,ETHN 127,A00,887248,Cuong; Marisol,11,0,15,4
1746584310618,ETHN 139,A00,887250,Staff,7,0,10,3
1746584311643,ETHN 142,A00,887252,Staff,10,0,30,20
1746584312671,ETHN 161,A00,887253,Browne; Errol Tsekani,24,0,30,6
1746584313696,ETHN 163FR,A00,887255,Burelle; Julie Sara Veronique,0,0,5,5
1746584314722,GLBH 20,A00,889149,Elwardani; Nile Regina,8,0,42,34
1746584316776,GLBH 111,A01,889152,Burgos; Jose L.,17,0,17,0
1746584317802,GLBH 150,A00,889181,Sloane; Julia Kathryn,0,5,15,15
1746584319858,HDS 60,A01,886406,Warstadt; Melissa Fawn,73,0,80,7
1746584320882,HIAF 111,A00,889324,Gyamfi; Bright,25,0,32,7
1746584321906,HIEA 131,A00,889328,Staff,15,0,32,17
1746584322936,HIEA 144,A00,889333,Henry; Todd A.,26,0,32,6
1746584323961,HIEA 154,A00,889336,Henry; Todd A.,24,0,32,8
1746584324986,HIEU 106,A00,889339,Staff,22,0,32,10
1746584327036,HIEU 114,A00,889340,Staff,4,0,32,28
1746584328062,HIEU 135GS,A00,889342,Patterson; Patrick H.,0,0,1,24
1746584329088,HIEU 137,A00,889343,Edington; Claire Ellen,10,0,25,15
1746584330112,HIEU 148,A00,889345,Staff,14,0,32,18
1746584331139,HIEU 154,A00,889346,Biess; Frank Peter,21,0,32,11
1746584332165,HILA 102,A00,889351,Staff,12,0,32,20
1746584333189,HILD 2A,A01,889221,Lewandoski; Julia Mavis,1,10,32,31
1746584334215,HILD 7B,A01,889225,Man; Simeon S,0,12,32,32
1746584335239,HILD 7C,A01,889288,Alvarez; Luis A,0,14,32,32
1746584336264,HILD 30,A01,889323,Staff,0,5,32,32
1746584338317,HISC 119,A00,889383,Golan; Tal,19,0,32,13
1746584339346,HIUS 103,A00,889384,Man; Simeon S,0,0,32,32
1746584340374,HIUS 117,A00,919797,Kwak; Nancy,19,0,32,13
1746584341398,HIUS 142A,A00,919788,Staff,22,0,32,10
1746584343453,HIUS 149,A00,889386,Gyamfi; Bright,26,0,32,6
1746584344477,HIUS 155,A00,889387,Alvarez; Luis A,15,0,32,17
1746584345507,HUM 3,A01,886499,Caldwell; Michael Alan,19,0,50,31
1746584346534,HUM 3GS,A00,886500,Rodriguez; Bretton Sigfred,0,0,0,28
1746584347559,HUM 3R,A01,886502,Markman; Kristina,0,36,50,50
1746584348585,HUM 4,A01,886504,Crum; Matthew Stephen,23,0,50,27
1746584348585,HUM 4,B01,886506,West; Geoffrey Scott,17,0,50,33
1746584349612,HUM 4GS,A00,886507,Staff,0,0,0,19
1746584350637,HUM 5,A01,886509,Staff,32,0,50,18
1746584351668,HUM 5R,A01,886511,Zavodny; Tatiana Sophia,0,39,50,50
1746584352693,JAPN 180,A00,886407,Staff,16,0,40,24
1746584353718,LATI 50,A01,886409,Martin-Cabrera; Luis,3,0,22,19
1746584353718,LATI 50,A02,886410,Martin-Cabrera; Luis,19,0,22,3
1746584353718,LATI 50,A03,886411,Martin-Cabrera; Luis,21,0,22,1
1746584353718,LATI 50,A04,886412,Martin-Cabrera; Luis,8,0,22,14
1746584354746,LAWS 101,A00,907664,Staff,28,0,60,32
1746584355774,LIAB 1A,A00,889388,Saab; Dima,17,0,20,3
1746584356802,LIAB 1AX,A00,889389,El Cheddadi; Youniss,18,0,20,2
1746584357827,LIFR 1C,A00,889391,Van Moer; Vinciane G,8,0,20,12
1746584358853,LIFR 1CX,A00,889392,Van Moer; Vinciane G,7,0,20,13
1746584359882,LIFR 1D,A00,889393,Van Moer; Vinciane G,7,0,20,13
1746584360908,LIFR 1DX,A00,889394,Van Moer; Vinciane G,8,0,20,12
1746584361937,LIGN 7,A00,886923,Staff,24,0,50,26
1746584362962,LIGN 17,A00,886924,Kehler; Andrew Scott,125,0,150,25
1746584363986,LTAM 110,A00,889395,Staff,15,0,30,15
1746584365014,LTAM 110GS,A00,958010,Rodriguez; Bretton Sigfred,0,0,0,28
1746584366042,LTCH 101,A00,889397,Staff,23,0,25,2
1746584367068,LTCS 130,A00,889398,Staff,23,0,25,2
1746584368093,LTEA 138,A00,889399,Staff,24,0,40,16
1746584369122,LTEN 149,A00,889400,Wesling; Megan E.,0,3,25,25
1746584370146,LTEN 169,A00,889401,Staff,20,0,25,5
1746584371174,LTEN 180,A00,889402,Staff,10,0,15,5
1746584372202,LTEN 181,A00,889403,Staff,21,0,25,4
1746584373229,LTWL 100,A00,889404,Myerston Santana; Jacobo,2,0,25,23
1746584374254,LTWL 180GS,A00,889405,Staff,0,0,20,20
1746584375282,LTWL 181,A00,889406,Staff,16,0,25,9
1746584376307,LTWL 184,A00,889475,Mukherjee; Silpa,22,0,25,3
1746584377331,LTWR 102C,A00,889486,Staff,29,0,30,1
1746584378358,LTWR 115W,A00,889491,Staff,0,2,15,15
1746584379382,MAE 8,A01,886905,Staff,0,2,0,0
1746584380407,MAE 11,A00,886906,Bandaru; Prabhakar,0,7,50,50
1746584381431,MAE 20,A00,886907,Evdokimenko; Ekaterina,43,0,70,27
1746584382457,MAE 30B,A00,886909,Ghazinejad; Maziar,26,0,45,19
1746584383488,MAE 101B,A00,886910,Saintillan; David,29,0,45,16
1746584384514,MAE 105,A00,886911,Bandaru; Prabhakar,18,0,50,32
1746584385544,MAE 107,B00,958024,Staff,7,0,50,43
1746584386570,MAE 143B,A00,886913,Bewley; Thomas R,3,0,40,37
1746584387598,MAE 148,A01,886915,Silberman; Jack,0,3,14,14
1746584388623,MAE 160,A00,886916,Evdokimenko; Ekaterina,31,0,60,29
1746584389650,MATH 3C,A01,889681,Staff,0,2,30,30
1746584389650,MATH 3C,A02,960048,Staff,24,0,30,6
1746584390686,MATH 10A,A01,889760,Staff,26,0,30,4
1746584390686,MATH 10A,A02,889783,Staff,29,0,30,1
1746584391718,MATH 10B,A01,889785,Verstraete; Jacques Allan,1,0,35,34
1746584391718,MATH 10B,A02,889795,Verstraete; Jacques Allan,4,0,35,31
1746584391718,MATH 10B,B01,889797,Verstraete; Jacques Allan,3,0,35,32
1746584391718,MATH 10B,B02,889828,Verstraete; Jacques Allan,3,0,35,32
1746584392744,MATH 10C,A01,889849,Habib; Yousaf,7,0,30,23
1746584392744,MATH 10C,A02,889852,Habib; Yousaf,14,0,30,16
1746584392744,MATH 10C,A03,889853,Habib; Yousaf,22,0,30,8
1746584392744,MATH 10C,A04,889858,Habib; Yousaf,20,0,30,10
1746584392744,MATH 10C,B01,889861,Staff,1,0,30,29
1746584392744,MATH 10C,B02,889862,Staff,24,0,30,6
1746584392744,MATH 10C,B03,889863,Staff,27,0,30,3
1746584392744,MATH 10C,B04,889967,Staff,23,0,30,7
1746584393771,MATH 18,A01,889974,Staff,7,0,30,23
1746584393771,MATH 18,A02,889977,Staff,20,0,30,10
1746584393771,MATH 18,B01,889984,Hardiman; Liam,20,0,30,10
1746584393771,MATH 18,B02,889985,Hardiman; Liam,25,0,30,5
1746584394799,MATH 20A,A01,889990,Suk; Andrew Hoon,30,0,35,5
1746584395831,MATH 20B,A01,889993,Ohm; Ko Woon,21,0,30,9
1746584395831,MATH 20B,A02,889994,Ohm; Ko Woon,30,0,30,0
1746584395831,MATH 20B,B01,889996,Ohm; Ko Woon,22,0,30,8
1746584395831,MATH 20B,B02,889997,Ohm; Ko Woon,23,0,30,7
1746584396858,MATH 20C,A01,889999,Hammock; Frances H,17,0,30,13
1746584396858,MATH 20C,A02,890003,Hammock; Frances H,23,0,30,7
1746584396858,MATH 20C,B01,890006,Hammock; Frances H,3,0,30,27
1746584396858,MATH 20C,B02,890007,Hammock; Frances H,12,0,30,18
1746584397886,MATH 20D,A01,890011,Cheng; Hsiao-Bing,1,1,30,29
1746584397886,MATH 20D,A02,890012,Cheng; Hsiao-Bing,14,0,30,16
1746584397886,MATH 20D,B01,890016,Cheng; Hsiao-Bing,13,0,30,17
1746584397886,MATH 20D,B02,890017,Cheng; Hsiao-Bing,13,0,30,17
1746584398915,MATH 20E,A01,890026,Harel; Guershon,1,0,30,29
1746584398915,MATH 20E,A02,890029,Harel; Guershon,22,0,30,8
1746584398915,MATH 20E,B01,890033,Harel; Guershon,7,0,30,23
1746584398915,MATH 20E,B02,890101,Harel; Guershon,21,0,30,9
1746584399940,MATH 102,A01,890104,Staff,18,0,30,12
1746584399940,MATH 102,A02,890105,Staff,27,0,30,3
1746584400969,MATH 103B,A01,890116,Salehi Golsefidy; Alireza,3,0,30,27
1746584400969,MATH 103B,B01,890118,Staff,0,3,34,34
1746584401995,MATH 109,A01,890121,Aliabadi Sr.; Mohsen,0,0,30,30
1746584401995,MATH 109,B01,890124,Upadrashta; Pranav Kumar,18,0,30,12
1746584403025,MATH 120A,A01,890126,Eggers; John Dietrich,13,0,30,17
1746584404052,MATH 142B,A01,890128,Ioana; Adrian,19,0,30,11
1746584404052,MATH 142B,A02,890129,Ioana; Adrian,12,0,30,18
1746584405075,MATH 154,A01,890174,Staff,0,1,30,30
1746584405075,MATH 154,A02,890182,Staff,0,0,30,30
1746584406100,MATH 168A,A01,890197,Dumitriu; Ioana,21,0,35,14
1746584407126,MATH 170A,A01,890240,Nie; Jiawang,1,0,30,29
1746584407126,MATH 170A,A02,890241,Nie; Jiawang,11,0,30,19
1746584407126,MATH 170A,A03,890249,Nie; Jiawang,23,0,30,7
1746584408154,MATH 170B,A01,957891,Nag; Panchali,13,0,35,22
1746584410203,MATH 181A,A01,908025,Staff,0,3,35,35
1746584410203,MATH 181A,A02,960115,Staff,26,0,35,9
1746584411226,MATH 181B,A01,959874,Staff,25,0,30,5
1746584412256,MATH 193B,A01,890265,Staff,0,4,35,35
1746584413284,MGT 4,A01,890311,Anderson; John Charles,42,0,88,46
1746584414308,MGT 5,A00,907740,Staff,13,0,98,85
1746584415334,MGT 12,A00,890312,Lindenberger; Wade Douglas,67,0,98,31
1746584416358,MGT 16,A00,957883,Staff,78,0,98,20
1746584418412,MGT 45,A00,890314,Pecore; Joseph P.,45,0,98,53
1746584419437,MGT 71,A00,890315,Staff,0,12,98,98
1746584420461,MGT 100,A00,890316,Yavorsky; Daniel Ryan,44,0,98,54
1746584421489,MGT 103,A00,890317,Ehrich; Kristine R,73,0,98,25
1746584422515,MGT 105,A00,890356,Bates; Kenneth Walter,0,8,98,98
1746584423541,MGT 112,A00,890360,Ehrich; Kristine R,55,0,98,43
1746584424565,MGT 127R,A00,907732,Zhu; Kevin Xiaoguo,23,0,98,75
1746584425591,MGT 131B,A00,890361,Anderson; John Charles,59,0,98,39
1746584426618,MGT 137,A00,890362,Lindenberger; Wade Douglas,65,0,98,33
1746584427646,MGT 160,A00,890369,Johnson; Erik Barry,9,0,98,89
1746584429695,MGT 164,A00,890372,Zimmermann; Carsten,0,40,98,98
1746584430723,MGT 180,A00,890374,Bliss; Barbara Ann,12,0,98,86
1746584431753,MMW 15,A01,886414,Chang; Edmond Yi-Teh,0,12,28,28
1746584431753,MMW 15,A02,886415,Chang; Edmond Yi-Teh,0,8,28,28
1746584431753,MMW 15,A03,886416,Chang; Edmond Yi-Teh,0,9,28,28
1746584431753,MMW 15,A04,886417,Chang; Edmond Yi-Teh,0,8,28,28
1746584431753,MMW 15,B01,886419,Chang; Edmond Yi-Teh,0,7,28,28
1746584431753,MMW 15,B02,886420,Chang; Edmond Yi-Teh,0,8,28,28
1746584431753,MMW 15,B03,886421,Chang; Edmond Yi-Teh,0,7,28,28
1746584431753,MMW 15,B04,886422,Chang; Edmond Yi-Teh,0,8,28,28
1746584431753,MMW 15,C01,886424,Staff,0,9,28,28
1746584431753,MMW 15,C02,886425,Staff,0,8,28,28
1746584431753,MMW 15,C03,886426,Staff,0,8,28,28
1746584431753,MMW 15,C04,886427,Staff,0,8,28,28
1746584431753,MMW 15,C05,958038,Staff,0,8,28,28
1746584431753,MMW 15,C06,958039,Staff,1,8,28,27
1746584432779,MMW 15GS,A00,906910,Patterson; Patrick H.,4,0,28,24
1746584433805,MMW 122R,A01,886429,Rahimi; Babak,0,13,28,28
1746584433805,MMW 122R,A02,886430,Rahimi; Babak,0,12,28,28
1746584433805,MMW 122R,A03,958040,Rahimi; Babak,0,11,28,28
1746584434833,MUS 1A,A01,890937,Staff,2,0,25,23
1746584434833,MUS 1A,A02,891035,Staff,6,0,25,19
1746584434833,MUS 1A,C01,958912,Staff,24,0,25,1
1746584434833,MUS 1A,C02,958913,Staff,25,0,25,0
1746584436889,MUS 2AK,A00,957092,Ohnishi; Takae,15,0,15,0
1746584437919,MUS 4,A01,891044,Staff,1,0,25,24
1746584437919,MUS 4,A02,891045,Staff,23,0,25,2
1746584437919,MUS 4,B01,891048,Staff,17,0,25,8
1746584437919,MUS 4,B02,891050,Staff,25,0,25,0
1746584438946,MUS 5,A01,957506,Dubnov; Shlomo,0,0,25,25
1746584438946,MUS 5,A02,957622,Dubnov; Shlomo,13,0,25,12
1746584438946,MUS 5,A03,957623,Dubnov; Shlomo,20,0,25,5
1746584439970,MUS 6,A01,891053,Freitas Caetano; Marcelo,24,0,25,1
1746584439970,MUS 6,A02,891054,Freitas Caetano; Marcelo,23,0,25,2
1746584440998,MUS 7,A01,891081,Staff,0,0,25,25
1746584440998,MUS 7,A02,891082,Staff,3,0,25,22
1746584442023,MUS 8GS,A00,891118,Borgo; David Garcia,1,0,25,24
1746584443049,MUS 11,A01,891140,Staff,9,0,25,16
1746584443049,MUS 11,A02,891141,Staff,21,0,25,4
1746584444075,MUS 13,A01,891143,Staff,8,0,25,17
1746584444075,MUS 13,A02,891144,Staff,24,0,25,1
1746584445104,MUS 15,A01,891146,Staff,9,0,25,16
1746584445104,MUS 15,A02,891148,Staff,21,0,25,4
1746584445104,MUS 15,B01,891150,Staff,18,0,25,7
1746584445104,MUS 15,B02,891151,Staff,25,0,25,0
1746584446128,MUS 20,A01,891153,Staff,5,0,20,15
1746584446128,MUS 20,A02,891155,Staff,14,0,20,6
1746584447156,MUS 80,A00,891156,Staff,19,0,25,6
1746584447156,MUS 80,B00,891157,Staff,23,0,25,2
1746584448180,MUS 130,A00,891158,Ohnishi; Takae,35,0,35,0
1746584449207,MUS 150GS,A01,891160,Borgo; David Garcia,1,0,25,24
1746584450237,MUS 170,A01,891162,Freitas Caetano; Marcelo,20,0,25,5
1746584450237,MUS 170,A02,891164,Freitas Caetano; Marcelo,21,0,25,4
1746584451266,NANO 11,A00,886220,Vazquez Mena; Oscar,13,0,15,2
1746584452290,NANO 15,A01,886222,Drews; Aaron,4,0,7,3
1746584453319,NANO 104,A00,886224,Sirbuly; Donald,17,0,25,8
1746584454345,PH 40,A00,886528,Staff,24,0,40,16
1746584455370,PH 45,A01,886799,Staff,35,0,40,5
1746584456398,PH 110,A00,886802,Staff,0,7,40,40
1746584457422,PH 172,A00,906716,Staff,19,0,35,16
1746584458452,PH 191,A00,886803,Staff,6,0,40,34
1746584459480,PHIL 1,A00,889500,Staff,20,0,30,10
1746584460510,PHIL 10,A01,889549,Grush; Rick Scott,16,0,22,6
1746584460510,PHIL 10,A02,889551,Grush; Rick Scott,22,0,22,0
1746584461539,PHIL 28,A01,889559,Lamey; Andy M.,0,2,31,31
1746584461539,PHIL 28,A02,889561,Lamey; Andy M.,0,1,30,30
1746584461539,PHIL 28,A03,889572,Lamey; Andy M.,0,1,30,30
1746584462565,PHIL 35,A00,907839,Staff,13,0,15,2
1746584463589,PHIL 60,A00,889574,Staff,73,0,90,17
1746584464617,PHIL 101,A00,958004,Staff,12,0,15,3
1746584466667,PHIL 136,A00,889582,Fulkerson; Matthew Todd,26,0,45,19
1746584467693,PHIL 163,A01,889601,Staff,21,0,30,9
1746584467693,PHIL 163,B01,889606,Brandt; Reuven A,0,3,0,0
1746584468721,PHIL 164,A00,889610,Staff,16,0,30,14
1746584469748,PHIL 165,A00,889613,Staff,22,0,30,8
1746584470772,PHYS 1A,A00,886431,Staff,29,0,70,41
1746584471802,PHYS 1AL,001,886432,Tsai; Philbert S,1,2,30,29
1746584471802,PHYS 1AL,002,886436,Tsai; Philbert S,12,0,30,18
1746584472829,PHYS 1B,A00,886439,Staff,184,0,240,56
1746584473854,PHYS 1BL,001,886441,Tsai; Philbert S,0,4,30,30
1746584473854,PHYS 1BL,002,886444,Tsai; Philbert S,2,0,30,28
1746584474879,PHYS 1C,A00,896092,Arnold; Kam S,78,0,146,68
1746584475906,PHYS 1CL,001,886448,Tsai; Philbert S,0,0,30,30
1746584475906,PHYS 1CL,002,886449,Tsai; Philbert S,1,0,30,29
1746584475906,PHYS 1CL,003,886450,Tsai; Philbert S,16,0,30,14
1746584475906,PHYS 1CL,004,886451,Tsai; Philbert S,15,0,30,15
1746584476932,PHYS 2B,A01,886457,Staff,67,0,115,48
1746584477957,PHYS 2C,A01,886460,Shotwell; Brian,0,9,65,65
1746584478981,PHYS 2CL,A01,886467,Staff,0,4,28,28
1746584478981,PHYS 2CL,A02,886468,Staff,0,3,28,28
1746584480007,PHYS 2D,A01,886470,Staff,10,0,50,40
1746584481033,PHYS 4B,A01,886475,Grinstein; Benjamin,22,0,40,18
1746584482060,POLI 5,A00,891173,Desposato; Scott,7,0,25,18
1746584483086,POLI 5D,A01,891175,Staff,5,0,5,0
1746584483086,POLI 5D,B01,891178,Staff,5,0,5,0
1746584484110,POLI 11,A00,891179,Ferree; Karen E,2,0,35,33
1746584485138,POLI 12,A00,891180,Staff,16,0,30,14
1746584486162,POLI 27,A01,891182,Staff,12,0,75,63
1746584487187,POLI 30,A00,891183,Staff,8,0,50,42
1746584488216,POLI 100B,A00,891244,Staff,5,1,35,30
1746584489241,POLI 100I,A00,891247,Staff,7,0,30,23
1746584490269,POLI 104J,A00,891248,Nichter; Maysa,14,0,30,16
1746584491293,POLI 104U,A00,891250,Nichter; Maysa,1,0,30,29
1746584493346,POLI 110B,A00,891255,Wiens; David,19,0,25,6
1746584494372,POLI 112A,A00,891256,Wiens; David,6,0,25,19
1746584495397,POLI 114BR,A00,891261,Staff,19,0,30,11
1746584496421,POLI 117R,A00,891262,Forman; Fonna,0,6,50,50
1746584497445,POLI 118,A00,891264,Ingham; Sean,17,0,25,8
1746584498471,POLI 124A,A00,891265,Staff,18,0,20,2
1746584499498,POLI 125D,A00,891266,Nichter; Simeon C,2,0,25,23
1746584500523,POLI 126,A00,891268,Nichter; Simeon C,7,0,25,18
1746584501552,POLI 126AA,A00,891272,Staff,15,0,25,10
1746584502578,POLI 130AA,A00,891273,Staff,15,0,20,5
1746584503603,POLI 134AA,A00,891274,Staff,4,0,20,16
1746584505653,POLI 138,A00,891278,Staff,21,0,25,4
1746584506679,POLI 142K,A00,891280,Staff,10,0,25,15
1746584507706,POLI 142M,A00,891281,Gartzke; Erik,16,0,30,14
1746584508732,POLI 142P,A00,891284,Staff,20,0,30,10
1746584509757,POLI 143,A00,891285,Gartzke; Erik,12,0,30,18
1746584510784,POLI 153,A00,891286,Staff,19,0,20,1
1746584512833,POLI 175,A00,891290,Staff,15,0,20,5
1746584513862,PSYC 1,A00,890674,Steiner; Eric Tomas,0,11,45,45
1746584514887,PSYC 2,A00,890676,Albright; Thomas D,20,0,35,15
1746584515915,PSYC 3,A00,890679,Staff,17,0,20,3
1746584516944,PSYC 6,A00,959858,Staff,19,0,20,1
1746584517971,PSYC 60,A01,890684,Rickard; Timothy C.,0,5,45,45
1746584518995,PSYC 70,A01,890689,Geller; Emma Harlan,6,0,30,24
1746584520025,PSYC 71,A01,959860,Staff,21,0,25,4
1746584521049,PSYC 100,A00,890690,Lacefield; Katharine I,0,50,180,180
1746584522078,PSYC 102,A00,890695,Staff,18,0,40,22
1746584523102,PSYC 105,A00,890699,Geller; Emma Harlan,70,0,100,30
1746584524130,PSYC 106,A00,890701,Gorman; Michael R.,5,0,30,25
1746584525159,PSYC 108,A00,890704,Adrian; Julia Anna,0,28,50,50
1746584526184,PSYC 118,A01,890712,Staff,11,0,30,19
1746584527208,PSYC 124,A00,890716,Chapman; Eddie Nathaniel,25,0,60,35
1746584528232,PSYC 131,A00,890717,Anagnostaras; Stephan,0,7,80,80
1746584529262,PSYC 137,A00,890719,Winkielman; Piotr,0,11,30,30
1746584530293,PSYC 144,A00,890721,Adrian; Julia Anna,0,9,45,45
1746584531317,PSYC 162,A00,890805,Staff,0,1,75,75
1746584532343,PSYC 169,A00,890810,Staff,0,15,30,30
1746584533368,PSYC 172,A00,890814,Gorman; Michael R.,9,0,30,21
1746584534397,PSYC 181,A00,890818,Anagnostaras; Stephan,7,0,200,193
1746584535426,PSYC 184,A00,959861,Staff,164,0,175,11
1746584536450,PSYC 189,A00,890823,Staff,0,2,30,30
1746584537474,PSYC 191,A00,890884,Rickard; Timothy C.,0,12,35,35
1746584538499,PSYC 193,A00,890913,Staff,19,0,30,11
1746584538499,PSYC 193,B00,890914,Chapman; Eddie Nathaniel,24,0,30,6
1746584539530,PSYC 193L,A01,890918,Lowe; Angela Beth,20,0,30,10
1746584539530,PSYC 193L,B01,890921,Hurwitz; Ethan Scott,20,0,30,10
1746584539530,PSYC 193L,C01,890928,Staff,30,0,30,0
1746584540554,RELI 149,A00,886806,Rahimi; Babak,23,0,40,17
1746584541579,SE 9,A01,886814,Staff,7,0,20,13
1746584542609,SE 101B,A01,886816,Chadha; Mayank,4,0,35,31
1746584543635,SE 110B,A00,886818,Zhu; Qiang,4,0,75,71
1746584544662,SE 125,A01,886830,Staff,10,0,30,20
1746584545688,SE 130B,A01,886835,Staff,14,0,40,26
1746584546713,SE 131A,A01,886838,Krysl; Petr,34,0,55,21
1746584547737,SE 154,A00,886840,Staff,28,0,50,22
1746584548763,SE 164GS,A01,886849,Staff,6,0,20,14
1746584549788,SE 167GS,A01,886853,Staff,6,0,20,14
1746584550815,SIO 25,A01,890107,Staff,19,0,30,11
1746584551841,SIO 45,A00,890109,Cook; Geoffrey W,116,0,200,84
1746584552866,SIO 109R,A00,890110,Forman; Fonna,0,16,20,20
1746584553895,SIO 187,A01,890114,Kacev; David,15,0,40,25
1746584554923,SOCI 1,A01,890431,Thorpe; Charles Robert,14,0,30,16
1746584554923,SOCI 1,A02,890518,Thorpe; Charles Robert,30,0,30,0
1746584555953,SOCI 2,A01,957978,Staff,25,0,25,0
1746584555953,SOCI 2,A02,957979,Staff,23,0,25,2
1746584556977,SOCI 20,A01,890523,Calderon-Zaks; Michael Aar,21,0,30,9
1746584556977,SOCI 20,A02,890526,Calderon-Zaks; Michael Aar,29,0,30,1
1746584558006,SOCI 30,A01,890533,Pardo Guerra; Juan Pablo,37,0,40,3
1746584559030,SOCI 40,A01,890535,Staff,27,0,45,18
1746584560056,SOCI 104Q,A00,890559,Staff,18,0,30,12
1746584561083,SOCI 106,A00,890560,Arnal; Maud Marie Leonie,20,0,30,10
1746584562111,SOCI 110,A00,890567,Holkenbrink-Monk; Charlene,19,0,30,11
1746584563136,SOCI 112,A00,890568,Victoria Torres; Pablo,2,0,55,53
1746584564162,SOCI 115,A00,890597,Arnal; Maud Marie Leonie,28,0,45,17
1746584566219,SOCI 121,A00,890604,Pardo Guerra; Juan Pablo,38,0,45,7
1746584567246,SOCI 126,A01,890608,Staff,8,0,10,2
1746584568275,SOCI 127,A00,890609,Staff,18,0,30,12
1746584569301,SOCI 131,A00,890610,Thorpe; Charles Robert,37,0,45,8
1746584570326,SOCI 135,A00,890615,Payne; Christine Anna,13,0,45,32
1746584571353,SOCI 139,A00,890620,Staff,38,0,45,7
1746584572377,SOCI 148E,A00,890622,Calderon-Zaks; Michael Aar,36,0,45,9
1746584573403,SOCI 150,A00,890623,Kohler; Kristopher M.,31,0,45,14
1746584574431,SOCI 157,A00,890625,Jules-Rosette; Bennetta W.,18,0,20,2
1746584575456,SOCI 160,A00,890627,Payne; Christine Anna,21,0,45,24
1746584576480,SYN 1,A00,886855,Fish; Gwendolyn Anne,0,1,0,0
1746584576480,SYN 1,B00,906086,Fish; Gwendolyn Anne,0,2,0,2
1746584577506,SYN 2R,A00,886860,Staff,0,17,15,15
1746584577506,SYN 2R,B00,906106,Atkinson; Arthur Laird,0,16,15,15
1746584578532,SYN 100,A01,886866,Browne; Emily,0,28,20,20
1746584578532,SYN 100,B01,906128,Rock; Martin,0,4,20,20
1746584578532,SYN 100,C01,906140,Deavenport; James Cary,0,4,20,20
1746584578532,SYN 100,D01,907816,Deavenport; James Cary,0,5,20,20
1746584579561,TDAC 1,A00,890286,Walsh; Kim C.,7,0,20,13
1746584580588,TDAC 101,A00,890296,Basso; Beatrice,15,0,20,5
1746584581614,TDDE 131,A00,890297,Staff,47,0,50,3
1746584582641,TDDM 1,A00,890287,Weinberg; Sadie,25,0,30,5
1746584583670,TDGE 11,A00,890288,Fulton; Julia,138,0,200,62
1746584583670,TDGE 11,B00,890289,Castro; Robert Jess,184,0,200,16
1746584584694,TDGE 25,B00,957359,Walsh; Kim C.,5,0,20,15
1746584585721,TDGE 40,A01,890292,Power; Jade Yukana,27,0,30,3
1746584586746,TDGE 124,A00,890298,Havis; Allan,0,1,50,50
1746584587770,TDGE 131R,A00,890299,Burelle; Julie Sara Veronique,15,0,42,27
1746584588796,TDHT 101,A00,890300,Staff,10,0,20,10
1746584589826,TDHT 109,A01,890302,Anderson; Mysia Anyse,31,0,40,9
1746584590851,TDMV 1,A00,890293,Arcidiacono; Kristin,18,0,30,12
1746584591878,TDMV 2,A00,890294,Weinberg; Sadie,23,0,30,7
1746584592907,TDMV 3,A00,957878,Arcidiacono; Kristin,28,0,30,2
1746584594954,TDMV 138,A00,890304,Jun; Grace Shin Hae,25,0,40,15
1746584595981,TDMV 140,A00,890305,Corrales; Joseph Bernales,25,0,30,5
1746584597005,TDMV 142,A00,890307,Caligagan; Tony,32,0,40,8
1746584598034,TDMV 144,A00,890308,Camaya; Michelle Ann,25,0,30,5
1746584599057,TDPW 1,A00,890295,Stein; Deborah Isobel,3,0,20,17
1746584600087,USP 2,A01,890272,Lerner; Amy M,7,0,20,13
1746584601111,USP 3,A01,890274,Staff,12,0,30,18
1746584602136,USP 15,A01,890276,Sun; Feiyang,16,0,30,14
1746584603159,USP 25,A00,890277,Shenkman; Michael Thomas,18,0,25,7
1746584604183,USP 138,A00,890278,Staff,13,0,25,12
1746584605207,USP 143,A00,890279,Staff,22,0,70,48
1746584606237,USP 144,A00,890280,Chowdhury; Muhammed Zohir,16,0,30,14
1746584607261,USP 150,A00,890281,Boomhower; Matthew Charles,4,0,30,26
1746584608286,USP 151,A00,890282,Staff,16,0,20,4
1746584609312,USP 162,A00,890283,Andrews; Abigail Leslie,16,0,20,4
1746584610336,USP 168,A00,920477,Kwak; Nancy,0,0,5,5
1746584611364,USP 181,A00,890284,Staff,3,0,20,17
1746584612387,USP 191A,A00,890285,Staff,12,0,20,8
1746584613411,VIS 101,A00,886512,Staff,26,0,75,49
1746584614434,VIS 103,A00,886513,Cruz; Edwin Teddy,61,0,75,14
1746584615460,VIS 108,A00,886514,Staff,3,0,15,12
1746584616485,VIS 127P,A00,886515,Shen; Kuiyi,79,0,146,67
1746584617512,VIS 149,A00,886516,Yoldas; Pinar,0,0,15,15
1746584618538,VIS 164,A00,886526,Erdmann; Dean,19,0,22,3
1746584619565,VIS 194S,A00,886527,Staff,61,0,75,14
1746584620595,WCWP 10A,C00,886484,Martiniuk; Jill,12,0,15,3
1746584621620,WCWP 10B,A00,886490,Uriarte; Emma,0,0,15,15
1746584621620,WCWP 10B,B00,886491,Dhir; Simrita,8,0,15,7
1746584621620,WCWP 10B,C00,886492,Ornelas; Tricia,0,0,15,15
1746584622646,WCWP 100,A00,886494,Young; Mark T,0,6,15,15
1746584624748,AAS 10,A01,886199,Childs; Dennis R.,0,3,0,0
1746584625773,ANAR 104,A01,886940,Shtienberg; Gilad,27,0,30,3
1746584626797,ANAR 120,A00,886953,Staff,13,0,20,7
1746584627823,ANBI 148,A01,886955,Wilder; Linnea Lorene,30,0,40,10
1746584629879,ANSC 122,A00,886957,Staff,24,0,30,6
1746584630902,ANSC 150,A00,886958,Sloane; Julia Kathryn,2,0,15,13
1746584631932,ANSC 156,A00,886959,Jenkins; Janis A.,0,1,15,15
1746584632960,ANSC 180,A00,886960,Staff,11,0,17,6
1746584633984,ANSC 188,A00,886961,Jassal; Aftab,9,0,25,16
1746584635009,ANSC 190,A00,886962,Jassal; Aftab,14,0,25,11
1746584636035,ANSC 191,A00,886963,Staff,18,0,20,2
1746584637060,ANTH 3,A01,891689,Staff,17,0,20,3
1746584638085,ANTH 5,A00,886933,Semendeferi; Ekaterini,16,0,20,4
1746584639115,ANTH 10,A00,886934,Staff,0,12,30,30
1746584640139,ANTH 21,A01,886936,Staff,41,0,60,19
1746584641167,ANTH 23,A01,886938,Staff,92,0,100,8
1746584642199,ANTH 105,A00,886964,Stewart; Alexander B,84,0,100,16
1746584643227,ANTH 108,A00,886965,Pedersen; David,9,0,20,11
1746584644263,AWP 10,001,886147,Staff,0,0,0,0
1746584644263,AWP 10,002,886148,Staff,0,0,0,0
1746584644263,AWP 10,003,886149,Staff,0,0,0,0
1746584644263,AWP 10,004,886150,Staff,0,0,0,0
1746584644263,AWP 10,005,886151,Staff,0,0,0,0
1746584644263,AWP 10,006,886152,Staff,0,0,0,0
1746584644263,AWP 10,007,886153,Staff,0,0,0,0
1746584644263,AWP 10,008,886154,Staff,0,0,0,0
1746584644263,AWP 10,009,886155,Staff,0,0,0,0
1746584644263,AWP 10,010,886156,Staff,0,0,0,0
1746584644263,AWP 10,011,886158,Staff,0,0,0,0
1746584644263,AWP 10,012,886160,Staff,0,0,0,0
1746584644263,AWP 10,013,886161,Staff,0,0,0,0
1746584644263,AWP 10,014,886162,Staff,0,0,0,0
1746584644263,AWP 10,015,886163,Staff,0,0,0,0
1746584644263,AWP 10,016,886164,Staff,0,0,0,0
1746584644263,AWP 10,017,886165,Staff,0,0,0,0
1746584644263,AWP 10,018,886166,Staff,0,0,0,0
1746584644263,AWP 10,019,886168,Staff,0,0,0,0
1746584644263,AWP 10,020,886170,Staff,0,0,0,0
1746584644263,AWP 10,021,886172,Staff,0,0,0,0
1746584645298,AWP 10R,001,886173,Staff,0,1,0,0
1746584645298,AWP 10R,002,886174,Staff,0,1,0,0
1746584645298,AWP 10R,003,886175,Staff,0,0,0,0
1746584645298,AWP 10R,004,886176,Staff,0,0,0,0
1746584645298,AWP 10R,005,886177,Staff,0,0,0,0
1746584645298,AWP 10R,006,886178,Staff,0,0,0,0
1746584645298,AWP 10R,007,886179,Staff,0,0,0,0
1746584645298,AWP 10R,008,886181,Staff,0,0,0,0
1746584645298,AWP 10R,009,886182,Staff,0,0,0,0
1746584645298,AWP 10R,010,886183,Staff,0,0,0,0
1746584645298,AWP 10R,011,886184,Staff,0,0,0,0
1746584645298,AWP 10R,012,886185,Staff,0,0,0,0
1746584645298,AWP 10R,013,886186,Staff,0,0,0,0
1746584645298,AWP 10R,014,886187,Staff,0,0,0,0
1746584645298,AWP 10R,015,886188,Staff,0,0,0,0
1746584645298,AWP 10R,016,886189,Staff,0,0,0,0
1746584645298,AWP 10R,017,960532,Staff,0,0,0,0
1746584645298,AWP 10R,018,960533,Staff,0,0,0,0
1746584645298,AWP 10R,019,960534,Staff,0,0,0,0
1746584645298,AWP 10R,020,960538,Staff,0,0,0,0
1746584645298,AWP 10R,021,960540,Staff,0,0,0,0
1746584645298,AWP 10R,022,960541,Staff,0,0,0,0
1746584645298,AWP 10R,023,960542,Staff,0,0,0,0
1746584645298,AWP 10R,024,960544,Staff,0,0,0,0
1746584645298,AWP 10R,025,960545,Staff,0,0,0,0
1746584645298,AWP 10R,026,960548,Staff,0,0,0,0
1746584646329,AWP 102R,A00,886190,Staff,0,0,0,0
1746584646329,AWP 102R,B00,886191,Staff,0,0,0,0
1746584647356,BENG 100,A01,886193,Staff,17,0,30,13
1746584648383,BENG 122A,A01,886195,Hasty; Jeff M,13,0,30,17
1746584649412,BENG 166A,A00,886196,Sah; Robert Lie-Yuan,0,3,30,30
1746584650440,BENG 190,A00,958050,Khojah; Reem I,17,0,25,8
1746584651467,BIBC 102,A01,894320,Staff,0,0,46,46
1746584651467,BIBC 102,A02,894321,Staff,0,0,46,46
1746584651467,BIBC 102,A03,894344,Staff,6,0,46,40
1746584651467,BIBC 102,A04,894345,Staff,27,0,47,20
1746584652492,BICD 100R,A01,894365,Smith; Laurie,0,3,58,58
1746584652492,BICD 100R,A02,894366,Smith; Laurie,0,5,58,58
1746584652492,BICD 100R,A03,894367,Smith; Laurie,0,0,59,59
1746584652492,BICD 100R,A04,959869,Smith; Laurie,40,0,59,19
1746584653520,BICD 136,A01,894383,Gustafson-Brown; Cindy,14,0,50,36
1746584654545,BIEB 102,A01,894494,Butler; Shannon Rhey,51,0,130,79
1746584656602,BIEB 150,A01,894617,Wills; Christopher,3,0,20,17
1746584656602,BIEB 150,A02,894631,Wills; Christopher,3,0,20,17
1746584656602,BIEB 150,A03,894937,Wills; Christopher,3,0,20,17
1746584656602,BIEB 150,A04,894946,Wills; Christopher,5,0,20,15
1746584657631,BIEB 194,A00,906141,Kurle; Carolyn M.,5,0,20,15
1746584658658,BILD 1,A01,894154,Staff,3,0,19,16
1746584658658,BILD 1,A02,894155,Staff,14,0,19,5
1746584658658,BILD 1,A03,894160,Staff,13,0,19,6
1746584658658,BILD 1,A04,894161,Staff,15,0,18,3
1746584659682,BILD 2,A01,894168,Staff,0,0,50,50
1746584659682,BILD 2,A02,894169,Staff,0,0,50,50
1746584659682,BILD 2,A03,894179,Staff,0,0,50,50
1746584659682,BILD 2,A04,894203,Staff,24,0,50,26
1746584660709,BILD 3,A01,894213,Staff,23,0,31,8
1746584660709,BILD 3,A02,894214,Staff,26,0,31,5
1746584660709,BILD 3,A03,894235,Staff,28,0,31,3
1746584660709,BILD 3,A04,894236,Staff,28,0,32,4
1746584661741,BILD 4,A01,894253,Reuther; Keefe,5,0,24,19
1746584661741,BILD 4,A02,894258,Reuther; Keefe,16,0,24,8
1746584662766,BILD 5,A01,894276,Reuther; Keefe,34,0,50,16
1746584662766,BILD 5,A02,894277,Reuther; Keefe,45,0,50,5
1746584662766,BILD 5,A03,894290,Reuther; Keefe,44,0,50,6
1746584662766,BILD 5,A04,894291,Reuther; Keefe,48,0,50,2
1746584663795,BILD 24,A01,894297,Pirino; Giorgia,40,0,60,20
1746584664824,BIMM 100,B01,958915,Staff,71,0,100,29
1746584665849,BIMM 101,A01,895017,McDonnell; Lisa Marie,0,5,24,24
1746584665849,BIMM 101,A02,895018,McDonnell; Lisa Marie,0,5,24,24
1746584665849,BIMM 101,B01,895020,McDonnell; Lisa Marie,0,6,24,24
1746584665849,BIMM 101,B02,895021,McDonnell; Lisa Marie,0,4,24,24
1746584666877,BIMM 110,A01,895023,Staff,1,0,25,24
1746584666877,BIMM 110,A02,895024,Staff,9,0,25,16
1746584666877,BIMM 110,A03,895025,Staff,18,0,25,7
1746584666877,BIMM 110,A04,895031,Staff,20,0,25,5
1746584667904,BIMM 120,A01,895114,Gustafson-Brown; Cindy,14,0,28,14
1746584667904,BIMM 120,A02,895126,Gustafson-Brown; Cindy,21,0,27,6
1746584668928,BIPN 100,A01,895130,Yang; Mingyu,0,0,38,38
1746584668928,BIPN 100,A02,895131,Yang; Mingyu,31,0,38,7
1746584668928,BIPN 100,A03,895132,Yang; Mingyu,32,0,38,6
1746584668928,BIPN 100,A04,895133,Yang; Mingyu,27,0,36,9
1746584669954,BIPN 120,A01,895135,Cooke; James Edward,0,3,13,13
1746584669954,BIPN 120,A02,895136,Cooke; James Edward,0,1,13,13
1746584669954,BIPN 120,A03,895137,Cooke; James Edward,0,3,13,13
1746584669954,BIPN 120,A04,895156,Cooke; James Edward,0,2,11,11
1746584670979,BIPN 134,A01,895235,Cooke; James Edward,0,2,25,25
1746584670979,BIPN 134,A02,895237,Cooke; James Edward,0,0,25,25
1746584670979,BIPN 134,A03,895240,Cooke; James Edward,3,0,25,22
1746584670979,BIPN 134,A04,895270,Cooke; James Edward,20,0,25,5
1746584672004,BIPN 189,A00,892103,Staff,0,14,14,14
1746584674053,BISP 194,A00,958008,Staff,0,2,0,0
1746584675080,CAT 124,A01,922009,Staff,0,5,20,20
1746584676105,CAT 125R,A00,886390,Morales; Celeste Georgianna,0,2,20,20
1746584676105,CAT 125R,B00,886391,Irwin; Matthew Joseph,0,4,20,20
1746584676105,CAT 125R,C00,886392,Smith; Lauryn Alissa,0,2,20,20
1746584676105,CAT 125R,D00,886393,Vanderschuit; Maya Alysia,0,3,20,20
1746584676105,CAT 125R,E00,886394,Marchisotto; Jennifer Anne,0,3,20,20
1746584677131,CENG 15,A01,886218,Drews; Aaron,3,0,8,5
1746584678154,CENG 113,A00,886219,Opatkiewicz; Justin Paul,15,0,25,10
1746584679183,CGS 101,A00,887044,Staff,7,0,20,13
1746584680211,CGS 105,A01,887046,Staff,14,0,25,11
1746584681234,CGS 112,A00,887047,Cuong; Marisol,12,0,15,3
1746584682258,CGS 113,A00,887048,Staff,23,0,30,7
1746584683286,CGS 120,A00,887049,Staff,10,0,17,7
1746584684309,CHEM 6A,A01,886336,Lam; Tin Yiu,38,0,50,12
1746584684309,CHEM 6A,A02,886338,Lam; Tin Yiu,37,0,50,13
1746584685335,CHEM 6B,A01,886341,Hopkins; Patrycja Anna,16,0,50,34
1746584685335,CHEM 6B,A02,886343,Hopkins; Patrycja Anna,42,0,50,8
1746584686360,CHEM 6C,A01,886346,Albizati; Kim F.,0,2,50,50
1746584686360,CHEM 6C,A02,886348,Albizati; Kim F.,24,0,50,26
1746584687386,CHEM 40A,A01,886352,Klosterman; Jeremy K,65,0,100,35
1746584688409,CHEM 40B,A01,886356,Klosterman; Jeremy K,0,24,100,100
1746584689434,CHEM 41B,A01,886360,Theodorakis; Emmanuel,25,0,50,25
1746584689434,CHEM 41B,A02,886362,Theodorakis; Emmanuel,47,0,50,3
1746584690457,CHIN 165A,A00,886382,Xu; Li,18,0,20,2
1746584691482,CLAS 120,A00,886387,Myerston Santana; Jacobo,33,0,40,7
1746584692511,COGS 9,A01,886967,Shannon; Kyle Michael,42,0,60,18
1746584693534,COGS 11,A01,886969,Staff,9,0,30,21
1746584694559,COGS 14A,A01,886971,Staff,6,0,60,54
1746584695588,COGS 14B,A01,886973,Hoffman; Drew Ellen,4,0,60,56
1746584696613,COGS 18,A01,886975,Morgan; Eric,34,0,60,26
1746584697639,COGS 20,A01,886977,Staff,3,0,8,5
1746584697639,COGS 20,A02,886978,Staff,5,0,7,2
1746584698666,COGS 100,A01,907783,Staff,1,2,30,29
1746584699693,COGS 101B,A01,886980,Staff,0,4,48,48
1746584700718,COGS 101C,A01,886982,Delgado; Tania,0,5,44,44
1746584701744,COGS 102A,A01,886984,Johnson; Christine M.,3,0,30,27
1746584702772,COGS 118B,A01,886986,Staff,1,5,88,87
1746584703807,COGS 150,A01,886988,Bergen; Benjamin,22,0,50,28
1746584704831,COGS 153,A00,886989,Delgado; Tania,0,3,41,41
1746584705858,COGS 186,A01,886991,Staff,0,0,32,32
1746584706882,COGS 187A,A01,886993,Boyle; Mary E. T.,7,0,30,23
1746584707906,COGS 189,A00,886994,Staff,0,1,30,30
1746584708931,COMM 10,A01,886996,Staff,0,0,20,21
1746584708931,COMM 10,A02,886997,Staff,10,0,20,10
1746584708931,COMM 10,A03,959845,Staff,19,0,20,1
1746584709955,COMM 20,A01,886999,Leuning; Grant Maurstad,24,0,40,16
1746584712005,COMM 100A,A01,887002,Staff,0,0,20,25
1746584712005,COMM 100A,A02,887003,Staff,6,0,20,14
1746584713031,COMM 100B,A01,887005,Staff,0,8,20,24
1746584714179,COMM 106D,A00,887006,Staff,13,0,40,27
1746584715203,COMM 110G,A00,887007,Whitworth-Smith; Andrew C,12,0,40,28
1746584716300,COMM 111B,A00,887008,Staff,31,0,40,9
1746584717330,COMM 113T,A00,887009,Abuelhiga; Soraya Jill,28,0,40,12
1746584717330,COMM 113T,B00,906733,Staff,40,0,40,0
1746584718356,COMM 145,A00,887010,Staff,12,0,40,28
1746584719382,COMM 146,A00,887054,Staff,31,0,40,9
1746584720408,COMM 190,A00,887012,Staff,8,0,23,15
1746584721433,CSE 8A,A50,887015,Cao; Yingjun,57,0,85,28
1746584722462,CSE 11,A01,887017,Cao; Yingjun,12,0,70,58
1746584723491,CSE 20,A01,887019,Staff,30,0,50,20
1746584724517,CSE 21,A01,887021,Staff,78,0,100,22
1746584724517,CSE 21,B01,892583,Braun; Oliver,45,0,50,5
1746584725547,CSE 30,A01,887025,Eldon; John,142,0,200,58
1746584726571,CSE 100,A01,887027,Staff,26,0,50,24
1746584726571,CSE 100,A02,887028,Staff,42,0,50,8
1746584727598,CSE 101,A01,887030,Braun; Oliver,74,0,100,26
1746584727598,CSE 101,B01,887032,Jones; Miles E,0,3,50,50
1746584727598,CSE 101,B02,887033,Jones; Miles E,0,2,50,50
1746584728623,CSE 105,A01,908084,Jones; Miles E,32,0,50,18
1746584728623,CSE 105,A02,908087,Jones; Miles E,31,0,50,19
1746584729647,CSE 135,A01,887035,Powell; Thomas Allan,0,5,50,50
1746584730673,CSE 142,A01,887037,Staff,8,0,60,52
1746584731702,CSE 142L,A01,887039,Staff,34,0,60,26
1746584732727,CSE 151A,A01,887041,Solares; Edwin A,47,0,100,53
1746584733756,CSE 175,A01,887043,Kumar; Rakesh,30,0,30,0
1746584734788,CSS 1,A01,886389,Staff,1,2,40,39
1746584735814,DSC 30,A01,908097,Liao; Soohyun Nam,47,0,75,28
1746584736839,DSC 40A,A01,908099,Shannon; Kyle Michael,30,0,50,20
1746584737864,DSC 40B,A01,908112,Staff,15,0,50,35
1746584738893,DSC 80,A01,908116,Staff,19,0,60,41
1746584739919,DSC 197,001,956863,Eldridge; Justin Matthew,9999,0,9999,0
1746584740947,ECE 5,A01,886400,Morris; Karcher William,1,0,6,5
1746584740947,ECE 5,A02,886401,Morris; Karcher William,3,0,6,3
1746584741976,ECE 148,A01,886403,Silberman; Jack,0,14,14,14
1746584743002,ECON 1,A01,887265,Crane; Meredith Helen,12,0,70,58
1746584743002,ECON 1,B01,887268,Staff,42,0,50,8
1746584744027,ECON 2,A01,887273,Crane; Meredith Helen,55,0,70,15
1746584745053,ECON 3,A01,887279,Rondina; Giacomo,32,0,70,38
1746584746080,ECON 4,A01,887282,Anderson; John Charles,0,2,10,10
1746584747107,ECON 5,A01,887285,Staff,34,0,45,11
1746584747107,ECON 5,B01,887292,Staff,41,0,45,4
1746584748134,ECON 100A,A01,887337,Newhouse; Herbert S,54,0,70,16
1746584748134,ECON 100A,B01,887349,Staff,45,0,50,5
1746584749162,ECON 100B,A01,887361,Du; Songzi,29,0,70,41
1746584750191,ECON 100C,A01,887445,Newhouse; Herbert S,59,0,70,11
1746584751216,ECON 105,A00,887488,Vespa; Emanuel Ignacio,23,0,35,12
1746584752240,ECON 109,A01,887506,Shishkin; Denis,28,0,35,7
1746584753265,ECON 110A,A01,887568,Alon; Titan Michael,0,3,35,35
1746584753265,ECON 110A,B01,907601,Alon; Titan Michael,20,0,35,15
1746584754289,ECON 110B,A01,887598,Levkoff; Steven B.,0,24,70,70
1746584755317,ECON 112,A00,887599,Rondina; Giacomo,19,0,35,16
1746584756346,ECON 120A,A01,887603,Dai; Yinlin,35,0,70,35
1746584757376,ECON 120C,A01,887608,Sun; Yixiao,0,1,35,35
1746584757376,ECON 120C,B01,887614,Sun; Yixiao,0,0,35,35
1746584758400,ECON 138,A00,887621,Bharadwaj; Prashant,0,21,20,20
1746584759428,ECON 144,A00,958007,Squires; Dale E,12,0,35,23
1746584760461,ECON 171,A01,907666,Staff,18,0,35,17
1746584761488,ECON 175,A00,887626,Wu; Pak Yeung,22,0,35,13
1746584762513,ECON 190,A00,887640,Vespa; Emanuel Ignacio,22,0,35,13
1746584763548,EDS 25,A01,888197,Staff,0,0,0,0
1746584763548,EDS 25,A02,888209,Staff,0,0,0,0
1746584763548,EDS 25,A03,888210,Staff,0,0,0,0
1746584763548,EDS 25,A04,888212,Staff,0,0,0,0
1746584763548,EDS 25,A05,888213,Staff,0,0,0,0
1746584763548,EDS 25,A06,888214,Staff,0,0,0,0
1746584763548,EDS 25,A07,888235,Staff,0,2,0,0
1746584763548,EDS 25,A08,888236,Staff,0,0,0,0
1746584763548,EDS 25,A09,888240,Staff,0,0,0,0
1746584763548,EDS 25,A10,888244,Staff,0,0,0,0
1746584763548,EDS 25,B01,888273,Staff,0,0,0,0
1746584763548,EDS 25,B02,888285,Staff,0,0,0,0
1746584763548,EDS 25,B03,888423,Staff,0,0,0,1
1746584763548,EDS 25,B04,888432,Staff,0,0,0,0
1746584763548,EDS 25,B05,888433,Staff,0,0,0,0
1746584763548,EDS 25,B06,888467,Staff,0,0,0,0
1746584763548,EDS 25,B07,888468,Staff,0,0,0,0
1746584763548,EDS 25,B08,888479,Staff,0,0,0,0
1746584763548,EDS 25,B09,888484,Staff,0,0,0,0
1746584763548,EDS 25,B10,888487,Staff,0,0,0,0
1746584764576,EDS 38,A01,907700,Choi; Bailey Miyeon,30,0,30,0
1746584765602,EDS 112,A01,888601,Chapman; Thandeka K,12,0,40,28
1746584766627,EDS 115,A00,888697,Mendez; Kathrina Mendoza,10,0,30,20
1746584767656,EDS 116,A01,888893,Staff,34,0,40,6
1746584769705,EDS 124AR,A00,889133,Staff,29,0,50,21
1746584769705,EDS 124AR,B00,907471,Simon; Elizabeth A,37,0,50,13
1746584770733,EDS 124BR,A00,889134,Simon; Elizabeth A,44,0,100,56
1746584771758,EDS 125,A00,889135,Staff,25,0,30,5
1746584772785,EDS 126,A01,889138,Staff,35,0,40,5
1746584773851,EDS 164R,A01,889142,Wishard Guerra; Alison G.,32,0,50,18
1746584774877,ENG 30,A01,886396,Staff,0,0,0,0
1746584774877,ENG 30,B01,886398,Staff,0,0,0,0
1746584775906,ENVR 102,A00,906150,Montejo; Carolina,23,0,25,2
1746584776935,ETHN 103A,A00,887236,Man; Simeon S,0,3,0,0
1746584777963,ETHN 113,A00,887239,Staff,16,0,30,14
1746584778989,ETHN 116,A00,887240,Staff,16,0,25,9
1746584780027,ETHN 117,A00,887241,Choi; Esther Min,28,0,30,2
1746584781052,ETHN 118,A00,887243,Staff,24,0,30,6
1746584782078,ETHN 127,A00,887248,Cuong; Marisol,11,0,15,4
1746584783103,ETHN 139,A00,887250,Staff,7,0,10,3
1746584784126,ETHN 142,A00,887252,Staff,10,0,30,20
1746584785151,ETHN 161,A00,887253,Browne; Errol Tsekani,24,0,30,6
1746584786175,ETHN 163FR,A00,887255,Burelle; Julie Sara Veronique,0,0,5,5
1746584787204,GLBH 20,A00,889149,Elwardani; Nile Regina,8,0,42,34
1746584789256,GLBH 111,A01,889152,Burgos; Jose L.,17,0,17,0
1746584790285,GLBH 150,A00,889181,Sloane; Julia Kathryn,0,5,15,15
1746584792336,HDS 60,A01,886406,Warstadt; Melissa Fawn,73,0,80,7
1746584793365,HIAF 111,A00,889324,Gyamfi; Bright,25,0,32,7
1746584794388,HIEA 131,A00,889328,Staff,15,0,32,17
1746584795417,HIEA 144,A00,889333,Henry; Todd A.,26,0,32,6
1746584796447,HIEA 154,A00,889336,Henry; Todd A.,24,0,32,8
1746584797476,HIEU 106,A00,889339,Staff,22,0,32,10
1746584799528,HIEU 114,A00,889340,Staff,4,0,32,28
1746584800556,HIEU 135GS,A00,889342,Patterson; Patrick H.,0,0,1,24
1746584801582,HIEU 137,A00,889343,Edington; Claire Ellen,10,0,25,15
1746584802610,HIEU 148,A00,889345,Staff,14,0,32,18
1746584803636,HIEU 154,A00,889346,Biess; Frank Peter,21,0,32,11
1746584804662,HILA 102,A00,889351,Staff,12,0,32,20
1746584805687,HILD 2A,A01,889221,Lewandoski; Julia Mavis,1,10,32,31
1746584806716,HILD 7B,A01,889225,Man; Simeon S,0,12,32,32
1746584807740,HILD 7C,A01,889288,Alvarez; Luis A,0,14,32,32
1746584808767,HILD 30,A01,889323,Staff,0,5,32,32
1746584810822,HISC 119,A00,889383,Golan; Tal,19,0,32,13
1746584811846,HIUS 103,A00,889384,Man; Simeon S,0,0,32,32
1746584812876,HIUS 117,A00,919797,Kwak; Nancy,19,0,32,13
1746584813903,HIUS 142A,A00,919788,Staff,22,0,32,10
1746584815954,HIUS 149,A00,889386,Gyamfi; Bright,26,0,32,6
1746584816978,HIUS 155,A00,889387,Alvarez; Luis A,15,0,32,17
1746584818005,HUM 3,A01,886499,Caldwell; Michael Alan,19,0,50,31
1746584819029,HUM 3GS,A00,886500,Rodriguez; Bretton Sigfred,0,0,0,28
1746584820053,HUM 3R,A01,886502,Markman; Kristina,0,36,50,50
1746584821082,HUM 4,A01,886504,Crum; Matthew Stephen,23,0,50,27
1746584821082,HUM 4,B01,886506,West; Geoffrey Scott,17,0,50,33
1746584822116,HUM 4GS,A00,886507,Staff,0,0,0,19
1746584823141,HUM 5,A01,886509,Staff,32,0,50,18
1746584824166,HUM 5R,A01,886511,Zavodny; Tatiana Sophia,0,39,50,50
1746584825193,JAPN 180,A00,886407,Staff,16,0,40,24
1746584826218,LATI 50,A01,886409,Martin-Cabrera; Luis,3,0,22,19
1746584826218,LATI 50,A02,886410,Martin-Cabrera; Luis,19,0,22,3
1746584826218,LATI 50,A03,886411,Martin-Cabrera; Luis,21,0,22,1
1746584826218,LATI 50,A04,886412,Martin-Cabrera; Luis,8,0,22,14
1746584827245,LAWS 101,A00,907664,Staff,28,0,60,32
1746584828270,LIAB 1A,A00,889388,Saab; Dima,17,0,20,3
1746584829353,LIAB 1AX,A00,889389,El Cheddadi; Youniss,18,0,20,2
1746584830378,LIFR 1C,A00,889391,Van Moer; Vinciane G,8,0,20,12
1746584831403,LIFR 1CX,A00,889392,Van Moer; Vinciane G,7,0,20,13
1746584832427,LIFR 1D,A00,889393,Van Moer; Vinciane G,7,0,20,13
1746584833452,LIFR 1DX,A00,889394,Van Moer; Vinciane G,8,0,20,12
1746584834477,LIGN 7,A00,886923,Staff,24,0,50,26
1746584835503,LIGN 17,A00,886924,Kehler; Andrew Scott,125,0,150,25
1746584836529,LTAM 110,A00,889395,Staff,15,0,30,15
1746584837555,LTAM 110GS,A00,958010,Rodriguez; Bretton Sigfred,0,0,0,28
1746584838582,LTCH 101,A00,889397,Staff,23,0,25,2
1746584839606,LTCS 130,A00,889398,Staff,23,0,25,2
1746584840634,LTEA 138,A00,889399,Staff,24,0,40,16
1746584841659,LTEN 149,A00,889400,Wesling; Megan E.,0,3,25,25
1746584842684,LTEN 169,A00,889401,Staff,20,0,25,5
1746584843712,LTEN 180,A00,889402,Staff,10,0,15,5
1746584844738,LTEN 181,A00,889403,Staff,21,0,25,4
1746584845765,LTWL 100,A00,889404,Myerston Santana; Jacobo,2,0,25,23
1746584846791,LTWL 180GS,A00,889405,Staff,0,0,20,20
1746584847819,LTWL 181,A00,889406,Staff,16,0,25,9
1746584848844,LTWL 184,A00,889475,Mukherjee; Silpa,22,0,25,3
1746584849869,LTWR 102C,A00,889486,Staff,29,0,30,1
1746584850897,LTWR 115W,A00,889491,Staff,0,2,15,15
1746584851921,MAE 8,A01,886905,Staff,0,2,0,0
1746584852949,MAE 11,A00,886906,Bandaru; Prabhakar,0,7,50,50
1746584853980,MAE 20,A00,886907,Evdokimenko; Ekaterina,43,0,70,27
1746584855006,MAE 30B,A00,886909,Ghazinejad; Maziar,26,0,45,19
1746584856035,MAE 101B,A00,886910,Saintillan; David,29,0,45,16
1746584857061,MAE 105,A00,886911,Bandaru; Prabhakar,18,0,50,32
1746584858089,MAE 107,B00,958024,Staff,7,0,50,43
1746584859114,MAE 143B,A00,886913,Bewley; Thomas R,3,0,40,37
1746584860139,MAE 148,A01,886915,Silberman; Jack,0,3,14,14
1746584861163,MAE 160,A00,886916,Evdokimenko; Ekaterina,31,0,60,29
1746584862189,MATH 3C,A01,889681,Staff,0,2,30,30
1746584862189,MATH 3C,A02,960048,Staff,23,0,30,7
1746584863216,MATH 10A,A01,889760,Staff,26,0,30,4
1746584863216,MATH 10A,A02,889783,Staff,29,0,30,1
1746584864244,MATH 10B,A01,889785,Verstraete; Jacques Allan,1,0,35,34
1746584864244,MATH 10B,A02,889795,Verstraete; Jacques Allan,4,0,35,31
1746584864244,MATH 10B,B01,889797,Verstraete; Jacques Allan,3,0,35,32
1746584864244,MATH 10B,B02,889828,Verstraete; Jacques Allan,3,0,35,32
1746584865274,MATH 10C,A01,889849,Habib; Yousaf,7,0,30,23
1746584865274,MATH 10C,A02,889852,Habib; Yousaf,14,0,30,16
1746584865274,MATH 10C,A03,889853,Habib; Yousaf,22,0,30,8
1746584865274,MATH 10C,A04,889858,Habib; Yousaf,20,0,30,10
1746584865274,MATH 10C,B01,889861,Staff,1,0,30,29
1746584865274,MATH 10C,B02,889862,Staff,24,0,30,6
1746584865274,MATH 10C,B03,889863,Staff,27,0,30,3
1746584865274,MATH 10C,B04,889967,Staff,23,0,30,7
1746584866304,MATH 18,A01,889974,Staff,7,0,30,23
1746584866304,MATH 18,A02,889977,Staff,20,0,30,10
1746584866304,MATH 18,B01,889984,Hardiman; Liam,20,0,30,10
1746584866304,MATH 18,B02,889985,Hardiman; Liam,25,0,30,5
1746584867329,MATH 20A,A01,889990,Suk; Andrew Hoon,30,0,35,5
1746584868354,MATH 20B,A01,889993,Ohm; Ko Woon,21,0,30,9
1746584868354,MATH 20B,A02,889994,Ohm; Ko Woon,30,0,30,0
1746584868354,MATH 20B,B01,889996,Ohm; Ko Woon,22,0,30,8
1746584868354,MATH 20B,B02,889997,Ohm; Ko Woon,23,0,30,7
1746584869378,MATH 20C,A01,889999,Hammock; Frances H,17,0,30,13
1746584869378,MATH 20C,A02,890003,Hammock; Frances H,23,0,30,7
1746584869378,MATH 20C,B01,890006,Hammock; Frances H,3,0,30,27
1746584869378,MATH 20C,B02,890007,Hammock; Frances H,12,0,30,18
1746584870409,MATH 20D,A01,890011,Cheng; Hsiao-Bing,1,1,30,29
1746584870409,MATH 20D,A02,890012,Cheng; Hsiao-Bing,14,0,30,16
1746584870409,MATH 20D,B01,890016,Cheng; Hsiao-Bing,13,0,30,17
1746584870409,MATH 20D,B02,890017,Cheng; Hsiao-Bing,13,0,30,17
1746584871434,MATH 20E,A01,890026,Harel; Guershon,1,0,30,29
1746584871434,MATH 20E,A02,890029,Harel; Guershon,22,0,30,8
1746584871434,MATH 20E,B01,890033,Harel; Guershon,7,0,30,23
1746584871434,MATH 20E,B02,890101,Harel; Guershon,21,0,30,9
1746584872461,MATH 102,A01,890104,Staff,18,0,30,12
1746584872461,MATH 102,A02,890105,Staff,27,0,30,3
1746584873486,MATH 103B,A01,890116,Salehi Golsefidy; Alireza,3,0,30,27
1746584873486,MATH 103B,B01,890118,Staff,0,3,34,34
1746584874513,MATH 109,A01,890121,Aliabadi Sr.; Mohsen,0,0,30,30
1746584874513,MATH 109,B01,890124,Upadrashta; Pranav Kumar,18,0,30,12
1746584875538,MATH 120A,A01,890126,Eggers; John Dietrich,13,0,30,17
1746584876564,MATH 142B,A01,890128,Ioana; Adrian,19,0,30,11
1746584876564,MATH 142B,A02,890129,Ioana; Adrian,12,0,30,18
1746584877588,MATH 154,A01,890174,Staff,0,1,30,30
1746584877588,MATH 154,A02,890182,Staff,0,0,30,30
1746584878617,MATH 168A,A01,890197,Dumitriu; Ioana,21,0,35,14
1746584879646,MATH 170A,A01,890240,Nie; Jiawang,1,0,30,29
1746584879646,MATH 170A,A02,890241,Nie; Jiawang,11,0,30,19
1746584879646,MATH 170A,A03,890249,Nie; Jiawang,23,0,30,7
1746584880676,MATH 170B,A01,957891,Nag; Panchali,13,0,35,22
1746584882728,MATH 181A,A01,908025,Staff,0,3,35,35
1746584882728,MATH 181A,A02,960115,Staff,26,0,35,9
1746584883753,MATH 181B,A01,959874,Staff,25,0,30,5
1746584884779,MATH 193B,A01,890265,Staff,0,4,35,35
1746584885809,MGT 4,A01,890311,Anderson; John Charles,42,0,88,46
1746584886834,MGT 5,A00,907740,Staff,13,0,98,85
1746584887860,MGT 12,A00,890312,Lindenberger; Wade Douglas,67,0,98,31
1746584888886,MGT 16,A00,957883,Staff,78,0,98,20
1746584890939,MGT 45,A00,890314,Pecore; Joseph P.,45,0,98,53
1746584891965,MGT 71,A00,890315,Staff,0,12,98,98
1746584892993,MGT 100,A00,890316,Yavorsky; Daniel Ryan,44,0,98,54
1746584894019,MGT 103,A00,890317,Ehrich; Kristine R,73,0,98,25
1746584895044,MGT 105,A00,890356,Bates; Kenneth Walter,0,8,98,98
1746584896069,MGT 112,A00,890360,Ehrich; Kristine R,55,0,98,43
1746584897098,MGT 127R,A00,907732,Zhu; Kevin Xiaoguo,23,0,98,75
1746584898124,MGT 131B,A00,890361,Anderson; John Charles,59,0,98,39
1746584899153,MGT 137,A00,890362,Lindenberger; Wade Douglas,65,0,98,33
1746584900182,MGT 160,A00,890369,Johnson; Erik Barry,9,0,98,89
1746584902240,MGT 164,A00,890372,Zimmermann; Carsten,0,40,98,98
1746584903265,MGT 180,A00,890374,Bliss; Barbara Ann,12,0,98,86
1746584904291,MMW 15,A01,886414,Chang; Edmond Yi-Teh,0,12,28,28
1746584904291,MMW 15,A02,886415,Chang; Edmond Yi-Teh,0,8,28,28
1746584904291,MMW 15,A03,886416,Chang; Edmond Yi-Teh,0,9,28,28
1746584904291,MMW 15,A04,886417,Chang; Edmond Yi-Teh,0,8,28,28
1746584904291,MMW 15,B01,886419,Chang; Edmond Yi-Teh,0,7,28,28
1746584904291,MMW 15,B02,886420,Chang; Edmond Yi-Teh,0,8,28,28
1746584904291,MMW 15,B03,886421,Chang; Edmond Yi-Teh,0,7,28,28
1746584904291,MMW 15,B04,886422,Chang; Edmond Yi-Teh,0,8,28,28
1746584904291,MMW 15,C01,886424,Staff,0,9,28,28
1746584904291,MMW 15,C02,886425,Staff,0,8,28,28
1746584904291,MMW 15,C03,886426,Staff,0,8,28,28
1746584904291,MMW 15,C04,886427,Staff,0,8,28,28
1746584904291,MMW 15,C05,958038,Staff,0,8,28,28
1746584904291,MMW 15,C06,958039,Staff,1,8,28,27
1746584905318,MMW 15GS,A00,906910,Patterson; Patrick H.,4,0,28,24
1746584906345,MMW 122R,A01,886429,Rahimi; Babak,0,13,28,28
1746584906345,MMW 122R,A02,886430,Rahimi; Babak,0,12,28,28
1746584906345,MMW 122R,A03,958040,Rahimi; Babak,0,11,28,28
1746584907371,MUS 1A,A01,890937,Staff,2,0,25,23
1746584907371,MUS 1A,A02,891035,Staff,6,0,25,19
1746584907371,MUS 1A,C01,958912,Staff,24,0,25,1
1746584907371,MUS 1A,C02,958913,Staff,25,0,25,0
1746584909418,MUS 2AK,A00,957092,Ohnishi; Takae,15,0,15,0
1746584910443,MUS 4,A01,891044,Staff,1,0,25,24
1746584910443,MUS 4,A02,891045,Staff,23,0,25,2
1746584910443,MUS 4,B01,891048,Staff,17,0,25,8
1746584910443,MUS 4,B02,891050,Staff,25,0,25,0
1746584911467,MUS 5,A01,957506,Dubnov; Shlomo,0,0,25,25
1746584911467,MUS 5,A02,957622,Dubnov; Shlomo,13,0,25,12
1746584911467,MUS 5,A03,957623,Dubnov; Shlomo,20,0,25,5
1746584912496,MUS 6,A01,891053,Freitas Caetano; Marcelo,24,0,25,1
1746584912496,MUS 6,A02,891054,Freitas Caetano; Marcelo,23,0,25,2
1746584913523,MUS 7,A01,891081,Staff,0,0,25,25
1746584913523,MUS 7,A02,891082,Staff,3,0,25,22
1746584914551,MUS 8GS,A00,891118,Borgo; David Garcia,1,0,25,24
1746584915581,MUS 11,A01,891140,Staff,9,0,25,16
1746584915581,MUS 11,A02,891141,Staff,21,0,25,4
1746584916609,MUS 13,A01,891143,Staff,8,0,25,17
1746584916609,MUS 13,A02,891144,Staff,24,0,25,1
1746584917633,MUS 15,A01,891146,Staff,9,0,25,16
1746584917633,MUS 15,A02,891148,Staff,21,0,25,4
1746584917633,MUS 15,B01,891150,Staff,18,0,25,7
1746584917633,MUS 15,B02,891151,Staff,25,0,25,0
1746584918659,MUS 20,A01,891153,Staff,5,0,20,15
1746584918659,MUS 20,A02,891155,Staff,14,0,20,6
1746584919688,MUS 80,A00,891156,Staff,19,0,25,6
1746584919688,MUS 80,B00,891157,Staff,23,0,25,2
1746584920713,MUS 130,A00,891158,Ohnishi; Takae,35,0,35,0
1746584921740,MUS 150GS,A01,891160,Borgo; David Garcia,1,0,25,24
1746584922769,MUS 170,A01,891162,Freitas Caetano; Marcelo,20,0,25,5
1746584922769,MUS 170,A02,891164,Freitas Caetano; Marcelo,21,0,25,4
1746584923796,NANO 11,A00,886220,Vazquez Mena; Oscar,13,0,15,2
1746584924822,NANO 15,A01,886222,Drews; Aaron,4,0,7,3
1746584925851,NANO 104,A00,886224,Sirbuly; Donald,17,0,25,8
1746584926876,PH 40,A00,886528,Staff,24,0,40,16
1746584927906,PH 45,A01,886799,Staff,35,0,40,5
1746584928935,PH 110,A00,886802,Staff,0,7,40,40
1746584929958,PH 172,A00,906716,Staff,19,0,35,16
1746584930982,PH 191,A00,886803,Staff,6,0,40,34
1746584932007,PHIL 1,A00,889500,Staff,20,0,30,10
1746584933032,PHIL 10,A01,889549,Grush; Rick Scott,16,0,22,6
1746584933032,PHIL 10,A02,889551,Grush; Rick Scott,22,0,22,0
1746584934057,PHIL 28,A01,889559,Lamey; Andy M.,0,2,31,31
1746584934057,PHIL 28,A02,889561,Lamey; Andy M.,0,1,30,30
1746584934057,PHIL 28,A03,889572,Lamey; Andy M.,0,1,30,30
1746584935084,PHIL 35,A00,907839,Staff,13,0,15,2
1746584936108,PHIL 60,A00,889574,Staff,73,0,90,17
1746584937134,PHIL 101,A00,958004,Staff,12,0,15,3
1746584939189,PHIL 136,A00,889582,Fulkerson; Matthew Todd,26,0,45,19
1746584940214,PHIL 163,A01,889601,Staff,21,0,30,9
1746584940214,PHIL 163,B01,889606,Brandt; Reuven A,0,3,0,0
1746584941242,PHIL 164,A00,889610,Staff,16,0,30,14
1746584942270,PHIL 165,A00,889613,Staff,22,0,30,8
1746584943296,PHYS 1A,A00,886431,Staff,29,0,70,41
1746584944321,PHYS 1AL,001,886432,Tsai; Philbert S,1,2,30,29
1746584944321,PHYS 1AL,002,886436,Tsai; Philbert S,12,0,30,18
1746584945348,PHYS 1B,A00,886439,Staff,184,0,240,56
1746584946374,PHYS 1BL,001,886441,Tsai; Philbert S,0,4,30,30
1746584946374,PHYS 1BL,002,886444,Tsai; Philbert S,2,0,30,28
1746584947398,PHYS 1C,A00,896092,Arnold; Kam S,78,0,146,68
1746584948422,PHYS 1CL,001,886448,Tsai; Philbert S,0,0,30,30
1746584948422,PHYS 1CL,002,886449,Tsai; Philbert S,1,0,30,29
1746584948422,PHYS 1CL,003,886450,Tsai; Philbert S,16,0,30,14
1746584948422,PHYS 1CL,004,886451,Tsai; Philbert S,15,0,30,15
1746584949446,PHYS 2B,A01,886457,Staff,67,0,115,48
1746584950476,PHYS 2C,A01,886460,Shotwell; Brian,0,9,65,65
1746584951501,PHYS 2CL,A01,886467,Staff,0,4,28,28
1746584951501,PHYS 2CL,A02,886468,Staff,0,3,28,28
1746584952527,PHYS 2D,A01,886470,Staff,10,0,50,40
1746584953553,PHYS 4B,A01,886475,Grinstein; Benjamin,22,0,40,18
1746584954578,POLI 5,A00,891173,Desposato; Scott,7,0,25,18
1746584955609,POLI 5D,A01,891175,Staff,5,0,5,0
1746584955609,POLI 5D,B01,891178,Staff,5,0,5,0
1746584956634,POLI 11,A00,891179,Ferree; Karen E,2,0,35,33
1746584957662,POLI 12,A00,891180,Staff,16,0,30,14
1746584958688,POLI 27,A01,891182,Staff,12,0,75,63
1746584959713,POLI 30,A00,891183,Staff,8,0,50,42
1746584960737,POLI 100B,A00,891244,Staff,5,1,35,30
1746584961761,POLI 100I,A00,891247,Staff,7,0,30,23
1746584962785,POLI 104J,A00,891248,Nichter; Maysa,14,0,30,16
1746584963813,POLI 104U,A00,891250,Nichter; Maysa,1,0,30,29
1746584965899,POLI 110B,A00,891255,Wiens; David,19,0,25,6
1746584966925,POLI 112A,A00,891256,Wiens; David,6,0,25,19
1746584967948,POLI 114BR,A00,891261,Staff,19,0,30,11
1746584968975,POLI 117R,A00,891262,Forman; Fonna,0,6,50,50
1746584970000,POLI 118,A00,891264,Ingham; Sean,17,0,25,8
1746584971025,POLI 124A,A00,891265,Staff,18,0,20,2
1746584972050,POLI 125D,A00,891266,Nichter; Simeon C,2,0,25,23
1746584973075,POLI 126,A00,891268,Nichter; Simeon C,7,0,25,18
1746584974104,POLI 126AA,A00,891272,Staff,15,0,25,10
1746584975133,POLI 130AA,A00,891273,Staff,15,0,20,5
1746584976156,POLI 134AA,A00,891274,Staff,4,0,20,16
1746584978207,POLI 138,A00,891278,Staff,21,0,25,4
1746584979236,POLI 142K,A00,891280,Staff,10,0,25,15
1746584980264,POLI 142M,A00,891281,Gartzke; Erik,16,0,30,14
1746584981288,POLI 142P,A00,891284,Staff,20,0,30,10
1746584982315,POLI 143,A00,891285,Gartzke; Erik,12,0,30,18
1746584983340,POLI 153,A00,891286,Staff,19,0,20,1
1746584985392,POLI 175,A00,891290,Staff,15,0,20,5
1746584986417,PSYC 1,A00,890674,Steiner; Eric Tomas,0,11,45,45
1746584987445,PSYC 2,A00,890676,Albright; Thomas D,20,0,35,15
1746584988470,PSYC 3,A00,890679,Staff,17,0,20,3
1746584989496,PSYC 6,A00,959858,Staff,19,0,20,1
1746584990522,PSYC 60,A01,890684,Rickard; Timothy C.,0,6,45,45
1746584991547,PSYC 70,A01,890689,Geller; Emma Harlan,6,0,30,24
1746584992578,PSYC 71,A01,959860,Staff,21,0,25,4
1746584993615,PSYC 100,A00,890690,Lacefield; Katharine I,0,50,180,180
1746584994640,PSYC 102,A00,890695,Staff,18,0,40,22
1746584995665,PSYC 105,A00,890699,Geller; Emma Harlan,70,0,100,30
1746584996696,PSYC 106,A00,890701,Gorman; Michael R.,5,0,30,25
1746584997723,PSYC 108,A00,890704,Adrian; Julia Anna,0,28,50,50
1746584998751,PSYC 118,A01,890712,Staff,11,0,30,19
1746584999777,PSYC 124,A00,890716,Chapman; Eddie Nathaniel,25,0,60,35
1746585000805,PSYC 131,A00,890717,Anagnostaras; Stephan,0,7,80,80
1746585001837,PSYC 137,A00,890719,Winkielman; Piotr,0,11,30,30
1746585002861,PSYC 144,A00,890721,Adrian; Julia Anna,0,9,45,45
1746585003889,PSYC 162,A00,890805,Staff,0,1,75,75
1746585004914,PSYC 169,A00,890810,Staff,0,15,30,30
1746585005938,PSYC 172,A00,890814,Gorman; Michael R.,9,0,30,21
1746585006963,PSYC 181,A00,890818,Anagnostaras; Stephan,7,0,200,193
1746585007990,PSYC 184,A00,959861,Staff,164,0,175,11
1746585009019,PSYC 189,A00,890823,Staff,0,2,30,30
1746585010055,PSYC 191,A00,890884,Rickard; Timothy C.,0,12,35,35
1746585011079,PSYC 193,A00,890913,Staff,19,0,30,11
1746585011079,PSYC 193,B00,890914,Chapman; Eddie Nathaniel,24,0,30,6
1746585012104,PSYC 193L,A01,890918,Lowe; Angela Beth,20,0,30,10
1746585012104,PSYC 193L,B01,890921,Hurwitz; Ethan Scott,20,0,30,10
1746585012104,PSYC 193L,C01,890928,Staff,30,0,30,0
1746585013134,RELI 149,A00,886806,Rahimi; Babak,23,0,40,17
1746585014164,SE 9,A01,886814,Staff,7,0,20,13
1746585015188,SE 101B,A01,886816,Chadha; Mayank,4,0,35,31
1746585016217,SE 110B,A00,886818,Zhu; Qiang,4,0,75,71
1746585017244,SE 125,A01,886830,Staff,10,0,30,20
1746585018268,SE 130B,A01,886835,Staff,14,0,40,26
1746585019297,SE 131A,A01,886838,Krysl; Petr,34,0,55,21
1746585020321,SE 154,A00,886840,Staff,28,0,50,22
1746585021352,SE 164GS,A01,886849,Staff,6,0,20,14
1746585022405,SE 167GS,A01,886853,Staff,6,0,20,14
1746585023428,SIO 25,A01,890107,Staff,19,0,30,11
1746585024455,SIO 45,A00,890109,Cook; Geoffrey W,116,0,200,84
1746585025480,SIO 109R,A00,890110,Forman; Fonna,0,16,20,20
1746585026507,SIO 187,A01,890114,Kacev; David,15,0,40,25
1746585027535,SOCI 1,A01,890431,Thorpe; Charles Robert,14,0,30,16
1746585027535,SOCI 1,A02,890518,Thorpe; Charles Robert,30,0,30,0
1746585028563,SOCI 2,A01,957978,Staff,25,0,25,0
1746585028563,SOCI 2,A02,957979,Staff,23,0,25,2
1746585029588,SOCI 20,A01,890523,Calderon-Zaks; Michael Aar,21,0,30,9
1746585029588,SOCI 20,A02,890526,Calderon-Zaks; Michael Aar,29,0,30,1
1746585030614,SOCI 30,A01,890533,Pardo Guerra; Juan Pablo,37,0,40,3
1746585031644,SOCI 40,A01,890535,Staff,27,0,45,18
1746585032668,SOCI 104Q,A00,890559,Staff,18,0,30,12
1746585033693,SOCI 106,A00,890560,Arnal; Maud Marie Leonie,20,0,30,10
1746585034717,SOCI 110,A00,890567,Holkenbrink-Monk; Charlene,19,0,30,11
1746585035745,SOCI 112,A00,890568,Victoria Torres; Pablo,2,0,55,53
1746585036772,SOCI 115,A00,890597,Arnal; Maud Marie Leonie,28,0,45,17
1746585038825,SOCI 121,A00,890604,Pardo Guerra; Juan Pablo,38,0,45,7
1746585039856,SOCI 126,A01,890608,Staff,8,0,10,2
1746585040882,SOCI 127,A00,890609,Staff,18,0,30,12
1746585041907,SOCI 131,A00,890610,Thorpe; Charles Robert,37,0,45,8
1746585042931,SOCI 135,A00,890615,Payne; Christine Anna,13,0,45,32
1746585043963,SOCI 139,A00,890620,Staff,38,0,45,7
1746585044992,SOCI 148E,A00,890622,Calderon-Zaks; Michael Aar,36,0,45,9
1746585046017,SOCI 150,A00,890623,Kohler; Kristopher M.,31,0,45,14
1746585047045,SOCI 157,A00,890625,Jules-Rosette; Bennetta W.,18,0,20,2
1746585048070,SOCI 160,A00,890627,Payne; Christine Anna,21,0,45,24
1746585049099,SYN 1,A00,886855,Fish; Gwendolyn Anne,0,1,0,0
1746585049099,SYN 1,B00,906086,Fish; Gwendolyn Anne,0,2,0,2
1746585050138,SYN 2R,A00,886860,Staff,0,17,15,15
1746585050138,SYN 2R,B00,906106,Atkinson; Arthur Laird,0,16,15,15
1746585051172,SYN 100,A01,886866,Browne; Emily,0,28,20,20
1746585051172,SYN 100,B01,906128,Rock; Martin,0,4,20,20
1746585051172,SYN 100,C01,906140,Deavenport; James Cary,0,4,20,20
1746585051172,SYN 100,D01,907816,Deavenport; James Cary,0,5,20,20
1746585052198,TDAC 1,A00,890286,Walsh; Kim C.,7,0,20,13
1746585053222,TDAC 101,A00,890296,Basso; Beatrice,15,0,20,5
1746585054247,TDDE 131,A00,890297,Staff,47,0,50,3
1746585055276,TDDM 1,A00,890287,Weinberg; Sadie,25,0,30,5
1746585056301,TDGE 11,A00,890288,Fulton; Julia,138,0,200,62
1746585056301,TDGE 11,B00,890289,Castro; Robert Jess,184,0,200,16
1746585057325,TDGE 25,B00,957359,Walsh; Kim C.,5,0,20,15
1746585058349,TDGE 40,A01,890292,Power; Jade Yukana,27,0,30,3
1746585059379,TDGE 124,A00,890298,Havis; Allan,0,1,50,50
1746585060408,TDGE 131R,A00,890299,Burelle; Julie Sara Veronique,15,0,42,27
1746585061432,TDHT 101,A00,890300,Staff,10,0,20,10
1746585062458,TDHT 109,A01,890302,Anderson; Mysia Anyse,31,0,40,9
1746585063485,TDMV 1,A00,890293,Arcidiacono; Kristin,18,0,30,12
1746585064509,TDMV 2,A00,890294,Weinberg; Sadie,23,0,30,7
1746585065540,TDMV 3,A00,957878,Arcidiacono; Kristin,28,0,30,2
1746585067596,TDMV 138,A00,890304,Jun; Grace Shin Hae,25,0,40,15
1746585068624,TDMV 140,A00,890305,Corrales; Joseph Bernales,25,0,30,5
1746585069653,TDMV 142,A00,890307,Caligagan; Tony,32,0,40,8
1746585070677,TDMV 144,A00,890308,Camaya; Michelle Ann,25,0,30,5
1746585071704,TDPW 1,A00,890295,Stein; Deborah Isobel,3,0,20,17
1746585072733,USP 2,A01,890272,Lerner; Amy M,7,0,20,13
1746585073761,USP 3,A01,890274,Staff,12,0,30,18
1746585074787,USP 15,A01,890276,Sun; Feiyang,16,0,30,14
1746585075811,USP 25,A00,890277,Shenkman; Michael Thomas,18,0,25,7
1746585076836,USP 138,A00,890278,Staff,13,0,25,12
1746585077863,USP 143,A00,890279,Staff,22,0,70,48
1746585078889,USP 144,A00,890280,Chowdhury; Muhammed Zohir,16,0,30,14
1746585079913,USP 150,A00,890281,Boomhower; Matthew Charles,4,0,30,26
1746585080938,USP 151,A00,890282,Staff,16,0,20,4
1746585081963,USP 162,A00,890283,Andrews; Abigail Leslie,16,0,20,4
1746585082989,USP 168,A00,920477,Kwak; Nancy,0,0,5,5
1746585084015,USP 181,A00,890284,Staff,3,0,20,17
1746585085041,USP 191A,A00,890285,Staff,12,0,20,8
1746585086065,VIS 101,A00,886512,Staff,26,0,75,49
1746585087093,VIS 103,A00,886513,Cruz; Edwin Teddy,61,0,75,14
1746585088121,VIS 108,A00,886514,Staff,3,0,15,12
1746585089146,VIS 127P,A00,886515,Shen; Kuiyi,79,0,146,67
1746585090200,VIS 149,A00,886516,Yoldas; Pinar,0,0,15,15
1746585091229,VIS 164,A00,886526,Erdmann; Dean,19,0,22,3
1746585092255,VIS 194S,A00,886527,Staff,61,0,75,14
1746585093282,WCWP 10A,C00,886484,Martiniuk; Jill,12,0,15,3
1746585094307,WCWP 10B,A00,886490,Uriarte; Emma,0,0,15,15
1746585094307,WCWP 10B,B00,886491,Dhir; Simrita,8,0,15,7
1746585094307,WCWP 10B,C00,886492,Ornelas; Tricia,0,0,15,15
1746585095332,WCWP 100,A00,886494,Young; Mark T,0,6,15,15
1746585097400,AAS 10,A01,886199,Childs; Dennis R.,0,3,0,0
1746585098429,ANAR 104,A01,886940,Shtienberg; Gilad,27,0,30,3
1746585099453,ANAR 120,A00,886953,Staff,13,0,20,7
1746585100478,ANBI 148,A01,886955,Wilder; Linnea Lorene,30,0,40,10
1746585102531,ANSC 122,A00,886957,Staff,24,0,30,6
1746585103559,ANSC 150,A00,886958,Sloane; Julia Kathryn,2,0,15,13
1746585104586,ANSC 156,A00,886959,Jenkins; Janis A.,0,1,15,15
1746585105615,ANSC 180,A00,886960,Staff,11,0,17,6
1746585106643,ANSC 188,A00,886961,Jassal; Aftab,9,0,25,16
1746585107667,ANSC 190,A00,886962,Jassal; Aftab,14,0,25,11
1746585108692,ANSC 191,A00,886963,Staff,18,0,20,2
1746585109718,ANTH 3,A01,891689,Staff,17,0,20,3
1746585110743,ANTH 5,A00,886933,Semendeferi; Ekaterini,16,0,20,4
1746585111771,ANTH 10,A00,886934,Staff,0,12,30,30
1746585112799,ANTH 21,A01,886936,Staff,41,0,60,19
1746585113826,ANTH 23,A01,886938,Staff,92,0,100,8
1746585114850,ANTH 105,A00,886964,Stewart; Alexander B,84,0,100,16
1746585115875,ANTH 108,A00,886965,Pedersen; David,9,0,20,11
1746585116903,AWP 10,001,886147,Staff,0,0,0,0
1746585116903,AWP 10,002,886148,Staff,0,0,0,0
1746585116903,AWP 10,003,886149,Staff,0,0,0,0
1746585116903,AWP 10,004,886150,Staff,0,0,0,0
1746585116903,AWP 10,005,886151,Staff,0,0,0,0
1746585116903,AWP 10,006,886152,Staff,0,0,0,0
1746585116903,AWP 10,007,886153,Staff,0,0,0,0
1746585116903,AWP 10,008,886154,Staff,0,0,0,0
1746585116903,AWP 10,009,886155,Staff,0,0,0,0
1746585116903,AWP 10,010,886156,Staff,0,0,0,0
1746585116903,AWP 10,011,886158,Staff,0,0,0,0
1746585116903,AWP 10,012,886160,Staff,0,0,0,0
1746585116903,AWP 10,013,886161,Staff,0,0,0,0
1746585116903,AWP 10,014,886162,Staff,0,0,0,0
1746585116903,AWP 10,015,886163,Staff,0,0,0,0
1746585116903,AWP 10,016,886164,Staff,0,0,0,0
1746585116903,AWP 10,017,886165,Staff,0,0,0,0
1746585116903,AWP 10,018,886166,Staff,0,0,0,0
1746585116903,AWP 10,019,886168,Staff,0,0,0,0
1746585116903,AWP 10,020,886170,Staff,0,0,0,0
1746585116903,AWP 10,021,886172,Staff,0,0,0,0
1746585117935,AWP 10R,001,886173,Staff,0,1,0,0
1746585117935,AWP 10R,002,886174,Staff,0,1,0,0
1746585117935,AWP 10R,003,886175,Staff,0,0,0,0
1746585117935,AWP 10R,004,886176,Staff,0,0,0,0
1746585117935,AWP 10R,005,886177,Staff,0,0,0,0
1746585117935,AWP 10R,006,886178,Staff,0,0,0,0
1746585117935,AWP 10R,007,886179,Staff,0,0,0,0
1746585117935,AWP 10R,008,886181,Staff,0,0,0,0
1746585117935,AWP 10R,009,886182,Staff,0,0,0,0
1746585117935,AWP 10R,010,886183,Staff,0,0,0,0
1746585117935,AWP 10R,011,886184,Staff,0,0,0,0
1746585117935,AWP 10R,012,886185,Staff,0,0,0,0
1746585117935,AWP 10R,013,886186,Staff,0,0,0,0
1746585117935,AWP 10R,014,886187,Staff,0,0,0,0
1746585117935,AWP 10R,015,886188,Staff,0,0,0,0
1746585117935,AWP 10R,016,886189,Staff,0,0,0,0
1746585117935,AWP 10R,017,960532,Staff,0,0,0,0
1746585117935,AWP 10R,018,960533,Staff,0,0,0,0
1746585117935,AWP 10R,019,960534,Staff,0,0,0,0
1746585117935,AWP 10R,020,960538,Staff,0,0,0,0
1746585117935,AWP 10R,021,960540,Staff,0,0,0,0
1746585117935,AWP 10R,022,960541,Staff,0,0,0,0
1746585117935,AWP 10R,023,960542,Staff,0,0,0,0
1746585117935,AWP 10R,024,960544,Staff,0,0,0,0
1746585117935,AWP 10R,025,960545,Staff,0,0,0,0
1746585117935,AWP 10R,026,960548,Staff,0,0,0,0
1746585118959,AWP 102R,A00,886190,Staff,0,0,0,0
1746585118959,AWP 102R,B00,886191,Staff,0,0,0,0
1746585119985,BENG 100,A01,886193,Staff,17,0,30,13
1746585121012,BENG 122A,A01,886195,Hasty; Jeff M,13,0,30,17
1746585122040,BENG 166A,A00,886196,Sah; Robert Lie-Yuan,0,3,30,30
1746585123065,BENG 190,A00,958050,Khojah; Reem I,17,0,25,8
1746585124095,BIBC 102,A01,894320,Staff,0,0,46,46
1746585124095,BIBC 102,A02,894321,Staff,0,0,46,46
1746585124095,BIBC 102,A03,894344,Staff,6,0,46,40
1746585124095,BIBC 102,A04,894345,Staff,27,0,47,20
1746585125124,BICD 100R,A01,894365,Smith; Laurie,0,3,58,58
1746585125124,BICD 100R,A02,894366,Smith; Laurie,0,5,58,58
1746585125124,BICD 100R,A03,894367,Smith; Laurie,0,0,59,59
1746585125124,BICD 100R,A04,959869,Smith; Laurie,40,0,59,19
1746585126147,BICD 136,A01,894383,Gustafson-Brown; Cindy,14,0,50,36
1746585127174,BIEB 102,A01,894494,Butler; Shannon Rhey,51,0,130,79
1746585129224,BIEB 150,A01,894617,Wills; Christopher,3,0,20,17
1746585129224,BIEB 150,A02,894631,Wills; Christopher,3,0,20,17
1746585129224,BIEB 150,A03,894937,Wills; Christopher,3,0,20,17
1746585129224,BIEB 150,A04,894946,Wills; Christopher,5,0,20,15
1746585130251,BIEB 194,A00,906141,Kurle; Carolyn M.,5,0,20,15
1746585131276,BILD 1,A01,894154,Staff,3,0,19,16
1746585131276,BILD 1,A02,894155,Staff,14,0,19,5
1746585131276,BILD 1,A03,894160,Staff,13,0,19,6
1746585131276,BILD 1,A04,894161,Staff,15,0,18,3
1746585132303,BILD 2,A01,894168,Staff,0,0,50,50
1746585132303,BILD 2,A02,894169,Staff,0,0,50,50
1746585132303,BILD 2,A03,894179,Staff,0,0,50,50
1746585132303,BILD 2,A04,894203,Staff,24,0,50,26
1746585133330,BILD 3,A01,894213,Staff,23,0,31,8
1746585133330,BILD 3,A02,894214,Staff,26,0,31,5
1746585133330,BILD 3,A03,894235,Staff,28,0,31,3
1746585133330,BILD 3,A04,894236,Staff,28,0,32,4
1746585134357,BILD 4,A01,894253,Reuther; Keefe,5,0,24,19
1746585134357,BILD 4,A02,894258,Reuther; Keefe,16,0,24,8
1746585135386,BILD 5,A01,894276,Reuther; Keefe,34,0,50,16
1746585135386,BILD 5,A02,894277,Reuther; Keefe,45,0,50,5
1746585135386,BILD 5,A03,894290,Reuther; Keefe,44,0,50,6
1746585135386,BILD 5,A04,894291,Reuther; Keefe,48,0,50,2
1746585136418,BILD 24,A01,894297,Pirino; Giorgia,40,0,60,20
1746585137443,BIMM 100,B01,958915,Staff,71,0,100,29
1746585138472,BIMM 101,A01,895017,McDonnell; Lisa Marie,0,5,24,24
1746585138472,BIMM 101,A02,895018,McDonnell; Lisa Marie,0,5,24,24
1746585138472,BIMM 101,B01,895020,McDonnell; Lisa Marie,0,6,24,24
1746585138472,BIMM 101,B02,895021,McDonnell; Lisa Marie,0,4,24,24
1746585139496,BIMM 110,A01,895023,Staff,1,0,25,24
1746585139496,BIMM 110,A02,895024,Staff,9,0,25,16
1746585139496,BIMM 110,A03,895025,Staff,18,0,25,7
1746585139496,BIMM 110,A04,895031,Staff,20,0,25,5
1746585140522,BIMM 120,A01,895114,Gustafson-Brown; Cindy,14,0,28,14
1746585140522,BIMM 120,A02,895126,Gustafson-Brown; Cindy,21,0,27,6
1746585141552,BIPN 100,A01,895130,Yang; Mingyu,0,0,38,38
1746585141552,BIPN 100,A02,895131,Yang; Mingyu,31,0,38,7
1746585141552,BIPN 100,A03,895132,Yang; Mingyu,32,0,38,6
1746585141552,BIPN 100,A04,895133,Yang; Mingyu,27,0,36,9
1746585142579,BIPN 120,A01,895135,Cooke; James Edward,0,3,13,13
1746585142579,BIPN 120,A02,895136,Cooke; James Edward,0,1,13,13
1746585142579,BIPN 120,A03,895137,Cooke; James Edward,0,3,13,13
1746585142579,BIPN 120,A04,895156,Cooke; James Edward,0,2,11,11
1746585143608,BIPN 134,A01,895235,Cooke; James Edward,0,2,25,25
1746585143608,BIPN 134,A02,895237,Cooke; James Edward,0,0,25,25
1746585143608,BIPN 134,A03,895240,Cooke; James Edward,3,0,25,22
1746585143608,BIPN 134,A04,895270,Cooke; James Edward,20,0,25,5
1746585144634,BIPN 189,A00,892103,Staff,0,14,14,14
1746585146687,BISP 194,A00,958008,Staff,0,2,0,0
1746585147712,CAT 124,A01,922009,Staff,0,5,20,20
1746585148737,CAT 125R,A00,886390,Morales; Celeste Georgianna,0,2,20,20
1746585148737,CAT 125R,B00,886391,Irwin; Matthew Joseph,0,4,20,20
1746585148737,CAT 125R,C00,886392,Smith; Lauryn Alissa,0,2,20,20
1746585148737,CAT 125R,D00,886393,Vanderschuit; Maya Alysia,0,3,20,20
1746585148737,CAT 125R,E00,886394,Marchisotto; Jennifer Anne,0,3,20,20
1746585149766,CENG 15,A01,886218,Drews; Aaron,3,0,8,5
1746585150791,CENG 113,A00,886219,Opatkiewicz; Justin Paul,15,0,25,10
1746585151817,CGS 101,A00,887044,Staff,7,0,20,13
1746585152844,CGS 105,A01,887046,Staff,14,0,25,11
1746585153877,CGS 112,A00,887047,Cuong; Marisol,12,0,15,3
1746585154904,CGS 113,A00,887048,Staff,23,0,30,7
1746585155933,CGS 120,A00,887049,Staff,10,0,17,7
1746585156959,CHEM 6A,A01,886336,Lam; Tin Yiu,38,0,50,12
1746585156959,CHEM 6A,A02,886338,Lam; Tin Yiu,37,0,50,13
1746585157985,CHEM 6B,A01,886341,Hopkins; Patrycja Anna,16,0,50,34
1746585157985,CHEM 6B,A02,886343,Hopkins; Patrycja Anna,42,0,50,8
1746585159011,CHEM 6C,A01,886346,Albizati; Kim F.,0,2,50,50
1746585159011,CHEM 6C,A02,886348,Albizati; Kim F.,24,0,50,26
1746585160041,CHEM 40A,A01,886352,Klosterman; Jeremy K,65,0,100,35
1746585161068,CHEM 40B,A01,886356,Klosterman; Jeremy K,0,24,100,100
1746585162096,CHEM 41B,A01,886360,Theodorakis; Emmanuel,25,0,50,25
1746585162096,CHEM 41B,A02,886362,Theodorakis; Emmanuel,47,0,50,3
1746585163121,CHIN 165A,A00,886382,Xu; Li,18,0,20,2
1746585164150,CLAS 120,A00,886387,Myerston Santana; Jacobo,33,0,40,7
1746585165181,COGS 9,A01,886967,Shannon; Kyle Michael,42,0,60,18
1746585166211,COGS 11,A01,886969,Staff,9,0,30,21
1746585167239,COGS 14A,A01,886971,Staff,6,0,60,54
1746585168284,COGS 14B,A01,886973,Hoffman; Drew Ellen,4,0,60,56
1746585169314,COGS 18,A01,886975,Morgan; Eric,34,0,60,26
1746585170339,COGS 20,A01,886977,Staff,2,0,8,6
1746585170339,COGS 20,A02,886978,Staff,4,0,7,3
1746585171365,COGS 100,A01,907783,Staff,1,2,30,29
1746585172399,COGS 101B,A01,886980,Staff,0,4,48,48
1746585173423,COGS 101C,A01,886982,Delgado; Tania,0,5,44,44
1746585174449,COGS 102A,A01,886984,Johnson; Christine M.,3,0,30,27
1746585175473,COGS 118B,A01,886986,Staff,1,5,88,87
1746585176499,COGS 150,A01,886988,Bergen; Benjamin,22,0,50,28
1746585177529,COGS 153,A00,886989,Delgado; Tania,0,3,41,41
1746585178558,COGS 186,A01,886991,Staff,0,0,32,32
1746585179588,COGS 187A,A01,886993,Boyle; Mary E. T.,7,0,30,23
1746585180613,COGS 189,A00,886994,Staff,0,1,30,30
1746585181643,COMM 10,A01,886996,Staff,0,0,20,21
1746585181643,COMM 10,A02,886997,Staff,10,0,20,10
1746585181643,COMM 10,A03,959845,Staff,19,0,20,1
1746585182674,COMM 20,A01,886999,Leuning; Grant Maurstad,24,0,40,16
1746585184726,COMM 100A,A01,887002,Staff,0,0,20,25
1746585184726,COMM 100A,A02,887003,Staff,6,0,20,14
1746585185755,COMM 100B,A01,887005,Staff,0,8,20,24
1746585186784,COMM 106D,A00,887006,Staff,13,0,40,27
1746585187809,COMM 110G,A00,887007,Whitworth-Smith; Andrew C,12,0,40,28
1746585188837,COMM 111B,A00,887008,Staff,31,0,40,9
1746585189864,COMM 113T,A00,887009,Abuelhiga; Soraya Jill,28,0,40,12
1746585189864,COMM 113T,B00,906733,Staff,40,0,40,0
1746585190888,COMM 145,A00,887010,Staff,12,0,40,28
1746585191914,COMM 146,A00,887054,Staff,31,0,40,9
1746585192941,COMM 190,A00,887012,Staff,8,0,23,15
1746585193966,CSE 8A,A50,887015,Cao; Yingjun,57,0,85,28
1746585194994,CSE 11,A01,887017,Cao; Yingjun,12,0,70,58
1746585196023,CSE 20,A01,887019,Staff,30,0,50,20
1746585197046,CSE 21,A01,887021,Staff,78,0,100,22
1746585197046,CSE 21,B01,892583,Braun; Oliver,45,0,50,5
1746585198075,CSE 30,A01,887025,Eldon; John,142,0,200,58
1746585199101,CSE 100,A01,887027,Staff,26,0,50,24
1746585199101,CSE 100,A02,887028,Staff,42,0,50,8
1746585200129,CSE 101,A01,887030,Braun; Oliver,74,0,100,26
1746585200129,CSE 101,B01,887032,Jones; Miles E,0,3,50,50
1746585200129,CSE 101,B02,887033,Jones; Miles E,0,2,50,50
1746585201158,CSE 105,A01,908084,Jones; Miles E,32,0,50,18
1746585201158,CSE 105,A02,908087,Jones; Miles E,31,0,50,19
1746585202182,CSE 135,A01,887035,Powell; Thomas Allan,0,5,50,50
1746585203208,CSE 142,A01,887037,Staff,8,0,60,52
1746585204232,CSE 142L,A01,887039,Staff,34,0,60,26
1746585205262,CSE 151A,A01,887041,Solares; Edwin A,47,0,100,53
1746585206286,CSE 175,A01,887043,Kumar; Rakesh,30,0,30,0
1746585207311,CSS 1,A01,886389,Staff,1,2,40,39
1746585208337,DSC 30,A01,908097,Liao; Soohyun Nam,47,0,75,28
1746585209363,DSC 40A,A01,908099,Shannon; Kyle Michael,30,0,50,20
1746585210389,DSC 40B,A01,908112,Staff,15,0,50,35
1746585211413,DSC 80,A01,908116,Staff,19,0,60,41
1746585212439,DSC 197,001,956863,Eldridge; Justin Matthew,9999,0,9999,0
1746585213464,ECE 5,A01,886400,Morris; Karcher William,1,0,6,5
1746585213464,ECE 5,A02,886401,Morris; Karcher William,3,0,6,3
1746585214499,ECE 148,A01,886403,Silberman; Jack,0,14,14,14
1746585215530,ECON 1,A01,887265,Crane; Meredith Helen,12,0,70,58
1746585215530,ECON 1,B01,887268,Staff,42,0,50,8
1746585216555,ECON 2,A01,887273,Crane; Meredith Helen,54,0,70,16
1746585217581,ECON 3,A01,887279,Rondina; Giacomo,31,0,70,39
1746585218609,ECON 4,A01,887282,Anderson; John Charles,0,2,10,10
1746585219637,ECON 5,A01,887285,Staff,34,0,45,11
1746585219637,ECON 5,B01,887292,Staff,41,0,45,4
1746585220662,ECON 100A,A01,887337,Newhouse; Herbert S,54,0,70,16
1746585220662,ECON 100A,B01,887349,Staff,45,0,50,5
1746585221688,ECON 100B,A01,887361,Du; Songzi,29,0,70,41
1746585222712,ECON 100C,A01,887445,Newhouse; Herbert S,59,0,70,11
1746585223738,ECON 105,A00,887488,Vespa; Emanuel Ignacio,23,0,35,12
1746585224764,ECON 109,A01,887506,Shishkin; Denis,28,0,35,7
1746585225790,ECON 110A,A01,887568,Alon; Titan Michael,0,3,35,35
1746585225790,ECON 110A,B01,907601,Alon; Titan Michael,20,0,35,15
1746585226816,ECON 110B,A01,887598,Levkoff; Steven B.,0,24,70,70
1746585227851,ECON 112,A00,887599,Rondina; Giacomo,19,0,35,16
1746585228875,ECON 120A,A01,887603,Dai; Yinlin,35,0,70,35
1746585229900,ECON 120C,A01,887608,Sun; Yixiao,0,1,35,35
1746585229900,ECON 120C,B01,887614,Sun; Yixiao,0,0,35,35
1746585230926,ECON 138,A00,887621,Bharadwaj; Prashant,0,21,20,20
1746585231954,ECON 144,A00,958007,Squires; Dale E,12,0,35,23
1746585232978,ECON 171,A01,907666,Staff,18,0,35,17
1746585234007,ECON 175,A00,887626,Wu; Pak Yeung,22,0,35,13
1746585235036,ECON 190,A00,887640,Vespa; Emanuel Ignacio,22,0,35,13
1746585236063,EDS 25,A01,888197,Staff,0,0,0,0
1746585236063,EDS 25,A02,888209,Staff,0,0,0,0
1746585236063,EDS 25,A03,888210,Staff,0,0,0,0
1746585236063,EDS 25,A04,888212,Staff,0,0,0,0
1746585236063,EDS 25,A05,888213,Staff,0,0,0,0
1746585236063,EDS 25,A06,888214,Staff,0,0,0,0
1746585236063,EDS 25,A07,888235,Staff,0,2,0,0
1746585236063,EDS 25,A08,888236,Staff,0,0,0,0
1746585236063,EDS 25,A09,888240,Staff,0,0,0,0
1746585236063,EDS 25,A10,888244,Staff,0,0,0,0
1746585236063,EDS 25,B01,888273,Staff,0,0,0,0
1746585236063,EDS 25,B02,888285,Staff,0,0,0,0
1746585236063,EDS 25,B03,888423,Staff,0,0,0,1
1746585236063,EDS 25,B04,888432,Staff,0,0,0,0
1746585236063,EDS 25,B05,888433,Staff,0,0,0,0
1746585236063,EDS 25,B06,888467,Staff,0,0,0,0
1746585236063,EDS 25,B07,888468,Staff,0,0,0,0
1746585236063,EDS 25,B08,888479,Staff,0,0,0,0
1746585236063,EDS 25,B09,888484,Staff,0,0,0,0
1746585236063,EDS 25,B10,888487,Staff,0,0,0,0
1746585237090,EDS 38,A01,907700,Choi; Bailey Miyeon,30,0,30,0
1746585238117,EDS 112,A01,888601,Chapman; Thandeka K,12,0,40,28
1746585239143,EDS 115,A00,888697,Mendez; Kathrina Mendoza,10,0,30,20
1746585240168,EDS 116,A01,888893,Staff,34,0,40,6
1746585242216,EDS 124AR,A00,889133,Staff,29,0,50,21
1746585242216,EDS 124AR,B00,907471,Simon; Elizabeth A,37,0,50,13
1746585243240,EDS 124BR,A00,889134,Simon; Elizabeth A,44,0,100,56
1746585244265,EDS 125,A00,889135,Staff,25,0,30,5
1746585245292,EDS 126,A01,889138,Staff,35,0,40,5
1746585246320,EDS 164R,A01,889142,Wishard Guerra; Alison G.,32,0,50,18
1746585247346,ENG 30,A01,886396,Staff,0,0,0,0
1746585247346,ENG 30,B01,886398,Staff,0,0,0,0
1746585248371,ENVR 102,A00,906150,Montejo; Carolina,23,0,25,2
1746585249396,ETHN 103A,A00,887236,Man; Simeon S,0,3,0,0
1746585250423,ETHN 113,A00,887239,Staff,16,0,30,14
1746585251451,ETHN 116,A00,887240,Staff,16,0,25,9
1746585252481,ETHN 117,A00,887241,Choi; Esther Min,28,0,30,2
1746585253526,ETHN 118,A00,887243,Staff,24,0,30,6
1746585254555,ETHN 127,A00,887248,Cuong; Marisol,11,0,15,4
1746585255585,ETHN 139,A00,887250,Staff,7,0,10,3
1746585256610,ETHN 142,A00,887252,Staff,10,0,30,20
1746585257634,ETHN 161,A00,887253,Browne; Errol Tsekani,24,0,30,6
1746585258660,ETHN 163FR,A00,887255,Burelle; Julie Sara Veronique,0,0,5,5
1746585259685,GLBH 20,A00,889149,Elwardani; Nile Regina,8,0,42,34
1746585261736,GLBH 111,A01,889152,Burgos; Jose L.,17,0,17,0
1746585262764,GLBH 150,A00,889181,Sloane; Julia Kathryn,0,5,15,15
1746585264816,HDS 60,A01,886406,Warstadt; Melissa Fawn,73,0,80,7
1746585265844,HIAF 111,A00,889324,Gyamfi; Bright,25,0,32,7
1746585266871,HIEA 131,A00,889328,Staff,15,0,32,17
1746585267896,HIEA 144,A00,889333,Henry; Todd A.,26,0,32,6
1746585268922,HIEA 154,A00,889336,Henry; Todd A.,24,0,32,8
1746585269948,HIEU 106,A00,889339,Staff,22,0,32,10
1746585272000,HIEU 114,A00,889340,Staff,4,0,32,28
1746585273027,HIEU 135GS,A00,889342,Patterson; Patrick H.,0,0,1,24
1746585274054,HIEU 137,A00,889343,Edington; Claire Ellen,10,0,25,15
1746585275078,HIEU 148,A00,889345,Staff,14,0,32,18
1746585276105,HIEU 154,A00,889346,Biess; Frank Peter,21,0,32,11
1746585277135,HILA 102,A00,889351,Staff,12,0,32,20
1746585278162,HILD 2A,A01,889221,Lewandoski; Julia Mavis,1,10,32,31
1746585279186,HILD 7B,A01,889225,Man; Simeon S,0,12,32,32
1746585280211,HILD 7C,A01,889288,Alvarez; Luis A,0,14,32,32
1746585281235,HILD 30,A01,889323,Staff,0,5,32,32
1746585283287,HISC 119,A00,889383,Golan; Tal,19,0,32,13
1746585284313,HIUS 103,A00,889384,Man; Simeon S,0,0,32,32
1746585285340,HIUS 117,A00,919797,Kwak; Nancy,19,0,32,13
1746585286367,HIUS 142A,A00,919788,Staff,22,0,32,10
1746585288418,HIUS 149,A00,889386,Gyamfi; Bright,26,0,32,6
1746585289445,HIUS 155,A00,889387,Alvarez; Luis A,15,0,32,17
1746585290473,HUM 3,A01,886499,Caldwell; Michael Alan,19,0,50,31
1746585291501,HUM 3GS,A00,886500,Rodriguez; Bretton Sigfred,0,0,0,28
1746585292526,HUM 3R,A01,886502,Markman; Kristina,0,36,50,50
1746585293563,HUM 4,A01,886504,Crum; Matthew Stephen,23,0,50,27
1746585293563,HUM 4,B01,886506,West; Geoffrey Scott,17,0,50,33
1746585294589,HUM 4GS,A00,886507,Staff,0,0,0,19
1746585295615,HUM 5,A01,886509,Staff,32,0,50,18
1746585296639,HUM 5R,A01,886511,Zavodny; Tatiana Sophia,0,39,50,50
1746585297666,JAPN 180,A00,886407,Staff,16,0,40,24
1746585298694,LATI 50,A01,886409,Martin-Cabrera; Luis,3,0,22,19
1746585298694,LATI 50,A02,886410,Martin-Cabrera; Luis,19,0,22,3
1746585298694,LATI 50,A03,886411,Martin-Cabrera; Luis,21,0,22,1
1746585298694,LATI 50,A04,886412,Martin-Cabrera; Luis,8,0,22,14
1746585299723,LAWS 101,A00,907664,Staff,28,0,60,32
1746585300750,LIAB 1A,A00,889388,Saab; Dima,17,0,20,3
1746585301776,LIAB 1AX,A00,889389,El Cheddadi; Youniss,18,0,20,2
1746585302804,LIFR 1C,A00,889391,Van Moer; Vinciane G,8,0,20,12
1746585303834,LIFR 1CX,A00,889392,Van Moer; Vinciane G,7,0,20,13
1746585304862,LIFR 1D,A00,889393,Van Moer; Vinciane G,7,0,20,13
1746585305891,LIFR 1DX,A00,889394,Van Moer; Vinciane G,8,0,20,12
1746585306918,LIGN 7,A00,886923,Staff,24,0,50,26
1746585307944,LIGN 17,A00,886924,Kehler; Andrew Scott,125,0,150,25
1746585308971,LTAM 110,A00,889395,Staff,15,0,30,15
1746585309998,LTAM 110GS,A00,958010,Rodriguez; Bretton Sigfred,0,0,0,28
1746585311024,LTCH 101,A00,889397,Staff,23,0,25,2
1746585312053,LTCS 130,A00,889398,Staff,23,0,25,2
1746585313079,LTEA 138,A00,889399,Staff,24,0,40,16
1746585314105,LTEN 149,A00,889400,Wesling; Megan E.,0,3,25,25
1746585315133,LTEN 169,A00,889401,Staff,20,0,25,5
1746585316161,LTEN 180,A00,889402,Staff,10,0,15,5
1746585317191,LTEN 181,A00,889403,Staff,21,0,25,4
1746585318219,LTWL 100,A00,889404,Myerston Santana; Jacobo,2,0,25,23
1746585319246,LTWL 180GS,A00,889405,Staff,0,0,20,20
1746585320274,LTWL 181,A00,889406,Staff,16,0,25,9
1746585321297,LTWL 184,A00,889475,Mukherjee; Silpa,22,0,25,3
1746585322323,LTWR 102C,A00,889486,Staff,29,0,30,1
1746585323352,LTWR 115W,A00,889491,Staff,0,2,15,15
1746585324378,MAE 8,A01,886905,Staff,0,2,0,0
1746585325407,MAE 11,A00,886906,Bandaru; Prabhakar,0,7,50,50
1746585326436,MAE 20,A00,886907,Evdokimenko; Ekaterina,43,0,70,27
1746585327463,MAE 30B,A00,886909,Ghazinejad; Maziar,26,0,45,19
1746585328487,MAE 101B,A00,886910,Saintillan; David,29,0,45,16
1746585329516,MAE 105,A00,886911,Bandaru; Prabhakar,18,0,50,32
1746585330542,MAE 107,B00,958024,Staff,7,0,50,43
1746585331567,MAE 143B,A00,886913,Bewley; Thomas R,3,0,40,37
1746585332597,MAE 148,A01,886915,Silberman; Jack,0,3,14,14
1746585333622,MAE 160,A00,886916,Evdokimenko; Ekaterina,31,0,60,29
1746585334653,MATH 3C,A01,889681,Staff,0,2,30,30
1746585334653,MATH 3C,A02,960048,Staff,23,0,30,7
1746585335683,MATH 10A,A01,889760,Staff,26,0,30,4
1746585335683,MATH 10A,A02,889783,Staff,29,0,30,1
1746585336709,MATH 10B,A01,889785,Verstraete; Jacques Allan,1,0,35,34
1746585336709,MATH 10B,A02,889795,Verstraete; Jacques Allan,4,0,35,31
1746585336709,MATH 10B,B01,889797,Verstraete; Jacques Allan,3,0,35,32
1746585336709,MATH 10B,B02,889828,Verstraete; Jacques Allan,3,0,35,32
1746585337741,MATH 10C,A01,889849,Habib; Yousaf,7,0,30,23
1746585337741,MATH 10C,A02,889852,Habib; Yousaf,14,0,30,16
1746585337741,MATH 10C,A03,889853,Habib; Yousaf,22,0,30,8
1746585337741,MATH 10C,A04,889858,Habib; Yousaf,20,0,30,10
1746585337741,MATH 10C,B01,889861,Staff,1,0,30,29
1746585337741,MATH 10C,B02,889862,Staff,24,0,30,6
1746585337741,MATH 10C,B03,889863,Staff,27,0,30,3
1746585337741,MATH 10C,B04,889967,Staff,23,0,30,7
1746585338768,MATH 18,A01,889974,Staff,7,0,30,23
1746585338768,MATH 18,A02,889977,Staff,20,0,30,10
1746585338768,MATH 18,B01,889984,Hardiman; Liam,20,0,30,10
1746585338768,MATH 18,B02,889985,Hardiman; Liam,25,0,30,5
1746585339795,MATH 20A,A01,889990,Suk; Andrew Hoon,30,0,35,5
1746585340826,MATH 20B,A01,889993,Ohm; Ko Woon,21,0,30,9
1746585340826,MATH 20B,A02,889994,Ohm; Ko Woon,30,0,30,0
1746585340826,MATH 20B,B01,889996,Ohm; Ko Woon,22,0,30,8
1746585340826,MATH 20B,B02,889997,Ohm; Ko Woon,23,0,30,7
1746585341851,MATH 20C,A01,889999,Hammock; Frances H,17,0,30,13
1746585341851,MATH 20C,A02,890003,Hammock; Frances H,23,0,30,7
1746585341851,MATH 20C,B01,890006,Hammock; Frances H,3,0,30,27
1746585341851,MATH 20C,B02,890007,Hammock; Frances H,12,0,30,18
1746585342882,MATH 20D,A01,890011,Cheng; Hsiao-Bing,1,1,30,29
1746585342882,MATH 20D,A02,890012,Cheng; Hsiao-Bing,14,0,30,16
1746585342882,MATH 20D,B01,890016,Cheng; Hsiao-Bing,13,0,30,17
1746585342882,MATH 20D,B02,890017,Cheng; Hsiao-Bing,13,0,30,17
1746585343907,MATH 20E,A01,890026,Harel; Guershon,1,0,30,29
1746585343907,MATH 20E,A02,890029,Harel; Guershon,22,0,30,8
1746585343907,MATH 20E,B01,890033,Harel; Guershon,7,0,30,23
1746585343907,MATH 20E,B02,890101,Harel; Guershon,21,0,30,9
1746585344933,MATH 102,A01,890104,Staff,18,0,30,12
1746585344933,MATH 102,A02,890105,Staff,27,0,30,3
1746585345961,MATH 103B,A01,890116,Salehi Golsefidy; Alireza,3,0,30,27
1746585345961,MATH 103B,B01,890118,Staff,0,3,34,34
1746585346985,MATH 109,A01,890121,Aliabadi Sr.; Mohsen,0,0,30,30
1746585346985,MATH 109,B01,890124,Upadrashta; Pranav Kumar,18,0,30,12
1746585348009,MATH 120A,A01,890126,Eggers; John Dietrich,13,0,30,17
1746585349038,MATH 142B,A01,890128,Ioana; Adrian,19,0,30,11
1746585349038,MATH 142B,A02,890129,Ioana; Adrian,12,0,30,18
1746585350066,MATH 154,A01,890174,Staff,0,1,30,30
1746585350066,MATH 154,A02,890182,Staff,0,0,30,30
1746585351091,MATH 168A,A01,890197,Dumitriu; Ioana,21,0,35,14
1746585352121,MATH 170A,A01,890240,Nie; Jiawang,1,0,30,29
1746585352121,MATH 170A,A02,890241,Nie; Jiawang,11,0,30,19
1746585352121,MATH 170A,A03,890249,Nie; Jiawang,23,0,30,7
1746585353151,MATH 170B,A01,957891,Nag; Panchali,13,0,35,22
1746585355204,MATH 181A,A01,908025,Staff,0,3,35,35
1746585355204,MATH 181A,A02,960115,Staff,26,0,35,9
1746585356230,MATH 181B,A01,959874,Staff,25,0,30,5
1746585357255,MATH 193B,A01,890265,Staff,0,4,35,35
1746585358279,MGT 4,A01,890311,Anderson; John Charles,42,0,88,46
1746585359306,MGT 5,A00,907740,Staff,13,0,98,85
1746585360329,MGT 12,A00,890312,Lindenberger; Wade Douglas,67,0,98,31
1746585361356,MGT 16,A00,957883,Staff,78,0,98,20
1746585363405,MGT 45,A00,890314,Pecore; Joseph P.,45,0,98,53
1746585364432,MGT 71,A00,890315,Staff,0,12,98,98
1746585365457,MGT 100,A00,890316,Yavorsky; Daniel Ryan,44,0,98,54
1746585366483,MGT 103,A00,890317,Ehrich; Kristine R,73,0,98,25
1746585367513,MGT 105,A00,890356,Bates; Kenneth Walter,0,8,98,98
1746585368543,MGT 112,A00,890360,Ehrich; Kristine R,55,0,98,43
1746585369569,MGT 127R,A00,907732,Zhu; Kevin Xiaoguo,23,0,98,75
1746585370598,MGT 131B,A00,890361,Anderson; John Charles,59,0,98,39
1746585371626,MGT 137,A00,890362,Lindenberger; Wade Douglas,65,0,98,33
1746585372656,MGT 160,A00,890369,Johnson; Erik Barry,9,0,98,89
1746585374711,MGT 164,A00,890372,Zimmermann; Carsten,0,40,98,98
1746585375737,MGT 180,A00,890374,Bliss; Barbara Ann,12,0,98,86
1746585376766,MMW 15,A01,886414,Chang; Edmond Yi-Teh,0,12,28,28
1746585376766,MMW 15,A02,886415,Chang; Edmond Yi-Teh,0,8,28,28
1746585376766,MMW 15,A03,886416,Chang; Edmond Yi-Teh,0,9,28,28
1746585376766,MMW 15,A04,886417,Chang; Edmond Yi-Teh,0,8,28,28
1746585376766,MMW 15,B01,886419,Chang; Edmond Yi-Teh,0,7,28,28
1746585376766,MMW 15,B02,886420,Chang; Edmond Yi-Teh,0,8,28,28
1746585376766,MMW 15,B03,886421,Chang; Edmond Yi-Teh,0,7,28,28
1746585376766,MMW 15,B04,886422,Chang; Edmond Yi-Teh,0,8,28,28
1746585376766,MMW 15,C01,886424,Staff,0,9,28,28
1746585376766,MMW 15,C02,886425,Staff,0,8,28,28
1746585376766,MMW 15,C03,886426,Staff,0,8,28,28
1746585376766,MMW 15,C04,886427,Staff,0,8,28,28
1746585376766,MMW 15,C05,958038,Staff,0,8,28,28
1746585376766,MMW 15,C06,958039,Staff,1,8,28,27
1746585377888,MMW 15GS,A00,906910,Patterson; Patrick H.,4,0,28,24
1746585378931,MMW 122R,A01,886429,Rahimi; Babak,0,13,28,28
1746585378931,MMW 122R,A02,886430,Rahimi; Babak,0,12,28,28
1746585378931,MMW 122R,A03,958040,Rahimi; Babak,0,11,28,28
1746585380066,MUS 1A,A01,890937,Staff,2,0,25,23
1746585380066,MUS 1A,A02,891035,Staff,6,0,25,19
1746585380066,MUS 1A,C01,958912,Staff,24,0,25,1
1746585380066,MUS 1A,C02,958913,Staff,25,0,25,0
1746585382120,MUS 2AK,A00,957092,Ohnishi; Takae,15,0,15,0
1746585383147,MUS 4,A01,891044,Staff,1,0,25,24
1746585383147,MUS 4,A02,891045,Staff,23,0,25,2
1746585383147,MUS 4,B01,891048,Staff,17,0,25,8
1746585383147,MUS 4,B02,891050,Staff,25,0,25,0
1746585384178,MUS 5,A01,957506,Dubnov; Shlomo,0,0,25,25
1746585384178,MUS 5,A02,957622,Dubnov; Shlomo,13,0,25,12
1746585384178,MUS 5,A03,957623,Dubnov; Shlomo,20,0,25,5
1746585385204,MUS 6,A01,891053,Freitas Caetano; Marcelo,24,0,25,1
1746585385204,MUS 6,A02,891054,Freitas Caetano; Marcelo,23,0,25,2
1746585386230,MUS 7,A01,891081,Staff,0,0,25,25
1746585386230,MUS 7,A02,891082,Staff,3,0,25,22
1746585387253,MUS 8GS,A00,891118,Borgo; David Garcia,1,0,25,24
1746585388278,MUS 11,A01,891140,Staff,9,0,25,16
1746585388278,MUS 11,A02,891141,Staff,21,0,25,4
1746585389305,MUS 13,A01,891143,Staff,8,0,25,17
1746585389305,MUS 13,A02,891144,Staff,24,0,25,1
1746585390331,MUS 15,A01,891146,Staff,9,0,25,16
1746585390331,MUS 15,A02,891148,Staff,21,0,25,4
1746585390331,MUS 15,B01,891150,Staff,18,0,25,7
1746585390331,MUS 15,B02,891151,Staff,25,0,25,0
1746585391358,MUS 20,A01,891153,Staff,5,0,20,15
1746585391358,MUS 20,A02,891155,Staff,14,0,20,6
1746585392401,MUS 80,A00,891156,Staff,19,0,25,6
1746585392401,MUS 80,B00,891157,Staff,23,0,25,2
1746585393424,MUS 130,A00,891158,Ohnishi; Takae,35,0,35,0
1746585394450,MUS 150GS,A01,891160,Borgo; David Garcia,1,0,25,24
1746585395473,MUS 170,A01,891162,Freitas Caetano; Marcelo,20,0,25,5
1746585395473,MUS 170,A02,891164,Freitas Caetano; Marcelo,21,0,25,4
1746585396497,NANO 11,A00,886220,Vazquez Mena; Oscar,13,0,15,2
1746585397521,NANO 15,A01,886222,Drews; Aaron,4,0,7,3
1746585398545,NANO 104,A00,886224,Sirbuly; Donald,17,0,25,8
1746585399571,PH 40,A00,886528,Staff,24,0,40,16
1746585400599,PH 45,A01,886799,Staff,35,0,40,5
1746585401626,PH 110,A00,886802,Staff,0,7,40,40
1746585402654,PH 172,A00,906716,Staff,19,0,35,16
1746585403679,PH 191,A00,886803,Staff,6,0,40,34
1746585404707,PHIL 1,A00,889500,Staff,20,0,30,10
1746585405735,PHIL 10,A01,889549,Grush; Rick Scott,16,0,22,6
1746585405735,PHIL 10,A02,889551,Grush; Rick Scott,22,0,22,0
1746585406765,PHIL 28,A01,889559,Lamey; Andy M.,0,2,31,31
1746585406765,PHIL 28,A02,889561,Lamey; Andy M.,0,1,30,30
1746585406765,PHIL 28,A03,889572,Lamey; Andy M.,0,1,30,30
1746585407789,PHIL 35,A00,907839,Staff,13,0,15,2
1746585408816,PHIL 60,A00,889574,Staff,73,0,90,17
1746585409841,PHIL 101,A00,958004,Staff,12,0,15,3
1746585411892,PHIL 136,A00,889582,Fulkerson; Matthew Todd,26,0,45,19
1746585412919,PHIL 163,A01,889601,Staff,21,0,30,9
1746585412919,PHIL 163,B01,889606,Brandt; Reuven A,0,3,0,0
1746585413945,PHIL 164,A00,889610,Staff,16,0,30,14
1746585414975,PHIL 165,A00,889613,Staff,22,0,30,8
1746585416000,PHYS 1A,A00,886431,Staff,29,0,70,41
1746585417027,PHYS 1AL,001,886432,Tsai; Philbert S,1,2,30,29
1746585417027,PHYS 1AL,002,886436,Tsai; Philbert S,12,0,30,18
1746585418053,PHYS 1B,A00,886439,Staff,184,0,240,56
1746585419081,PHYS 1BL,001,886441,Tsai; Philbert S,0,4,30,30
1746585419081,PHYS 1BL,002,886444,Tsai; Philbert S,2,0,30,28
1746585420107,PHYS 1C,A00,896092,Arnold; Kam S,78,0,146,68
1746585421134,PHYS 1CL,001,886448,Tsai; Philbert S,0,0,30,30
1746585421134,PHYS 1CL,002,886449,Tsai; Philbert S,1,0,30,29
1746585421134,PHYS 1CL,003,886450,Tsai; Philbert S,16,0,30,14
1746585421134,PHYS 1CL,004,886451,Tsai; Philbert S,15,0,30,15
1746585422161,PHYS 2B,A01,886457,Staff,67,0,115,48
1746585423186,PHYS 2C,A01,886460,Shotwell; Brian,0,9,65,65
1746585424216,PHYS 2CL,A01,886467,Staff,0,4,28,28
1746585424216,PHYS 2CL,A02,886468,Staff,0,3,28,28
1746585425241,PHYS 2D,A01,886470,Staff,10,0,50,40
1746585426269,PHYS 4B,A01,886475,Grinstein; Benjamin,22,0,40,18
1746585427296,POLI 5,A00,891173,Desposato; Scott,7,0,25,18
1746585428320,POLI 5D,A01,891175,Staff,5,0,5,0
1746585428320,POLI 5D,B01,891178,Staff,5,0,5,0
1746585429348,POLI 11,A00,891179,Ferree; Karen E,2,0,35,33
1746585430375,POLI 12,A00,891180,Staff,16,0,30,14
1746585431409,POLI 27,A01,891182,Staff,12,0,75,63
1746585432437,POLI 30,A00,891183,Staff,8,0,50,42
1746585433463,POLI 100B,A00,891244,Staff,5,1,35,30
1746585434490,POLI 100I,A00,891247,Staff,7,0,30,23
1746585435515,POLI 104J,A00,891248,Nichter; Maysa,14,0,30,16
1746585436543,POLI 104U,A00,891250,Nichter; Maysa,1,0,30,29
1746585438594,POLI 110B,A00,891255,Wiens; David,19,0,25,6
1746585439624,POLI 112A,A00,891256,Wiens; David,6,0,25,19
1746585440649,POLI 114BR,A00,891261,Staff,19,0,30,11
1746585441674,POLI 117R,A00,891262,Forman; Fonna,0,6,50,50
1746585442700,POLI 118,A00,891264,Ingham; Sean,17,0,25,8
1746585443731,POLI 124A,A00,891265,Staff,18,0,20,2
1746585444759,POLI 125D,A00,891266,Nichter; Simeon C,2,0,25,23
1746585445790,POLI 126,A00,891268,Nichter; Simeon C,7,0,25,18
1746585446815,POLI 126AA,A00,891272,Staff,15,0,25,10
1746585447843,POLI 130AA,A00,891273,Staff,15,0,20,5
1746585448870,POLI 134AA,A00,891274,Staff,4,0,20,16
1746585450921,POLI 138,A00,891278,Staff,21,0,25,4
1746585451947,POLI 142K,A00,891280,Staff,10,0,25,15
1746585452976,POLI 142M,A00,891281,Gartzke; Erik,16,0,30,14
1746585454003,POLI 142P,A00,891284,Staff,20,0,30,10
1746585455034,POLI 143,A00,891285,Gartzke; Erik,12,0,30,18
1746585456059,POLI 153,A00,891286,Staff,19,0,20,1
1746585458110,POLI 175,A00,891290,Staff,15,0,20,5
1746585459136,PSYC 1,A00,890674,Steiner; Eric Tomas,0,11,45,45
1746585460163,PSYC 2,A00,890676,Albright; Thomas D,20,0,35,15
1746585461190,PSYC 3,A00,890679,Staff,17,0,20,3
1746585462213,PSYC 6,A00,959858,Staff,19,0,20,1
1746585463240,PSYC 60,A01,890684,Rickard; Timothy C.,0,6,45,45
1746585464263,PSYC 70,A01,890689,Geller; Emma Harlan,6,0,30,24
1746585465290,PSYC 71,A01,959860,Staff,21,0,25,4
1746585466314,PSYC 100,A00,890690,Lacefield; Katharine I,0,50,180,180
1746585467340,PSYC 102,A00,890695,Staff,18,0,40,22
1746585468367,PSYC 105,A00,890699,Geller; Emma Harlan,70,0,100,30
1746585469394,PSYC 106,A00,890701,Gorman; Michael R.,5,0,30,25
1746585470422,PSYC 108,A00,890704,Adrian; Julia Anna,0,28,50,50
1746585471451,PSYC 118,A01,890712,Staff,11,0,30,19
1746585472478,PSYC 124,A00,890716,Chapman; Eddie Nathaniel,25,0,60,35
1746585473503,PSYC 131,A00,890717,Anagnostaras; Stephan,0,7,80,80
1746585474528,PSYC 137,A00,890719,Winkielman; Piotr,0,11,30,30
1746585475554,PSYC 144,A00,890721,Adrian; Julia Anna,0,9,45,45
1746585476580,PSYC 162,A00,890805,Staff,0,1,75,75
1746585477607,PSYC 169,A00,890810,Staff,0,15,30,30
1746585478631,PSYC 172,A00,890814,Gorman; Michael R.,9,0,30,21
1746585479658,PSYC 181,A00,890818,Anagnostaras; Stephan,7,0,200,193
1746585480684,PSYC 184,A00,959861,Staff,164,0,175,11
1746585481711,PSYC 189,A00,890823,Staff,0,2,30,30
1746585482742,PSYC 191,A00,890884,Rickard; Timothy C.,0,12,35,35
1746585483766,PSYC 193,A00,890913,Staff,19,0,30,11
1746585483766,PSYC 193,B00,890914,Chapman; Eddie Nathaniel,24,0,30,6
1746585484798,PSYC 193L,A01,890918,Lowe; Angela Beth,20,0,30,10
1746585484798,PSYC 193L,B01,890921,Hurwitz; Ethan Scott,20,0,30,10
1746585484798,PSYC 193L,C01,890928,Staff,30,0,30,0
1746585485821,RELI 149,A00,886806,Rahimi; Babak,23,0,40,17
1746585486847,SE 9,A01,886814,Staff,7,0,20,13
1746585487873,SE 101B,A01,886816,Chadha; Mayank,4,0,35,31
1746585488899,SE 110B,A00,886818,Zhu; Qiang,4,0,75,71
1746585489923,SE 125,A01,886830,Staff,10,0,30,20
1746585490953,SE 130B,A01,886835,Staff,14,0,40,26
1746585491978,SE 131A,A01,886838,Krysl; Petr,34,0,55,21
1746585493007,SE 154,A00,886840,Staff,28,0,50,22
1746585494037,SE 164GS,A01,886849,Staff,6,0,20,14
1746585495064,SE 167GS,A01,886853,Staff,6,0,20,14
1746585496089,SIO 25,A01,890107,Staff,19,0,30,11
1746585497137,SIO 45,A00,890109,Cook; Geoffrey W,116,0,200,84
1746585498162,SIO 109R,A00,890110,Forman; Fonna,0,16,20,20
1746585499186,SIO 187,A01,890114,Kacev; David,15,0,40,25
1746585500211,SOCI 1,A01,890431,Thorpe; Charles Robert,14,0,30,16
1746585500211,SOCI 1,A02,890518,Thorpe; Charles Robert,30,0,30,0
1746585501236,SOCI 2,A01,957978,Staff,25,0,25,0
1746585501236,SOCI 2,A02,957979,Staff,23,0,25,2
1746585502263,SOCI 20,A01,890523,Calderon-Zaks; Michael Aar,21,0,30,9
1746585502263,SOCI 20,A02,890526,Calderon-Zaks; Michael Aar,29,0,30,1
1746585503291,SOCI 30,A01,890533,Pardo Guerra; Juan Pablo,37,0,40,3
1746585504320,SOCI 40,A01,890535,Staff,27,0,45,18
1746585505349,SOCI 104Q,A00,890559,Staff,18,0,30,12
1746585506377,SOCI 106,A00,890560,Arnal; Maud Marie Leonie,20,0,30,10
1746585507404,SOCI 110,A00,890567,Holkenbrink-Monk; Charlene,19,0,30,11
1746585508428,SOCI 112,A00,890568,Victoria Torres; Pablo,2,0,55,53
1746585509453,SOCI 115,A00,890597,Arnal; Maud Marie Leonie,28,0,45,17
1746585511506,SOCI 121,A00,890604,Pardo Guerra; Juan Pablo,38,0,45,7
1746585512534,SOCI 126,A01,890608,Staff,8,0,10,2
1746585513562,SOCI 127,A00,890609,Staff,18,0,30,12
1746585514586,SOCI 131,A00,890610,Thorpe; Charles Robert,37,0,45,8
1746585515614,SOCI 135,A00,890615,Payne; Christine Anna,13,0,45,32
1746585516663,SOCI 139,A00,890620,Staff,38,0,45,7
1746585517687,SOCI 148E,A00,890622,Calderon-Zaks; Michael Aar,36,0,45,9
1746585518713,SOCI 150,A00,890623,Kohler; Kristopher M.,31,0,45,14
1746585519742,SOCI 157,A00,890625,Jules-Rosette; Bennetta W.,18,0,20,2
1746585520766,SOCI 160,A00,890627,Payne; Christine Anna,21,0,45,24
1746585521791,SYN 1,A00,886855,Fish; Gwendolyn Anne,0,1,0,0
1746585521791,SYN 1,B00,906086,Fish; Gwendolyn Anne,0,2,0,2
1746585522815,SYN 2R,A00,886860,Staff,0,17,15,15
1746585522815,SYN 2R,B00,906106,Atkinson; Arthur Laird,0,16,15,15
1746585523848,SYN 100,A01,886866,Browne; Emily,0,28,20,20
1746585523848,SYN 100,B01,906128,Rock; Martin,0,4,20,20
1746585523848,SYN 100,C01,906140,Deavenport; James Cary,0,4,20,20
1746585523848,SYN 100,D01,907816,Deavenport; James Cary,0,5,20,20
1746585524873,TDAC 1,A00,890286,Walsh; Kim C.,7,0,20,13
1746585525897,TDAC 101,A00,890296,Basso; Beatrice,15,0,20,5
1746585526922,TDDE 131,A00,890297,Staff,47,0,50,3
1746585527951,TDDM 1,A00,890287,Weinberg; Sadie,25,0,30,5
1746585528976,TDGE 11,A00,890288,Fulton; Julia,138,0,200,62
1746585528976,TDGE 11,B00,890289,Castro; Robert Jess,184,0,200,16
1746585530001,TDGE 25,B00,957359,Walsh; Kim C.,5,0,20,15
1746585531026,TDGE 40,A01,890292,Power; Jade Yukana,27,0,30,3
1746585532053,TDGE 124,A00,890298,Havis; Allan,0,1,50,50
1746585533079,TDGE 131R,A00,890299,Burelle; Julie Sara Veronique,15,0,42,27
1746585534107,TDHT 101,A00,890300,Staff,10,0,20,10
1746585535135,TDHT 109,A01,890302,Anderson; Mysia Anyse,31,0,40,9
1746585536161,TDMV 1,A00,890293,Arcidiacono; Kristin,18,0,30,12
1746585537188,TDMV 2,A00,890294,Weinberg; Sadie,23,0,30,7
1746585538211,TDMV 3,A00,957878,Arcidiacono; Kristin,28,0,30,2
1746585540264,TDMV 138,A00,890304,Jun; Grace Shin Hae,25,0,40,15
1746585541293,TDMV 140,A00,890305,Corrales; Joseph Bernales,25,0,30,5
1746585542321,TDMV 142,A00,890307,Caligagan; Tony,32,0,40,8
1746585543345,TDMV 144,A00,890308,Camaya; Michelle Ann,25,0,30,5
1746585544370,TDPW 1,A00,890295,Stein; Deborah Isobel,3,0,20,17
1746585545395,USP 2,A01,890272,Lerner; Amy M,7,0,20,13
1746585546420,USP 3,A01,890274,Staff,12,0,30,18
1746585547444,USP 15,A01,890276,Sun; Feiyang,16,0,30,14
1746585548471,USP 25,A00,890277,Shenkman; Michael Thomas,18,0,25,7
1746585549498,USP 138,A00,890278,Staff,13,0,25,12
1746585550523,USP 143,A00,890279,Staff,22,0,70,48
1746585551548,USP 144,A00,890280,Chowdhury; Muhammed Zohir,16,0,30,14
1746585552573,USP 150,A00,890281,Boomhower; Matthew Charles,4,0,30,26
1746585553597,USP 151,A00,890282,Staff,16,0,20,4
1746585554621,USP 162,A00,890283,Andrews; Abigail Leslie,16,0,20,4
1746585555646,USP 168,A00,920477,Kwak; Nancy,0,0,5,5
1746585556673,USP 181,A00,890284,Staff,3,0,20,17
1746585557701,USP 191A,A00,890285,Staff,12,0,20,8
1746585558726,VIS 101,A00,886512,Staff,26,0,75,49
1746585559754,VIS 103,A00,886513,Cruz; Edwin Teddy,61,0,75,14
1746585560780,VIS 108,A00,886514,Staff,3,0,15,12
1746585561807,VIS 127P,A00,886515,Shen; Kuiyi,79,0,146,67
1746585562833,VIS 149,A00,886516,Yoldas; Pinar,0,0,15,15
1746585563858,VIS 164,A00,886526,Erdmann; Dean,19,0,22,3
1746585564888,VIS 194S,A00,886527,Staff,61,0,75,14
1746585565913,WCWP 10A,C00,886484,Martiniuk; Jill,12,0,15,3
1746585566941,WCWP 10B,A00,886490,Uriarte; Emma,0,0,15,15
1746585566941,WCWP 10B,B00,886491,Dhir; Simrita,8,0,15,7
1746585566941,WCWP 10B,C00,886492,Ornelas; Tricia,0,0,15,15
1746585567995,WCWP 100,A00,886494,Young; Mark T,0,6,15,15
1746585570100,AAS 10,A01,886199,Childs; Dennis R.,0,3,0,0
1746585571129,ANAR 104,A01,886940,Shtienberg; Gilad,27,0,30,3
1746585572153,ANAR 120,A00,886953,Staff,13,0,20,7
1746585573182,ANBI 148,A01,886955,Wilder; Linnea Lorene,30,0,40,10
1746585575234,ANSC 122,A00,886957,Staff,24,0,30,6
1746585576263,ANSC 150,A00,886958,Sloane; Julia Kathryn,2,0,15,13
1746585577290,ANSC 156,A00,886959,Jenkins; Janis A.,0,1,15,15
1746585578315,ANSC 180,A00,886960,Staff,11,0,17,6
1746585579341,ANSC 188,A00,886961,Jassal; Aftab,9,0,25,16
1746585580366,ANSC 190,A00,886962,Jassal; Aftab,14,0,25,11
1746585581393,ANSC 191,A00,886963,Staff,18,0,20,2
1746585582426,ANTH 3,A01,891689,Staff,17,0,20,3
1746585583453,ANTH 5,A00,886933,Semendeferi; Ekaterini,16,0,20,4
1746585584482,ANTH 10,A00,886934,Staff,0,12,30,30
1746585585508,ANTH 21,A01,886936,Staff,41,0,60,19
1746585586532,ANTH 23,A01,886938,Staff,92,0,100,8
1746585587558,ANTH 105,A00,886964,Stewart; Alexander B,84,0,100,16
1746585588582,ANTH 108,A00,886965,Pedersen; David,9,0,20,11
1746585589612,AWP 10,001,886147,Staff,0,0,0,0
1746585589612,AWP 10,002,886148,Staff,0,0,0,0
1746585589612,AWP 10,003,886149,Staff,0,0,0,0
1746585589612,AWP 10,004,886150,Staff,0,0,0,0
1746585589612,AWP 10,005,886151,Staff,0,0,0,0
1746585589612,AWP 10,006,886152,Staff,0,0,0,0
1746585589612,AWP 10,007,886153,Staff,0,0,0,0
1746585589612,AWP 10,008,886154,Staff,0,0,0,0
1746585589612,AWP 10,009,886155,Staff,0,0,0,0
1746585589612,AWP 10,010,886156,Staff,0,0,0,0
1746585589612,AWP 10,011,886158,Staff,0,0,0,0
1746585589612,AWP 10,012,886160,Staff,0,0,0,0
1746585589612,AWP 10,013,886161,Staff,0,0,0,0
1746585589612,AWP 10,014,886162,Staff,0,0,0,0
1746585589612,AWP 10,015,886163,Staff,0,0,0,0
1746585589612,AWP 10,016,886164,Staff,0,0,0,0
1746585589612,AWP 10,017,886165,Staff,0,0,0,0
1746585589612,AWP 10,018,886166,Staff,0,0,0,0
1746585589612,AWP 10,019,886168,Staff,0,0,0,0
1746585589612,AWP 10,020,886170,Staff,0,0,0,0
1746585589612,AWP 10,021,886172,Staff,0,0,0,0
1746585590641,AWP 10R,001,886173,Staff,0,1,0,0
1746585590641,AWP 10R,002,886174,Staff,0,1,0,0
1746585590641,AWP 10R,003,886175,Staff,0,0,0,0
1746585590641,AWP 10R,004,886176,Staff,0,0,0,0
1746585590641,AWP 10R,005,886177,Staff,0,0,0,0
1746585590641,AWP 10R,006,886178,Staff,0,0,0,0
1746585590641,AWP 10R,007,886179,Staff,0,0,0,0
1746585590641,AWP 10R,008,886181,Staff,0,0,0,0
1746585590641,AWP 10R,009,886182,Staff,0,0,0,0
1746585590641,AWP 10R,010,886183,Staff,0,0,0,0
1746585590641,AWP 10R,011,886184,Staff,0,0,0,0
1746585590641,AWP 10R,012,886185,Staff,0,0,0,0
1746585590641,AWP 10R,013,886186,Staff,0,0,0,0
1746585590641,AWP 10R,014,886187,Staff,0,0,0,0
1746585590641,AWP 10R,015,886188,Staff,0,0,0,0
1746585590641,AWP 10R,016,886189,Staff,0,0,0,0
1746585590641,AWP 10R,017,960532,Staff,0,0,0,0
1746585590641,AWP 10R,018,960533,Staff,0,0,0,0
1746585590641,AWP 10R,019,960534,Staff,0,0,0,0
1746585590641,AWP 10R,020,960538,Staff,0,0,0,0
1746585590641,AWP 10R,021,960540,Staff,0,0,0,0
1746585590641,AWP 10R,022,960541,Staff,0,0,0,0
1746585590641,AWP 10R,023,960542,Staff,0,0,0,0
1746585590641,AWP 10R,024,960544,Staff,0,0,0,0
1746585590641,AWP 10R,025,960545,Staff,0,0,0,0
1746585590641,AWP 10R,026,960548,Staff,0,0,0,0
1746585591670,AWP 102R,A00,886190,Staff,0,0,0,0
1746585591670,AWP 102R,B00,886191,Staff,0,0,0,0
1746585592695,BENG 100,A01,886193,Staff,17,0,30,13
1746585593721,BENG 122A,A01,886195,Hasty; Jeff M,13,0,30,17
1746585594750,BENG 166A,A00,886196,Sah; Robert Lie-Yuan,0,3,30,30
1746585595775,BENG 190,A00,958050,Khojah; Reem I,17,0,25,8
1746585596804,BIBC 102,A01,894320,Staff,0,0,46,46
1746585596804,BIBC 102,A02,894321,Staff,0,0,46,46
1746585596804,BIBC 102,A03,894344,Staff,6,0,46,40
1746585596804,BIBC 102,A04,894345,Staff,27,0,47,20
1746585597833,BICD 100R,A01,894365,Smith; Laurie,0,3,58,58
1746585597833,BICD 100R,A02,894366,Smith; Laurie,0,5,58,58
1746585597833,BICD 100R,A03,894367,Smith; Laurie,0,0,59,59
1746585597833,BICD 100R,A04,959869,Smith; Laurie,40,0,59,19
1746585598858,BICD 136,A01,894383,Gustafson-Brown; Cindy,14,0,50,36
1746585599888,BIEB 102,A01,894494,Butler; Shannon Rhey,51,0,130,79
1746585601950,BIEB 150,A01,894617,Wills; Christopher,3,0,20,17
1746585601950,BIEB 150,A02,894631,Wills; Christopher,3,0,20,17
1746585601950,BIEB 150,A03,894937,Wills; Christopher,3,0,20,17
1746585601950,BIEB 150,A04,894946,Wills; Christopher,5,0,20,15
1746585602974,BIEB 194,A00,906141,Kurle; Carolyn M.,5,0,20,15
1746585604004,BILD 1,A01,894154,Staff,3,0,19,16
1746585604004,BILD 1,A02,894155,Staff,14,0,19,5
1746585604004,BILD 1,A03,894160,Staff,13,0,19,6
1746585604004,BILD 1,A04,894161,Staff,15,0,18,3
1746585605029,BILD 2,A01,894168,Staff,0,0,50,50
1746585605029,BILD 2,A02,894169,Staff,0,0,50,50
1746585605029,BILD 2,A03,894179,Staff,0,0,50,50
1746585605029,BILD 2,A04,894203,Staff,24,0,50,26
1746585606055,BILD 3,A01,894213,Staff,23,0,31,8
1746585606055,BILD 3,A02,894214,Staff,26,0,31,5
1746585606055,BILD 3,A03,894235,Staff,28,0,31,3
1746585606055,BILD 3,A04,894236,Staff,28,0,32,4
1746585607084,BILD 4,A01,894253,Reuther; Keefe,5,0,24,19
1746585607084,BILD 4,A02,894258,Reuther; Keefe,16,0,24,8
1746585608114,BILD 5,A01,894276,Reuther; Keefe,34,0,50,16
1746585608114,BILD 5,A02,894277,Reuther; Keefe,45,0,50,5
1746585608114,BILD 5,A03,894290,Reuther; Keefe,44,0,50,6
1746585608114,BILD 5,A04,894291,Reuther; Keefe,48,0,50,2
1746585609140,BILD 24,A01,894297,Pirino; Giorgia,40,0,60,20
1746585610170,BIMM 100,B01,958915,Staff,71,0,100,29
1746585611196,BIMM 101,A01,895017,McDonnell; Lisa Marie,0,5,24,24
1746585611196,BIMM 101,A02,895018,McDonnell; Lisa Marie,0,5,24,24
1746585611196,BIMM 101,B01,895020,McDonnell; Lisa Marie,0,6,24,24
1746585611196,BIMM 101,B02,895021,McDonnell; Lisa Marie,0,4,24,24
1746585612223,BIMM 110,A01,895023,Staff,1,0,25,24
1746585612223,BIMM 110,A02,895024,Staff,9,0,25,16
1746585612223,BIMM 110,A03,895025,Staff,18,0,25,7
1746585612223,BIMM 110,A04,895031,Staff,20,0,25,5
1746585613248,BIMM 120,A01,895114,Gustafson-Brown; Cindy,14,0,28,14
1746585613248,BIMM 120,A02,895126,Gustafson-Brown; Cindy,21,0,27,6
1746585614275,BIPN 100,A01,895130,Yang; Mingyu,0,0,38,38
1746585614275,BIPN 100,A02,895131,Yang; Mingyu,31,0,38,7
1746585614275,BIPN 100,A03,895132,Yang; Mingyu,32,0,38,6
1746585614275,BIPN 100,A04,895133,Yang; Mingyu,27,0,36,9
1746585615304,BIPN 120,A01,895135,Cooke; James Edward,0,3,13,13
1746585615304,BIPN 120,A02,895136,Cooke; James Edward,0,1,13,13
1746585615304,BIPN 120,A03,895137,Cooke; James Edward,0,3,13,13
1746585615304,BIPN 120,A04,895156,Cooke; James Edward,0,2,11,11
1746585616330,BIPN 134,A01,895235,Cooke; James Edward,0,2,25,25
1746585616330,BIPN 134,A02,895237,Cooke; James Edward,0,0,25,25
1746585616330,BIPN 134,A03,895240,Cooke; James Edward,3,0,25,22
1746585616330,BIPN 134,A04,895270,Cooke; James Edward,20,0,25,5
1746585617357,BIPN 189,A00,892103,Staff,0,14,14,14
1746585619407,BISP 194,A00,958008,Staff,0,2,0,0
1746585620432,CAT 124,A01,922009,Staff,0,5,20,20
1746585621458,CAT 125R,A00,886390,Morales; Celeste Georgianna,0,2,20,20
1746585621458,CAT 125R,B00,886391,Irwin; Matthew Joseph,0,4,20,20
1746585621458,CAT 125R,C00,886392,Smith; Lauryn Alissa,0,2,20,20
1746585621458,CAT 125R,D00,886393,Vanderschuit; Maya Alysia,0,3,20,20
1746585621458,CAT 125R,E00,886394,Marchisotto; Jennifer Anne,0,3,20,20
1746585622484,CENG 15,A01,886218,Drews; Aaron,3,0,8,5
1746585623510,CENG 113,A00,886219,Opatkiewicz; Justin Paul,15,0,25,10
1746585624536,CGS 101,A00,887044,Staff,7,0,20,13
1746585625562,CGS 105,A01,887046,Staff,14,0,25,11
1746585626590,CGS 112,A00,887047,Cuong; Marisol,12,0,15,3
1746585627615,CGS 113,A00,887048,Staff,23,0,30,7
1746585628640,CGS 120,A00,887049,Staff,10,0,17,7
1746585629665,CHEM 6A,A01,886336,Lam; Tin Yiu,38,0,50,12
1746585629665,CHEM 6A,A02,886338,Lam; Tin Yiu,37,0,50,13
1746585630691,CHEM 6B,A01,886341,Hopkins; Patrycja Anna,16,0,50,34
1746585630691,CHEM 6B,A02,886343,Hopkins; Patrycja Anna,42,0,50,8
1746585631717,CHEM 6C,A01,886346,Albizati; Kim F.,0,2,50,50
1746585631717,CHEM 6C,A02,886348,Albizati; Kim F.,24,0,50,26
1746585632743,CHEM 40A,A01,886352,Klosterman; Jeremy K,65,0,100,35
1746585633768,CHEM 40B,A01,886356,Klosterman; Jeremy K,0,24,100,100
1746585634794,CHEM 41B,A01,886360,Theodorakis; Emmanuel,25,0,50,25
1746585634794,CHEM 41B,A02,886362,Theodorakis; Emmanuel,47,0,50,3
1746585635819,CHIN 165A,A00,886382,Xu; Li,18,0,20,2
1746585636843,CLAS 120,A00,886387,Myerston Santana; Jacobo,33,0,40,7
1746585637868,COGS 9,A01,886967,Shannon; Kyle Michael,42,0,60,18
1746585638894,COGS 11,A01,886969,Staff,9,0,30,21
1746585639923,COGS 14A,A01,886971,Staff,6,0,60,54
1746585640951,COGS 14B,A01,886973,Hoffman; Drew Ellen,4,0,60,56
1746585641976,COGS 18,A01,886975,Morgan; Eric,34,0,60,26
1746585643001,COGS 20,A01,886977,Staff,2,0,8,6
1746585643001,COGS 20,A02,886978,Staff,4,0,7,3
1746585644028,COGS 100,A01,907783,Staff,1,2,30,29
1746585645052,COGS 101B,A01,886980,Staff,0,4,48,48
1746585646077,COGS 101C,A01,886982,Delgado; Tania,0,5,44,44
1746585647106,COGS 102A,A01,886984,Johnson; Christine M.,3,0,30,27
1746585648132,COGS 118B,A01,886986,Staff,1,5,88,87
1746585649160,COGS 150,A01,886988,Bergen; Benjamin,22,0,50,28
1746585650187,COGS 153,A00,886989,Delgado; Tania,0,3,41,41
1746585651214,COGS 186,A01,886991,Staff,0,0,32,32
1746585652241,COGS 187A,A01,886993,Boyle; Mary E. T.,7,0,30,23
1746585653267,COGS 189,A00,886994,Staff,0,1,30,30
1746585654291,COMM 10,A01,886996,Staff,0,0,20,21
1746585654291,COMM 10,A02,886997,Staff,10,0,20,10
1746585654291,COMM 10,A03,959845,Staff,19,0,20,1
1746585655317,COMM 20,A01,886999,Leuning; Grant Maurstad,24,0,40,16
1746585657369,COMM 100A,A01,887002,Staff,0,0,20,25
1746585657369,COMM 100A,A02,887003,Staff,6,0,20,14
1746585658396,COMM 100B,A01,887005,Staff,0,8,20,24
1746585659427,COMM 106D,A00,887006,Staff,13,0,40,27
1746585660453,COMM 110G,A00,887007,Whitworth-Smith; Andrew C,12,0,40,28
1746585661479,COMM 111B,A00,887008,Staff,31,0,40,9
1746585662509,COMM 113T,A00,887009,Abuelhiga; Soraya Jill,28,0,40,12
1746585662509,COMM 113T,B00,906733,Staff,40,0,40,0
1746585663533,COMM 145,A00,887010,Staff,12,0,40,28
1746585664558,COMM 146,A00,887054,Staff,31,0,40,9
1746585665585,COMM 190,A00,887012,Staff,8,0,23,15
1746585666611,CSE 8A,A50,887015,Cao; Yingjun,57,0,85,28
1746585667637,CSE 11,A01,887017,Cao; Yingjun,12,0,70,58
1746585668663,CSE 20,A01,887019,Staff,30,0,50,20
1746585669692,CSE 21,A01,887021,Staff,78,0,100,22
1746585669692,CSE 21,B01,892583,Braun; Oliver,45,0,50,5
1746585670720,CSE 30,A01,887025,Eldon; John,142,0,200,58
1746585671745,CSE 100,A01,887027,Staff,26,0,50,24
1746585671745,CSE 100,A02,887028,Staff,42,0,50,8
1746585672769,CSE 101,A01,887030,Braun; Oliver,74,0,100,26
1746585672769,CSE 101,B01,887032,Jones; Miles E,0,3,50,50
1746585672769,CSE 101,B02,887033,Jones; Miles E,0,2,50,50
1746585673794,CSE 105,A01,908084,Jones; Miles E,32,0,50,18
1746585673794,CSE 105,A02,908087,Jones; Miles E,31,0,50,19
1746585674825,CSE 135,A01,887035,Powell; Thomas Allan,0,5,50,50
1746585675853,CSE 142,A01,887037,Staff,8,0,60,52
1746585676880,CSE 142L,A01,887039,Staff,34,0,60,26
1746585677903,CSE 151A,A01,887041,Solares; Edwin A,47,0,100,53
1746585678932,CSE 175,A01,887043,Kumar; Rakesh,30,0,30,0
1746585679957,CSS 1,A01,886389,Staff,1,2,40,39
1746585680986,DSC 30,A01,908097,Liao; Soohyun Nam,47,0,75,28
1746585682012,DSC 40A,A01,908099,Shannon; Kyle Michael,30,0,50,20
1746585683041,DSC 40B,A01,908112,Staff,15,0,50,35
1746585684066,DSC 80,A01,908116,Staff,19,0,60,41
1746585685094,DSC 197,001,956863,Eldridge; Justin Matthew,9999,0,9999,0
1746585686122,ECE 5,A01,886400,Morris; Karcher William,1,0,6,5
1746585686122,ECE 5,A02,886401,Morris; Karcher William,3,0,6,3
1746585687145,ECE 148,A01,886403,Silberman; Jack,0,14,14,14
1746585688174,ECON 1,A01,887265,Crane; Meredith Helen,11,0,70,59
1746585688174,ECON 1,B01,887268,Staff,42,0,50,8
1746585689199,ECON 2,A01,887273,Crane; Meredith Helen,54,0,70,16
1746585690227,ECON 3,A01,887279,Rondina; Giacomo,31,0,70,39
1746585691255,ECON 4,A01,887282,Anderson; John Charles,0,2,10,10
1746585692282,ECON 5,A01,887285,Staff,34,0,45,11
1746585692282,ECON 5,B01,887292,Staff,41,0,45,4
1746585693306,ECON 100A,A01,887337,Newhouse; Herbert S,54,0,70,16
1746585693306,ECON 100A,B01,887349,Staff,45,0,50,5
1746585694329,ECON 100B,A01,887361,Du; Songzi,29,0,70,41
1746585695359,ECON 100C,A01,887445,Newhouse; Herbert S,59,0,70,11
1746585696384,ECON 105,A00,887488,Vespa; Emanuel Ignacio,23,0,35,12
1746585697415,ECON 109,A01,887506,Shishkin; Denis,28,0,35,7
1746585698444,ECON 110A,A01,887568,Alon; Titan Michael,0,3,35,35
1746585698444,ECON 110A,B01,907601,Alon; Titan Michael,20,0,35,15
1746585699470,ECON 110B,A01,887598,Levkoff; Steven B.,0,24,70,70
1746585700497,ECON 112,A00,887599,Rondina; Giacomo,19,0,35,16
1746585701525,ECON 120A,A01,887603,Dai; Yinlin,35,0,70,35
1746585702572,ECON 120C,A01,887608,Sun; Yixiao,0,1,35,35
1746585702572,ECON 120C,B01,887614,Sun; Yixiao,0,0,35,35
1746585703603,ECON 138,A00,887621,Bharadwaj; Prashant,0,21,20,20
1746585704629,ECON 144,A00,958007,Squires; Dale E,12,0,35,23
1746585705653,ECON 171,A01,907666,Staff,18,0,35,17
1746585706680,ECON 175,A00,887626,Wu; Pak Yeung,22,0,35,13
1746585707705,ECON 190,A00,887640,Vespa; Emanuel Ignacio,22,0,35,13
1746585708737,EDS 25,A01,888197,Staff,0,0,0,0
1746585708737,EDS 25,A02,888209,Staff,0,0,0,0
1746585708737,EDS 25,A03,888210,Staff,0,0,0,0
1746585708737,EDS 25,A04,888212,Staff,0,0,0,0
1746585708737,EDS 25,A05,888213,Staff,0,0,0,0
1746585708737,EDS 25,A06,888214,Staff,0,0,0,0
1746585708737,EDS 25,A07,888235,Staff,0,2,0,0
1746585708737,EDS 25,A08,888236,Staff,0,0,0,0
1746585708737,EDS 25,A09,888240,Staff,0,0,0,0
1746585708737,EDS 25,A10,888244,Staff,0,0,0,0
1746585708737,EDS 25,B01,888273,Staff,0,0,0,0
1746585708737,EDS 25,B02,888285,Staff,0,0,0,0
1746585708737,EDS 25,B03,888423,Staff,0,0,0,1
1746585708737,EDS 25,B04,888432,Staff,0,0,0,0
1746585708737,EDS 25,B05,888433,Staff,0,0,0,0
1746585708737,EDS 25,B06,888467,Staff,0,0,0,0
1746585708737,EDS 25,B07,888468,Staff,0,0,0,0
1746585708737,EDS 25,B08,888479,Staff,0,0,0,0
1746585708737,EDS 25,B09,888484,Staff,0,0,0,0
1746585708737,EDS 25,B10,888487,Staff,0,0,0,0
1746585709761,EDS 38,A01,907700,Choi; Bailey Miyeon,30,0,30,0
1746585710785,EDS 112,A01,888601,Chapman; Thandeka K,12,0,40,28
1746585711813,EDS 115,A00,888697,Mendez; Kathrina Mendoza,10,0,30,20
1746585712840,EDS 116,A01,888893,Staff,34,0,40,6
1746585714895,EDS 124AR,A00,889133,Staff,29,0,50,21
1746585714895,EDS 124AR,B00,907471,Simon; Elizabeth A,37,0,50,13
1746585715921,EDS 124BR,A00,889134,Simon; Elizabeth A,44,0,100,56
1746585716945,EDS 125,A00,889135,Staff,25,0,30,5
1746585717970,EDS 126,A01,889138,Staff,35,0,40,5
1746585718998,EDS 164R,A01,889142,Wishard Guerra; Alison G.,32,0,50,18
1746585720023,ENG 30,A01,886396,Staff,0,0,0,0
1746585720023,ENG 30,B01,886398,Staff,0,0,0,0
1746585721049,ENVR 102,A00,906150,Montejo; Carolina,23,0,25,2
1746585722073,ETHN 103A,A00,887236,Man; Simeon S,0,3,0,0
1746585723096,ETHN 113,A00,887239,Staff,16,0,30,14
1746585724124,ETHN 116,A00,887240,Staff,16,0,25,9
1746585725151,ETHN 117,A00,887241,Choi; Esther Min,28,0,30,2
1746585726176,ETHN 118,A00,887243,Staff,24,0,30,6
1746585727206,ETHN 127,A00,887248,Cuong; Marisol,11,0,15,4
1746585728231,ETHN 139,A00,887250,Staff,7,0,10,3
1746585729259,ETHN 142,A00,887252,Staff,10,0,30,20
1746585730286,ETHN 161,A00,887253,Browne; Errol Tsekani,24,0,30,6
1746585731313,ETHN 163FR,A00,887255,Burelle; Julie Sara Veronique,0,0,5,5
1746585732338,GLBH 20,A00,889149,Elwardani; Nile Regina,8,0,42,34
1746585734392,GLBH 111,A01,889152,Burgos; Jose L.,17,0,17,0
1746585735422,GLBH 150,A00,889181,Sloane; Julia Kathryn,0,5,15,15
1746585737475,HDS 60,A01,886406,Warstadt; Melissa Fawn,73,0,80,7
1746585738499,HIAF 111,A00,889324,Gyamfi; Bright,25,0,32,7
1746585739526,HIEA 131,A00,889328,Staff,15,0,32,17
1746585740556,HIEA 144,A00,889333,Henry; Todd A.,26,0,32,6
1746585741584,HIEA 154,A00,889336,Henry; Todd A.,24,0,32,8
1746585742611,HIEU 106,A00,889339,Staff,22,0,32,10
1746585744664,HIEU 114,A00,889340,Staff,4,0,32,28
1746585745693,HIEU 135GS,A00,889342,Patterson; Patrick H.,0,0,1,24
1746585746720,HIEU 137,A00,889343,Edington; Claire Ellen,10,0,25,15
1746585747751,HIEU 148,A00,889345,Staff,14,0,32,18
1746585748777,HIEU 154,A00,889346,Biess; Frank Peter,21,0,32,11
1746585749807,HILA 102,A00,889351,Staff,12,0,32,20
1746585750834,HILD 2A,A01,889221,Lewandoski; Julia Mavis,2,10,32,30
1746585751858,HILD 7B,A01,889225,Man; Simeon S,0,12,32,32
1746585752885,HILD 7C,A01,889288,Alvarez; Luis A,0,14,32,32
1746585753911,HILD 30,A01,889323,Staff,0,5,32,32
1746585755962,HISC 119,A00,889383,Golan; Tal,19,0,32,13
1746585756988,HIUS 103,A00,889384,Man; Simeon S,0,0,32,32
1746585758015,HIUS 117,A00,919797,Kwak; Nancy,19,0,32,13
1746585759041,HIUS 142A,A00,919788,Staff,22,0,32,10
1746585761101,HIUS 149,A00,889386,Gyamfi; Bright,26,0,32,6
1746585762128,HIUS 155,A00,889387,Alvarez; Luis A,15,0,32,17
1746585763156,HUM 3,A01,886499,Caldwell; Michael Alan,19,0,50,31
1746585764181,HUM 3GS,A00,886500,Rodriguez; Bretton Sigfred,0,0,0,28
1746585765210,HUM 3R,A01,886502,Markman; Kristina,0,36,50,50
1746585766240,HUM 4,A01,886504,Crum; Matthew Stephen,23,0,50,27
1746585766240,HUM 4,B01,886506,West; Geoffrey Scott,17,0,50,33
1746585767289,HUM 4GS,A00,886507,Staff,0,0,0,19
1746585768315,HUM 5,A01,886509,Staff,32,0,50,18
1746585769344,HUM 5R,A01,886511,Zavodny; Tatiana Sophia,0,39,50,50
1746585770385,JAPN 180,A00,886407,Staff,16,0,40,24
1746585771414,LATI 50,A01,886409,Martin-Cabrera; Luis,3,0,22,19
1746585771414,LATI 50,A02,886410,Martin-Cabrera; Luis,19,0,22,3
1746585771414,LATI 50,A03,886411,Martin-Cabrera; Luis,21,0,22,1
1746585771414,LATI 50,A04,886412,Martin-Cabrera; Luis,8,0,22,14
1746585772441,LAWS 101,A00,907664,Staff,28,0,60,32
1746585773464,LIAB 1A,A00,889388,Saab; Dima,17,0,20,3
1746585774488,LIAB 1AX,A00,889389,El Cheddadi; Youniss,18,0,20,2
1746585775515,LIFR 1C,A00,889391,Van Moer; Vinciane G,8,0,20,12
1746585776546,LIFR 1CX,A00,889392,Van Moer; Vinciane G,7,0,20,13
1746585777571,LIFR 1D,A00,889393,Van Moer; Vinciane G,7,0,20,13
1746585778595,LIFR 1DX,A00,889394,Van Moer; Vinciane G,8,0,20,12
1746585779620,LIGN 7,A00,886923,Staff,24,0,50,26
1746585780647,LIGN 17,A00,886924,Kehler; Andrew Scott,125,0,150,25
1746585781672,LTAM 110,A00,889395,Staff,15,0,30,15
1746585782697,LTAM 110GS,A00,958010,Rodriguez; Bretton Sigfred,0,0,0,28
1746585783722,LTCH 101,A00,889397,Staff,23,0,25,2
1746585784745,LTCS 130,A00,889398,Staff,23,0,25,2
1746585785773,LTEA 138,A00,889399,Staff,24,0,40,16
1746585786803,LTEN 149,A00,889400,Wesling; Megan E.,0,3,25,25
1746585787833,LTEN 169,A00,889401,Staff,20,0,25,5
1746585788863,LTEN 180,A00,889402,Staff,10,0,15,5
1746585789893,LTEN 181,A00,889403,Staff,21,0,25,4
1746585790919,LTWL 100,A00,889404,Myerston Santana; Jacobo,2,0,25,23
1746585791943,LTWL 180GS,A00,889405,Staff,0,0,20,20
1746585792968,LTWL 181,A00,889406,Staff,16,0,25,9
1746585793995,LTWL 184,A00,889475,Mukherjee; Silpa,22,0,25,3
1746585795022,LTWR 102C,A00,889486,Staff,29,0,30,1
1746585796050,LTWR 115W,A00,889491,Staff,0,2,15,15
1746585797080,MAE 8,A01,886905,Staff,0,2,0,0
1746585798103,MAE 11,A00,886906,Bandaru; Prabhakar,0,7,50,50
1746585799129,MAE 20,A00,886907,Evdokimenko; Ekaterina,43,0,70,27
1746585800161,MAE 30B,A00,886909,Ghazinejad; Maziar,26,0,45,19
1746585801185,MAE 101B,A00,886910,Saintillan; David,29,0,45,16
1746585802212,MAE 105,A00,886911,Bandaru; Prabhakar,18,0,50,32
1746585803243,MAE 107,B00,958024,Staff,7,0,50,43
1746585804272,MAE 143B,A00,886913,Bewley; Thomas R,3,0,40,37
1746585805305,MAE 148,A01,886915,Silberman; Jack,0,3,14,14
1746585806337,MAE 160,A00,886916,Evdokimenko; Ekaterina,31,0,60,29
1746585807364,MATH 3C,A01,889681,Staff,0,2,30,30
1746585807364,MATH 3C,A02,960048,Staff,23,0,30,7
1746585808393,MATH 10A,A01,889760,Staff,26,0,30,4
1746585808393,MATH 10A,A02,889783,Staff,29,0,30,1
1746585809427,MATH 10B,A01,889785,Verstraete; Jacques Allan,1,0,35,34
1746585809427,MATH 10B,A02,889795,Verstraete; Jacques Allan,4,0,35,31
1746585809427,MATH 10B,B01,889797,Verstraete; Jacques Allan,3,0,35,32
1746585809427,MATH 10B,B02,889828,Verstraete; Jacques Allan,3,0,35,32
1746585810452,MATH 10C,A01,889849,Habib; Yousaf,7,0,30,23
1746585810452,MATH 10C,A02,889852,Habib; Yousaf,14,0,30,16
1746585810452,MATH 10C,A03,889853,Habib; Yousaf,22,0,30,8
1746585810452,MATH 10C,A04,889858,Habib; Yousaf,20,0,30,10
1746585810452,MATH 10C,B01,889861,Staff,1,0,30,29
1746585810452,MATH 10C,B02,889862,Staff,24,0,30,6
1746585810452,MATH 10C,B03,889863,Staff,27,0,30,3
1746585810452,MATH 10C,B04,889967,Staff,23,0,30,7
1746585811481,MATH 18,A01,889974,Staff,7,0,30,23
1746585811481,MATH 18,A02,889977,Staff,20,0,30,10
1746585811481,MATH 18,B01,889984,Hardiman; Liam,20,0,30,10
1746585811481,MATH 18,B02,889985,Hardiman; Liam,25,0,30,5
1746585812510,MATH 20A,A01,889990,Suk; Andrew Hoon,30,0,35,5
1746585813541,MATH 20B,A01,889993,Ohm; Ko Woon,21,0,30,9
1746585813541,MATH 20B,A02,889994,Ohm; Ko Woon,30,0,30,0
1746585813541,MATH 20B,B01,889996,Ohm; Ko Woon,22,0,30,8
1746585813541,MATH 20B,B02,889997,Ohm; Ko Woon,23,0,30,7
1746585814565,MATH 20C,A01,889999,Hammock; Frances H,17,0,30,13
1746585814565,MATH 20C,A02,890003,Hammock; Frances H,23,0,30,7
1746585814565,MATH 20C,B01,890006,Hammock; Frances H,3,0,30,27
1746585814565,MATH 20C,B02,890007,Hammock; Frances H,12,0,30,18
1746585815591,MATH 20D,A01,890011,Cheng; Hsiao-Bing,1,1,30,29
1746585815591,MATH 20D,A02,890012,Cheng; Hsiao-Bing,14,0,30,16
1746585815591,MATH 20D,B01,890016,Cheng; Hsiao-Bing,13,0,30,17
1746585815591,MATH 20D,B02,890017,Cheng; Hsiao-Bing,13,0,30,17
1746585816623,MATH 20E,A01,890026,Harel; Guershon,1,0,30,29
1746585816623,MATH 20E,A02,890029,Harel; Guershon,22,0,30,8
1746585816623,MATH 20E,B01,890033,Harel; Guershon,7,0,30,23
1746585816623,MATH 20E,B02,890101,Harel; Guershon,21,0,30,9
1746585817664,MATH 102,A01,890104,Staff,18,0,30,12
1746585817664,MATH 102,A02,890105,Staff,27,0,30,3
1746585818696,MATH 103B,A01,890116,Salehi Golsefidy; Alireza,3,0,30,27
1746585818696,MATH 103B,B01,890118,Staff,0,3,34,34
1746585819724,MATH 109,A01,890121,Aliabadi Sr.; Mohsen,0,0,30,30
1746585819724,MATH 109,B01,890124,Upadrashta; Pranav Kumar,18,0,30,12
1746585820755,MATH 120A,A01,890126,Eggers; John Dietrich,13,0,30,17
1746585821782,MATH 142B,A01,890128,Ioana; Adrian,19,0,30,11
1746585821782,MATH 142B,A02,890129,Ioana; Adrian,12,0,30,18
1746585822811,MATH 154,A01,890174,Staff,0,1,30,30
1746585822811,MATH 154,A02,890182,Staff,0,0,30,30
1746585823836,MATH 168A,A01,890197,Dumitriu; Ioana,21,0,35,14
1746585824867,MATH 170A,A01,890240,Nie; Jiawang,1,0,30,29
1746585824867,MATH 170A,A02,890241,Nie; Jiawang,11,0,30,19
1746585824867,MATH 170A,A03,890249,Nie; Jiawang,23,0,30,7
1746585825892,MATH 170B,A01,957891,Nag; Panchali,13,0,35,22
1746585827944,MATH 181A,A01,908025,Staff,0,3,35,35
1746585827944,MATH 181A,A02,960115,Staff,26,0,35,9
1746585828973,MATH 181B,A01,959874,Staff,25,0,30,5
1746585829998,MATH 193B,A01,890265,Staff,0,4,35,35
1746585831029,MGT 4,A01,890311,Anderson; John Charles,42,0,88,46
1746585832054,MGT 5,A00,907740,Staff,13,0,98,85
1746585833079,MGT 12,A00,890312,Lindenberger; Wade Douglas,67,0,98,31
1746585834103,MGT 16,A00,957883,Staff,78,0,98,20
1746585836155,MGT 45,A00,890314,Pecore; Joseph P.,45,0,98,53
1746585837179,MGT 71,A00,890315,Staff,0,12,98,98
1746585838207,MGT 100,A00,890316,Yavorsky; Daniel Ryan,44,0,98,54
1746585839232,MGT 103,A00,890317,Ehrich; Kristine R,73,0,98,25
1746585840257,MGT 105,A00,890356,Bates; Kenneth Walter,0,8,98,98
1746585841284,MGT 112,A00,890360,Ehrich; Kristine R,55,0,98,43
1746585842313,MGT 127R,A00,907732,Zhu; Kevin Xiaoguo,23,0,98,75
1746585843338,MGT 131B,A00,890361,Anderson; John Charles,59,0,98,39
1746585844362,MGT 137,A00,890362,Lindenberger; Wade Douglas,65,0,98,33
1746585845387,MGT 160,A00,890369,Johnson; Erik Barry,9,0,98,89
1746585847439,MGT 164,A00,890372,Zimmermann; Carsten,0,40,98,98
1746585848465,MGT 180,A00,890374,Bliss; Barbara Ann,12,0,98,86
1746585849498,MMW 15,A01,886414,Chang; Edmond Yi-Teh,0,12,28,28
1746585849498,MMW 15,A02,886415,Chang; Edmond Yi-Teh,0,8,28,28
1746585849498,MMW 15,A03,886416,Chang; Edmond Yi-Teh,0,9,28,28
1746585849498,MMW 15,A04,886417,Chang; Edmond Yi-Teh,0,8,28,28
1746585849498,MMW 15,B01,886419,Chang; Edmond Yi-Teh,0,7,28,28
1746585849498,MMW 15,B02,886420,Chang; Edmond Yi-Teh,0,8,28,28
1746585849498,MMW 15,B03,886421,Chang; Edmond Yi-Teh,0,7,28,28
1746585849498,MMW 15,B04,886422,Chang; Edmond Yi-Teh,0,8,28,28
1746585849498,MMW 15,C01,886424,Staff,0,9,28,28
1746585849498,MMW 15,C02,886425,Staff,0,8,28,28
1746585849498,MMW 15,C03,886426,Staff,0,8,28,28
1746585849498,MMW 15,C04,886427,Staff,0,8,28,28
1746585849498,MMW 15,C05,958038,Staff,0,8,28,28
1746585849498,MMW 15,C06,958039,Staff,1,8,28,27
1746585850527,MMW 15GS,A00,906910,Patterson; Patrick H.,4,0,28,24
1746585851554,MMW 122R,A01,886429,Rahimi; Babak,0,13,28,28
1746585851554,MMW 122R,A02,886430,Rahimi; Babak,0,12,28,28
1746585851554,MMW 122R,A03,958040,Rahimi; Babak,0,11,28,28
1746585852580,MUS 1A,A01,890937,Staff,2,0,25,23
1746585852580,MUS 1A,A02,891035,Staff,6,0,25,19
1746585852580,MUS 1A,C01,958912,Staff,24,0,25,1
1746585852580,MUS 1A,C02,958913,Staff,25,0,25,0
1746585854636,MUS 2AK,A00,957092,Ohnishi; Takae,15,0,15,0
1746585855662,MUS 4,A01,891044,Staff,1,0,25,24
1746585855662,MUS 4,A02,891045,Staff,23,0,25,2
1746585855662,MUS 4,B01,891048,Staff,17,0,25,8
1746585855662,MUS 4,B02,891050,Staff,25,0,25,0
1746585856694,MUS 5,A01,957506,Dubnov; Shlomo,0,0,25,25
1746585856694,MUS 5,A02,957622,Dubnov; Shlomo,13,0,25,12
1746585856694,MUS 5,A03,957623,Dubnov; Shlomo,20,0,25,5
1746585857718,MUS 6,A01,891053,Freitas Caetano; Marcelo,24,0,25,1
1746585857718,MUS 6,A02,891054,Freitas Caetano; Marcelo,23,0,25,2
1746585858746,MUS 7,A01,891081,Staff,0,0,25,25
1746585858746,MUS 7,A02,891082,Staff,3,0,25,22
1746585859771,MUS 8GS,A00,891118,Borgo; David Garcia,1,0,25,24
1746585860816,MUS 11,A01,891140,Staff,9,0,25,16
1746585860816,MUS 11,A02,891141,Staff,21,0,25,4
1746585861843,MUS 13,A01,891143,Staff,8,0,25,17
1746585861843,MUS 13,A02,891144,Staff,24,0,25,1
1746585862873,MUS 15,A01,891146,Staff,9,0,25,16
1746585862873,MUS 15,A02,891148,Staff,21,0,25,4
1746585862873,MUS 15,B01,891150,Staff,18,0,25,7
1746585862873,MUS 15,B02,891151,Staff,25,0,25,0
1746585863901,MUS 20,A01,891153,Staff,5,0,20,15
1746585863901,MUS 20,A02,891155,Staff,14,0,20,6
1746585864927,MUS 80,A00,891156,Staff,19,0,25,6
1746585864927,MUS 80,B00,891157,Staff,23,0,25,2
1746585865952,MUS 130,A00,891158,Ohnishi; Takae,35,0,35,0
1746585866979,MUS 150GS,A01,891160,Borgo; David Garcia,1,0,25,24
1746585868005,MUS 170,A01,891162,Freitas Caetano; Marcelo,20,0,25,5
1746585868005,MUS 170,A02,891164,Freitas Caetano; Marcelo,21,0,25,4
1746585869030,NANO 11,A00,886220,Vazquez Mena; Oscar,13,0,15,2
1746585870058,NANO 15,A01,886222,Drews; Aaron,4,0,7,3
1746585871087,NANO 104,A00,886224,Sirbuly; Donald,17,0,25,8
1746585872112,PH 40,A00,886528,Staff,24,0,40,16
1746585873140,PH 45,A01,886799,Staff,35,0,40,5
1746585874165,PH 110,A00,886802,Staff,0,7,40,40
1746585875195,PH 172,A00,906716,Staff,19,0,35,16
1746585876225,PH 191,A00,886803,Staff,6,0,40,34
1746585877251,PHIL 1,A00,889500,Staff,20,0,30,10
1746585878282,PHIL 10,A01,889549,Grush; Rick Scott,16,0,22,6
1746585878282,PHIL 10,A02,889551,Grush; Rick Scott,22,0,22,0
1746585879311,PHIL 28,A01,889559,Lamey; Andy M.,0,2,31,31
1746585879311,PHIL 28,A02,889561,Lamey; Andy M.,0,1,30,30
1746585879311,PHIL 28,A03,889572,Lamey; Andy M.,0,1,30,30
1746585880337,PHIL 35,A00,907839,Staff,13,0,15,2
1746585881362,PHIL 60,A00,889574,Staff,73,0,90,17
1746585882400,PHIL 101,A00,958004,Staff,12,0,15,3
1746585884452,PHIL 136,A00,889582,Fulkerson; Matthew Todd,26,0,45,19
1746585885482,PHIL 163,A01,889601,Staff,21,0,30,9
1746585885482,PHIL 163,B01,889606,Brandt; Reuven A,0,3,0,0
1746585886508,PHIL 164,A00,889610,Staff,16,0,30,14
1746585887532,PHIL 165,A00,889613,Staff,22,0,30,8
1746585888574,PHYS 1A,A00,886431,Staff,29,0,70,41
1746585889602,PHYS 1AL,001,886432,Tsai; Philbert S,1,2,30,29
1746585889602,PHYS 1AL,002,886436,Tsai; Philbert S,12,0,30,18
1746585890631,PHYS 1B,A00,886439,Staff,184,0,240,56
1746585891655,PHYS 1BL,001,886441,Tsai; Philbert S,0,4,30,30
1746585891655,PHYS 1BL,002,886444,Tsai; Philbert S,2,0,30,28
1746585892684,PHYS 1C,A00,896092,Arnold; Kam S,78,0,146,68
1746585893714,PHYS 1CL,001,886448,Tsai; Philbert S,0,0,30,30
1746585893714,PHYS 1CL,002,886449,Tsai; Philbert S,1,0,30,29
1746585893714,PHYS 1CL,003,886450,Tsai; Philbert S,16,0,30,14
1746585893714,PHYS 1CL,004,886451,Tsai; Philbert S,15,0,30,15
1746585894762,PHYS 2B,A01,886457,Staff,67,0,115,48
1746585895855,PHYS 2C,A01,886460,Shotwell; Brian,0,9,65,65
1746585896882,PHYS 2CL,A01,886467,Staff,0,4,28,28
1746585896882,PHYS 2CL,A02,886468,Staff,0,3,28,28
1746585897908,PHYS 2D,A01,886470,Staff,10,0,50,40
1746585898936,PHYS 4B,A01,886475,Grinstein; Benjamin,22,0,40,18
1746585899968,POLI 5,A00,891173,Desposato; Scott,7,0,25,18
1746585900991,POLI 5D,A01,891175,Staff,5,0,5,0
1746585900991,POLI 5D,B01,891178,Staff,5,0,5,0
1746585902021,POLI 11,A00,891179,Ferree; Karen E,2,0,35,33
1746585903049,POLI 12,A00,891180,Staff,16,0,30,14
1746585904075,POLI 27,A01,891182,Staff,12,0,75,63
1746585905101,POLI 30,A00,891183,Staff,8,0,50,42
1746585906130,POLI 100B,A00,891244,Staff,5,1,35,30
1746585907156,POLI 100I,A00,891247,Staff,7,0,30,23
1746585908185,POLI 104J,A00,891248,Nichter; Maysa,14,0,30,16
1746585909217,POLI 104U,A00,891250,Nichter; Maysa,1,0,30,29
1746585911268,POLI 110B,A00,891255,Wiens; David,19,0,25,6
1746585912299,POLI 112A,A00,891256,Wiens; David,6,0,25,19
1746585913327,POLI 114BR,A00,891261,Staff,19,0,30,11
1746585914353,POLI 117R,A00,891262,Forman; Fonna,0,6,50,50
1746585915375,POLI 118,A00,891264,Ingham; Sean,17,0,25,8
1746585916403,POLI 124A,A00,891265,Staff,18,0,20,2
1746585917426,POLI 125D,A00,891266,Nichter; Simeon C,2,0,25,23
1746585918451,POLI 126,A00,891268,Nichter; Simeon C,7,0,25,18
1746585919477,POLI 126AA,A00,891272,Staff,15,0,25,10
1746585920503,POLI 130AA,A00,891273,Staff,15,0,20,5
1746585921529,POLI 134AA,A00,891274,Staff,4,0,20,16
1746585923580,POLI 138,A00,891278,Staff,21,0,25,4
1746585924606,POLI 142K,A00,891280,Staff,10,0,25,15
1746585925634,POLI 142M,A00,891281,Gartzke; Erik,16,0,30,14
1746585926659,POLI 142P,A00,891284,Staff,20,0,30,10
1746585927685,POLI 143,A00,891285,Gartzke; Erik,12,0,30,18
1746585928713,POLI 153,A00,891286,Staff,19,0,20,1
1746585930768,POLI 175,A00,891290,Staff,15,0,20,5
1746585931798,PSYC 1,A00,890674,Steiner; Eric Tomas,0,11,45,45
1746585932826,PSYC 2,A00,890676,Albright; Thomas D,20,0,35,15
1746585933855,PSYC 3,A00,890679,Staff,17,0,20,3
1746585934884,PSYC 6,A00,959858,Staff,19,0,20,1
1746585935911,PSYC 60,A01,890684,Rickard; Timothy C.,0,6,45,45
1746585936941,PSYC 70,A01,890689,Geller; Emma Harlan,6,0,30,24
1746585937969,PSYC 71,A01,959860,Staff,21,0,25,4
1746585938994,PSYC 100,A00,890690,Lacefield; Katharine I,0,50,180,180
1746585940019,PSYC 102,A00,890695,Staff,18,0,40,22
1746585941048,PSYC 105,A00,890699,Geller; Emma Harlan,70,0,100,30
1746585942074,PSYC 106,A00,890701,Gorman; Michael R.,5,0,30,25
1746585943099,PSYC 108,A00,890704,Adrian; Julia Anna,0,28,50,50
1746585944127,PSYC 118,A01,890712,Staff,11,0,30,19
1746585945154,PSYC 124,A00,890716,Chapman; Eddie Nathaniel,25,0,60,35
1746585946180,PSYC 131,A00,890717,Anagnostaras; Stephan,0,7,80,80
1746585947209,PSYC 137,A00,890719,Winkielman; Piotr,0,11,30,30
1746585948232,PSYC 144,A00,890721,Adrian; Julia Anna,0,9,45,45
1746585949259,PSYC 162,A00,890805,Staff,0,1,75,75
1746585950285,PSYC 169,A00,890810,Staff,0,15,30,30
1746585951312,PSYC 172,A00,890814,Gorman; Michael R.,9,0,30,21
1746585952340,PSYC 181,A00,890818,Anagnostaras; Stephan,7,0,200,193
1746585953366,PSYC 184,A00,959861,Staff,164,0,175,11
1746585954390,PSYC 189,A00,890823,Staff,0,2,30,30
1746585955416,PSYC 191,A00,890884,Rickard; Timothy C.,0,12,35,35
1746585956442,PSYC 193,A00,890913,Staff,19,0,30,11
1746585956442,PSYC 193,B00,890914,Chapman; Eddie Nathaniel,24,0,30,6
1746585957467,PSYC 193L,A01,890918,Lowe; Angela Beth,20,0,30,10
1746585957467,PSYC 193L,B01,890921,Hurwitz; Ethan Scott,20,0,30,10
1746585957467,PSYC 193L,C01,890928,Staff,30,0,30,0
1746585958494,RELI 149,A00,886806,Rahimi; Babak,23,0,40,17
1746585959522,SE 9,A01,886814,Staff,7,0,20,13
1746585960552,SE 101B,A01,886816,Chadha; Mayank,4,0,35,31
1746585961581,SE 110B,A00,886818,Zhu; Qiang,4,0,75,71
1746585962611,SE 125,A01,886830,Staff,10,0,30,20
1746585963637,SE 130B,A01,886835,Staff,14,0,40,26
1746585964667,SE 131A,A01,886838,Krysl; Petr,34,0,55,21
1746585965696,SE 154,A00,886840,Staff,28,0,50,22
1746585966720,SE 164GS,A01,886849,Staff,6,0,20,14
1746585967747,SE 167GS,A01,886853,Staff,6,0,20,14
1746585968775,SIO 25,A01,890107,Staff,19,0,30,11
1746585969804,SIO 45,A00,890109,Cook; Geoffrey W,116,0,200,84
1746585970835,SIO 109R,A00,890110,Forman; Fonna,0,16,20,20
1746585971861,SIO 187,A01,890114,Kacev; David,15,0,40,25
1746585972890,SOCI 1,A01,890431,Thorpe; Charles Robert,14,0,30,16
1746585972890,SOCI 1,A02,890518,Thorpe; Charles Robert,30,0,30,0
1746585973917,SOCI 2,A01,957978,Staff,25,0,25,0
1746585973917,SOCI 2,A02,957979,Staff,23,0,25,2
1746585974943,SOCI 20,A01,890523,Calderon-Zaks; Michael Aar,21,0,30,9
1746585974943,SOCI 20,A02,890526,Calderon-Zaks; Michael Aar,29,0,30,1
1746585975969,SOCI 30,A01,890533,Pardo Guerra; Juan Pablo,37,0,40,3
1746585976997,SOCI 40,A01,890535,Staff,27,0,45,18
1746585978027,SOCI 104Q,A00,890559,Staff,18,0,30,12
1746585979055,SOCI 106,A00,890560,Arnal; Maud Marie Leonie,20,0,30,10
1746585980082,SOCI 110,A00,890567,Holkenbrink-Monk; Charlene,19,0,30,11
1746585981131,SOCI 112,A00,890568,Victoria Torres; Pablo,2,0,55,53
1746585982158,SOCI 115,A00,890597,Arnal; Maud Marie Leonie,28,0,45,17
1746585984284,SOCI 121,A00,890604,Pardo Guerra; Juan Pablo,38,0,45,7
1746585985313,SOCI 126,A01,890608,Staff,8,0,10,2
1746585986338,SOCI 127,A00,890609,Staff,18,0,30,12
1746585987364,SOCI 131,A00,890610,Thorpe; Charles Robert,37,0,45,8
1746585988392,SOCI 135,A00,890615,Payne; Christine Anna,13,0,45,32
1746585989419,SOCI 139,A00,890620,Staff,38,0,45,7
1746585990448,SOCI 148E,A00,890622,Calderon-Zaks; Michael Aar,36,0,45,9
1746585991479,SOCI 150,A00,890623,Kohler; Kristopher M.,31,0,45,14
1746585992508,SOCI 157,A00,890625,Jules-Rosette; Bennetta W.,18,0,20,2
1746585993534,SOCI 160,A00,890627,Payne; Christine Anna,21,0,45,24
1746585994560,SYN 1,A00,886855,Fish; Gwendolyn Anne,0,1,0,0
1746585994560,SYN 1,B00,906086,Fish; Gwendolyn Anne,0,2,0,2
1746585995588,SYN 2R,A00,886860,Staff,0,17,15,15
1746585995588,SYN 2R,B00,906106,Atkinson; Arthur Laird,0,16,15,15
1746585996615,SYN 100,A01,886866,Browne; Emily,0,28,20,20
1746585996615,SYN 100,B01,906128,Rock; Martin,0,4,20,20
1746585996615,SYN 100,C01,906140,Deavenport; James Cary,0,4,20,20
1746585996615,SYN 100,D01,907816,Deavenport; James Cary,0,5,20,20
1746585997640,TDAC 1,A00,890286,Walsh; Kim C.,7,0,20,13
1746585998666,TDAC 101,A00,890296,Basso; Beatrice,15,0,20,5
1746585999692,TDDE 131,A00,890297,Staff,47,0,50,3
1746586000723,TDDM 1,A00,890287,Weinberg; Sadie,25,0,30,5
1746586001752,TDGE 11,A00,890288,Fulton; Julia,138,0,200,62
1746586001752,TDGE 11,B00,890289,Castro; Robert Jess,185,0,200,15
1746586002781,TDGE 25,B00,957359,Walsh; Kim C.,5,0,20,15
1746586003805,TDGE 40,A01,890292,Power; Jade Yukana,27,0,30,3
1746586004831,TDGE 124,A00,890298,Havis; Allan,0,1,50,50
1746586005857,TDGE 131R,A00,890299,Burelle; Julie Sara Veronique,15,0,42,27
1746586006882,TDHT 101,A00,890300,Staff,10,0,20,10
1746586007910,TDHT 109,A01,890302,Anderson; Mysia Anyse,31,0,40,9
1746586008939,TDMV 1,A00,890293,Arcidiacono; Kristin,18,0,30,12
1746586009965,TDMV 2,A00,890294,Weinberg; Sadie,23,0,30,7
1746586010991,TDMV 3,A00,957878,Arcidiacono; Kristin,28,0,30,2
1746586013041,TDMV 138,A00,890304,Jun; Grace Shin Hae,25,0,40,15
1746586014066,TDMV 140,A00,890305,Corrales; Joseph Bernales,25,0,30,5
1746586015091,TDMV 142,A00,890307,Caligagan; Tony,32,0,40,8
1746586016115,TDMV 144,A00,890308,Camaya; Michelle Ann,25,0,30,5
1746586017142,TDPW 1,A00,890295,Stein; Deborah Isobel,3,0,20,17
1746586018168,USP 2,A01,890272,Lerner; Amy M,7,0,20,13
1746586019194,USP 3,A01,890274,Staff,12,0,30,18
1746586020222,USP 15,A01,890276,Sun; Feiyang,16,0,30,14
1746586021248,USP 25,A00,890277,Shenkman; Michael Thomas,18,0,25,7
1746586022279,USP 138,A00,890278,Staff,13,0,25,12
1746586023307,USP 143,A00,890279,Staff,22,0,70,48
1746586024332,USP 144,A00,890280,Chowdhury; Muhammed Zohir,16,0,30,14
1746586025362,USP 150,A00,890281,Boomhower; Matthew Charles,4,0,30,26
1746586026387,USP 151,A00,890282,Staff,16,0,20,4
1746586027410,USP 162,A00,890283,Andrews; Abigail Leslie,16,0,20,4
1746586028435,USP 168,A00,920477,Kwak; Nancy,0,0,5,5
1746586029461,USP 181,A00,890284,Staff,3,0,20,17
1746586030491,USP 191A,A00,890285,Staff,12,0,20,8
1746586031522,VIS 101,A00,886512,Staff,26,0,75,49
1746586032549,VIS 103,A00,886513,Cruz; Edwin Teddy,61,0,75,14
1746586033574,VIS 108,A00,886514,Staff,3,0,15,12
1746586034598,VIS 127P,A00,886515,Shen; Kuiyi,79,0,146,67
1746586035624,VIS 149,A00,886516,Yoldas; Pinar,0,0,15,15
1746586036648,VIS 164,A00,886526,Erdmann; Dean,19,0,22,3
1746586037674,VIS 194S,A00,886527,Staff,61,0,75,14
1746586038705,WCWP 10A,C00,886484,Martiniuk; Jill,12,0,15,3
1746586039732,WCWP 10B,A00,886490,Uriarte; Emma,0,0,15,15
1746586039732,WCWP 10B,B00,886491,Dhir; Simrita,8,0,15,7
1746586039732,WCWP 10B,C00,886492,Ornelas; Tricia,0,0,15,15
1746586040759,WCWP 100,A00,886494,Young; Mark T,0,6,15,15
1746586042870,AAS 10,A01,886199,Childs; Dennis R.,0,3,0,0
1746586043899,ANAR 104,A01,886940,Shtienberg; Gilad,27,0,30,3
1746586044924,ANAR 120,A00,886953,Staff,13,0,20,7
1746586045952,ANBI 148,A01,886955,Wilder; Linnea Lorene,30,0,40,10
1746586048003,ANSC 122,A00,886957,Staff,24,0,30,6
1746586049032,ANSC 150,A00,886958,Sloane; Julia Kathryn,2,0,15,13
1746586050059,ANSC 156,A00,886959,Jenkins; Janis A.,0,1,15,15
1746586051083,ANSC 180,A00,886960,Staff,11,0,17,6
1746586052112,ANSC 188,A00,886961,Jassal; Aftab,9,0,25,16
1746586053146,ANSC 190,A00,886962,Jassal; Aftab,14,0,25,11
1746586054174,ANSC 191,A00,886963,Staff,18,0,20,2
1746586055202,ANTH 3,A01,891689,Staff,17,0,20,3
1746586056233,ANTH 5,A00,886933,Semendeferi; Ekaterini,16,0,20,4
1746586057257,ANTH 10,A00,886934,Staff,0,12,30,30
1746586058283,ANTH 21,A01,886936,Staff,41,0,60,19
1746586059308,ANTH 23,A01,886938,Staff,92,0,100,8
1746586060334,ANTH 105,A00,886964,Stewart; Alexander B,84,0,100,16
1746586061361,ANTH 108,A00,886965,Pedersen; David,9,0,20,11
1746586062394,AWP 10,001,886147,Staff,0,0,0,0
1746586062394,AWP 10,002,886148,Staff,0,0,0,0
1746586062394,AWP 10,003,886149,Staff,0,0,0,0
1746586062394,AWP 10,004,886150,Staff,0,0,0,0
1746586062394,AWP 10,005,886151,Staff,0,0,0,0
1746586062394,AWP 10,006,886152,Staff,0,0,0,0
1746586062394,AWP 10,007,886153,Staff,0,0,0,0
1746586062394,AWP 10,008,886154,Staff,0,0,0,0
1746586062394,AWP 10,009,886155,Staff,0,0,0,0
1746586062394,AWP 10,010,886156,Staff,0,0,0,0
1746586062394,AWP 10,011,886158,Staff,0,0,0,0
1746586062394,AWP 10,012,886160,Staff,0,0,0,0
1746586062394,AWP 10,013,886161,Staff,0,0,0,0
1746586062394,AWP 10,014,886162,Staff,0,0,0,0
1746586062394,AWP 10,015,886163,Staff,0,0,0,0
1746586062394,AWP 10,016,886164,Staff,0,0,0,0
1746586062394,AWP 10,017,886165,Staff,0,0,0,0
1746586062394,AWP 10,018,886166,Staff,0,0,0,0
1746586062394,AWP 10,019,886168,Staff,0,0,0,0
1746586062394,AWP 10,020,886170,Staff,0,0,0,0
1746586062394,AWP 10,021,886172,Staff,0,0,0,0
1746586063430,AWP 10R,001,886173,Staff,0,1,0,0
1746586063430,AWP 10R,002,886174,Staff,0,1,0,0
1746586063430,AWP 10R,003,886175,Staff,0,0,0,0
1746586063430,AWP 10R,004,886176,Staff,0,0,0,0
1746586063430,AWP 10R,005,886177,Staff,0,0,0,0
1746586063430,AWP 10R,006,886178,Staff,0,0,0,0
1746586063430,AWP 10R,007,886179,Staff,0,0,0,0
1746586063430,AWP 10R,008,886181,Staff,0,0,0,0
1746586063430,AWP 10R,009,886182,Staff,0,0,0,0
1746586063430,AWP 10R,010,886183,Staff,0,0,0,0
1746586063430,AWP 10R,011,886184,Staff,0,0,0,0
1746586063430,AWP 10R,012,886185,Staff,0,0,0,0
1746586063430,AWP 10R,013,886186,Staff,0,0,0,0
1746586063430,AWP 10R,014,886187,Staff,0,0,0,0
1746586063430,AWP 10R,015,886188,Staff,0,0,0,0
1746586063430,AWP 10R,016,886189,Staff,0,0,0,0
1746586063430,AWP 10R,017,960532,Staff,0,0,0,0
1746586063430,AWP 10R,018,960533,Staff,0,0,0,0
1746586063430,AWP 10R,019,960534,Staff,0,0,0,0
1746586063430,AWP 10R,020,960538,Staff,0,0,0,0
1746586063430,AWP 10R,021,960540,Staff,0,0,0,0
1746586063430,AWP 10R,022,960541,Staff,0,0,0,0
1746586063430,AWP 10R,023,960542,Staff,0,0,0,0
1746586063430,AWP 10R,024,960544,Staff,0,0,0,0
1746586063430,AWP 10R,025,960545,Staff,0,0,0,0
1746586063430,AWP 10R,026,960548,Staff,0,0,0,0
1746586064455,AWP 102R,A00,886190,Staff,0,0,0,0
1746586064455,AWP 102R,B00,886191,Staff,0,0,0,0
1746586065482,BENG 100,A01,886193,Staff,17,0,30,13
1746586066508,BENG 122A,A01,886195,Hasty; Jeff M,13,0,30,17
1746586067534,BENG 166A,A00,886196,Sah; Robert Lie-Yuan,0,3,30,30
1746586068563,BENG 190,A00,958050,Khojah; Reem I,17,0,25,8
1746586069589,BIBC 102,A01,894320,Staff,0,0,46,46
1746586069589,BIBC 102,A02,894321,Staff,0,0,46,46
1746586069589,BIBC 102,A03,894344,Staff,6,0,46,40
1746586069589,BIBC 102,A04,894345,Staff,27,0,47,20
1746586070615,BICD 100R,A01,894365,Smith; Laurie,1,3,58,57
1746586070615,BICD 100R,A02,894366,Smith; Laurie,1,5,58,57
1746586070615,BICD 100R,A03,894367,Smith; Laurie,0,0,59,59
1746586070615,BICD 100R,A04,959869,Smith; Laurie,40,0,59,19
1746586071640,BICD 136,A01,894383,Gustafson-Brown; Cindy,14,0,50,36
1746586072666,BIEB 102,A01,894494,Butler; Shannon Rhey,51,0,130,79
1746586074721,BIEB 150,A01,894617,Wills; Christopher,3,0,20,17
1746586074721,BIEB 150,A02,894631,Wills; Christopher,3,0,20,17
1746586074721,BIEB 150,A03,894937,Wills; Christopher,3,0,20,17
1746586074721,BIEB 150,A04,894946,Wills; Christopher,5,0,20,15
1746586075748,BIEB 194,A00,906141,Kurle; Carolyn M.,5,0,20,15
1746586076778,BILD 1,A01,894154,Staff,3,0,19,16
1746586076778,BILD 1,A02,894155,Staff,14,0,19,5
1746586076778,BILD 1,A03,894160,Staff,13,0,19,6
1746586076778,BILD 1,A04,894161,Staff,15,0,18,3
1746586077803,BILD 2,A01,894168,Staff,0,0,50,50
1746586077803,BILD 2,A02,894169,Staff,0,0,50,50
1746586077803,BILD 2,A03,894179,Staff,0,0,50,50
1746586077803,BILD 2,A04,894203,Staff,24,0,50,26
1746586078830,BILD 3,A01,894213,Staff,23,0,31,8
1746586078830,BILD 3,A02,894214,Staff,26,0,31,5
1746586078830,BILD 3,A03,894235,Staff,28,0,31,3
1746586078830,BILD 3,A04,894236,Staff,28,0,32,4
1746586079855,BILD 4,A01,894253,Reuther; Keefe,5,0,24,19
1746586079855,BILD 4,A02,894258,Reuther; Keefe,16,0,24,8
1746586080881,BILD 5,A01,894276,Reuther; Keefe,34,0,50,16
1746586080881,BILD 5,A02,894277,Reuther; Keefe,45,0,50,5
1746586080881,BILD 5,A03,894290,Reuther; Keefe,44,0,50,6
1746586080881,BILD 5,A04,894291,Reuther; Keefe,48,0,50,2
1746586081912,BILD 24,A01,894297,Pirino; Giorgia,40,0,60,20
1746586082944,BIMM 100,B01,958915,Staff,71,0,100,29
1746586083974,BIMM 101,A01,895017,McDonnell; Lisa Marie,0,5,24,24
1746586083974,BIMM 101,A02,895018,McDonnell; Lisa Marie,0,5,24,24
1746586083974,BIMM 101,B01,895020,McDonnell; Lisa Marie,0,6,24,24
1746586083974,BIMM 101,B02,895021,McDonnell; Lisa Marie,0,4,24,24
1746586085001,BIMM 110,A01,895023,Staff,1,0,25,24
1746586085001,BIMM 110,A02,895024,Staff,9,0,25,16
1746586085001,BIMM 110,A03,895025,Staff,18,0,25,7
1746586085001,BIMM 110,A04,895031,Staff,20,0,25,5
1746586086033,BIMM 120,A01,895114,Gustafson-Brown; Cindy,14,0,28,14
1746586086033,BIMM 120,A02,895126,Gustafson-Brown; Cindy,21,0,27,6
1746586087062,BIPN 100,A01,895130,Yang; Mingyu,0,0,38,38
1746586087062,BIPN 100,A02,895131,Yang; Mingyu,31,0,38,7
1746586087062,BIPN 100,A03,895132,Yang; Mingyu,32,0,38,6
1746586087062,BIPN 100,A04,895133,Yang; Mingyu,27,0,36,9
1746586088087,BIPN 120,A01,895135,Cooke; James Edward,0,3,13,13
1746586088087,BIPN 120,A02,895136,Cooke; James Edward,0,1,13,13
1746586088087,BIPN 120,A03,895137,Cooke; James Edward,0,3,13,13
1746586088087,BIPN 120,A04,895156,Cooke; James Edward,0,2,11,11
1746586089113,BIPN 134,A01,895235,Cooke; James Edward,0,2,25,25
1746586089113,BIPN 134,A02,895237,Cooke; James Edward,0,0,25,25
1746586089113,BIPN 134,A03,895240,Cooke; James Edward,3,0,25,22
1746586089113,BIPN 134,A04,895270,Cooke; James Edward,20,0,25,5
1746586090138,BIPN 189,A00,892103,Staff,0,14,14,14
1746586092203,BISP 194,A00,958008,Staff,0,2,0,0
1746586093229,CAT 124,A01,922009,Staff,0,5,20,20
1746586094259,CAT 125R,A00,886390,Morales; Celeste Georgianna,0,2,20,20
1746586094259,CAT 125R,B00,886391,Irwin; Matthew Joseph,0,4,20,20
1746586094259,CAT 125R,C00,886392,Smith; Lauryn Alissa,0,2,20,20
1746586094259,CAT 125R,D00,886393,Vanderschuit; Maya Alysia,0,3,20,20
1746586094259,CAT 125R,E00,886394,Marchisotto; Jennifer Anne,0,3,20,20
1746586095285,CENG 15,A01,886218,Drews; Aaron,3,0,8,5
1746586096313,CENG 113,A00,886219,Opatkiewicz; Justin Paul,15,0,25,10
1746586097339,CGS 101,A00,887044,Staff,7,0,20,13
1746586098365,CGS 105,A01,887046,Staff,14,0,25,11
1746586099389,CGS 112,A00,887047,Cuong; Marisol,12,0,15,3
1746586100415,CGS 113,A00,887048,Staff,23,0,30,7
1746586101443,CGS 120,A00,887049,Staff,10,0,17,7
1746586102468,CHEM 6A,A01,886336,Lam; Tin Yiu,38,0,50,12
1746586102468,CHEM 6A,A02,886338,Lam; Tin Yiu,37,0,50,13
1746586103494,CHEM 6B,A01,886341,Hopkins; Patrycja Anna,16,0,50,34
1746586103494,CHEM 6B,A02,886343,Hopkins; Patrycja Anna,42,0,50,8
1746586104521,CHEM 6C,A01,886346,Albizati; Kim F.,0,2,50,50
1746586104521,CHEM 6C,A02,886348,Albizati; Kim F.,24,0,50,26
1746586105547,CHEM 40A,A01,886352,Klosterman; Jeremy K,65,0,100,35
1746586106572,CHEM 40B,A01,886356,Klosterman; Jeremy K,0,24,100,100
1746586107598,CHEM 41B,A01,886360,Theodorakis; Emmanuel,25,0,50,25
1746586107598,CHEM 41B,A02,886362,Theodorakis; Emmanuel,47,0,50,3
1746586108623,CHIN 165A,A00,886382,Xu; Li,18,0,20,2
1746586109652,CLAS 120,A00,886387,Myerston Santana; Jacobo,33,0,40,7
1746586110678,COGS 9,A01,886967,Shannon; Kyle Michael,42,0,60,18
1746586111704,COGS 11,A01,886969,Staff,9,0,30,21
1746586112735,COGS 14A,A01,886971,Staff,6,0,60,54
1746586113760,COGS 14B,A01,886973,Hoffman; Drew Ellen,4,0,60,56
1746586114789,COGS 18,A01,886975,Morgan; Eric,34,0,60,26
1746586115818,COGS 20,A01,886977,Staff,2,0,8,6
1746586115818,COGS 20,A02,886978,Staff,4,0,7,3
1746586116843,COGS 100,A01,907783,Staff,1,2,30,29
1746586117868,COGS 101B,A01,886980,Staff,0,4,48,48
1746586118894,COGS 101C,A01,886982,Delgado; Tania,0,5,44,44
1746586119921,COGS 102A,A01,886984,Johnson; Christine M.,3,0,30,27
1746586120946,COGS 118B,A01,886986,Staff,1,5,88,87
1746586121972,COGS 150,A01,886988,Bergen; Benjamin,22,0,50,28
1746586123000,COGS 153,A00,886989,Delgado; Tania,0,3,41,41
1746586124026,COGS 186,A01,886991,Staff,0,0,32,32
1746586125051,COGS 187A,A01,886993,Boyle; Mary E. T.,7,0,30,23
1746586126077,COGS 189,A00,886994,Staff,0,1,30,30
1746586127101,COMM 10,A01,886996,Staff,0,0,20,21
1746586127101,COMM 10,A02,886997,Staff,10,0,20,10
1746586127101,COMM 10,A03,959845,Staff,19,0,20,1
1746586128129,COMM 20,A01,886999,Leuning; Grant Maurstad,24,0,40,16
1746586130181,COMM 100A,A01,887002,Staff,0,0,20,25
1746586130181,COMM 100A,A02,887003,Staff,6,0,20,14
1746586131207,COMM 100B,A01,887005,Staff,0,8,20,24
1746586132230,COMM 106D,A00,887006,Staff,13,0,40,27
1746586133255,COMM 110G,A00,887007,Whitworth-Smith; Andrew C,12,0,40,28
1746586134282,COMM 111B,A00,887008,Staff,31,0,40,9
1746586135309,COMM 113T,A00,887009,Abuelhiga; Soraya Jill,28,0,40,12
1746586135309,COMM 113T,B00,906733,Staff,40,0,40,0
1746586136335,COMM 145,A00,887010,Staff,12,0,40,28
1746586137360,COMM 146,A00,887054,Staff,31,0,40,9
1746586138385,COMM 190,A00,887012,Staff,8,0,23,15
1746586139412,CSE 8A,A50,887015,Cao; Yingjun,57,0,85,28
1746586140438,CSE 11,A01,887017,Cao; Yingjun,12,0,70,58
1746586141464,CSE 20,A01,887019,Staff,30,0,50,20
1746586142489,CSE 21,A01,887021,Staff,78,0,100,22
1746586142489,CSE 21,B01,892583,Braun; Oliver,45,0,50,5
1746586143515,CSE 30,A01,887025,Eldon; John,142,0,200,58
1746586144543,CSE 100,A01,887027,Staff,26,0,50,24
1746586144543,CSE 100,A02,887028,Staff,42,0,50,8
1746586145568,CSE 101,A01,887030,Braun; Oliver,74,0,100,26
1746586145568,CSE 101,B01,887032,Jones; Miles E,0,3,50,50
1746586145568,CSE 101,B02,887033,Jones; Miles E,0,2,50,50
1746586146596,CSE 105,A01,908084,Jones; Miles E,32,0,50,18
1746586146596,CSE 105,A02,908087,Jones; Miles E,31,0,50,19
1746586147622,CSE 135,A01,887035,Powell; Thomas Allan,0,5,50,50
1746586148647,CSE 142,A01,887037,Staff,8,0,60,52
1746586149673,CSE 142L,A01,887039,Staff,34,0,60,26
1746586150699,CSE 151A,A01,887041,Solares; Edwin A,47,0,100,53
1746586151728,CSE 175,A01,887043,Kumar; Rakesh,30,0,30,0
1746586152753,CSS 1,A01,886389,Staff,1,2,40,39
1746586153779,DSC 30,A01,908097,Liao; Soohyun Nam,47,0,75,28
1746586154805,DSC 40A,A01,908099,Shannon; Kyle Michael,30,0,50,20
1746586155832,DSC 40B,A01,908112,Staff,15,0,50,35
1746586156857,DSC 80,A01,908116,Staff,19,0,60,41
1746586157884,DSC 197,001,956863,Eldridge; Justin Matthew,9999,0,9999,0
1746586158910,ECE 5,A01,886400,Morris; Karcher William,1,0,6,5
1746586158910,ECE 5,A02,886401,Morris; Karcher William,3,0,6,3
1746586159938,ECE 148,A01,886403,Silberman; Jack,0,14,14,14
1746586160969,ECON 1,A01,887265,Crane; Meredith Helen,11,0,70,59
1746586160969,ECON 1,B01,887268,Staff,42,0,50,8
1746586161996,ECON 2,A01,887273,Crane; Meredith Helen,54,0,70,16
1746586163024,ECON 3,A01,887279,Rondina; Giacomo,31,0,70,39
1746586164051,ECON 4,A01,887282,Anderson; John Charles,0,2,10,10
1746586165077,ECON 5,A01,887285,Staff,34,0,45,11
1746586165077,ECON 5,B01,887292,Staff,41,0,45,4
1746586166102,ECON 100A,A01,887337,Newhouse; Herbert S,54,0,70,16
1746586166102,ECON 100A,B01,887349,Staff,45,0,50,5
1746586167132,ECON 100B,A01,887361,Du; Songzi,29,0,70,41
1746586168156,ECON 100C,A01,887445,Newhouse; Herbert S,59,0,70,11
1746586169184,ECON 105,A00,887488,Vespa; Emanuel Ignacio,23,0,35,12
1746586170213,ECON 109,A01,887506,Shishkin; Denis,28,0,35,7
1746586171244,ECON 110A,A01,887568,Alon; Titan Michael,0,3,35,35
1746586171244,ECON 110A,B01,907601,Alon; Titan Michael,20,0,35,15
1746586172272,ECON 110B,A01,887598,Levkoff; Steven B.,0,24,70,70
1746586173297,ECON 112,A00,887599,Rondina; Giacomo,19,0,35,16
1746586174321,ECON 120A,A01,887603,Dai; Yinlin,35,0,70,35
1746586175354,ECON 120C,A01,887608,Sun; Yixiao,0,1,35,35
1746586175354,ECON 120C,B01,887614,Sun; Yixiao,0,0,35,35
1746586176382,ECON 138,A00,887621,Bharadwaj; Prashant,0,21,20,20
1746586177407,ECON 144,A00,958007,Squires; Dale E,12,0,35,23
1746586178432,ECON 171,A01,907666,Staff,18,0,35,17
1746586179463,ECON 175,A00,887626,Wu; Pak Yeung,22,0,35,13
1746586180490,ECON 190,A00,887640,Vespa; Emanuel Ignacio,22,0,35,13
1746586181528,EDS 25,A01,888197,Staff,0,0,0,0
1746586181528,EDS 25,A02,888209,Staff,0,0,0,0
1746586181528,EDS 25,A03,888210,Staff,0,0,0,0
1746586181528,EDS 25,A04,888212,Staff,0,0,0,0
1746586181528,EDS 25,A05,888213,Staff,0,0,0,0
1746586181528,EDS 25,A06,888214,Staff,0,0,0,0
1746586181528,EDS 25,A07,888235,Staff,0,2,0,0
1746586181528,EDS 25,A08,888236,Staff,0,0,0,0
1746586181528,EDS 25,A09,888240,Staff,0,0,0,0
1746586181528,EDS 25,A10,888244,Staff,0,0,0,0
1746586181528,EDS 25,B01,888273,Staff,0,0,0,0
1746586181528,EDS 25,B02,888285,Staff,0,0,0,0
1746586181528,EDS 25,B03,888423,Staff,0,0,0,1
1746586181528,EDS 25,B04,888432,Staff,0,0,0,0
1746586181528,EDS 25,B05,888433,Staff,0,0,0,0
1746586181528,EDS 25,B06,888467,Staff,0,0,0,0
1746586181528,EDS 25,B07,888468,Staff,0,0,0,0
1746586181528,EDS 25,B08,888479,Staff,0,0,0,0
1746586181528,EDS 25,B09,888484,Staff,0,0,0,0
1746586181528,EDS 25,B10,888487,Staff,0,0,0,0
1746586182571,EDS 38,A01,907700,Choi; Bailey Miyeon,30,0,30,0
1746586183600,EDS 112,A01,888601,Chapman; Thandeka K,12,0,40,28
1746586184625,EDS 115,A00,888697,Mendez; Kathrina Mendoza,10,0,30,20
1746586185650,EDS 116,A01,888893,Staff,34,0,40,6
1746586187699,EDS 124AR,A00,889133,Staff,29,0,50,21
1746586187699,EDS 124AR,B00,907471,Simon; Elizabeth A,37,0,50,13
1746586188727,EDS 124BR,A00,889134,Simon; Elizabeth A,44,0,100,56
1746586189750,EDS 125,A00,889135,Staff,25,0,30,5
1746586190779,EDS 126,A01,889138,Staff,35,0,40,5
1746586191803,EDS 164R,A01,889142,Wishard Guerra; Alison G.,32,0,50,18
1746586192827,ENG 30,A01,886396,Staff,0,0,0,0
1746586192827,ENG 30,B01,886398,Staff,0,0,0,0
1746586193854,ENVR 102,A00,906150,Montejo; Carolina,23,0,25,2
1746586194878,ETHN 103A,A00,887236,Man; Simeon S,0,3,0,0
1746586195902,ETHN 113,A00,887239,Staff,16,0,30,14
1746586196927,ETHN 116,A00,887240,Staff,16,0,25,9
1746586197953,ETHN 117,A00,887241,Choi; Esther Min,28,0,30,2
1746586198978,ETHN 118,A00,887243,Staff,24,0,30,6
1746586200008,ETHN 127,A00,887248,Cuong; Marisol,11,0,15,4
1746586201036,ETHN 139,A00,887250,Staff,7,0,10,3
1746586202076,ETHN 142,A00,887252,Staff,10,0,30,20
1746586203104,ETHN 161,A00,887253,Browne; Errol Tsekani,24,0,30,6
1746586204133,ETHN 163FR,A00,887255,Burelle; Julie Sara Veronique,0,0,5,5
1746586205162,GLBH 20,A00,889149,Elwardani; Nile Regina,8,0,42,34
1746586207214,GLBH 111,A01,889152,Burgos; Jose L.,17,0,17,0
1746586208240,GLBH 150,A00,889181,Sloane; Julia Kathryn,0,5,15,15
1746586210291,HDS 60,A01,886406,Warstadt; Melissa Fawn,73,0,80,7
1746586211320,HIAF 111,A00,889324,Gyamfi; Bright,25,0,32,7
1746586212345,HIEA 131,A00,889328,Staff,15,0,32,17
1746586213369,HIEA 144,A00,889333,Henry; Todd A.,26,0,32,6
1746586214399,HIEA 154,A00,889336,Henry; Todd A.,24,0,32,8
1746586215428,HIEU 106,A00,889339,Staff,22,0,32,10
1746586217481,HIEU 114,A00,889340,Staff,4,0,32,28
1746586218506,HIEU 135GS,A00,889342,Patterson; Patrick H.,0,0,1,24
1746586219533,HIEU 137,A00,889343,Edington; Claire Ellen,10,0,25,15
1746586220559,HIEU 148,A00,889345,Staff,14,0,32,18
1746586221589,HIEU 154,A00,889346,Biess; Frank Peter,21,0,32,11
1746586222615,HILA 102,A00,889351,Staff,12,0,32,20
1746586223640,HILD 2A,A01,889221,Lewandoski; Julia Mavis,2,10,32,30
1746586224665,HILD 7B,A01,889225,Man; Simeon S,0,12,32,32
1746586225690,HILD 7C,A01,889288,Alvarez; Luis A,0,14,32,32
1746586226716,HILD 30,A01,889323,Staff,0,5,32,32
1746586228770,HISC 119,A00,889383,Golan; Tal,19,0,32,13
1746586229796,HIUS 103,A00,889384,Man; Simeon S,0,0,32,32
1746586230824,HIUS 117,A00,919797,Kwak; Nancy,19,0,32,13
1746586231850,HIUS 142A,A00,919788,Staff,22,0,32,10
1746586233908,HIUS 149,A00,889386,Gyamfi; Bright,26,0,32,6
1746586234939,HIUS 155,A00,889387,Alvarez; Luis A,15,0,32,17
1746586235969,HUM 3,A01,886499,Caldwell; Michael Alan,19,0,50,31
1746586236996,HUM 3GS,A00,886500,Rodriguez; Bretton Sigfred,0,0,0,28
1746586238025,HUM 3R,A01,886502,Markman; Kristina,0,36,50,50
1746586239056,HUM 4,A01,886504,Crum; Matthew Stephen,23,0,50,27
1746586239056,HUM 4,B01,886506,West; Geoffrey Scott,17,0,50,33
1746586240084,HUM 4GS,A00,886507,Staff,0,0,0,19
1746586241113,HUM 5,A01,886509,Staff,32,0,50,18
1746586242141,HUM 5R,A01,886511,Zavodny; Tatiana Sophia,0,39,50,50
1746586243169,JAPN 180,A00,886407,Staff,16,0,40,24
1746586244199,LATI 50,A01,886409,Martin-Cabrera; Luis,3,0,22,19
1746586244199,LATI 50,A02,886410,Martin-Cabrera; Luis,19,0,22,3
1746586244199,LATI 50,A03,886411,Martin-Cabrera; Luis,21,0,22,1
1746586244199,LATI 50,A04,886412,Martin-Cabrera; Luis,8,0,22,14
1746586245228,LAWS 101,A00,907664,Staff,28,0,60,32
1746586246253,LIAB 1A,A00,889388,Saab; Dima,17,0,20,3
1746586247282,LIAB 1AX,A00,889389,El Cheddadi; Youniss,18,0,20,2
1746586248310,LIFR 1C,A00,889391,Van Moer; Vinciane G,8,0,20,12
1746586249336,LIFR 1CX,A00,889392,Van Moer; Vinciane G,7,0,20,13
1746586250365,LIFR 1D,A00,889393,Van Moer; Vinciane G,7,0,20,13
1746586251389,LIFR 1DX,A00,889394,Van Moer; Vinciane G,8,0,20,12
1746586252418,LIGN 7,A00,886923,Staff,24,0,50,26
1746586253450,LIGN 17,A00,886924,Kehler; Andrew Scott,125,0,150,25
1746586254475,LTAM 110,A00,889395,Staff,15,0,30,15
1746586255512,LTAM 110GS,A00,958010,Rodriguez; Bretton Sigfred,0,0,0,28
1746586256539,LTCH 101,A00,889397,Staff,23,0,25,2
1746586257568,LTCS 130,A00,889398,Staff,23,0,25,2
1746586258593,LTEA 138,A00,889399,Staff,24,0,40,16
1746586259619,LTEN 149,A00,889400,Wesling; Megan E.,0,3,25,25
1746586260644,LTEN 169,A00,889401,Staff,20,0,25,5
1746586261668,LTEN 180,A00,889402,Staff,10,0,15,5
1746586262693,LTEN 181,A00,889403,Staff,21,0,25,4
1746586263721,LTWL 100,A00,889404,Myerston Santana; Jacobo,2,0,25,23
1746586264749,LTWL 180GS,A00,889405,Staff,0,0,20,20
1746586265776,LTWL 181,A00,889406,Staff,16,0,25,9
1746586266802,LTWL 184,A00,889475,Mukherjee; Silpa,22,0,25,3
1746586267830,LTWR 102C,A00,889486,Staff,29,0,30,1
1746586268860,LTWR 115W,A00,889491,Staff,0,2,15,15
1746586269889,MAE 8,A01,886905,Staff,0,2,0,0
1746586270917,MAE 11,A00,886906,Bandaru; Prabhakar,0,7,50,50
1746586271948,MAE 20,A00,886907,Evdokimenko; Ekaterina,43,0,70,27
1746586272975,MAE 30B,A00,886909,Ghazinejad; Maziar,26,0,45,19
1746586274001,MAE 101B,A00,886910,Saintillan; David,29,0,45,16
1746586275028,MAE 105,A00,886911,Bandaru; Prabhakar,18,0,50,32
1746586276056,MAE 107,B00,958024,Staff,7,0,50,43
1746586277084,MAE 143B,A00,886913,Bewley; Thomas R,3,0,40,37
1746586278112,MAE 148,A01,886915,Silberman; Jack,0,3,14,14
1746586279139,MAE 160,A00,886916,Evdokimenko; Ekaterina,31,0,60,29
1746586280168,MATH 3C,A01,889681,Staff,0,2,30,30
1746586280168,MATH 3C,A02,960048,Staff,23,0,30,7
1746586281194,MATH 10A,A01,889760,Staff,26,0,30,4
1746586281194,MATH 10A,A02,889783,Staff,29,0,30,1
1746586282224,MATH 10B,A01,889785,Verstraete; Jacques Allan,1,0,35,34
1746586282224,MATH 10B,A02,889795,Verstraete; Jacques Allan,4,0,35,31
1746586282224,MATH 10B,B01,889797,Verstraete; Jacques Allan,3,0,35,32
1746586282224,MATH 10B,B02,889828,Verstraete; Jacques Allan,3,0,35,32
1746586283254,MATH 10C,A01,889849,Habib; Yousaf,7,0,30,23
1746586283254,MATH 10C,A02,889852,Habib; Yousaf,14,0,30,16
1746586283254,MATH 10C,A03,889853,Habib; Yousaf,22,0,30,8
1746586283254,MATH 10C,A04,889858,Habib; Yousaf,20,0,30,10
1746586283254,MATH 10C,B01,889861,Staff,1,0,30,29
1746586283254,MATH 10C,B02,889862,Staff,24,0,30,6
1746586283254,MATH 10C,B03,889863,Staff,27,0,30,3
1746586283254,MATH 10C,B04,889967,Staff,23,0,30,7
1746586284284,MATH 18,A01,889974,Staff,7,0,30,23
1746586284284,MATH 18,A02,889977,Staff,20,0,30,10
1746586284284,MATH 18,B01,889984,Hardiman; Liam,20,0,30,10
1746586284284,MATH 18,B02,889985,Hardiman; Liam,25,0,30,5
1746586285309,MATH 20A,A01,889990,Suk; Andrew Hoon,30,0,35,5
1746586286334,MATH 20B,A01,889993,Ohm; Ko Woon,21,0,30,9
1746586286334,MATH 20B,A02,889994,Ohm; Ko Woon,30,0,30,0
1746586286334,MATH 20B,B01,889996,Ohm; Ko Woon,22,0,30,8
1746586286334,MATH 20B,B02,889997,Ohm; Ko Woon,23,0,30,7
1746586287360,MATH 20C,A01,889999,Hammock; Frances H,17,0,30,13
1746586287360,MATH 20C,A02,890003,Hammock; Frances H,23,0,30,7
1746586287360,MATH 20C,B01,890006,Hammock; Frances H,3,0,30,27
1746586287360,MATH 20C,B02,890007,Hammock; Frances H,12,0,30,18
1746586288387,MATH 20D,A01,890011,Cheng; Hsiao-Bing,1,1,30,29
1746586288387,MATH 20D,A02,890012,Cheng; Hsiao-Bing,14,0,30,16
1746586288387,MATH 20D,B01,890016,Cheng; Hsiao-Bing,13,0,30,17
1746586288387,MATH 20D,B02,890017,Cheng; Hsiao-Bing,13,0,30,17
1746586289415,MATH 20E,A01,890026,Harel; Guershon,1,0,30,29
1746586289415,MATH 20E,A02,890029,Harel; Guershon,22,0,30,8
1746586289415,MATH 20E,B01,890033,Harel; Guershon,7,0,30,23
1746586289415,MATH 20E,B02,890101,Harel; Guershon,21,0,30,9
1746586290441,MATH 102,A01,890104,Staff,18,0,30,12
1746586290441,MATH 102,A02,890105,Staff,27,0,30,3
1746586291471,MATH 103B,A01,890116,Salehi Golsefidy; Alireza,3,0,30,27
1746586291471,MATH 103B,B01,890118,Staff,0,3,34,34
1746586292501,MATH 109,A01,890121,Aliabadi Sr.; Mohsen,0,0,30,30
1746586292501,MATH 109,B01,890124,Upadrashta; Pranav Kumar,18,0,30,12
1746586293527,MATH 120A,A01,890126,Eggers; John Dietrich,13,0,30,17
1746586294556,MATH 142B,A01,890128,Ioana; Adrian,19,0,30,11
1746586294556,MATH 142B,A02,890129,Ioana; Adrian,12,0,30,18
1746586295587,MATH 154,A01,890174,Staff,0,1,30,30
1746586295587,MATH 154,A02,890182,Staff,0,0,30,30
1746586296612,MATH 168A,A01,890197,Dumitriu; Ioana,21,0,35,14
1746586297642,MATH 170A,A01,890240,Nie; Jiawang,1,0,30,29
1746586297642,MATH 170A,A02,890241,Nie; Jiawang,11,0,30,19
1746586297642,MATH 170A,A03,890249,Nie; Jiawang,23,0,30,7
1746586298665,MATH 170B,A01,957891,Nag; Panchali,13,0,35,22
1746586300720,MATH 181A,A01,908025,Staff,0,3,35,35
1746586300720,MATH 181A,A02,960115,Staff,26,0,35,9
1746586301746,MATH 181B,A01,959874,Staff,25,0,30,5
1746586302776,MATH 193B,A01,890265,Staff,0,4,35,35
1746586303802,MGT 4,A01,890311,Anderson; John Charles,42,0,88,46
1746586304828,MGT 5,A00,907740,Staff,13,0,98,85
1746586305853,MGT 12,A00,890312,Lindenberger; Wade Douglas,67,0,98,31
1746586306877,MGT 16,A00,957883,Staff,78,0,98,20
1746586308930,MGT 45,A00,890314,Pecore; Joseph P.,45,0,98,53
1746586309957,MGT 71,A00,890315,Staff,0,12,98,98
1746586310983,MGT 100,A00,890316,Yavorsky; Daniel Ryan,44,0,98,54
1746586312009,MGT 103,A00,890317,Ehrich; Kristine R,73,0,98,25
1746586313038,MGT 105,A00,890356,Bates; Kenneth Walter,0,8,98,98
1746586314062,MGT 112,A00,890360,Ehrich; Kristine R,55,0,98,43
1746586315091,MGT 127R,A00,907732,Zhu; Kevin Xiaoguo,23,0,98,75
1746586316116,MGT 131B,A00,890361,Anderson; John Charles,59,0,98,39
1746586317141,MGT 137,A00,890362,Lindenberger; Wade Douglas,65,0,98,33
1746586318166,MGT 160,A00,890369,Johnson; Erik Barry,9,0,98,89
1746586320226,MGT 164,A00,890372,Zimmermann; Carsten,0,40,98,98
1746586321250,MGT 180,A00,890374,Bliss; Barbara Ann,12,0,98,86
1746586322281,MMW 15,A01,886414,Chang; Edmond Yi-Teh,0,12,28,28
1746586322281,MMW 15,A02,886415,Chang; Edmond Yi-Teh,0,8,28,28
1746586322281,MMW 15,A03,886416,Chang; Edmond Yi-Teh,0,9,28,28
1746586322281,MMW 15,A04,886417,Chang; Edmond Yi-Teh,0,8,28,28
1746586322281,MMW 15,B01,886419,Chang; Edmond Yi-Teh,0,7,28,28
1746586322281,MMW 15,B02,886420,Chang; Edmond Yi-Teh,0,8,28,28
1746586322281,MMW 15,B03,886421,Chang; Edmond Yi-Teh,0,7,28,28
1746586322281,MMW 15,B04,886422,Chang; Edmond Yi-Teh,0,8,28,28
1746586322281,MMW 15,C01,886424,Staff,0,9,28,28
1746586322281,MMW 15,C02,886425,Staff,0,8,28,28
1746586322281,MMW 15,C03,886426,Staff,0,8,28,28
1746586322281,MMW 15,C04,886427,Staff,0,8,28,28
1746586322281,MMW 15,C05,958038,Staff,0,8,28,28
1746586322281,MMW 15,C06,958039,Staff,1,8,28,27
1746586323309,MMW 15GS,A00,906910,Patterson; Patrick H.,4,0,28,24
1746586324334,MMW 122R,A01,886429,Rahimi; Babak,0,13,28,28
1746586324334,MMW 122R,A02,886430,Rahimi; Babak,0,12,28,28
1746586324334,MMW 122R,A03,958040,Rahimi; Babak,0,11,28,28
1746586325363,MUS 1A,A01,890937,Staff,2,0,25,23
1746586325363,MUS 1A,A02,891035,Staff,6,0,25,19
1746586325363,MUS 1A,C01,958912,Staff,24,0,25,1
1746586325363,MUS 1A,C02,958913,Staff,25,0,25,0
1746586327419,MUS 2AK,A00,957092,Ohnishi; Takae,15,0,15,0
1746586328445,MUS 4,A01,891044,Staff,1,0,25,24
1746586328445,MUS 4,A02,891045,Staff,23,0,25,2
1746586328445,MUS 4,B01,891048,Staff,17,0,25,8
1746586328445,MUS 4,B02,891050,Staff,25,0,25,0
1746586329468,MUS 5,A01,957506,Dubnov; Shlomo,0,0,25,25
1746586329468,MUS 5,A02,957622,Dubnov; Shlomo,13,0,25,12
1746586329468,MUS 5,A03,957623,Dubnov; Shlomo,20,0,25,5
1746586330494,MUS 6,A01,891053,Freitas Caetano; Marcelo,24,0,25,1
1746586330494,MUS 6,A02,891054,Freitas Caetano; Marcelo,23,0,25,2
1746586331520,MUS 7,A01,891081,Staff,0,0,25,25
1746586331520,MUS 7,A02,891082,Staff,3,0,25,22
1746586332548,MUS 8GS,A00,891118,Borgo; David Garcia,1,0,25,24
1746586333572,MUS 11,A01,891140,Staff,9,0,25,16
1746586333572,MUS 11,A02,891141,Staff,21,0,25,4
1746586334598,MUS 13,A01,891143,Staff,8,0,25,17
1746586334598,MUS 13,A02,891144,Staff,24,0,25,1
1746586335626,MUS 15,A01,891146,Staff,9,0,25,16
1746586335626,MUS 15,A02,891148,Staff,21,0,25,4
1746586335626,MUS 15,B01,891150,Staff,18,0,25,7
1746586335626,MUS 15,B02,891151,Staff,25,0,25,0
1746586336652,MUS 20,A01,891153,Staff,5,0,20,15
1746586336652,MUS 20,A02,891155,Staff,14,0,20,6
1746586337678,MUS 80,A00,891156,Staff,19,0,25,6
1746586337678,MUS 80,B00,891157,Staff,23,0,25,2
1746586338704,MUS 130,A00,891158,Ohnishi; Takae,35,0,35,0
1746586339729,MUS 150GS,A01,891160,Borgo; David Garcia,1,0,25,24
1746586340757,MUS 170,A01,891162,Freitas Caetano; Marcelo,20,0,25,5
1746586340757,MUS 170,A02,891164,Freitas Caetano; Marcelo,21,0,25,4
1746586341781,NANO 11,A00,886220,Vazquez Mena; Oscar,13,0,15,2
1746586342805,NANO 15,A01,886222,Drews; Aaron,4,0,7,3
1746586343830,NANO 104,A00,886224,Sirbuly; Donald,17,0,25,8
1746586344856,PH 40,A00,886528,Staff,24,0,40,16
1746586345880,PH 45,A01,886799,Staff,35,0,40,5
1746586346906,PH 110,A00,886802,Staff,0,7,40,40
1746586347932,PH 172,A00,906716,Staff,19,0,35,16
1746586348957,PH 191,A00,886803,Staff,6,0,40,34
1746586349986,PHIL 1,A00,889500,Staff,20,0,30,10
1746586351018,PHIL 10,A01,889549,Grush; Rick Scott,16,0,22,6
1746586351018,PHIL 10,A02,889551,Grush; Rick Scott,22,0,22,0
1746586352047,PHIL 28,A01,889559,Lamey; Andy M.,0,2,31,31
1746586352047,PHIL 28,A02,889561,Lamey; Andy M.,0,1,30,30
1746586352047,PHIL 28,A03,889572,Lamey; Andy M.,0,1,30,30
1746586353072,PHIL 35,A00,907839,Staff,13,0,15,2
1746586354098,PHIL 60,A00,889574,Staff,73,0,90,17
1746586355127,PHIL 101,A00,958004,Staff,12,0,15,3
1746586357176,PHIL 136,A00,889582,Fulkerson; Matthew Todd,26,0,45,19
1746586358204,PHIL 163,A01,889601,Staff,21,0,30,9
1746586358204,PHIL 163,B01,889606,Brandt; Reuven A,0,3,0,0
1746586359229,PHIL 164,A00,889610,Staff,16,0,30,14
1746586360256,PHIL 165,A00,889613,Staff,22,0,30,8
1746586361280,PHYS 1A,A00,886431,Staff,29,0,70,41
1746586362305,PHYS 1AL,001,886432,Tsai; Philbert S,1,2,30,29
1746586362305,PHYS 1AL,002,886436,Tsai; Philbert S,12,0,30,18
1746586363331,PHYS 1B,A00,886439,Staff,184,0,240,56
1746586364356,PHYS 1BL,001,886441,Tsai; Philbert S,0,4,30,30
1746586364356,PHYS 1BL,002,886444,Tsai; Philbert S,2,0,30,28
1746586365388,PHYS 1C,A00,896092,Arnold; Kam S,78,0,146,68
1746586366419,PHYS 1CL,001,886448,Tsai; Philbert S,0,0,30,30
1746586366419,PHYS 1CL,002,886449,Tsai; Philbert S,1,0,30,29
1746586366419,PHYS 1CL,003,886450,Tsai; Philbert S,16,0,30,14
1746586366419,PHYS 1CL,004,886451,Tsai; Philbert S,15,0,30,15
1746586367448,PHYS 2B,A01,886457,Staff,67,0,115,48
1746586368475,PHYS 2C,A01,886460,Shotwell; Brian,0,9,65,65
1746586369503,PHYS 2CL,A01,886467,Staff,0,4,28,28
1746586369503,PHYS 2CL,A02,886468,Staff,0,3,28,28
1746586370530,PHYS 2D,A01,886470,Staff,10,0,50,40
1746586371561,PHYS 4B,A01,886475,Grinstein; Benjamin,22,0,40,18
1746586372590,POLI 5,A00,891173,Desposato; Scott,7,0,25,18
1746586373618,POLI 5D,A01,891175,Staff,5,0,5,0
1746586373618,POLI 5D,B01,891178,Staff,5,0,5,0
1746586374644,POLI 11,A00,891179,Ferree; Karen E,2,0,35,33
1746586375670,POLI 12,A00,891180,Staff,16,0,30,14
1746586376700,POLI 27,A01,891182,Staff,12,0,75,63
1746586377728,POLI 30,A00,891183,Staff,8,0,50,42
1746586378756,POLI 100B,A00,891244,Staff,5,1,35,30
1746586379781,POLI 100I,A00,891247,Staff,7,0,30,23
1746586380807,POLI 104J,A00,891248,Nichter; Maysa,14,0,30,16
1746586381831,POLI 104U,A00,891250,Nichter; Maysa,1,0,30,29
1746586383885,POLI 110B,A00,891255,Wiens; David,19,0,25,6
1746586384909,POLI 112A,A00,891256,Wiens; David,6,0,25,19
1746586385936,POLI 114BR,A00,891261,Staff,19,0,30,11
1746586386961,POLI 117R,A00,891262,Forman; Fonna,0,6,50,50
1746586387986,POLI 118,A00,891264,Ingham; Sean,17,0,25,8
1746586389011,POLI 124A,A00,891265,Staff,18,0,20,2
1746586390037,POLI 125D,A00,891266,Nichter; Simeon C,2,0,25,23
1746586391066,POLI 126,A00,891268,Nichter; Simeon C,7,0,25,18
1746586392092,POLI 126AA,A00,891272,Staff,15,0,25,10
1746586393121,POLI 130AA,A00,891273,Staff,15,0,20,5
1746586394146,POLI 134AA,A00,891274,Staff,4,0,20,16
1746586396203,POLI 138,A00,891278,Staff,21,0,25,4
1746586397229,POLI 142K,A00,891280,Staff,10,0,25,15
1746586398255,POLI 142M,A00,891281,Gartzke; Erik,16,0,30,14
1746586399284,POLI 142P,A00,891284,Staff,20,0,30,10
1746586400311,POLI 143,A00,891285,Gartzke; Erik,12,0,30,18
1746586401340,POLI 153,A00,891286,Staff,19,0,20,1
1746586403388,POLI 175,A00,891290,Staff,15,0,20,5
1746586404418,PSYC 1,A00,890674,Steiner; Eric Tomas,0,11,45,45
1746586405444,PSYC 2,A00,890676,Albright; Thomas D,20,0,35,15
1746586406470,PSYC 3,A00,890679,Staff,17,0,20,3
1746586407494,PSYC 6,A00,959858,Staff,19,0,20,1
1746586408523,PSYC 60,A01,890684,Rickard; Timothy C.,0,6,45,45
1746586409551,PSYC 70,A01,890689,Geller; Emma Harlan,6,0,30,24
1746586410579,PSYC 71,A01,959860,Staff,21,0,25,4
1746586411604,PSYC 100,A00,890690,Lacefield; Katharine I,0,50,180,180
1746586412628,PSYC 102,A00,890695,Staff,18,0,40,22
1746586413653,PSYC 105,A00,890699,Geller; Emma Harlan,70,0,100,30
1746586414680,PSYC 106,A00,890701,Gorman; Michael R.,5,0,30,25
1746586415707,PSYC 108,A00,890704,Adrian; Julia Anna,0,28,50,50
1746586416751,PSYC 118,A01,890712,Staff,11,0,30,19
1746586417778,PSYC 124,A00,890716,Chapman; Eddie Nathaniel,25,0,60,35
1746586418802,PSYC 131,A00,890717,Anagnostaras; Stephan,0,7,80,80
1746586419830,PSYC 137,A00,890719,Winkielman; Piotr,0,11,30,30
1746586420860,PSYC 144,A00,890721,Adrian; Julia Anna,0,9,45,45
1746586421885,PSYC 162,A00,890805,Staff,0,1,75,75
1746586422911,PSYC 169,A00,890810,Staff,0,15,30,30
1746586423937,PSYC 172,A00,890814,Gorman; Michael R.,9,0,30,21
1746586424961,PSYC 181,A00,890818,Anagnostaras; Stephan,7,0,200,193
1746586425990,PSYC 184,A00,959861,Staff,164,0,175,11
1746586427014,PSYC 189,A00,890823,Staff,0,2,30,30
1746586428044,PSYC 191,A00,890884,Rickard; Timothy C.,0,12,35,35
1746586429073,PSYC 193,A00,890913,Staff,19,0,30,11
1746586429073,PSYC 193,B00,890914,Chapman; Eddie Nathaniel,24,0,30,6
1746586430098,PSYC 193L,A01,890918,Lowe; Angela Beth,20,0,30,10
1746586430098,PSYC 193L,B01,890921,Hurwitz; Ethan Scott,20,0,30,10
1746586430098,PSYC 193L,C01,890928,Staff,30,0,30,0
1746586431125,RELI 149,A00,886806,Rahimi; Babak,23,0,40,17
1746586432153,SE 9,A01,886814,Staff,7,0,20,13
1746586433181,SE 101B,A01,886816,Chadha; Mayank,3,0,35,32
1746586434208,SE 110B,A00,886818,Zhu; Qiang,4,0,75,71
1746586435233,SE 125,A01,886830,Staff,10,0,30,20
1746586436261,SE 130B,A01,886835,Staff,14,0,40,26
1746586437287,SE 131A,A01,886838,Krysl; Petr,34,0,55,21
1746586438313,SE 154,A00,886840,Staff,28,0,50,22
1746586439341,SE 164GS,A01,886849,Staff,6,0,20,14
1746586440371,SE 167GS,A01,886853,Staff,6,0,20,14
1746586441397,SIO 25,A01,890107,Staff,19,0,30,11
1746586442433,SIO 45,A00,890109,Cook; Geoffrey W,116,0,200,84
1746586443458,SIO 109R,A00,890110,Forman; Fonna,0,16,20,20
1746586444482,SIO 187,A01,890114,Kacev; David,15,0,40,25
1746586445511,SOCI 1,A01,890431,Thorpe; Charles Robert,14,0,30,16
1746586445511,SOCI 1,A02,890518,Thorpe; Charles Robert,30,0,30,0
1746586446541,SOCI 2,A01,957978,Staff,25,0,25,0
1746586446541,SOCI 2,A02,957979,Staff,23,0,25,2
1746586447569,SOCI 20,A01,890523,Calderon-Zaks; Michael Aar,21,0,30,9
1746586447569,SOCI 20,A02,890526,Calderon-Zaks; Michael Aar,29,0,30,1
1746586448593,SOCI 30,A01,890533,Pardo Guerra; Juan Pablo,37,0,40,3
1746586449617,SOCI 40,A01,890535,Staff,27,0,45,18
1746586450642,SOCI 104Q,A00,890559,Staff,18,0,30,12
1746586451671,SOCI 106,A00,890560,Arnal; Maud Marie Leonie,20,0,30,10
1746586452700,SOCI 110,A00,890567,Holkenbrink-Monk; Charlene,19,0,30,11
1746586453723,SOCI 112,A00,890568,Victoria Torres; Pablo,2,0,55,53
1746586454751,SOCI 115,A00,890597,Arnal; Maud Marie Leonie,28,0,45,17
1746586456803,SOCI 121,A00,890604,Pardo Guerra; Juan Pablo,38,0,45,7
1746586457830,SOCI 126,A01,890608,Staff,8,0,10,2
1746586458857,SOCI 127,A00,890609,Staff,18,0,30,12
1746586459886,SOCI 131,A00,890610,Thorpe; Charles Robert,37,0,45,8
1746586460911,SOCI 135,A00,890615,Payne; Christine Anna,13,0,45,32
1746586461941,SOCI 139,A00,890620,Staff,38,0,45,7
1746586462969,SOCI 148E,A00,890622,Calderon-Zaks; Michael Aar,36,0,45,9
1746586463998,SOCI 150,A00,890623,Kohler; Kristopher M.,31,0,45,14
1746586465024,SOCI 157,A00,890625,Jules-Rosette; Bennetta W.,18,0,20,2
1746586466052,SOCI 160,A00,890627,Payne; Christine Anna,21,0,45,24
1746586467081,SYN 1,A00,886855,Fish; Gwendolyn Anne,0,1,0,0
1746586467081,SYN 1,B00,906086,Fish; Gwendolyn Anne,0,2,0,2
1746586468107,SYN 2R,A00,886860,Staff,0,17,15,15
1746586468107,SYN 2R,B00,906106,Atkinson; Arthur Laird,0,16,15,15
1746586469132,SYN 100,A01,886866,Browne; Emily,0,28,20,20
1746586469132,SYN 100,B01,906128,Rock; Martin,0,4,20,20
1746586469132,SYN 100,C01,906140,Deavenport; James Cary,0,4,20,20
1746586469132,SYN 100,D01,907816,Deavenport; James Cary,0,5,20,20
1746586470188,TDAC 1,A00,890286,Walsh; Kim C.,7,0,20,13
1746586471217,TDAC 101,A00,890296,Basso; Beatrice,15,0,20,5
1746586472241,TDDE 131,A00,890297,Staff,47,0,50,3
1746586473265,TDDM 1,A00,890287,Weinberg; Sadie,25,0,30,5
1746586474294,TDGE 11,A00,890288,Fulton; Julia,138,0,200,62
1746586474294,TDGE 11,B00,890289,Castro; Robert Jess,185,0,200,15
1746586475318,TDGE 25,B00,957359,Walsh; Kim C.,5,0,20,15
1746586476350,TDGE 40,A01,890292,Power; Jade Yukana,27,0,30,3
1746586477375,TDGE 124,A00,890298,Havis; Allan,0,1,50,50
1746586478402,TDGE 131R,A00,890299,Burelle; Julie Sara Veronique,15,0,42,27
1746586479427,TDHT 101,A00,890300,Staff,10,0,20,10
1746586480451,TDHT 109,A01,890302,Anderson; Mysia Anyse,31,0,40,9
1746586481479,TDMV 1,A00,890293,Arcidiacono; Kristin,18,0,30,12
1746586482504,TDMV 2,A00,890294,Weinberg; Sadie,23,0,30,7
1746586483530,TDMV 3,A00,957878,Arcidiacono; Kristin,28,0,30,2
1746586485580,TDMV 138,A00,890304,Jun; Grace Shin Hae,25,0,40,15
1746586486608,TDMV 140,A00,890305,Corrales; Joseph Bernales,25,0,30,5
1746586487632,TDMV 142,A00,890307,Caligagan; Tony,32,0,40,8
1746586488659,TDMV 144,A00,890308,Camaya; Michelle Ann,25,0,30,5
1746586489685,TDPW 1,A00,890295,Stein; Deborah Isobel,3,0,20,17
1746586490712,USP 2,A01,890272,Lerner; Amy M,7,0,20,13
1746586491737,USP 3,A01,890274,Staff,12,0,30,18
1746586492763,USP 15,A01,890276,Sun; Feiyang,16,0,30,14
1746586493787,USP 25,A00,890277,Shenkman; Michael Thomas,18,0,25,7
1746586494813,USP 138,A00,890278,Staff,13,0,25,12
1746586495838,USP 143,A00,890279,Staff,22,0,70,48
1746586496862,USP 144,A00,890280,Chowdhury; Muhammed Zohir,16,0,30,14
1746586497887,USP 150,A00,890281,Boomhower; Matthew Charles,4,0,30,26
1746586498911,USP 151,A00,890282,Staff,16,0,20,4
1746586499939,USP 162,A00,890283,Andrews; Abigail Leslie,16,0,20,4
1746586500965,USP 168,A00,920477,Kwak; Nancy,0,0,5,5
1746586501994,USP 181,A00,890284,Staff,3,0,20,17
1746586503028,USP 191A,A00,890285,Staff,12,0,20,8
1746586504058,VIS 101,A00,886512,Staff,26,0,75,49
1746586505086,VIS 103,A00,886513,Cruz; Edwin Teddy,61,0,75,14
1746586506112,VIS 108,A00,886514,Staff,3,0,15,12
1746586507139,VIS 127P,A00,886515,Shen; Kuiyi,79,0,146,67
1746586508166,VIS 149,A00,886516,Yoldas; Pinar,0,0,15,15
1746586509192,VIS 164,A00,886526,Erdmann; Dean,19,0,22,3
1746586510217,VIS 194S,A00,886527,Staff,61,0,75,14
1746586511244,WCWP 10A,C00,886484,Martiniuk; Jill,12,0,15,3
1746586512270,WCWP 10B,A00,886490,Uriarte; Emma,0,0,15,15
1746586512270,WCWP 10B,B00,886491,Dhir; Simrita,8,0,15,7
1746586512270,WCWP 10B,C00,886492,Ornelas; Tricia,0,0,15,15
1746586513297,WCWP 100,A00,886494,Young; Mark T,0,6,15,15
1746586515366,AAS 10,A01,886199,Childs; Dennis R.,0,3,0,0
1746586516390,ANAR 104,A01,886940,Shtienberg; Gilad,27,0,30,3
1746586517416,ANAR 120,A00,886953,Staff,13,0,20,7
1746586518441,ANBI 148,A01,886955,Wilder; Linnea Lorene,30,0,40,10
1746586520495,ANSC 122,A00,886957,Staff,24,0,30,6
1746586521522,ANSC 150,A00,886958,Sloane; Julia Kathryn,2,0,15,13
1746586522546,ANSC 156,A00,886959,Jenkins; Janis A.,0,1,15,15
1746586523571,ANSC 180,A00,886960,Staff,11,0,17,6
1746586524600,ANSC 188,A00,886961,Jassal; Aftab,9,0,25,16
1746586525629,ANSC 190,A00,886962,Jassal; Aftab,14,0,25,11
1746586526658,ANSC 191,A00,886963,Staff,18,0,20,2
1746586527686,ANTH 3,A01,891689,Staff,17,0,20,3
1746586528713,ANTH 5,A00,886933,Semendeferi; Ekaterini,16,0,20,4
1746586529736,ANTH 10,A00,886934,Staff,0,12,30,30
1746586530762,ANTH 21,A01,886936,Staff,41,0,60,19
1746586531788,ANTH 23,A01,886938,Staff,92,0,100,8
1746586532816,ANTH 105,A00,886964,Stewart; Alexander B,84,0,100,16
1746586533843,ANTH 108,A00,886965,Pedersen; David,9,0,20,11
1746586534870,AWP 10,001,886147,Staff,0,0,0,0
1746586534870,AWP 10,002,886148,Staff,0,0,0,0
1746586534870,AWP 10,003,886149,Staff,0,0,0,0
1746586534870,AWP 10,004,886150,Staff,0,0,0,0
1746586534870,AWP 10,005,886151,Staff,0,0,0,0
1746586534870,AWP 10,006,886152,Staff,0,0,0,0
1746586534870,AWP 10,007,886153,Staff,0,0,0,0
1746586534870,AWP 10,008,886154,Staff,0,0,0,0
1746586534870,AWP 10,009,886155,Staff,0,0,0,0
1746586534870,AWP 10,010,886156,Staff,0,0,0,0
1746586534870,AWP 10,011,886158,Staff,0,0,0,0
1746586534870,AWP 10,012,886160,Staff,0,0,0,0
1746586534870,AWP 10,013,886161,Staff,0,0,0,0
1746586534870,AWP 10,014,886162,Staff,0,0,0,0
1746586534870,AWP 10,015,886163,Staff,0,0,0,0
1746586534870,AWP 10,016,886164,Staff,0,0,0,0
1746586534870,AWP 10,017,886165,Staff,0,0,0,0
1746586534870,AWP 10,018,886166,Staff,0,0,0,0
1746586534870,AWP 10,019,886168,Staff,0,0,0,0
1746586534870,AWP 10,020,886170,Staff,0,0,0,0
1746586534870,AWP 10,021,886172,Staff,0,0,0,0
1746586535906,AWP 10R,001,886173,Staff,0,1,0,0
1746586535906,AWP 10R,002,886174,Staff,0,1,0,0
1746586535906,AWP 10R,003,886175,Staff,0,0,0,0
1746586535906,AWP 10R,004,886176,Staff,0,0,0,0
1746586535906,AWP 10R,005,886177,Staff,0,0,0,0
1746586535906,AWP 10R,006,886178,Staff,0,0,0,0
1746586535906,AWP 10R,007,886179,Staff,0,0,0,0
1746586535906,AWP 10R,008,886181,Staff,0,0,0,0
1746586535906,AWP 10R,009,886182,Staff,0,0,0,0
1746586535906,AWP 10R,010,886183,Staff,0,0,0,0
1746586535906,AWP 10R,011,886184,Staff,0,0,0,0
1746586535906,AWP 10R,012,886185,Staff,0,0,0,0
1746586535906,AWP 10R,013,886186,Staff,0,0,0,0
1746586535906,AWP 10R,014,886187,Staff,0,0,0,0
1746586535906,AWP 10R,015,886188,Staff,0,0,0,0
1746586535906,AWP 10R,016,886189,Staff,0,0,0,0
1746586535906,AWP 10R,017,960532,Staff,0,0,0,0
1746586535906,AWP 10R,018,960533,Staff,0,0,0,0
1746586535906,AWP 10R,019,960534,Staff,0,0,0,0
1746586535906,AWP 10R,020,960538,Staff,0,0,0,0
1746586535906,AWP 10R,021,960540,Staff,0,0,0,0
1746586535906,AWP 10R,022,960541,Staff,0,0,0,0
1746586535906,AWP 10R,023,960542,Staff,0,0,0,0
1746586535906,AWP 10R,024,960544,Staff,0,0,0,0
1746586535906,AWP 10R,025,960545,Staff,0,0,0,0
1746586535906,AWP 10R,026,960548,Staff,0,0,0,0
1746586536933,AWP 102R,A00,886190,Staff,0,0,0,0
1746586536933,AWP 102R,B00,886191,Staff,0,0,0,0
1746586537958,BENG 100,A01,886193,Staff,17,0,30,13
1746586538986,BENG 122A,A01,886195,Hasty; Jeff M,13,0,30,17
1746586540015,BENG 166A,A00,886196,Sah; Robert Lie-Yuan,0,3,30,30
1746586541039,BENG 190,A00,958050,Khojah; Reem I,17,0,25,8
1746586542066,BIBC 102,A01,894320,Staff,0,0,46,46
1746586542066,BIBC 102,A02,894321,Staff,0,0,46,46
1746586542066,BIBC 102,A03,894344,Staff,6,0,46,40
1746586542066,BIBC 102,A04,894345,Staff,27,0,47,20
1746586543091,BICD 100R,A01,894365,Smith; Laurie,1,3,58,57
1746586543091,BICD 100R,A02,894366,Smith; Laurie,1,5,58,57
1746586543091,BICD 100R,A03,894367,Smith; Laurie,0,0,59,59
1746586543091,BICD 100R,A04,959869,Smith; Laurie,40,0,59,19
1746586544117,BICD 136,A01,894383,Gustafson-Brown; Cindy,14,0,50,36
1746586545143,BIEB 102,A01,894494,Butler; Shannon Rhey,51,0,130,79
1746586547199,BIEB 150,A01,894617,Wills; Christopher,3,0,20,17
1746586547199,BIEB 150,A02,894631,Wills; Christopher,3,0,20,17
1746586547199,BIEB 150,A03,894937,Wills; Christopher,3,0,20,17
1746586547199,BIEB 150,A04,894946,Wills; Christopher,5,0,20,15
1746586548223,BIEB 194,A00,906141,Kurle; Carolyn M.,5,0,20,15
1746586549251,BILD 1,A01,894154,Staff,3,0,19,16
1746586549251,BILD 1,A02,894155,Staff,14,0,19,5
1746586549251,BILD 1,A03,894160,Staff,13,0,19,6
1746586549251,BILD 1,A04,894161,Staff,15,0,18,3
1746586550279,BILD 2,A01,894168,Staff,0,0,50,50
1746586550279,BILD 2,A02,894169,Staff,0,0,50,50
1746586550279,BILD 2,A03,894179,Staff,0,0,50,50
1746586550279,BILD 2,A04,894203,Staff,24,0,50,26
1746586551304,BILD 3,A01,894213,Staff,23,0,31,8
1746586551304,BILD 3,A02,894214,Staff,26,0,31,5
1746586551304,BILD 3,A03,894235,Staff,28,0,31,3
1746586551304,BILD 3,A04,894236,Staff,28,0,32,4
1746586552331,BILD 4,A01,894253,Reuther; Keefe,5,0,24,19
1746586552331,BILD 4,A02,894258,Reuther; Keefe,16,0,24,8
1746586553357,BILD 5,A01,894276,Reuther; Keefe,34,0,50,16
1746586553357,BILD 5,A02,894277,Reuther; Keefe,45,0,50,5
1746586553357,BILD 5,A03,894290,Reuther; Keefe,44,0,50,6
1746586553357,BILD 5,A04,894291,Reuther; Keefe,48,0,50,2
1746586554384,BILD 24,A01,894297,Pirino; Giorgia,40,0,60,20
1746586555412,BIMM 100,B01,958915,Staff,71,0,100,29
1746586556438,BIMM 101,A01,895017,McDonnell; Lisa Marie,0,5,24,24
1746586556438,BIMM 101,A02,895018,McDonnell; Lisa Marie,0,5,24,24
1746586556438,BIMM 101,B01,895020,McDonnell; Lisa Marie,0,6,24,24
1746586556438,BIMM 101,B02,895021,McDonnell; Lisa Marie,0,4,24,24
1746586557465,BIMM 110,A01,895023,Staff,1,0,25,24
1746586557465,BIMM 110,A02,895024,Staff,9,0,25,16
1746586557465,BIMM 110,A03,895025,Staff,18,0,25,7
1746586557465,BIMM 110,A04,895031,Staff,20,0,25,5
1746586558490,BIMM 120,A01,895114,Gustafson-Brown; Cindy,14,0,28,14
1746586558490,BIMM 120,A02,895126,Gustafson-Brown; Cindy,21,0,27,6
1746586559515,BIPN 100,A01,895130,Yang; Mingyu,0,0,38,38
1746586559515,BIPN 100,A02,895131,Yang; Mingyu,31,0,38,7
1746586559515,BIPN 100,A03,895132,Yang; Mingyu,32,0,38,6
1746586559515,BIPN 100,A04,895133,Yang; Mingyu,27,0,36,9
1746586560540,BIPN 120,A01,895135,Cooke; James Edward,0,3,13,13
1746586560540,BIPN 120,A02,895136,Cooke; James Edward,0,1,13,13
1746586560540,BIPN 120,A03,895137,Cooke; James Edward,0,3,13,13
1746586560540,BIPN 120,A04,895156,Cooke; James Edward,0,2,11,11
1746586561565,BIPN 134,A01,895235,Cooke; James Edward,0,2,25,25
1746586561565,BIPN 134,A02,895237,Cooke; James Edward,0,0,25,25
1746586561565,BIPN 134,A03,895240,Cooke; James Edward,3,0,25,22
1746586561565,BIPN 134,A04,895270,Cooke; James Edward,20,0,25,5
1746586562590,BIPN 189,A00,892103,Staff,0,14,14,14
1746586564641,BISP 194,A00,958008,Staff,0,2,0,0
1746586565673,CAT 124,A01,922009,Staff,0,5,20,20
1746586566699,CAT 125R,A00,886390,Morales; Celeste Georgianna,0,2,20,20
1746586566699,CAT 125R,B00,886391,Irwin; Matthew Joseph,0,4,20,20
1746586566699,CAT 125R,C00,886392,Smith; Lauryn Alissa,0,2,20,20
1746586566699,CAT 125R,D00,886393,Vanderschuit; Maya Alysia,0,3,20,20
1746586566699,CAT 125R,E00,886394,Marchisotto; Jennifer Anne,0,3,20,20
1746586567727,CENG 15,A01,886218,Drews; Aaron,3,0,8,5
1746586568753,CENG 113,A00,886219,Opatkiewicz; Justin Paul,15,0,25,10
1746586569777,CGS 101,A00,887044,Staff,7,0,20,13
1746586570808,CGS 105,A01,887046,Staff,14,0,25,11
1746586571832,CGS 112,A00,887047,Cuong; Marisol,12,0,15,3
1746586572856,CGS 113,A00,887048,Staff,23,0,30,7
1746586573881,CGS 120,A00,887049,Staff,10,0,17,7
1746586574908,CHEM 6A,A01,886336,Lam; Tin Yiu,38,0,50,12
1746586574908,CHEM 6A,A02,886338,Lam; Tin Yiu,37,0,50,13
1746586575961,CHEM 6B,A01,886341,Hopkins; Patrycja Anna,16,0,50,34
1746586575961,CHEM 6B,A02,886343,Hopkins; Patrycja Anna,42,0,50,8
1746586576988,CHEM 6C,A01,886346,Albizati; Kim F.,0,2,50,50
1746586576988,CHEM 6C,A02,886348,Albizati; Kim F.,24,0,50,26
1746586578013,CHEM 40A,A01,886352,Klosterman; Jeremy K,65,0,100,35
1746586579038,CHEM 40B,A01,886356,Klosterman; Jeremy K,0,24,100,100
1746586580064,CHEM 41B,A01,886360,Theodorakis; Emmanuel,25,0,50,25
1746586580064,CHEM 41B,A02,886362,Theodorakis; Emmanuel,47,0,50,3
1746586581088,CHIN 165A,A00,886382,Xu; Li,18,0,20,2
1746586582117,CLAS 120,A00,886387,Myerston Santana; Jacobo,33,0,40,7
1746586583166,COGS 9,A01,886967,Shannon; Kyle Michael,42,0,60,18
1746586584192,COGS 11,A01,886969,Staff,9,0,30,21
1746586585219,COGS 14A,A01,886971,Staff,6,0,60,54
1746586586248,COGS 14B,A01,886973,Hoffman; Drew Ellen,4,0,60,56
1746586587274,COGS 18,A01,886975,Morgan; Eric,34,0,60,26
1746586588300,COGS 20,A01,886977,Staff,2,0,8,6
1746586588300,COGS 20,A02,886978,Staff,4,0,7,3
1746586589326,COGS 100,A01,907783,Staff,1,2,30,29
1746586590349,COGS 101B,A01,886980,Staff,0,4,48,48
1746586591377,COGS 101C,A01,886982,Delgado; Tania,0,5,44,44
1746586592404,COGS 102A,A01,886984,Johnson; Christine M.,3,0,30,27
1746586593432,COGS 118B,A01,886986,Staff,1,5,88,87
1746586594456,COGS 150,A01,886988,Bergen; Benjamin,22,0,50,28
1746586595482,COGS 153,A00,886989,Delgado; Tania,0,3,41,41
1746586596508,COGS 186,A01,886991,Staff,0,0,32,32
1746586597536,COGS 187A,A01,886993,Boyle; Mary E. T.,7,0,30,23
1746586598561,COGS 189,A00,886994,Staff,0,1,30,30
1746586599589,COMM 10,A01,886996,Staff,0,0,20,21
1746586599589,COMM 10,A02,886997,Staff,10,0,20,10
1746586599589,COMM 10,A03,959845,Staff,19,0,20,1
1746586600617,COMM 20,A01,886999,Leuning; Grant Maurstad,24,0,40,16
1746586602727,COMM 100A,A01,887002,Staff,0,0,20,25
1746586602727,COMM 100A,A02,887003,Staff,6,0,20,14
1746586603753,COMM 100B,A01,887005,Staff,0,8,20,24
1746586604778,COMM 106D,A00,887006,Staff,13,0,40,27
1746586605803,COMM 110G,A00,887007,Whitworth-Smith; Andrew C,12,0,40,28
1746586606831,COMM 111B,A00,887008,Staff,31,0,40,9
1746586607859,COMM 113T,A00,887009,Abuelhiga; Soraya Jill,28,0,40,12
1746586607859,COMM 113T,B00,906733,Staff,40,0,40,0
1746586608885,COMM 145,A00,887010,Staff,12,0,40,28
1746586609912,COMM 146,A00,887054,Staff,31,0,40,9
1746586610935,COMM 190,A00,887012,Staff,8,0,23,15
1746586611963,CSE 8A,A50,887015,Cao; Yingjun,57,0,85,28
1746586612988,CSE 11,A01,887017,Cao; Yingjun,12,0,70,58
1746586614014,CSE 20,A01,887019,Staff,30,0,50,20
1746586615044,CSE 21,A01,887021,Staff,78,0,100,22
1746586615044,CSE 21,B01,892583,Braun; Oliver,45,0,50,5
1746586616069,CSE 30,A01,887025,Eldon; John,142,0,200,58
1746586617094,CSE 100,A01,887027,Staff,26,0,50,24
1746586617094,CSE 100,A02,887028,Staff,42,0,50,8
1746586618121,CSE 101,A01,887030,Braun; Oliver,74,0,100,26
1746586618121,CSE 101,B01,887032,Jones; Miles E,0,3,50,50
1746586618121,CSE 101,B02,887033,Jones; Miles E,0,2,50,50
1746586619146,CSE 105,A01,908084,Jones; Miles E,32,0,50,18
1746586619146,CSE 105,A02,908087,Jones; Miles E,31,0,50,19
1746586620172,CSE 135,A01,887035,Powell; Thomas Allan,0,5,50,50
1746586621196,CSE 142,A01,887037,Staff,8,0,60,52
1746586622222,CSE 142L,A01,887039,Staff,34,0,60,26
1746586623252,CSE 151A,A01,887041,Solares; Edwin A,47,0,100,53
1746586624279,CSE 175,A01,887043,Kumar; Rakesh,30,0,30,0
1746586625304,CSS 1,A01,886389,Staff,1,2,40,39
1746586626331,DSC 30,A01,908097,Liao; Soohyun Nam,47,0,75,28
1746586627357,DSC 40A,A01,908099,Shannon; Kyle Michael,30,0,50,20
1746586628383,DSC 40B,A01,908112,Staff,15,0,50,35
1746586629407,DSC 80,A01,908116,Staff,19,0,60,41
1746586630431,DSC 197,001,956863,Eldridge; Justin Matthew,9999,0,9999,0
1746586631457,ECE 5,A01,886400,Morris; Karcher William,1,0,6,5
1746586631457,ECE 5,A02,886401,Morris; Karcher William,3,0,6,3
1746586632483,ECE 148,A01,886403,Silberman; Jack,0,14,14,14
1746586633513,ECON 1,A01,887265,Crane; Meredith Helen,11,0,70,59
1746586633513,ECON 1,B01,887268,Staff,42,0,50,8
1746586634540,ECON 2,A01,887273,Crane; Meredith Helen,54,0,70,16
1746586635567,ECON 3,A01,887279,Rondina; Giacomo,31,0,70,39
1746586636591,ECON 4,A01,887282,Anderson; John Charles,0,2,10,10
1746586637619,ECON 5,A01,887285,Staff,34,0,45,11
1746586637619,ECON 5,B01,887292,Staff,41,0,45,4
1746586638649,ECON 100A,A01,887337,Newhouse; Herbert S,54,0,70,16
1746586638649,ECON 100A,B01,887349,Staff,45,0,50,5
1746586639674,ECON 100B,A01,887361,Du; Songzi,29,0,70,41
1746586640704,ECON 100C,A01,887445,Newhouse; Herbert S,59,0,70,11
1746586641730,ECON 105,A00,887488,Vespa; Emanuel Ignacio,23,0,35,12
1746586642759,ECON 109,A01,887506,Shishkin; Denis,28,0,35,7
1746586643784,ECON 110A,A01,887568,Alon; Titan Michael,0,3,35,35
1746586643784,ECON 110A,B01,907601,Alon; Titan Michael,20,0,35,15
1746586644812,ECON 110B,A01,887598,Levkoff; Steven B.,0,24,70,70
1746586645840,ECON 112,A00,887599,Rondina; Giacomo,19,0,35,16
1746586646866,ECON 120A,A01,887603,Dai; Yinlin,35,0,70,35
1746586647892,ECON 120C,A01,887608,Sun; Yixiao,0,1,35,35
1746586647892,ECON 120C,B01,887614,Sun; Yixiao,0,0,35,35
1746586648917,ECON 138,A00,887621,Bharadwaj; Prashant,0,21,20,20
1746586649943,ECON 144,A00,958007,Squires; Dale E,12,0,35,23
1746586650971,ECON 171,A01,907666,Staff,18,0,35,17
1746586651996,ECON 175,A00,887626,Wu; Pak Yeung,22,0,35,13
1746586653025,ECON 190,A00,887640,Vespa; Emanuel Ignacio,22,0,35,13
1746586654053,EDS 25,A01,888197,Staff,0,0,0,0
1746586654053,EDS 25,A02,888209,Staff,0,0,0,0
1746586654053,EDS 25,A03,888210,Staff,0,0,0,0
1746586654053,EDS 25,A04,888212,Staff,0,0,0,0
1746586654053,EDS 25,A05,888213,Staff,0,0,0,0
1746586654053,EDS 25,A06,888214,Staff,0,0,0,0
1746586654053,EDS 25,A07,888235,Staff,0,2,0,0
1746586654053,EDS 25,A08,888236,Staff,0,0,0,0
1746586654053,EDS 25,A09,888240,Staff,0,0,0,0
1746586654053,EDS 25,A10,888244,Staff,0,0,0,0
1746586654053,EDS 25,B01,888273,Staff,0,0,0,0
1746586654053,EDS 25,B02,888285,Staff,0,0,0,0
1746586654053,EDS 25,B03,888423,Staff,0,0,0,1
1746586654053,EDS 25,B04,888432,Staff,0,0,0,0
1746586654053,EDS 25,B05,888433,Staff,0,0,0,0
1746586654053,EDS 25,B06,888467,Staff,0,0,0,0
1746586654053,EDS 25,B07,888468,Staff,0,0,0,0
1746586654053,EDS 25,B08,888479,Staff,0,0,0,0
1746586654053,EDS 25,B09,888484,Staff,0,0,0,0
1746586654053,EDS 25,B10,888487,Staff,0,0,0,0
1746586655078,EDS 38,A01,907700,Choi; Bailey Miyeon,30,0,30,0
1746586656104,EDS 112,A01,888601,Chapman; Thandeka K,12,0,40,28
1746586657128,EDS 115,A00,888697,Mendez; Kathrina Mendoza,10,0,30,20
1746586658153,EDS 116,A01,888893,Staff,34,0,40,6
1746586660205,EDS 124AR,A00,889133,Staff,29,0,50,21
1746586660205,EDS 124AR,B00,907471,Simon; Elizabeth A,37,0,50,13
1746586661233,EDS 124BR,A00,889134,Simon; Elizabeth A,44,0,100,56
1746586662261,EDS 125,A00,889135,Staff,25,0,30,5
1746586663286,EDS 126,A01,889138,Staff,35,0,40,5
1746586664312,EDS 164R,A01,889142,Wishard Guerra; Alison G.,32,0,50,18
1746586665342,ENG 30,A01,886396,Staff,0,0,0,0
1746586665342,ENG 30,B01,886398,Staff,0,0,0,0
1746586666371,ENVR 102,A00,906150,Montejo; Carolina,23,0,25,2
1746586667396,ETHN 103A,A00,887236,Man; Simeon S,0,3,0,0
1746586668424,ETHN 113,A00,887239,Staff,16,0,30,14
1746586669450,ETHN 116,A00,887240,Staff,16,0,25,9
1746586670475,ETHN 117,A00,887241,Choi; Esther Min,28,0,30,2
1746586671502,ETHN 118,A00,887243,Staff,24,0,30,6
1746586672529,ETHN 127,A00,887248,Cuong; Marisol,11,0,15,4
1746586673553,ETHN 139,A00,887250,Staff,7,0,10,3
1746586674579,ETHN 142,A00,887252,Staff,10,0,30,20
1746586675607,ETHN 161,A00,887253,Browne; Errol Tsekani,24,0,30,6
1746586676634,ETHN 163FR,A00,887255,Burelle; Julie Sara Veronique,0,0,5,5
1746586677662,GLBH 20,A00,889149,Elwardani; Nile Regina,8,0,42,34
1746586679713,GLBH 111,A01,889152,Burgos; Jose L.,17,0,17,0
1746586680738,GLBH 150,A00,889181,Sloane; Julia Kathryn,0,5,15,15
1746586682788,HDS 60,A01,886406,Warstadt; Melissa Fawn,73,0,80,7
1746586683817,HIAF 111,A00,889324,Gyamfi; Bright,25,0,32,7
1746586684843,HIEA 131,A00,889328,Staff,15,0,32,17
1746586685872,HIEA 144,A00,889333,Henry; Todd A.,26,0,32,6
1746586686899,HIEA 154,A00,889336,Henry; Todd A.,24,0,32,8
1746586687927,HIEU 106,A00,889339,Staff,22,0,32,10
1746586689980,HIEU 114,A00,889340,Staff,4,0,32,28
1746586691005,HIEU 135GS,A00,889342,Patterson; Patrick H.,0,0,1,24
1746586692029,HIEU 137,A00,889343,Edington; Claire Ellen,10,0,25,15
1746586693092,HIEU 148,A00,889345,Staff,14,0,32,18
1746586694117,HIEU 154,A00,889346,Biess; Frank Peter,21,0,32,11
1746586695146,HILA 102,A00,889351,Staff,12,0,32,20
1746586696173,HILD 2A,A01,889221,Lewandoski; Julia Mavis,2,10,32,30
1746586697199,HILD 7B,A01,889225,Man; Simeon S,0,12,32,32
1746586698225,HILD 7C,A01,889288,Alvarez; Luis A,0,14,32,32
1746586699249,HILD 30,A01,889323,Staff,0,5,32,32
1746586701301,HISC 119,A00,889383,Golan; Tal,19,0,32,13
1746586702326,HIUS 103,A00,889384,Man; Simeon S,0,0,32,32
1746586703352,HIUS 117,A00,919797,Kwak; Nancy,19,0,32,13
1746586704378,HIUS 142A,A00,919788,Staff,22,0,32,10
1746586706430,HIUS 149,A00,889386,Gyamfi; Bright,26,0,32,6
1746586707453,HIUS 155,A00,889387,Alvarez; Luis A,15,0,32,17
1746586708477,HUM 3,A01,886499,Caldwell; Michael Alan,19,0,50,31
1746586709502,HUM 3GS,A00,886500,Rodriguez; Bretton Sigfred,0,0,0,28
1746586710530,HUM 3R,A01,886502,Markman; Kristina,0,36,50,50
1746586711557,HUM 4,A01,886504,Crum; Matthew Stephen,23,0,50,27
1746586711557,HUM 4,B01,886506,West; Geoffrey Scott,17,0,50,33
1746586712581,HUM 4GS,A00,886507,Staff,0,0,0,19
1746586713609,HUM 5,A01,886509,Staff,32,0,50,18
1746586714633,HUM 5R,A01,886511,Zavodny; Tatiana Sophia,0,39,50,50
1746586715660,JAPN 180,A00,886407,Staff,16,0,40,24
1746586716687,LATI 50,A01,886409,Martin-Cabrera; Luis,3,0,22,19
1746586716687,LATI 50,A02,886410,Martin-Cabrera; Luis,19,0,22,3
1746586716687,LATI 50,A03,886411,Martin-Cabrera; Luis,21,0,22,1
1746586716687,LATI 50,A04,886412,Martin-Cabrera; Luis,8,0,22,14
1746586717710,LAWS 101,A00,907664,Staff,28,0,60,32
1746586718736,LIAB 1A,A00,889388,Saab; Dima,17,0,20,3
1746586719762,LIAB 1AX,A00,889389,El Cheddadi; Youniss,18,0,20,2
1746586720785,LIFR 1C,A00,889391,Van Moer; Vinciane G,8,0,20,12
1746586721813,LIFR 1CX,A00,889392,Van Moer; Vinciane G,7,0,20,13
1746586722839,LIFR 1D,A00,889393,Van Moer; Vinciane G,7,0,20,13
1746586723866,LIFR 1DX,A00,889394,Van Moer; Vinciane G,8,0,20,12
1746586724893,LIGN 7,A00,886923,Staff,24,0,50,26
1746586725920,LIGN 17,A00,886924,Kehler; Andrew Scott,125,0,150,25
1746586726944,LTAM 110,A00,889395,Staff,15,0,30,15
1746586727968,LTAM 110GS,A00,958010,Rodriguez; Bretton Sigfred,0,0,0,28
1746586728991,LTCH 101,A00,889397,Staff,23,0,25,2
1746586730020,LTCS 130,A00,889398,Staff,23,0,25,2
1746586731048,LTEA 138,A00,889399,Staff,24,0,40,16
1746586732078,LTEN 149,A00,889400,Wesling; Megan E.,0,3,25,25
1746586733104,LTEN 169,A00,889401,Staff,20,0,25,5
1746586734150,LTEN 180,A00,889402,Staff,10,0,15,5
1746586735176,LTEN 181,A00,889403,Staff,21,0,25,4
1746586736200,LTWL 100,A00,889404,Myerston Santana; Jacobo,2,0,25,23
1746586737226,LTWL 180GS,A00,889405,Staff,0,0,20,20
1746586738249,LTWL 181,A00,889406,Staff,16,0,25,9
1746586739276,LTWL 184,A00,889475,Mukherjee; Silpa,22,0,25,3
1746586740304,LTWR 102C,A00,889486,Staff,29,0,30,1
1746586741331,LTWR 115W,A00,889491,Staff,0,2,15,15
1746586742359,MAE 8,A01,886905,Staff,0,2,0,0
1746586743384,MAE 11,A00,886906,Bandaru; Prabhakar,0,7,50,50
1746586744408,MAE 20,A00,886907,Evdokimenko; Ekaterina,43,0,70,27
1746586745437,MAE 30B,A00,886909,Ghazinejad; Maziar,26,0,45,19
1746586746466,MAE 101B,A00,886910,Saintillan; David,29,0,45,16
1746586747493,MAE 105,A00,886911,Bandaru; Prabhakar,18,0,50,32
1746586748521,MAE 107,B00,958024,Staff,7,0,50,43
1746586749549,MAE 143B,A00,886913,Bewley; Thomas R,3,0,40,37
1746586750573,MAE 148,A01,886915,Silberman; Jack,0,3,14,14
1746586751599,MAE 160,A00,886916,Evdokimenko; Ekaterina,31,0,60,29
1746586752626,MATH 3C,A01,889681,Staff,0,2,30,30
1746586752626,MATH 3C,A02,960048,Staff,23,0,30,7
1746586753651,MATH 10A,A01,889760,Staff,26,0,30,4
1746586753651,MATH 10A,A02,889783,Staff,29,0,30,1
1746586754682,MATH 10B,A01,889785,Verstraete; Jacques Allan,1,0,35,34
1746586754682,MATH 10B,A02,889795,Verstraete; Jacques Allan,4,0,35,31
1746586754682,MATH 10B,B01,889797,Verstraete; Jacques Allan,3,0,35,32
1746586754682,MATH 10B,B02,889828,Verstraete; Jacques Allan,3,0,35,32
1746586755707,MATH 10C,A01,889849,Habib; Yousaf,7,0,30,23
1746586755707,MATH 10C,A02,889852,Habib; Yousaf,14,0,30,16
1746586755707,MATH 10C,A03,889853,Habib; Yousaf,22,0,30,8
1746586755707,MATH 10C,A04,889858,Habib; Yousaf,20,0,30,10
1746586755707,MATH 10C,B01,889861,Staff,1,0,30,29
1746586755707,MATH 10C,B02,889862,Staff,24,0,30,6
1746586755707,MATH 10C,B03,889863,Staff,27,0,30,3
1746586755707,MATH 10C,B04,889967,Staff,23,0,30,7
1746586756737,MATH 18,A01,889974,Staff,7,0,30,23
1746586756737,MATH 18,A02,889977,Staff,20,0,30,10
1746586756737,MATH 18,B01,889984,Hardiman; Liam,20,0,30,10
1746586756737,MATH 18,B02,889985,Hardiman; Liam,25,0,30,5
1746586757761,MATH 20A,A01,889990,Suk; Andrew Hoon,30,0,35,5
1746586758785,MATH 20B,A01,889993,Ohm; Ko Woon,21,0,30,9
1746586758785,MATH 20B,A02,889994,Ohm; Ko Woon,30,0,30,0
1746586758785,MATH 20B,B01,889996,Ohm; Ko Woon,22,0,30,8
1746586758785,MATH 20B,B02,889997,Ohm; Ko Woon,23,0,30,7
1746586759810,MATH 20C,A01,889999,Hammock; Frances H,17,0,30,13
1746586759810,MATH 20C,A02,890003,Hammock; Frances H,23,0,30,7
1746586759810,MATH 20C,B01,890006,Hammock; Frances H,3,0,30,27
1746586759810,MATH 20C,B02,890007,Hammock; Frances H,12,0,30,18
1746586760836,MATH 20D,A01,890011,Cheng; Hsiao-Bing,1,1,30,29
1746586760836,MATH 20D,A02,890012,Cheng; Hsiao-Bing,14,0,30,16
1746586760836,MATH 20D,B01,890016,Cheng; Hsiao-Bing,13,0,30,17
1746586760836,MATH 20D,B02,890017,Cheng; Hsiao-Bing,13,0,30,17
1746586761860,MATH 20E,A01,890026,Harel; Guershon,1,0,30,29
1746586761860,MATH 20E,A02,890029,Harel; Guershon,22,0,30,8
1746586761860,MATH 20E,B01,890033,Harel; Guershon,7,0,30,23
1746586761860,MATH 20E,B02,890101,Harel; Guershon,21,0,30,9
1746586762885,MATH 102,A01,890104,Staff,18,0,30,12
1746586762885,MATH 102,A02,890105,Staff,27,0,30,3
1746586763914,MATH 103B,A01,890116,Salehi Golsefidy; Alireza,3,0,30,27
1746586763914,MATH 103B,B01,890118,Staff,0,3,34,34
1746586764941,MATH 109,A01,890121,Aliabadi Sr.; Mohsen,0,0,30,30
1746586764941,MATH 109,B01,890124,Upadrashta; Pranav Kumar,18,0,30,12
1746586765966,MATH 120A,A01,890126,Eggers; John Dietrich,13,0,30,17
1746586766995,MATH 142B,A01,890128,Ioana; Adrian,19,0,30,11
1746586766995,MATH 142B,A02,890129,Ioana; Adrian,12,0,30,18
1746586768024,MATH 154,A01,890174,Staff,0,1,30,30
1746586768024,MATH 154,A02,890182,Staff,0,0,30,30
1746586769054,MATH 168A,A01,890197,Dumitriu; Ioana,21,0,35,14
1746586770080,MATH 170A,A01,890240,Nie; Jiawang,1,0,30,29
1746586770080,MATH 170A,A02,890241,Nie; Jiawang,11,0,30,19
1746586770080,MATH 170A,A03,890249,Nie; Jiawang,23,0,30,7
1746586771106,MATH 170B,A01,957891,Nag; Panchali,13,0,35,22
1746586773156,MATH 181A,A01,908025,Staff,0,3,35,35
1746586773156,MATH 181A,A02,960115,Staff,26,0,35,9
1746586774182,MATH 181B,A01,959874,Staff,25,0,30,5
1746586775212,MATH 193B,A01,890265,Staff,0,4,35,35
1746586776241,MGT 4,A01,890311,Anderson; John Charles,42,0,88,46
1746586777265,MGT 5,A00,907740,Staff,13,0,98,85
1746586778294,MGT 12,A00,890312,Lindenberger; Wade Douglas,67,0,98,31
1746586779320,MGT 16,A00,957883,Staff,78,0,98,20
1746586781367,MGT 45,A00,890314,Pecore; Joseph P.,45,0,98,53
1746586782409,MGT 71,A00,890315,Staff,0,12,98,98
1746586783434,MGT 100,A00,890316,Yavorsky; Daniel Ryan,44,0,98,54
1746586784459,MGT 103,A00,890317,Ehrich; Kristine R,73,0,98,25
1746586785484,MGT 105,A00,890356,Bates; Kenneth Walter,0,8,98,98
1746586786509,MGT 112,A00,890360,Ehrich; Kristine R,55,0,98,43
1746586787534,MGT 127R,A00,907732,Zhu; Kevin Xiaoguo,23,0,98,75
1746586788560,MGT 131B,A00,890361,Anderson; John Charles,59,0,98,39
1746586789585,MGT 137,A00,890362,Lindenberger; Wade Douglas,65,0,98,33
1746586790620,MGT 160,A00,890369,Johnson; Erik Barry,9,0,98,89
1746586804057,MGT 164,A00,890372,Zimmermann; Carsten,0,40,98,98
1746586805083,MGT 180,A00,890374,Bliss; Barbara Ann,12,0,98,86
1746586806111,MMW 15,A01,886414,Chang; Edmond Yi-Teh,0,12,28,28
1746586806111,MMW 15,A02,886415,Chang; Edmond Yi-Teh,0,8,28,28
1746586806111,MMW 15,A03,886416,Chang; Edmond Yi-Teh,0,9,28,28
1746586806111,MMW 15,A04,886417,Chang; Edmond Yi-Teh,0,8,28,28
1746586806111,MMW 15,B01,886419,Chang; Edmond Yi-Teh,0,7,28,28
1746586806111,MMW 15,B02,886420,Chang; Edmond Yi-Teh,0,8,28,28
1746586806111,MMW 15,B03,886421,Chang; Edmond Yi-Teh,0,7,28,28
1746586806111,MMW 15,B04,886422,Chang; Edmond Yi-Teh,0,8,28,28
1746586806111,MMW 15,C01,886424,Staff,0,9,28,28
1746586806111,MMW 15,C02,886425,Staff,0,8,28,28
1746586806111,MMW 15,C03,886426,Staff,0,8,28,28
1746586806111,MMW 15,C04,886427,Staff,0,8,28,28
1746586806111,MMW 15,C05,958038,Staff,0,8,28,28
1746586806111,MMW 15,C06,958039,Staff,1,8,28,27
1746586807136,MMW 15GS,A00,906910,Patterson; Patrick H.,4,0,28,24
1746586808168,MMW 122R,A01,886429,Rahimi; Babak,0,13,28,28
1746586808168,MMW 122R,A02,886430,Rahimi; Babak,0,12,28,28
1746586808168,MMW 122R,A03,958040,Rahimi; Babak,0,11,28,28
1746586809202,MUS 1A,A01,890937,Staff,2,0,25,23
1746586809202,MUS 1A,A02,891035,Staff,6,0,25,19
1746586809202,MUS 1A,C01,958912,Staff,24,0,25,1
1746586809202,MUS 1A,C02,958913,Staff,25,0,25,0
1746586811253,MUS 2AK,A00,957092,Ohnishi; Takae,15,0,15,0
1746586812282,MUS 4,A01,891044,Staff,1,0,25,24
1746586812282,MUS 4,A02,891045,Staff,23,0,25,2
1746586812282,MUS 4,B01,891048,Staff,17,0,25,8
1746586812282,MUS 4,B02,891050,Staff,25,0,25,0
1746586813311,MUS 5,A01,957506,Dubnov; Shlomo,0,0,25,25
1746586813311,MUS 5,A02,957622,Dubnov; Shlomo,13,0,25,12
1746586813311,MUS 5,A03,957623,Dubnov; Shlomo,20,0,25,5
1746586814340,MUS 6,A01,891053,Freitas Caetano; Marcelo,24,0,25,1
1746586814340,MUS 6,A02,891054,Freitas Caetano; Marcelo,23,0,25,2
1746586815363,MUS 7,A01,891081,Staff,0,0,25,25
1746586815363,MUS 7,A02,891082,Staff,3,0,25,22
1746586816388,MUS 8GS,A00,891118,Borgo; David Garcia,1,0,25,24
1746586817416,MUS 11,A01,891140,Staff,9,0,25,16
1746586817416,MUS 11,A02,891141,Staff,21,0,25,4
1746586818448,MUS 13,A01,891143,Staff,8,0,25,17
1746586818448,MUS 13,A02,891144,Staff,24,0,25,1
1746586819477,MUS 15,A01,891146,Staff,9,0,25,16
1746586819477,MUS 15,A02,891148,Staff,21,0,25,4
1746586819477,MUS 15,B01,891150,Staff,18,0,25,7
1746586819477,MUS 15,B02,891151,Staff,25,0,25,0
1746586820507,MUS 20,A01,891153,Staff,5,0,20,15
1746586820507,MUS 20,A02,891155,Staff,14,0,20,6
1746586821535,MUS 80,A00,891156,Staff,19,0,25,6
1746586821535,MUS 80,B00,891157,Staff,23,0,25,2
1746586822563,MUS 130,A00,891158,Ohnishi; Takae,35,0,35,0
1746586823590,MUS 150GS,A01,891160,Borgo; David Garcia,1,0,25,24
1746586824621,MUS 170,A01,891162,Freitas Caetano; Marcelo,20,0,25,5
1746586824621,MUS 170,A02,891164,Freitas Caetano; Marcelo,21,0,25,4
1746586825648,NANO 11,A00,886220,Vazquez Mena; Oscar,13,0,15,2
1746586826673,NANO 15,A01,886222,Drews; Aaron,4,0,7,3
1746586827701,NANO 104,A00,886224,Sirbuly; Donald,17,0,25,8
1746586828727,PH 40,A00,886528,Staff,24,0,40,16
1746586829754,PH 45,A01,886799,Staff,35,0,40,5
1746586830782,PH 110,A00,886802,Staff,0,7,40,40
1746586832019,PH 172,A00,906716,Staff,19,0,35,16
1746586833047,PH 191,A00,886803,Staff,6,0,40,34
1746586834074,PHIL 1,A00,889500,Staff,20,0,30,10
1746586835103,PHIL 10,A01,889549,Grush; Rick Scott,16,0,22,6
1746586835103,PHIL 10,A02,889551,Grush; Rick Scott,22,0,22,0
1746586836129,PHIL 28,A01,889559,Lamey; Andy M.,0,2,31,31
1746586836129,PHIL 28,A02,889561,Lamey; Andy M.,0,1,30,30
1746586836129,PHIL 28,A03,889572,Lamey; Andy M.,0,1,30,30
1746586837156,PHIL 35,A00,907839,Staff,13,0,15,2
1746586838187,PHIL 60,A00,889574,Staff,73,0,90,17
1746586839212,PHIL 101,A00,958004,Staff,12,0,15,3
1746586841265,PHIL 136,A00,889582,Fulkerson; Matthew Todd,26,0,45,19
1746586842293,PHIL 163,A01,889601,Staff,21,0,30,9
1746586842293,PHIL 163,B01,889606,Brandt; Reuven A,0,3,0,0
1746586843318,PHIL 164,A00,889610,Staff,16,0,30,14
1746586844346,PHIL 165,A00,889613,Staff,22,0,30,8
1746586845376,PHYS 1A,A00,886431,Staff,29,0,70,41
1746586846404,PHYS 1AL,001,886432,Tsai; Philbert S,1,2,30,29
1746586846404,PHYS 1AL,002,886436,Tsai; Philbert S,12,0,30,18
1746586847433,PHYS 1B,A00,886439,Staff,184,0,240,56
1746586848463,PHYS 1BL,001,886441,Tsai; Philbert S,0,4,30,30
1746586848463,PHYS 1BL,002,886444,Tsai; Philbert S,2,0,30,28
1746586849487,PHYS 1C,A00,896092,Arnold; Kam S,78,0,146,68
1746586850513,PHYS 1CL,001,886448,Tsai; Philbert S,0,0,30,30
1746586850513,PHYS 1CL,002,886449,Tsai; Philbert S,1,0,30,29
1746586850513,PHYS 1CL,003,886450,Tsai; Philbert S,16,0,30,14
1746586850513,PHYS 1CL,004,886451,Tsai; Philbert S,15,0,30,15
1746586851541,PHYS 2B,A01,886457,Staff,67,0,115,48
1746586852568,PHYS 2C,A01,886460,Shotwell; Brian,0,9,65,65
1746586853595,PHYS 2CL,A01,886467,Staff,0,4,28,28
1746586853595,PHYS 2CL,A02,886468,Staff,0,3,28,28
1746586854624,PHYS 2D,A01,886470,Staff,10,0,50,40
1746586855651,PHYS 4B,A01,886475,Grinstein; Benjamin,22,0,40,18
1746586856676,POLI 5,A00,891173,Desposato; Scott,7,0,25,18
1746586857706,POLI 5D,A01,891175,Staff,5,0,5,0
1746586857706,POLI 5D,B01,891178,Staff,5,0,5,0
1746586858735,POLI 11,A00,891179,Ferree; Karen E,2,0,35,33
1746586859761,POLI 12,A00,891180,Staff,16,0,30,14
1746586860791,POLI 27,A01,891182,Staff,12,0,75,63
1746586861818,POLI 30,A00,891183,Staff,8,0,50,42
1746586862842,POLI 100B,A00,891244,Staff,5,1,35,30
1746586863867,POLI 100I,A00,891247,Staff,7,0,30,23
1746586864892,POLI 104J,A00,891248,Nichter; Maysa,14,0,30,16
1746586865919,POLI 104U,A00,891250,Nichter; Maysa,1,0,30,29
1746586867974,POLI 110B,A00,891255,Wiens; David,19,0,25,6
1746586869000,POLI 112A,A00,891256,Wiens; David,6,0,25,19
1746586870024,POLI 114BR,A00,891261,Staff,19,0,30,11
1746586871053,POLI 117R,A00,891262,Forman; Fonna,0,6,50,50
1746586872082,POLI 118,A00,891264,Ingham; Sean,17,0,25,8
1746586873111,POLI 124A,A00,891265,Staff,18,0,20,2
1746586874142,POLI 125D,A00,891266,Nichter; Simeon C,2,0,25,23
1746586875169,POLI 126,A00,891268,Nichter; Simeon C,7,0,25,18
1746586876196,POLI 126AA,A00,891272,Staff,15,0,25,10
1746586877224,POLI 130AA,A00,891273,Staff,15,0,20,5
1746586878254,POLI 134AA,A00,891274,Staff,4,0,20,16
1746586880304,POLI 138,A00,891278,Staff,21,0,25,4
1746586881333,POLI 142K,A00,891280,Staff,10,0,25,15
1746586882360,POLI 142M,A00,891281,Gartzke; Erik,16,0,30,14
1746586883390,POLI 142P,A00,891284,Staff,20,0,30,10
1746586884419,POLI 143,A00,891285,Gartzke; Erik,12,0,30,18
1746586885446,POLI 153,A00,891286,Staff,19,0,20,1
1746586887500,POLI 175,A00,891290,Staff,15,0,20,5
1746586888530,PSYC 1,A00,890674,Steiner; Eric Tomas,0,11,45,45
1746586889555,PSYC 2,A00,890676,Albright; Thomas D,20,0,35,15
1746586890586,PSYC 3,A00,890679,Staff,17,0,20,3
1746586891616,PSYC 6,A00,959858,Staff,19,0,20,1
1746586892643,PSYC 60,A01,890684,Rickard; Timothy C.,0,6,45,45
1746586893671,PSYC 70,A01,890689,Geller; Emma Harlan,6,0,30,24
1746586894700,PSYC 71,A01,959860,Staff,21,0,25,4
1746586895725,PSYC 100,A00,890690,Lacefield; Katharine I,0,50,180,180
1746586896752,PSYC 102,A00,890695,Staff,17,0,40,23
1746586897780,PSYC 105,A00,890699,Geller; Emma Harlan,70,0,100,30
1746586898806,PSYC 106,A00,890701,Gorman; Michael R.,5,0,30,25
1746586899831,PSYC 108,A00,890704,Adrian; Julia Anna,0,29,50,50
1746586900860,PSYC 118,A01,890712,Staff,11,0,30,19
1746586901888,PSYC 124,A00,890716,Chapman; Eddie Nathaniel,25,0,60,35
1746586902912,PSYC 131,A00,890717,Anagnostaras; Stephan,0,7,80,80
1746586903941,PSYC 137,A00,890719,Winkielman; Piotr,0,11,30,30
1746586904987,PSYC 144,A00,890721,Adrian; Julia Anna,0,9,45,45
1746586906012,PSYC 162,A00,890805,Staff,0,1,75,75
1746586907038,PSYC 169,A00,890810,Staff,0,15,30,30
1746586908067,PSYC 172,A00,890814,Gorman; Michael R.,9,0,30,21
1746586909093,PSYC 181,A00,890818,Anagnostaras; Stephan,7,0,200,193
1746586910120,PSYC 184,A00,959861,Staff,164,0,175,11
1746586911150,PSYC 189,A00,890823,Staff,0,2,30,30
1746586912180,PSYC 191,A00,890884,Rickard; Timothy C.,0,12,35,35
1746586913204,PSYC 193,A00,890913,Staff,19,0,30,11
1746586913204,PSYC 193,B00,890914,Chapman; Eddie Nathaniel,24,0,30,6
1746586914236,PSYC 193L,A01,890918,Lowe; Angela Beth,20,0,30,10
1746586914236,PSYC 193L,B01,890921,Hurwitz; Ethan Scott,20,0,30,10
1746586914236,PSYC 193L,C01,890928,Staff,30,0,30,0
1746586915261,RELI 149,A00,886806,Rahimi; Babak,23,0,40,17
1746586916286,SE 9,A01,886814,Staff,7,0,20,13
1746586917310,SE 101B,A01,886816,Chadha; Mayank,3,0,35,32
1746586918339,SE 110B,A00,886818,Zhu; Qiang,4,0,75,71
1746586919368,SE 125,A01,886830,Staff,10,0,30,20
1746586920393,SE 130B,A01,886835,Staff,14,0,40,26
1746586921419,SE 131A,A01,886838,Krysl; Petr,34,0,55,21
1746586922446,SE 154,A00,886840,Staff,28,0,50,22
1746586923473,SE 164GS,A01,886849,Staff,6,0,20,14
1746586924498,SE 167GS,A01,886853,Staff,6,0,20,14
1746586925523,SIO 25,A01,890107,Staff,19,0,30,11
1746586926548,SIO 45,A00,890109,Cook; Geoffrey W,116,0,200,84
1746586927579,SIO 109R,A00,890110,Forman; Fonna,0,16,20,20
1746586928604,SIO 187,A01,890114,Kacev; David,15,0,40,25
1746586929633,SOCI 1,A01,890431,Thorpe; Charles Robert,14,0,30,16
1746586929633,SOCI 1,A02,890518,Thorpe; Charles Robert,30,0,30,0
1746586930659,SOCI 2,A01,957978,Staff,25,0,25,0
1746586930659,SOCI 2,A02,957979,Staff,23,0,25,2
1746586931689,SOCI 20,A01,890523,Calderon-Zaks; Michael Aar,21,0,30,9
1746586931689,SOCI 20,A02,890526,Calderon-Zaks; Michael Aar,29,0,30,1
1746586932720,SOCI 30,A01,890533,Pardo Guerra; Juan Pablo,37,0,40,3
1746586933748,SOCI 40,A01,890535,Staff,27,0,45,18
1746586934775,SOCI 104Q,A00,890559,Staff,18,0,30,12
1746586935801,SOCI 106,A00,890560,Arnal; Maud Marie Leonie,20,0,30,10
1746586936827,SOCI 110,A00,890567,Holkenbrink-Monk; Charlene,19,0,30,11
1746586937853,SOCI 112,A00,890568,Victoria Torres; Pablo,2,0,55,53
1746586938883,SOCI 115,A00,890597,Arnal; Maud Marie Leonie,28,0,45,17
1746586940940,SOCI 121,A00,890604,Pardo Guerra; Juan Pablo,38,0,45,7
1746586941965,SOCI 126,A01,890608,Staff,8,0,10,2
1746586942992,SOCI 127,A00,890609,Staff,18,0,30,12
1746586944017,SOCI 131,A00,890610,Thorpe; Charles Robert,37,0,45,8
1746586945042,SOCI 135,A00,890615,Payne; Christine Anna,13,0,45,32
1746586946069,SOCI 139,A00,890620,Staff,38,0,45,7
1746586947098,SOCI 148E,A00,890622,Calderon-Zaks; Michael Aar,36,0,45,9
1746586948124,SOCI 150,A00,890623,Kohler; Kristopher M.,31,0,45,14
1746586949154,SOCI 157,A00,890625,Jules-Rosette; Bennetta W.,18,0,20,2
1746586950179,SOCI 160,A00,890627,Payne; Christine Anna,21,0,45,24
1746586951204,SYN 1,A00,886855,Fish; Gwendolyn Anne,0,1,0,0
1746586951204,SYN 1,B00,906086,Fish; Gwendolyn Anne,0,2,0,2
1746586952234,SYN 2R,A00,886860,Staff,0,17,15,15
1746586952234,SYN 2R,B00,906106,Atkinson; Arthur Laird,0,16,15,15
1746586953266,SYN 100,A01,886866,Browne; Emily,0,28,20,20
1746586953266,SYN 100,B01,906128,Rock; Martin,0,4,20,20
1746586953266,SYN 100,C01,906140,Deavenport; James Cary,0,4,20,20
1746586953266,SYN 100,D01,907816,Deavenport; James Cary,0,5,20,20
1746586954292,TDAC 1,A00,890286,Walsh; Kim C.,7,0,20,13
1746586955316,TDAC 101,A00,890296,Basso; Beatrice,15,0,20,5
1746586956342,TDDE 131,A00,890297,Staff,47,0,50,3
1746586957368,TDDM 1,A00,890287,Weinberg; Sadie,25,0,30,5
1746586958397,TDGE 11,A00,890288,Fulton; Julia,138,0,200,62
1746586958397,TDGE 11,B00,890289,Castro; Robert Jess,185,0,200,15
1746586959425,TDGE 25,B00,957359,Walsh; Kim C.,5,0,20,15
1746586960454,TDGE 40,A01,890292,Power; Jade Yukana,27,0,30,3
1746586961479,TDGE 124,A00,890298,Havis; Allan,0,1,50,50
1746586962507,TDGE 131R,A00,890299,Burelle; Julie Sara Veronique,15,0,42,27
1746586963534,TDHT 101,A00,890300,Staff,10,0,20,10
1746586964564,TDHT 109,A01,890302,Anderson; Mysia Anyse,31,0,40,9
1746586965589,TDMV 1,A00,890293,Arcidiacono; Kristin,18,0,30,12
1746586966614,TDMV 2,A00,890294,Weinberg; Sadie,23,0,30,7
1746586967639,TDMV 3,A00,957878,Arcidiacono; Kristin,28,0,30,2
1746586969690,TDMV 138,A00,890304,Jun; Grace Shin Hae,25,0,40,15
1746586970717,TDMV 140,A00,890305,Corrales; Joseph Bernales,25,0,30,5
1746586971743,TDMV 142,A00,890307,Caligagan; Tony,32,0,40,8
1746586972769,TDMV 144,A00,890308,Camaya; Michelle Ann,25,0,30,5
1746586973793,TDPW 1,A00,890295,Stein; Deborah Isobel,3,0,20,17
1746586974818,USP 2,A01,890272,Lerner; Amy M,7,0,20,13
1746586975848,USP 3,A01,890274,Staff,12,0,30,18
1746586976874,USP 15,A01,890276,Sun; Feiyang,16,0,30,14
1746586977901,USP 25,A00,890277,Shenkman; Michael Thomas,18,0,25,7
1746586978930,USP 138,A00,890278,Staff,13,0,25,12
1746586979960,USP 143,A00,890279,Staff,22,0,70,48
1746586980988,USP 144,A00,890280,Chowdhury; Muhammed Zohir,16,0,30,14
1746586982013,USP 150,A00,890281,Boomhower; Matthew Charles,4,0,30,26
1746586983039,USP 151,A00,890282,Staff,16,0,20,4
1746586984065,USP 162,A00,890283,Andrews; Abigail Leslie,16,0,20,4
1746586985090,USP 168,A00,920477,Kwak; Nancy,0,0,5,5
1746586986114,USP 181,A00,890284,Staff,3,0,20,17
1746586987139,USP 191A,A00,890285,Staff,12,0,20,8
1746586988166,VIS 101,A00,886512,Staff,26,0,75,49
1746586989190,VIS 103,A00,886513,Cruz; Edwin Teddy,61,0,75,14
1746586990219,VIS 108,A00,886514,Staff,3,0,15,12
1746586991248,VIS 127P,A00,886515,Shen; Kuiyi,79,0,146,67
1746586992277,VIS 149,A00,886516,Yoldas; Pinar,0,0,15,15
1746586993305,VIS 164,A00,886526,Erdmann; Dean,19,0,22,3
1746586994331,VIS 194S,A00,886527,Staff,61,0,75,14
1746586995360,WCWP 10A,C00,886484,Martiniuk; Jill,12,0,15,3
1746586996386,WCWP 10B,A00,886490,Uriarte; Emma,0,0,15,15
1746586996386,WCWP 10B,B00,886491,Dhir; Simrita,8,0,15,7
1746586996386,WCWP 10B,C00,886492,Ornelas; Tricia,0,0,15,15
1746586997411,WCWP 100,A00,886494,Young; Mark T,0,6,15,15
1746586999529,AAS 10,A01,886199,Childs; Dennis R.,0,3,0,0
1746587000554,ANAR 104,A01,886940,Shtienberg; Gilad,27,0,30,3
1746587001583,ANAR 120,A00,886953,Staff,13,0,20,7
1746587002608,ANBI 148,A01,886955,Wilder; Linnea Lorene,30,0,40,10
1746587004660,ANSC 122,A00,886957,Staff,24,0,30,6
1746587005684,ANSC 150,A00,886958,Sloane; Julia Kathryn,2,0,15,13
1746587006711,ANSC 156,A00,886959,Jenkins; Janis A.,0,1,15,15
1746587007737,ANSC 180,A00,886960,Staff,11,0,17,6
1746587008767,ANSC 188,A00,886961,Jassal; Aftab,9,0,25,16
1746587009795,ANSC 190,A00,886962,Jassal; Aftab,14,0,25,11
1746587010819,ANSC 191,A00,886963,Staff,18,0,20,2
1746587011847,ANTH 3,A01,891689,Staff,17,0,20,3
1746587012873,ANTH 5,A00,886933,Semendeferi; Ekaterini,16,0,20,4
1746587013899,ANTH 10,A00,886934,Staff,0,12,30,30
1746587014923,ANTH 21,A01,886936,Staff,41,0,60,19
1746587015947,ANTH 23,A01,886938,Staff,92,0,100,8
1746587016979,ANTH 105,A00,886964,Stewart; Alexander B,84,0,100,16
1746587018003,ANTH 108,A00,886965,Pedersen; David,9,0,20,11
1746587019037,AWP 10,001,886147,Staff,0,0,0,0
1746587019037,AWP 10,002,886148,Staff,0,0,0,0
1746587019037,AWP 10,003,886149,Staff,0,0,0,0
1746587019037,AWP 10,004,886150,Staff,0,0,0,0
1746587019037,AWP 10,005,886151,Staff,0,0,0,0
1746587019037,AWP 10,006,886152,Staff,0,0,0,0
1746587019037,AWP 10,007,886153,Staff,0,0,0,0
1746587019037,AWP 10,008,886154,Staff,0,0,0,0
1746587019037,AWP 10,009,886155,Staff,0,0,0,0
1746587019037,AWP 10,010,886156,Staff,0,0,0,0
1746587019037,AWP 10,011,886158,Staff,0,0,0,0
1746587019037,AWP 10,012,886160,Staff,0,0,0,0
1746587019037,AWP 10,013,886161,Staff,0,0,0,0
1746587019037,AWP 10,014,886162,Staff,0,0,0,0
1746587019037,AWP 10,015,886163,Staff,0,0,0,0
1746587019037,AWP 10,016,886164,Staff,0,0,0,0
1746587019037,AWP 10,017,886165,Staff,0,0,0,0
1746587019037,AWP 10,018,886166,Staff,0,0,0,0
1746587019037,AWP 10,019,886168,Staff,0,0,0,0
1746587019037,AWP 10,020,886170,Staff,0,0,0,0
1746587019037,AWP 10,021,886172,Staff,0,0,0,0
1746587020063,AWP 10R,001,886173,Staff,0,1,0,0
1746587020063,AWP 10R,002,886174,Staff,0,1,0,0
1746587020063,AWP 10R,003,886175,Staff,0,0,0,0
1746587020063,AWP 10R,004,886176,Staff,0,0,0,0
1746587020063,AWP 10R,005,886177,Staff,0,0,0,0
1746587020063,AWP 10R,006,886178,Staff,0,0,0,0
1746587020063,AWP 10R,007,886179,Staff,0,0,0,0
1746587020063,AWP 10R,008,886181,Staff,0,0,0,0
1746587020063,AWP 10R,009,886182,Staff,0,0,0,0
1746587020063,AWP 10R,010,886183,Staff,0,0,0,0
1746587020063,AWP 10R,011,886184,Staff,0,0,0,0
1746587020063,AWP 10R,012,886185,Staff,0,0,0,0
1746587020063,AWP 10R,013,886186,Staff,0,0,0,0
1746587020063,AWP 10R,014,886187,Staff,0,0,0,0
1746587020063,AWP 10R,015,886188,Staff,0,0,0,0
1746587020063,AWP 10R,016,886189,Staff,0,0,0,0
1746587020063,AWP 10R,017,960532,Staff,0,0,0,0
1746587020063,AWP 10R,018,960533,Staff,0,0,0,0
1746587020063,AWP 10R,019,960534,Staff,0,0,0,0
1746587020063,AWP 10R,020,960538,Staff,0,0,0,0
1746587020063,AWP 10R,021,960540,Staff,0,0,0,0
1746587020063,AWP 10R,022,960541,Staff,0,0,0,0
1746587020063,AWP 10R,023,960542,Staff,0,0,0,0
1746587020063,AWP 10R,024,960544,Staff,0,0,0,0
1746587020063,AWP 10R,025,960545,Staff,0,0,0,0
1746587020063,AWP 10R,026,960548,Staff,0,0,0,0
1746587021088,AWP 102R,A00,886190,Staff,0,0,0,0
1746587021088,AWP 102R,B00,886191,Staff,0,0,0,0
1746587022114,BENG 100,A01,886193,Staff,17,0,30,13
1746587023139,BENG 122A,A01,886195,Hasty; Jeff M,13,0,30,17
1746587024168,BENG 166A,A00,886196,Sah; Robert Lie-Yuan,0,3,30,30
1746587025194,BENG 190,A00,958050,Khojah; Reem I,17,0,25,8
1746587026220,BIBC 102,A01,894320,Staff,0,0,46,46
1746587026220,BIBC 102,A02,894321,Staff,0,0,46,46
1746587026220,BIBC 102,A03,894344,Staff,6,0,46,40
1746587026220,BIBC 102,A04,894345,Staff,27,0,47,20
1746587027246,BICD 100R,A01,894365,Smith; Laurie,1,3,58,57
1746587027246,BICD 100R,A02,894366,Smith; Laurie,1,5,58,57
1746587027246,BICD 100R,A03,894367,Smith; Laurie,0,0,59,59
1746587027246,BICD 100R,A04,959869,Smith; Laurie,40,0,59,19
1746587028270,BICD 136,A01,894383,Gustafson-Brown; Cindy,14,0,50,36
1746587029297,BIEB 102,A01,894494,Butler; Shannon Rhey,51,0,130,79
1746587031349,BIEB 150,A01,894617,Wills; Christopher,3,0,20,17
1746587031349,BIEB 150,A02,894631,Wills; Christopher,3,0,20,17
1746587031349,BIEB 150,A03,894937,Wills; Christopher,3,0,20,17
1746587031349,BIEB 150,A04,894946,Wills; Christopher,5,0,20,15
1746587032373,BIEB 194,A00,906141,Kurle; Carolyn M.,5,0,20,15
1746587033399,BILD 1,A01,894154,Staff,3,0,19,16
1746587033399,BILD 1,A02,894155,Staff,14,0,19,5
1746587033399,BILD 1,A03,894160,Staff,13,0,19,6
1746587033399,BILD 1,A04,894161,Staff,15,0,18,3
1746587034427,BILD 2,A01,894168,Staff,0,0,50,50
1746587034427,BILD 2,A02,894169,Staff,0,0,50,50
1746587034427,BILD 2,A03,894179,Staff,0,0,50,50
1746587034427,BILD 2,A04,894203,Staff,23,0,50,27
1746587035452,BILD 3,A01,894213,Staff,23,0,31,8
1746587035452,BILD 3,A02,894214,Staff,26,0,31,5
1746587035452,BILD 3,A03,894235,Staff,28,0,31,3
1746587035452,BILD 3,A04,894236,Staff,28,0,32,4
1746587036478,BILD 4,A01,894253,Reuther; Keefe,5,0,24,19
1746587036478,BILD 4,A02,894258,Reuther; Keefe,16,0,24,8
1746587037509,BILD 5,A01,894276,Reuther; Keefe,34,0,50,16
1746587037509,BILD 5,A02,894277,Reuther; Keefe,45,0,50,5
1746587037509,BILD 5,A03,894290,Reuther; Keefe,44,0,50,6
1746587037509,BILD 5,A04,894291,Reuther; Keefe,48,0,50,2
1746587038537,BILD 24,A01,894297,Pirino; Giorgia,40,0,60,20
1746587039564,BIMM 100,B01,958915,Staff,71,0,100,29
1746587040591,BIMM 101,A01,895017,McDonnell; Lisa Marie,0,5,24,24
1746587040591,BIMM 101,A02,895018,McDonnell; Lisa Marie,0,5,24,24
1746587040591,BIMM 101,B01,895020,McDonnell; Lisa Marie,0,6,24,24
1746587040591,BIMM 101,B02,895021,McDonnell; Lisa Marie,0,4,24,24
1746587041617,BIMM 110,A01,895023,Staff,1,0,25,24
1746587041617,BIMM 110,A02,895024,Staff,9,0,25,16
1746587041617,BIMM 110,A03,895025,Staff,18,0,25,7
1746587041617,BIMM 110,A04,895031,Staff,20,0,25,5
1746587042651,BIMM 120,A01,895114,Gustafson-Brown; Cindy,14,0,28,14
1746587042651,BIMM 120,A02,895126,Gustafson-Brown; Cindy,21,0,27,6
1746587043676,BIPN 100,A01,895130,Yang; Mingyu,0,0,38,38
1746587043676,BIPN 100,A02,895131,Yang; Mingyu,31,0,38,7
1746587043676,BIPN 100,A03,895132,Yang; Mingyu,32,0,38,6
1746587043676,BIPN 100,A04,895133,Yang; Mingyu,27,0,36,9
1746587044702,BIPN 120,A01,895135,Cooke; James Edward,0,3,13,13
1746587044702,BIPN 120,A02,895136,Cooke; James Edward,0,1,13,13
1746587044702,BIPN 120,A03,895137,Cooke; James Edward,0,3,13,13
1746587044702,BIPN 120,A04,895156,Cooke; James Edward,0,2,11,11
1746587045728,BIPN 134,A01,895235,Cooke; James Edward,0,2,25,25
1746587045728,BIPN 134,A02,895237,Cooke; James Edward,0,0,25,25
1746587045728,BIPN 134,A03,895240,Cooke; James Edward,3,0,25,22
1746587045728,BIPN 134,A04,895270,Cooke; James Edward,20,0,25,5
1746587046752,BIPN 189,A00,892103,Staff,0,14,14,14
1746587048810,BISP 194,A00,958008,Staff,0,2,0,0
1746587049835,CAT 124,A01,922009,Staff,0,5,20,20
1746587050864,CAT 125R,A00,886390,Morales; Celeste Georgianna,0,2,20,20
1746587050864,CAT 125R,B00,886391,Irwin; Matthew Joseph,0,4,20,20
1746587050864,CAT 125R,C00,886392,Smith; Lauryn Alissa,0,2,20,20
1746587050864,CAT 125R,D00,886393,Vanderschuit; Maya Alysia,0,3,20,20
1746587050864,CAT 125R,E00,886394,Marchisotto; Jennifer Anne,0,3,20,20
1746587051893,CENG 15,A01,886218,Drews; Aaron,3,0,8,5
1746587052918,CENG 113,A00,886219,Opatkiewicz; Justin Paul,15,0,25,10
1746587053944,CGS 101,A00,887044,Staff,7,0,20,13
1746587054970,CGS 105,A01,887046,Staff,14,0,25,11
1746587055995,CGS 112,A00,887047,Cuong; Marisol,12,0,15,3
1746587057020,CGS 113,A00,887048,Staff,23,0,30,7
1746587058045,CGS 120,A00,887049,Staff,10,0,17,7
1746587059075,CHEM 6A,A01,886336,Lam; Tin Yiu,38,0,50,12
1746587059075,CHEM 6A,A02,886338,Lam; Tin Yiu,37,0,50,13
1746587060103,CHEM 6B,A01,886341,Hopkins; Patrycja Anna,16,0,50,34
1746587060103,CHEM 6B,A02,886343,Hopkins; Patrycja Anna,42,0,50,8
1746587061130,CHEM 6C,A01,886346,Albizati; Kim F.,0,2,50,50
1746587061130,CHEM 6C,A02,886348,Albizati; Kim F.,24,0,50,26
1746587062160,CHEM 40A,A01,886352,Klosterman; Jeremy K,65,0,100,35
1746587063187,CHEM 40B,A01,886356,Klosterman; Jeremy K,0,24,100,100
1746587064213,CHEM 41B,A01,886360,Theodorakis; Emmanuel,25,0,50,25
1746587064213,CHEM 41B,A02,886362,Theodorakis; Emmanuel,47,0,50,3
1746587065238,CHIN 165A,A00,886382,Xu; Li,18,0,20,2
1746587066268,CLAS 120,A00,886387,Myerston Santana; Jacobo,33,0,40,7
1746587067297,COGS 9,A01,886967,Shannon; Kyle Michael,42,0,60,18
1746587068322,COGS 11,A01,886969,Staff,9,0,30,21
1746587069351,COGS 14A,A01,886971,Staff,6,0,60,54
1746587070376,COGS 14B,A01,886973,Hoffman; Drew Ellen,4,0,60,56
1746587071404,COGS 18,A01,886975,Morgan; Eric,34,0,60,26
1746587072431,COGS 20,A01,886977,Staff,2,0,8,6
1746587072431,COGS 20,A02,886978,Staff,4,0,7,3
1746587073455,COGS 100,A01,907783,Staff,1,2,30,29
1746587074480,COGS 101B,A01,886980,Staff,0,4,48,48
1746587075507,COGS 101C,A01,886982,Delgado; Tania,0,5,44,44
1746587076536,COGS 102A,A01,886984,Johnson; Christine M.,3,0,30,27
1746587077563,COGS 118B,A01,886986,Staff,1,5,88,87
1746587078589,COGS 150,A01,886988,Bergen; Benjamin,22,0,50,28
1746587079619,COGS 153,A00,886989,Delgado; Tania,0,3,41,41
1746587080646,COGS 186,A01,886991,Staff,0,0,32,32
1746587081673,COGS 187A,A01,886993,Boyle; Mary E. T.,7,0,30,23
1746587082702,COGS 189,A00,886994,Staff,0,1,30,30
1746587083732,COMM 10,A01,886996,Staff,0,0,20,21
1746587083732,COMM 10,A02,886997,Staff,10,0,20,10
1746587083732,COMM 10,A03,959845,Staff,19,0,20,1
1746587084757,COMM 20,A01,886999,Leuning; Grant Maurstad,24,0,40,16
1746587086815,COMM 100A,A01,887002,Staff,0,0,20,25
1746587086815,COMM 100A,A02,887003,Staff,6,0,20,14
1746587087840,COMM 100B,A01,887005,Staff,0,8,20,24
1746587088866,COMM 106D,A00,887006,Staff,13,0,40,27
1746587089892,COMM 110G,A00,887007,Whitworth-Smith; Andrew C,12,0,40,28
1746587090919,COMM 111B,A00,887008,Staff,31,0,40,9
1746587091944,COMM 113T,A00,887009,Abuelhiga; Soraya Jill,28,0,40,12
1746587091944,COMM 113T,B00,906733,Staff,40,0,40,0
1746587092970,COMM 145,A00,887010,Staff,12,0,40,28
1746587093997,COMM 146,A00,887054,Staff,31,0,40,9
1746587095023,COMM 190,A00,887012,Staff,8,0,23,15
1746587096055,CSE 8A,A50,887015,Cao; Yingjun,57,0,85,28
1746587097084,CSE 11,A01,887017,Cao; Yingjun,12,0,70,58
1746587098112,CSE 20,A01,887019,Staff,30,0,50,20
1746587099155,CSE 21,A01,887021,Staff,78,0,100,22
1746587099155,CSE 21,B01,892583,Braun; Oliver,45,0,50,5
1746587100185,CSE 30,A01,887025,Eldon; John,142,0,200,58
1746587101214,CSE 100,A01,887027,Staff,26,0,50,24
1746587101214,CSE 100,A02,887028,Staff,42,0,50,8
1746587102239,CSE 101,A01,887030,Braun; Oliver,74,0,100,26
1746587102239,CSE 101,B01,887032,Jones; Miles E,0,3,50,50
1746587102239,CSE 101,B02,887033,Jones; Miles E,0,2,50,50
1746587103267,CSE 105,A01,908084,Jones; Miles E,32,0,50,18
1746587103267,CSE 105,A02,908087,Jones; Miles E,31,0,50,19
1746587104292,CSE 135,A01,887035,Powell; Thomas Allan,0,5,50,50
1746587105317,CSE 142,A01,887037,Staff,8,0,60,52
1746587106344,CSE 142L,A01,887039,Staff,34,0,60,26
1746587107373,CSE 151A,A01,887041,Solares; Edwin A,47,0,100,53
1746587108402,CSE 175,A01,887043,Kumar; Rakesh,30,0,30,0
1746587109432,CSS 1,A01,886389,Staff,1,2,40,39
1746587110461,DSC 30,A01,908097,Liao; Soohyun Nam,47,0,75,28
1746587111488,DSC 40A,A01,908099,Shannon; Kyle Michael,30,0,50,20
1746587112541,DSC 40B,A01,908112,Staff,15,0,50,35
1746587113567,DSC 80,A01,908116,Staff,19,0,60,41
1746587114594,DSC 197,001,956863,Eldridge; Justin Matthew,9999,0,9999,0
1746587115628,ECE 5,A01,886400,Morris; Karcher William,1,0,6,5
1746587115628,ECE 5,A02,886401,Morris; Karcher William,3,0,6,3
1746587116652,ECE 148,A01,886403,Silberman; Jack,0,14,14,14
1746587117677,ECON 1,A01,887265,Crane; Meredith Helen,11,0,70,59
1746587117677,ECON 1,B01,887268,Staff,42,0,50,8
1746587118701,ECON 2,A01,887273,Crane; Meredith Helen,54,0,70,16
1746587119727,ECON 3,A01,887279,Rondina; Giacomo,31,0,70,39
1746587120753,ECON 4,A01,887282,Anderson; John Charles,0,2,10,10
1746587121784,ECON 5,A01,887285,Staff,34,0,45,11
1746587121784,ECON 5,B01,887292,Staff,41,0,45,4
1746587122811,ECON 100A,A01,887337,Newhouse; Herbert S,54,0,70,16
1746587122811,ECON 100A,B01,887349,Staff,45,0,50,5
1746587123842,ECON 100B,A01,887361,Du; Songzi,29,0,70,41
1746587124867,ECON 100C,A01,887445,Newhouse; Herbert S,59,0,70,11
1746587125894,ECON 105,A00,887488,Vespa; Emanuel Ignacio,23,0,35,12
1746587126919,ECON 109,A01,887506,Shishkin; Denis,28,0,35,7
1746587127949,ECON 110A,A01,887568,Alon; Titan Michael,0,3,35,35
1746587127949,ECON 110A,B01,907601,Alon; Titan Michael,20,0,35,15
1746587128973,ECON 110B,A01,887598,Levkoff; Steven B.,0,24,70,70
1746587129998,ECON 112,A00,887599,Rondina; Giacomo,19,0,35,16
1746587131022,ECON 120A,A01,887603,Dai; Yinlin,35,0,70,35
1746587132053,ECON 120C,A01,887608,Sun; Yixiao,0,1,35,35
1746587132053,ECON 120C,B01,887614,Sun; Yixiao,0,0,35,35
1746587133079,ECON 138,A00,887621,Bharadwaj; Prashant,0,21,20,20
1746587134109,ECON 144,A00,958007,Squires; Dale E,12,0,35,23
1746587135133,ECON 171,A01,907666,Staff,18,0,35,17
1746587136158,ECON 175,A00,887626,Wu; Pak Yeung,22,0,35,13
1746587137184,ECON 190,A00,887640,Vespa; Emanuel Ignacio,22,0,35,13
1746587138211,EDS 25,A01,888197,Staff,0,0,0,0
1746587138211,EDS 25,A02,888209,Staff,0,0,0,0
1746587138211,EDS 25,A03,888210,Staff,0,0,0,0
1746587138211,EDS 25,A04,888212,Staff,0,0,0,0
1746587138211,EDS 25,A05,888213,Staff,0,0,0,0
1746587138211,EDS 25,A06,888214,Staff,0,0,0,0
1746587138211,EDS 25,A07,888235,Staff,0,2,0,0
1746587138211,EDS 25,A08,888236,Staff,0,0,0,0
1746587138211,EDS 25,A09,888240,Staff,0,0,0,0
1746587138211,EDS 25,A10,888244,Staff,0,0,0,0
1746587138211,EDS 25,B01,888273,Staff,0,0,0,0
1746587138211,EDS 25,B02,888285,Staff,0,0,0,0
1746587138211,EDS 25,B03,888423,Staff,0,0,0,1
1746587138211,EDS 25,B04,888432,Staff,0,0,0,0
1746587138211,EDS 25,B05,888433,Staff,0,0,0,0
1746587138211,EDS 25,B06,888467,Staff,0,0,0,0
1746587138211,EDS 25,B07,888468,Staff,0,0,0,0
1746587138211,EDS 25,B08,888479,Staff,0,0,0,0
1746587138211,EDS 25,B09,888484,Staff,0,0,0,0
1746587138211,EDS 25,B10,888487,Staff,0,0,0,0
1746587139235,EDS 38,A01,907700,Choi; Bailey Miyeon,30,0,30,0
1746587140259,EDS 112,A01,888601,Chapman; Thandeka K,12,0,40,28
1746587141288,EDS 115,A00,888697,Mendez; Kathrina Mendoza,10,0,30,20
1746587142315,EDS 116,A01,888893,Staff,34,0,40,6
1746587144365,EDS 124AR,A00,889133,Staff,29,0,50,21
1746587144365,EDS 124AR,B00,907471,Simon; Elizabeth A,37,0,50,13
1746587145390,EDS 124BR,A00,889134,Simon; Elizabeth A,44,0,100,56
1746587146415,EDS 125,A00,889135,Staff,25,0,30,5
1746587147440,EDS 126,A01,889138,Staff,35,0,40,5
1746587148468,EDS 164R,A01,889142,Wishard Guerra; Alison G.,32,0,50,18
1746587149494,ENG 30,A01,886396,Staff,0,0,0,0
1746587149494,ENG 30,B01,886398,Staff,0,0,0,0
1746587150520,ENVR 102,A00,906150,Montejo; Carolina,23,0,25,2
1746587151550,ETHN 103A,A00,887236,Man; Simeon S,0,3,0,0
1746587152581,ETHN 113,A00,887239,Staff,16,0,30,14
1746587153610,ETHN 116,A00,887240,Staff,16,0,25,9
1746587154634,ETHN 117,A00,887241,Choi; Esther Min,28,0,30,2
1746587155661,ETHN 118,A00,887243,Staff,24,0,30,6
1746587156687,ETHN 127,A00,887248,Cuong; Marisol,11,0,15,4
1746587157711,ETHN 139,A00,887250,Staff,7,0,10,3
1746587158738,ETHN 142,A00,887252,Staff,10,0,30,20
1746587159766,ETHN 161,A00,887253,Browne; Errol Tsekani,24,0,30,6
1746587160794,ETHN 163FR,A00,887255,Burelle; Julie Sara Veronique,0,0,5,5
1746587161821,GLBH 20,A00,889149,Elwardani; Nile Regina,8,0,42,34
1746587163878,GLBH 111,A01,889152,Burgos; Jose L.,17,0,17,0
1746587164904,GLBH 150,A00,889181,Sloane; Julia Kathryn,0,5,15,15
1746587166962,HDS 60,A01,886406,Warstadt; Melissa Fawn,73,0,80,7
1746587167990,HIAF 111,A00,889324,Gyamfi; Bright,25,0,32,7
1746587169015,HIEA 131,A00,889328,Staff,15,0,32,17
1746587170044,HIEA 144,A00,889333,Henry; Todd A.,26,0,32,6
1746587171072,HIEA 154,A00,889336,Henry; Todd A.,24,0,32,8
1746587172098,HIEU 106,A00,889339,Staff,22,0,32,10
1746587174154,HIEU 114,A00,889340,Staff,4,0,32,28
1746587175180,HIEU 135GS,A00,889342,Patterson; Patrick H.,0,0,1,24
1746587176208,HIEU 137,A00,889343,Edington; Claire Ellen,10,0,25,15
1746587177235,HIEU 148,A00,889345,Staff,14,0,32,18
1746587178260,HIEU 154,A00,889346,Biess; Frank Peter,21,0,32,11
1746587179285,HILA 102,A00,889351,Staff,12,0,32,20
1746587180310,HILD 2A,A01,889221,Lewandoski; Julia Mavis,2,10,32,30
1746587181339,HILD 7B,A01,889225,Man; Simeon S,0,12,32,32
1746587182362,HILD 7C,A01,889288,Alvarez; Luis A,0,14,32,32
1746587183413,HILD 30,A01,889323,Staff,0,5,32,32
1746587185462,HISC 119,A00,889383,Golan; Tal,19,0,32,13
1746587186488,HIUS 103,A00,889384,Man; Simeon S,0,0,32,32
1746587187515,HIUS 117,A00,919797,Kwak; Nancy,19,0,32,13
1746587188541,HIUS 142A,A00,919788,Staff,22,0,32,10
1746587190592,HIUS 149,A00,889386,Gyamfi; Bright,26,0,32,6
1746587191616,HIUS 155,A00,889387,Alvarez; Luis A,15,0,32,17
1746587192643,HUM 3,A01,886499,Caldwell; Michael Alan,19,0,50,31
1746587193673,HUM 3GS,A00,886500,Rodriguez; Bretton Sigfred,0,0,0,28
1746587194702,HUM 3R,A01,886502,Markman; Kristina,0,36,50,50
1746587195734,HUM 4,A01,886504,Crum; Matthew Stephen,23,0,50,27
1746587195734,HUM 4,B01,886506,West; Geoffrey Scott,17,0,50,33
1746587196757,HUM 4GS,A00,886507,Staff,0,0,0,19
1746587197785,HUM 5,A01,886509,Staff,32,0,50,18
1746587198809,HUM 5R,A01,886511,Zavodny; Tatiana Sophia,0,39,50,50
1746587199836,JAPN 180,A00,886407,Staff,16,0,40,24
1746587200862,LATI 50,A01,886409,Martin-Cabrera; Luis,3,0,22,19
1746587200862,LATI 50,A02,886410,Martin-Cabrera; Luis,19,0,22,3
1746587200862,LATI 50,A03,886411,Martin-Cabrera; Luis,21,0,22,1
1746587200862,LATI 50,A04,886412,Martin-Cabrera; Luis,8,0,22,14
1746587201887,LAWS 101,A00,907664,Staff,28,0,60,32
1746587202915,LIAB 1A,A00,889388,Saab; Dima,17,0,20,3
1746587203940,LIAB 1AX,A00,889389,El Cheddadi; Youniss,18,0,20,2
1746587204965,LIFR 1C,A00,889391,Van Moer; Vinciane G,8,0,20,12
1746587205989,LIFR 1CX,A00,889392,Van Moer; Vinciane G,7,0,20,13
1746587207018,LIFR 1D,A00,889393,Van Moer; Vinciane G,7,0,20,13
1746587208045,LIFR 1DX,A00,889394,Van Moer; Vinciane G,8,0,20,12
1746587209073,LIGN 7,A00,886923,Staff,24,0,50,26
1746587210103,LIGN 17,A00,886924,Kehler; Andrew Scott,125,0,150,25
1746587211128,LTAM 110,A00,889395,Staff,15,0,30,15
1746587212157,LTAM 110GS,A00,958010,Rodriguez; Bretton Sigfred,0,0,0,28
1746587213183,LTCH 101,A00,889397,Staff,23,0,25,2
1746587214210,LTCS 130,A00,889398,Staff,23,0,25,2
1746587215235,LTEA 138,A00,889399,Staff,24,0,40,16
1746587216261,LTEN 149,A00,889400,Wesling; Megan E.,0,3,25,25
1746587217288,LTEN 169,A00,889401,Staff,20,0,25,5
1746587218313,LTEN 180,A00,889402,Staff,10,0,15,5
1746587219344,LTEN 181,A00,889403,Staff,21,0,25,4
1746587220377,LTWL 100,A00,889404,Myerston Santana; Jacobo,2,0,25,23
1746587221404,LTWL 180GS,A00,889405,Staff,0,0,20,20
1746587222433,LTWL 181,A00,889406,Staff,16,0,25,9
1746587223458,LTWL 184,A00,889475,Mukherjee; Silpa,22,0,25,3
1746587224482,LTWR 102C,A00,889486,Staff,29,0,30,1
1746587225507,LTWR 115W,A00,889491,Staff,0,2,15,15
1746587226531,MAE 8,A01,886905,Staff,0,2,0,0
1746587227556,MAE 11,A00,886906,Bandaru; Prabhakar,0,7,50,50
1746587228585,MAE 20,A00,886907,Evdokimenko; Ekaterina,43,0,70,27
1746587229612,MAE 30B,A00,886909,Ghazinejad; Maziar,26,0,45,19
1746587230638,MAE 101B,A00,886910,Saintillan; David,29,0,45,16
1746587231669,MAE 105,A00,886911,Bandaru; Prabhakar,18,0,50,32
1746587232698,MAE 107,B00,958024,Staff,7,0,50,43
1746587233723,MAE 143B,A00,886913,Bewley; Thomas R,3,0,40,37
1746587234747,MAE 148,A01,886915,Silberman; Jack,0,3,14,14
1746587235778,MAE 160,A00,886916,Evdokimenko; Ekaterina,31,0,60,29
1746587236809,MATH 3C,A01,889681,Staff,0,2,30,30
1746587236809,MATH 3C,A02,960048,Staff,23,0,30,7
1746587237838,MATH 10A,A01,889760,Staff,26,0,30,4
1746587237838,MATH 10A,A02,889783,Staff,29,0,30,1
1746587238866,MATH 10B,A01,889785,Verstraete; Jacques Allan,1,0,35,34
1746587238866,MATH 10B,A02,889795,Verstraete; Jacques Allan,4,0,35,31
1746587238866,MATH 10B,B01,889797,Verstraete; Jacques Allan,3,0,35,32
1746587238866,MATH 10B,B02,889828,Verstraete; Jacques Allan,3,0,35,32
1746587239892,MATH 10C,A01,889849,Habib; Yousaf,7,0,30,23
1746587239892,MATH 10C,A02,889852,Habib; Yousaf,14,0,30,16
1746587239892,MATH 10C,A03,889853,Habib; Yousaf,22,0,30,8
1746587239892,MATH 10C,A04,889858,Habib; Yousaf,20,0,30,10
1746587239892,MATH 10C,B01,889861,Staff,1,0,30,29
1746587239892,MATH 10C,B02,889862,Staff,24,0,30,6
1746587239892,MATH 10C,B03,889863,Staff,27,0,30,3
1746587239892,MATH 10C,B04,889967,Staff,23,0,30,7
1746587240919,MATH 18,A01,889974,Staff,7,0,30,23
1746587240919,MATH 18,A02,889977,Staff,20,0,30,10
1746587240919,MATH 18,B01,889984,Hardiman; Liam,20,0,30,10
1746587240919,MATH 18,B02,889985,Hardiman; Liam,25,0,30,5
1746587241945,MATH 20A,A01,889990,Suk; Andrew Hoon,30,0,35,5
1746587242973,MATH 20B,A01,889993,Ohm; Ko Woon,21,0,30,9
1746587242973,MATH 20B,A02,889994,Ohm; Ko Woon,30,0,30,0
1746587242973,MATH 20B,B01,889996,Ohm; Ko Woon,22,0,30,8
1746587242973,MATH 20B,B02,889997,Ohm; Ko Woon,23,0,30,7
1746587244005,MATH 20C,A01,889999,Hammock; Frances H,17,0,30,13
1746587244005,MATH 20C,A02,890003,Hammock; Frances H,23,0,30,7
1746587244005,MATH 20C,B01,890006,Hammock; Frances H,3,0,30,27
1746587244005,MATH 20C,B02,890007,Hammock; Frances H,12,0,30,18
1746587245032,MATH 20D,A01,890011,Cheng; Hsiao-Bing,1,1,30,29
1746587245032,MATH 20D,A02,890012,Cheng; Hsiao-Bing,14,0,30,16
1746587245032,MATH 20D,B01,890016,Cheng; Hsiao-Bing,13,0,30,17
1746587245032,MATH 20D,B02,890017,Cheng; Hsiao-Bing,13,0,30,17
1746587246061,MATH 20E,A01,890026,Harel; Guershon,1,0,30,29
1746587246061,MATH 20E,A02,890029,Harel; Guershon,22,0,30,8
1746587246061,MATH 20E,B01,890033,Harel; Guershon,7,0,30,23
1746587246061,MATH 20E,B02,890101,Harel; Guershon,21,0,30,9
1746587247092,MATH 102,A01,890104,Staff,18,0,30,12
1746587247092,MATH 102,A02,890105,Staff,27,0,30,3
1746587248121,MATH 103B,A01,890116,Salehi Golsefidy; Alireza,3,0,30,27
1746587248121,MATH 103B,B01,890118,Staff,0,3,34,34
1746587249149,MATH 109,A01,890121,Aliabadi Sr.; Mohsen,0,0,30,30
1746587249149,MATH 109,B01,890124,Upadrashta; Pranav Kumar,18,0,30,12
1746587250185,MATH 120A,A01,890126,Eggers; John Dietrich,13,0,30,17
1746587251213,MATH 142B,A01,890128,Ioana; Adrian,19,0,30,11
1746587251213,MATH 142B,A02,890129,Ioana; Adrian,12,0,30,18
1746587252241,MATH 154,A01,890174,Staff,0,1,30,30
1746587252241,MATH 154,A02,890182,Staff,0,0,30,30
1746587253268,MATH 168A,A01,890197,Dumitriu; Ioana,21,0,35,14
1746587254298,MATH 170A,A01,890240,Nie; Jiawang,1,0,30,29
1746587254298,MATH 170A,A02,890241,Nie; Jiawang,11,0,30,19
1746587254298,MATH 170A,A03,890249,Nie; Jiawang,23,0,30,7
1746587255324,MATH 170B,A01,957891,Nag; Panchali,13,0,35,22
1746587257377,MATH 181A,A01,908025,Staff,0,3,35,35
1746587257377,MATH 181A,A02,960115,Staff,26,0,35,9
1746587258404,MATH 181B,A01,959874,Staff,25,0,30,5
1746587259429,MATH 193B,A01,890265,Staff,0,4,35,35
1746587260458,MGT 4,A01,890311,Anderson; John Charles,42,0,88,46
1746587261483,MGT 5,A00,907740,Staff,13,0,98,85
1746587262512,MGT 12,A00,890312,Lindenberger; Wade Douglas,67,0,98,31
1746587263538,MGT 16,A00,957883,Staff,78,0,98,20
1746587265591,MGT 45,A00,890314,Pecore; Joseph P.,45,0,98,53
1746587266616,MGT 71,A00,890315,Staff,0,12,98,98
1746587267640,MGT 100,A00,890316,Yavorsky; Daniel Ryan,44,0,98,54
1746587268665,MGT 103,A00,890317,Ehrich; Kristine R,73,0,98,25
1746587269694,MGT 105,A00,890356,Bates; Kenneth Walter,0,8,98,98
1746587270720,MGT 112,A00,890360,Ehrich; Kristine R,55,0,98,43
1746587271746,MGT 127R,A00,907732,Zhu; Kevin Xiaoguo,23,0,98,75
1746587272774,MGT 131B,A00,890361,Anderson; John Charles,59,0,98,39
1746587273799,MGT 137,A00,890362,Lindenberger; Wade Douglas,65,0,98,33
1746587274824,MGT 160,A00,890369,Johnson; Erik Barry,9,0,98,89
1746587276900,MGT 164,A00,890372,Zimmermann; Carsten,0,40,98,98
1746587277927,MGT 180,A00,890374,Bliss; Barbara Ann,12,0,98,86
1746587278953,MMW 15,A01,886414,Chang; Edmond Yi-Teh,0,12,28,28
1746587278953,MMW 15,A02,886415,Chang; Edmond Yi-Teh,0,8,28,28
1746587278953,MMW 15,A03,886416,Chang; Edmond Yi-Teh,0,9,28,28
1746587278953,MMW 15,A04,886417,Chang; Edmond Yi-Teh,0,8,28,28
1746587278953,MMW 15,B01,886419,Chang; Edmond Yi-Teh,0,7,28,28
1746587278953,MMW 15,B02,886420,Chang; Edmond Yi-Teh,0,8,28,28
1746587278953,MMW 15,B03,886421,Chang; Edmond Yi-Teh,0,7,28,28
1746587278953,MMW 15,B04,886422,Chang; Edmond Yi-Teh,0,8,28,28
1746587278953,MMW 15,C01,886424,Staff,0,9,28,28
1746587278953,MMW 15,C02,886425,Staff,0,8,28,28
1746587278953,MMW 15,C03,886426,Staff,0,8,28,28
1746587278953,MMW 15,C04,886427,Staff,0,8,28,28
1746587278953,MMW 15,C05,958038,Staff,0,8,28,28
1746587278953,MMW 15,C06,958039,Staff,1,8,28,27
1746587279981,MMW 15GS,A00,906910,Patterson; Patrick H.,4,0,28,24
1746587281012,MMW 122R,A01,886429,Rahimi; Babak,0,13,28,28
1746587281012,MMW 122R,A02,886430,Rahimi; Babak,0,12,28,28
1746587281012,MMW 122R,A03,958040,Rahimi; Babak,0,11,28,28
1746587282039,MUS 1A,A01,890937,Staff,2,0,25,23
1746587282039,MUS 1A,A02,891035,Staff,6,0,25,19
1746587282039,MUS 1A,C01,958912,Staff,24,0,25,1
1746587282039,MUS 1A,C02,958913,Staff,25,0,25,0
1746587284092,MUS 2AK,A00,957092,Ohnishi; Takae,15,0,15,0
1746587285118,MUS 4,A01,891044,Staff,1,0,25,24
1746587285118,MUS 4,A02,891045,Staff,23,0,25,2
1746587285118,MUS 4,B01,891048,Staff,17,0,25,8
1746587285118,MUS 4,B02,891050,Staff,25,0,25,0
1746587286142,MUS 5,A01,957506,Dubnov; Shlomo,0,0,25,25
1746587286142,MUS 5,A02,957622,Dubnov; Shlomo,13,0,25,12
1746587286142,MUS 5,A03,957623,Dubnov; Shlomo,20,0,25,5
1746587287208,MUS 6,A01,891053,Freitas Caetano; Marcelo,24,0,25,1
1746587287208,MUS 6,A02,891054,Freitas Caetano; Marcelo,23,0,25,2
1746587288232,MUS 7,A01,891081,Staff,0,0,25,25
1746587288232,MUS 7,A02,891082,Staff,3,0,25,22
1746587289261,MUS 8GS,A00,891118,Borgo; David Garcia,1,0,25,24
1746587290285,MUS 11,A01,891140,Staff,9,0,25,16
1746587290285,MUS 11,A02,891141,Staff,21,0,25,4
1746587291312,MUS 13,A01,891143,Staff,8,0,25,17
1746587291312,MUS 13,A02,891144,Staff,24,0,25,1
1746587292340,MUS 15,A01,891146,Staff,9,0,25,16
1746587292340,MUS 15,A02,891148,Staff,21,0,25,4
1746587292340,MUS 15,B01,891150,Staff,18,0,25,7
1746587292340,MUS 15,B02,891151,Staff,25,0,25,0
1746587293366,MUS 20,A01,891153,Staff,5,0,20,15
1746587293366,MUS 20,A02,891155,Staff,14,0,20,6
1746587294397,MUS 80,A00,891156,Staff,19,0,25,6
1746587294397,MUS 80,B00,891157,Staff,23,0,25,2
1746587295424,MUS 130,A00,891158,Ohnishi; Takae,35,0,35,0
1746587296451,MUS 150GS,A01,891160,Borgo; David Garcia,1,0,25,24
1746587297478,MUS 170,A01,891162,Freitas Caetano; Marcelo,20,0,25,5
1746587297478,MUS 170,A02,891164,Freitas Caetano; Marcelo,21,0,25,4
1746587298507,NANO 11,A00,886220,Vazquez Mena; Oscar,13,0,15,2
1746587299540,NANO 15,A01,886222,Drews; Aaron,4,0,7,3
1746587300569,NANO 104,A00,886224,Sirbuly; Donald,17,0,25,8
1746587301620,PH 40,A00,886528,Staff,24,0,40,16
1746587302651,PH 45,A01,886799,Staff,35,0,40,5
1746587303679,PH 110,A00,886802,Staff,0,7,40,40
1746587304708,PH 172,A00,906716,Staff,19,0,35,16
1746587305733,PH 191,A00,886803,Staff,6,0,40,34
1746587306760,PHIL 1,A00,889500,Staff,20,0,30,10
1746587307786,PHIL 10,A01,889549,Grush; Rick Scott,16,0,22,6
1746587307786,PHIL 10,A02,889551,Grush; Rick Scott,22,0,22,0
1746587308816,PHIL 28,A01,889559,Lamey; Andy M.,0,2,31,31
1746587308816,PHIL 28,A02,889561,Lamey; Andy M.,0,1,30,30
1746587308816,PHIL 28,A03,889572,Lamey; Andy M.,0,1,30,30
1746587309846,PHIL 35,A00,907839,Staff,13,0,15,2
1746587310873,PHIL 60,A00,889574,Staff,73,0,90,17
1746587311902,PHIL 101,A00,958004,Staff,12,0,15,3
1746587313955,PHIL 136,A00,889582,Fulkerson; Matthew Todd,26,0,45,19
1746587314982,PHIL 163,A01,889601,Staff,21,0,30,9
1746587314982,PHIL 163,B01,889606,Brandt; Reuven A,0,3,0,0
1746587316010,PHIL 164,A00,889610,Staff,16,0,30,14
1746587317034,PHIL 165,A00,889613,Staff,22,0,30,8
1746587318063,PHYS 1A,A00,886431,Staff,29,0,70,41
1746587319089,PHYS 1AL,001,886432,Tsai; Philbert S,1,2,30,29
1746587319089,PHYS 1AL,002,886436,Tsai; Philbert S,12,0,30,18
1746587320121,PHYS 1B,A00,886439,Staff,184,0,240,56
1746587321150,PHYS 1BL,001,886441,Tsai; Philbert S,0,4,30,30
1746587321150,PHYS 1BL,002,886444,Tsai; Philbert S,2,0,30,28
1746587322175,PHYS 1C,A00,896092,Arnold; Kam S,78,0,146,68
1746587323200,PHYS 1CL,001,886448,Tsai; Philbert S,0,0,30,30
1746587323200,PHYS 1CL,002,886449,Tsai; Philbert S,1,0,30,29
1746587323200,PHYS 1CL,003,886450,Tsai; Philbert S,16,0,30,14
1746587323200,PHYS 1CL,004,886451,Tsai; Philbert S,15,0,30,15
1746587324225,PHYS 2B,A01,886457,Staff,67,0,115,48
1746587325258,PHYS 2C,A01,886460,Shotwell; Brian,0,9,65,65
1746587326282,PHYS 2CL,A01,886467,Staff,0,4,28,28
1746587326282,PHYS 2CL,A02,886468,Staff,0,3,28,28
1746587327307,PHYS 2D,A01,886470,Staff,10,0,50,40
1746587328335,PHYS 4B,A01,886475,Grinstein; Benjamin,22,0,40,18
1746587329359,POLI 5,A00,891173,Desposato; Scott,7,0,25,18
1746587330390,POLI 5D,A01,891175,Staff,5,0,5,0
1746587330390,POLI 5D,B01,891178,Staff,5,0,5,0
1746587331415,POLI 11,A00,891179,Ferree; Karen E,2,0,35,33
1746587332443,POLI 12,A00,891180,Staff,16,0,30,14
1746587333471,POLI 27,A01,891182,Staff,12,0,75,63
1746587334496,POLI 30,A00,891183,Staff,8,0,50,42
1746587335522,POLI 100B,A00,891244,Staff,5,1,35,30
1746587336547,POLI 100I,A00,891247,Staff,7,0,30,23
1746587337577,POLI 104J,A00,891248,Nichter; Maysa,14,0,30,16
1746587338603,POLI 104U,A00,891250,Nichter; Maysa,1,0,30,29
1746587340658,POLI 110B,A00,891255,Wiens; David,19,0,25,6
1746587341682,POLI 112A,A00,891256,Wiens; David,6,0,25,19
1746587342712,POLI 114BR,A00,891261,Staff,19,0,30,11
1746587343742,POLI 117R,A00,891262,Forman; Fonna,0,6,50,50
1746587344773,POLI 118,A00,891264,Ingham; Sean,17,0,25,8
1746587345802,POLI 124A,A00,891265,Staff,18,0,20,2
1746587346826,POLI 125D,A00,891266,Nichter; Simeon C,2,0,25,23
1746587347864,POLI 126,A00,891268,Nichter; Simeon C,7,0,25,18
1746587348892,POLI 126AA,A00,891272,Staff,15,0,25,10
1746587349919,POLI 130AA,A00,891273,Staff,15,0,20,5
1746587350949,POLI 134AA,A00,891274,Staff,4,0,20,16
1746587353000,POLI 138,A00,891278,Staff,21,0,25,4
1746587354030,POLI 142K,A00,891280,Staff,10,0,25,15
1746587355056,POLI 142M,A00,891281,Gartzke; Erik,16,0,30,14
1746587356085,POLI 142P,A00,891284,Staff,20,0,30,10
1746587357110,POLI 143,A00,891285,Gartzke; Erik,12,0,30,18
1746587358134,POLI 153,A00,891286,Staff,19,0,20,1
1746587360183,POLI 175,A00,891290,Staff,15,0,20,5
1746587361208,PSYC 1,A00,890674,Steiner; Eric Tomas,0,11,45,45
1746587362237,PSYC 2,A00,890676,Albright; Thomas D,20,0,35,15
1746587363264,PSYC 3,A00,890679,Staff,17,0,20,3
1746587364294,PSYC 6,A00,959858,Staff,19,0,20,1
1746587365323,PSYC 60,A01,890684,Rickard; Timothy C.,0,6,45,45
1746587366348,PSYC 70,A01,890689,Geller; Emma Harlan,6,0,30,24
1746587367375,PSYC 71,A01,959860,Staff,21,0,25,4
1746587368403,PSYC 100,A00,890690,Lacefield; Katharine I,0,50,180,180
1746587369430,PSYC 102,A00,890695,Staff,17,0,40,23
1746587370454,PSYC 105,A00,890699,Geller; Emma Harlan,70,0,100,30
1746587371478,PSYC 106,A00,890701,Gorman; Michael R.,5,0,30,25
1746587372502,PSYC 108,A00,890704,Adrian; Julia Anna,0,29,50,50
1746587373528,PSYC 118,A01,890712,Staff,11,0,30,19
1746587374556,PSYC 124,A00,890716,Chapman; Eddie Nathaniel,25,0,60,35
1746587375583,PSYC 131,A00,890717,Anagnostaras; Stephan,0,7,80,80
1746587376608,PSYC 137,A00,890719,Winkielman; Piotr,0,11,30,30
1746587377632,PSYC 144,A00,890721,Adrian; Julia Anna,0,9,45,45
1746587378657,PSYC 162,A00,890805,Staff,0,1,75,75
1746587379686,PSYC 169,A00,890810,Staff,0,15,30,30
1746587380715,PSYC 172,A00,890814,Gorman; Michael R.,9,0,30,21
1746587381740,PSYC 181,A00,890818,Anagnostaras; Stephan,7,0,200,193
1746587382770,PSYC 184,A00,959861,Staff,164,0,175,11
1746587383795,PSYC 189,A00,890823,Staff,0,2,30,30
1746587384825,PSYC 191,A00,890884,Rickard; Timothy C.,0,12,35,35
1746587385850,PSYC 193,A00,890913,Staff,19,0,30,11
1746587385850,PSYC 193,B00,890914,Chapman; Eddie Nathaniel,24,0,30,6
1746587386882,PSYC 193L,A01,890918,Lowe; Angela Beth,20,0,30,10
1746587386882,PSYC 193L,B01,890921,Hurwitz; Ethan Scott,20,0,30,10
1746587386882,PSYC 193L,C01,890928,Staff,30,0,30,0
1746587387910,RELI 149,A00,886806,Rahimi; Babak,23,0,40,17
1746587388938,SE 9,A01,886814,Staff,7,0,20,13
1746587389964,SE 101B,A01,886816,Chadha; Mayank,3,0,35,32
1746587390993,SE 110B,A00,886818,Zhu; Qiang,4,0,75,71
1746587392022,SE 125,A01,886830,Staff,10,0,30,20
1746587393052,SE 130B,A01,886835,Staff,14,0,40,26
1746587394082,SE 131A,A01,886838,Krysl; Petr,34,0,55,21
1746587395107,SE 154,A00,886840,Staff,28,0,50,22
1746587396133,SE 164GS,A01,886849,Staff,6,0,20,14
1746587397158,SE 167GS,A01,886853,Staff,6,0,20,14
1746587398186,SIO 25,A01,890107,Staff,19,0,30,11
1746587399214,SIO 45,A00,890109,Cook; Geoffrey W,116,0,200,84
1746587400241,SIO 109R,A00,890110,Forman; Fonna,0,16,20,20
1746587401265,SIO 187,A01,890114,Kacev; David,15,0,40,25
1746587402292,SOCI 1,A01,890431,Thorpe; Charles Robert,14,0,30,16
1746587402292,SOCI 1,A02,890518,Thorpe; Charles Robert,30,0,30,0
1746587403318,SOCI 2,A01,957978,Staff,25,0,25,0
1746587403318,SOCI 2,A02,957979,Staff,23,0,25,2
1746587404343,SOCI 20,A01,890523,Calderon-Zaks; Michael Aar,21,0,30,9
1746587404343,SOCI 20,A02,890526,Calderon-Zaks; Michael Aar,29,0,30,1
1746587405372,SOCI 30,A01,890533,Pardo Guerra; Juan Pablo,37,0,40,3
1746587406402,SOCI 40,A01,890535,Staff,27,0,45,18
1746587407427,SOCI 104Q,A00,890559,Staff,18,0,30,12
1746587408456,SOCI 106,A00,890560,Arnal; Maud Marie Leonie,20,0,30,10
1746587409482,SOCI 110,A00,890567,Holkenbrink-Monk; Charlene,19,0,30,11
1746587410513,SOCI 112,A00,890568,Victoria Torres; Pablo,2,0,55,53
1746587411536,SOCI 115,A00,890597,Arnal; Maud Marie Leonie,28,0,45,17
1746587413588,SOCI 121,A00,890604,Pardo Guerra; Juan Pablo,38,0,45,7
1746587414615,SOCI 126,A01,890608,Staff,8,0,10,2
1746587415642,SOCI 127,A00,890609,Staff,18,0,30,12
1746587416668,SOCI 131,A00,890610,Thorpe; Charles Robert,37,0,45,8
1746587417692,SOCI 135,A00,890615,Payne; Christine Anna,13,0,45,32
1746587418719,SOCI 139,A00,890620,Staff,38,0,45,7
1746587419748,SOCI 148E,A00,890622,Calderon-Zaks; Michael Aar,36,0,45,9
1746587420780,SOCI 150,A00,890623,Kohler; Kristopher M.,31,0,45,14
1746587421807,SOCI 157,A00,890625,Jules-Rosette; Bennetta W.,18,0,20,2
1746587422835,SOCI 160,A00,890627,Payne; Christine Anna,21,0,45,24
1746587423860,SYN 1,A00,886855,Fish; Gwendolyn Anne,0,1,0,0
1746587423860,SYN 1,B00,906086,Fish; Gwendolyn Anne,0,2,0,2
1746587424886,SYN 2R,A00,886860,Staff,0,17,15,15
1746587424886,SYN 2R,B00,906106,Atkinson; Arthur Laird,0,16,15,15
1746587425914,SYN 100,A01,886866,Browne; Emily,0,28,20,20
1746587425914,SYN 100,B01,906128,Rock; Martin,0,4,20,20
1746587425914,SYN 100,C01,906140,Deavenport; James Cary,0,4,20,20
1746587425914,SYN 100,D01,907816,Deavenport; James Cary,0,5,20,20
1746587426937,TDAC 1,A00,890286,Walsh; Kim C.,7,0,20,13
1746587427963,TDAC 101,A00,890296,Basso; Beatrice,15,0,20,5
1746587428988,TDDE 131,A00,890297,Staff,47,0,50,3
1746587430021,TDDM 1,A00,890287,Weinberg; Sadie,25,0,30,5
1746587431047,TDGE 11,A00,890288,Fulton; Julia,138,0,200,62
1746587431047,TDGE 11,B00,890289,Castro; Robert Jess,185,0,200,15
1746587432284,TDGE 25,B00,957359,Walsh; Kim C.,5,0,20,15
1746587433309,TDGE 40,A01,890292,Power; Jade Yukana,27,0,30,3
1746587434334,TDGE 124,A00,890298,Havis; Allan,0,1,50,50
1746587435360,TDGE 131R,A00,890299,Burelle; Julie Sara Veronique,15,0,42,27
1746587436387,TDHT 101,A00,890300,Staff,10,0,20,10
1746587437413,TDHT 109,A01,890302,Anderson; Mysia Anyse,31,0,40,9
1746587438440,TDMV 1,A00,890293,Arcidiacono; Kristin,18,0,30,12
1746587439464,TDMV 2,A00,890294,Weinberg; Sadie,23,0,30,7
1746587440493,TDMV 3,A00,957878,Arcidiacono; Kristin,28,0,30,2
1746587442549,TDMV 138,A00,890304,Jun; Grace Shin Hae,25,0,40,15
1746587443574,TDMV 140,A00,890305,Corrales; Joseph Bernales,25,0,30,5
1746587444602,TDMV 142,A00,890307,Caligagan; Tony,32,0,40,8
1746587445626,TDMV 144,A00,890308,Camaya; Michelle Ann,25,0,30,5
1746587446656,TDPW 1,A00,890295,Stein; Deborah Isobel,3,0,20,17
1746587447683,USP 2,A01,890272,Lerner; Amy M,7,0,20,13
1746587448708,USP 3,A01,890274,Staff,12,0,30,18
1746587449733,USP 15,A01,890276,Sun; Feiyang,16,0,30,14
1746587450759,USP 25,A00,890277,Shenkman; Michael Thomas,18,0,25,7
1746587451786,USP 138,A00,890278,Staff,13,0,25,12
1746587452812,USP 143,A00,890279,Staff,22,0,70,48
1746587453842,USP 144,A00,890280,Chowdhury; Muhammed Zohir,16,0,30,14
1746587454866,USP 150,A00,890281,Boomhower; Matthew Charles,4,0,30,26
1746587455891,USP 151,A00,890282,Staff,16,0,20,4
1746587456926,USP 162,A00,890283,Andrews; Abigail Leslie,16,0,20,4
1746587457953,USP 168,A00,920477,Kwak; Nancy,0,0,5,5
1746587458980,USP 181,A00,890284,Staff,3,0,20,17
1746587460005,USP 191A,A00,890285,Staff,12,0,20,8
1746587461034,VIS 101,A00,886512,Staff,26,0,75,49
1746587462058,VIS 103,A00,886513,Cruz; Edwin Teddy,61,0,75,14
1746587463083,VIS 108,A00,886514,Staff,3,0,15,12
1746587464108,VIS 127P,A00,886515,Shen; Kuiyi,79,0,146,67
1746587465133,VIS 149,A00,886516,Yoldas; Pinar,0,0,15,15
1746587466156,VIS 164,A00,886526,Erdmann; Dean,19,0,22,3
1746587467188,VIS 194S,A00,886527,Staff,61,0,75,14
1746587468213,WCWP 10A,C00,886484,Martiniuk; Jill,12,0,15,3
1746587469243,WCWP 10B,A00,886490,Uriarte; Emma,0,0,15,15
1746587469243,WCWP 10B,B00,886491,Dhir; Simrita,8,0,15,7
1746587469243,WCWP 10B,C00,886492,Ornelas; Tricia,0,0,15,15
1746587470272,WCWP 100,A00,886494,Young; Mark T,0,6,15,15
1746587472338,AAS 10,A01,886199,Childs; Dennis R.,0,3,0,0
1746587473366,ANAR 104,A01,886940,Shtienberg; Gilad,27,0,30,3
1746587474396,ANAR 120,A00,886953,Staff,13,0,20,7
1746587475420,ANBI 148,A01,886955,Wilder; Linnea Lorene,30,0,40,10
1746587477467,ANSC 122,A00,886957,Staff,24,0,30,6
1746587478496,ANSC 150,A00,886958,Sloane; Julia Kathryn,2,0,15,13
1746587479522,ANSC 156,A00,886959,Jenkins; Janis A.,0,1,15,15
1746587480551,ANSC 180,A00,886960,Staff,11,0,17,6
1746587481583,ANSC 188,A00,886961,Jassal; Aftab,9,0,25,16
1746587482612,ANSC 190,A00,886962,Jassal; Aftab,14,0,25,11
1746587483638,ANSC 191,A00,886963,Staff,18,0,20,2
1746587484667,ANTH 3,A01,891689,Staff,17,0,20,3
1746587485692,ANTH 5,A00,886933,Semendeferi; Ekaterini,16,0,20,4
1746587486717,ANTH 10,A00,886934,Staff,0,12,30,30
1746587487742,ANTH 21,A01,886936,Staff,41,0,60,19
1746587488769,ANTH 23,A01,886938,Staff,92,0,100,8
1746587489796,ANTH 105,A00,886964,Stewart; Alexander B,84,0,100,16
1746587490826,ANTH 108,A00,886965,Pedersen; David,9,0,20,11
1746587491855,AWP 10,001,886147,Staff,0,0,0,0
1746587491855,AWP 10,002,886148,Staff,0,0,0,0
1746587491855,AWP 10,003,886149,Staff,0,0,0,0
1746587491855,AWP 10,004,886150,Staff,0,0,0,0
1746587491855,AWP 10,005,886151,Staff,0,0,0,0
1746587491855,AWP 10,006,886152,Staff,0,0,0,0
1746587491855,AWP 10,007,886153,Staff,0,0,0,0
1746587491855,AWP 10,008,886154,Staff,0,0,0,0
1746587491855,AWP 10,009,886155,Staff,0,0,0,0
1746587491855,AWP 10,010,886156,Staff,0,0,0,0
1746587491855,AWP 10,011,886158,Staff,0,0,0,0
1746587491855,AWP 10,012,886160,Staff,0,0,0,0
1746587491855,AWP 10,013,886161,Staff,0,0,0,0
1746587491855,AWP 10,014,886162,Staff,0,0,0,0
1746587491855,AWP 10,015,886163,Staff,0,0,0,0
1746587491855,AWP 10,016,886164,Staff,0,0,0,0
1746587491855,AWP 10,017,886165,Staff,0,0,0,0
1746587491855,AWP 10,018,886166,Staff,0,0,0,0
1746587491855,AWP 10,019,886168,Staff,0,0,0,0
1746587491855,AWP 10,020,886170,Staff,0,0,0,0
1746587491855,AWP 10,021,886172,Staff,0,0,0,0
1746587492888,AWP 10R,001,886173,Staff,0,1,0,0
1746587492888,AWP 10R,002,886174,Staff,0,1,0,0
1746587492888,AWP 10R,003,886175,Staff,0,0,0,0
1746587492888,AWP 10R,004,886176,Staff,0,0,0,0
1746587492888,AWP 10R,005,886177,Staff,0,0,0,0
1746587492888,AWP 10R,006,886178,Staff,0,0,0,0
1746587492888,AWP 10R,007,886179,Staff,0,0,0,0
1746587492888,AWP 10R,008,886181,Staff,0,0,0,0
1746587492888,AWP 10R,009,886182,Staff,0,0,0,0
1746587492888,AWP 10R,010,886183,Staff,0,0,0,0
1746587492888,AWP 10R,011,886184,Staff,0,0,0,0
1746587492888,AWP 10R,012,886185,Staff,0,0,0,0
1746587492888,AWP 10R,013,886186,Staff,0,0,0,0
1746587492888,AWP 10R,014,886187,Staff,0,0,0,0
1746587492888,AWP 10R,015,886188,Staff,0,0,0,0
1746587492888,AWP 10R,016,886189,Staff,0,0,0,0
1746587492888,AWP 10R,017,960532,Staff,0,0,0,0
1746587492888,AWP 10R,018,960533,Staff,0,0,0,0
1746587492888,AWP 10R,019,960534,Staff,0,0,0,0
1746587492888,AWP 10R,020,960538,Staff,0,0,0,0
1746587492888,AWP 10R,021,960540,Staff,0,0,0,0
1746587492888,AWP 10R,022,960541,Staff,0,0,0,0
1746587492888,AWP 10R,023,960542,Staff,0,0,0,0
1746587492888,AWP 10R,024,960544,Staff,0,0,0,0
1746587492888,AWP 10R,025,960545,Staff,0,0,0,0
1746587492888,AWP 10R,026,960548,Staff,0,0,0,0
1746587493917,AWP 102R,A00,886190,Staff,0,0,0,0
1746587493917,AWP 102R,B00,886191,Staff,0,0,0,0
1746587494943,BENG 100,A01,886193,Staff,17,0,30,13
1746587495969,BENG 122A,A01,886195,Hasty; Jeff M,13,0,30,17
1746587496995,BENG 166A,A00,886196,Sah; Robert Lie-Yuan,0,3,30,30
1746587498025,BENG 190,A00,958050,Khojah; Reem I,17,0,25,8
1746587499054,BIBC 102,A01,894320,Staff,0,0,46,46
1746587499054,BIBC 102,A02,894321,Staff,0,0,46,46
1746587499054,BIBC 102,A03,894344,Staff,6,0,46,40
1746587499054,BIBC 102,A04,894345,Staff,27,0,47,20
1746587500087,BICD 100R,A01,894365,Smith; Laurie,1,3,58,57
1746587500087,BICD 100R,A02,894366,Smith; Laurie,1,5,58,57
1746587500087,BICD 100R,A03,894367,Smith; Laurie,0,0,59,59
1746587500087,BICD 100R,A04,959869,Smith; Laurie,40,0,59,19
1746587501113,BICD 136,A01,894383,Gustafson-Brown; Cindy,14,0,50,36
1746587502143,BIEB 102,A01,894494,Butler; Shannon Rhey,51,0,130,79
1746587504238,BIEB 150,A01,894617,Wills; Christopher,3,0,20,17
1746587504238,BIEB 150,A02,894631,Wills; Christopher,3,0,20,17
1746587504238,BIEB 150,A03,894937,Wills; Christopher,3,0,20,17
1746587504238,BIEB 150,A04,894946,Wills; Christopher,5,0,20,15
1746587505263,BIEB 194,A00,906141,Kurle; Carolyn M.,5,0,20,15
1746587506290,BILD 1,A01,894154,Staff,3,0,19,16
1746587506290,BILD 1,A02,894155,Staff,14,0,19,5
1746587506290,BILD 1,A03,894160,Staff,13,0,19,6
1746587506290,BILD 1,A04,894161,Staff,15,0,18,3
1746587507315,BILD 2,A01,894168,Staff,0,0,50,50
1746587507315,BILD 2,A02,894169,Staff,0,0,50,50
1746587507315,BILD 2,A03,894179,Staff,0,0,50,50
1746587507315,BILD 2,A04,894203,Staff,23,0,50,27
1746587508341,BILD 3,A01,894213,Staff,23,0,31,8
1746587508341,BILD 3,A02,894214,Staff,26,0,31,5
1746587508341,BILD 3,A03,894235,Staff,28,0,31,3
1746587508341,BILD 3,A04,894236,Staff,28,0,32,4
1746587509366,BILD 4,A01,894253,Reuther; Keefe,5,0,24,19
1746587509366,BILD 4,A02,894258,Reuther; Keefe,16,0,24,8
1746587510394,BILD 5,A01,894276,Reuther; Keefe,34,0,50,16
1746587510394,BILD 5,A02,894277,Reuther; Keefe,45,0,50,5
1746587510394,BILD 5,A03,894290,Reuther; Keefe,44,0,50,6
1746587510394,BILD 5,A04,894291,Reuther; Keefe,48,0,50,2
1746587511424,BILD 24,A01,894297,Pirino; Giorgia,40,0,60,20
1746587512453,BIMM 100,B01,958915,Staff,71,0,100,29
1746587513481,BIMM 101,A01,895017,McDonnell; Lisa Marie,0,5,24,24
1746587513481,BIMM 101,A02,895018,McDonnell; Lisa Marie,0,5,24,24
1746587513481,BIMM 101,B01,895020,McDonnell; Lisa Marie,0,6,24,24
1746587513481,BIMM 101,B02,895021,McDonnell; Lisa Marie,0,4,24,24
1746587514508,BIMM 110,A01,895023,Staff,1,0,25,24
1746587514508,BIMM 110,A02,895024,Staff,9,0,25,16
1746587514508,BIMM 110,A03,895025,Staff,18,0,25,7
1746587514508,BIMM 110,A04,895031,Staff,20,0,25,5
1746587515539,BIMM 120,A01,895114,Gustafson-Brown; Cindy,14,0,28,14
1746587515539,BIMM 120,A02,895126,Gustafson-Brown; Cindy,21,0,27,6
1746587516565,BIPN 100,A01,895130,Yang; Mingyu,0,0,38,38
1746587516565,BIPN 100,A02,895131,Yang; Mingyu,31,0,38,7
1746587516565,BIPN 100,A03,895132,Yang; Mingyu,32,0,38,6
1746587516565,BIPN 100,A04,895133,Yang; Mingyu,27,0,36,9
1746587517592,BIPN 120,A01,895135,Cooke; James Edward,0,3,13,13
1746587517592,BIPN 120,A02,895136,Cooke; James Edward,0,1,13,13
1746587517592,BIPN 120,A03,895137,Cooke; James Edward,0,3,13,13
1746587517592,BIPN 120,A04,895156,Cooke; James Edward,0,2,11,11
1746587518618,BIPN 134,A01,895235,Cooke; James Edward,0,2,25,25
1746587518618,BIPN 134,A02,895237,Cooke; James Edward,0,0,25,25
1746587518618,BIPN 134,A03,895240,Cooke; James Edward,3,0,25,22
1746587518618,BIPN 134,A04,895270,Cooke; James Edward,20,0,25,5
1746587519643,BIPN 189,A00,892103,Staff,0,14,14,14
1746587521695,BISP 194,A00,958008,Staff,0,2,0,0
1746587522720,CAT 124,A01,922009,Staff,0,5,20,20
1746587523748,CAT 125R,A00,886390,Morales; Celeste Georgianna,0,2,20,20
1746587523748,CAT 125R,B00,886391,Irwin; Matthew Joseph,0,4,20,20
1746587523748,CAT 125R,C00,886392,Smith; Lauryn Alissa,0,2,20,20
1746587523748,CAT 125R,D00,886393,Vanderschuit; Maya Alysia,0,3,20,20
1746587523748,CAT 125R,E00,886394,Marchisotto; Jennifer Anne,0,3,20,20
1746587524774,CENG 15,A01,886218,Drews; Aaron,3,0,8,5
1746587525801,CENG 113,A00,886219,Opatkiewicz; Justin Paul,15,0,25,10
1746587526829,CGS 101,A00,887044,Staff,7,0,20,13
1746587527859,CGS 105,A01,887046,Staff,14,0,25,11
1746587528887,CGS 112,A00,887047,Cuong; Marisol,12,0,15,3
1746587529913,CGS 113,A00,887048,Staff,23,0,30,7
1746587530939,CGS 120,A00,887049,Staff,10,0,17,7
1746587531968,CHEM 6A,A01,886336,Lam; Tin Yiu,38,0,50,12
1746587531968,CHEM 6A,A02,886338,Lam; Tin Yiu,37,0,50,13
1746587532993,CHEM 6B,A01,886341,Hopkins; Patrycja Anna,16,0,50,34
1746587532993,CHEM 6B,A02,886343,Hopkins; Patrycja Anna,42,0,50,8
1746587534021,CHEM 6C,A01,886346,Albizati; Kim F.,0,2,50,50
1746587534021,CHEM 6C,A02,886348,Albizati; Kim F.,24,0,50,26
1746587535047,CHEM 40A,A01,886352,Klosterman; Jeremy K,65,0,100,35
1746587536080,CHEM 40B,A01,886356,Klosterman; Jeremy K,0,24,100,100
1746587537106,CHEM 41B,A01,886360,Theodorakis; Emmanuel,25,0,50,25
1746587537106,CHEM 41B,A02,886362,Theodorakis; Emmanuel,47,0,50,3
1746587538134,CHIN 165A,A00,886382,Xu; Li,18,0,20,2
1746587539159,CLAS 120,A00,886387,Myerston Santana; Jacobo,33,0,40,7
1746587540187,COGS 9,A01,886967,Shannon; Kyle Michael,42,0,60,18
1746587541212,COGS 11,A01,886969,Staff,9,0,30,21
1746587542239,COGS 14A,A01,886971,Staff,6,0,60,54
1746587543265,COGS 14B,A01,886973,Hoffman; Drew Ellen,4,0,60,56
1746587544291,COGS 18,A01,886975,Morgan; Eric,34,0,60,26
1746587545317,COGS 20,A01,886977,Staff,2,0,8,6
1746587545317,COGS 20,A02,886978,Staff,4,0,7,3
1746587546343,COGS 100,A01,907783,Staff,1,2,30,29
1746587547368,COGS 101B,A01,886980,Staff,0,4,48,48
1746587548393,COGS 101C,A01,886982,Delgado; Tania,0,5,44,44
1746587549421,COGS 102A,A01,886984,Johnson; Christine M.,3,0,30,27
1746587550448,COGS 118B,A01,886986,Staff,1,5,88,87
1746587551472,COGS 150,A01,886988,Bergen; Benjamin,22,0,50,28
1746587552498,COGS 153,A00,886989,Delgado; Tania,0,3,41,41
1746587553524,COGS 186,A01,886991,Staff,0,0,32,32
1746587554553,COGS 187A,A01,886993,Boyle; Mary E. T.,7,0,30,23
1746587555582,COGS 189,A00,886994,Staff,0,1,30,30
1746587556610,COMM 10,A01,886996,Staff,0,0,20,21
1746587556610,COMM 10,A02,886997,Staff,10,0,20,10
1746587556610,COMM 10,A03,959845,Staff,19,0,20,1
1746587557639,COMM 20,A01,886999,Leuning; Grant Maurstad,24,0,40,16
1746587559694,COMM 100A,A01,887002,Staff,0,0,20,25
1746587559694,COMM 100A,A02,887003,Staff,6,0,20,14
1746587560722,COMM 100B,A01,887005,Staff,0,8,20,24
1746587561750,COMM 106D,A00,887006,Staff,13,0,40,27
1746587562780,COMM 110G,A00,887007,Whitworth-Smith; Andrew C,12,0,40,28
1746587563809,COMM 111B,A00,887008,Staff,31,0,40,9
1746587564834,COMM 113T,A00,887009,Abuelhiga; Soraya Jill,28,0,40,12
1746587564834,COMM 113T,B00,906733,Staff,40,0,40,0
1746587565860,COMM 145,A00,887010,Staff,12,0,40,28
1746587566885,COMM 146,A00,887054,Staff,31,0,40,9
1746587567908,COMM 190,A00,887012,Staff,8,0,23,15
1746587568934,CSE 8A,A50,887015,Cao; Yingjun,57,0,85,28
1746587569959,CSE 11,A01,887017,Cao; Yingjun,11,0,70,59
1746587570983,CSE 20,A01,887019,Staff,30,0,50,20
1746587572010,CSE 21,A01,887021,Staff,78,0,100,22
1746587572010,CSE 21,B01,892583,Braun; Oliver,45,0,50,5
1746587573040,CSE 30,A01,887025,Eldon; John,142,0,200,58
1746587574067,CSE 100,A01,887027,Staff,26,0,50,24
1746587574067,CSE 100,A02,887028,Staff,42,0,50,8
1746587575101,CSE 101,A01,887030,Braun; Oliver,74,0,100,26
1746587575101,CSE 101,B01,887032,Jones; Miles E,0,3,50,50
1746587575101,CSE 101,B02,887033,Jones; Miles E,0,2,50,50
1746587576143,CSE 105,A01,908084,Jones; Miles E,32,0,50,18
1746587576143,CSE 105,A02,908087,Jones; Miles E,31,0,50,19
1746587577174,CSE 135,A01,887035,Powell; Thomas Allan,0,5,50,50
1746587578202,CSE 142,A01,887037,Staff,8,0,60,52
1746587579233,CSE 142L,A01,887039,Staff,34,0,60,26
1746587580261,CSE 151A,A01,887041,Solares; Edwin A,47,0,100,53
1746587581292,CSE 175,A01,887043,Kumar; Rakesh,30,0,30,0
1746587582320,CSS 1,A01,886389,Staff,1,2,40,39
1746587583351,DSC 30,A01,908097,Liao; Soohyun Nam,47,0,75,28
1746587584375,DSC 40A,A01,908099,Shannon; Kyle Michael,30,0,50,20
1746587585403,DSC 40B,A01,908112,Staff,15,0,50,35
1746587586429,DSC 80,A01,908116,Staff,19,0,60,41
1746587587457,DSC 197,001,956863,Eldridge; Justin Matthew,9999,0,9999,0
1746587588485,ECE 5,A01,886400,Morris; Karcher William,1,0,6,5
1746587588485,ECE 5,A02,886401,Morris; Karcher William,3,0,6,3
1746587589512,ECE 148,A01,886403,Silberman; Jack,0,14,14,14
1746587590538,ECON 1,A01,887265,Crane; Meredith Helen,11,0,70,59
1746587590538,ECON 1,B01,887268,Staff,42,0,50,8
1746587591562,ECON 2,A01,887273,Crane; Meredith Helen,54,0,70,16
1746587592596,ECON 3,A01,887279,Rondina; Giacomo,31,0,70,39
1746587593626,ECON 4,A01,887282,Anderson; John Charles,0,2,10,10
1746587594653,ECON 5,A01,887285,Staff,34,0,45,11
1746587594653,ECON 5,B01,887292,Staff,41,0,45,4
1746587595679,ECON 100A,A01,887337,Newhouse; Herbert S,54,0,70,16
1746587595679,ECON 100A,B01,887349,Staff,45,0,50,5
1746587596708,ECON 100B,A01,887361,Du; Songzi,29,0,70,41
1746587597734,ECON 100C,A01,887445,Newhouse; Herbert S,59,0,70,11
1746587598762,ECON 105,A00,887488,Vespa; Emanuel Ignacio,23,0,35,12
1746587599792,ECON 109,A01,887506,Shishkin; Denis,28,0,35,7
1746587600838,ECON 110A,A01,887568,Alon; Titan Michael,1,3,35,34
1746587600838,ECON 110A,B01,907601,Alon; Titan Michael,20,0,35,15
1746587601865,ECON 110B,A01,887598,Levkoff; Steven B.,0,24,70,70
1746587602892,ECON 112,A00,887599,Rondina; Giacomo,19,0,35,16
1746587603919,ECON 120A,A01,887603,Dai; Yinlin,35,0,70,35
1746587604949,ECON 120C,A01,887608,Sun; Yixiao,0,1,35,35
1746587604949,ECON 120C,B01,887614,Sun; Yixiao,0,0,35,35
1746587605974,ECON 138,A00,887621,Bharadwaj; Prashant,0,21,20,20
1746587606998,ECON 144,A00,958007,Squires; Dale E,12,0,35,23
1746587608025,ECON 171,A01,907666,Staff,18,0,35,17
1746587609052,ECON 175,A00,887626,Wu; Pak Yeung,22,0,35,13
1746587610077,ECON 190,A00,887640,Vespa; Emanuel Ignacio,22,0,35,13
1746587611107,EDS 25,A01,888197,Staff,0,0,0,0
1746587611107,EDS 25,A02,888209,Staff,0,0,0,0
1746587611107,EDS 25,A03,888210,Staff,0,0,0,0
1746587611107,EDS 25,A04,888212,Staff,0,0,0,0
1746587611107,EDS 25,A05,888213,Staff,0,0,0,0
1746587611107,EDS 25,A06,888214,Staff,0,0,0,0
1746587611107,EDS 25,A07,888235,Staff,0,2,0,0
1746587611107,EDS 25,A08,888236,Staff,0,0,0,0
1746587611107,EDS 25,A09,888240,Staff,0,0,0,0
1746587611107,EDS 25,A10,888244,Staff,0,0,0,0
1746587611107,EDS 25,B01,888273,Staff,0,0,0,0
1746587611107,EDS 25,B02,888285,Staff,0,0,0,0
1746587611107,EDS 25,B03,888423,Staff,0,0,0,1
1746587611107,EDS 25,B04,888432,Staff,0,0,0,0
1746587611107,EDS 25,B05,888433,Staff,0,0,0,0
1746587611107,EDS 25,B06,888467,Staff,0,0,0,0
1746587611107,EDS 25,B07,888468,Staff,0,0,0,0
1746587611107,EDS 25,B08,888479,Staff,0,0,0,0
1746587611107,EDS 25,B09,888484,Staff,0,0,0,0
1746587611107,EDS 25,B10,888487,Staff,0,0,0,0
1746587612132,EDS 38,A01,907700,Choi; Bailey Miyeon,30,0,30,0
1746587613160,EDS 112,A01,888601,Chapman; Thandeka K,12,0,40,28
1746587614193,EDS 115,A00,888697,Mendez; Kathrina Mendoza,10,0,30,20
1746587615221,EDS 116,A01,888893,Staff,34,0,40,6
1746587617274,EDS 124AR,A00,889133,Staff,29,0,50,21
1746587617274,EDS 124AR,B00,907471,Simon; Elizabeth A,37,0,50,13
1746587618299,EDS 124BR,A00,889134,Simon; Elizabeth A,44,0,100,56
1746587619326,EDS 125,A00,889135,Staff,25,0,30,5
1746587620351,EDS 126,A01,889138,Staff,35,0,40,5
1746587621378,EDS 164R,A01,889142,Wishard Guerra; Alison G.,32,0,50,18
1746587622404,ENG 30,A01,886396,Staff,0,0,0,0
1746587622404,ENG 30,B01,886398,Staff,0,0,0,0
1746587623432,ENVR 102,A00,906150,Montejo; Carolina,23,0,25,2
1746587624460,ETHN 103A,A00,887236,Man; Simeon S,0,3,0,0
1746587625485,ETHN 113,A00,887239,Staff,16,0,30,14
1746587626510,ETHN 116,A00,887240,Staff,16,0,25,9
1746587627539,ETHN 117,A00,887241,Choi; Esther Min,28,0,30,2
1746587628566,ETHN 118,A00,887243,Staff,24,0,30,6
1746587629593,ETHN 127,A00,887248,Cuong; Marisol,11,0,15,4
1746587630619,ETHN 139,A00,887250,Staff,7,0,10,3
1746587631644,ETHN 142,A00,887252,Staff,10,0,30,20
1746587632670,ETHN 161,A00,887253,Browne; Errol Tsekani,24,0,30,6
1746587633694,ETHN 163FR,A00,887255,Burelle; Julie Sara Veronique,0,0,5,5
1746587634724,GLBH 20,A00,889149,Elwardani; Nile Regina,8,0,42,34
1746587636779,GLBH 111,A01,889152,Burgos; Jose L.,17,0,17,0
1746587637803,GLBH 150,A00,889181,Sloane; Julia Kathryn,0,5,15,15
1746587639859,HDS 60,A01,886406,Warstadt; Melissa Fawn,73,0,80,7
1746587640884,HIAF 111,A00,889324,Gyamfi; Bright,25,0,32,7
1746587641940,HIEA 131,A00,889328,Staff,15,0,32,17
1746587642965,HIEA 144,A00,889333,Henry; Todd A.,26,0,32,6
1746587643991,HIEA 154,A00,889336,Henry; Todd A.,24,0,32,8
1746587645017,HIEU 106,A00,889339,Staff,22,0,32,10
1746587647067,HIEU 114,A00,889340,Staff,4,0,32,28
1746587648092,HIEU 135GS,A00,889342,Patterson; Patrick H.,0,0,1,24
1746587649121,HIEU 137,A00,889343,Edington; Claire Ellen,10,0,25,15
1746587650146,HIEU 148,A00,889345,Staff,14,0,32,18
1746587651176,HIEU 154,A00,889346,Biess; Frank Peter,21,0,32,11
1746587652202,HILA 102,A00,889351,Staff,12,0,32,20
1746587653225,HILD 2A,A01,889221,Lewandoski; Julia Mavis,2,10,32,30
1746587654251,HILD 7B,A01,889225,Man; Simeon S,0,12,32,32
1746587655275,HILD 7C,A01,889288,Alvarez; Luis A,0,14,32,32
1746587656302,HILD 30,A01,889323,Staff,0,5,32,32
1746587658351,HISC 119,A00,889383,Golan; Tal,19,0,32,13
1746587659377,HIUS 103,A00,889384,Man; Simeon S,0,0,32,32
1746587660406,HIUS 117,A00,919797,Kwak; Nancy,18,0,32,14
1746587661430,HIUS 142A,A00,919788,Staff,22,0,32,10
1746587663483,HIUS 149,A00,889386,Gyamfi; Bright,26,0,32,6
1746587664509,HIUS 155,A00,889387,Alvarez; Luis A,15,0,32,17
1746587665535,HUM 3,A01,886499,Caldwell; Michael Alan,19,0,50,31
1746587666564,HUM 3GS,A00,886500,Rodriguez; Bretton Sigfred,0,0,0,28
1746587667589,HUM 3R,A01,886502,Markman; Kristina,0,36,50,50
1746587668615,HUM 4,A01,886504,Crum; Matthew Stephen,23,0,50,27
1746587668615,HUM 4,B01,886506,West; Geoffrey Scott,17,0,50,33
1746587669642,HUM 4GS,A00,886507,Staff,0,0,0,19
1746587670673,HUM 5,A01,886509,Staff,32,0,50,18
1746587671700,HUM 5R,A01,886511,Zavodny; Tatiana Sophia,0,39,50,50
1746587672728,JAPN 180,A00,886407,Staff,16,0,40,24
1746587673814,LATI 50,A01,886409,Martin-Cabrera; Luis,3,0,22,19
1746587673814,LATI 50,A02,886410,Martin-Cabrera; Luis,19,0,22,3
1746587673814,LATI 50,A03,886411,Martin-Cabrera; Luis,21,0,22,1
1746587673814,LATI 50,A04,886412,Martin-Cabrera; Luis,8,0,22,14
1746587674838,LAWS 101,A00,907664,Staff,28,0,60,32
1746587675864,LIAB 1A,A00,889388,Saab; Dima,17,0,20,3
1746587676893,LIAB 1AX,A00,889389,El Cheddadi; Youniss,18,0,20,2
1746587677918,LIFR 1C,A00,889391,Van Moer; Vinciane G,8,0,20,12
1746587678943,LIFR 1CX,A00,889392,Van Moer; Vinciane G,7,0,20,13
1746587679974,LIFR 1D,A00,889393,Van Moer; Vinciane G,7,0,20,13
1746587680999,LIFR 1DX,A00,889394,Van Moer; Vinciane G,8,0,20,12
1746587682024,LIGN 7,A00,886923,Staff,24,0,50,26
1746587683049,LIGN 17,A00,886924,Kehler; Andrew Scott,125,0,150,25
1746587684078,LTAM 110,A00,889395,Staff,15,0,30,15
1746587685109,LTAM 110GS,A00,958010,Rodriguez; Bretton Sigfred,0,0,0,28
1746587686133,LTCH 101,A00,889397,Staff,23,0,25,2
1746587687159,LTCS 130,A00,889398,Staff,23,0,25,2
1746587688185,LTEA 138,A00,889399,Staff,24,0,40,16
1746587689214,LTEN 149,A00,889400,Wesling; Megan E.,0,3,25,25
1746587690243,LTEN 169,A00,889401,Staff,20,0,25,5
1746587691268,LTEN 180,A00,889402,Staff,10,0,15,5
1746587692294,LTEN 181,A00,889403,Staff,21,0,25,4
1746587693323,LTWL 100,A00,889404,Myerston Santana; Jacobo,2,0,25,23
1746587694349,LTWL 180GS,A00,889405,Staff,0,0,20,20
1746587695374,LTWL 181,A00,889406,Staff,16,0,25,9
1746587696403,LTWL 184,A00,889475,Mukherjee; Silpa,22,0,25,3
1746587697428,LTWR 102C,A00,889486,Staff,29,0,30,1
1746587698456,LTWR 115W,A00,889491,Staff,0,2,15,15
1746587699481,MAE 8,A01,886905,Staff,0,2,0,0
1746587700512,MAE 11,A00,886906,Bandaru; Prabhakar,0,7,50,50
1746587701538,MAE 20,A00,886907,Evdokimenko; Ekaterina,43,0,70,27
1746587702566,MAE 30B,A00,886909,Ghazinejad; Maziar,26,0,45,19
1746587703594,MAE 101B,A00,886910,Saintillan; David,29,0,45,16
1746587704620,MAE 105,A00,886911,Bandaru; Prabhakar,18,0,50,32
1746587705645,MAE 107,B00,958024,Staff,7,0,50,43
1746587706670,MAE 143B,A00,886913,Bewley; Thomas R,3,0,40,37
1746587707700,MAE 148,A01,886915,Silberman; Jack,0,3,14,14
1746587708728,MAE 160,A00,886916,Evdokimenko; Ekaterina,31,0,60,29
1746587709755,MATH 3C,A01,889681,Staff,0,2,30,30
1746587709755,MATH 3C,A02,960048,Staff,23,0,30,7
1746587710784,MATH 10A,A01,889760,Staff,26,0,30,4
1746587710784,MATH 10A,A02,889783,Staff,29,0,30,1
1746587711810,MATH 10B,A01,889785,Verstraete; Jacques Allan,1,0,35,34
1746587711810,MATH 10B,A02,889795,Verstraete; Jacques Allan,4,0,35,31
1746587711810,MATH 10B,B01,889797,Verstraete; Jacques Allan,3,0,35,32
1746587711810,MATH 10B,B02,889828,Verstraete; Jacques Allan,3,0,35,32
1746587712841,MATH 10C,A01,889849,Habib; Yousaf,7,0,30,23
1746587712841,MATH 10C,A02,889852,Habib; Yousaf,14,0,30,16
1746587712841,MATH 10C,A03,889853,Habib; Yousaf,22,0,30,8
1746587712841,MATH 10C,A04,889858,Habib; Yousaf,20,0,30,10
1746587712841,MATH 10C,B01,889861,Staff,1,0,30,29
1746587712841,MATH 10C,B02,889862,Staff,24,0,30,6
1746587712841,MATH 10C,B03,889863,Staff,27,0,30,3
1746587712841,MATH 10C,B04,889967,Staff,23,0,30,7
1746587713867,MATH 18,A01,889974,Staff,7,0,30,23
1746587713867,MATH 18,A02,889977,Staff,20,0,30,10
1746587713867,MATH 18,B01,889984,Hardiman; Liam,20,0,30,10
1746587713867,MATH 18,B02,889985,Hardiman; Liam,25,0,30,5
1746587714896,MATH 20A,A01,889990,Suk; Andrew Hoon,30,0,35,5
1746587715924,MATH 20B,A01,889993,Ohm; Ko Woon,21,0,30,9
1746587715924,MATH 20B,A02,889994,Ohm; Ko Woon,30,0,30,0
1746587715924,MATH 20B,B01,889996,Ohm; Ko Woon,22,0,30,8
1746587715924,MATH 20B,B02,889997,Ohm; Ko Woon,23,0,30,7
1746587716955,MATH 20C,A01,889999,Hammock; Frances H,17,0,30,13
1746587716955,MATH 20C,A02,890003,Hammock; Frances H,23,0,30,7
1746587716955,MATH 20C,B01,890006,Hammock; Frances H,3,0,30,27
1746587716955,MATH 20C,B02,890007,Hammock; Frances H,12,0,30,18
1746587717983,MATH 20D,A01,890011,Cheng; Hsiao-Bing,1,1,30,29
1746587717983,MATH 20D,A02,890012,Cheng; Hsiao-Bing,14,0,30,16
1746587717983,MATH 20D,B01,890016,Cheng; Hsiao-Bing,13,0,30,17
1746587717983,MATH 20D,B02,890017,Cheng; Hsiao-Bing,13,0,30,17
1746587719010,MATH 20E,A01,890026,Harel; Guershon,1,0,30,29
1746587719010,MATH 20E,A02,890029,Harel; Guershon,22,0,30,8
1746587719010,MATH 20E,B01,890033,Harel; Guershon,7,0,30,23
1746587719010,MATH 20E,B02,890101,Harel; Guershon,21,0,30,9
1746587720036,MATH 102,A01,890104,Staff,18,0,30,12
1746587720036,MATH 102,A02,890105,Staff,27,0,30,3
1746587721065,MATH 103B,A01,890116,Salehi Golsefidy; Alireza,3,0,30,27
1746587721065,MATH 103B,B01,890118,Staff,0,3,34,34
1746587722093,MATH 109,A01,890121,Aliabadi Sr.; Mohsen,0,0,30,30
1746587722093,MATH 109,B01,890124,Upadrashta; Pranav Kumar,18,0,30,12
1746587723120,MATH 120A,A01,890126,Eggers; John Dietrich,13,0,30,17
1746587724152,MATH 142B,A01,890128,Ioana; Adrian,19,0,30,11
1746587724152,MATH 142B,A02,890129,Ioana; Adrian,12,0,30,18
1746587725178,MATH 154,A01,890174,Staff,0,1,30,30
1746587725178,MATH 154,A02,890182,Staff,0,0,30,30
1746587726202,MATH 168A,A01,890197,Dumitriu; Ioana,21,0,35,14
1746587727232,MATH 170A,A01,890240,Nie; Jiawang,1,0,30,29
1746587727232,MATH 170A,A02,890241,Nie; Jiawang,11,0,30,19
1746587727232,MATH 170A,A03,890249,Nie; Jiawang,23,0,30,7
1746587728260,MATH 170B,A01,957891,Nag; Panchali,13,0,35,22
1746587730320,MATH 181A,A01,908025,Staff,0,3,35,35
1746587730320,MATH 181A,A02,960115,Staff,26,0,35,9
1746587731346,MATH 181B,A01,959874,Staff,25,0,30,5
1746587732371,MATH 193B,A01,890265,Staff,0,4,35,35
1746587733401,MGT 4,A01,890311,Anderson; John Charles,42,0,88,46
1746587734426,MGT 5,A00,907740,Staff,12,0,98,86
1746587735452,MGT 12,A00,890312,Lindenberger; Wade Douglas,67,0,98,31
1746587736477,MGT 16,A00,957883,Staff,78,0,98,20
1746587738533,MGT 45,A00,890314,Pecore; Joseph P.,45,0,98,53
1746587739561,MGT 71,A00,890315,Staff,0,12,98,98
1746587740588,MGT 100,A00,890316,Yavorsky; Daniel Ryan,44,0,98,54
1746587741616,MGT 103,A00,890317,Ehrich; Kristine R,73,0,98,25
1746587742646,MGT 105,A00,890356,Bates; Kenneth Walter,0,8,98,98
1746587743671,MGT 112,A00,890360,Ehrich; Kristine R,55,0,98,43
1746587744700,MGT 127R,A00,907732,Zhu; Kevin Xiaoguo,23,0,98,75
1746587745768,MGT 131B,A00,890361,Anderson; John Charles,59,0,98,39
1746587746793,MGT 137,A00,890362,Lindenberger; Wade Douglas,65,0,98,33
1746587747823,MGT 160,A00,890369,Johnson; Erik Barry,9,0,98,89
1746587749880,MGT 164,A00,890372,Zimmermann; Carsten,0,40,98,98
1746587750908,MGT 180,A00,890374,Bliss; Barbara Ann,12,0,98,86
1746587751945,MMW 15,A01,886414,Chang; Edmond Yi-Teh,0,12,28,28
1746587751945,MMW 15,A02,886415,Chang; Edmond Yi-Teh,0,8,28,28
1746587751945,MMW 15,A03,886416,Chang; Edmond Yi-Teh,0,9,28,28
1746587751945,MMW 15,A04,886417,Chang; Edmond Yi-Teh,0,8,28,28
1746587751945,MMW 15,B01,886419,Chang; Edmond Yi-Teh,0,7,28,28
1746587751945,MMW 15,B02,886420,Chang; Edmond Yi-Teh,0,8,28,28
1746587751945,MMW 15,B03,886421,Chang; Edmond Yi-Teh,0,7,28,28
1746587751945,MMW 15,B04,886422,Chang; Edmond Yi-Teh,0,8,28,28
1746587751945,MMW 15,C01,886424,Staff,0,9,28,28
1746587751945,MMW 15,C02,886425,Staff,0,8,28,28
1746587751945,MMW 15,C03,886426,Staff,0,8,28,28
1746587751945,MMW 15,C04,886427,Staff,0,8,28,28
1746587751945,MMW 15,C05,958038,Staff,0,8,28,28
1746587751945,MMW 15,C06,958039,Staff,1,8,28,27
1746587752973,MMW 15GS,A00,906910,Patterson; Patrick H.,4,0,28,24
1746587754002,MMW 122R,A01,886429,Rahimi; Babak,0,13,28,28
1746587754002,MMW 122R,A02,886430,Rahimi; Babak,0,12,28,28
1746587754002,MMW 122R,A03,958040,Rahimi; Babak,0,11,28,28
1746587755029,MUS 1A,A01,890937,Staff,2,0,25,23
1746587755029,MUS 1A,A02,891035,Staff,6,0,25,19
1746587755029,MUS 1A,C01,958912,Staff,24,0,25,1
1746587755029,MUS 1A,C02,958913,Staff,25,0,25,0
1746587757087,MUS 2AK,A00,957092,Ohnishi; Takae,15,0,15,0
1746587758113,MUS 4,A01,891044,Staff,0,0,25,25
1746587758113,MUS 4,A02,891045,Staff,23,0,25,2
1746587758113,MUS 4,B01,891048,Staff,17,0,25,8
1746587758113,MUS 4,B02,891050,Staff,25,0,25,0
1746587759166,MUS 5,A01,957506,Dubnov; Shlomo,0,0,25,25
1746587759166,MUS 5,A02,957622,Dubnov; Shlomo,13,0,25,12
1746587759166,MUS 5,A03,957623,Dubnov; Shlomo,20,0,25,5
1746587760195,MUS 6,A01,891053,Freitas Caetano; Marcelo,24,0,25,1
1746587760195,MUS 6,A02,891054,Freitas Caetano; Marcelo,23,0,25,2
1746587761221,MUS 7,A01,891081,Staff,0,0,25,25
1746587761221,MUS 7,A02,891082,Staff,3,0,25,22
1746587762253,MUS 8GS,A00,891118,Borgo; David Garcia,1,0,25,24
1746587763285,MUS 11,A01,891140,Staff,9,0,25,16
1746587763285,MUS 11,A02,891141,Staff,21,0,25,4
1746587764312,MUS 13,A01,891143,Staff,8,0,25,17
1746587764312,MUS 13,A02,891144,Staff,24,0,25,1
1746587765338,MUS 15,A01,891146,Staff,9,0,25,16
1746587765338,MUS 15,A02,891148,Staff,21,0,25,4
1746587765338,MUS 15,B01,891150,Staff,18,0,25,7
1746587765338,MUS 15,B02,891151,Staff,25,0,25,0
1746587766365,MUS 20,A01,891153,Staff,5,0,20,15
1746587766365,MUS 20,A02,891155,Staff,14,0,20,6
1746587767390,MUS 80,A00,891156,Staff,19,0,25,6
1746587767390,MUS 80,B00,891157,Staff,23,0,25,2
1746587768415,MUS 130,A00,891158,Ohnishi; Takae,35,0,35,0
1746587769440,MUS 150GS,A01,891160,Borgo; David Garcia,1,0,25,24
1746587770468,MUS 170,A01,891162,Freitas Caetano; Marcelo,20,0,25,5
1746587770468,MUS 170,A02,891164,Freitas Caetano; Marcelo,21,0,25,4
1746587771497,NANO 11,A00,886220,Vazquez Mena; Oscar,13,0,15,2
1746587772523,NANO 15,A01,886222,Drews; Aaron,4,0,7,3
1746587773549,NANO 104,A00,886224,Sirbuly; Donald,17,0,25,8
1746587774575,PH 40,A00,886528,Staff,24,0,40,16
1746587775600,PH 45,A01,886799,Staff,35,0,40,5
1746587776626,PH 110,A00,886802,Staff,0,7,40,40
1746587777654,PH 172,A00,906716,Staff,19,0,35,16
1746587778684,PH 191,A00,886803,Staff,6,0,40,34
1746587779713,PHIL 1,A00,889500,Staff,20,0,30,10
1746587780739,PHIL 10,A01,889549,Grush; Rick Scott,16,0,22,6
1746587780739,PHIL 10,A02,889551,Grush; Rick Scott,22,0,22,0
1746587781772,PHIL 28,A01,889559,Lamey; Andy M.,0,2,31,31
1746587781772,PHIL 28,A02,889561,Lamey; Andy M.,0,1,30,30
1746587781772,PHIL 28,A03,889572,Lamey; Andy M.,0,1,30,30
1746587782796,PHIL 35,A00,907839,Staff,13,0,15,2
1746587783821,PHIL 60,A00,889574,Staff,73,0,90,17
1746587784848,PHIL 101,A00,958004,Staff,12,0,15,3
1746587786899,PHIL 136,A00,889582,Fulkerson; Matthew Todd,26,0,45,19
1746587787929,PHIL 163,A01,889601,Staff,21,0,30,9
1746587787929,PHIL 163,B01,889606,Brandt; Reuven A,0,3,0,0
1746587788957,PHIL 164,A00,889610,Staff,16,0,30,14
1746587789984,PHIL 165,A00,889613,Staff,22,0,30,8
1746587791012,PHYS 1A,A00,886431,Staff,29,0,70,41
1746587792039,PHYS 1AL,001,886432,Tsai; Philbert S,1,2,30,29
1746587792039,PHYS 1AL,002,886436,Tsai; Philbert S,12,0,30,18
1746587793064,PHYS 1B,A00,886439,Staff,184,0,240,56
1746587794093,PHYS 1BL,001,886441,Tsai; Philbert S,0,4,30,30
1746587794093,PHYS 1BL,002,886444,Tsai; Philbert S,2,0,30,28
1746587795119,PHYS 1C,A00,896092,Arnold; Kam S,78,0,146,68
1746587796150,PHYS 1CL,001,886448,Tsai; Philbert S,0,0,30,30
1746587796150,PHYS 1CL,002,886449,Tsai; Philbert S,1,0,30,29
1746587796150,PHYS 1CL,003,886450,Tsai; Philbert S,16,0,30,14
1746587796150,PHYS 1CL,004,886451,Tsai; Philbert S,15,0,30,15
1746587797177,PHYS 2B,A01,886457,Staff,67,0,115,48
1746587798203,PHYS 2C,A01,886460,Shotwell; Brian,0,9,65,65
1746587799229,PHYS 2CL,A01,886467,Staff,0,4,28,28
1746587799229,PHYS 2CL,A02,886468,Staff,0,3,28,28
1746587800260,PHYS 2D,A01,886470,Staff,10,0,50,40
1746587801288,PHYS 4B,A01,886475,Grinstein; Benjamin,22,0,40,18
1746587802314,POLI 5,A00,891173,Desposato; Scott,7,0,25,18
1746587803339,POLI 5D,A01,891175,Staff,5,0,5,0
1746587803339,POLI 5D,B01,891178,Staff,5,0,5,0
1746587804364,POLI 11,A00,891179,Ferree; Karen E,2,0,35,33
1746587805391,POLI 12,A00,891180,Staff,16,0,30,14
1746587806419,POLI 27,A01,891182,Staff,12,0,75,63
1746587807446,POLI 30,A00,891183,Staff,8,0,50,42
1746587808475,POLI 100B,A00,891244,Staff,5,1,35,30
1746587809498,POLI 100I,A00,891247,Staff,7,0,30,23
1746587810523,POLI 104J,A00,891248,Nichter; Maysa,14,0,30,16
1746587811562,POLI 104U,A00,891250,Nichter; Maysa,1,0,30,29
1746587813617,POLI 110B,A00,891255,Wiens; David,19,0,25,6
1746587814647,POLI 112A,A00,891256,Wiens; David,6,0,25,19
1746587815674,POLI 114BR,A00,891261,Staff,19,0,30,11
1746587816701,POLI 117R,A00,891262,Forman; Fonna,0,6,50,50
1746587817726,POLI 118,A00,891264,Ingham; Sean,17,0,25,8
1746587818754,POLI 124A,A00,891265,Staff,18,0,20,2
1746587819780,POLI 125D,A00,891266,Nichter; Simeon C,2,0,25,23
1746587820807,POLI 126,A00,891268,Nichter; Simeon C,7,0,25,18
1746587821853,POLI 126AA,A00,891272,Staff,15,0,25,10
1746587822882,POLI 130AA,A00,891273,Staff,15,0,20,5
1746587823907,POLI 134AA,A00,891274,Staff,4,0,20,16
1746587825959,POLI 138,A00,891278,Staff,21,0,25,4
1746587826983,POLI 142K,A00,891280,Staff,10,0,25,15
1746587828012,POLI 142M,A00,891281,Gartzke; Erik,16,0,30,14
1746587829037,POLI 142P,A00,891284,Staff,20,0,30,10
1746587830062,POLI 143,A00,891285,Gartzke; Erik,12,0,30,18
1746587831088,POLI 153,A00,891286,Staff,19,0,20,1
1746587833141,POLI 175,A00,891290,Staff,15,0,20,5
1746587834168,PSYC 1,A00,890674,Steiner; Eric Tomas,0,11,45,45
1746587835197,PSYC 2,A00,890676,Albright; Thomas D,20,0,35,15
1746587836221,PSYC 3,A00,890679,Staff,17,0,20,3
1746587837247,PSYC 6,A00,959858,Staff,19,0,20,1
1746587838272,PSYC 60,A01,890684,Rickard; Timothy C.,0,6,45,45
1746587839297,PSYC 70,A01,890689,Geller; Emma Harlan,6,0,30,24
1746587840320,PSYC 71,A01,959860,Staff,21,0,25,4
1746587841346,PSYC 100,A00,890690,Lacefield; Katharine I,0,50,180,180
1746587842373,PSYC 102,A00,890695,Staff,17,0,40,23
1746587843398,PSYC 105,A00,890699,Geller; Emma Harlan,70,0,100,30
1746587844425,PSYC 106,A00,890701,Gorman; Michael R.,5,0,30,25
1746587845455,PSYC 108,A00,890704,Adrian; Julia Anna,0,29,50,50
1746587846480,PSYC 118,A01,890712,Staff,11,0,30,19
1746587847508,PSYC 124,A00,890716,Chapman; Eddie Nathaniel,25,0,60,35
1746587848533,PSYC 131,A00,890717,Anagnostaras; Stephan,0,7,80,80
1746587849555,PSYC 137,A00,890719,Winkielman; Piotr,0,11,30,30
1746587850583,PSYC 144,A00,890721,Adrian; Julia Anna,0,9,45,45
1746587851610,PSYC 162,A00,890805,Staff,0,1,75,75
1746587852637,PSYC 169,A00,890810,Staff,0,15,30,30
1746587853665,PSYC 172,A00,890814,Gorman; Michael R.,9,0,30,21
1746587854690,PSYC 181,A00,890818,Anagnostaras; Stephan,7,0,200,193
1746587855719,PSYC 184,A00,959861,Staff,164,0,175,11
1746587856745,PSYC 189,A00,890823,Staff,0,2,30,30
1746587857770,PSYC 191,A00,890884,Rickard; Timothy C.,0,12,35,35
1746587858794,PSYC 193,A00,890913,Staff,19,0,30,11
1746587858794,PSYC 193,B00,890914,Chapman; Eddie Nathaniel,24,0,30,6
1746587859821,PSYC 193L,A01,890918,Lowe; Angela Beth,20,0,30,10
1746587859821,PSYC 193L,B01,890921,Hurwitz; Ethan Scott,20,0,30,10
1746587859821,PSYC 193L,C01,890928,Staff,30,0,30,0
1746587860848,RELI 149,A00,886806,Rahimi; Babak,23,0,40,17
1746587861874,SE 9,A01,886814,Staff,7,0,20,13
1746587862903,SE 101B,A01,886816,Chadha; Mayank,3,0,35,32
1746587863930,SE 110B,A00,886818,Zhu; Qiang,4,0,75,71
1746587864961,SE 125,A01,886830,Staff,10,0,30,20
1746587865988,SE 130B,A01,886835,Staff,14,0,40,26
1746587867016,SE 131A,A01,886838,Krysl; Petr,34,0,55,21
1746587868045,SE 154,A00,886840,Staff,28,0,50,22
1746587869072,SE 164GS,A01,886849,Staff,6,0,20,14
1746587870102,SE 167GS,A01,886853,Staff,6,0,20,14
1746587871128,SIO 25,A01,890107,Staff,19,0,30,11
1746587872155,SIO 45,A00,890109,Cook; Geoffrey W,116,0,200,84
1746587873180,SIO 109R,A00,890110,Forman; Fonna,0,16,20,20
1746587874206,SIO 187,A01,890114,Kacev; David,15,0,40,25
1746587875230,SOCI 1,A01,890431,Thorpe; Charles Robert,14,0,30,16
1746587875230,SOCI 1,A02,890518,Thorpe; Charles Robert,30,0,30,0
1746587876256,SOCI 2,A01,957978,Staff,25,0,25,0
1746587876256,SOCI 2,A02,957979,Staff,23,0,25,2
1746587877280,SOCI 20,A01,890523,Calderon-Zaks; Michael Aar,21,0,30,9
1746587877280,SOCI 20,A02,890526,Calderon-Zaks; Michael Aar,29,0,30,1
1746587878308,SOCI 30,A01,890533,Pardo Guerra; Juan Pablo,37,0,40,3
1746587879334,SOCI 40,A01,890535,Staff,27,0,45,18
1746587880359,SOCI 104Q,A00,890559,Staff,18,0,30,12
1746587881383,SOCI 106,A00,890560,Arnal; Maud Marie Leonie,20,0,30,10
1746587882423,SOCI 110,A00,890567,Holkenbrink-Monk; Charlene,19,0,30,11
1746587883449,SOCI 112,A00,890568,Victoria Torres; Pablo,2,0,55,53
1746587884474,SOCI 115,A00,890597,Arnal; Maud Marie Leonie,28,0,45,17
1746587886529,SOCI 121,A00,890604,Pardo Guerra; Juan Pablo,38,0,45,7
1746587887558,SOCI 126,A01,890608,Staff,8,0,10,2
1746587888583,SOCI 127,A00,890609,Staff,18,0,30,12
1746587889612,SOCI 131,A00,890610,Thorpe; Charles Robert,37,0,45,8
1746587890638,SOCI 135,A00,890615,Payne; Christine Anna,13,0,45,32
1746587891664,SOCI 139,A00,890620,Staff,38,0,45,7
1746587892690,SOCI 148E,A00,890622,Calderon-Zaks; Michael Aar,36,0,45,9
1746587893717,SOCI 150,A00,890623,Kohler; Kristopher M.,31,0,45,14
1746587894743,SOCI 157,A00,890625,Jules-Rosette; Bennetta W.,18,0,20,2
1746587895768,SOCI 160,A00,890627,Payne; Christine Anna,21,0,45,24
1746587896796,SYN 1,A00,886855,Fish; Gwendolyn Anne,0,1,0,0
1746587896796,SYN 1,B00,906086,Fish; Gwendolyn Anne,0,2,0,2
1746587897824,SYN 2R,A00,886860,Staff,0,17,15,15
1746587897824,SYN 2R,B00,906106,Atkinson; Arthur Laird,0,16,15,15
1746587898852,SYN 100,A01,886866,Browne; Emily,0,28,20,20
1746587898852,SYN 100,B01,906128,Rock; Martin,0,4,20,20
1746587898852,SYN 100,C01,906140,Deavenport; James Cary,0,4,20,20
1746587898852,SYN 100,D01,907816,Deavenport; James Cary,0,5,20,20
1746587899881,TDAC 1,A00,890286,Walsh; Kim C.,7,0,20,13
1746587900906,TDAC 101,A00,890296,Basso; Beatrice,15,0,20,5
1746587901932,TDDE 131,A00,890297,Staff,47,0,50,3
1746587902962,TDDM 1,A00,890287,Weinberg; Sadie,25,0,30,5
1746587903990,TDGE 11,A00,890288,Fulton; Julia,138,0,200,62
1746587903990,TDGE 11,B00,890289,Castro; Robert Jess,185,0,200,15
1746587905020,TDGE 25,B00,957359,Walsh; Kim C.,5,0,20,15
1746587906046,TDGE 40,A01,890292,Power; Jade Yukana,26,0,30,4
1746587907072,TDGE 124,A00,890298,Havis; Allan,0,2,50,50
1746587908097,TDGE 131R,A00,890299,Burelle; Julie Sara Veronique,15,0,42,27
1746587909164,TDHT 101,A00,890300,Staff,10,0,20,10
1746587910191,TDHT 109,A01,890302,Anderson; Mysia Anyse,31,0,40,9
1746587911221,TDMV 1,A00,890293,Arcidiacono; Kristin,18,0,30,12
1746587912247,TDMV 2,A00,890294,Weinberg; Sadie,23,0,30,7
1746587913273,TDMV 3,A00,957878,Arcidiacono; Kristin,28,0,30,2
1746587915327,TDMV 138,A00,890304,Jun; Grace Shin Hae,25,0,40,15
1746587916353,TDMV 140,A00,890305,Corrales; Joseph Bernales,25,0,30,5
1746587917380,TDMV 142,A00,890307,Caligagan; Tony,32,0,40,8
1746587918408,TDMV 144,A00,890308,Camaya; Michelle Ann,25,0,30,5
1746587919433,TDPW 1,A00,890295,Stein; Deborah Isobel,3,0,20,17
1746587920461,USP 2,A01,890272,Lerner; Amy M,7,0,20,13
1746587921490,USP 3,A01,890274,Staff,12,0,30,18
1746587922518,USP 15,A01,890276,Sun; Feiyang,16,0,30,14
1746587923544,USP 25,A00,890277,Shenkman; Michael Thomas,18,0,25,7
1746587924572,USP 138,A00,890278,Staff,13,0,25,12
1746587925599,USP 143,A00,890279,Staff,22,0,70,48
1746587926627,USP 144,A00,890280,Chowdhury; Muhammed Zohir,16,0,30,14
1746587927653,USP 150,A00,890281,Boomhower; Matthew Charles,4,0,30,26
1746587928677,USP 151,A00,890282,Staff,16,0,20,4
1746587929701,USP 162,A00,890283,Andrews; Abigail Leslie,16,0,20,4
1746587930727,USP 168,A00,920477,Kwak; Nancy,0,0,5,5
1746587931754,USP 181,A00,890284,Staff,3,0,20,17
1746587932780,USP 191A,A00,890285,Staff,12,0,20,8
1746587933811,VIS 101,A00,886512,Staff,26,0,75,49
1746587934837,VIS 103,A00,886513,Cruz; Edwin Teddy,61,0,75,14
1746587935864,VIS 108,A00,886514,Staff,3,0,15,12
1746587936890,VIS 127P,A00,886515,Shen; Kuiyi,79,0,146,67
1746587937917,VIS 149,A00,886516,Yoldas; Pinar,0,0,15,15
1746587938941,VIS 164,A00,886526,Erdmann; Dean,19,0,22,3
1746587939967,VIS 194S,A00,886527,Staff,61,0,75,14
1746587940996,WCWP 10A,C00,886484,Martiniuk; Jill,12,0,15,3
1746587942026,WCWP 10B,A00,886490,Uriarte; Emma,0,0,15,15
1746587942026,WCWP 10B,B00,886491,Dhir; Simrita,8,0,15,7
1746587942026,WCWP 10B,C00,886492,Ornelas; Tricia,0,0,15,15
1746587943052,WCWP 100,A00,886494,Young; Mark T,0,6,15,15
1746587945146,AAS 10,A01,886199,Childs; Dennis R.,0,3,0,0
1746587946171,ANAR 104,A01,886940,Shtienberg; Gilad,27,0,30,3
1746587947196,ANAR 120,A00,886953,Staff,13,0,20,7
1746587948224,ANBI 148,A01,886955,Wilder; Linnea Lorene,30,0,40,10
1746587950276,ANSC 122,A00,886957,Staff,24,0,30,6
1746587951303,ANSC 150,A00,886958,Sloane; Julia Kathryn,2,0,15,13
1746587952329,ANSC 156,A00,886959,Jenkins; Janis A.,0,1,15,15
1746587953357,ANSC 180,A00,886960,Staff,11,0,17,6
1746587954384,ANSC 188,A00,886961,Jassal; Aftab,9,0,25,16
1746587955410,ANSC 190,A00,886962,Jassal; Aftab,14,0,25,11
1746587956440,ANSC 191,A00,886963,Staff,18,0,20,2
1746587957466,ANTH 3,A01,891689,Staff,17,0,20,3
1746587958494,ANTH 5,A00,886933,Semendeferi; Ekaterini,16,0,20,4
1746587959520,ANTH 10,A00,886934,Staff,0,12,30,30
1746587960550,ANTH 21,A01,886936,Staff,41,0,60,19
1746587961576,ANTH 23,A01,886938,Staff,92,0,100,8
1746587962606,ANTH 105,A00,886964,Stewart; Alexander B,84,0,100,16
1746587963635,ANTH 108,A00,886965,Pedersen; David,9,0,20,11
1746587964669,AWP 10,001,886147,Staff,0,0,0,0
1746587964669,AWP 10,002,886148,Staff,0,0,0,0
1746587964669,AWP 10,003,886149,Staff,0,0,0,0
1746587964669,AWP 10,004,886150,Staff,0,0,0,0
1746587964669,AWP 10,005,886151,Staff,0,0,0,0
1746587964669,AWP 10,006,886152,Staff,0,0,0,0
1746587964669,AWP 10,007,886153,Staff,0,0,0,0
1746587964669,AWP 10,008,886154,Staff,0,0,0,0
1746587964669,AWP 10,009,886155,Staff,0,0,0,0
1746587964669,AWP 10,010,886156,Staff,0,0,0,0
1746587964669,AWP 10,011,886158,Staff,0,0,0,0
1746587964669,AWP 10,012,886160,Staff,0,0,0,0
1746587964669,AWP 10,013,886161,Staff,0,0,0,0
1746587964669,AWP 10,014,886162,Staff,0,0,0,0
1746587964669,AWP 10,015,886163,Staff,0,0,0,0
1746587964669,AWP 10,016,886164,Staff,0,0,0,0
1746587964669,AWP 10,017,886165,Staff,0,0,0,0
1746587964669,AWP 10,018,886166,Staff,0,0,0,0
1746587964669,AWP 10,019,886168,Staff,0,0,0,0
1746587964669,AWP 10,020,886170,Staff,0,0,0,0
1746587964669,AWP 10,021,886172,Staff,0,0,0,0
1746587965701,AWP 10R,001,886173,Staff,0,1,0,0
1746587965701,AWP 10R,002,886174,Staff,0,1,0,0
1746587965701,AWP 10R,003,886175,Staff,0,0,0,0
1746587965701,AWP 10R,004,886176,Staff,0,0,0,0
1746587965701,AWP 10R,005,886177,Staff,0,0,0,0
1746587965701,AWP 10R,006,886178,Staff,0,0,0,0
1746587965701,AWP 10R,007,886179,Staff,0,0,0,0
1746587965701,AWP 10R,008,886181,Staff,0,0,0,0
1746587965701,AWP 10R,009,886182,Staff,0,0,0,0
1746587965701,AWP 10R,010,886183,Staff,0,0,0,0
1746587965701,AWP 10R,011,886184,Staff,0,0,0,0
1746587965701,AWP 10R,012,886185,Staff,0,0,0,0
1746587965701,AWP 10R,013,886186,Staff,0,0,0,0
1746587965701,AWP 10R,014,886187,Staff,0,0,0,0
1746587965701,AWP 10R,015,886188,Staff,0,0,0,0
1746587965701,AWP 10R,016,886189,Staff,0,0,0,0
1746587965701,AWP 10R,017,960532,Staff,0,0,0,0
1746587965701,AWP 10R,018,960533,Staff,0,0,0,0
1746587965701,AWP 10R,019,960534,Staff,0,0,0,0
1746587965701,AWP 10R,020,960538,Staff,0,0,0,0
1746587965701,AWP 10R,021,960540,Staff,0,0,0,0
1746587965701,AWP 10R,022,960541,Staff,0,0,0,0
1746587965701,AWP 10R,023,960542,Staff,0,0,0,0
1746587965701,AWP 10R,024,960544,Staff,0,0,0,0
1746587965701,AWP 10R,025,960545,Staff,0,0,0,0
1746587965701,AWP 10R,026,960548,Staff,0,0,0,0
1746587966729,AWP 102R,A00,886190,Staff,0,0,0,0
1746587966729,AWP 102R,B00,886191,Staff,0,0,0,0
1746587967757,BENG 100,A01,886193,Staff,17,0,30,13
1746587968785,BENG 122A,A01,886195,Hasty; Jeff M,13,0,30,17
1746587969812,BENG 166A,A00,886196,Sah; Robert Lie-Yuan,0,3,30,30
1746587970840,BENG 190,A00,958050,Khojah; Reem I,17,0,25,8
1746587971870,BIBC 102,A01,894320,Staff,0,0,46,46
1746587971870,BIBC 102,A02,894321,Staff,0,0,46,46
1746587971870,BIBC 102,A03,894344,Staff,6,0,46,40
1746587971870,BIBC 102,A04,894345,Staff,27,0,47,20
1746587972898,BICD 100R,A01,894365,Smith; Laurie,1,3,58,57
1746587972898,BICD 100R,A02,894366,Smith; Laurie,1,5,58,57
1746587972898,BICD 100R,A03,894367,Smith; Laurie,0,0,59,59
1746587972898,BICD 100R,A04,959869,Smith; Laurie,40,0,59,19
1746587973928,BICD 136,A01,894383,Gustafson-Brown; Cindy,14,0,50,36
1746587974960,BIEB 102,A01,894494,Butler; Shannon Rhey,51,0,130,79
1746587977017,BIEB 150,A01,894617,Wills; Christopher,3,0,20,17
1746587977017,BIEB 150,A02,894631,Wills; Christopher,3,0,20,17
1746587977017,BIEB 150,A03,894937,Wills; Christopher,3,0,20,17
1746587977017,BIEB 150,A04,894946,Wills; Christopher,5,0,20,15
1746587978045,BIEB 194,A00,906141,Kurle; Carolyn M.,5,0,20,15
1746587979075,BILD 1,A01,894154,Staff,3,0,19,16
1746587979075,BILD 1,A02,894155,Staff,14,0,19,5
1746587979075,BILD 1,A03,894160,Staff,13,0,19,6
1746587979075,BILD 1,A04,894161,Staff,15,0,18,3
1746587980103,BILD 2,A01,894168,Staff,0,0,50,50
1746587980103,BILD 2,A02,894169,Staff,0,0,50,50
1746587980103,BILD 2,A03,894179,Staff,0,0,50,50
1746587980103,BILD 2,A04,894203,Staff,23,0,50,27
1746587981131,BILD 3,A01,894213,Staff,23,0,31,8
1746587981131,BILD 3,A02,894214,Staff,26,0,31,5
1746587981131,BILD 3,A03,894235,Staff,28,0,31,3
1746587981131,BILD 3,A04,894236,Staff,28,0,32,4
1746587982161,BILD 4,A01,894253,Reuther; Keefe,5,0,24,19
1746587982161,BILD 4,A02,894258,Reuther; Keefe,16,0,24,8
1746587983188,BILD 5,A01,894276,Reuther; Keefe,34,0,50,16
1746587983188,BILD 5,A02,894277,Reuther; Keefe,45,0,50,5
1746587983188,BILD 5,A03,894290,Reuther; Keefe,44,0,50,6
1746587983188,BILD 5,A04,894291,Reuther; Keefe,48,0,50,2
1746587984217,BILD 24,A01,894297,Pirino; Giorgia,40,0,60,20
1746587985248,BIMM 100,B01,958915,Staff,71,0,100,29
1746587986278,BIMM 101,A01,895017,McDonnell; Lisa Marie,0,5,24,24
1746587986278,BIMM 101,A02,895018,McDonnell; Lisa Marie,0,5,24,24
1746587986278,BIMM 101,B01,895020,McDonnell; Lisa Marie,0,6,24,24
1746587986278,BIMM 101,B02,895021,McDonnell; Lisa Marie,0,4,24,24
1746587987302,BIMM 110,A01,895023,Staff,1,0,25,24
1746587987302,BIMM 110,A02,895024,Staff,9,0,25,16
1746587987302,BIMM 110,A03,895025,Staff,18,0,25,7
1746587987302,BIMM 110,A04,895031,Staff,20,0,25,5
1746587988333,BIMM 120,A01,895114,Gustafson-Brown; Cindy,14,0,28,14
1746587988333,BIMM 120,A02,895126,Gustafson-Brown; Cindy,21,0,27,6
1746587989361,BIPN 100,A01,895130,Yang; Mingyu,0,0,38,38
1746587989361,BIPN 100,A02,895131,Yang; Mingyu,31,0,38,7
1746587989361,BIPN 100,A03,895132,Yang; Mingyu,32,0,38,6
1746587989361,BIPN 100,A04,895133,Yang; Mingyu,27,0,36,9
1746587990392,BIPN 120,A01,895135,Cooke; James Edward,0,3,13,13
1746587990392,BIPN 120,A02,895136,Cooke; James Edward,0,1,13,13
1746587990392,BIPN 120,A03,895137,Cooke; James Edward,0,3,13,13
1746587990392,BIPN 120,A04,895156,Cooke; James Edward,0,2,11,11
1746587991420,BIPN 134,A01,895235,Cooke; James Edward,0,2,25,25
1746587991420,BIPN 134,A02,895237,Cooke; James Edward,0,0,25,25
1746587991420,BIPN 134,A03,895240,Cooke; James Edward,3,0,25,22
1746587991420,BIPN 134,A04,895270,Cooke; James Edward,20,0,25,5
1746587992445,BIPN 189,A00,892103,Staff,0,14,14,14
1746587994499,BISP 194,A00,958008,Staff,0,2,0,0
1746587995524,CAT 124,A01,922009,Staff,0,5,20,20
1746587996555,CAT 125R,A00,886390,Morales; Celeste Georgianna,0,2,20,20
1746587996555,CAT 125R,B00,886391,Irwin; Matthew Joseph,0,4,20,20
1746587996555,CAT 125R,C00,886392,Smith; Lauryn Alissa,0,2,20,20
1746587996555,CAT 125R,D00,886393,Vanderschuit; Maya Alysia,0,3,20,20
1746587996555,CAT 125R,E00,886394,Marchisotto; Jennifer Anne,0,3,20,20
1746587997580,CENG 15,A01,886218,Drews; Aaron,3,0,8,5
1746587998614,CENG 113,A00,886219,Opatkiewicz; Justin Paul,15,0,25,10
1746587999640,CGS 101,A00,887044,Staff,7,0,20,13
1746588000665,CGS 105,A01,887046,Staff,14,0,25,11
1746588001701,CGS 112,A00,887047,Cuong; Marisol,12,0,15,3
1746588002729,CGS 113,A00,887048,Staff,23,0,30,7
1746588003757,CGS 120,A00,887049,Staff,10,0,17,7
1746588004783,CHEM 6A,A01,886336,Lam; Tin Yiu,38,0,50,12
1746588004783,CHEM 6A,A02,886338,Lam; Tin Yiu,37,0,50,13
1746588005809,CHEM 6B,A01,886341,Hopkins; Patrycja Anna,16,0,50,34
1746588005809,CHEM 6B,A02,886343,Hopkins; Patrycja Anna,42,0,50,8
1746588006836,CHEM 6C,A01,886346,Albizati; Kim F.,0,2,50,50
1746588006836,CHEM 6C,A02,886348,Albizati; Kim F.,24,0,50,26
1746588007861,CHEM 40A,A01,886352,Klosterman; Jeremy K,65,0,100,35
1746588008890,CHEM 40B,A01,886356,Klosterman; Jeremy K,0,24,100,100
1746588009915,CHEM 41B,A01,886360,Theodorakis; Emmanuel,25,0,50,25
1746588009915,CHEM 41B,A02,886362,Theodorakis; Emmanuel,47,0,50,3
1746588010941,CHIN 165A,A00,886382,Xu; Li,18,0,20,2
1746588011965,CLAS 120,A00,886387,Myerston Santana; Jacobo,33,0,40,7
1746588013029,COGS 9,A01,886967,Shannon; Kyle Michael,42,0,60,18
1746588014060,COGS 11,A01,886969,Staff,9,0,30,21
1746588015086,COGS 14A,A01,886971,Staff,6,0,60,54
1746588016113,COGS 14B,A01,886973,Hoffman; Drew Ellen,4,0,60,56
1746588017141,COGS 18,A01,886975,Morgan; Eric,34,0,60,26
1746588018170,COGS 20,A01,886977,Staff,2,0,8,6
1746588018170,COGS 20,A02,886978,Staff,4,0,7,3
1746588019194,COGS 100,A01,907783,Staff,1,2,30,29
1746588020219,COGS 101B,A01,886980,Staff,0,4,48,48
1746588021245,COGS 101C,A01,886982,Delgado; Tania,0,5,44,44
1746588022271,COGS 102A,A01,886984,Johnson; Christine M.,3,0,30,27
1746588023297,COGS 118B,A01,886986,Staff,1,5,88,87
1746588024326,COGS 150,A01,886988,Bergen; Benjamin,22,0,50,28
1746588025353,COGS 153,A00,886989,Delgado; Tania,0,3,41,41
1746588026378,COGS 186,A01,886991,Staff,0,0,32,32
1746588027403,COGS 187A,A01,886993,Boyle; Mary E. T.,7,0,30,23
1746588028429,COGS 189,A00,886994,Staff,0,1,30,30
1746588029454,COMM 10,A01,886996,Staff,0,0,20,21
1746588029454,COMM 10,A02,886997,Staff,10,0,20,10
1746588029454,COMM 10,A03,959845,Staff,19,0,20,1
1746588030479,COMM 20,A01,886999,Leuning; Grant Maurstad,24,0,40,16
1746588032534,COMM 100A,A01,887002,Staff,0,0,20,25
1746588032534,COMM 100A,A02,887003,Staff,6,0,20,14
1746588033558,COMM 100B,A01,887005,Staff,0,8,20,24
1746588034584,COMM 106D,A00,887006,Staff,13,0,40,27
1746588035607,COMM 110G,A00,887007,Whitworth-Smith; Andrew C,12,0,40,28
1746588036632,COMM 111B,A00,887008,Staff,31,0,40,9
1746588037663,COMM 113T,A00,887009,Abuelhiga; Soraya Jill,28,0,40,12
1746588037663,COMM 113T,B00,906733,Staff,40,0,40,0
1746588038688,COMM 145,A00,887010,Staff,12,0,40,28
1746588039713,COMM 146,A00,887054,Staff,31,0,40,9
1746588040739,COMM 190,A00,887012,Staff,8,0,23,15
1746588041769,CSE 8A,A50,887015,Cao; Yingjun,57,0,85,28
1746588042800,CSE 11,A01,887017,Cao; Yingjun,11,0,70,59
1746588043830,CSE 20,A01,887019,Staff,30,0,50,20
1746588044862,CSE 21,A01,887021,Staff,78,0,100,22
1746588044862,CSE 21,B01,892583,Braun; Oliver,45,0,50,5
1746588045887,CSE 30,A01,887025,Eldon; John,142,0,200,58
1746588046912,CSE 100,A01,887027,Staff,26,0,50,24
1746588046912,CSE 100,A02,887028,Staff,42,0,50,8
1746588047942,CSE 101,A01,887030,Braun; Oliver,74,0,100,26
1746588047942,CSE 101,B01,887032,Jones; Miles E,0,3,50,50
1746588047942,CSE 101,B02,887033,Jones; Miles E,0,2,50,50
1746588048967,CSE 105,A01,908084,Jones; Miles E,32,0,50,18
1746588048967,CSE 105,A02,908087,Jones; Miles E,31,0,50,19
1746588050000,CSE 135,A01,887035,Powell; Thomas Allan,0,5,50,50
1746588051028,CSE 142,A01,887037,Staff,8,0,60,52
1746588052054,CSE 142L,A01,887039,Staff,34,0,60,26
1746588053083,CSE 151A,A01,887041,Solares; Edwin A,47,0,100,53
1746588054112,CSE 175,A01,887043,Kumar; Rakesh,30,0,30,0
1746588055140,CSS 1,A01,886389,Staff,1,2,40,39
1746588056168,DSC 30,A01,908097,Liao; Soohyun Nam,47,0,75,28
1746588057192,DSC 40A,A01,908099,Shannon; Kyle Michael,30,0,50,20
1746588058222,DSC 40B,A01,908112,Staff,15,0,50,35
1746588059249,DSC 80,A01,908116,Staff,19,0,60,41
1746588060274,DSC 197,001,956863,Eldridge; Justin Matthew,9999,0,9999,0
1746588061298,ECE 5,A01,886400,Morris; Karcher William,1,0,6,5
1746588061298,ECE 5,A02,886401,Morris; Karcher William,3,0,6,3
1746588062328,ECE 148,A01,886403,Silberman; Jack,0,14,14,14
1746588063353,ECON 1,A01,887265,Crane; Meredith Helen,11,0,70,59
1746588063353,ECON 1,B01,887268,Staff,42,0,50,8
1746588064381,ECON 2,A01,887273,Crane; Meredith Helen,54,0,70,16
1746588065410,ECON 3,A01,887279,Rondina; Giacomo,31,0,70,39
1746588066435,ECON 4,A01,887282,Anderson; John Charles,0,2,10,10
1746588067465,ECON 5,A01,887285,Staff,34,0,45,11
1746588067465,ECON 5,B01,887292,Staff,41,0,45,4
1746588068496,ECON 100A,A01,887337,Newhouse; Herbert S,54,0,70,16
1746588068496,ECON 100A,B01,887349,Staff,45,0,50,5
1746588069527,ECON 100B,A01,887361,Du; Songzi,29,0,70,41
1746588070556,ECON 100C,A01,887445,Newhouse; Herbert S,59,0,70,11
1746588071584,ECON 105,A00,887488,Vespa; Emanuel Ignacio,23,0,35,12
1746588072610,ECON 109,A01,887506,Shishkin; Denis,28,0,35,7
1746588073636,ECON 110A,A01,887568,Alon; Titan Michael,1,3,35,34
1746588073636,ECON 110A,B01,907601,Alon; Titan Michael,20,0,35,15
1746588074665,ECON 110B,A01,887598,Levkoff; Steven B.,0,24,70,70
1746588075695,ECON 112,A00,887599,Rondina; Giacomo,19,0,35,16
1746588076719,ECON 120A,A01,887603,Dai; Yinlin,35,0,70,35
1746588077747,ECON 120C,A01,887608,Sun; Yixiao,0,1,35,35
1746588077747,ECON 120C,B01,887614,Sun; Yixiao,0,0,35,35
1746588078776,ECON 138,A00,887621,Bharadwaj; Prashant,0,21,20,20
1746588079801,ECON 144,A00,958007,Squires; Dale E,12,0,35,23
1746588080829,ECON 171,A01,907666,Staff,18,0,35,17
1746588081855,ECON 175,A00,887626,Wu; Pak Yeung,22,0,35,13
1746588082880,ECON 190,A00,887640,Vespa; Emanuel Ignacio,22,0,35,13
1746588083916,EDS 25,A01,888197,Staff,0,0,0,0
1746588083916,EDS 25,A02,888209,Staff,0,0,0,0
1746588083916,EDS 25,A03,888210,Staff,0,0,0,0
1746588083916,EDS 25,A04,888212,Staff,0,0,0,0
1746588083916,EDS 25,A05,888213,Staff,0,0,0,0
1746588083916,EDS 25,A06,888214,Staff,0,0,0,0
1746588083916,EDS 25,A07,888235,Staff,0,2,0,0
1746588083916,EDS 25,A08,888236,Staff,0,0,0,0
1746588083916,EDS 25,A09,888240,Staff,0,0,0,0
1746588083916,EDS 25,A10,888244,Staff,0,0,0,0
1746588083916,EDS 25,B01,888273,Staff,0,0,0,0
1746588083916,EDS 25,B02,888285,Staff,0,0,0,0
1746588083916,EDS 25,B03,888423,Staff,0,0,0,1
1746588083916,EDS 25,B04,888432,Staff,0,0,0,0
1746588083916,EDS 25,B05,888433,Staff,0,0,0,0
1746588083916,EDS 25,B06,888467,Staff,0,0,0,0
1746588083916,EDS 25,B07,888468,Staff,0,0,0,0
1746588083916,EDS 25,B08,888479,Staff,0,0,0,0
1746588083916,EDS 25,B09,888484,Staff,0,0,0,0
1746588083916,EDS 25,B10,888487,Staff,0,0,0,0
1746588084945,EDS 38,A01,907700,Choi; Bailey Miyeon,30,0,30,0
1746588085969,EDS 112,A01,888601,Chapman; Thandeka K,12,0,40,28
1746588086992,EDS 115,A00,888697,Mendez; Kathrina Mendoza,10,0,30,20
1746588088021,EDS 116,A01,888893,Staff,33,0,40,7
1746588090074,EDS 124AR,A00,889133,Staff,29,0,50,21
1746588090074,EDS 124AR,B00,907471,Simon; Elizabeth A,37,0,50,13
1746588091099,EDS 124BR,A00,889134,Simon; Elizabeth A,44,0,100,56
1746588092128,EDS 125,A00,889135,Staff,25,0,30,5
1746588093153,EDS 126,A01,889138,Staff,35,0,40,5
1746588094176,EDS 164R,A01,889142,Wishard Guerra; Alison G.,32,0,50,18
1746588095205,ENG 30,A01,886396,Staff,0,0,0,0
1746588095205,ENG 30,B01,886398,Staff,0,0,0,0
1746588096231,ENVR 102,A00,906150,Montejo; Carolina,23,0,25,2
1746588097258,ETHN 103A,A00,887236,Man; Simeon S,0,3,0,0
1746588098286,ETHN 113,A00,887239,Staff,16,0,30,14
1746588099309,ETHN 116,A00,887240,Staff,16,0,25,9
1746588100337,ETHN 117,A00,887241,Choi; Esther Min,28,0,30,2
1746588101366,ETHN 118,A00,887243,Staff,24,0,30,6
1746588102393,ETHN 127,A00,887248,Cuong; Marisol,11,0,15,4
1746588103418,ETHN 139,A00,887250,Staff,7,0,10,3
1746588104444,ETHN 142,A00,887252,Staff,10,0,30,20
1746588105477,ETHN 161,A00,887253,Browne; Errol Tsekani,24,0,30,6
1746588106501,ETHN 163FR,A00,887255,Burelle; Julie Sara Veronique,0,0,5,5
1746588107530,GLBH 20,A00,889149,Elwardani; Nile Regina,8,0,42,34
1746588109585,GLBH 111,A01,889152,Burgos; Jose L.,17,0,17,0
1746588110610,GLBH 150,A00,889181,Sloane; Julia Kathryn,0,5,15,15
1746588112665,HDS 60,A01,886406,Warstadt; Melissa Fawn,73,0,80,7
1746588113694,HIAF 111,A00,889324,Gyamfi; Bright,25,0,32,7
1746588114718,HIEA 131,A00,889328,Staff,15,0,32,17
1746588115747,HIEA 144,A00,889333,Henry; Todd A.,26,0,32,6
1746588116775,HIEA 154,A00,889336,Henry; Todd A.,24,0,32,8
1746588117819,HIEU 106,A00,889339,Staff,22,0,32,10
1746588119873,HIEU 114,A00,889340,Staff,4,0,32,28
1746588120900,HIEU 135GS,A00,889342,Patterson; Patrick H.,0,0,1,24
1746588121928,HIEU 137,A00,889343,Edington; Claire Ellen,10,0,25,15
1746588122953,HIEU 148,A00,889345,Staff,14,0,32,18
1746588123979,HIEU 154,A00,889346,Biess; Frank Peter,21,0,32,11
1746588125002,HILA 102,A00,889351,Staff,12,0,32,20
1746588126028,HILD 2A,A01,889221,Lewandoski; Julia Mavis,2,10,32,30
1746588127057,HILD 7B,A01,889225,Man; Simeon S,0,12,32,32
1746588128082,HILD 7C,A01,889288,Alvarez; Luis A,0,14,32,32
1746588129106,HILD 30,A01,889323,Staff,0,5,32,32
1746588131158,HISC 119,A00,889383,Golan; Tal,19,0,32,13
1746588132191,HIUS 103,A00,889384,Man; Simeon S,0,0,32,32
1746588133221,HIUS 117,A00,919797,Kwak; Nancy,18,0,32,14
1746588134248,HIUS 142A,A00,919788,Staff,22,0,32,10
1746588136301,HIUS 149,A00,889386,Gyamfi; Bright,26,0,32,6
1746588137328,HIUS 155,A00,889387,Alvarez; Luis A,15,0,32,17
1746588138354,HUM 3,A01,886499,Caldwell; Michael Alan,19,0,50,31
1746588139379,HUM 3GS,A00,886500,Rodriguez; Bretton Sigfred,0,0,0,28
1746588140495,HUM 3R,A01,886502,Markman; Kristina,0,36,50,50
1746588141522,HUM 4,A01,886504,Crum; Matthew Stephen,23,0,50,27
1746588141522,HUM 4,B01,886506,West; Geoffrey Scott,17,0,50,33
1746588142547,HUM 4GS,A00,886507,Staff,0,0,0,19
1746588143576,HUM 5,A01,886509,Staff,32,0,50,18
1746588144607,HUM 5R,A01,886511,Zavodny; Tatiana Sophia,0,39,50,50
1746588145633,JAPN 180,A00,886407,Staff,16,0,40,24
1746588146662,LATI 50,A01,886409,Martin-Cabrera; Luis,3,0,22,19
1746588146662,LATI 50,A02,886410,Martin-Cabrera; Luis,19,0,22,3
1746588146662,LATI 50,A03,886411,Martin-Cabrera; Luis,21,0,22,1
1746588146662,LATI 50,A04,886412,Martin-Cabrera; Luis,8,0,22,14
1746588147691,LAWS 101,A00,907664,Staff,28,0,60,32
1746588148718,LIAB 1A,A00,889388,Saab; Dima,17,0,20,3
1746588149748,LIAB 1AX,A00,889389,El Cheddadi; Youniss,18,0,20,2
1746588150779,LIFR 1C,A00,889391,Van Moer; Vinciane G,8,0,20,12
1746588151807,LIFR 1CX,A00,889392,Van Moer; Vinciane G,7,0,20,13
1746588152831,LIFR 1D,A00,889393,Van Moer; Vinciane G,7,0,20,13
1746588153861,LIFR 1DX,A00,889394,Van Moer; Vinciane G,8,0,20,12
1746588154889,LIGN 7,A00,886923,Staff,24,0,50,26
1746588155915,LIGN 17,A00,886924,Kehler; Andrew Scott,125,0,150,25
1746588156942,LTAM 110,A00,889395,Staff,15,0,30,15
1746588157967,LTAM 110GS,A00,958010,Rodriguez; Bretton Sigfred,0,0,0,28
1746588158994,LTCH 101,A00,889397,Staff,23,0,25,2
1746588160017,LTCS 130,A00,889398,Staff,23,0,25,2
1746588161043,LTEA 138,A00,889399,Staff,24,0,40,16
1746588162068,LTEN 149,A00,889400,Wesling; Megan E.,0,3,25,25
1746588163097,LTEN 169,A00,889401,Staff,20,0,25,5
1746588164125,LTEN 180,A00,889402,Staff,10,0,15,5
1746588165154,LTEN 181,A00,889403,Staff,21,0,25,4
1746588166179,LTWL 100,A00,889404,Myerston Santana; Jacobo,2,0,25,23
1746588167204,LTWL 180GS,A00,889405,Staff,0,0,20,20
1746588168231,LTWL 181,A00,889406,Staff,16,0,25,9
1746588169261,LTWL 184,A00,889475,Mukherjee; Silpa,22,0,25,3
1746588170288,LTWR 102C,A00,889486,Staff,29,0,30,1
1746588171313,LTWR 115W,A00,889491,Staff,0,2,15,15
1746588172342,MAE 8,A01,886905,Staff,0,2,0,0
1746588173370,MAE 11,A00,886906,Bandaru; Prabhakar,0,7,50,50
1746588174399,MAE 20,A00,886907,Evdokimenko; Ekaterina,43,0,70,27
1746588175425,MAE 30B,A00,886909,Ghazinejad; Maziar,26,0,45,19
1746588176453,MAE 101B,A00,886910,Saintillan; David,29,0,45,16
1746588177480,MAE 105,A00,886911,Bandaru; Prabhakar,18,0,50,32
1746588178509,MAE 107,B00,958024,Staff,7,0,50,43
1746588179537,MAE 143B,A00,886913,Bewley; Thomas R,3,0,40,37
1746588180563,MAE 148,A01,886915,Silberman; Jack,0,3,14,14
1746588181590,MAE 160,A00,886916,Evdokimenko; Ekaterina,31,0,60,29
1746588182617,MATH 3C,A01,889681,Staff,0,2,30,30
1746588182617,MATH 3C,A02,960048,Staff,23,0,30,7
1746588183641,MATH 10A,A01,889760,Staff,26,0,30,4
1746588183641,MATH 10A,A02,889783,Staff,29,0,30,1
1746588184674,MATH 10B,A01,889785,Verstraete; Jacques Allan,1,0,35,34
1746588184674,MATH 10B,A02,889795,Verstraete; Jacques Allan,4,0,35,31
1746588184674,MATH 10B,B01,889797,Verstraete; Jacques Allan,3,0,35,32
1746588184674,MATH 10B,B02,889828,Verstraete; Jacques Allan,3,0,35,32
1746588185709,MATH 10C,A01,889849,Habib; Yousaf,7,0,30,23
1746588185709,MATH 10C,A02,889852,Habib; Yousaf,14,0,30,16
1746588185709,MATH 10C,A03,889853,Habib; Yousaf,22,0,30,8
1746588185709,MATH 10C,A04,889858,Habib; Yousaf,20,0,30,10
1746588185709,MATH 10C,B01,889861,Staff,1,0,30,29
1746588185709,MATH 10C,B02,889862,Staff,24,0,30,6
1746588185709,MATH 10C,B03,889863,Staff,27,0,30,3
1746588185709,MATH 10C,B04,889967,Staff,23,0,30,7
1746588186741,MATH 18,A01,889974,Staff,7,0,30,23
1746588186741,MATH 18,A02,889977,Staff,20,0,30,10
1746588186741,MATH 18,B01,889984,Hardiman; Liam,20,0,30,10
1746588186741,MATH 18,B02,889985,Hardiman; Liam,25,0,30,5
1746588187767,MATH 20A,A01,889990,Suk; Andrew Hoon,30,0,35,5
1746588188797,MATH 20B,A01,889993,Ohm; Ko Woon,21,0,30,9
1746588188797,MATH 20B,A02,889994,Ohm; Ko Woon,30,0,30,0
1746588188797,MATH 20B,B01,889996,Ohm; Ko Woon,22,0,30,8
1746588188797,MATH 20B,B02,889997,Ohm; Ko Woon,23,0,30,7
1746588189829,MATH 20C,A01,889999,Hammock; Frances H,17,0,30,13
1746588189829,MATH 20C,A02,890003,Hammock; Frances H,23,0,30,7
1746588189829,MATH 20C,B01,890006,Hammock; Frances H,3,0,30,27
1746588189829,MATH 20C,B02,890007,Hammock; Frances H,12,0,30,18
1746588190854,MATH 20D,A01,890011,Cheng; Hsiao-Bing,1,1,30,29
1746588190854,MATH 20D,A02,890012,Cheng; Hsiao-Bing,14,0,30,16
1746588190854,MATH 20D,B01,890016,Cheng; Hsiao-Bing,13,0,30,17
1746588190854,MATH 20D,B02,890017,Cheng; Hsiao-Bing,13,0,30,17
1746588191878,MATH 20E,A01,890026,Harel; Guershon,1,0,30,29
1746588191878,MATH 20E,A02,890029,Harel; Guershon,22,0,30,8
1746588191878,MATH 20E,B01,890033,Harel; Guershon,7,0,30,23
1746588191878,MATH 20E,B02,890101,Harel; Guershon,21,0,30,9
1746588192906,MATH 102,A01,890104,Staff,18,0,30,12
1746588192906,MATH 102,A02,890105,Staff,27,0,30,3
1746588193932,MATH 103B,A01,890116,Salehi Golsefidy; Alireza,3,0,30,27
1746588193932,MATH 103B,B01,890118,Staff,0,3,34,34
1746588194957,MATH 109,A01,890121,Aliabadi Sr.; Mohsen,0,0,30,30
1746588194957,MATH 109,B01,890124,Upadrashta; Pranav Kumar,18,0,30,12
1746588195988,MATH 120A,A01,890126,Eggers; John Dietrich,13,0,30,17
1746588197013,MATH 142B,A01,890128,Ioana; Adrian,19,0,30,11
1746588197013,MATH 142B,A02,890129,Ioana; Adrian,12,0,30,18
1746588198039,MATH 154,A01,890174,Staff,0,1,30,30
1746588198039,MATH 154,A02,890182,Staff,0,0,30,30
1746588199065,MATH 168A,A01,890197,Dumitriu; Ioana,21,0,35,14
1746588200091,MATH 170A,A01,890240,Nie; Jiawang,1,0,30,29
1746588200091,MATH 170A,A02,890241,Nie; Jiawang,11,0,30,19
1746588200091,MATH 170A,A03,890249,Nie; Jiawang,23,0,30,7
1746588201118,MATH 170B,A01,957891,Nag; Panchali,13,0,35,22
1746588203168,MATH 181A,A01,908025,Staff,0,3,35,35
1746588203168,MATH 181A,A02,960115,Staff,26,0,35,9
1746588204193,MATH 181B,A01,959874,Staff,25,0,30,5
1746588205218,MATH 193B,A01,890265,Staff,0,4,35,35
1746588206246,MGT 4,A01,890311,Anderson; John Charles,42,0,88,46
1746588207275,MGT 5,A00,907740,Staff,12,0,98,86
1746588208299,MGT 12,A00,890312,Lindenberger; Wade Douglas,67,0,98,31
1746588209327,MGT 16,A00,957883,Staff,78,0,98,20
1746588211382,MGT 45,A00,890314,Pecore; Joseph P.,45,0,98,53
1746588212410,MGT 71,A00,890315,Staff,0,12,98,98
1746588213435,MGT 100,A00,890316,Yavorsky; Daniel Ryan,44,0,98,54
1746588214461,MGT 103,A00,890317,Ehrich; Kristine R,73,0,98,25
1746588215487,MGT 105,A00,890356,Bates; Kenneth Walter,0,8,98,98
1746588216513,MGT 112,A00,890360,Ehrich; Kristine R,55,0,98,43
1746588217541,MGT 127R,A00,907732,Zhu; Kevin Xiaoguo,23,0,98,75
1746588218569,MGT 131B,A00,890361,Anderson; John Charles,59,0,98,39
1746588219598,MGT 137,A00,890362,Lindenberger; Wade Douglas,65,0,98,33
1746588220625,MGT 160,A00,890369,Johnson; Erik Barry,9,0,98,89
1746588222679,MGT 164,A00,890372,Zimmermann; Carsten,0,40,98,98
1746588223708,MGT 180,A00,890374,Bliss; Barbara Ann,12,0,98,86
1746588224738,MMW 15,A01,886414,Chang; Edmond Yi-Teh,0,12,28,28
1746588224738,MMW 15,A02,886415,Chang; Edmond Yi-Teh,0,8,28,28
1746588224738,MMW 15,A03,886416,Chang; Edmond Yi-Teh,0,9,28,28
1746588224738,MMW 15,A04,886417,Chang; Edmond Yi-Teh,0,8,28,28
1746588224738,MMW 15,B01,886419,Chang; Edmond Yi-Teh,0,7,28,28
1746588224738,MMW 15,B02,886420,Chang; Edmond Yi-Teh,0,8,28,28
1746588224738,MMW 15,B03,886421,Chang; Edmond Yi-Teh,0,7,28,28
1746588224738,MMW 15,B04,886422,Chang; Edmond Yi-Teh,0,8,28,28
1746588224738,MMW 15,C01,886424,Staff,0,9,28,28
1746588224738,MMW 15,C02,886425,Staff,0,8,28,28
1746588224738,MMW 15,C03,886426,Staff,0,8,28,28
1746588224738,MMW 15,C04,886427,Staff,0,8,28,28
1746588224738,MMW 15,C05,958038,Staff,0,8,28,28
1746588224738,MMW 15,C06,958039,Staff,1,8,28,27
1746588225766,MMW 15GS,A00,906910,Patterson; Patrick H.,4,0,28,24
1746588226796,MMW 122R,A01,886429,Rahimi; Babak,0,13,28,28
1746588226796,MMW 122R,A02,886430,Rahimi; Babak,0,12,28,28
1746588226796,MMW 122R,A03,958040,Rahimi; Babak,0,11,28,28
1746588227824,MUS 1A,A01,890937,Staff,2,0,25,23
1746588227824,MUS 1A,A02,891035,Staff,6,0,25,19
1746588227824,MUS 1A,C01,958912,Staff,24,0,25,1
1746588227824,MUS 1A,C02,958913,Staff,25,0,25,0
1746588229880,MUS 2AK,A00,957092,Ohnishi; Takae,15,0,15,0
1746588230906,MUS 4,A01,891044,Staff,0,0,25,25
1746588230906,MUS 4,A02,891045,Staff,23,0,25,2
1746588230906,MUS 4,B01,891048,Staff,17,0,25,8
1746588230906,MUS 4,B02,891050,Staff,25,0,25,0
1746588231932,MUS 5,A01,957506,Dubnov; Shlomo,0,0,25,25
1746588231932,MUS 5,A02,957622,Dubnov; Shlomo,13,0,25,12
1746588231932,MUS 5,A03,957623,Dubnov; Shlomo,20,0,25,5
1746588232959,MUS 6,A01,891053,Freitas Caetano; Marcelo,24,0,25,1
1746588232959,MUS 6,A02,891054,Freitas Caetano; Marcelo,23,0,25,2
1746588233985,MUS 7,A01,891081,Staff,0,0,25,25
1746588233985,MUS 7,A02,891082,Staff,3,0,25,22
1746588235014,MUS 8GS,A00,891118,Borgo; David Garcia,1,0,25,24
1746588236038,MUS 11,A01,891140,Staff,9,0,25,16
1746588236038,MUS 11,A02,891141,Staff,21,0,25,4
1746588237065,MUS 13,A01,891143,Staff,8,0,25,17
1746588237065,MUS 13,A02,891144,Staff,24,0,25,1
1746588238091,MUS 15,A01,891146,Staff,9,0,25,16
1746588238091,MUS 15,A02,891148,Staff,21,0,25,4
1746588238091,MUS 15,B01,891150,Staff,18,0,25,7
1746588238091,MUS 15,B02,891151,Staff,25,0,25,0
1746588239120,MUS 20,A01,891153,Staff,5,0,20,15
1746588239120,MUS 20,A02,891155,Staff,14,0,20,6
1746588240145,MUS 80,A00,891156,Staff,19,0,25,6
1746588240145,MUS 80,B00,891157,Staff,23,0,25,2
1746588241170,MUS 130,A00,891158,Ohnishi; Takae,35,0,35,0
1746588242195,MUS 150GS,A01,891160,Borgo; David Garcia,1,0,25,24
1746588243222,MUS 170,A01,891162,Freitas Caetano; Marcelo,20,0,25,5
1746588243222,MUS 170,A02,891164,Freitas Caetano; Marcelo,21,0,25,4
1746588244250,NANO 11,A00,886220,Vazquez Mena; Oscar,13,0,15,2
1746588245275,NANO 15,A01,886222,Drews; Aaron,4,0,7,3
1746588246303,NANO 104,A00,886224,Sirbuly; Donald,17,0,25,8
1746588247331,PH 40,A00,886528,Staff,24,0,40,16
1746588248358,PH 45,A01,886799,Staff,35,0,40,5
1746588249384,PH 110,A00,886802,Staff,0,7,40,40
1746588250413,PH 172,A00,906716,Staff,19,0,35,16
1746588251438,PH 191,A00,886803,Staff,6,0,40,34
1746588252465,PHIL 1,A00,889500,Staff,20,0,30,10
1746588253495,PHIL 10,A01,889549,Grush; Rick Scott,16,0,22,6
1746588253495,PHIL 10,A02,889551,Grush; Rick Scott,22,0,22,0
1746588254526,PHIL 28,A01,889559,Lamey; Andy M.,0,2,31,31
1746588254526,PHIL 28,A02,889561,Lamey; Andy M.,0,1,30,30
1746588254526,PHIL 28,A03,889572,Lamey; Andy M.,0,1,30,30
1746588255557,PHIL 35,A00,907839,Staff,13,0,15,2
1746588256585,PHIL 60,A00,889574,Staff,73,0,90,17
1746588257612,PHIL 101,A00,958004,Staff,12,0,15,3
1746588259668,PHIL 136,A00,889582,Fulkerson; Matthew Todd,26,0,45,19
1746588260695,PHIL 163,A01,889601,Staff,21,0,30,9
1746588260695,PHIL 163,B01,889606,Brandt; Reuven A,0,3,0,0
1746588261721,PHIL 164,A00,889610,Staff,16,0,30,14
1746588262746,PHIL 165,A00,889613,Staff,22,0,30,8
1746588263769,PHYS 1A,A00,886431,Staff,29,0,70,41
1746588264797,PHYS 1AL,001,886432,Tsai; Philbert S,1,2,30,29
1746588264797,PHYS 1AL,002,886436,Tsai; Philbert S,12,0,30,18
1746588265826,PHYS 1B,A00,886439,Staff,184,0,240,56
1746588266851,PHYS 1BL,001,886441,Tsai; Philbert S,0,4,30,30
1746588266851,PHYS 1BL,002,886444,Tsai; Philbert S,2,0,30,28
1746588267876,PHYS 1C,A00,896092,Arnold; Kam S,78,0,146,68
1746588268904,PHYS 1CL,001,886448,Tsai; Philbert S,0,0,30,30
1746588268904,PHYS 1CL,002,886449,Tsai; Philbert S,1,0,30,29
1746588268904,PHYS 1CL,003,886450,Tsai; Philbert S,16,0,30,14
1746588268904,PHYS 1CL,004,886451,Tsai; Philbert S,15,0,30,15
1746588269936,PHYS 2B,A01,886457,Staff,67,0,115,48
1746588270964,PHYS 2C,A01,886460,Shotwell; Brian,0,9,65,65
1746588271992,PHYS 2CL,A01,886467,Staff,0,4,28,28
1746588271992,PHYS 2CL,A02,886468,Staff,0,3,28,28
1746588273017,PHYS 2D,A01,886470,Staff,10,0,50,40
1746588274044,PHYS 4B,A01,886475,Grinstein; Benjamin,22,0,40,18
1746588275071,POLI 5,A00,891173,Desposato; Scott,7,0,25,18
1746588276099,POLI 5D,A01,891175,Staff,5,0,5,0
1746588276099,POLI 5D,B01,891178,Staff,5,0,5,0
1746588277131,POLI 11,A00,891179,Ferree; Karen E,2,0,35,33
1746588278159,POLI 12,A00,891180,Staff,16,0,30,14
1746588279188,POLI 27,A01,891182,Staff,12,0,75,63
1746588280215,POLI 30,A00,891183,Staff,8,0,50,42
1746588281242,POLI 100B,A00,891244,Staff,5,1,35,30
1746588282270,POLI 100I,A00,891247,Staff,7,0,30,23
1746588283293,POLI 104J,A00,891248,Nichter; Maysa,14,0,30,16
1746588284319,POLI 104U,A00,891250,Nichter; Maysa,1,0,30,29
1746588286374,POLI 110B,A00,891255,Wiens; David,19,0,25,6
1746588287398,POLI 112A,A00,891256,Wiens; David,6,0,25,19
1746588288428,POLI 114BR,A00,891261,Staff,19,0,30,11
1746588289453,POLI 117R,A00,891262,Forman; Fonna,0,6,50,50
1746588290483,POLI 118,A00,891264,Ingham; Sean,17,0,25,8
1746588291532,POLI 124A,A00,891265,Staff,18,0,20,2
1746588292558,POLI 125D,A00,891266,Nichter; Simeon C,2,0,25,23
1746588293583,POLI 126,A00,891268,Nichter; Simeon C,7,0,25,18
1746588294609,POLI 126AA,A00,891272,Staff,15,0,25,10
1746588295635,POLI 130AA,A00,891273,Staff,15,0,20,5
1746588296664,POLI 134AA,A00,891274,Staff,4,0,20,16
1746588298716,POLI 138,A00,891278,Staff,21,0,25,4
1746588299746,POLI 142K,A00,891280,Staff,10,0,25,15
1746588300771,POLI 142M,A00,891281,Gartzke; Erik,16,0,30,14
1746588301796,POLI 142P,A00,891284,Staff,20,0,30,10
1746588302822,POLI 143,A00,891285,Gartzke; Erik,12,0,30,18
1746588303859,POLI 153,A00,891286,Staff,19,0,20,1
1746588305912,POLI 175,A00,891290,Staff,15,0,20,5
1746588306938,PSYC 1,A00,890674,Steiner; Eric Tomas,0,11,45,45
1746588307966,PSYC 2,A00,890676,Albright; Thomas D,20,0,35,15
1746588308990,PSYC 3,A00,890679,Staff,17,0,20,3
1746588310016,PSYC 6,A00,959858,Staff,19,0,20,1
1746588311041,PSYC 60,A01,890684,Rickard; Timothy C.,0,6,45,45
1746588312066,PSYC 70,A01,890689,Geller; Emma Harlan,6,0,30,24
1746588313090,PSYC 71,A01,959860,Staff,21,0,25,4
1746588314116,PSYC 100,A00,890690,Lacefield; Katharine I,0,50,180,180
1746588315143,PSYC 102,A00,890695,Staff,17,0,40,23
1746588316170,PSYC 105,A00,890699,Geller; Emma Harlan,70,0,100,30
1746588317195,PSYC 106,A00,890701,Gorman; Michael R.,5,0,30,25
1746588318221,PSYC 108,A00,890704,Adrian; Julia Anna,0,29,50,50
1746588319246,PSYC 118,A01,890712,Staff,11,0,30,19
1746588320272,PSYC 124,A00,890716,Chapman; Eddie Nathaniel,25,0,60,35
1746588321296,PSYC 131,A00,890717,Anagnostaras; Stephan,0,7,80,80
1746588322322,PSYC 137,A00,890719,Winkielman; Piotr,0,11,30,30
1746588323351,PSYC 144,A00,890721,Adrian; Julia Anna,0,9,45,45
1746588324375,PSYC 162,A00,890805,Staff,0,1,75,75
1746588325399,PSYC 169,A00,890810,Staff,0,15,30,30
1746588326423,PSYC 172,A00,890814,Gorman; Michael R.,9,0,30,21
1746588327449,PSYC 181,A00,890818,Anagnostaras; Stephan,7,0,200,193
1746588328476,PSYC 184,A00,959861,Staff,164,0,175,11
1746588329504,PSYC 189,A00,890823,Staff,0,2,30,30
1746588330533,PSYC 191,A00,890884,Rickard; Timothy C.,0,12,35,35
1746588331560,PSYC 193,A00,890913,Staff,19,0,30,11
1746588331560,PSYC 193,B00,890914,Chapman; Eddie Nathaniel,24,0,30,6
1746588332592,PSYC 193L,A01,890918,Lowe; Angela Beth,20,0,30,10
1746588332592,PSYC 193L,B01,890921,Hurwitz; Ethan Scott,20,0,30,10
1746588332592,PSYC 193L,C01,890928,Staff,30,0,30,0
1746588333617,RELI 149,A00,886806,Rahimi; Babak,23,0,40,17
1746588334642,SE 9,A01,886814,Staff,7,0,20,13
1746588335676,SE 101B,A01,886816,Chadha; Mayank,3,0,35,32
1746588336701,SE 110B,A00,886818,Zhu; Qiang,4,0,75,71
1746588337728,SE 125,A01,886830,Staff,10,0,30,20
1746588338754,SE 130B,A01,886835,Staff,14,0,40,26
1746588339782,SE 131A,A01,886838,Krysl; Petr,34,0,55,21
1746588340806,SE 154,A00,886840,Staff,28,0,50,22
1746588341830,SE 164GS,A01,886849,Staff,6,0,20,14
1746588342857,SE 167GS,A01,886853,Staff,6,0,20,14
1746588343887,SIO 25,A01,890107,Staff,19,0,30,11
1746588344913,SIO 45,A00,890109,Cook; Geoffrey W,116,0,200,84
1746588345943,SIO 109R,A00,890110,Forman; Fonna,0,16,20,20
1746588346968,SIO 187,A01,890114,Kacev; David,15,0,40,25
1746588347995,SOCI 1,A01,890431,Thorpe; Charles Robert,14,0,30,16
1746588347995,SOCI 1,A02,890518,Thorpe; Charles Robert,30,0,30,0
1746588349024,SOCI 2,A01,957978,Staff,25,0,25,0
1746588349024,SOCI 2,A02,957979,Staff,23,0,25,2
1746588350049,SOCI 20,A01,890523,Calderon-Zaks; Michael Aar,21,0,30,9
1746588350049,SOCI 20,A02,890526,Calderon-Zaks; Michael Aar,29,0,30,1
1746588351077,SOCI 30,A01,890533,Pardo Guerra; Juan Pablo,37,0,40,3
1746588352102,SOCI 40,A01,890535,Staff,27,0,45,18
1746588353131,SOCI 104Q,A00,890559,Staff,18,0,30,12
1746588354158,SOCI 106,A00,890560,Arnal; Maud Marie Leonie,20,0,30,10
1746588355185,SOCI 110,A00,890567,Holkenbrink-Monk; Charlene,19,0,30,11
1746588356213,SOCI 112,A00,890568,Victoria Torres; Pablo,2,0,55,53
1746588357239,SOCI 115,A00,890597,Arnal; Maud Marie Leonie,28,0,45,17
1746588359292,SOCI 121,A00,890604,Pardo Guerra; Juan Pablo,38,0,45,7
1746588360317,SOCI 126,A01,890608,Staff,8,0,10,2
1746588361346,SOCI 127,A00,890609,Staff,18,0,30,12
1746588362377,SOCI 131,A00,890610,Thorpe; Charles Robert,37,0,45,8
1746588363402,SOCI 135,A00,890615,Payne; Christine Anna,13,0,45,32
1746588364427,SOCI 139,A00,890620,Staff,38,0,45,7
1746588365454,SOCI 148E,A00,890622,Calderon-Zaks; Michael Aar,36,0,45,9
1746588366481,SOCI 150,A00,890623,Kohler; Kristopher M.,31,0,45,14
1746588367506,SOCI 157,A00,890625,Jules-Rosette; Bennetta W.,18,0,20,2
1746588368532,SOCI 160,A00,890627,Payne; Christine Anna,21,0,45,24
1746588369559,SYN 1,A00,886855,Fish; Gwendolyn Anne,0,1,0,0
1746588369559,SYN 1,B00,906086,Fish; Gwendolyn Anne,0,2,0,2
1746588370585,SYN 2R,A00,886860,Staff,0,17,15,15
1746588370585,SYN 2R,B00,906106,Atkinson; Arthur Laird,0,16,15,15
1746588371611,SYN 100,A01,886866,Browne; Emily,0,28,20,20
1746588371611,SYN 100,B01,906128,Rock; Martin,0,4,20,20
1746588371611,SYN 100,C01,906140,Deavenport; James Cary,0,4,20,20
1746588371611,SYN 100,D01,907816,Deavenport; James Cary,0,5,20,20
1746588372638,TDAC 1,A00,890286,Walsh; Kim C.,7,0,20,13
1746588373665,TDAC 101,A00,890296,Basso; Beatrice,15,0,20,5
1746588374695,TDDE 131,A00,890297,Staff,47,0,50,3
1746588375726,TDDM 1,A00,890287,Weinberg; Sadie,25,0,30,5
1746588376752,TDGE 11,A00,890288,Fulton; Julia,138,0,200,62
1746588376752,TDGE 11,B00,890289,Castro; Robert Jess,185,0,200,15
1746588377781,TDGE 25,B00,957359,Walsh; Kim C.,5,0,20,15
1746588378808,TDGE 40,A01,890292,Power; Jade Yukana,26,0,30,4
1746588379837,TDGE 124,A00,890298,Havis; Allan,0,2,50,50
1746588380866,TDGE 131R,A00,890299,Burelle; Julie Sara Veronique,15,0,42,27
1746588381893,TDHT 101,A00,890300,Staff,10,0,20,10
1746588382920,TDHT 109,A01,890302,Anderson; Mysia Anyse,31,0,40,9
1746588383947,TDMV 1,A00,890293,Arcidiacono; Kristin,18,0,30,12
1746588384975,TDMV 2,A00,890294,Weinberg; Sadie,23,0,30,7
1746588386004,TDMV 3,A00,957878,Arcidiacono; Kristin,28,0,30,2
1746588388059,TDMV 138,A00,890304,Jun; Grace Shin Hae,25,0,40,15
1746588389085,TDMV 140,A00,890305,Corrales; Joseph Bernales,25,0,30,5
1746588390110,TDMV 142,A00,890307,Caligagan; Tony,32,0,40,8
1746588391136,TDMV 144,A00,890308,Camaya; Michelle Ann,25,0,30,5
1746588392166,TDPW 1,A00,890295,Stein; Deborah Isobel,3,0,20,17
1746588393193,USP 2,A01,890272,Lerner; Amy M,7,0,20,13
1746588394217,USP 3,A01,890274,Staff,12,0,30,18
1746588395244,USP 15,A01,890276,Sun; Feiyang,16,0,30,14
1746588396270,USP 25,A00,890277,Shenkman; Michael Thomas,18,0,25,7
1746588397299,USP 138,A00,890278,Staff,13,0,25,12
1746588398324,USP 143,A00,890279,Staff,22,0,70,48
1746588399354,USP 144,A00,890280,Chowdhury; Muhammed Zohir,16,0,30,14
1746588400378,USP 150,A00,890281,Boomhower; Matthew Charles,4,0,30,26
1746588401402,USP 151,A00,890282,Staff,16,0,20,4
1746588402428,USP 162,A00,890283,Andrews; Abigail Leslie,16,0,20,4
1746588403457,USP 168,A00,920477,Kwak; Nancy,0,0,5,5
1746588404522,USP 181,A00,890284,Staff,3,0,20,17
1746588405548,USP 191A,A00,890285,Staff,12,0,20,8
1746588406577,VIS 101,A00,886512,Staff,26,0,75,49
1746588407606,VIS 103,A00,886513,Cruz; Edwin Teddy,61,0,75,14
1746588408635,VIS 108,A00,886514,Staff,3,0,15,12
1746588409665,VIS 127P,A00,886515,Shen; Kuiyi,79,0,146,67
1746588410688,VIS 149,A00,886516,Yoldas; Pinar,0,0,15,15
1746588411714,VIS 164,A00,886526,Erdmann; Dean,19,0,22,3
1746588412739,VIS 194S,A00,886527,Staff,61,0,75,14
1746588413770,WCWP 10A,C00,886484,Martiniuk; Jill,12,0,15,3
1746588414796,WCWP 10B,A00,886490,Uriarte; Emma,0,0,15,15
1746588414796,WCWP 10B,B00,886491,Dhir; Simrita,8,0,15,7
1746588414796,WCWP 10B,C00,886492,Ornelas; Tricia,0,0,15,15
1746588415825,WCWP 100,A00,886494,Young; Mark T,0,6,15,15
1746588417893,AAS 10,A01,886199,Childs; Dennis R.,0,3,0,0
1746588418919,ANAR 104,A01,886940,Shtienberg; Gilad,27,0,30,3
1746588419949,ANAR 120,A00,886953,Staff,13,0,20,7
1746588420973,ANBI 148,A01,886955,Wilder; Linnea Lorene,30,0,40,10
1746588423025,ANSC 122,A00,886957,Staff,24,0,30,6
1746588424051,ANSC 150,A00,886958,Sloane; Julia Kathryn,2,0,15,13
1746588425078,ANSC 156,A00,886959,Jenkins; Janis A.,0,1,15,15
1746588426106,ANSC 180,A00,886960,Staff,11,0,17,6
1746588427136,ANSC 188,A00,886961,Jassal; Aftab,9,0,25,16
1746588428162,ANSC 190,A00,886962,Jassal; Aftab,14,0,25,11
1746588429190,ANSC 191,A00,886963,Staff,18,0,20,2
1746588430214,ANTH 3,A01,891689,Staff,17,0,20,3
1746588431241,ANTH 5,A00,886933,Semendeferi; Ekaterini,16,0,20,4
1746588432267,ANTH 10,A00,886934,Staff,0,12,30,30
1746588433295,ANTH 21,A01,886936,Staff,41,0,60,19
1746588434322,ANTH 23,A01,886938,Staff,92,0,100,8
1746588435350,ANTH 105,A00,886964,Stewart; Alexander B,84,0,100,16
1746588436374,ANTH 108,A00,886965,Pedersen; David,9,0,20,11
1746588437406,AWP 10,001,886147,Staff,0,0,0,0
1746588437406,AWP 10,002,886148,Staff,0,0,0,0
1746588437406,AWP 10,003,886149,Staff,0,0,0,0
1746588437406,AWP 10,004,886150,Staff,0,0,0,0
1746588437406,AWP 10,005,886151,Staff,0,0,0,0
1746588437406,AWP 10,006,886152,Staff,0,0,0,0
1746588437406,AWP 10,007,886153,Staff,0,0,0,0
1746588437406,AWP 10,008,886154,Staff,0,0,0,0
1746588437406,AWP 10,009,886155,Staff,0,0,0,0
1746588437406,AWP 10,010,886156,Staff,0,0,0,0
1746588437406,AWP 10,011,886158,Staff,0,0,0,0
1746588437406,AWP 10,012,886160,Staff,0,0,0,0
1746588437406,AWP 10,013,886161,Staff,0,0,0,0
1746588437406,AWP 10,014,886162,Staff,0,0,0,0
1746588437406,AWP 10,015,886163,Staff,0,0,0,0
1746588437406,AWP 10,016,886164,Staff,0,0,0,0
1746588437406,AWP 10,017,886165,Staff,0,0,0,0
1746588437406,AWP 10,018,886166,Staff,0,0,0,0
1746588437406,AWP 10,019,886168,Staff,0,0,0,0
1746588437406,AWP 10,020,886170,Staff,0,0,0,0
1746588437406,AWP 10,021,886172,Staff,0,0,0,0
1746588438439,AWP 10R,001,886173,Staff,0,1,0,0
1746588438439,AWP 10R,002,886174,Staff,0,1,0,0
1746588438439,AWP 10R,003,886175,Staff,0,0,0,0
1746588438439,AWP 10R,004,886176,Staff,0,0,0,0
1746588438439,AWP 10R,005,886177,Staff,0,0,0,0
1746588438439,AWP 10R,006,886178,Staff,0,0,0,0
1746588438439,AWP 10R,007,886179,Staff,0,0,0,0
1746588438439,AWP 10R,008,886181,Staff,0,0,0,0
1746588438439,AWP 10R,009,886182,Staff,0,0,0,0
1746588438439,AWP 10R,010,886183,Staff,0,0,0,0
1746588438439,AWP 10R,011,886184,Staff,0,0,0,0
1746588438439,AWP 10R,012,886185,Staff,0,0,0,0
1746588438439,AWP 10R,013,886186,Staff,0,0,0,0
1746588438439,AWP 10R,014,886187,Staff,0,0,0,0
1746588438439,AWP 10R,015,886188,Staff,0,0,0,0
1746588438439,AWP 10R,016,886189,Staff,0,0,0,0
1746588438439,AWP 10R,017,960532,Staff,0,0,0,0
1746588438439,AWP 10R,018,960533,Staff,0,0,0,0
1746588438439,AWP 10R,019,960534,Staff,0,0,0,0
1746588438439,AWP 10R,020,960538,Staff,0,0,0,0
1746588438439,AWP 10R,021,960540,Staff,0,0,0,0
1746588438439,AWP 10R,022,960541,Staff,0,0,0,0
1746588438439,AWP 10R,023,960542,Staff,0,0,0,0
1746588438439,AWP 10R,024,960544,Staff,0,0,0,0
1746588438439,AWP 10R,025,960545,Staff,0,0,0,0
1746588438439,AWP 10R,026,960548,Staff,0,0,0,0
1746588439466,AWP 102R,A00,886190,Staff,0,0,0,0
1746588439466,AWP 102R,B00,886191,Staff,0,0,0,0
1746588440491,BENG 100,A01,886193,Staff,17,0,30,13
1746588441516,BENG 122A,A01,886195,Hasty; Jeff M,13,0,30,17
1746588442544,BENG 166A,A00,886196,Sah; Robert Lie-Yuan,0,3,30,30
1746588443567,BENG 190,A00,958050,Khojah; Reem I,17,0,25,8
1746588444597,BIBC 102,A01,894320,Staff,0,0,46,46
1746588444597,BIBC 102,A02,894321,Staff,0,0,46,46
1746588444597,BIBC 102,A03,894344,Staff,6,0,46,40
1746588444597,BIBC 102,A04,894345,Staff,27,0,47,20
1746588445624,BICD 100R,A01,894365,Smith; Laurie,1,3,58,57
1746588445624,BICD 100R,A02,894366,Smith; Laurie,1,5,58,57
1746588445624,BICD 100R,A03,894367,Smith; Laurie,0,0,59,59
1746588445624,BICD 100R,A04,959869,Smith; Laurie,40,0,59,19
1746588446653,BICD 136,A01,894383,Gustafson-Brown; Cindy,14,0,50,36
1746588447681,BIEB 102,A01,894494,Butler; Shannon Rhey,51,0,130,79
1746588449735,BIEB 150,A01,894617,Wills; Christopher,3,0,20,17
1746588449735,BIEB 150,A02,894631,Wills; Christopher,3,0,20,17
1746588449735,BIEB 150,A03,894937,Wills; Christopher,3,0,20,17
1746588449735,BIEB 150,A04,894946,Wills; Christopher,5,0,20,15
1746588450760,BIEB 194,A00,906141,Kurle; Carolyn M.,5,0,20,15
1746588451790,BILD 1,A01,894154,Staff,3,0,19,16
1746588451790,BILD 1,A02,894155,Staff,14,0,19,5
1746588451790,BILD 1,A03,894160,Staff,13,0,19,6
1746588451790,BILD 1,A04,894161,Staff,15,0,18,3
1746588452816,BILD 2,A01,894168,Staff,0,0,50,50
1746588452816,BILD 2,A02,894169,Staff,0,0,50,50
1746588452816,BILD 2,A03,894179,Staff,0,0,50,50
1746588452816,BILD 2,A04,894203,Staff,23,0,50,27
1746588453847,BILD 3,A01,894213,Staff,23,0,31,8
1746588453847,BILD 3,A02,894214,Staff,26,0,31,5
1746588453847,BILD 3,A03,894235,Staff,28,0,31,3
1746588453847,BILD 3,A04,894236,Staff,28,0,32,4
1746588454876,BILD 4,A01,894253,Reuther; Keefe,5,0,24,19
1746588454876,BILD 4,A02,894258,Reuther; Keefe,16,0,24,8
1746588455900,BILD 5,A01,894276,Reuther; Keefe,34,0,50,16
1746588455900,BILD 5,A02,894277,Reuther; Keefe,45,0,50,5
1746588455900,BILD 5,A03,894290,Reuther; Keefe,44,0,50,6
1746588455900,BILD 5,A04,894291,Reuther; Keefe,48,0,50,2
1746588456930,BILD 24,A01,894297,Pirino; Giorgia,40,0,60,20
1746588457956,BIMM 100,B01,958915,Staff,71,0,100,29
1746588458986,BIMM 101,A01,895017,McDonnell; Lisa Marie,0,5,24,24
1746588458986,BIMM 101,A02,895018,McDonnell; Lisa Marie,0,5,24,24
1746588458986,BIMM 101,B01,895020,McDonnell; Lisa Marie,0,6,24,24
1746588458986,BIMM 101,B02,895021,McDonnell; Lisa Marie,0,4,24,24
1746588460017,BIMM 110,A01,895023,Staff,1,0,25,24
1746588460017,BIMM 110,A02,895024,Staff,9,0,25,16
1746588460017,BIMM 110,A03,895025,Staff,18,0,25,7
1746588460017,BIMM 110,A04,895031,Staff,20,0,25,5
1746588461048,BIMM 120,A01,895114,Gustafson-Brown; Cindy,14,0,28,14
1746588461048,BIMM 120,A02,895126,Gustafson-Brown; Cindy,21,0,27,6
1746588462075,BIPN 100,A01,895130,Yang; Mingyu,0,0,38,38
1746588462075,BIPN 100,A02,895131,Yang; Mingyu,31,0,38,7
1746588462075,BIPN 100,A03,895132,Yang; Mingyu,32,0,38,6
1746588462075,BIPN 100,A04,895133,Yang; Mingyu,27,0,36,9
1746588463100,BIPN 120,A01,895135,Cooke; James Edward,0,3,13,13
1746588463100,BIPN 120,A02,895136,Cooke; James Edward,0,1,13,13
1746588463100,BIPN 120,A03,895137,Cooke; James Edward,0,3,13,13
1746588463100,BIPN 120,A04,895156,Cooke; James Edward,0,2,11,11
1746588464130,BIPN 134,A01,895235,Cooke; James Edward,0,2,25,25
1746588464130,BIPN 134,A02,895237,Cooke; James Edward,0,0,25,25
1746588464130,BIPN 134,A03,895240,Cooke; James Edward,3,0,25,22
1746588464130,BIPN 134,A04,895270,Cooke; James Edward,20,0,25,5
1746588465156,BIPN 189,A00,892103,Staff,0,14,14,14
1746588467210,BISP 194,A00,958008,Staff,0,2,0,0
1746588468238,CAT 124,A01,922009,Staff,0,5,20,20
1746588469264,CAT 125R,A00,886390,Morales; Celeste Georgianna,0,3,20,20
1746588469264,CAT 125R,B00,886391,Irwin; Matthew Joseph,0,4,20,20
1746588469264,CAT 125R,C00,886392,Smith; Lauryn Alissa,0,2,20,20
1746588469264,CAT 125R,D00,886393,Vanderschuit; Maya Alysia,0,3,20,20
1746588469264,CAT 125R,E00,886394,Marchisotto; Jennifer Anne,0,3,20,20
1746588470293,CENG 15,A01,886218,Drews; Aaron,3,0,8,5
1746588471322,CENG 113,A00,886219,Opatkiewicz; Justin Paul,15,0,25,10
1746588472365,CGS 101,A00,887044,Staff,7,0,20,13
1746588473394,CGS 105,A01,887046,Staff,14,0,25,11
1746588474422,CGS 112,A00,887047,Cuong; Marisol,12,0,15,3
1746588475451,CGS 113,A00,887048,Staff,23,0,30,7
1746588476478,CGS 120,A00,887049,Staff,10,0,17,7
1746588477503,CHEM 6A,A01,886336,Lam; Tin Yiu,38,0,50,12
1746588477503,CHEM 6A,A02,886338,Lam; Tin Yiu,37,0,50,13
1746588478530,CHEM 6B,A01,886341,Hopkins; Patrycja Anna,16,0,50,34
1746588478530,CHEM 6B,A02,886343,Hopkins; Patrycja Anna,42,0,50,8
1746588479554,CHEM 6C,A01,886346,Albizati; Kim F.,0,2,50,50
1746588479554,CHEM 6C,A02,886348,Albizati; Kim F.,24,0,50,26
1746588480580,CHEM 40A,A01,886352,Klosterman; Jeremy K,65,0,100,35
1746588481606,CHEM 40B,A01,886356,Klosterman; Jeremy K,0,24,100,100
1746588482632,CHEM 41B,A01,886360,Theodorakis; Emmanuel,25,0,50,25
1746588482632,CHEM 41B,A02,886362,Theodorakis; Emmanuel,47,0,50,3
1746588483662,CHIN 165A,A00,886382,Xu; Li,18,0,20,2
1746588484686,CLAS 120,A00,886387,Myerston Santana; Jacobo,33,0,40,7
1746588485712,COGS 9,A01,886967,Shannon; Kyle Michael,42,0,60,18
1746588486737,COGS 11,A01,886969,Staff,9,0,30,21
1746588487766,COGS 14A,A01,886971,Staff,6,0,60,54
1746588488795,COGS 14B,A01,886973,Hoffman; Drew Ellen,4,0,60,56
1746588489826,COGS 18,A01,886975,Morgan; Eric,34,0,60,26
1746588490855,COGS 20,A01,886977,Staff,2,0,8,6
1746588490855,COGS 20,A02,886978,Staff,4,0,7,3
1746588491882,COGS 100,A01,907783,Staff,1,2,30,29
1746588492907,COGS 101B,A01,886980,Staff,0,4,48,48
1746588493934,COGS 101C,A01,886982,Delgado; Tania,0,5,44,44
1746588494964,COGS 102A,A01,886984,Johnson; Christine M.,3,0,30,27
1746588495996,COGS 118B,A01,886986,Staff,1,5,88,87
1746588497020,COGS 150,A01,886988,Bergen; Benjamin,22,0,50,28
1746588498045,COGS 153,A00,886989,Delgado; Tania,0,3,41,41
1746588499070,COGS 186,A01,886991,Staff,0,0,32,32
1746588500095,COGS 187A,A01,886993,Boyle; Mary E. T.,7,0,30,23
1746588501119,COGS 189,A00,886994,Staff,0,1,30,30
1746588502148,COMM 10,A01,886996,Staff,0,0,20,21
1746588502148,COMM 10,A02,886997,Staff,10,0,20,10
1746588502148,COMM 10,A03,959845,Staff,19,0,20,1
1746588503171,COMM 20,A01,886999,Leuning; Grant Maurstad,24,0,40,16
1746588505223,COMM 100A,A01,887002,Staff,0,0,20,25
1746588505223,COMM 100A,A02,887003,Staff,6,0,20,14
1746588506248,COMM 100B,A01,887005,Staff,0,8,20,24
1746588507274,COMM 106D,A00,887006,Staff,13,0,40,27
1746588508298,COMM 110G,A00,887007,Whitworth-Smith; Andrew C,12,0,40,28
1746588509324,COMM 111B,A00,887008,Staff,31,0,40,9
1746588510353,COMM 113T,A00,887009,Abuelhiga; Soraya Jill,28,0,40,12
1746588510353,COMM 113T,B00,906733,Staff,40,0,40,0
1746588511380,COMM 145,A00,887010,Staff,12,0,40,28
1746588512408,COMM 146,A00,887054,Staff,31,0,40,9
1746588513434,COMM 190,A00,887012,Staff,8,0,23,15
1746588514463,CSE 8A,A50,887015,Cao; Yingjun,57,0,85,28
1746588515492,CSE 11,A01,887017,Cao; Yingjun,11,0,70,59
1746588516518,CSE 20,A01,887019,Staff,30,0,50,20
1746588517544,CSE 21,A01,887021,Staff,78,0,100,22
1746588517544,CSE 21,B01,892583,Braun; Oliver,45,0,50,5
1746588518574,CSE 30,A01,887025,Eldon; John,142,0,200,58
1746588519600,CSE 100,A01,887027,Staff,26,0,50,24
1746588519600,CSE 100,A02,887028,Staff,42,0,50,8
1746588520633,CSE 101,A01,887030,Braun; Oliver,74,0,100,26
1746588520633,CSE 101,B01,887032,Jones; Miles E,0,3,50,50
1746588520633,CSE 101,B02,887033,Jones; Miles E,0,2,50,50
1746588521660,CSE 105,A01,908084,Jones; Miles E,32,0,50,18
1746588521660,CSE 105,A02,908087,Jones; Miles E,31,0,50,19
1746588522684,CSE 135,A01,887035,Powell; Thomas Allan,0,5,50,50
1746588523710,CSE 142,A01,887037,Staff,8,0,60,52
1746588524738,CSE 142L,A01,887039,Staff,34,0,60,26
1746588525767,CSE 151A,A01,887041,Solares; Edwin A,47,0,100,53
1746588526793,CSE 175,A01,887043,Kumar; Rakesh,30,0,30,0
1746588527817,CSS 1,A01,886389,Staff,1,2,40,39
1746588528843,DSC 30,A01,908097,Liao; Soohyun Nam,47,0,75,28
1746588529870,DSC 40A,A01,908099,Shannon; Kyle Michael,30,0,50,20
1746588530894,DSC 40B,A01,908112,Staff,15,0,50,35
1746588531918,DSC 80,A01,908116,Staff,19,0,60,41
1746588532948,DSC 197,001,956863,Eldridge; Justin Matthew,9999,0,9999,0
1746588533993,ECE 5,A01,886400,Morris; Karcher William,1,0,6,5
1746588533993,ECE 5,A02,886401,Morris; Karcher William,3,0,6,3
1746588535023,ECE 148,A01,886403,Silberman; Jack,0,14,14,14
1746588536047,ECON 1,A01,887265,Crane; Meredith Helen,11,0,70,59
1746588536047,ECON 1,B01,887268,Staff,42,0,50,8
1746588537076,ECON 2,A01,887273,Crane; Meredith Helen,54,0,70,16
1746588538101,ECON 3,A01,887279,Rondina; Giacomo,31,0,70,39
1746588539128,ECON 4,A01,887282,Anderson; John Charles,0,2,10,10
1746588540157,ECON 5,A01,887285,Staff,34,0,45,11
1746588540157,ECON 5,B01,887292,Staff,41,0,45,4
1746588541186,ECON 100A,A01,887337,Newhouse; Herbert S,54,0,70,16
1746588541186,ECON 100A,B01,887349,Staff,45,0,50,5
1746588542221,ECON 100B,A01,887361,Du; Songzi,29,0,70,41
1746588543248,ECON 100C,A01,887445,Newhouse; Herbert S,59,0,70,11
1746588544273,ECON 105,A00,887488,Vespa; Emanuel Ignacio,23,0,35,12
1746588545298,ECON 109,A01,887506,Shishkin; Denis,28,0,35,7
1746588546323,ECON 110A,A01,887568,Alon; Titan Michael,1,3,35,34
1746588546323,ECON 110A,B01,907601,Alon; Titan Michael,20,0,35,15
1746588547348,ECON 110B,A01,887598,Levkoff; Steven B.,0,24,70,70
1746588548374,ECON 112,A00,887599,Rondina; Giacomo,19,0,35,16
1746588549398,ECON 120A,A01,887603,Dai; Yinlin,35,0,70,35
1746588550423,ECON 120C,A01,887608,Sun; Yixiao,0,1,35,35
1746588550423,ECON 120C,B01,887614,Sun; Yixiao,0,0,35,35
1746588551447,ECON 138,A00,887621,Bharadwaj; Prashant,0,21,20,20
1746588552476,ECON 144,A00,958007,Squires; Dale E,12,0,35,23
1746588553499,ECON 171,A01,907666,Staff,18,0,35,17
1746588554524,ECON 175,A00,887626,Wu; Pak Yeung,22,0,35,13
1746588555549,ECON 190,A00,887640,Vespa; Emanuel Ignacio,22,0,35,13
1746588556579,EDS 25,A01,888197,Staff,0,0,0,0
1746588556579,EDS 25,A02,888209,Staff,0,0,0,0
1746588556579,EDS 25,A03,888210,Staff,0,0,0,0
1746588556579,EDS 25,A04,888212,Staff,0,0,0,0
1746588556579,EDS 25,A05,888213,Staff,0,0,0,0
1746588556579,EDS 25,A06,888214,Staff,0,0,0,0
1746588556579,EDS 25,A07,888235,Staff,0,2,0,0
1746588556579,EDS 25,A08,888236,Staff,0,0,0,0
1746588556579,EDS 25,A09,888240,Staff,0,0,0,0
1746588556579,EDS 25,A10,888244,Staff,0,0,0,0
1746588556579,EDS 25,B01,888273,Staff,0,0,0,0
1746588556579,EDS 25,B02,888285,Staff,0,0,0,0
1746588556579,EDS 25,B03,888423,Staff,0,0,0,1
1746588556579,EDS 25,B04,888432,Staff,0,0,0,0
1746588556579,EDS 25,B05,888433,Staff,0,0,0,0
1746588556579,EDS 25,B06,888467,Staff,0,0,0,0
1746588556579,EDS 25,B07,888468,Staff,0,0,0,0
1746588556579,EDS 25,B08,888479,Staff,0,0,0,0
1746588556579,EDS 25,B09,888484,Staff,0,0,0,0
1746588556579,EDS 25,B10,888487,Staff,0,0,0,0
1746588557606,EDS 38,A01,907700,Choi; Bailey Miyeon,30,0,30,0
1746588558631,EDS 112,A01,888601,Chapman; Thandeka K,12,0,40,28
1746588559655,EDS 115,A00,888697,Mendez; Kathrina Mendoza,10,0,30,20
1746588560680,EDS 116,A01,888893,Staff,33,0,40,7
1746588562732,EDS 124AR,A00,889133,Staff,29,0,50,21
1746588562732,EDS 124AR,B00,907471,Simon; Elizabeth A,37,0,50,13
1746588563756,EDS 124BR,A00,889134,Simon; Elizabeth A,44,0,100,56
1746588564781,EDS 125,A00,889135,Staff,25,0,30,5
1746588565807,EDS 126,A01,889138,Staff,35,0,40,5
1746588566832,EDS 164R,A01,889142,Wishard Guerra; Alison G.,32,0,50,18
1746588567857,ENG 30,A01,886396,Staff,0,0,0,0
1746588567857,ENG 30,B01,886398,Staff,0,0,0,0
1746588568885,ENVR 102,A00,906150,Montejo; Carolina,23,0,25,2
1746588569910,ETHN 103A,A00,887236,Man; Simeon S,0,3,0,0
1746588570935,ETHN 113,A00,887239,Staff,16,0,30,14
1746588571961,ETHN 116,A00,887240,Staff,16,0,25,9
1746588572988,ETHN 117,A00,887241,Choi; Esther Min,28,0,30,2
1746588574013,ETHN 118,A00,887243,Staff,24,0,30,6
1746588575038,ETHN 127,A00,887248,Cuong; Marisol,11,0,15,4
1746588576067,ETHN 139,A00,887250,Staff,7,0,10,3
1746588577096,ETHN 142,A00,887252,Staff,10,0,30,20
1746588578124,ETHN 161,A00,887253,Browne; Errol Tsekani,24,0,30,6
1746588579173,ETHN 163FR,A00,887255,Burelle; Julie Sara Veronique,0,0,5,5
1746588580199,GLBH 20,A00,889149,Elwardani; Nile Regina,8,0,42,34
1746588582253,GLBH 111,A01,889152,Burgos; Jose L.,17,0,17,0
1746588583280,GLBH 150,A00,889181,Sloane; Julia Kathryn,0,5,15,15
1746588585336,HDS 60,A01,886406,Warstadt; Melissa Fawn,73,0,80,7
1746588586361,HIAF 111,A00,889324,Gyamfi; Bright,25,0,32,7
1746588587388,HIEA 131,A00,889328,Staff,15,0,32,17
1746588588416,HIEA 144,A00,889333,Henry; Todd A.,26,0,32,6
1746588589441,HIEA 154,A00,889336,Henry; Todd A.,24,0,32,8
1746588590467,HIEU 106,A00,889339,Staff,22,0,32,10
1746588592525,HIEU 114,A00,889340,Staff,4,0,32,28
1746588593551,HIEU 135GS,A00,889342,Patterson; Patrick H.,0,0,1,24
1746588594575,HIEU 137,A00,889343,Edington; Claire Ellen,10,0,25,15
1746588595606,HIEU 148,A00,889345,Staff,14,0,32,18
1746588596631,HIEU 154,A00,889346,Biess; Frank Peter,21,0,32,11
1746588597657,HILA 102,A00,889351,Staff,12,0,32,20
1746588598686,HILD 2A,A01,889221,Lewandoski; Julia Mavis,2,10,32,30
1746588599714,HILD 7B,A01,889225,Man; Simeon S,0,12,32,32
1746588600739,HILD 7C,A01,889288,Alvarez; Luis A,0,14,32,32
1746588601768,HILD 30,A01,889323,Staff,0,5,32,32
1746588603823,HISC 119,A00,889383,Golan; Tal,19,0,32,13
1746588604848,HIUS 103,A00,889384,Man; Simeon S,0,0,32,32
1746588605876,HIUS 117,A00,919797,Kwak; Nancy,18,0,32,14
1746588606900,HIUS 142A,A00,919788,Staff,22,0,32,10
1746588608953,HIUS 149,A00,889386,Gyamfi; Bright,26,0,32,6
1746588609979,HIUS 155,A00,889387,Alvarez; Luis A,15,0,32,17
1746588611005,HUM 3,A01,886499,Caldwell; Michael Alan,19,0,50,31
1746588612030,HUM 3GS,A00,886500,Rodriguez; Bretton Sigfred,0,0,0,28
1746588613055,HUM 3R,A01,886502,Markman; Kristina,0,36,50,50
1746588614083,HUM 4,A01,886504,Crum; Matthew Stephen,23,0,50,27
1746588614083,HUM 4,B01,886506,West; Geoffrey Scott,17,0,50,33
1746588615108,HUM 4GS,A00,886507,Staff,0,0,0,19
1746588616137,HUM 5,A01,886509,Staff,32,0,50,18
1746588617163,HUM 5R,A01,886511,Zavodny; Tatiana Sophia,0,39,50,50
1746588618192,JAPN 180,A00,886407,Staff,16,0,40,24
1746588619217,LATI 50,A01,886409,Martin-Cabrera; Luis,3,0,22,19
1746588619217,LATI 50,A02,886410,Martin-Cabrera; Luis,19,0,22,3
1746588619217,LATI 50,A03,886411,Martin-Cabrera; Luis,21,0,22,1
1746588619217,LATI 50,A04,886412,Martin-Cabrera; Luis,8,0,22,14
1746588620244,LAWS 101,A00,907664,Staff,28,0,60,32
1746588621269,LIAB 1A,A00,889388,Saab; Dima,17,0,20,3
1746588622308,LIAB 1AX,A00,889389,El Cheddadi; Youniss,18,0,20,2
1746588623337,LIFR 1C,A00,889391,Van Moer; Vinciane G,8,0,20,12
1746588624361,LIFR 1CX,A00,889392,Van Moer; Vinciane G,7,0,20,13
1746588625386,LIFR 1D,A00,889393,Van Moer; Vinciane G,7,0,20,13
1746588626413,LIFR 1DX,A00,889394,Van Moer; Vinciane G,8,0,20,12
1746588627442,LIGN 7,A00,886923,Staff,24,0,50,26
1746588628471,LIGN 17,A00,886924,Kehler; Andrew Scott,125,0,150,25
1746588629495,LTAM 110,A00,889395,Staff,15,0,30,15
1746588630519,LTAM 110GS,A00,958010,Rodriguez; Bretton Sigfred,0,0,0,28
1746588631546,LTCH 101,A00,889397,Staff,23,0,25,2
1746588632573,LTCS 130,A00,889398,Staff,23,0,25,2
1746588633597,LTEA 138,A00,889399,Staff,24,0,40,16
1746588634628,LTEN 149,A00,889400,Wesling; Megan E.,0,3,25,25
1746588635655,LTEN 169,A00,889401,Staff,20,0,25,5
1746588636679,LTEN 180,A00,889402,Staff,10,0,15,5
1746588637705,LTEN 181,A00,889403,Staff,21,0,25,4
1746588638731,LTWL 100,A00,889404,Myerston Santana; Jacobo,2,0,25,23
1746588639757,LTWL 180GS,A00,889405,Staff,0,0,20,20
1746588640782,LTWL 181,A00,889406,Staff,16,0,25,9
1746588641806,LTWL 184,A00,889475,Mukherjee; Silpa,22,0,25,3
1746588642832,LTWR 102C,A00,889486,Staff,29,0,30,1
1746588643860,LTWR 115W,A00,889491,Staff,0,2,15,15
1746588644888,MAE 8,A01,886905,Staff,0,2,0,0
1746588645921,MAE 11,A00,886906,Bandaru; Prabhakar,0,7,50,50
1746588646946,MAE 20,A00,886907,Evdokimenko; Ekaterina,43,0,70,27
1746588647977,MAE 30B,A00,886909,Ghazinejad; Maziar,26,0,45,19
1746588649005,MAE 101B,A00,886910,Saintillan; David,29,0,45,16
1746588650030,MAE 105,A00,886911,Bandaru; Prabhakar,18,0,50,32
1746588651057,MAE 107,B00,958024,Staff,7,0,50,43
1746588652083,MAE 143B,A00,886913,Bewley; Thomas R,3,0,40,37
1746588653112,MAE 148,A01,886915,Silberman; Jack,0,3,14,14
1746588654137,MAE 160,A00,886916,Evdokimenko; Ekaterina,31,0,60,29
1746588655165,MATH 3C,A01,889681,Staff,0,2,30,30
1746588655165,MATH 3C,A02,960048,Staff,23,0,30,7
1746588656190,MATH 10A,A01,889760,Staff,26,0,30,4
1746588656190,MATH 10A,A02,889783,Staff,29,0,30,1
1746588657216,MATH 10B,A01,889785,Verstraete; Jacques Allan,1,0,35,34
1746588657216,MATH 10B,A02,889795,Verstraete; Jacques Allan,4,0,35,31
1746588657216,MATH 10B,B01,889797,Verstraete; Jacques Allan,3,0,35,32
1746588657216,MATH 10B,B02,889828,Verstraete; Jacques Allan,3,0,35,32
1746588658248,MATH 10C,A01,889849,Habib; Yousaf,7,0,30,23
1746588658248,MATH 10C,A02,889852,Habib; Yousaf,14,0,30,16
1746588658248,MATH 10C,A03,889853,Habib; Yousaf,22,0,30,8
1746588658248,MATH 10C,A04,889858,Habib; Yousaf,20,0,30,10
1746588658248,MATH 10C,B01,889861,Staff,1,0,30,29
1746588658248,MATH 10C,B02,889862,Staff,24,0,30,6
1746588658248,MATH 10C,B03,889863,Staff,27,0,30,3
1746588658248,MATH 10C,B04,889967,Staff,23,0,30,7
1746588659276,MATH 18,A01,889974,Staff,7,0,30,23
1746588659276,MATH 18,A02,889977,Staff,20,0,30,10
1746588659276,MATH 18,B01,889984,Hardiman; Liam,20,0,30,10
1746588659276,MATH 18,B02,889985,Hardiman; Liam,25,0,30,5
1746588660300,MATH 20A,A01,889990,Suk; Andrew Hoon,30,0,35,5
1746588661326,MATH 20B,A01,889993,Ohm; Ko Woon,21,0,30,9
1746588661326,MATH 20B,A02,889994,Ohm; Ko Woon,30,0,30,0
1746588661326,MATH 20B,B01,889996,Ohm; Ko Woon,22,0,30,8
1746588661326,MATH 20B,B02,889997,Ohm; Ko Woon,23,0,30,7
1746588662359,MATH 20C,A01,889999,Hammock; Frances H,17,0,30,13
1746588662359,MATH 20C,A02,890003,Hammock; Frances H,23,0,30,7
1746588662359,MATH 20C,B01,890006,Hammock; Frances H,3,0,30,27
1746588662359,MATH 20C,B02,890007,Hammock; Frances H,12,0,30,18
1746588663397,MATH 20D,A01,890011,Cheng; Hsiao-Bing,1,1,30,29
1746588663397,MATH 20D,A02,890012,Cheng; Hsiao-Bing,14,0,30,16
1746588663397,MATH 20D,B01,890016,Cheng; Hsiao-Bing,13,0,30,17
1746588663397,MATH 20D,B02,890017,Cheng; Hsiao-Bing,13,0,30,17
1746588664421,MATH 20E,A01,890026,Harel; Guershon,1,0,30,29
1746588664421,MATH 20E,A02,890029,Harel; Guershon,22,0,30,8
1746588664421,MATH 20E,B01,890033,Harel; Guershon,7,0,30,23
1746588664421,MATH 20E,B02,890101,Harel; Guershon,21,0,30,9
1746588665452,MATH 102,A01,890104,Staff,18,0,30,12
1746588665452,MATH 102,A02,890105,Staff,27,0,30,3
1746588666481,MATH 103B,A01,890116,Salehi Golsefidy; Alireza,3,0,30,27
1746588666481,MATH 103B,B01,890118,Staff,0,3,34,34
1746588667508,MATH 109,A01,890121,Aliabadi Sr.; Mohsen,0,0,30,30
1746588667508,MATH 109,B01,890124,Upadrashta; Pranav Kumar,18,0,30,12
1746588668537,MATH 120A,A01,890126,Eggers; John Dietrich,13,0,30,17
1746588669567,MATH 142B,A01,890128,Ioana; Adrian,19,0,30,11
1746588669567,MATH 142B,A02,890129,Ioana; Adrian,12,0,30,18
1746588670596,MATH 154,A01,890174,Staff,0,1,30,30
1746588670596,MATH 154,A02,890182,Staff,0,0,30,30
1746588671624,MATH 168A,A01,890197,Dumitriu; Ioana,21,0,35,14
1746588672653,MATH 170A,A01,890240,Nie; Jiawang,1,0,30,29
1746588672653,MATH 170A,A02,890241,Nie; Jiawang,11,0,30,19
1746588672653,MATH 170A,A03,890249,Nie; Jiawang,23,0,30,7
1746588673676,MATH 170B,A01,957891,Nag; Panchali,13,0,35,22
1746588675729,MATH 181A,A01,908025,Staff,0,3,35,35
1746588675729,MATH 181A,A02,960115,Staff,26,0,35,9
1746588676758,MATH 181B,A01,959874,Staff,25,0,30,5
1746588677782,MATH 193B,A01,890265,Staff,0,4,35,35
1746588678810,MGT 4,A01,890311,Anderson; John Charles,42,0,88,46
1746588679835,MGT 5,A00,907740,Staff,12,0,98,86
1746588680863,MGT 12,A00,890312,Lindenberger; Wade Douglas,67,0,98,31
1746588681894,MGT 16,A00,957883,Staff,78,0,98,20
1746588683949,MGT 45,A00,890314,Pecore; Joseph P.,45,0,98,53
1746588684974,MGT 71,A00,890315,Staff,0,12,98,98
1746588686001,MGT 100,A00,890316,Yavorsky; Daniel Ryan,44,0,98,54
1746588687026,MGT 103,A00,890317,Ehrich; Kristine R,73,0,98,25
1746588688053,MGT 105,A00,890356,Bates; Kenneth Walter,0,8,98,98
1746588689079,MGT 112,A00,890360,Ehrich; Kristine R,55,0,98,43
1746588690109,MGT 127R,A00,907732,Zhu; Kevin Xiaoguo,23,0,98,75
1746588691138,MGT 131B,A00,890361,Anderson; John Charles,59,0,98,39
1746588692166,MGT 137,A00,890362,Lindenberger; Wade Douglas,65,0,98,33
1746588693190,MGT 160,A00,890369,Johnson; Erik Barry,9,0,98,89
1746588695261,MGT 164,A00,890372,Zimmermann; Carsten,0,40,98,98
1746588696291,MGT 180,A00,890374,Bliss; Barbara Ann,12,0,98,86
1746588697324,MMW 15,A01,886414,Chang; Edmond Yi-Teh,0,12,28,28
1746588697324,MMW 15,A02,886415,Chang; Edmond Yi-Teh,0,8,28,28
1746588697324,MMW 15,A03,886416,Chang; Edmond Yi-Teh,0,9,28,28
1746588697324,MMW 15,A04,886417,Chang; Edmond Yi-Teh,0,8,28,28
1746588697324,MMW 15,B01,886419,Chang; Edmond Yi-Teh,0,7,28,28
1746588697324,MMW 15,B02,886420,Chang; Edmond Yi-Teh,0,8,28,28
1746588697324,MMW 15,B03,886421,Chang; Edmond Yi-Teh,0,7,28,28
1746588697324,MMW 15,B04,886422,Chang; Edmond Yi-Teh,0,8,28,28
1746588697324,MMW 15,C01,886424,Staff,0,9,28,28
1746588697324,MMW 15,C02,886425,Staff,0,8,28,28
1746588697324,MMW 15,C03,886426,Staff,0,8,28,28
1746588697324,MMW 15,C04,886427,Staff,0,8,28,28
1746588697324,MMW 15,C05,958038,Staff,0,8,28,28
1746588697324,MMW 15,C06,958039,Staff,1,8,28,27
1746588698351,MMW 15GS,A00,906910,Patterson; Patrick H.,4,0,28,24
1746588699376,MMW 122R,A01,886429,Rahimi; Babak,0,13,28,28
1746588699376,MMW 122R,A02,886430,Rahimi; Babak,0,12,28,28
1746588699376,MMW 122R,A03,958040,Rahimi; Babak,0,11,28,28
1746588700400,MUS 1A,A01,890937,Staff,2,0,25,23
1746588700400,MUS 1A,A02,891035,Staff,6,0,25,19
1746588700400,MUS 1A,C01,958912,Staff,24,0,25,1
1746588700400,MUS 1A,C02,958913,Staff,25,0,25,0
1746588702453,MUS 2AK,A00,957092,Ohnishi; Takae,15,0,15,0
1746588703482,MUS 4,A01,891044,Staff,0,0,25,25
1746588703482,MUS 4,A02,891045,Staff,23,0,25,2
1746588703482,MUS 4,B01,891048,Staff,17,0,25,8
1746588703482,MUS 4,B02,891050,Staff,25,0,25,0
1746588704507,MUS 5,A01,957506,Dubnov; Shlomo,0,0,25,25
1746588704507,MUS 5,A02,957622,Dubnov; Shlomo,13,0,25,12
1746588704507,MUS 5,A03,957623,Dubnov; Shlomo,20,0,25,5
1746588705532,MUS 6,A01,891053,Freitas Caetano; Marcelo,24,0,25,1
1746588705532,MUS 6,A02,891054,Freitas Caetano; Marcelo,23,0,25,2
1746588706557,MUS 7,A01,891081,Staff,0,0,25,25
1746588706557,MUS 7,A02,891082,Staff,3,0,25,22
1746588707583,MUS 8GS,A00,891118,Borgo; David Garcia,1,0,25,24
1746588708606,MUS 11,A01,891140,Staff,9,0,25,16
1746588708606,MUS 11,A02,891141,Staff,21,0,25,4
1746588709630,MUS 13,A01,891143,Staff,8,0,25,17
1746588709630,MUS 13,A02,891144,Staff,24,0,25,1
1746588710658,MUS 15,A01,891146,Staff,9,0,25,16
1746588710658,MUS 15,A02,891148,Staff,21,0,25,4
1746588710658,MUS 15,B01,891150,Staff,18,0,25,7
1746588710658,MUS 15,B02,891151,Staff,25,0,25,0
1746588711686,MUS 20,A01,891153,Staff,5,0,20,15
1746588711686,MUS 20,A02,891155,Staff,14,0,20,6
1746588712712,MUS 80,A00,891156,Staff,19,0,25,6
1746588712712,MUS 80,B00,891157,Staff,23,0,25,2
1746588713738,MUS 130,A00,891158,Ohnishi; Takae,35,0,35,0
1746588714763,MUS 150GS,A01,891160,Borgo; David Garcia,1,0,25,24
1746588715791,MUS 170,A01,891162,Freitas Caetano; Marcelo,20,0,25,5
1746588715791,MUS 170,A02,891164,Freitas Caetano; Marcelo,21,0,25,4
1746588716819,NANO 11,A00,886220,Vazquez Mena; Oscar,13,0,15,2
1746588717848,NANO 15,A01,886222,Drews; Aaron,4,0,7,3
1746588718874,NANO 104,A00,886224,Sirbuly; Donald,17,0,25,8
1746588719902,PH 40,A00,886528,Staff,23,0,40,17
1746588720929,PH 45,A01,886799,Staff,35,0,40,5
1746588721954,PH 110,A00,886802,Staff,0,7,40,40
1746588722980,PH 172,A00,906716,Staff,19,0,35,16
1746588724004,PH 191,A00,886803,Staff,6,0,40,34
1746588725032,PHIL 1,A00,889500,Staff,20,0,30,10
1746588726061,PHIL 10,A01,889549,Grush; Rick Scott,16,0,22,6
1746588726061,PHIL 10,A02,889551,Grush; Rick Scott,22,0,22,0
1746588727112,PHIL 28,A01,889559,Lamey; Andy M.,0,2,31,31
1746588727112,PHIL 28,A02,889561,Lamey; Andy M.,0,1,30,30
1746588727112,PHIL 28,A03,889572,Lamey; Andy M.,0,1,30,30
1746588728137,PHIL 35,A00,907839,Staff,13,0,15,2
1746588729162,PHIL 60,A00,889574,Staff,73,0,90,17
1746588730186,PHIL 101,A00,958004,Staff,12,0,15,3
1746588732235,PHIL 136,A00,889582,Fulkerson; Matthew Todd,26,0,45,19
1746588733261,PHIL 163,A01,889601,Staff,21,0,30,9
1746588733261,PHIL 163,B01,889606,Brandt; Reuven A,0,3,0,0
1746588734286,PHIL 164,A00,889610,Staff,16,0,30,14
1746588735312,PHIL 165,A00,889613,Staff,22,0,30,8
1746588736339,PHYS 1A,A00,886431,Staff,29,0,70,41
1746588737369,PHYS 1AL,001,886432,Tsai; Philbert S,1,2,30,29
1746588737369,PHYS 1AL,002,886436,Tsai; Philbert S,12,0,30,18
1746588738395,PHYS 1B,A00,886439,Staff,184,0,240,56
1746588739419,PHYS 1BL,001,886441,Tsai; Philbert S,0,4,30,30
1746588739419,PHYS 1BL,002,886444,Tsai; Philbert S,2,0,30,28
1746588740443,PHYS 1C,A00,896092,Arnold; Kam S,78,0,146,68
1746588741468,PHYS 1CL,001,886448,Tsai; Philbert S,0,0,30,30
1746588741468,PHYS 1CL,002,886449,Tsai; Philbert S,1,0,30,29
1746588741468,PHYS 1CL,003,886450,Tsai; Philbert S,16,0,30,14
1746588741468,PHYS 1CL,004,886451,Tsai; Philbert S,15,0,30,15
1746588742496,PHYS 2B,A01,886457,Staff,67,0,115,48
1746588743522,PHYS 2C,A01,886460,Shotwell; Brian,0,9,65,65
1746588744550,PHYS 2CL,A01,886467,Staff,0,4,28,28
1746588744550,PHYS 2CL,A02,886468,Staff,0,3,28,28
1746588745576,PHYS 2D,A01,886470,Staff,10,0,50,40
1746588746601,PHYS 4B,A01,886475,Grinstein; Benjamin,22,0,40,18
1746588747629,POLI 5,A00,891173,Desposato; Scott,7,0,25,18
1746588748655,POLI 5D,A01,891175,Staff,5,0,5,0
1746588748655,POLI 5D,B01,891178,Staff,5,0,5,0
1746588749680,POLI 11,A00,891179,Ferree; Karen E,2,0,35,33
1746588750704,POLI 12,A00,891180,Staff,16,0,30,14
1746588751728,POLI 27,A01,891182,Staff,12,0,75,63
1746588752755,POLI 30,A00,891183,Staff,8,0,50,42
1746588753783,POLI 100B,A00,891244,Staff,5,1,35,30
1746588754809,POLI 100I,A00,891247,Staff,7,0,30,23
1746588755835,POLI 104J,A00,891248,Nichter; Maysa,14,0,30,16
1746588756863,POLI 104U,A00,891250,Nichter; Maysa,1,0,30,29
1746588758914,POLI 110B,A00,891255,Wiens; David,19,0,25,6
1746588759942,POLI 112A,A00,891256,Wiens; David,6,0,25,19
1746588760965,POLI 114BR,A00,891261,Staff,19,0,30,11
1746588761993,POLI 117R,A00,891262,Forman; Fonna,0,6,50,50
1746588763021,POLI 118,A00,891264,Ingham; Sean,17,0,25,8
1746588764047,POLI 124A,A00,891265,Staff,18,0,20,2
1746588765078,POLI 125D,A00,891266,Nichter; Simeon C,2,0,25,23
1746588766102,POLI 126,A00,891268,Nichter; Simeon C,7,0,25,18
1746588767129,POLI 126AA,A00,891272,Staff,15,0,25,10
1746588768154,POLI 130AA,A00,891273,Staff,15,0,20,5
1746588769181,POLI 134AA,A00,891274,Staff,4,0,20,16
1746588771266,POLI 138,A00,891278,Staff,21,0,25,4
1746588772293,POLI 142K,A00,891280,Staff,10,0,25,15
1746588773319,POLI 142M,A00,891281,Gartzke; Erik,16,0,30,14
1746588774344,POLI 142P,A00,891284,Staff,20,0,30,10
1746588775369,POLI 143,A00,891285,Gartzke; Erik,12,0,30,18
1746588776394,POLI 153,A00,891286,Staff,19,0,20,1
1746588778444,POLI 175,A00,891290,Staff,15,0,20,5
1746588779470,PSYC 1,A00,890674,Steiner; Eric Tomas,0,11,45,45
1746588780500,PSYC 2,A00,890676,Albright; Thomas D,20,0,35,15
1746588781524,PSYC 3,A00,890679,Staff,17,0,20,3
1746588782550,PSYC 6,A00,959858,Staff,19,0,20,1
1746588783579,PSYC 60,A01,890684,Rickard; Timothy C.,0,6,45,45
1746588784604,PSYC 70,A01,890689,Geller; Emma Harlan,6,0,30,24
1746588785632,PSYC 71,A01,959860,Staff,21,0,25,4
1746588786661,PSYC 100,A00,890690,Lacefield; Katharine I,0,50,180,180
1746588787686,PSYC 102,A00,890695,Staff,17,0,40,23
1746588788713,PSYC 105,A00,890699,Geller; Emma Harlan,70,0,100,30
1746588789742,PSYC 106,A00,890701,Gorman; Michael R.,5,0,30,25
1746588790771,PSYC 108,A00,890704,Adrian; Julia Anna,0,29,50,50
1746588791799,PSYC 118,A01,890712,Staff,11,0,30,19
1746588792826,PSYC 124,A00,890716,Chapman; Eddie Nathaniel,25,0,60,35
1746588793855,PSYC 131,A00,890717,Anagnostaras; Stephan,0,7,80,80
1746588794879,PSYC 137,A00,890719,Winkielman; Piotr,0,11,30,30
1746588795905,PSYC 144,A00,890721,Adrian; Julia Anna,0,9,45,45
1746588796929,PSYC 162,A00,890805,Staff,0,1,75,75
1746588797957,PSYC 169,A00,890810,Staff,0,15,30,30
1746588798981,PSYC 172,A00,890814,Gorman; Michael R.,9,0,30,21
1746588800006,PSYC 181,A00,890818,Anagnostaras; Stephan,7,0,200,193
1746588801031,PSYC 184,A00,959861,Staff,164,0,175,11
1746588802056,PSYC 189,A00,890823,Staff,0,2,30,30
1746588803082,PSYC 191,A00,890884,Rickard; Timothy C.,0,12,35,35
1746588804108,PSYC 193,A00,890913,Staff,19,0,30,11
1746588804108,PSYC 193,B00,890914,Chapman; Eddie Nathaniel,24,0,30,6
1746588805134,PSYC 193L,A01,890918,Lowe; Angela Beth,20,0,30,10
1746588805134,PSYC 193L,B01,890921,Hurwitz; Ethan Scott,20,0,30,10
1746588805134,PSYC 193L,C01,890928,Staff,30,0,30,0
1746588806159,RELI 149,A00,886806,Rahimi; Babak,23,0,40,17
1746588807185,SE 9,A01,886814,Staff,7,0,20,13
1746588808211,SE 101B,A01,886816,Chadha; Mayank,3,0,35,32
1746588809239,SE 110B,A00,886818,Zhu; Qiang,4,0,75,71
1746588810264,SE 125,A01,886830,Staff,10,0,30,20
1746588811289,SE 130B,A01,886835,Staff,14,0,40,26
1746588812315,SE 131A,A01,886838,Krysl; Petr,34,0,55,21
1746588813343,SE 154,A00,886840,Staff,28,0,50,22
1746588814372,SE 164GS,A01,886849,Staff,6,0,20,14
1746588815398,SE 167GS,A01,886853,Staff,6,0,20,14
1746588816427,SIO 25,A01,890107,Staff,19,0,30,11
1746588817452,SIO 45,A00,890109,Cook; Geoffrey W,116,0,200,84
1746588818479,SIO 109R,A00,890110,Forman; Fonna,0,16,20,20
1746588819509,SIO 187,A01,890114,Kacev; David,15,0,40,25
1746588820536,SOCI 1,A01,890431,Thorpe; Charles Robert,14,0,30,16
1746588820536,SOCI 1,A02,890518,Thorpe; Charles Robert,30,0,30,0
1746588821561,SOCI 2,A01,957978,Staff,25,0,25,0
1746588821561,SOCI 2,A02,957979,Staff,23,0,25,2
1746588822586,SOCI 20,A01,890523,Calderon-Zaks; Michael Aar,21,0,30,9
1746588822586,SOCI 20,A02,890526,Calderon-Zaks; Michael Aar,29,0,30,1
1746588823612,SOCI 30,A01,890533,Pardo Guerra; Juan Pablo,37,0,40,3
1746588824637,SOCI 40,A01,890535,Staff,27,0,45,18
1746588825666,SOCI 104Q,A00,890559,Staff,18,0,30,12
1746588826693,SOCI 106,A00,890560,Arnal; Maud Marie Leonie,20,0,30,10
1746588827721,SOCI 110,A00,890567,Holkenbrink-Monk; Charlene,19,0,30,11
1746588828748,SOCI 112,A00,890568,Victoria Torres; Pablo,2,0,55,53
1746588829773,SOCI 115,A00,890597,Arnal; Maud Marie Leonie,28,0,45,17
1746588831829,SOCI 121,A00,890604,Pardo Guerra; Juan Pablo,38,0,45,7
1746588832855,SOCI 126,A01,890608,Staff,8,0,10,2
1746588833887,SOCI 127,A00,890609,Staff,18,0,30,12
1746588834911,SOCI 131,A00,890610,Thorpe; Charles Robert,37,0,45,8
1746588835941,SOCI 135,A00,890615,Payne; Christine Anna,13,0,45,32
1746588836968,SOCI 139,A00,890620,Staff,38,0,45,7
1746588837996,SOCI 148E,A00,890622,Calderon-Zaks; Michael Aar,36,0,45,9
1746588839026,SOCI 150,A00,890623,Kohler; Kristopher M.,31,0,45,14
1746588840053,SOCI 157,A00,890625,Jules-Rosette; Bennetta W.,18,0,20,2
1746588841081,SOCI 160,A00,890627,Payne; Christine Anna,21,0,45,24
1746588842108,SYN 1,A00,886855,Fish; Gwendolyn Anne,0,1,0,0
1746588842108,SYN 1,B00,906086,Fish; Gwendolyn Anne,0,2,0,2
1746588843133,SYN 2R,A00,886860,Staff,0,17,15,15
1746588843133,SYN 2R,B00,906106,Atkinson; Arthur Laird,0,16,15,15
1746588844169,SYN 100,A01,886866,Browne; Emily,0,28,20,20
1746588844169,SYN 100,B01,906128,Rock; Martin,0,4,20,20
1746588844169,SYN 100,C01,906140,Deavenport; James Cary,0,4,20,20
1746588844169,SYN 100,D01,907816,Deavenport; James Cary,0,5,20,20
1746588845194,TDAC 1,A00,890286,Walsh; Kim C.,7,0,20,13
1746588846219,TDAC 101,A00,890296,Basso; Beatrice,15,0,20,5
1746588847246,TDDE 131,A00,890297,Staff,47,0,50,3
1746588848276,TDDM 1,A00,890287,Weinberg; Sadie,25,0,30,5
1746588849303,TDGE 11,A00,890288,Fulton; Julia,138,0,200,62
1746588849303,TDGE 11,B00,890289,Castro; Robert Jess,185,0,200,15
1746588850328,TDGE 25,B00,957359,Walsh; Kim C.,5,0,20,15
1746588851354,TDGE 40,A01,890292,Power; Jade Yukana,26,0,30,4
1746588852380,TDGE 124,A00,890298,Havis; Allan,0,2,50,50
1746588853408,TDGE 131R,A00,890299,Burelle; Julie Sara Veronique,15,0,42,27
1746588854436,TDHT 101,A00,890300,Staff,10,0,20,10
1746588855465,TDHT 109,A01,890302,Anderson; Mysia Anyse,31,0,40,9
1746588856489,TDMV 1,A00,890293,Arcidiacono; Kristin,18,0,30,12
1746588857517,TDMV 2,A00,890294,Weinberg; Sadie,23,0,30,7
1746588858546,TDMV 3,A00,957878,Arcidiacono; Kristin,28,0,30,2
1746588860598,TDMV 138,A00,890304,Jun; Grace Shin Hae,25,0,40,15
1746588861623,TDMV 140,A00,890305,Corrales; Joseph Bernales,25,0,30,5
1746588862650,TDMV 142,A00,890307,Caligagan; Tony,32,0,40,8
1746588863673,TDMV 144,A00,890308,Camaya; Michelle Ann,25,0,30,5
1746588864698,TDPW 1,A00,890295,Stein; Deborah Isobel,3,0,20,17
1746588865724,USP 2,A01,890272,Lerner; Amy M,7,0,20,13
1746588866752,USP 3,A01,890274,Staff,12,0,30,18
1746588867778,USP 15,A01,890276,Sun; Feiyang,16,0,30,14
1746588868806,USP 25,A00,890277,Shenkman; Michael Thomas,18,0,25,7
1746588869830,USP 138,A00,890278,Staff,13,0,25,12
1746588870858,USP 143,A00,890279,Staff,22,0,70,48
1746588871885,USP 144,A00,890280,Chowdhury; Muhammed Zohir,16,0,30,14
1746588872910,USP 150,A00,890281,Boomhower; Matthew Charles,4,0,30,26
1746588873935,USP 151,A00,890282,Staff,16,0,20,4
1746588874960,USP 162,A00,890283,Andrews; Abigail Leslie,16,0,20,4
1746588875986,USP 168,A00,920477,Kwak; Nancy,0,0,5,5
1746588877014,USP 181,A00,890284,Staff,3,0,20,17
1746588878042,USP 191A,A00,890285,Staff,12,0,20,8
1746588879071,VIS 101,A00,886512,Staff,26,0,75,49
1746588880096,VIS 103,A00,886513,Cruz; Edwin Teddy,61,0,75,14
1746588881123,VIS 108,A00,886514,Staff,3,0,15,12
1746588882147,VIS 127P,A00,886515,Shen; Kuiyi,79,0,146,67
1746588883174,VIS 149,A00,886516,Yoldas; Pinar,0,0,15,15
1746588884199,VIS 164,A00,886526,Erdmann; Dean,19,0,22,3
1746588885227,VIS 194S,A00,886527,Staff,61,0,75,14
1746588886252,WCWP 10A,C00,886484,Martiniuk; Jill,12,0,15,3
1746588887281,WCWP 10B,A00,886490,Uriarte; Emma,0,0,15,15
1746588887281,WCWP 10B,B00,886491,Dhir; Simrita,8,0,15,7
1746588887281,WCWP 10B,C00,886492,Ornelas; Tricia,0,0,15,15
1746588888305,WCWP 100,A00,886494,Young; Mark T,0,6,15,15
1746588890403,AAS 10,A01,886199,Childs; Dennis R.,0,3,0,0
1746588891427,ANAR 104,A01,886940,Shtienberg; Gilad,27,0,30,3
1746588892452,ANAR 120,A00,886953,Staff,13,0,20,7
1746588893480,ANBI 148,A01,886955,Wilder; Linnea Lorene,30,0,40,10
1746588895531,ANSC 122,A00,886957,Staff,24,0,30,6
1746588896558,ANSC 150,A00,886958,Sloane; Julia Kathryn,2,0,15,13
1746588897583,ANSC 156,A00,886959,Jenkins; Janis A.,0,1,15,15
1746588898611,ANSC 180,A00,886960,Staff,11,0,17,6
1746588899637,ANSC 188,A00,886961,Jassal; Aftab,9,0,25,16
1746588900663,ANSC 190,A00,886962,Jassal; Aftab,14,0,25,11
1746588901690,ANSC 191,A00,886963,Staff,18,0,20,2
1746588902719,ANTH 3,A01,891689,Staff,17,0,20,3
1746588903753,ANTH 5,A00,886933,Semendeferi; Ekaterini,16,0,20,4
1746588904783,ANTH 10,A00,886934,Staff,0,12,30,30
1746588905807,ANTH 21,A01,886936,Staff,41,0,60,19
1746588906835,ANTH 23,A01,886938,Staff,92,0,100,8
1746588907863,ANTH 105,A00,886964,Stewart; Alexander B,84,0,100,16
1746588908891,ANTH 108,A00,886965,Pedersen; David,9,0,20,11
1746588909924,AWP 10,001,886147,Staff,0,0,0,0
1746588909924,AWP 10,002,886148,Staff,0,0,0,0
1746588909924,AWP 10,003,886149,Staff,0,0,0,0
1746588909924,AWP 10,004,886150,Staff,0,0,0,0
1746588909924,AWP 10,005,886151,Staff,0,0,0,0
1746588909924,AWP 10,006,886152,Staff,0,0,0,0
1746588909924,AWP 10,007,886153,Staff,0,0,0,0
1746588909924,AWP 10,008,886154,Staff,0,0,0,0
1746588909924,AWP 10,009,886155,Staff,0,0,0,0
1746588909924,AWP 10,010,886156,Staff,0,0,0,0
1746588909924,AWP 10,011,886158,Staff,0,0,0,0
1746588909924,AWP 10,012,886160,Staff,0,0,0,0
1746588909924,AWP 10,013,886161,Staff,0,0,0,0
1746588909924,AWP 10,014,886162,Staff,0,0,0,0
1746588909924,AWP 10,015,886163,Staff,0,0,0,0
1746588909924,AWP 10,016,886164,Staff,0,0,0,0
1746588909924,AWP 10,017,886165,Staff,0,0,0,0
1746588909924,AWP 10,018,886166,Staff,0,0,0,0
1746588909924,AWP 10,019,886168,Staff,0,0,0,0
1746588909924,AWP 10,020,886170,Staff,0,0,0,0
1746588909924,AWP 10,021,886172,Staff,0,0,0,0
1746588910952,AWP 10R,001,886173,Staff,0,1,0,0
1746588910952,AWP 10R,002,886174,Staff,0,1,0,0
1746588910952,AWP 10R,003,886175,Staff,0,0,0,0
1746588910952,AWP 10R,004,886176,Staff,0,0,0,0
1746588910952,AWP 10R,005,886177,Staff,0,0,0,0
1746588910952,AWP 10R,006,886178,Staff,0,0,0,0
1746588910952,AWP 10R,007,886179,Staff,0,0,0,0
1746588910952,AWP 10R,008,886181,Staff,0,0,0,0
1746588910952,AWP 10R,009,886182,Staff,0,0,0,0
1746588910952,AWP 10R,010,886183,Staff,0,0,0,0
1746588910952,AWP 10R,011,886184,Staff,0,0,0,0
1746588910952,AWP 10R,012,886185,Staff,0,0,0,0
1746588910952,AWP 10R,013,886186,Staff,0,0,0,0
1746588910952,AWP 10R,014,886187,Staff,0,0,0,0
1746588910952,AWP 10R,015,886188,Staff,0,0,0,0
1746588910952,AWP 10R,016,886189,Staff,0,0,0,0
1746588910952,AWP 10R,017,960532,Staff,0,0,0,0
1746588910952,AWP 10R,018,960533,Staff,0,0,0,0
1746588910952,AWP 10R,019,960534,Staff,0,0,0,0
1746588910952,AWP 10R,020,960538,Staff,0,0,0,0
1746588910952,AWP 10R,021,960540,Staff,0,0,0,0
1746588910952,AWP 10R,022,960541,Staff,0,0,0,0
1746588910952,AWP 10R,023,960542,Staff,0,0,0,0
1746588910952,AWP 10R,024,960544,Staff,0,0,0,0
1746588910952,AWP 10R,025,960545,Staff,0,0,0,0
1746588910952,AWP 10R,026,960548,Staff,0,0,0,0
1746588911979,AWP 102R,A00,886190,Staff,0,0,0,0
1746588911979,AWP 102R,B00,886191,Staff,0,0,0,0
1746588913005,BENG 100,A01,886193,Staff,17,0,30,13
1746588914029,BENG 122A,A01,886195,Hasty; Jeff M,13,0,30,17
1746588915055,BENG 166A,A00,886196,Sah; Robert Lie-Yuan,0,3,30,30
1746588916079,BENG 190,A00,958050,Khojah; Reem I,17,0,25,8
1746588917103,BIBC 102,A01,894320,Staff,0,0,46,46
1746588917103,BIBC 102,A02,894321,Staff,0,0,46,46
1746588917103,BIBC 102,A03,894344,Staff,6,0,46,40
1746588917103,BIBC 102,A04,894345,Staff,27,0,47,20
1746588918134,BICD 100R,A01,894365,Smith; Laurie,1,3,58,57
1746588918134,BICD 100R,A02,894366,Smith; Laurie,1,5,58,57
1746588918134,BICD 100R,A03,894367,Smith; Laurie,0,0,59,59
1746588918134,BICD 100R,A04,959869,Smith; Laurie,40,0,59,19
1746588919203,BICD 136,A01,894383,Gustafson-Brown; Cindy,14,0,50,36
1746588920229,BIEB 102,A01,894494,Butler; Shannon Rhey,51,0,130,79
1746588922283,BIEB 150,A01,894617,Wills; Christopher,3,0,20,17
1746588922283,BIEB 150,A02,894631,Wills; Christopher,3,0,20,17
1746588922283,BIEB 150,A03,894937,Wills; Christopher,3,0,20,17
1746588922283,BIEB 150,A04,894946,Wills; Christopher,5,0,20,15
1746588923309,BIEB 194,A00,906141,Kurle; Carolyn M.,5,0,20,15
1746588924334,BILD 1,A01,894154,Staff,3,0,19,16
1746588924334,BILD 1,A02,894155,Staff,14,0,19,5
1746588924334,BILD 1,A03,894160,Staff,13,0,19,6
1746588924334,BILD 1,A04,894161,Staff,15,0,18,3
1746588925359,BILD 2,A01,894168,Staff,0,0,50,50
1746588925359,BILD 2,A02,894169,Staff,0,0,50,50
1746588925359,BILD 2,A03,894179,Staff,0,0,50,50
1746588925359,BILD 2,A04,894203,Staff,23,0,50,27
1746588926386,BILD 3,A01,894213,Staff,23,0,31,8
1746588926386,BILD 3,A02,894214,Staff,26,0,31,5
1746588926386,BILD 3,A03,894235,Staff,28,0,31,3
1746588926386,BILD 3,A04,894236,Staff,28,0,32,4
1746588927413,BILD 4,A01,894253,Reuther; Keefe,5,0,24,19
1746588927413,BILD 4,A02,894258,Reuther; Keefe,16,0,24,8
1746588928438,BILD 5,A01,894276,Reuther; Keefe,34,0,50,16
1746588928438,BILD 5,A02,894277,Reuther; Keefe,45,0,50,5
1746588928438,BILD 5,A03,894290,Reuther; Keefe,44,0,50,6
1746588928438,BILD 5,A04,894291,Reuther; Keefe,48,0,50,2
1746588929464,BILD 24,A01,894297,Pirino; Giorgia,40,0,60,20
1746588930488,BIMM 100,B01,958915,Staff,71,0,100,29
1746588931513,BIMM 101,A01,895017,McDonnell; Lisa Marie,0,5,24,24
1746588931513,BIMM 101,A02,895018,McDonnell; Lisa Marie,0,5,24,24
1746588931513,BIMM 101,B01,895020,McDonnell; Lisa Marie,0,6,24,24
1746588931513,BIMM 101,B02,895021,McDonnell; Lisa Marie,0,4,24,24
1746588932543,BIMM 110,A01,895023,Staff,1,0,25,24
1746588932543,BIMM 110,A02,895024,Staff,9,0,25,16
1746588932543,BIMM 110,A03,895025,Staff,18,0,25,7
1746588932543,BIMM 110,A04,895031,Staff,20,0,25,5
1746588933570,BIMM 120,A01,895114,Gustafson-Brown; Cindy,14,0,28,14
1746588933570,BIMM 120,A02,895126,Gustafson-Brown; Cindy,21,0,27,6
1746588934594,BIPN 100,A01,895130,Yang; Mingyu,0,0,38,38
1746588934594,BIPN 100,A02,895131,Yang; Mingyu,31,0,38,7
1746588934594,BIPN 100,A03,895132,Yang; Mingyu,32,0,38,6
1746588934594,BIPN 100,A04,895133,Yang; Mingyu,27,0,36,9
1746588935621,BIPN 120,A01,895135,Cooke; James Edward,0,3,13,13
1746588935621,BIPN 120,A02,895136,Cooke; James Edward,0,1,13,13
1746588935621,BIPN 120,A03,895137,Cooke; James Edward,0,3,13,13
1746588935621,BIPN 120,A04,895156,Cooke; James Edward,0,2,11,11
1746588936646,BIPN 134,A01,895235,Cooke; James Edward,0,2,25,25
1746588936646,BIPN 134,A02,895237,Cooke; James Edward,0,0,25,25
1746588936646,BIPN 134,A03,895240,Cooke; James Edward,3,0,25,22
1746588936646,BIPN 134,A04,895270,Cooke; James Edward,20,0,25,5
1746588937675,BIPN 189,A00,892103,Staff,0,14,14,14
1746588939727,BISP 194,A00,958008,Staff,0,2,0,0
1746588940755,CAT 124,A01,922009,Staff,0,5,20,20
1746588941780,CAT 125R,A00,886390,Morales; Celeste Georgianna,0,3,20,20
1746588941780,CAT 125R,B00,886391,Irwin; Matthew Joseph,0,4,20,20
1746588941780,CAT 125R,C00,886392,Smith; Lauryn Alissa,0,2,20,20
1746588941780,CAT 125R,D00,886393,Vanderschuit; Maya Alysia,0,3,20,20
1746588941780,CAT 125R,E00,886394,Marchisotto; Jennifer Anne,0,3,20,20
1746588942809,CENG 15,A01,886218,Drews; Aaron,3,0,8,5
1746588943834,CENG 113,A00,886219,Opatkiewicz; Justin Paul,15,0,25,10
1746588944859,CGS 101,A00,887044,Staff,7,0,20,13
1746588945886,CGS 105,A01,887046,Staff,14,0,25,11
1746588946911,CGS 112,A00,887047,Cuong; Marisol,12,0,15,3
1746588947936,CGS 113,A00,887048,Staff,23,0,30,7
1746588948962,CGS 120,A00,887049,Staff,10,0,17,7
1746588949991,CHEM 6A,A01,886336,Lam; Tin Yiu,38,0,50,12
1746588949991,CHEM 6A,A02,886338,Lam; Tin Yiu,37,0,50,13
1746588951022,CHEM 6B,A01,886341,Hopkins; Patrycja Anna,16,0,50,34
1746588951022,CHEM 6B,A02,886343,Hopkins; Patrycja Anna,42,0,50,8
1746588952048,CHEM 6C,A01,886346,Albizati; Kim F.,0,2,50,50
1746588952048,CHEM 6C,A02,886348,Albizati; Kim F.,24,0,50,26
1746588953074,CHEM 40A,A01,886352,Klosterman; Jeremy K,65,0,100,35
1746588954101,CHEM 40B,A01,886356,Klosterman; Jeremy K,0,24,100,100
1746588955126,CHEM 41B,A01,886360,Theodorakis; Emmanuel,25,0,50,25
1746588955126,CHEM 41B,A02,886362,Theodorakis; Emmanuel,47,0,50,3
1746588956152,CHIN 165A,A00,886382,Xu; Li,18,0,20,2
1746588957178,CLAS 120,A00,886387,Myerston Santana; Jacobo,33,0,40,7
1746588958204,COGS 9,A01,886967,Shannon; Kyle Michael,42,0,60,18
1746588959231,COGS 11,A01,886969,Staff,9,0,30,21
1746588960259,COGS 14A,A01,886971,Staff,6,0,60,54
1746588961285,COGS 14B,A01,886973,Hoffman; Drew Ellen,4,0,60,56
1746588962314,COGS 18,A01,886975,Morgan; Eric,34,0,60,26
1746588963340,COGS 20,A01,886977,Staff,2,0,8,6
1746588963340,COGS 20,A02,886978,Staff,4,0,7,3
1746588964367,COGS 100,A01,907783,Staff,1,2,30,29
1746588965394,COGS 101B,A01,886980,Staff,0,4,48,48
1746588966423,COGS 101C,A01,886982,Delgado; Tania,0,5,44,44
1746588967450,COGS 102A,A01,886984,Johnson; Christine M.,3,0,30,27
1746588968477,COGS 118B,A01,886986,Staff,1,5,88,87
1746588969503,COGS 150,A01,886988,Bergen; Benjamin,22,0,50,28
1746588970532,COGS 153,A00,886989,Delgado; Tania,0,3,41,41
1746588971559,COGS 186,A01,886991,Staff,0,0,32,32
1746588972585,COGS 187A,A01,886993,Boyle; Mary E. T.,7,0,30,23
1746588973612,COGS 189,A00,886994,Staff,0,1,30,30
1746588974639,COMM 10,A01,886996,Staff,0,0,20,21
1746588974639,COMM 10,A02,886997,Staff,10,0,20,10
1746588974639,COMM 10,A03,959845,Staff,19,0,20,1
1746588975664,COMM 20,A01,886999,Leuning; Grant Maurstad,24,0,40,16
1746588977720,COMM 100A,A01,887002,Staff,0,0,20,25
1746588977720,COMM 100A,A02,887003,Staff,6,0,20,14
1746588978747,COMM 100B,A01,887005,Staff,0,8,20,24
1746588979775,COMM 106D,A00,887006,Staff,13,0,40,27
1746588980802,COMM 110G,A00,887007,Whitworth-Smith; Andrew C,12,0,40,28
1746588981833,COMM 111B,A00,887008,Staff,31,0,40,9
1746588982860,COMM 113T,A00,887009,Abuelhiga; Soraya Jill,28,0,40,12
1746588982860,COMM 113T,B00,906733,Staff,40,0,40,0
1746588983886,COMM 145,A00,887010,Staff,12,0,40,28
1746588984912,COMM 146,A00,887054,Staff,31,0,40,9
1746588985938,COMM 190,A00,887012,Staff,8,0,23,15
1746588986971,CSE 8A,A50,887015,Cao; Yingjun,56,0,85,29
1746588987997,CSE 11,A01,887017,Cao; Yingjun,11,0,70,59
1746588989023,CSE 20,A01,887019,Staff,30,0,50,20
1746588990050,CSE 21,A01,887021,Staff,78,0,100,22
1746588990050,CSE 21,B01,892583,Braun; Oliver,45,0,50,5
1746588991079,CSE 30,A01,887025,Eldon; John,142,0,200,58
1746588992107,CSE 100,A01,887027,Staff,26,0,50,24
1746588992107,CSE 100,A02,887028,Staff,42,0,50,8
1746588993139,CSE 101,A01,887030,Braun; Oliver,74,0,100,26
1746588993139,CSE 101,B01,887032,Jones; Miles E,0,3,50,50
1746588993139,CSE 101,B02,887033,Jones; Miles E,0,2,50,50
1746588994166,CSE 105,A01,908084,Jones; Miles E,32,0,50,18
1746588994166,CSE 105,A02,908087,Jones; Miles E,31,0,50,19
1746588995197,CSE 135,A01,887035,Powell; Thomas Allan,0,5,50,50
1746588996222,CSE 142,A01,887037,Staff,8,0,60,52
1746588997250,CSE 142L,A01,887039,Staff,34,0,60,26
1746588998278,CSE 151A,A01,887041,Solares; Edwin A,47,0,100,53
1746588999306,CSE 175,A01,887043,Kumar; Rakesh,30,0,30,0
1746589000330,CSS 1,A01,886389,Staff,1,2,40,39
1746589001355,DSC 30,A01,908097,Liao; Soohyun Nam,47,0,75,28
1746589002381,DSC 40A,A01,908099,Shannon; Kyle Michael,30,0,50,20
1746589003408,DSC 40B,A01,908112,Staff,15,0,50,35
1746589004438,DSC 80,A01,908116,Staff,19,0,60,41
1746589005463,DSC 197,001,956863,Eldridge; Justin Matthew,9999,0,9999,0
1746589006494,ECE 5,A01,886400,Morris; Karcher William,1,0,6,5
1746589006494,ECE 5,A02,886401,Morris; Karcher William,3,0,6,3
1746589007519,ECE 148,A01,886403,Silberman; Jack,0,14,14,14
1746589008548,ECON 1,A01,887265,Crane; Meredith Helen,11,0,70,59
1746589008548,ECON 1,B01,887268,Staff,42,0,50,8
1746589009573,ECON 2,A01,887273,Crane; Meredith Helen,54,0,70,16
1746589010600,ECON 3,A01,887279,Rondina; Giacomo,31,0,70,39
1746589011624,ECON 4,A01,887282,Anderson; John Charles,0,2,10,10
1746589012652,ECON 5,A01,887285,Staff,34,0,45,11
1746589012652,ECON 5,B01,887292,Staff,41,0,45,4
1746589013683,ECON 100A,A01,887337,Newhouse; Herbert S,54,0,70,16
1746589013683,ECON 100A,B01,887349,Staff,45,0,50,5
1746589014708,ECON 100B,A01,887361,Du; Songzi,29,0,70,41
1746589015737,ECON 100C,A01,887445,Newhouse; Herbert S,59,0,70,11
1746589016762,ECON 105,A00,887488,Vespa; Emanuel Ignacio,23,0,35,12
1746589017787,ECON 109,A01,887506,Shishkin; Denis,28,0,35,7
1746589018813,ECON 110A,A01,887568,Alon; Titan Michael,1,3,35,34
1746589018813,ECON 110A,B01,907601,Alon; Titan Michael,20,0,35,15
1746589019842,ECON 110B,A01,887598,Levkoff; Steven B.,0,24,70,70
1746589020869,ECON 112,A00,887599,Rondina; Giacomo,19,0,35,16
1746589021898,ECON 120A,A01,887603,Dai; Yinlin,35,0,70,35
1746589022966,ECON 120C,A01,887608,Sun; Yixiao,0,1,35,35
1746589022966,ECON 120C,B01,887614,Sun; Yixiao,0,0,35,35
1746589023991,ECON 138,A00,887621,Bharadwaj; Prashant,0,21,20,20
1746589025020,ECON 144,A00,958007,Squires; Dale E,12,0,35,23
1746589026045,ECON 171,A01,907666,Staff,18,0,35,17
1746589027072,ECON 175,A00,887626,Wu; Pak Yeung,22,0,35,13
1746589028099,ECON 190,A00,887640,Vespa; Emanuel Ignacio,22,0,35,13
1746589029133,EDS 25,A01,888197,Staff,0,0,0,0
1746589029133,EDS 25,A02,888209,Staff,0,0,0,0
1746589029133,EDS 25,A03,888210,Staff,0,0,0,0
1746589029133,EDS 25,A04,888212,Staff,0,0,0,0
1746589029133,EDS 25,A05,888213,Staff,0,0,0,0
1746589029133,EDS 25,A06,888214,Staff,0,0,0,0
1746589029133,EDS 25,A07,888235,Staff,0,2,0,0
1746589029133,EDS 25,A08,888236,Staff,0,0,0,0
1746589029133,EDS 25,A09,888240,Staff,0,0,0,0
1746589029133,EDS 25,A10,888244,Staff,0,0,0,0
1746589029133,EDS 25,B01,888273,Staff,0,0,0,0
1746589029133,EDS 25,B02,888285,Staff,0,0,0,0
1746589029133,EDS 25,B03,888423,Staff,0,0,0,1
1746589029133,EDS 25,B04,888432,Staff,0,0,0,0
1746589029133,EDS 25,B05,888433,Staff,0,0,0,0
1746589029133,EDS 25,B06,888467,Staff,0,0,0,0
1746589029133,EDS 25,B07,888468,Staff,0,0,0,0
1746589029133,EDS 25,B08,888479,Staff,0,0,0,0
1746589029133,EDS 25,B09,888484,Staff,0,0,0,0
1746589029133,EDS 25,B10,888487,Staff,0,0,0,0
1746589030157,EDS 38,A01,907700,Choi; Bailey Miyeon,30,0,30,0
1746589031238,EDS 112,A01,888601,Chapman; Thandeka K,12,0,40,28
1746589032264,EDS 115,A00,888697,Mendez; Kathrina Mendoza,10,0,30,20
1746589033292,EDS 116,A01,888893,Staff,33,0,40,7
1746589035347,EDS 124AR,A00,889133,Staff,29,0,50,21
1746589035347,EDS 124AR,B00,907471,Simon; Elizabeth A,37,0,50,13
1746589036372,EDS 124BR,A00,889134,Simon; Elizabeth A,44,0,100,56
1746589037400,EDS 125,A00,889135,Staff,25,0,30,5
1746589038429,EDS 126,A01,889138,Staff,35,0,40,5
1746589039454,EDS 164R,A01,889142,Wishard Guerra; Alison G.,32,0,50,18
1746589040484,ENG 30,A01,886396,Staff,0,0,0,0
1746589040484,ENG 30,B01,886398,Staff,0,0,0,0
1746589041508,ENVR 102,A00,906150,Montejo; Carolina,23,0,25,2
1746589042534,ETHN 103A,A00,887236,Man; Simeon S,0,3,0,0
1746589043560,ETHN 113,A00,887239,Staff,16,0,30,14
1746589044586,ETHN 116,A00,887240,Staff,16,0,25,9
1746589045614,ETHN 117,A00,887241,Choi; Esther Min,28,0,30,2
1746589046637,ETHN 118,A00,887243,Staff,24,0,30,6
1746589047663,ETHN 127,A00,887248,Cuong; Marisol,11,0,15,4
1746589048689,ETHN 139,A00,887250,Staff,7,0,10,3
1746589049715,ETHN 142,A00,887252,Staff,10,0,30,20
1746589050740,ETHN 161,A00,887253,Browne; Errol Tsekani,24,0,30,6
1746589051768,ETHN 163FR,A00,887255,Burelle; Julie Sara Veronique,0,0,5,5
1746589052794,GLBH 20,A00,889149,Elwardani; Nile Regina,8,0,42,34
1746589054848,GLBH 111,A01,889152,Burgos; Jose L.,17,0,17,0
1746589055874,GLBH 150,A00,889181,Sloane; Julia Kathryn,0,5,15,15
1746589057926,HDS 60,A01,886406,Warstadt; Melissa Fawn,73,0,80,7
1746589058953,HIAF 111,A00,889324,Gyamfi; Bright,25,0,32,7
1746589059981,HIEA 131,A00,889328,Staff,15,0,32,17
1746589061014,HIEA 144,A00,889333,Henry; Todd A.,26,0,32,6
1746589062040,HIEA 154,A00,889336,Henry; Todd A.,24,0,32,8
1746589063065,HIEU 106,A00,889339,Staff,22,0,32,10
1746589065121,HIEU 114,A00,889340,Staff,4,0,32,28
1746589066146,HIEU 135GS,A00,889342,Patterson; Patrick H.,0,0,1,24
1746589067171,HIEU 137,A00,889343,Edington; Claire Ellen,10,0,25,15
1746589068197,HIEU 148,A00,889345,Staff,14,0,32,18
1746589069223,HIEU 154,A00,889346,Biess; Frank Peter,21,0,32,11
1746589070251,HILA 102,A00,889351,Staff,12,0,32,20
1746589071276,HILD 2A,A01,889221,Lewandoski; Julia Mavis,2,10,32,30
1746589072304,HILD 7B,A01,889225,Man; Simeon S,0,12,32,32
1746589073329,HILD 7C,A01,889288,Alvarez; Luis A,0,14,32,32
1746589074356,HILD 30,A01,889323,Staff,0,5,32,32
1746589076415,HISC 119,A00,889383,Golan; Tal,19,0,32,13
1746589077440,HIUS 103,A00,889384,Man; Simeon S,0,0,32,32
1746589078470,HIUS 117,A00,919797,Kwak; Nancy,18,0,32,14
1746589079495,HIUS 142A,A00,919788,Staff,22,0,32,10
1746589081571,HIUS 149,A00,889386,Gyamfi; Bright,26,0,32,6
1746589082599,HIUS 155,A00,889387,Alvarez; Luis A,15,0,32,17
1746589083626,HUM 3,A01,886499,Caldwell; Michael Alan,19,0,50,31
1746589084652,HUM 3GS,A00,886500,Rodriguez; Bretton Sigfred,0,0,0,28
1746589085675,HUM 3R,A01,886502,Markman; Kristina,0,36,50,50
1746589086705,HUM 4,A01,886504,Crum; Matthew Stephen,23,0,50,27
1746589086705,HUM 4,B01,886506,West; Geoffrey Scott,17,0,50,33
1746589087734,HUM 4GS,A00,886507,Staff,0,0,0,19
1746589088761,HUM 5,A01,886509,Staff,32,0,50,18
1746589089786,HUM 5R,A01,886511,Zavodny; Tatiana Sophia,0,39,50,50
1746589090810,JAPN 180,A00,886407,Staff,16,0,40,24
1746589091840,LATI 50,A01,886409,Martin-Cabrera; Luis,3,0,22,19
1746589091840,LATI 50,A02,886410,Martin-Cabrera; Luis,19,0,22,3
1746589091840,LATI 50,A03,886411,Martin-Cabrera; Luis,21,0,22,1
1746589091840,LATI 50,A04,886412,Martin-Cabrera; Luis,8,0,22,14
1746589092868,LAWS 101,A00,907664,Staff,28,0,60,32
1746589093894,LIAB 1A,A00,889388,Saab; Dima,17,0,20,3
1746589094922,LIAB 1AX,A00,889389,El Cheddadi; Youniss,18,0,20,2
1746589095946,LIFR 1C,A00,889391,Van Moer; Vinciane G,8,0,20,12
1746589096973,LIFR 1CX,A00,889392,Van Moer; Vinciane G,7,0,20,13
1746589097998,LIFR 1D,A00,889393,Van Moer; Vinciane G,7,0,20,13
1746589099027,LIFR 1DX,A00,889394,Van Moer; Vinciane G,8,0,20,12
1746589100053,LIGN 7,A00,886923,Staff,24,0,50,26
1746589101080,LIGN 17,A00,886924,Kehler; Andrew Scott,125,0,150,25
1746589102105,LTAM 110,A00,889395,Staff,15,0,30,15
1746589103154,LTAM 110GS,A00,958010,Rodriguez; Bretton Sigfred,0,0,0,28
1746589104184,LTCH 101,A00,889397,Staff,23,0,25,2
1746589105210,LTCS 130,A00,889398,Staff,23,0,25,2
1746589106234,LTEA 138,A00,889399,Staff,24,0,40,16
1746589107263,LTEN 149,A00,889400,Wesling; Megan E.,0,3,25,25
1746589108287,LTEN 169,A00,889401,Staff,20,0,25,5
1746589109311,LTEN 180,A00,889402,Staff,10,0,15,5
1746589110337,LTEN 181,A00,889403,Staff,21,0,25,4
1746589111360,LTWL 100,A00,889404,Myerston Santana; Jacobo,2,0,25,23
1746589112387,LTWL 180GS,A00,889405,Staff,0,0,20,20
1746589113412,LTWL 181,A00,889406,Staff,16,0,25,9
1746589114436,LTWL 184,A00,889475,Mukherjee; Silpa,22,0,25,3
1746589115461,LTWR 102C,A00,889486,Staff,29,0,30,1
1746589116486,LTWR 115W,A00,889491,Staff,0,2,15,15
1746589117515,MAE 8,A01,886905,Staff,0,2,0,0
1746589118544,MAE 11,A00,886906,Bandaru; Prabhakar,0,7,50,50
1746589119571,MAE 20,A00,886907,Evdokimenko; Ekaterina,43,0,70,27
1746589120598,MAE 30B,A00,886909,Ghazinejad; Maziar,26,0,45,19
1746589121624,MAE 101B,A00,886910,Saintillan; David,29,0,45,16
1746589122651,MAE 105,A00,886911,Bandaru; Prabhakar,18,0,50,32
1746589123677,MAE 107,B00,958024,Staff,7,0,50,43
1746589124701,MAE 143B,A00,886913,Bewley; Thomas R,3,0,40,37
1746589125726,MAE 148,A01,886915,Silberman; Jack,0,3,14,14
1746589126752,MAE 160,A00,886916,Evdokimenko; Ekaterina,31,0,60,29
1746589127777,MATH 3C,A01,889681,Staff,0,2,30,30
1746589127777,MATH 3C,A02,960048,Staff,23,0,30,7
1746589128805,MATH 10A,A01,889760,Staff,26,0,30,4
1746589128805,MATH 10A,A02,889783,Staff,29,0,30,1
1746589129833,MATH 10B,A01,889785,Verstraete; Jacques Allan,1,0,35,34
1746589129833,MATH 10B,A02,889795,Verstraete; Jacques Allan,4,0,35,31
1746589129833,MATH 10B,B01,889797,Verstraete; Jacques Allan,3,0,35,32
1746589129833,MATH 10B,B02,889828,Verstraete; Jacques Allan,3,0,35,32
1746589130860,MATH 10C,A01,889849,Habib; Yousaf,7,0,30,23
1746589130860,MATH 10C,A02,889852,Habib; Yousaf,14,0,30,16
1746589130860,MATH 10C,A03,889853,Habib; Yousaf,22,0,30,8
1746589130860,MATH 10C,A04,889858,Habib; Yousaf,20,0,30,10
1746589130860,MATH 10C,B01,889861,Staff,1,0,30,29
1746589130860,MATH 10C,B02,889862,Staff,24,0,30,6
1746589130860,MATH 10C,B03,889863,Staff,27,0,30,3
1746589130860,MATH 10C,B04,889967,Staff,23,0,30,7
1746589131885,MATH 18,A01,889974,Staff,7,0,30,23
1746589131885,MATH 18,A02,889977,Staff,20,0,30,10
1746589131885,MATH 18,B01,889984,Hardiman; Liam,20,0,30,10
1746589131885,MATH 18,B02,889985,Hardiman; Liam,25,0,30,5
1746589132914,MATH 20A,A01,889990,Suk; Andrew Hoon,30,0,35,5
1746589133943,MATH 20B,A01,889993,Ohm; Ko Woon,21,0,30,9
1746589133943,MATH 20B,A02,889994,Ohm; Ko Woon,30,0,30,0
1746589133943,MATH 20B,B01,889996,Ohm; Ko Woon,22,0,30,8
1746589133943,MATH 20B,B02,889997,Ohm; Ko Woon,23,0,30,7
1746589134969,MATH 20C,A01,889999,Hammock; Frances H,17,0,30,13
1746589134969,MATH 20C,A02,890003,Hammock; Frances H,23,0,30,7
1746589134969,MATH 20C,B01,890006,Hammock; Frances H,3,0,30,27
1746589134969,MATH 20C,B02,890007,Hammock; Frances H,12,0,30,18
1746589135999,MATH 20D,A01,890011,Cheng; Hsiao-Bing,1,1,30,29
1746589135999,MATH 20D,A02,890012,Cheng; Hsiao-Bing,14,0,30,16
1746589135999,MATH 20D,B01,890016,Cheng; Hsiao-Bing,13,0,30,17
1746589135999,MATH 20D,B02,890017,Cheng; Hsiao-Bing,13,0,30,17
1746589137025,MATH 20E,A01,890026,Harel; Guershon,1,0,30,29
1746589137025,MATH 20E,A02,890029,Harel; Guershon,22,0,30,8
1746589137025,MATH 20E,B01,890033,Harel; Guershon,7,0,30,23
1746589137025,MATH 20E,B02,890101,Harel; Guershon,21,0,30,9
1746589138050,MATH 102,A01,890104,Staff,18,0,30,12
1746589138050,MATH 102,A02,890105,Staff,27,0,30,3
1746589139079,MATH 103B,A01,890116,Salehi Golsefidy; Alireza,3,0,30,27
1746589139079,MATH 103B,B01,890118,Staff,0,3,34,34
1746589140106,MATH 109,A01,890121,Aliabadi Sr.; Mohsen,0,0,30,30
1746589140106,MATH 109,B01,890124,Upadrashta; Pranav Kumar,18,0,30,12
1746589141134,MATH 120A,A01,890126,Eggers; John Dietrich,13,0,30,17
1746589142164,MATH 142B,A01,890128,Ioana; Adrian,19,0,30,11
1746589142164,MATH 142B,A02,890129,Ioana; Adrian,12,0,30,18
1746589143189,MATH 154,A01,890174,Staff,0,1,30,30
1746589143189,MATH 154,A02,890182,Staff,0,0,30,30
1746589144216,MATH 168A,A01,890197,Dumitriu; Ioana,21,0,35,14
1746589145241,MATH 170A,A01,890240,Nie; Jiawang,1,0,30,29
1746589145241,MATH 170A,A02,890241,Nie; Jiawang,11,0,30,19
1746589145241,MATH 170A,A03,890249,Nie; Jiawang,23,0,30,7
1746589146264,MATH 170B,A01,957891,Nag; Panchali,13,0,35,22
1746589148314,MATH 181A,A01,908025,Staff,0,3,35,35
1746589148314,MATH 181A,A02,960115,Staff,26,0,35,9
1746589149338,MATH 181B,A01,959874,Staff,25,0,30,5
1746589150362,MATH 193B,A01,890265,Staff,0,4,35,35
1746589151387,MGT 4,A01,890311,Anderson; John Charles,42,0,88,46
1746589152415,MGT 5,A00,907740,Staff,12,0,98,86
1746589153439,MGT 12,A00,890312,Lindenberger; Wade Douglas,67,0,98,31
1746589154468,MGT 16,A00,957883,Staff,78,0,98,20
1746589156521,MGT 45,A00,890314,Pecore; Joseph P.,45,0,98,53
1746589157546,MGT 71,A00,890315,Staff,0,12,98,98
1746589158570,MGT 100,A00,890316,Yavorsky; Daniel Ryan,44,0,98,54
1746589159623,MGT 103,A00,890317,Ehrich; Kristine R,73,0,98,25
1746589160648,MGT 105,A00,890356,Bates; Kenneth Walter,0,8,98,98
1746589161673,MGT 112,A00,890360,Ehrich; Kristine R,55,0,98,43
1746589162698,MGT 127R,A00,907732,Zhu; Kevin Xiaoguo,23,0,98,75
1746589163727,MGT 131B,A00,890361,Anderson; John Charles,59,0,98,39
1746589164752,MGT 137,A00,890362,Lindenberger; Wade Douglas,65,0,98,33
1746589165776,MGT 160,A00,890369,Johnson; Erik Barry,9,0,98,89
1746589167825,MGT 164,A00,890372,Zimmermann; Carsten,0,40,98,98
1746589168851,MGT 180,A00,890374,Bliss; Barbara Ann,12,0,98,86
1746589169883,MMW 15,A01,886414,Chang; Edmond Yi-Teh,0,12,28,28
1746589169883,MMW 15,A02,886415,Chang; Edmond Yi-Teh,0,8,28,28
1746589169883,MMW 15,A03,886416,Chang; Edmond Yi-Teh,0,9,28,28
1746589169883,MMW 15,A04,886417,Chang; Edmond Yi-Teh,0,8,28,28
1746589169883,MMW 15,B01,886419,Chang; Edmond Yi-Teh,0,7,28,28
1746589169883,MMW 15,B02,886420,Chang; Edmond Yi-Teh,0,8,28,28
1746589169883,MMW 15,B03,886421,Chang; Edmond Yi-Teh,0,7,28,28
1746589169883,MMW 15,B04,886422,Chang; Edmond Yi-Teh,0,8,28,28
1746589169883,MMW 15,C01,886424,Staff,0,9,28,28
1746589169883,MMW 15,C02,886425,Staff,0,8,28,28
1746589169883,MMW 15,C03,886426,Staff,0,8,28,28
1746589169883,MMW 15,C04,886427,Staff,0,8,28,28
1746589169883,MMW 15,C05,958038,Staff,0,8,28,28
1746589169883,MMW 15,C06,958039,Staff,1,8,28,27
1746589170907,MMW 15GS,A00,906910,Patterson; Patrick H.,4,0,28,24
1746589171936,MMW 122R,A01,886429,Rahimi; Babak,0,13,28,28
1746589171936,MMW 122R,A02,886430,Rahimi; Babak,0,12,28,28
1746589171936,MMW 122R,A03,958040,Rahimi; Babak,0,11,28,28
1746589172961,MUS 1A,A01,890937,Staff,2,0,25,23
1746589172961,MUS 1A,A02,891035,Staff,6,0,25,19
1746589172961,MUS 1A,C01,958912,Staff,24,0,25,1
1746589172961,MUS 1A,C02,958913,Staff,25,0,25,0
1746589175013,MUS 2AK,A00,957092,Ohnishi; Takae,15,0,15,0
1746589176038,MUS 4,A01,891044,Staff,0,0,25,25
1746589176038,MUS 4,A02,891045,Staff,23,0,25,2
1746589176038,MUS 4,B01,891048,Staff,17,0,25,8
1746589176038,MUS 4,B02,891050,Staff,25,0,25,0
1746589177064,MUS 5,A01,957506,Dubnov; Shlomo,0,0,25,25
1746589177064,MUS 5,A02,957622,Dubnov; Shlomo,13,0,25,12
1746589177064,MUS 5,A03,957623,Dubnov; Shlomo,20,0,25,5
1746589178089,MUS 6,A01,891053,Freitas Caetano; Marcelo,24,0,25,1
1746589178089,MUS 6,A02,891054,Freitas Caetano; Marcelo,23,0,25,2
1746589179115,MUS 7,A01,891081,Staff,0,0,25,25
1746589179115,MUS 7,A02,891082,Staff,3,0,25,22
1746589180142,MUS 8GS,A00,891118,Borgo; David Garcia,1,0,25,24
1746589181169,MUS 11,A01,891140,Staff,9,0,25,16
1746589181169,MUS 11,A02,891141,Staff,21,0,25,4
1746589182193,MUS 13,A01,891143,Staff,8,0,25,17
1746589182193,MUS 13,A02,891144,Staff,24,0,25,1
1746589183222,MUS 15,A01,891146,Staff,9,0,25,16
1746589183222,MUS 15,A02,891148,Staff,21,0,25,4
1746589183222,MUS 15,B01,891150,Staff,18,0,25,7
1746589183222,MUS 15,B02,891151,Staff,25,0,25,0
1746589184246,MUS 20,A01,891153,Staff,5,0,20,15
1746589184246,MUS 20,A02,891155,Staff,14,0,20,6
1746589185271,MUS 80,A00,891156,Staff,19,0,25,6
1746589185271,MUS 80,B00,891157,Staff,23,0,25,2
1746589186295,MUS 130,A00,891158,Ohnishi; Takae,35,0,35,0
1746589187322,MUS 150GS,A01,891160,Borgo; David Garcia,1,0,25,24
1746589188347,MUS 170,A01,891162,Freitas Caetano; Marcelo,20,0,25,5
1746589188347,MUS 170,A02,891164,Freitas Caetano; Marcelo,21,0,25,4
1746589189374,NANO 11,A00,886220,Vazquez Mena; Oscar,13,0,15,2
1746589190401,NANO 15,A01,886222,Drews; Aaron,4,0,7,3
1746589191429,NANO 104,A00,886224,Sirbuly; Donald,17,0,25,8
1746589192454,PH 40,A00,886528,Staff,23,0,40,17
1746589193483,PH 45,A01,886799,Staff,35,0,40,5
1746589194513,PH 110,A00,886802,Staff,0,6,40,40
1746589195538,PH 172,A00,906716,Staff,19,0,35,16
1746589196564,PH 191,A00,886803,Staff,6,0,40,34
1746589197590,PHIL 1,A00,889500,Staff,20,0,30,10
1746589198616,PHIL 10,A01,889549,Grush; Rick Scott,16,0,22,6
1746589198616,PHIL 10,A02,889551,Grush; Rick Scott,22,0,22,0
1746589199645,PHIL 28,A01,889559,Lamey; Andy M.,0,2,31,31
1746589199645,PHIL 28,A02,889561,Lamey; Andy M.,0,1,30,30
1746589199645,PHIL 28,A03,889572,Lamey; Andy M.,0,1,30,30
1746589200670,PHIL 35,A00,907839,Staff,13,0,15,2
1746589201698,PHIL 60,A00,889574,Staff,73,0,90,17
1746589202721,PHIL 101,A00,958004,Staff,12,0,15,3
1746589204783,PHIL 136,A00,889582,Fulkerson; Matthew Todd,26,0,45,19
1746589205807,PHIL 163,A01,889601,Staff,21,0,30,9
1746589205807,PHIL 163,B01,889606,Brandt; Reuven A,0,3,0,0
1746589206832,PHIL 164,A00,889610,Staff,16,0,30,14
1746589207856,PHIL 165,A00,889613,Staff,22,0,30,8
1746589208881,PHYS 1A,A00,886431,Staff,29,0,70,41
1746589209909,PHYS 1AL,001,886432,Tsai; Philbert S,1,2,30,29
1746589209909,PHYS 1AL,002,886436,Tsai; Philbert S,12,0,30,18
1746589210934,PHYS 1B,A00,886439,Staff,184,0,240,56
1746589211961,PHYS 1BL,001,886441,Tsai; Philbert S,0,4,30,30
1746589211961,PHYS 1BL,002,886444,Tsai; Philbert S,2,0,30,28
1746589212988,PHYS 1C,A00,896092,Arnold; Kam S,78,0,146,68
1746589214016,PHYS 1CL,001,886448,Tsai; Philbert S,0,0,30,30
1746589214016,PHYS 1CL,002,886449,Tsai; Philbert S,1,0,30,29
1746589214016,PHYS 1CL,003,886450,Tsai; Philbert S,16,0,30,14
1746589214016,PHYS 1CL,004,886451,Tsai; Philbert S,15,0,30,15
1746589215041,PHYS 2B,A01,886457,Staff,67,0,115,48
1746589216069,PHYS 2C,A01,886460,Shotwell; Brian,0,9,65,65
1746589217092,PHYS 2CL,A01,886467,Staff,0,4,28,28
1746589217092,PHYS 2CL,A02,886468,Staff,0,3,28,28
1746589218117,PHYS 2D,A01,886470,Staff,10,0,50,40
1746589219146,PHYS 4B,A01,886475,Grinstein; Benjamin,22,0,40,18
1746589220171,POLI 5,A00,891173,Desposato; Scott,7,0,25,18
1746589221199,POLI 5D,A01,891175,Staff,5,0,5,0
1746589221199,POLI 5D,B01,891178,Staff,5,0,5,0
1746589222225,POLI 11,A00,891179,Ferree; Karen E,2,0,35,33
1746589223250,POLI 12,A00,891180,Staff,16,0,30,14
1746589224279,POLI 27,A01,891182,Staff,12,0,75,63
1746589225307,POLI 30,A00,891183,Staff,8,0,50,42
1746589226332,POLI 100B,A00,891244,Staff,5,1,35,30
1746589227383,POLI 100I,A00,891247,Staff,7,0,30,23
1746589228412,POLI 104J,A00,891248,Nichter; Maysa,14,0,30,16
1746589229437,POLI 104U,A00,891250,Nichter; Maysa,1,0,30,29
1746589231488,POLI 110B,A00,891255,Wiens; David,19,0,25,6
1746589232512,POLI 112A,A00,891256,Wiens; David,6,0,25,19
1746589233536,POLI 114BR,A00,891261,Staff,19,0,30,11
1746589234559,POLI 117R,A00,891262,Forman; Fonna,0,6,50,50
1746589235588,POLI 118,A00,891264,Ingham; Sean,17,0,25,8
1746589236611,POLI 124A,A00,891265,Staff,18,0,20,2
1746589237637,POLI 125D,A00,891266,Nichter; Simeon C,2,0,25,23
1746589238668,POLI 126,A00,891268,Nichter; Simeon C,7,0,25,18
1746589239692,POLI 126AA,A00,891272,Staff,15,0,25,10
1746589240718,POLI 130AA,A00,891273,Staff,15,0,20,5
1746589241745,POLI 134AA,A00,891274,Staff,4,0,20,16
1746589243800,POLI 138,A00,891278,Staff,21,0,25,4
1746589244829,POLI 142K,A00,891280,Staff,10,0,25,15
1746589245856,POLI 142M,A00,891281,Gartzke; Erik,16,0,30,14
1746589246882,POLI 142P,A00,891284,Staff,20,0,30,10
1746589247910,POLI 143,A00,891285,Gartzke; Erik,12,0,30,18
1746589248934,POLI 153,A00,891286,Staff,19,0,20,1
1746589250984,POLI 175,A00,891290,Staff,15,0,20,5
1746589252009,PSYC 1,A00,890674,Steiner; Eric Tomas,0,11,45,45
1746589253032,PSYC 2,A00,890676,Albright; Thomas D,20,0,35,15
1746589254060,PSYC 3,A00,890679,Staff,17,0,20,3
1746589255088,PSYC 6,A00,959858,Staff,19,0,20,1
1746589256118,PSYC 60,A01,890684,Rickard; Timothy C.,0,6,45,45
1746589257148,PSYC 70,A01,890689,Geller; Emma Harlan,6,0,30,24
1746589258178,PSYC 71,A01,959860,Staff,21,0,25,4
1746589259203,PSYC 100,A00,890690,Lacefield; Katharine I,0,50,180,180
1746589260227,PSYC 102,A00,890695,Staff,17,0,40,23
1746589261256,PSYC 105,A00,890699,Geller; Emma Harlan,70,0,100,30
1746589262281,PSYC 106,A00,890701,Gorman; Michael R.,5,0,30,25
1746589263307,PSYC 108,A00,890704,Adrian; Julia Anna,0,29,50,50
1746589264335,PSYC 118,A01,890712,Staff,11,0,30,19
1746589265358,PSYC 124,A00,890716,Chapman; Eddie Nathaniel,25,0,60,35
1746589266383,PSYC 131,A00,890717,Anagnostaras; Stephan,0,7,80,80
1746589267413,PSYC 137,A00,890719,Winkielman; Piotr,0,11,30,30
1746589268440,PSYC 144,A00,890721,Adrian; Julia Anna,0,9,45,45
1746589269466,PSYC 162,A00,890805,Staff,0,1,75,75
1746589270493,PSYC 169,A00,890810,Staff,0,15,30,30
1746589271518,PSYC 172,A00,890814,Gorman; Michael R.,9,0,30,21
1746589272547,PSYC 181,A00,890818,Anagnostaras; Stephan,7,0,200,193
1746589273574,PSYC 184,A00,959861,Staff,164,0,175,11
1746589274598,PSYC 189,A00,890823,Staff,0,2,30,30
1746589275624,PSYC 191,A00,890884,Rickard; Timothy C.,0,12,35,35
1746589276650,PSYC 193,A00,890913,Staff,19,0,30,11
1746589276650,PSYC 193,B00,890914,Chapman; Eddie Nathaniel,24,0,30,6
1746589277680,PSYC 193L,A01,890918,Lowe; Angela Beth,20,0,30,10
1746589277680,PSYC 193L,B01,890921,Hurwitz; Ethan Scott,20,0,30,10
1746589277680,PSYC 193L,C01,890928,Staff,30,0,30,0
1746589278709,RELI 149,A00,886806,Rahimi; Babak,23,0,40,17
1746589279736,SE 9,A01,886814,Staff,7,0,20,13
1746589280766,SE 101B,A01,886816,Chadha; Mayank,3,0,35,32
1746589281794,SE 110B,A00,886818,Zhu; Qiang,4,0,75,71
1746589282818,SE 125,A01,886830,Staff,10,0,30,20
1746589283843,SE 130B,A01,886835,Staff,14,0,40,26
1746589284870,SE 131A,A01,886838,Krysl; Petr,34,0,55,21
1746589285896,SE 154,A00,886840,Staff,28,0,50,22
1746589286919,SE 164GS,A01,886849,Staff,6,0,20,14
1746589287946,SE 167GS,A01,886853,Staff,6,0,20,14
1746589288975,SIO 25,A01,890107,Staff,19,0,30,11
1746589290005,SIO 45,A00,890109,Cook; Geoffrey W,116,0,200,84
1746589291032,SIO 109R,A00,890110,Forman; Fonna,0,16,20,20
1746589292059,SIO 187,A01,890114,Kacev; David,15,0,40,25
1746589293084,SOCI 1,A01,890431,Thorpe; Charles Robert,14,0,30,16
1746589293084,SOCI 1,A02,890518,Thorpe; Charles Robert,30,0,30,0
1746589294113,SOCI 2,A01,957978,Staff,25,0,25,0
1746589294113,SOCI 2,A02,957979,Staff,23,0,25,2
1746589295137,SOCI 20,A01,890523,Calderon-Zaks; Michael Aar,21,0,30,9
1746589295137,SOCI 20,A02,890526,Calderon-Zaks; Michael Aar,29,0,30,1
1746589296162,SOCI 30,A01,890533,Pardo Guerra; Juan Pablo,37,0,40,3
1746589297188,SOCI 40,A01,890535,Staff,27,0,45,18
1746589298215,SOCI 104Q,A00,890559,Staff,18,0,30,12
1746589299240,SOCI 106,A00,890560,Arnal; Maud Marie Leonie,20,0,30,10
1746589300268,SOCI 110,A00,890567,Holkenbrink-Monk; Charlene,19,0,30,11
1746589301293,SOCI 112,A00,890568,Victoria Torres; Pablo,2,0,55,53
1746589302318,SOCI 115,A00,890597,Arnal; Maud Marie Leonie,28,0,45,17
1746589304374,SOCI 121,A00,890604,Pardo Guerra; Juan Pablo,38,0,45,7
1746589305399,SOCI 126,A01,890608,Staff,8,0,10,2
1746589306477,SOCI 127,A00,890609,Staff,18,0,30,12
1746589307502,SOCI 131,A00,890610,Thorpe; Charles Robert,37,0,45,8
1746589308592,SOCI 135,A00,890615,Payne; Christine Anna,14,0,45,31
1746589309617,SOCI 139,A00,890620,Staff,38,0,45,7
1746589310647,SOCI 148E,A00,890622,Calderon-Zaks; Michael Aar,36,0,45,9
1746589311673,SOCI 150,A00,890623,Kohler; Kristopher M.,31,0,45,14
1746589312697,SOCI 157,A00,890625,Jules-Rosette; Bennetta W.,18,0,20,2
1746589313721,SOCI 160,A00,890627,Payne; Christine Anna,21,0,45,24
1746589314752,SYN 1,A00,886855,Fish; Gwendolyn Anne,0,1,0,0
1746589314752,SYN 1,B00,906086,Fish; Gwendolyn Anne,0,2,0,2
1746589315779,SYN 2R,A00,886860,Staff,0,17,15,15
1746589315779,SYN 2R,B00,906106,Atkinson; Arthur Laird,0,16,15,15
1746589316806,SYN 100,A01,886866,Browne; Emily,0,28,20,20
1746589316806,SYN 100,B01,906128,Rock; Martin,0,4,20,20
1746589316806,SYN 100,C01,906140,Deavenport; James Cary,0,4,20,20
1746589316806,SYN 100,D01,907816,Deavenport; James Cary,0,5,20,20
1746589317832,TDAC 1,A00,890286,Walsh; Kim C.,7,0,20,13
1746589318857,TDAC 101,A00,890296,Basso; Beatrice,15,0,20,5
1746589319883,TDDE 131,A00,890297,Staff,47,0,50,3
1746589320913,TDDM 1,A00,890287,Weinberg; Sadie,25,0,30,5
1746589321938,TDGE 11,A00,890288,Fulton; Julia,138,0,200,62
1746589321938,TDGE 11,B00,890289,Castro; Robert Jess,185,0,200,15
1746589322964,TDGE 25,B00,957359,Walsh; Kim C.,5,0,20,15
1746589323989,TDGE 40,A01,890292,Power; Jade Yukana,26,0,30,4
1746589325017,TDGE 124,A00,890298,Havis; Allan,0,2,50,50
1746589326043,TDGE 131R,A00,890299,Burelle; Julie Sara Veronique,15,0,42,27
1746589327066,TDHT 101,A00,890300,Staff,10,0,20,10
1746589328096,TDHT 109,A01,890302,Anderson; Mysia Anyse,31,0,40,9
1746589329125,TDMV 1,A00,890293,Arcidiacono; Kristin,18,0,30,12
1746589330149,TDMV 2,A00,890294,Weinberg; Sadie,23,0,30,7
1746589331177,TDMV 3,A00,957878,Arcidiacono; Kristin,28,0,30,2
1746589333231,TDMV 138,A00,890304,Jun; Grace Shin Hae,25,0,40,15
1746589334259,TDMV 140,A00,890305,Corrales; Joseph Bernales,25,0,30,5
1746589335283,TDMV 142,A00,890307,Caligagan; Tony,32,0,40,8
1746589336313,TDMV 144,A00,890308,Camaya; Michelle Ann,25,0,30,5
1746589337340,TDPW 1,A00,890295,Stein; Deborah Isobel,3,0,20,17
1746589338370,USP 2,A01,890272,Lerner; Amy M,7,0,20,13
1746589339396,USP 3,A01,890274,Staff,12,0,30,18
1746589340424,USP 15,A01,890276,Sun; Feiyang,16,0,30,14
1746589341452,USP 25,A00,890277,Shenkman; Michael Thomas,18,0,25,7
1746589342481,USP 138,A00,890278,Staff,13,0,25,12
1746589343507,USP 143,A00,890279,Staff,22,0,70,48
1746589344533,USP 144,A00,890280,Chowdhury; Muhammed Zohir,16,0,30,14
1746589345561,USP 150,A00,890281,Boomhower; Matthew Charles,4,0,30,26
1746589346590,USP 151,A00,890282,Staff,16,0,20,4
1746589347614,USP 162,A00,890283,Andrews; Abigail Leslie,16,0,20,4
1746589348642,USP 168,A00,920477,Kwak; Nancy,0,0,5,5
1746589349671,USP 181,A00,890284,Staff,3,0,20,17
1746589350699,USP 191A,A00,890285,Staff,12,0,20,8
1746589351723,VIS 101,A00,886512,Staff,26,0,75,49
1746589352752,VIS 103,A00,886513,Cruz; Edwin Teddy,61,0,75,14
1746589353778,VIS 108,A00,886514,Staff,3,0,15,12
1746589354807,VIS 127P,A00,886515,Shen; Kuiyi,79,0,146,67
1746589355831,VIS 149,A00,886516,Yoldas; Pinar,0,0,15,15
1746589356860,VIS 164,A00,886526,Erdmann; Dean,19,0,22,3
1746589357887,VIS 194S,A00,886527,Staff,61,0,75,14
1746589358915,WCWP 10A,C00,886484,Martiniuk; Jill,12,0,15,3
1746589359942,WCWP 10B,A00,886490,Uriarte; Emma,0,0,15,15
1746589359942,WCWP 10B,B00,886491,Dhir; Simrita,8,0,15,7
1746589359942,WCWP 10B,C00,886492,Ornelas; Tricia,0,0,15,15
1746589360967,WCWP 100,A00,886494,Young; Mark T,0,6,15,15
1746589363058,AAS 10,A01,886199,Childs; Dennis R.,0,3,0,0
1746589364084,ANAR 104,A01,886940,Shtienberg; Gilad,27,0,30,3
1746589365112,ANAR 120,A00,886953,Staff,13,0,20,7
1746589366142,ANBI 148,A01,886955,Wilder; Linnea Lorene,30,0,40,10
1746589368194,ANSC 122,A00,886957,Staff,24,0,30,6
1746589369219,ANSC 150,A00,886958,Sloane; Julia Kathryn,2,0,15,13
1746589370245,ANSC 156,A00,886959,Jenkins; Janis A.,0,1,15,15
1746589371270,ANSC 180,A00,886960,Staff,11,0,17,6
1746589372299,ANSC 188,A00,886961,Jassal; Aftab,9,0,25,16
1746589373325,ANSC 190,A00,886962,Jassal; Aftab,14,0,25,11
1746589374353,ANSC 191,A00,886963,Staff,18,0,20,2
1746589375381,ANTH 3,A01,891689,Staff,17,0,20,3
1746589376407,ANTH 5,A00,886933,Semendeferi; Ekaterini,16,0,20,4
1746589377436,ANTH 10,A00,886934,Staff,0,12,30,30
1746589378464,ANTH 21,A01,886936,Staff,41,0,60,19
1746589379488,ANTH 23,A01,886938,Staff,92,0,100,8
1746589380514,ANTH 105,A00,886964,Stewart; Alexander B,84,0,100,16
1746589381542,ANTH 108,A00,886965,Pedersen; David,9,0,20,11
1746589382571,AWP 10,001,886147,Staff,0,0,0,0
1746589382571,AWP 10,002,886148,Staff,0,0,0,0
1746589382571,AWP 10,003,886149,Staff,0,0,0,0
1746589382571,AWP 10,004,886150,Staff,0,0,0,0
1746589382571,AWP 10,005,886151,Staff,0,0,0,0
1746589382571,AWP 10,006,886152,Staff,0,0,0,0
1746589382571,AWP 10,007,886153,Staff,0,0,0,0
1746589382571,AWP 10,008,886154,Staff,0,0,0,0
1746589382571,AWP 10,009,886155,Staff,0,0,0,0
1746589382571,AWP 10,010,886156,Staff,0,0,0,0
1746589382571,AWP 10,011,886158,Staff,0,0,0,0
1746589382571,AWP 10,012,886160,Staff,0,0,0,0
1746589382571,AWP 10,013,886161,Staff,0,0,0,0
1746589382571,AWP 10,014,886162,Staff,0,0,0,0
1746589382571,AWP 10,015,886163,Staff,0,0,0,0
1746589382571,AWP 10,016,886164,Staff,0,0,0,0
1746589382571,AWP 10,017,886165,Staff,0,0,0,0
1746589382571,AWP 10,018,886166,Staff,0,0,0,0
1746589382571,AWP 10,019,886168,Staff,0,0,0,0
1746589382571,AWP 10,020,886170,Staff,0,0,0,0
1746589382571,AWP 10,021,886172,Staff,0,0,0,0
1746589383602,AWP 10R,001,886173,Staff,0,1,0,0
1746589383602,AWP 10R,002,886174,Staff,0,1,0,0
1746589383602,AWP 10R,003,886175,Staff,0,0,0,0
1746589383602,AWP 10R,004,886176,Staff,0,0,0,0
1746589383602,AWP 10R,005,886177,Staff,0,0,0,0
1746589383602,AWP 10R,006,886178,Staff,0,0,0,0
1746589383602,AWP 10R,007,886179,Staff,0,0,0,0
1746589383602,AWP 10R,008,886181,Staff,0,0,0,0
1746589383602,AWP 10R,009,886182,Staff,0,0,0,0
1746589383602,AWP 10R,010,886183,Staff,0,0,0,0
1746589383602,AWP 10R,011,886184,Staff,0,0,0,0
1746589383602,AWP 10R,012,886185,Staff,0,0,0,0
1746589383602,AWP 10R,013,886186,Staff,0,0,0,0
1746589383602,AWP 10R,014,886187,Staff,0,0,0,0
1746589383602,AWP 10R,015,886188,Staff,0,0,0,0
1746589383602,AWP 10R,016,886189,Staff,0,0,0,0
1746589383602,AWP 10R,017,960532,Staff,0,0,0,0
1746589383602,AWP 10R,018,960533,Staff,0,0,0,0
1746589383602,AWP 10R,019,960534,Staff,0,0,0,0
1746589383602,AWP 10R,020,960538,Staff,0,0,0,0
1746589383602,AWP 10R,021,960540,Staff,0,0,0,0
1746589383602,AWP 10R,022,960541,Staff,0,0,0,0
1746589383602,AWP 10R,023,960542,Staff,0,0,0,0
1746589383602,AWP 10R,024,960544,Staff,0,0,0,0
1746589383602,AWP 10R,025,960545,Staff,0,0,0,0
1746589383602,AWP 10R,026,960548,Staff,0,0,0,0
1746589384628,AWP 102R,A00,886190,Staff,0,0,0,0
1746589384628,AWP 102R,B00,886191,Staff,0,0,0,0
1746589385653,BENG 100,A01,886193,Staff,17,0,30,13
1746589386680,BENG 122A,A01,886195,Hasty; Jeff M,13,0,30,17
1746589387707,BENG 166A,A00,886196,Sah; Robert Lie-Yuan,0,3,30,30
1746589388735,BENG 190,A00,958050,Khojah; Reem I,17,0,25,8
1746589389761,BIBC 102,A01,894320,Staff,0,0,46,46
1746589389761,BIBC 102,A02,894321,Staff,0,0,46,46
1746589389761,BIBC 102,A03,894344,Staff,6,0,46,40
1746589389761,BIBC 102,A04,894345,Staff,27,0,47,20
1746589390790,BICD 100R,A01,894365,Smith; Laurie,1,3,58,57
1746589390790,BICD 100R,A02,894366,Smith; Laurie,1,5,58,57
1746589390790,BICD 100R,A03,894367,Smith; Laurie,0,0,59,59
1746589390790,BICD 100R,A04,959869,Smith; Laurie,40,0,59,19
1746589391822,BICD 136,A01,894383,Gustafson-Brown; Cindy,14,0,50,36
1746589392848,BIEB 102,A01,894494,Butler; Shannon Rhey,51,0,130,79
1746589394905,BIEB 150,A01,894617,Wills; Christopher,3,0,20,17
1746589394905,BIEB 150,A02,894631,Wills; Christopher,3,0,20,17
1746589394905,BIEB 150,A03,894937,Wills; Christopher,3,0,20,17
1746589394905,BIEB 150,A04,894946,Wills; Christopher,5,0,20,15
1746589395929,BIEB 194,A00,906141,Kurle; Carolyn M.,5,0,20,15
1746589396960,BILD 1,A01,894154,Staff,3,0,19,16
1746589396960,BILD 1,A02,894155,Staff,14,0,19,5
1746589396960,BILD 1,A03,894160,Staff,13,0,19,6
1746589396960,BILD 1,A04,894161,Staff,15,0,18,3
1746589397985,BILD 2,A01,894168,Staff,0,0,50,50
1746589397985,BILD 2,A02,894169,Staff,0,0,50,50
1746589397985,BILD 2,A03,894179,Staff,0,0,50,50
1746589397985,BILD 2,A04,894203,Staff,23,0,50,27
1746589399011,BILD 3,A01,894213,Staff,23,0,31,8
1746589399011,BILD 3,A02,894214,Staff,26,0,31,5
1746589399011,BILD 3,A03,894235,Staff,28,0,31,3
1746589399011,BILD 3,A04,894236,Staff,28,0,32,4
1746589400038,BILD 4,A01,894253,Reuther; Keefe,5,0,24,19
1746589400038,BILD 4,A02,894258,Reuther; Keefe,16,0,24,8
1746589401064,BILD 5,A01,894276,Reuther; Keefe,34,0,50,16
1746589401064,BILD 5,A02,894277,Reuther; Keefe,45,0,50,5
1746589401064,BILD 5,A03,894290,Reuther; Keefe,44,0,50,6
1746589401064,BILD 5,A04,894291,Reuther; Keefe,48,0,50,2
1746589402090,BILD 24,A01,894297,Pirino; Giorgia,40,0,60,20
1746589403118,BIMM 100,B01,958915,Staff,71,0,100,29
1746589404145,BIMM 101,A01,895017,McDonnell; Lisa Marie,0,5,24,24
1746589404145,BIMM 101,A02,895018,McDonnell; Lisa Marie,0,5,24,24
1746589404145,BIMM 101,B01,895020,McDonnell; Lisa Marie,1,6,24,23
1746589404145,BIMM 101,B02,895021,McDonnell; Lisa Marie,0,4,24,24
1746589405171,BIMM 110,A01,895023,Staff,1,0,25,24
1746589405171,BIMM 110,A02,895024,Staff,9,0,25,16
1746589405171,BIMM 110,A03,895025,Staff,18,0,25,7
1746589405171,BIMM 110,A04,895031,Staff,20,0,25,5
1746589406197,BIMM 120,A01,895114,Gustafson-Brown; Cindy,14,0,28,14
1746589406197,BIMM 120,A02,895126,Gustafson-Brown; Cindy,21,0,27,6
1746589407222,BIPN 100,A01,895130,Yang; Mingyu,0,0,38,38
1746589407222,BIPN 100,A02,895131,Yang; Mingyu,31,0,38,7
1746589407222,BIPN 100,A03,895132,Yang; Mingyu,32,0,38,6
1746589407222,BIPN 100,A04,895133,Yang; Mingyu,27,0,36,9
1746589408251,BIPN 120,A01,895135,Cooke; James Edward,0,3,13,13
1746589408251,BIPN 120,A02,895136,Cooke; James Edward,0,1,13,13
1746589408251,BIPN 120,A03,895137,Cooke; James Edward,0,3,13,13
1746589408251,BIPN 120,A04,895156,Cooke; James Edward,0,2,11,11
1746589409277,BIPN 134,A01,895235,Cooke; James Edward,0,2,25,25
1746589409277,BIPN 134,A02,895237,Cooke; James Edward,0,0,25,25
1746589409277,BIPN 134,A03,895240,Cooke; James Edward,3,0,25,22
1746589409277,BIPN 134,A04,895270,Cooke; James Edward,20,0,25,5
1746589410342,BIPN 189,A00,892103,Staff,0,14,14,14
1746589412401,BISP 194,A00,958008,Staff,0,2,0,0
1746589413427,CAT 124,A01,922009,Staff,0,5,20,20
1746589414452,CAT 125R,A00,886390,Morales; Celeste Georgianna,0,3,20,20
1746589414452,CAT 125R,B00,886391,Irwin; Matthew Joseph,0,4,20,20
1746589414452,CAT 125R,C00,886392,Smith; Lauryn Alissa,0,2,20,20
1746589414452,CAT 125R,D00,886393,Vanderschuit; Maya Alysia,0,3,20,20
1746589414452,CAT 125R,E00,886394,Marchisotto; Jennifer Anne,0,3,20,20
1746589415477,CENG 15,A01,886218,Drews; Aaron,3,0,8,5
1746589416503,CENG 113,A00,886219,Opatkiewicz; Justin Paul,15,0,25,10
1746589417530,CGS 101,A00,887044,Staff,7,0,20,13
1746589418557,CGS 105,A01,887046,Staff,14,0,25,11
1746589419584,CGS 112,A00,887047,Cuong; Marisol,12,0,15,3
1746589420611,CGS 113,A00,887048,Staff,23,0,30,7
1746589421639,CGS 120,A00,887049,Staff,10,0,17,7
1746589422666,CHEM 6A,A01,886336,Lam; Tin Yiu,38,0,50,12
1746589422666,CHEM 6A,A02,886338,Lam; Tin Yiu,37,0,50,13
1746589423691,CHEM 6B,A01,886341,Hopkins; Patrycja Anna,16,0,50,34
1746589423691,CHEM 6B,A02,886343,Hopkins; Patrycja Anna,42,0,50,8
1746589424718,CHEM 6C,A01,886346,Albizati; Kim F.,0,2,50,50
1746589424718,CHEM 6C,A02,886348,Albizati; Kim F.,24,0,50,26
1746589425747,CHEM 40A,A01,886352,Klosterman; Jeremy K,65,0,100,35
1746589426773,CHEM 40B,A01,886356,Klosterman; Jeremy K,0,24,100,100
1746589427798,CHEM 41B,A01,886360,Theodorakis; Emmanuel,25,0,50,25
1746589427798,CHEM 41B,A02,886362,Theodorakis; Emmanuel,47,0,50,3
1746589428823,CHIN 165A,A00,886382,Xu; Li,18,0,20,2
1746589429853,CLAS 120,A00,886387,Myerston Santana; Jacobo,33,0,40,7
1746589430878,COGS 9,A01,886967,Shannon; Kyle Michael,42,0,60,18
1746589431905,COGS 11,A01,886969,Staff,9,0,30,21
1746589432933,COGS 14A,A01,886971,Staff,6,0,60,54
1746589433962,COGS 14B,A01,886973,Hoffman; Drew Ellen,4,0,60,56
1746589434992,COGS 18,A01,886975,Morgan; Eric,34,0,60,26
1746589436017,COGS 20,A01,886977,Staff,2,0,8,6
1746589436017,COGS 20,A02,886978,Staff,4,0,7,3
1746589437041,COGS 100,A01,907783,Staff,1,2,30,29
1746589438066,COGS 101B,A01,886980,Staff,0,4,48,48
1746589439093,COGS 101C,A01,886982,Delgado; Tania,0,5,44,44
1746589440123,COGS 102A,A01,886984,Johnson; Christine M.,3,0,30,27
1746589441151,COGS 118B,A01,886986,Staff,1,5,88,87
1746589442178,COGS 150,A01,886988,Bergen; Benjamin,22,0,50,28
1746589443203,COGS 153,A00,886989,Delgado; Tania,0,3,41,41
1746589444226,COGS 186,A01,886991,Staff,0,0,32,32
1746589445252,COGS 187A,A01,886993,Boyle; Mary E. T.,7,0,30,23
1746589446277,COGS 189,A00,886994,Staff,0,1,30,30
1746589447305,COMM 10,A01,886996,Staff,0,0,20,21
1746589447305,COMM 10,A02,886997,Staff,10,0,20,10
1746589447305,COMM 10,A03,959845,Staff,19,0,20,1
1746589448329,COMM 20,A01,886999,Leuning; Grant Maurstad,24,0,40,16
1746589450386,COMM 100A,A01,887002,Staff,0,0,20,25
1746589450386,COMM 100A,A02,887003,Staff,6,0,20,14
1746589451410,COMM 100B,A01,887005,Staff,0,8,20,24
1746589452438,COMM 106D,A00,887006,Staff,13,0,40,27
1746589453463,COMM 110G,A00,887007,Whitworth-Smith; Andrew C,12,0,40,28
1746589454492,COMM 111B,A00,887008,Staff,31,0,40,9
1746589455517,COMM 113T,A00,887009,Abuelhiga; Soraya Jill,28,0,40,12
1746589455517,COMM 113T,B00,906733,Staff,40,0,40,0
1746589456541,COMM 145,A00,887010,Staff,12,0,40,28
1746589457568,COMM 146,A00,887054,Staff,31,0,40,9
1746589458594,COMM 190,A00,887012,Staff,8,0,23,15
1746589459620,CSE 8A,A50,887015,Cao; Yingjun,56,0,85,29
1746589460645,CSE 11,A01,887017,Cao; Yingjun,11,0,70,59
1746589461671,CSE 20,A01,887019,Staff,30,0,50,20
1746589462700,CSE 21,A01,887021,Staff,78,0,100,22
1746589462700,CSE 21,B01,892583,Braun; Oliver,45,0,50,5
1746589463729,CSE 30,A01,887025,Eldon; John,142,0,200,58
1746589464755,CSE 100,A01,887027,Staff,26,0,50,24
1746589464755,CSE 100,A02,887028,Staff,42,0,50,8
1746589465781,CSE 101,A01,887030,Braun; Oliver,74,0,100,26
1746589465781,CSE 101,B01,887032,Jones; Miles E,0,3,50,50
1746589465781,CSE 101,B02,887033,Jones; Miles E,0,2,50,50
1746589466807,CSE 105,A01,908084,Jones; Miles E,32,0,50,18
1746589466807,CSE 105,A02,908087,Jones; Miles E,31,0,50,19
1746589467830,CSE 135,A01,887035,Powell; Thomas Allan,0,5,50,50
1746589468858,CSE 142,A01,887037,Staff,8,0,60,52
1746589469884,CSE 142L,A01,887039,Staff,34,0,60,26
1746589470909,CSE 151A,A01,887041,Solares; Edwin A,47,0,100,53
1746589471938,CSE 175,A01,887043,Kumar; Rakesh,30,0,30,0
1746589472962,CSS 1,A01,886389,Staff,1,2,40,39
1746589473988,DSC 30,A01,908097,Liao; Soohyun Nam,47,0,75,28
1746589475015,DSC 40A,A01,908099,Shannon; Kyle Michael,30,0,50,20
1746589476044,DSC 40B,A01,908112,Staff,15,0,50,35
1746589477072,DSC 80,A01,908116,Staff,19,0,60,41
1746589478105,DSC 197,001,956863,Eldridge; Justin Matthew,9999,0,9999,0
1746589479131,ECE 5,A01,886400,Morris; Karcher William,1,0,6,5
1746589479131,ECE 5,A02,886401,Morris; Karcher William,3,0,6,3
1746589480160,ECE 148,A01,886403,Silberman; Jack,0,14,14,14
1746589481190,ECON 1,A01,887265,Crane; Meredith Helen,11,0,70,59
1746589481190,ECON 1,B01,887268,Staff,42,0,50,8
1746589482215,ECON 2,A01,887273,Crane; Meredith Helen,54,0,70,16
1746589483242,ECON 3,A01,887279,Rondina; Giacomo,31,0,70,39
1746589484266,ECON 4,A01,887282,Anderson; John Charles,0,2,10,10
1746589485294,ECON 5,A01,887285,Staff,34,0,45,11
1746589485294,ECON 5,B01,887292,Staff,41,0,45,4
1746589486324,ECON 100A,A01,887337,Newhouse; Herbert S,54,0,70,16
1746589486324,ECON 100A,B01,887349,Staff,45,0,50,5
1746589487350,ECON 100B,A01,887361,Du; Songzi,29,0,70,41
1746589488375,ECON 100C,A01,887445,Newhouse; Herbert S,59,0,70,11
1746589489402,ECON 105,A00,887488,Vespa; Emanuel Ignacio,23,0,35,12
1746589490428,ECON 109,A01,887506,Shishkin; Denis,28,0,35,7
1746589491456,ECON 110A,A01,887568,Alon; Titan Michael,1,3,35,34
1746589491456,ECON 110A,B01,907601,Alon; Titan Michael,20,0,35,15
1746589492483,ECON 110B,A01,887598,Levkoff; Steven B.,0,24,70,70
1746589493510,ECON 112,A00,887599,Rondina; Giacomo,19,0,35,16
1746589494534,ECON 120A,A01,887603,Dai; Yinlin,35,0,70,35
1746589495561,ECON 120C,A01,887608,Sun; Yixiao,0,1,35,35
1746589495561,ECON 120C,B01,887614,Sun; Yixiao,0,0,35,35
1746589496586,ECON 138,A00,887621,Bharadwaj; Prashant,0,21,20,20
1746589497612,ECON 144,A00,958007,Squires; Dale E,12,0,35,23
1746589498641,ECON 171,A01,907666,Staff,18,0,35,17
1746589499670,ECON 175,A00,887626,Wu; Pak Yeung,22,0,35,13
1746589500696,ECON 190,A00,887640,Vespa; Emanuel Ignacio,22,0,35,13
1746589501752,EDS 25,A01,888197,Staff,0,0,0,0
1746589501752,EDS 25,A02,888209,Staff,0,0,0,0
1746589501752,EDS 25,A03,888210,Staff,0,0,0,0
1746589501752,EDS 25,A04,888212,Staff,0,0,0,0
1746589501752,EDS 25,A05,888213,Staff,0,0,0,0
1746589501752,EDS 25,A06,888214,Staff,0,0,0,0
1746589501752,EDS 25,A07,888235,Staff,0,2,0,0
1746589501752,EDS 25,A08,888236,Staff,0,0,0,0
1746589501752,EDS 25,A09,888240,Staff,0,0,0,0
1746589501752,EDS 25,A10,888244,Staff,0,0,0,0
1746589501752,EDS 25,B01,888273,Staff,0,0,0,0
1746589501752,EDS 25,B02,888285,Staff,0,0,0,0
1746589501752,EDS 25,B03,888423,Staff,0,0,0,1
1746589501752,EDS 25,B04,888432,Staff,0,0,0,0
1746589501752,EDS 25,B05,888433,Staff,0,0,0,0
1746589501752,EDS 25,B06,888467,Staff,0,0,0,0
1746589501752,EDS 25,B07,888468,Staff,0,0,0,0
1746589501752,EDS 25,B08,888479,Staff,0,0,0,0
1746589501752,EDS 25,B09,888484,Staff,0,0,0,0
1746589501752,EDS 25,B10,888487,Staff,0,0,0,0
1746589502777,EDS 38,A01,907700,Choi; Bailey Miyeon,30,0,30,0
1746589503805,EDS 112,A01,888601,Chapman; Thandeka K,12,0,40,28
1746589504831,EDS 115,A00,888697,Mendez; Kathrina Mendoza,10,0,30,20
1746589505858,EDS 116,A01,888893,Staff,33,0,40,7
1746589507914,EDS 124AR,A00,889133,Staff,29,0,50,21
1746589507914,EDS 124AR,B00,907471,Simon; Elizabeth A,37,0,50,13
1746589508942,EDS 124BR,A00,889134,Simon; Elizabeth A,44,0,100,56
1746589509971,EDS 125,A00,889135,Staff,25,0,30,5
1746589510997,EDS 126,A01,889138,Staff,35,0,40,5
1746589512027,EDS 164R,A01,889142,Wishard Guerra; Alison G.,32,0,50,18
1746589513055,ENG 30,A01,886396,Staff,0,0,0,0
1746589513055,ENG 30,B01,886398,Staff,0,0,0,0
1746589514120,ENVR 102,A00,906150,Montejo; Carolina,23,0,25,2
1746589515148,ETHN 103A,A00,887236,Man; Simeon S,0,3,0,0
1746589516175,ETHN 113,A00,887239,Staff,16,0,30,14
1746589517202,ETHN 116,A00,887240,Staff,16,0,25,9
1746589518227,ETHN 117,A00,887241,Choi; Esther Min,28,0,30,2
1746589519253,ETHN 118,A00,887243,Staff,24,0,30,6
1746589520283,ETHN 127,A00,887248,Cuong; Marisol,11,0,15,4
1746589521310,ETHN 139,A00,887250,Staff,7,0,10,3
1746589522336,ETHN 142,A00,887252,Staff,10,0,30,20
1746589523361,ETHN 161,A00,887253,Browne; Errol Tsekani,24,0,30,6
1746589524386,ETHN 163FR,A00,887255,Burelle; Julie Sara Veronique,0,0,5,5
1746589525413,GLBH 20,A00,889149,Elwardani; Nile Regina,8,0,42,34
1746589527468,GLBH 111,A01,889152,Burgos; Jose L.,17,0,17,0
1746589528496,GLBH 150,A00,889181,Sloane; Julia Kathryn,0,5,15,15
1746589530548,HDS 60,A01,886406,Warstadt; Melissa Fawn,73,0,80,7
1746589531576,HIAF 111,A00,889324,Gyamfi; Bright,25,0,32,7
1746589532602,HIEA 131,A00,889328,Staff,15,0,32,17
1746589533632,HIEA 144,A00,889333,Henry; Todd A.,26,0,32,6
1746589534660,HIEA 154,A00,889336,Henry; Todd A.,24,0,32,8
1746589535686,HIEU 106,A00,889339,Staff,22,0,32,10
1746589537749,HIEU 114,A00,889340,Staff,4,0,32,28
1746589538775,HIEU 135GS,A00,889342,Patterson; Patrick H.,0,0,1,24
1746589539801,HIEU 137,A00,889343,Edington; Claire Ellen,10,0,25,15
1746589540830,HIEU 148,A00,889345,Staff,14,0,32,18
1746589541854,HIEU 154,A00,889346,Biess; Frank Peter,21,0,32,11
1746589542881,HILA 102,A00,889351,Staff,12,0,32,20
1746589543905,HILD 2A,A01,889221,Lewandoski; Julia Mavis,2,10,32,30
1746589544930,HILD 7B,A01,889225,Man; Simeon S,0,12,32,32
1746589545956,HILD 7C,A01,889288,Alvarez; Luis A,0,14,32,32
1746589546982,HILD 30,A01,889323,Staff,0,5,32,32
1746589549035,HISC 119,A00,889383,Golan; Tal,19,0,32,13
1746589550061,HIUS 103,A00,889384,Man; Simeon S,0,0,32,32
1746589551091,HIUS 117,A00,919797,Kwak; Nancy,18,0,32,14
1746589552118,HIUS 142A,A00,919788,Staff,22,0,32,10
1746589554172,HIUS 149,A00,889386,Gyamfi; Bright,26,0,32,6
1746589555197,HIUS 155,A00,889387,Alvarez; Luis A,15,0,32,17
1746589556225,HUM 3,A01,886499,Caldwell; Michael Alan,19,0,50,31
1746589557252,HUM 3GS,A00,886500,Rodriguez; Bretton Sigfred,0,0,0,28
1746589558281,HUM 3R,A01,886502,Markman; Kristina,0,36,50,50
1746589559310,HUM 4,A01,886504,Crum; Matthew Stephen,23,0,50,27
1746589559310,HUM 4,B01,886506,West; Geoffrey Scott,17,0,50,33
1746589560336,HUM 4GS,A00,886507,Staff,0,0,0,19
1746589561871,HUM 5,A01,886509,Staff,32,0,50,18
1746589562896,HUM 5R,A01,886511,Zavodny; Tatiana Sophia,0,39,50,50
1746589563921,JAPN 180,A00,886407,Staff,16,0,40,24
1746589564952,LATI 50,A01,886409,Martin-Cabrera; Luis,3,0,22,19
1746589564952,LATI 50,A02,886410,Martin-Cabrera; Luis,19,0,22,3
1746589564952,LATI 50,A03,886411,Martin-Cabrera; Luis,21,0,22,1
1746589564952,LATI 50,A04,886412,Martin-Cabrera; Luis,8,0,22,14
1746589565978,LAWS 101,A00,907664,Staff,28,0,60,32
1746589567004,LIAB 1A,A00,889388,Saab; Dima,17,0,20,3
1746589568033,LIAB 1AX,A00,889389,El Cheddadi; Youniss,18,0,20,2
1746589569064,LIFR 1C,A00,889391,Van Moer; Vinciane G,8,0,20,12
1746589570091,LIFR 1CX,A00,889392,Van Moer; Vinciane G,7,0,20,13
1746589571118,LIFR 1D,A00,889393,Van Moer; Vinciane G,7,0,20,13
1746589572143,LIFR 1DX,A00,889394,Van Moer; Vinciane G,8,0,20,12
1746589573171,LIGN 7,A00,886923,Staff,24,0,50,26
1746589574196,LIGN 17,A00,886924,Kehler; Andrew Scott,125,0,150,25
1746589575221,LTAM 110,A00,889395,Staff,15,0,30,15
1746589576248,LTAM 110GS,A00,958010,Rodriguez; Bretton Sigfred,0,0,0,28
1746589577273,LTCH 101,A00,889397,Staff,23,0,25,2
1746589578299,LTCS 130,A00,889398,Staff,23,0,25,2
1746589579327,LTEA 138,A00,889399,Staff,24,0,40,16
1746589580353,LTEN 149,A00,889400,Wesling; Megan E.,0,3,25,25
1746589581381,LTEN 169,A00,889401,Staff,20,0,25,5
1746589582418,LTEN 180,A00,889402,Staff,10,0,15,5
1746589583444,LTEN 181,A00,889403,Staff,21,0,25,4
1746589584471,LTWL 100,A00,889404,Myerston Santana; Jacobo,2,0,25,23
1746589585499,LTWL 180GS,A00,889405,Staff,0,0,20,20
1746589586527,LTWL 181,A00,889406,Staff,16,0,25,9
1746589587554,LTWL 184,A00,889475,Mukherjee; Silpa,22,0,25,3
1746589588579,LTWR 102C,A00,889486,Staff,29,0,30,1
1746589589607,LTWR 115W,A00,889491,Staff,0,2,15,15
1746589590632,MAE 8,A01,886905,Staff,0,2,0,0
1746589591658,MAE 11,A00,886906,Bandaru; Prabhakar,0,7,50,50
1746589592687,MAE 20,A00,886907,Evdokimenko; Ekaterina,43,0,70,27
1746589593716,MAE 30B,A00,886909,Ghazinejad; Maziar,26,0,45,19
1746589594741,MAE 101B,A00,886910,Saintillan; David,29,0,45,16
1746589595771,MAE 105,A00,886911,Bandaru; Prabhakar,18,0,50,32
1746589596797,MAE 107,B00,958024,Staff,7,0,50,43
1746589597827,MAE 143B,A00,886913,Bewley; Thomas R,3,0,40,37
1746589598873,MAE 148,A01,886915,Silberman; Jack,0,3,14,14
1746589599902,MAE 160,A00,886916,Evdokimenko; Ekaterina,31,0,60,29
1746589600927,MATH 3C,A01,889681,Staff,0,2,30,30
1746589600927,MATH 3C,A02,960048,Staff,23,0,30,7
1746589601954,MATH 10A,A01,889760,Staff,26,0,30,4
1746589601954,MATH 10A,A02,889783,Staff,29,0,30,1
1746589602980,MATH 10B,A01,889785,Verstraete; Jacques Allan,1,0,35,34
1746589602980,MATH 10B,A02,889795,Verstraete; Jacques Allan,4,0,35,31
1746589602980,MATH 10B,B01,889797,Verstraete; Jacques Allan,3,0,35,32
1746589602980,MATH 10B,B02,889828,Verstraete; Jacques Allan,3,0,35,32
1746589604017,MATH 10C,A01,889849,Habib; Yousaf,7,0,30,23
1746589604017,MATH 10C,A02,889852,Habib; Yousaf,14,0,30,16
1746589604017,MATH 10C,A03,889853,Habib; Yousaf,22,0,30,8
1746589604017,MATH 10C,A04,889858,Habib; Yousaf,20,0,30,10
1746589604017,MATH 10C,B01,889861,Staff,1,0,30,29
1746589604017,MATH 10C,B02,889862,Staff,24,0,30,6
1746589604017,MATH 10C,B03,889863,Staff,27,0,30,3
1746589604017,MATH 10C,B04,889967,Staff,23,0,30,7
1746589605050,MATH 18,A01,889974,Staff,7,0,30,23
1746589605050,MATH 18,A02,889977,Staff,20,0,30,10
1746589605050,MATH 18,B01,889984,Hardiman; Liam,20,0,30,10
1746589605050,MATH 18,B02,889985,Hardiman; Liam,25,0,30,5
1746589606077,MATH 20A,A01,889990,Suk; Andrew Hoon,30,0,35,5
1746589607103,MATH 20B,A01,889993,Ohm; Ko Woon,21,0,30,9
1746589607103,MATH 20B,A02,889994,Ohm; Ko Woon,30,0,30,0
1746589607103,MATH 20B,B01,889996,Ohm; Ko Woon,22,0,30,8
1746589607103,MATH 20B,B02,889997,Ohm; Ko Woon,23,0,30,7
1746589608133,MATH 20C,A01,889999,Hammock; Frances H,17,0,30,13
1746589608133,MATH 20C,A02,890003,Hammock; Frances H,23,0,30,7
1746589608133,MATH 20C,B01,890006,Hammock; Frances H,3,0,30,27
1746589608133,MATH 20C,B02,890007,Hammock; Frances H,12,0,30,18
1746589609161,MATH 20D,A01,890011,Cheng; Hsiao-Bing,1,1,30,29
1746589609161,MATH 20D,A02,890012,Cheng; Hsiao-Bing,14,0,30,16
1746589609161,MATH 20D,B01,890016,Cheng; Hsiao-Bing,13,0,30,17
1746589609161,MATH 20D,B02,890017,Cheng; Hsiao-Bing,13,0,30,17
1746589610192,MATH 20E,A01,890026,Harel; Guershon,1,0,30,29
1746589610192,MATH 20E,A02,890029,Harel; Guershon,22,0,30,8
1746589610192,MATH 20E,B01,890033,Harel; Guershon,7,0,30,23
1746589610192,MATH 20E,B02,890101,Harel; Guershon,21,0,30,9
1746589611217,MATH 102,A01,890104,Staff,18,0,30,12
1746589611217,MATH 102,A02,890105,Staff,27,0,30,3
1746589612244,MATH 103B,A01,890116,Salehi Golsefidy; Alireza,3,0,30,27
1746589612244,MATH 103B,B01,890118,Staff,0,3,34,34
1746589613272,MATH 109,A01,890121,Aliabadi Sr.; Mohsen,0,0,30,30
1746589613272,MATH 109,B01,890124,Upadrashta; Pranav Kumar,18,0,30,12
1746589614298,MATH 120A,A01,890126,Eggers; John Dietrich,13,0,30,17
1746589615325,MATH 142B,A01,890128,Ioana; Adrian,19,0,30,11
1746589615325,MATH 142B,A02,890129,Ioana; Adrian,12,0,30,18
1746589616353,MATH 154,A01,890174,Staff,0,1,30,30
1746589616353,MATH 154,A02,890182,Staff,0,0,30,30
1746589617381,MATH 168A,A01,890197,Dumitriu; Ioana,21,0,35,14
1746589618449,MATH 170A,A01,890240,Nie; Jiawang,1,0,30,29
1746589618449,MATH 170A,A02,890241,Nie; Jiawang,11,0,30,19
1746589618449,MATH 170A,A03,890249,Nie; Jiawang,23,0,30,7
1746589619476,MATH 170B,A01,957891,Nag; Panchali,13,0,35,22
1746589621529,MATH 181A,A01,908025,Staff,0,3,35,35
1746589621529,MATH 181A,A02,960115,Staff,26,0,35,9
1746589622555,MATH 181B,A01,959874,Staff,25,0,30,5
1746589623584,MATH 193B,A01,890265,Staff,0,4,35,35
1746589624610,MGT 4,A01,890311,Anderson; John Charles,42,0,88,46
1746589625636,MGT 5,A00,907740,Staff,12,0,98,86
1746589626663,MGT 12,A00,890312,Lindenberger; Wade Douglas,67,0,98,31
1746589627691,MGT 16,A00,957883,Staff,78,0,98,20
1746589629741,MGT 45,A00,890314,Pecore; Joseph P.,45,0,98,53
1746589630766,MGT 71,A00,890315,Staff,0,12,98,98
1746589631793,MGT 100,A00,890316,Yavorsky; Daniel Ryan,44,0,98,54
1746589632817,MGT 103,A00,890317,Ehrich; Kristine R,73,0,98,25
1746589633842,MGT 105,A00,890356,Bates; Kenneth Walter,0,8,98,98
1746589634870,MGT 112,A00,890360,Ehrich; Kristine R,55,0,98,43
1746589635898,MGT 127R,A00,907732,Zhu; Kevin Xiaoguo,23,0,98,75
1746589636922,MGT 131B,A00,890361,Anderson; John Charles,59,0,98,39
1746589637947,MGT 137,A00,890362,Lindenberger; Wade Douglas,65,0,98,33
1746589638975,MGT 160,A00,890369,Johnson; Erik Barry,9,0,98,89
1746589641027,MGT 164,A00,890372,Zimmermann; Carsten,0,40,98,98
1746589642056,MGT 180,A00,890374,Bliss; Barbara Ann,11,0,98,87
1746589643082,MMW 15,A01,886414,Chang; Edmond Yi-Teh,0,12,28,28
1746589643082,MMW 15,A02,886415,Chang; Edmond Yi-Teh,0,8,28,28
1746589643082,MMW 15,A03,886416,Chang; Edmond Yi-Teh,0,9,28,28
1746589643082,MMW 15,A04,886417,Chang; Edmond Yi-Teh,0,8,28,28
1746589643082,MMW 15,B01,886419,Chang; Edmond Yi-Teh,0,7,28,28
1746589643082,MMW 15,B02,886420,Chang; Edmond Yi-Teh,0,8,28,28
1746589643082,MMW 15,B03,886421,Chang; Edmond Yi-Teh,0,7,28,28
1746589643082,MMW 15,B04,886422,Chang; Edmond Yi-Teh,0,8,28,28
1746589643082,MMW 15,C01,886424,Staff,0,9,28,28
1746589643082,MMW 15,C02,886425,Staff,0,8,28,28
1746589643082,MMW 15,C03,886426,Staff,0,8,28,28
1746589643082,MMW 15,C04,886427,Staff,0,8,28,28
1746589643082,MMW 15,C05,958038,Staff,0,8,28,28
1746589643082,MMW 15,C06,958039,Staff,1,8,28,27
1746589644110,MMW 15GS,A00,906910,Patterson; Patrick H.,4,0,28,24
1746589645136,MMW 122R,A01,886429,Rahimi; Babak,0,13,28,28
1746589645136,MMW 122R,A02,886430,Rahimi; Babak,0,12,28,28
1746589645136,MMW 122R,A03,958040,Rahimi; Babak,0,11,28,28
1746589646163,MUS 1A,A01,890937,Staff,2,0,25,23
1746589646163,MUS 1A,A02,891035,Staff,6,0,25,19
1746589646163,MUS 1A,C01,958912,Staff,24,0,25,1
1746589646163,MUS 1A,C02,958913,Staff,25,0,25,0
1746589648215,MUS 2AK,A00,957092,Ohnishi; Takae,15,0,15,0
1746589649244,MUS 4,A01,891044,Staff,0,0,25,25
1746589649244,MUS 4,A02,891045,Staff,23,0,25,2
1746589649244,MUS 4,B01,891048,Staff,17,0,25,8
1746589649244,MUS 4,B02,891050,Staff,25,0,25,0
1746589650270,MUS 5,A01,957506,Dubnov; Shlomo,0,0,25,25
1746589650270,MUS 5,A02,957622,Dubnov; Shlomo,13,0,25,12
1746589650270,MUS 5,A03,957623,Dubnov; Shlomo,20,0,25,5
1746589651295,MUS 6,A01,891053,Freitas Caetano; Marcelo,24,0,25,1
1746589651295,MUS 6,A02,891054,Freitas Caetano; Marcelo,23,0,25,2
1746589652323,MUS 7,A01,891081,Staff,0,0,25,25
1746589652323,MUS 7,A02,891082,Staff,3,0,25,22
1746589653348,MUS 8GS,A00,891118,Borgo; David Garcia,1,0,25,24
1746589654376,MUS 11,A01,891140,Staff,9,0,25,16
1746589654376,MUS 11,A02,891141,Staff,21,0,25,4
1746589655401,MUS 13,A01,891143,Staff,8,0,25,17
1746589655401,MUS 13,A02,891144,Staff,24,0,25,1
1746589656426,MUS 15,A01,891146,Staff,9,0,25,16
1746589656426,MUS 15,A02,891148,Staff,21,0,25,4
1746589656426,MUS 15,B01,891150,Staff,18,0,25,7
1746589656426,MUS 15,B02,891151,Staff,25,0,25,0
1746589657456,MUS 20,A01,891153,Staff,5,0,20,15
1746589657456,MUS 20,A02,891155,Staff,14,0,20,6
1746589658482,MUS 80,A00,891156,Staff,19,0,25,6
1746589658482,MUS 80,B00,891157,Staff,23,0,25,2
1746589659508,MUS 130,A00,891158,Ohnishi; Takae,35,0,35,0
1746589660536,MUS 150GS,A01,891160,Borgo; David Garcia,1,0,25,24
1746589661562,MUS 170,A01,891162,Freitas Caetano; Marcelo,20,0,25,5
1746589661562,MUS 170,A02,891164,Freitas Caetano; Marcelo,21,0,25,4
1746589662591,NANO 11,A00,886220,Vazquez Mena; Oscar,13,0,15,2
1746589663617,NANO 15,A01,886222,Drews; Aaron,4,0,7,3
1746589664643,NANO 104,A00,886224,Sirbuly; Donald,17,0,25,8
1746589665671,PH 40,A00,886528,Staff,23,0,40,17
1746589666695,PH 45,A01,886799,Staff,35,0,40,5
1746589667724,PH 110,A00,886802,Staff,0,6,40,40
1746589668751,PH 172,A00,906716,Staff,19,0,35,16
1746589669783,PH 191,A00,886803,Staff,6,0,40,34
1746589670809,PHIL 1,A00,889500,Staff,20,0,30,10
1746589671837,PHIL 10,A01,889549,Grush; Rick Scott,16,0,22,6
1746589671837,PHIL 10,A02,889551,Grush; Rick Scott,22,0,22,0
1746589672864,PHIL 28,A01,889559,Lamey; Andy M.,0,2,31,31
1746589672864,PHIL 28,A02,889561,Lamey; Andy M.,0,1,30,30
1746589672864,PHIL 28,A03,889572,Lamey; Andy M.,0,1,30,30
1746589673889,PHIL 35,A00,907839,Staff,13,0,15,2
1746589674917,PHIL 60,A00,889574,Staff,73,0,90,17
1746589675945,PHIL 101,A00,958004,Staff,12,0,15,3
1746589677999,PHIL 136,A00,889582,Fulkerson; Matthew Todd,26,0,45,19
1746589679029,PHIL 163,A01,889601,Staff,21,0,30,9
1746589679029,PHIL 163,B01,889606,Brandt; Reuven A,0,3,0,0
1746589680056,PHIL 164,A00,889610,Staff,16,0,30,14
1746589681085,PHIL 165,A00,889613,Staff,22,0,30,8
1746589682111,PHYS 1A,A00,886431,Staff,29,0,70,41
1746589683138,PHYS 1AL,001,886432,Tsai; Philbert S,1,2,30,29
1746589683138,PHYS 1AL,002,886436,Tsai; Philbert S,12,0,30,18
1746589684164,PHYS 1B,A00,886439,Staff,184,0,240,56
1746589685194,PHYS 1BL,001,886441,Tsai; Philbert S,0,4,30,30
1746589685194,PHYS 1BL,002,886444,Tsai; Philbert S,2,0,30,28
1746589686218,PHYS 1C,A00,896092,Arnold; Kam S,78,0,146,68
1746589687244,PHYS 1CL,001,886448,Tsai; Philbert S,0,0,30,30
1746589687244,PHYS 1CL,002,886449,Tsai; Philbert S,1,0,30,29
1746589687244,PHYS 1CL,003,886450,Tsai; Philbert S,16,0,30,14
1746589687244,PHYS 1CL,004,886451,Tsai; Philbert S,15,0,30,15
1746589688274,PHYS 2B,A01,886457,Staff,67,0,115,48
1746589689300,PHYS 2C,A01,886460,Shotwell; Brian,0,9,65,65
1746589690326,PHYS 2CL,A01,886467,Staff,0,4,28,28
1746589690326,PHYS 2CL,A02,886468,Staff,0,3,28,28
1746589691356,PHYS 2D,A01,886470,Staff,10,0,50,40
1746589692384,PHYS 4B,A01,886475,Grinstein; Benjamin,22,0,40,18
1746589693410,POLI 5,A00,891173,Desposato; Scott,7,0,25,18
1746589694436,POLI 5D,A01,891175,Staff,5,0,5,0
1746589694436,POLI 5D,B01,891178,Staff,5,0,5,0
1746589695465,POLI 11,A00,891179,Ferree; Karen E,2,0,35,33
1746589696491,POLI 12,A00,891180,Staff,16,0,30,14
1746589697519,POLI 27,A01,891182,Staff,12,0,75,63
1746589698544,POLI 30,A00,891183,Staff,8,0,50,42
1746589699571,POLI 100B,A00,891244,Staff,5,1,35,30
1746589700600,POLI 100I,A00,891247,Staff,7,0,30,23
1746589701628,POLI 104J,A00,891248,Nichter; Maysa,14,0,30,16
1746589702655,POLI 104U,A00,891250,Nichter; Maysa,1,0,30,29
1746589704709,POLI 110B,A00,891255,Wiens; David,19,0,25,6
1746589705735,POLI 112A,A00,891256,Wiens; David,6,0,25,19
1746589706763,POLI 114BR,A00,891261,Staff,19,0,30,11
1746589707789,POLI 117R,A00,891262,Forman; Fonna,0,6,50,50
1746589708816,POLI 118,A00,891264,Ingham; Sean,17,0,25,8
1746589709842,POLI 124A,A00,891265,Staff,18,0,20,2
1746589710867,POLI 125D,A00,891266,Nichter; Simeon C,2,0,25,23
1746589711894,POLI 126,A00,891268,Nichter; Simeon C,7,0,25,18
1746589712924,POLI 126AA,A00,891272,Staff,15,0,25,10
1746589713950,POLI 130AA,A00,891273,Staff,15,0,20,5
1746589714975,POLI 134AA,A00,891274,Staff,4,0,20,16
1746589717029,POLI 138,A00,891278,Staff,21,0,25,4
1746589718056,POLI 142K,A00,891280,Staff,10,0,25,15
1746589719082,POLI 142M,A00,891281,Gartzke; Erik,16,0,30,14
1746589720108,POLI 142P,A00,891284,Staff,20,0,30,10
1746589721136,POLI 143,A00,891285,Gartzke; Erik,12,0,30,18
1746589722201,POLI 153,A00,891286,Staff,19,0,20,1
1746589724251,POLI 175,A00,891290,Staff,15,0,20,5
1746589725276,PSYC 1,A00,890674,Steiner; Eric Tomas,0,11,45,45
1746589726304,PSYC 2,A00,890676,Albright; Thomas D,20,0,35,15
1746589727332,PSYC 3,A00,890679,Staff,17,0,20,3
1746589728358,PSYC 6,A00,959858,Staff,19,0,20,1
1746589729385,PSYC 60,A01,890684,Rickard; Timothy C.,0,6,45,45
1746589730415,PSYC 70,A01,890689,Geller; Emma Harlan,6,0,30,24
1746589731443,PSYC 71,A01,959860,Staff,21,0,25,4
1746589732471,PSYC 100,A00,890690,Lacefield; Katharine I,0,50,180,180
1746589733499,PSYC 102,A00,890695,Staff,18,0,40,22
1746589734527,PSYC 105,A00,890699,Geller; Emma Harlan,70,0,100,30
1746589735552,PSYC 106,A00,890701,Gorman; Michael R.,5,0,30,25
1746589736577,PSYC 108,A00,890704,Adrian; Julia Anna,0,29,50,50
1746589737605,PSYC 118,A01,890712,Staff,11,0,30,19
1746589738631,PSYC 124,A00,890716,Chapman; Eddie Nathaniel,25,0,60,35
1746589739659,PSYC 131,A00,890717,Anagnostaras; Stephan,0,7,80,80
1746589740687,PSYC 137,A00,890719,Winkielman; Piotr,0,11,30,30
1746589741716,PSYC 144,A00,890721,Adrian; Julia Anna,0,9,45,45
1746589742745,PSYC 162,A00,890805,Staff,0,1,75,75
1746589743771,PSYC 169,A00,890810,Staff,0,15,30,30
1746589744800,PSYC 172,A00,890814,Gorman; Michael R.,9,0,30,21
1746589745825,PSYC 181,A00,890818,Anagnostaras; Stephan,7,0,200,193
1746589746851,PSYC 184,A00,959861,Staff,164,0,175,11
1746589747879,PSYC 189,A00,890823,Staff,0,2,30,30
1746589748907,PSYC 191,A00,890884,Rickard; Timothy C.,0,12,35,35
1746589749938,PSYC 193,A00,890913,Staff,19,0,30,11
1746589749938,PSYC 193,B00,890914,Chapman; Eddie Nathaniel,24,0,30,6
1746589750968,PSYC 193L,A01,890918,Lowe; Angela Beth,20,0,30,10
1746589750968,PSYC 193L,B01,890921,Hurwitz; Ethan Scott,20,0,30,10
1746589750968,PSYC 193L,C01,890928,Staff,30,0,30,0
1746589751998,RELI 149,A00,886806,Rahimi; Babak,23,0,40,17
1746589753025,SE 9,A01,886814,Staff,7,0,20,13
1746589754050,SE 101B,A01,886816,Chadha; Mayank,3,0,35,32
1746589755080,SE 110B,A00,886818,Zhu; Qiang,4,0,75,71
1746589756106,SE 125,A01,886830,Staff,10,0,30,20
1746589757134,SE 130B,A01,886835,Staff,14,0,40,26
1746589758159,SE 131A,A01,886838,Krysl; Petr,34,0,55,21
1746589759188,SE 154,A00,886840,Staff,28,0,50,22
1746589760214,SE 164GS,A01,886849,Staff,6,0,20,14
1746589761239,SE 167GS,A01,886853,Staff,6,0,20,14
1746589762268,SIO 25,A01,890107,Staff,19,0,30,11
1746589763295,SIO 45,A00,890109,Cook; Geoffrey W,116,0,200,84
1746589764324,SIO 109R,A00,890110,Forman; Fonna,0,16,20,20
1746589765348,SIO 187,A01,890114,Kacev; David,15,0,40,25
1746589766375,SOCI 1,A01,890431,Thorpe; Charles Robert,14,0,30,16
1746589766375,SOCI 1,A02,890518,Thorpe; Charles Robert,30,0,30,0
1746589767402,SOCI 2,A01,957978,Staff,25,0,25,0
1746589767402,SOCI 2,A02,957979,Staff,23,0,25,2
1746589768431,SOCI 20,A01,890523,Calderon-Zaks; Michael Aar,21,0,30,9
1746589768431,SOCI 20,A02,890526,Calderon-Zaks; Michael Aar,29,0,30,1
1746589769459,SOCI 30,A01,890533,Pardo Guerra; Juan Pablo,37,0,40,3
1746589770487,SOCI 40,A01,890535,Staff,27,0,45,18
1746589771514,SOCI 104Q,A00,890559,Staff,18,0,30,12
1746589772539,SOCI 106,A00,890560,Arnal; Maud Marie Leonie,20,0,30,10
1746589773563,SOCI 110,A00,890567,Holkenbrink-Monk; Charlene,19,0,30,11
1746589774590,SOCI 112,A00,890568,Victoria Torres; Pablo,2,0,55,53
1746589775615,SOCI 115,A00,890597,Arnal; Maud Marie Leonie,28,0,45,17
1746589777669,SOCI 121,A00,890604,Pardo Guerra; Juan Pablo,38,0,45,7
1746589778697,SOCI 126,A01,890608,Staff,8,0,10,2
1746589779725,SOCI 127,A00,890609,Staff,18,0,30,12
1746589780750,SOCI 131,A00,890610,Thorpe; Charles Robert,37,0,45,8
1746589781777,SOCI 135,A00,890615,Payne; Christine Anna,14,0,45,31
1746589782804,SOCI 139,A00,890620,Staff,38,0,45,7
1746589783833,SOCI 148E,A00,890622,Calderon-Zaks; Michael Aar,36,0,45,9
1746589784861,SOCI 150,A00,890623,Kohler; Kristopher M.,31,0,45,14
1746589785885,SOCI 157,A00,890625,Jules-Rosette; Bennetta W.,18,0,20,2
1746589786910,SOCI 160,A00,890627,Payne; Christine Anna,21,0,45,24
1746589787936,SYN 1,A00,886855,Fish; Gwendolyn Anne,0,1,0,0
1746589787936,SYN 1,B00,906086,Fish; Gwendolyn Anne,0,2,0,2
1746589788968,SYN 2R,A00,886860,Staff,0,17,15,15
1746589788968,SYN 2R,B00,906106,Atkinson; Arthur Laird,0,16,15,15
1746589789993,SYN 100,A01,886866,Browne; Emily,0,28,20,20
1746589789993,SYN 100,B01,906128,Rock; Martin,0,4,20,20
1746589789993,SYN 100,C01,906140,Deavenport; James Cary,0,4,20,20
1746589789993,SYN 100,D01,907816,Deavenport; James Cary,0,5,20,20
1746589791021,TDAC 1,A00,890286,Walsh; Kim C.,7,0,20,13
1746589792045,TDAC 101,A00,890296,Basso; Beatrice,15,0,20,5
1746589793071,TDDE 131,A00,890297,Staff,47,0,50,3
1746589794100,TDDM 1,A00,890287,Weinberg; Sadie,25,0,30,5
1746589795130,TDGE 11,A00,890288,Fulton; Julia,138,0,200,62
1746589795130,TDGE 11,B00,890289,Castro; Robert Jess,185,0,200,15
1746589796156,TDGE 25,B00,957359,Walsh; Kim C.,5,0,20,15
1746589797186,TDGE 40,A01,890292,Power; Jade Yukana,26,0,30,4
1746589798214,TDGE 124,A00,890298,Havis; Allan,0,2,50,50
1746589799240,TDGE 131R,A00,890299,Burelle; Julie Sara Veronique,15,0,42,27
1746589800266,TDHT 101,A00,890300,Staff,10,0,20,10
1746589801295,TDHT 109,A01,890302,Anderson; Mysia Anyse,31,0,40,9
1746589802321,TDMV 1,A00,890293,Arcidiacono; Kristin,18,0,30,12
1746589803352,TDMV 2,A00,890294,Weinberg; Sadie,23,0,30,7
1746589804381,TDMV 3,A00,957878,Arcidiacono; Kristin,28,0,30,2
1746589806435,TDMV 138,A00,890304,Jun; Grace Shin Hae,25,0,40,15
1746589807465,TDMV 140,A00,890305,Corrales; Joseph Bernales,25,0,30,5
1746589808491,TDMV 142,A00,890307,Caligagan; Tony,32,0,40,8
1746589809518,TDMV 144,A00,890308,Camaya; Michelle Ann,25,0,30,5
1746589810546,TDPW 1,A00,890295,Stein; Deborah Isobel,3,0,20,17
1746589811576,USP 2,A01,890272,Lerner; Amy M,7,0,20,13
1746589812607,USP 3,A01,890274,Staff,12,0,30,18
1746589813636,USP 15,A01,890276,Sun; Feiyang,16,0,30,14
1746589814665,USP 25,A00,890277,Shenkman; Michael Thomas,18,0,25,7
1746589815694,USP 138,A00,890278,Staff,13,0,25,12
1746589816720,USP 143,A00,890279,Staff,22,0,70,48
1746589817750,USP 144,A00,890280,Chowdhury; Muhammed Zohir,16,0,30,14
1746589818775,USP 150,A00,890281,Boomhower; Matthew Charles,4,0,30,26
1746589819801,USP 151,A00,890282,Staff,16,0,20,4
1746589820828,USP 162,A00,890283,Andrews; Abigail Leslie,16,0,20,4
1746589821857,USP 168,A00,920477,Kwak; Nancy,0,0,5,5
1746589822884,USP 181,A00,890284,Staff,3,0,20,17
1746589823911,USP 191A,A00,890285,Staff,12,0,20,8
1746589824940,VIS 101,A00,886512,Staff,26,0,75,49
1746589825971,VIS 103,A00,886513,Cruz; Edwin Teddy,61,0,75,14
1746589826998,VIS 108,A00,886514,Staff,3,0,15,12
1746589828027,VIS 127P,A00,886515,Shen; Kuiyi,79,0,146,67
1746589829053,VIS 149,A00,886516,Yoldas; Pinar,0,0,15,15
1746589830083,VIS 164,A00,886526,Erdmann; Dean,19,0,22,3
1746589831106,VIS 194S,A00,886527,Staff,61,0,75,14
1746589832134,WCWP 10A,C00,886484,Martiniuk; Jill,12,0,15,3
1746589833165,WCWP 10B,A00,886490,Uriarte; Emma,0,0,15,15
1746589833165,WCWP 10B,B00,886491,Dhir; Simrita,8,0,15,7
1746589833165,WCWP 10B,C00,886492,Ornelas; Tricia,0,0,15,15
1746589834197,WCWP 100,A00,886494,Young; Mark T,0,6,15,15
1746589836312,AAS 10,A01,886199,Childs; Dennis R.,0,3,0,0
1746589837337,ANAR 104,A01,886940,Shtienberg; Gilad,27,0,30,3
1746589838362,ANAR 120,A00,886953,Staff,13,0,20,7
1746589839389,ANBI 148,A01,886955,Wilder; Linnea Lorene,30,0,40,10
1746589841442,ANSC 122,A00,886957,Staff,24,0,30,6
1746589842469,ANSC 150,A00,886958,Sloane; Julia Kathryn,2,0,15,13
1746589843498,ANSC 156,A00,886959,Jenkins; Janis A.,0,1,15,15
1746589844527,ANSC 180,A00,886960,Staff,11,0,17,6
1746589845554,ANSC 188,A00,886961,Jassal; Aftab,9,0,25,16
1746589846580,ANSC 190,A00,886962,Jassal; Aftab,14,0,25,11
1746589847608,ANSC 191,A00,886963,Staff,18,0,20,2
1746589848633,ANTH 3,A01,891689,Staff,17,0,20,3
1746589849659,ANTH 5,A00,886933,Semendeferi; Ekaterini,16,0,20,4
1746589850683,ANTH 10,A00,886934,Staff,0,12,30,30
1746589851708,ANTH 21,A01,886936,Staff,41,0,60,19
1746589852737,ANTH 23,A01,886938,Staff,92,0,100,8
1746589853761,ANTH 105,A00,886964,Stewart; Alexander B,84,0,100,16
1746589854790,ANTH 108,A00,886965,Pedersen; David,9,0,20,11
1746589855816,AWP 10,001,886147,Staff,0,0,0,0
1746589855816,AWP 10,002,886148,Staff,0,0,0,0
1746589855816,AWP 10,003,886149,Staff,0,0,0,0
1746589855816,AWP 10,004,886150,Staff,0,0,0,0
1746589855816,AWP 10,005,886151,Staff,0,0,0,0
1746589855816,AWP 10,006,886152,Staff,0,0,0,0
1746589855816,AWP 10,007,886153,Staff,0,0,0,0
1746589855816,AWP 10,008,886154,Staff,0,0,0,0
1746589855816,AWP 10,009,886155,Staff,0,0,0,0
1746589855816,AWP 10,010,886156,Staff,0,0,0,0
1746589855816,AWP 10,011,886158,Staff,0,0,0,0
1746589855816,AWP 10,012,886160,Staff,0,0,0,0
1746589855816,AWP 10,013,886161,Staff,0,0,0,0
1746589855816,AWP 10,014,886162,Staff,0,0,0,0
1746589855816,AWP 10,015,886163,Staff,0,0,0,0
1746589855816,AWP 10,016,886164,Staff,0,0,0,0
1746589855816,AWP 10,017,886165,Staff,0,0,0,0
1746589855816,AWP 10,018,886166,Staff,0,0,0,0
1746589855816,AWP 10,019,886168,Staff,0,0,0,0
1746589855816,AWP 10,020,886170,Staff,0,0,0,0
1746589855816,AWP 10,021,886172,Staff,0,0,0,0
1746589856845,AWP 10R,001,886173,Staff,0,1,0,0
1746589856845,AWP 10R,002,886174,Staff,0,1,0,0
1746589856845,AWP 10R,003,886175,Staff,0,0,0,0
1746589856845,AWP 10R,004,886176,Staff,0,0,0,0
1746589856845,AWP 10R,005,886177,Staff,0,0,0,0
1746589856845,AWP 10R,006,886178,Staff,0,0,0,0
1746589856845,AWP 10R,007,886179,Staff,0,0,0,0
1746589856845,AWP 10R,008,886181,Staff,0,0,0,0
1746589856845,AWP 10R,009,886182,Staff,0,0,0,0
1746589856845,AWP 10R,010,886183,Staff,0,0,0,0
1746589856845,AWP 10R,011,886184,Staff,0,0,0,0
1746589856845,AWP 10R,012,886185,Staff,0,0,0,0
1746589856845,AWP 10R,013,886186,Staff,0,0,0,0
1746589856845,AWP 10R,014,886187,Staff,0,0,0,0
1746589856845,AWP 10R,015,886188,Staff,0,0,0,0
1746589856845,AWP 10R,016,886189,Staff,0,0,0,0
1746589856845,AWP 10R,017,960532,Staff,0,0,0,0
1746589856845,AWP 10R,018,960533,Staff,0,0,0,0
1746589856845,AWP 10R,019,960534,Staff,0,0,0,0
1746589856845,AWP 10R,020,960538,Staff,0,0,0,0
1746589856845,AWP 10R,021,960540,Staff,0,0,0,0
1746589856845,AWP 10R,022,960541,Staff,0,0,0,0
1746589856845,AWP 10R,023,960542,Staff,0,0,0,0
1746589856845,AWP 10R,024,960544,Staff,0,0,0,0
1746589856845,AWP 10R,025,960545,Staff,0,0,0,0
1746589856845,AWP 10R,026,960548,Staff,0,0,0,0
1746589857870,AWP 102R,A00,886190,Staff,0,0,0,0
1746589857870,AWP 102R,B00,886191,Staff,0,0,0,0
1746589858895,BENG 100,A01,886193,Staff,17,0,30,13
1746589859920,BENG 122A,A01,886195,Hasty; Jeff M,13,0,30,17
1746589860947,BENG 166A,A00,886196,Sah; Robert Lie-Yuan,0,3,30,30
1746589861977,BENG 190,A00,958050,Khojah; Reem I,17,0,25,8
1746589863003,BIBC 102,A01,894320,Staff,0,0,46,46
1746589863003,BIBC 102,A02,894321,Staff,0,0,46,46
1746589863003,BIBC 102,A03,894344,Staff,6,0,46,40
1746589863003,BIBC 102,A04,894345,Staff,27,0,47,20
1746589864030,BICD 100R,A01,894365,Smith; Laurie,1,3,58,57
1746589864030,BICD 100R,A02,894366,Smith; Laurie,1,5,58,57
1746589864030,BICD 100R,A03,894367,Smith; Laurie,0,0,59,59
1746589864030,BICD 100R,A04,959869,Smith; Laurie,40,0,59,19
1746589865056,BICD 136,A01,894383,Gustafson-Brown; Cindy,14,0,50,36
1746589866082,BIEB 102,A01,894494,Butler; Shannon Rhey,51,0,130,79
1746589868135,BIEB 150,A01,894617,Wills; Christopher,3,0,20,17
1746589868135,BIEB 150,A02,894631,Wills; Christopher,3,0,20,17
1746589868135,BIEB 150,A03,894937,Wills; Christopher,3,0,20,17
1746589868135,BIEB 150,A04,894946,Wills; Christopher,5,0,20,15
1746589869165,BIEB 194,A00,906141,Kurle; Carolyn M.,5,0,20,15
1746589870190,BILD 1,A01,894154,Staff,3,0,19,16
1746589870190,BILD 1,A02,894155,Staff,14,0,19,5
1746589870190,BILD 1,A03,894160,Staff,13,0,19,6
1746589870190,BILD 1,A04,894161,Staff,15,0,18,3
1746589871216,BILD 2,A01,894168,Staff,0,0,50,50
1746589871216,BILD 2,A02,894169,Staff,0,0,50,50
1746589871216,BILD 2,A03,894179,Staff,0,0,50,50
1746589871216,BILD 2,A04,894203,Staff,23,0,50,27
1746589872243,BILD 3,A01,894213,Staff,23,0,31,8
1746589872243,BILD 3,A02,894214,Staff,26,0,31,5
1746589872243,BILD 3,A03,894235,Staff,28,0,31,3
1746589872243,BILD 3,A04,894236,Staff,28,0,32,4
1746589873268,BILD 4,A01,894253,Reuther; Keefe,5,0,24,19
1746589873268,BILD 4,A02,894258,Reuther; Keefe,16,0,24,8
1746589874296,BILD 5,A01,894276,Reuther; Keefe,34,0,50,16
1746589874296,BILD 5,A02,894277,Reuther; Keefe,45,0,50,5
1746589874296,BILD 5,A03,894290,Reuther; Keefe,44,0,50,6
1746589874296,BILD 5,A04,894291,Reuther; Keefe,48,0,50,2
1746589875325,BILD 24,A01,894297,Pirino; Giorgia,40,0,60,20
1746589876353,BIMM 100,B01,958915,Staff,71,0,100,29
1746589877379,BIMM 101,A01,895017,McDonnell; Lisa Marie,0,5,24,24
1746589877379,BIMM 101,A02,895018,McDonnell; Lisa Marie,0,5,24,24
1746589877379,BIMM 101,B01,895020,McDonnell; Lisa Marie,1,6,24,23
1746589877379,BIMM 101,B02,895021,McDonnell; Lisa Marie,0,4,24,24
1746589878410,BIMM 110,A01,895023,Staff,1,0,25,24
1746589878410,BIMM 110,A02,895024,Staff,9,0,25,16
1746589878410,BIMM 110,A03,895025,Staff,18,0,25,7
1746589878410,BIMM 110,A04,895031,Staff,20,0,25,5
1746589879437,BIMM 120,A01,895114,Gustafson-Brown; Cindy,14,0,28,14
1746589879437,BIMM 120,A02,895126,Gustafson-Brown; Cindy,21,0,27,6
1746589880468,BIPN 100,A01,895130,Yang; Mingyu,0,0,38,38
1746589880468,BIPN 100,A02,895131,Yang; Mingyu,31,0,38,7
1746589880468,BIPN 100,A03,895132,Yang; Mingyu,32,0,38,6
1746589880468,BIPN 100,A04,895133,Yang; Mingyu,27,0,36,9
1746589881501,BIPN 120,A01,895135,Cooke; James Edward,0,3,13,13
1746589881501,BIPN 120,A02,895136,Cooke; James Edward,0,1,13,13
1746589881501,BIPN 120,A03,895137,Cooke; James Edward,0,3,13,13
1746589881501,BIPN 120,A04,895156,Cooke; James Edward,0,2,11,11
1746589882532,BIPN 134,A01,895235,Cooke; James Edward,0,2,25,25
1746589882532,BIPN 134,A02,895237,Cooke; James Edward,0,0,25,25
1746589882532,BIPN 134,A03,895240,Cooke; James Edward,3,0,25,22
1746589882532,BIPN 134,A04,895270,Cooke; James Edward,20,0,25,5
1746589883557,BIPN 189,A00,892103,Staff,0,14,14,14
1746589885612,BISP 194,A00,958008,Staff,0,2,0,0
1746589886642,CAT 124,A01,922009,Staff,0,5,20,20
1746589887671,CAT 125R,A00,886390,Morales; Celeste Georgianna,0,3,20,20
1746589887671,CAT 125R,B00,886391,Irwin; Matthew Joseph,0,4,20,20
1746589887671,CAT 125R,C00,886392,Smith; Lauryn Alissa,0,2,20,20
1746589887671,CAT 125R,D00,886393,Vanderschuit; Maya Alysia,0,3,20,20
1746589887671,CAT 125R,E00,886394,Marchisotto; Jennifer Anne,0,3,20,20
1746589888700,CENG 15,A01,886218,Drews; Aaron,3,0,8,5
1746589889728,CENG 113,A00,886219,Opatkiewicz; Justin Paul,15,0,25,10
1746589890754,CGS 101,A00,887044,Staff,7,0,20,13
1746589891780,CGS 105,A01,887046,Staff,14,0,25,11
1746589892809,CGS 112,A00,887047,Cuong; Marisol,12,0,15,3
1746589893837,CGS 113,A00,887048,Staff,23,0,30,7
1746589894863,CGS 120,A00,887049,Staff,10,0,17,7
1746589895890,CHEM 6A,A01,886336,Lam; Tin Yiu,38,0,50,12
1746589895890,CHEM 6A,A02,886338,Lam; Tin Yiu,37,0,50,13
1746589896921,CHEM 6B,A01,886341,Hopkins; Patrycja Anna,16,0,50,34
1746589896921,CHEM 6B,A02,886343,Hopkins; Patrycja Anna,42,0,50,8
1746589897951,CHEM 6C,A01,886346,Albizati; Kim F.,0,2,50,50
1746589897951,CHEM 6C,A02,886348,Albizati; Kim F.,24,0,50,26
1746589898976,CHEM 40A,A01,886352,Klosterman; Jeremy K,65,0,100,35
1746589900001,CHEM 40B,A01,886356,Klosterman; Jeremy K,0,24,100,100
1746589901032,CHEM 41B,A01,886360,Theodorakis; Emmanuel,25,0,50,25
1746589901032,CHEM 41B,A02,886362,Theodorakis; Emmanuel,47,0,50,3
1746589902060,CHIN 165A,A00,886382,Xu; Li,18,0,20,2
1746589903088,CLAS 120,A00,886387,Myerston Santana; Jacobo,33,0,40,7
1746589904115,COGS 9,A01,886967,Shannon; Kyle Michael,42,0,60,18
1746589905147,COGS 11,A01,886969,Staff,9,0,30,21
1746589906175,COGS 14A,A01,886971,Staff,5,0,60,55
1746589907201,COGS 14B,A01,886973,Hoffman; Drew Ellen,4,0,60,56
1746589908231,COGS 18,A01,886975,Morgan; Eric,34,0,60,26
1746589909258,COGS 20,A01,886977,Staff,2,0,8,6
1746589909258,COGS 20,A02,886978,Staff,4,0,7,3
1746589910288,COGS 100,A01,907783,Staff,1,2,30,29
1746589911312,COGS 101B,A01,886980,Staff,0,4,48,48
1746589912342,COGS 101C,A01,886982,Delgado; Tania,0,5,44,44
1746589913368,COGS 102A,A01,886984,Johnson; Christine M.,3,0,30,27
1746589914397,COGS 118B,A01,886986,Staff,1,5,88,87
1746589915422,COGS 150,A01,886988,Bergen; Benjamin,22,0,50,28
1746589916448,COGS 153,A00,886989,Delgado; Tania,0,3,41,41
1746589917476,COGS 186,A01,886991,Staff,0,0,32,32
1746589918501,COGS 187A,A01,886993,Boyle; Mary E. T.,7,0,30,23
1746589919527,COGS 189,A00,886994,Staff,0,1,30,30
1746589920552,COMM 10,A01,886996,Staff,0,0,20,21
1746589920552,COMM 10,A02,886997,Staff,10,0,20,10
1746589920552,COMM 10,A03,959845,Staff,19,0,20,1
1746589921579,COMM 20,A01,886999,Leuning; Grant Maurstad,24,0,40,16
1746589923632,COMM 100A,A01,887002,Staff,0,0,20,25
1746589923632,COMM 100A,A02,887003,Staff,6,0,20,14
1746589924659,COMM 100B,A01,887005,Staff,0,8,20,24
1746589925688,COMM 106D,A00,887006,Staff,13,0,40,27
1746589926715,COMM 110G,A00,887007,Whitworth-Smith; Andrew C,12,0,40,28
1746589927746,COMM 111B,A00,887008,Staff,31,0,40,9
1746589928772,COMM 113T,A00,887009,Abuelhiga; Soraya Jill,28,0,40,12
1746589928772,COMM 113T,B00,906733,Staff,40,0,40,0
1746589929798,COMM 145,A00,887010,Staff,12,0,40,28
1746589930823,COMM 146,A00,887054,Staff,31,0,40,9
1746589931853,COMM 190,A00,887012,Staff,8,0,23,15
1746589932877,CSE 8A,A50,887015,Cao; Yingjun,56,0,85,29
1746589933905,CSE 11,A01,887017,Cao; Yingjun,11,0,70,59
1746589934932,CSE 20,A01,887019,Staff,30,0,50,20
1746589935958,CSE 21,A01,887021,Staff,78,0,100,22
1746589935958,CSE 21,B01,892583,Braun; Oliver,45,0,50,5
1746589936987,CSE 30,A01,887025,Eldon; John,142,0,200,58
1746589938012,CSE 100,A01,887027,Staff,26,0,50,24
1746589938012,CSE 100,A02,887028,Staff,42,0,50,8
1746589939039,CSE 101,A01,887030,Braun; Oliver,74,0,100,26
1746589939039,CSE 101,B01,887032,Jones; Miles E,0,3,50,50
1746589939039,CSE 101,B02,887033,Jones; Miles E,0,2,50,50
1746589940066,CSE 105,A01,908084,Jones; Miles E,32,0,50,18
1746589940066,CSE 105,A02,908087,Jones; Miles E,31,0,50,19
1746589941090,CSE 135,A01,887035,Powell; Thomas Allan,0,5,50,50
1746589942117,CSE 142,A01,887037,Staff,8,0,60,52
1746589943141,CSE 142L,A01,887039,Staff,34,0,60,26
1746589944166,CSE 151A,A01,887041,Solares; Edwin A,47,0,100,53
1746589945195,CSE 175,A01,887043,Kumar; Rakesh,30,0,30,0
1746589946220,CSS 1,A01,886389,Staff,1,2,40,39
1746589947248,DSC 30,A01,908097,Liao; Soohyun Nam,47,0,75,28
1746589948276,DSC 40A,A01,908099,Shannon; Kyle Michael,30,0,50,20
1746589949303,DSC 40B,A01,908112,Staff,15,0,50,35
1746589950330,DSC 80,A01,908116,Staff,19,0,60,41
1746589951355,DSC 197,001,956863,Eldridge; Justin Matthew,9999,0,9999,0
1746589952381,ECE 5,A01,886400,Morris; Karcher William,1,0,6,5
1746589952381,ECE 5,A02,886401,Morris; Karcher William,3,0,6,3
1746589953407,ECE 148,A01,886403,Silberman; Jack,0,14,14,14
1746589954436,ECON 1,A01,887265,Crane; Meredith Helen,11,0,70,59
1746589954436,ECON 1,B01,887268,Staff,42,0,50,8
1746589955462,ECON 2,A01,887273,Crane; Meredith Helen,54,0,70,16
1746589956487,ECON 3,A01,887279,Rondina; Giacomo,31,0,70,39
1746589957514,ECON 4,A01,887282,Anderson; John Charles,0,2,10,10
1746589958541,ECON 5,A01,887285,Staff,34,0,45,11
1746589958541,ECON 5,B01,887292,Staff,41,0,45,4
1746589959571,ECON 100A,A01,887337,Newhouse; Herbert S,54,0,70,16
1746589959571,ECON 100A,B01,887349,Staff,45,0,50,5
1746589960598,ECON 100B,A01,887361,Du; Songzi,29,0,70,41
1746589961624,ECON 100C,A01,887445,Newhouse; Herbert S,59,0,70,11
1746589962651,ECON 105,A00,887488,Vespa; Emanuel Ignacio,23,0,35,12
1746589963679,ECON 109,A01,887506,Shishkin; Denis,28,0,35,7
1746589964707,ECON 110A,A01,887568,Alon; Titan Michael,1,3,35,34
1746589964707,ECON 110A,B01,907601,Alon; Titan Michael,20,0,35,15
1746589965737,ECON 110B,A01,887598,Levkoff; Steven B.,0,24,70,70
1746589966763,ECON 112,A00,887599,Rondina; Giacomo,19,0,35,16
1746589967789,ECON 120A,A01,887603,Dai; Yinlin,35,0,70,35
1746589968819,ECON 120C,A01,887608,Sun; Yixiao,0,1,35,35
1746589968819,ECON 120C,B01,887614,Sun; Yixiao,0,0,35,35
1746589969848,ECON 138,A00,887621,Bharadwaj; Prashant,0,21,20,20
1746589970875,ECON 144,A00,958007,Squires; Dale E,12,0,35,23
1746589971901,ECON 171,A01,907666,Staff,18,0,35,17
1746589972987,ECON 175,A00,887626,Wu; Pak Yeung,22,0,35,13
1746589974015,ECON 190,A00,887640,Vespa; Emanuel Ignacio,22,0,35,13
1746589975043,EDS 25,A01,888197,Staff,0,0,0,0
1746589975043,EDS 25,A02,888209,Staff,0,0,0,0
1746589975043,EDS 25,A03,888210,Staff,0,0,0,0
1746589975043,EDS 25,A04,888212,Staff,0,0,0,0
1746589975043,EDS 25,A05,888213,Staff,0,0,0,0
1746589975043,EDS 25,A06,888214,Staff,0,0,0,0
1746589975043,EDS 25,A07,888235,Staff,0,2,0,0
1746589975043,EDS 25,A08,888236,Staff,0,0,0,0
1746589975043,EDS 25,A09,888240,Staff,0,0,0,0
1746589975043,EDS 25,A10,888244,Staff,0,0,0,0
1746589975043,EDS 25,B01,888273,Staff,0,0,0,0
1746589975043,EDS 25,B02,888285,Staff,0,0,0,0
1746589975043,EDS 25,B03,888423,Staff,0,0,0,1
1746589975043,EDS 25,B04,888432,Staff,0,0,0,0
1746589975043,EDS 25,B05,888433,Staff,0,0,0,0
1746589975043,EDS 25,B06,888467,Staff,0,0,0,0
1746589975043,EDS 25,B07,888468,Staff,0,0,0,0
1746589975043,EDS 25,B08,888479,Staff,0,0,0,0
1746589975043,EDS 25,B09,888484,Staff,0,0,0,0
1746589975043,EDS 25,B10,888487,Staff,0,0,0,0
1746589976067,EDS 38,A01,907700,Choi; Bailey Miyeon,30,0,30,0
1746589977092,EDS 112,A01,888601,Chapman; Thandeka K,12,0,40,28
1746589978122,EDS 115,A00,888697,Mendez; Kathrina Mendoza,10,0,30,20
1746589979149,EDS 116,A01,888893,Staff,33,0,40,7
1746589981203,EDS 124AR,A00,889133,Staff,29,0,50,21
1746589981203,EDS 124AR,B00,907471,Simon; Elizabeth A,37,0,50,13
1746589982228,EDS 124BR,A00,889134,Simon; Elizabeth A,44,0,100,56
1746589983254,EDS 125,A00,889135,Staff,25,0,30,5
1746589984281,EDS 126,A01,889138,Staff,35,0,40,5
1746589985311,EDS 164R,A01,889142,Wishard Guerra; Alison G.,32,0,50,18
1746589986338,ENG 30,A01,886396,Staff,0,0,0,0
1746589986338,ENG 30,B01,886398,Staff,0,0,0,0
1746589987363,ENVR 102,A00,906150,Montejo; Carolina,23,0,25,2
1746589988387,ETHN 103A,A00,887236,Man; Simeon S,0,3,0,0
1746589989417,ETHN 113,A00,887239,Staff,16,0,30,14
1746589990443,ETHN 116,A00,887240,Staff,16,0,25,9
1746589991467,ETHN 117,A00,887241,Choi; Esther Min,28,0,30,2
1746589992493,ETHN 118,A00,887243,Staff,24,0,30,6
1746589993520,ETHN 127,A00,887248,Cuong; Marisol,11,0,15,4
1746589994549,ETHN 139,A00,887250,Staff,7,0,10,3
1746589995576,ETHN 142,A00,887252,Staff,10,0,30,20
1746589996603,ETHN 161,A00,887253,Browne; Errol Tsekani,24,0,30,6
1746589997628,ETHN 163FR,A00,887255,Burelle; Julie Sara Veronique,0,0,5,5
1746589998654,GLBH 20,A00,889149,Elwardani; Nile Regina,8,0,42,34
1746590000705,GLBH 111,A01,889152,Burgos; Jose L.,17,0,17,0
1746590001731,GLBH 150,A00,889181,Sloane; Julia Kathryn,0,5,15,15
1746590003794,HDS 60,A01,886406,Warstadt; Melissa Fawn,73,0,80,7
1746590004820,HIAF 111,A00,889324,Gyamfi; Bright,25,0,32,7
1746590005846,HIEA 131,A00,889328,Staff,15,0,32,17
1746590006872,HIEA 144,A00,889333,Henry; Todd A.,26,0,32,6
1746590007899,HIEA 154,A00,889336,Henry; Todd A.,24,0,32,8
1746590008925,HIEU 106,A00,889339,Staff,22,0,32,10
1746590010977,HIEU 114,A00,889340,Staff,4,0,32,28
1746590012003,HIEU 135GS,A00,889342,Patterson; Patrick H.,0,0,1,24
1746590013031,HIEU 137,A00,889343,Edington; Claire Ellen,10,0,25,15
1746590014062,HIEU 148,A00,889345,Staff,14,0,32,18
1746590015089,HIEU 154,A00,889346,Biess; Frank Peter,21,0,32,11
1746590016119,HILA 102,A00,889351,Staff,12,0,32,20
1746590017148,HILD 2A,A01,889221,Lewandoski; Julia Mavis,2,10,32,30
1746590018173,HILD 7B,A01,889225,Man; Simeon S,0,12,32,32
1746590019200,HILD 7C,A01,889288,Alvarez; Luis A,0,14,32,32
1746590020226,HILD 30,A01,889323,Staff,0,5,32,32
1746590022281,HISC 119,A00,889383,Golan; Tal,19,0,32,13
1746590023308,HIUS 103,A00,889384,Man; Simeon S,0,0,32,32
1746590024334,HIUS 117,A00,919797,Kwak; Nancy,18,0,32,14
1746590025361,HIUS 142A,A00,919788,Staff,22,0,32,10
1746590027414,HIUS 149,A00,889386,Gyamfi; Bright,26,0,32,6
1746590028441,HIUS 155,A00,889387,Alvarez; Luis A,15,0,32,17
1746590029467,HUM 3,A01,886499,Caldwell; Michael Alan,19,0,50,31
1746590030491,HUM 3GS,A00,886500,Rodriguez; Bretton Sigfred,0,0,0,28
1746590031519,HUM 3R,A01,886502,Markman; Kristina,0,36,50,50
1746590032550,HUM 4,A01,886504,Crum; Matthew Stephen,23,0,50,27
1746590032550,HUM 4,B01,886506,West; Geoffrey Scott,17,0,50,33
1746590033579,HUM 4GS,A00,886507,Staff,0,0,0,19
1746590034604,HUM 5,A01,886509,Staff,32,0,50,18
1746590035633,HUM 5R,A01,886511,Zavodny; Tatiana Sophia,0,39,50,50
1746590036660,JAPN 180,A00,886407,Staff,16,0,40,24
1746590037687,LATI 50,A01,886409,Martin-Cabrera; Luis,3,0,22,19
1746590037687,LATI 50,A02,886410,Martin-Cabrera; Luis,19,0,22,3
1746590037687,LATI 50,A03,886411,Martin-Cabrera; Luis,21,0,22,1
1746590037687,LATI 50,A04,886412,Martin-Cabrera; Luis,8,0,22,14
1746590038714,LAWS 101,A00,907664,Staff,28,0,60,32
1746590039745,LIAB 1A,A00,889388,Saab; Dima,17,0,20,3
1746590040771,LIAB 1AX,A00,889389,El Cheddadi; Youniss,18,0,20,2
1746590041800,LIFR 1C,A00,889391,Van Moer; Vinciane G,8,0,20,12
1746590042828,LIFR 1CX,A00,889392,Van Moer; Vinciane G,7,0,20,13
1746590043855,LIFR 1D,A00,889393,Van Moer; Vinciane G,7,0,20,13
1746590044883,LIFR 1DX,A00,889394,Van Moer; Vinciane G,8,0,20,12
1746590045910,LIGN 7,A00,886923,Staff,24,0,50,26
1746590046935,LIGN 17,A00,886924,Kehler; Andrew Scott,125,0,150,25
1746590047961,LTAM 110,A00,889395,Staff,15,0,30,15
1746590048986,LTAM 110GS,A00,958010,Rodriguez; Bretton Sigfred,0,0,0,28
1746590050014,LTCH 101,A00,889397,Staff,23,0,25,2
1746590051042,LTCS 130,A00,889398,Staff,23,0,25,2
1746590052071,LTEA 138,A00,889399,Staff,24,0,40,16
1746590053101,LTEN 149,A00,889400,Wesling; Megan E.,0,3,25,25
1746590054129,LTEN 169,A00,889401,Staff,20,0,25,5
1746590055159,LTEN 180,A00,889402,Staff,10,0,15,5
1746590056188,LTEN 181,A00,889403,Staff,21,0,25,4
1746590057212,LTWL 100,A00,889404,Myerston Santana; Jacobo,2,0,25,23
1746590058239,LTWL 180GS,A00,889405,Staff,0,0,20,20
1746590059268,LTWL 181,A00,889406,Staff,16,0,25,9
1746590060292,LTWL 184,A00,889475,Mukherjee; Silpa,22,0,25,3
1746590061320,LTWR 102C,A00,889486,Staff,29,0,30,1
1746590062345,LTWR 115W,A00,889491,Staff,0,2,15,15
1746590063374,MAE 8,A01,886905,Staff,0,2,0,0
1746590064402,MAE 11,A00,886906,Bandaru; Prabhakar,0,7,50,50
1746590065430,MAE 20,A00,886907,Evdokimenko; Ekaterina,43,0,70,27
1746590066456,MAE 30B,A00,886909,Ghazinejad; Maziar,26,0,45,19
1746590067485,MAE 101B,A00,886910,Saintillan; David,29,0,45,16
1746590068513,MAE 105,A00,886911,Bandaru; Prabhakar,18,0,50,32
1746590069539,MAE 107,B00,958024,Staff,7,0,50,43
1746590070566,MAE 143B,A00,886913,Bewley; Thomas R,3,0,40,37
1746590071595,MAE 148,A01,886915,Silberman; Jack,0,3,14,14
1746590072622,MAE 160,A00,886916,Evdokimenko; Ekaterina,31,0,60,29
1746590073651,MATH 3C,A01,889681,Staff,0,2,30,30
1746590073651,MATH 3C,A02,960048,Staff,23,0,30,7
1746590074677,MATH 10A,A01,889760,Staff,26,0,30,4
1746590074677,MATH 10A,A02,889783,Staff,29,0,30,1
1746590075705,MATH 10B,A01,889785,Verstraete; Jacques Allan,1,0,35,34
1746590075705,MATH 10B,A02,889795,Verstraete; Jacques Allan,4,0,35,31
1746590075705,MATH 10B,B01,889797,Verstraete; Jacques Allan,3,0,35,32
1746590075705,MATH 10B,B02,889828,Verstraete; Jacques Allan,3,0,35,32
1746590076737,MATH 10C,A01,889849,Habib; Yousaf,7,0,30,23
1746590076737,MATH 10C,A02,889852,Habib; Yousaf,14,0,30,16
1746590076737,MATH 10C,A03,889853,Habib; Yousaf,22,0,30,8
1746590076737,MATH 10C,A04,889858,Habib; Yousaf,20,0,30,10
1746590076737,MATH 10C,B01,889861,Staff,1,0,30,29
1746590076737,MATH 10C,B02,889862,Staff,24,0,30,6
1746590076737,MATH 10C,B03,889863,Staff,27,0,30,3
1746590076737,MATH 10C,B04,889967,Staff,23,0,30,7
1746590077771,MATH 18,A01,889974,Staff,7,0,30,23
1746590077771,MATH 18,A02,889977,Staff,20,0,30,10
1746590077771,MATH 18,B01,889984,Hardiman; Liam,20,0,30,10
1746590077771,MATH 18,B02,889985,Hardiman; Liam,25,0,30,5
1746590078803,MATH 20A,A01,889990,Suk; Andrew Hoon,30,0,35,5
1746590079834,MATH 20B,A01,889993,Ohm; Ko Woon,21,0,30,9
1746590079834,MATH 20B,A02,889994,Ohm; Ko Woon,30,0,30,0
1746590079834,MATH 20B,B01,889996,Ohm; Ko Woon,22,0,30,8
1746590079834,MATH 20B,B02,889997,Ohm; Ko Woon,23,0,30,7
1746590080859,MATH 20C,A01,889999,Hammock; Frances H,17,0,30,13
1746590080859,MATH 20C,A02,890003,Hammock; Frances H,23,0,30,7
1746590080859,MATH 20C,B01,890006,Hammock; Frances H,3,0,30,27
1746590080859,MATH 20C,B02,890007,Hammock; Frances H,12,0,30,18
1746590081885,MATH 20D,A01,890011,Cheng; Hsiao-Bing,1,1,30,29
1746590081885,MATH 20D,A02,890012,Cheng; Hsiao-Bing,14,0,30,16
1746590081885,MATH 20D,B01,890016,Cheng; Hsiao-Bing,13,0,30,17
1746590081885,MATH 20D,B02,890017,Cheng; Hsiao-Bing,13,0,30,17
1746590082916,MATH 20E,A01,890026,Harel; Guershon,1,0,30,29
1746590082916,MATH 20E,A02,890029,Harel; Guershon,22,0,30,8
1746590082916,MATH 20E,B01,890033,Harel; Guershon,7,0,30,23
1746590082916,MATH 20E,B02,890101,Harel; Guershon,21,0,30,9
1746590083944,MATH 102,A01,890104,Staff,18,0,30,12
1746590083944,MATH 102,A02,890105,Staff,27,0,30,3
1746590084975,MATH 103B,A01,890116,Salehi Golsefidy; Alireza,3,0,30,27
1746590084975,MATH 103B,B01,890118,Staff,0,3,34,34
1746590086006,MATH 109,A01,890121,Aliabadi Sr.; Mohsen,0,0,30,30
1746590086006,MATH 109,B01,890124,Upadrashta; Pranav Kumar,18,0,30,12
1746590087032,MATH 120A,A01,890126,Eggers; John Dietrich,13,0,30,17
1746590088061,MATH 142B,A01,890128,Ioana; Adrian,19,0,30,11
1746590088061,MATH 142B,A02,890129,Ioana; Adrian,12,0,30,18
1746590089087,MATH 154,A01,890174,Staff,0,1,30,30
1746590089087,MATH 154,A02,890182,Staff,0,0,30,30
1746590090114,MATH 168A,A01,890197,Dumitriu; Ioana,21,0,35,14
1746590091140,MATH 170A,A01,890240,Nie; Jiawang,1,0,30,29
1746590091140,MATH 170A,A02,890241,Nie; Jiawang,11,0,30,19
1746590091140,MATH 170A,A03,890249,Nie; Jiawang,23,0,30,7
1746590092169,MATH 170B,A01,957891,Nag; Panchali,13,0,35,22
1746590094222,MATH 181A,A01,908025,Staff,0,3,35,35
1746590094222,MATH 181A,A02,960115,Staff,26,0,35,9
1746590095249,MATH 181B,A01,959874,Staff,25,0,30,5
1746590096277,MATH 193B,A01,890265,Staff,0,4,35,35
1746590097307,MGT 4,A01,890311,Anderson; John Charles,42,0,88,46
1746590098332,MGT 5,A00,907740,Staff,12,0,98,86
1746590099361,MGT 12,A00,890312,Lindenberger; Wade Douglas,67,0,98,31
1746590100387,MGT 16,A00,957883,Staff,78,0,98,20
1746590102444,MGT 45,A00,890314,Pecore; Joseph P.,45,0,98,53
1746590103470,MGT 71,A00,890315,Staff,0,12,98,98
1746590104494,MGT 100,A00,890316,Yavorsky; Daniel Ryan,44,0,98,54
1746590105520,MGT 103,A00,890317,Ehrich; Kristine R,73,0,98,25
1746590106547,MGT 105,A00,890356,Bates; Kenneth Walter,0,8,98,98
1746590107572,MGT 112,A00,890360,Ehrich; Kristine R,55,0,98,43
1746590108597,MGT 127R,A00,907732,Zhu; Kevin Xiaoguo,23,0,98,75
1746590109625,MGT 131B,A00,890361,Anderson; John Charles,59,0,98,39
1746590110650,MGT 137,A00,890362,Lindenberger; Wade Douglas,65,0,98,33
1746590111676,MGT 160,A00,890369,Johnson; Erik Barry,9,0,98,89
1746590113741,MGT 164,A00,890372,Zimmermann; Carsten,0,40,98,98
1746590114767,MGT 180,A00,890374,Bliss; Barbara Ann,11,0,98,87
1746590115792,MMW 15,A01,886414,Chang; Edmond Yi-Teh,0,12,28,28
1746590115792,MMW 15,A02,886415,Chang; Edmond Yi-Teh,0,8,28,28
1746590115792,MMW 15,A03,886416,Chang; Edmond Yi-Teh,0,9,28,28
1746590115792,MMW 15,A04,886417,Chang; Edmond Yi-Teh,0,8,28,28
1746590115792,MMW 15,B01,886419,Chang; Edmond Yi-Teh,0,7,28,28
1746590115792,MMW 15,B02,886420,Chang; Edmond Yi-Teh,0,8,28,28
1746590115792,MMW 15,B03,886421,Chang; Edmond Yi-Teh,0,7,28,28
1746590115792,MMW 15,B04,886422,Chang; Edmond Yi-Teh,0,8,28,28
1746590115792,MMW 15,C01,886424,Staff,0,9,28,28
1746590115792,MMW 15,C02,886425,Staff,0,8,28,28
1746590115792,MMW 15,C03,886426,Staff,0,8,28,28
1746590115792,MMW 15,C04,886427,Staff,0,8,28,28
1746590115792,MMW 15,C05,958038,Staff,0,8,28,28
1746590115792,MMW 15,C06,958039,Staff,1,8,28,27
1746590116820,MMW 15GS,A00,906910,Patterson; Patrick H.,4,0,28,24
1746590117849,MMW 122R,A01,886429,Rahimi; Babak,0,13,28,28
1746590117849,MMW 122R,A02,886430,Rahimi; Babak,0,12,28,28
1746590117849,MMW 122R,A03,958040,Rahimi; Babak,0,11,28,28
1746590118875,MUS 1A,A01,890937,Staff,2,0,25,23
1746590118875,MUS 1A,A02,891035,Staff,6,0,25,19
1746590118875,MUS 1A,C01,958912,Staff,24,0,25,1
1746590118875,MUS 1A,C02,958913,Staff,25,0,25,0
1746590120927,MUS 2AK,A00,957092,Ohnishi; Takae,15,0,15,0
1746590121956,MUS 4,A01,891044,Staff,0,0,25,25
1746590121956,MUS 4,A02,891045,Staff,23,0,25,2
1746590121956,MUS 4,B01,891048,Staff,17,0,25,8
1746590121956,MUS 4,B02,891050,Staff,25,0,25,0
1746590122985,MUS 5,A01,957506,Dubnov; Shlomo,0,0,25,25
1746590122985,MUS 5,A02,957622,Dubnov; Shlomo,13,0,25,12
1746590122985,MUS 5,A03,957623,Dubnov; Shlomo,20,0,25,5
1746590124011,MUS 6,A01,891053,Freitas Caetano; Marcelo,24,0,25,1
1746590124011,MUS 6,A02,891054,Freitas Caetano; Marcelo,23,0,25,2
1746590125038,MUS 7,A01,891081,Staff,0,0,25,25
1746590125038,MUS 7,A02,891082,Staff,3,0,25,22
1746590126066,MUS 8GS,A00,891118,Borgo; David Garcia,1,0,25,24
1746590127093,MUS 11,A01,891140,Staff,9,0,25,16
1746590127093,MUS 11,A02,891141,Staff,21,0,25,4
1746590128121,MUS 13,A01,891143,Staff,8,0,25,17
1746590128121,MUS 13,A02,891144,Staff,24,0,25,1
1746590129151,MUS 15,A01,891146,Staff,9,0,25,16
1746590129151,MUS 15,A02,891148,Staff,21,0,25,4
1746590129151,MUS 15,B01,891150,Staff,18,0,25,7
1746590129151,MUS 15,B02,891151,Staff,25,0,25,0
1746590130177,MUS 20,A01,891153,Staff,5,0,20,15
1746590130177,MUS 20,A02,891155,Staff,14,0,20,6
1746590131204,MUS 80,A00,891156,Staff,19,0,25,6
1746590131204,MUS 80,B00,891157,Staff,23,0,25,2
1746590132231,MUS 130,A00,891158,Ohnishi; Takae,35,0,35,0
1746590133256,MUS 150GS,A01,891160,Borgo; David Garcia,1,0,25,24
1746590134280,MUS 170,A01,891162,Freitas Caetano; Marcelo,20,0,25,5
1746590134280,MUS 170,A02,891164,Freitas Caetano; Marcelo,21,0,25,4
1746590135310,NANO 11,A00,886220,Vazquez Mena; Oscar,13,0,15,2
1746590136337,NANO 15,A01,886222,Drews; Aaron,4,0,7,3
1746590137362,NANO 104,A00,886224,Sirbuly; Donald,17,0,25,8
1746590138387,PH 40,A00,886528,Staff,23,0,40,17
1746590139413,PH 45,A01,886799,Staff,35,0,40,5
1746590140438,PH 110,A00,886802,Staff,0,6,40,40
1746590141462,PH 172,A00,906716,Staff,19,0,35,16
1746590142490,PH 191,A00,886803,Staff,6,0,40,34
1746590143517,PHIL 1,A00,889500,Staff,20,0,30,10
1746590144542,PHIL 10,A01,889549,Grush; Rick Scott,16,0,22,6
1746590144542,PHIL 10,A02,889551,Grush; Rick Scott,22,0,22,0
1746590145571,PHIL 28,A01,889559,Lamey; Andy M.,0,2,31,31
1746590145571,PHIL 28,A02,889561,Lamey; Andy M.,0,1,30,30
1746590145571,PHIL 28,A03,889572,Lamey; Andy M.,0,1,30,30
1746590146601,PHIL 35,A00,907839,Staff,13,0,15,2
1746590147630,PHIL 60,A00,889574,Staff,73,0,90,17
1746590148657,PHIL 101,A00,958004,Staff,12,0,15,3
1746590150715,PHIL 136,A00,889582,Fulkerson; Matthew Todd,26,0,45,19
1746590151745,PHIL 163,A01,889601,Staff,21,0,30,9
1746590151745,PHIL 163,B01,889606,Brandt; Reuven A,0,3,0,0
1746590152771,PHIL 164,A00,889610,Staff,16,0,30,14
1746590153798,PHIL 165,A00,889613,Staff,22,0,30,8
1746590154823,PHYS 1A,A00,886431,Staff,30,0,70,40
1746590155853,PHYS 1AL,001,886432,Tsai; Philbert S,1,2,30,29
1746590155853,PHYS 1AL,002,886436,Tsai; Philbert S,13,0,30,17
1746590156880,PHYS 1B,A00,886439,Staff,184,0,240,56
1746590157906,PHYS 1BL,001,886441,Tsai; Philbert S,0,4,30,30
1746590157906,PHYS 1BL,002,886444,Tsai; Philbert S,2,0,30,28
1746590158933,PHYS 1C,A00,896092,Arnold; Kam S,78,0,146,68
1746590159957,PHYS 1CL,001,886448,Tsai; Philbert S,0,0,30,30
1746590159957,PHYS 1CL,002,886449,Tsai; Philbert S,1,0,30,29
1746590159957,PHYS 1CL,003,886450,Tsai; Philbert S,16,0,30,14
1746590159957,PHYS 1CL,004,886451,Tsai; Philbert S,15,0,30,15
1746590160983,PHYS 2B,A01,886457,Staff,67,0,115,48
1746590162012,PHYS 2C,A01,886460,Shotwell; Brian,0,9,65,65
1746590163041,PHYS 2CL,A01,886467,Staff,0,4,28,28
1746590163041,PHYS 2CL,A02,886468,Staff,0,3,28,28
1746590164070,PHYS 2D,A01,886470,Staff,10,0,50,40
1746590165100,PHYS 4B,A01,886475,Grinstein; Benjamin,22,0,40,18
1746590166124,POLI 5,A00,891173,Desposato; Scott,7,0,25,18
1746590167207,POLI 5D,A01,891175,Staff,5,0,5,0
1746590167207,POLI 5D,B01,891178,Staff,5,0,5,0
1746590168232,POLI 11,A00,891179,Ferree; Karen E,2,0,35,33
1746590169260,POLI 12,A00,891180,Staff,16,0,30,14
1746590170284,POLI 27,A01,891182,Staff,12,0,75,63
1746590171312,POLI 30,A00,891183,Staff,8,0,50,42
1746590172341,POLI 100B,A00,891244,Staff,5,1,35,30
1746590173367,POLI 100I,A00,891247,Staff,7,0,30,23
1746590174394,POLI 104J,A00,891248,Nichter; Maysa,14,0,30,16
1746590175420,POLI 104U,A00,891250,Nichter; Maysa,1,0,30,29
1746590177473,POLI 110B,A00,891255,Wiens; David,19,0,25,6
1746590178498,POLI 112A,A00,891256,Wiens; David,6,0,25,19
1746590179525,POLI 114BR,A00,891261,Staff,19,0,30,11
1746590180550,POLI 117R,A00,891262,Forman; Fonna,0,6,50,50
1746590181581,POLI 118,A00,891264,Ingham; Sean,17,0,25,8
1746590182608,POLI 124A,A00,891265,Staff,18,0,20,2
1746590183637,POLI 125D,A00,891266,Nichter; Simeon C,2,0,25,23
1746590184664,POLI 126,A00,891268,Nichter; Simeon C,7,0,25,18
1746590185691,POLI 126AA,A00,891272,Staff,15,0,25,10
1746590186720,POLI 130AA,A00,891273,Staff,15,0,20,5
1746590187745,POLI 134AA,A00,891274,Staff,4,0,20,16
1746590189793,POLI 138,A00,891278,Staff,21,0,25,4
1746590190817,POLI 142K,A00,891280,Staff,10,0,25,15
1746590191842,POLI 142M,A00,891281,Gartzke; Erik,16,0,30,14
1746590192873,POLI 142P,A00,891284,Staff,20,0,30,10
1746590193900,POLI 143,A00,891285,Gartzke; Erik,12,0,30,18
1746590194927,POLI 153,A00,891286,Staff,19,0,20,1
1746590196977,POLI 175,A00,891290,Staff,15,0,20,5
1746590198002,PSYC 1,A00,890674,Steiner; Eric Tomas,0,11,45,45
1746590199027,PSYC 2,A00,890676,Albright; Thomas D,20,0,35,15
1746590200053,PSYC 3,A00,890679,Staff,17,0,20,3
1746590201078,PSYC 6,A00,959858,Staff,19,0,20,1
1746590202108,PSYC 60,A01,890684,Rickard; Timothy C.,0,6,45,45
1746590203136,PSYC 70,A01,890689,Geller; Emma Harlan,6,0,30,24
1746590204161,PSYC 71,A01,959860,Staff,21,0,25,4
1746590205185,PSYC 100,A00,890690,Lacefield; Katharine I,0,50,180,180
1746590206210,PSYC 102,A00,890695,Staff,18,0,40,22
1746590207238,PSYC 105,A00,890699,Geller; Emma Harlan,70,0,100,30
1746590208266,PSYC 106,A00,890701,Gorman; Michael R.,5,0,30,25
1746590209293,PSYC 108,A00,890704,Adrian; Julia Anna,0,29,50,50
1746590210317,PSYC 118,A01,890712,Staff,11,0,30,19
1746590211341,PSYC 124,A00,890716,Chapman; Eddie Nathaniel,25,0,60,35
1746590212367,PSYC 131,A00,890717,Anagnostaras; Stephan,0,7,80,80
1746590213392,PSYC 137,A00,890719,Winkielman; Piotr,0,11,30,30
1746590214419,PSYC 144,A00,890721,Adrian; Julia Anna,0,9,45,45
1746590215443,PSYC 162,A00,890805,Staff,0,1,75,75
1746590216470,PSYC 169,A00,890810,Staff,0,15,30,30
1746590217500,PSYC 172,A00,890814,Gorman; Michael R.,9,0,30,21
1746590218529,PSYC 181,A00,890818,Anagnostaras; Stephan,7,0,200,193
1746590219557,PSYC 184,A00,959861,Staff,163,0,175,12
1746590220583,PSYC 189,A00,890823,Staff,0,2,30,30
1746590221610,PSYC 191,A00,890884,Rickard; Timothy C.,0,12,35,35
1746590222634,PSYC 193,A00,890913,Staff,19,0,30,11
1746590222634,PSYC 193,B00,890914,Chapman; Eddie Nathaniel,24,0,30,6
1746590223665,PSYC 193L,A01,890918,Lowe; Angela Beth,20,0,30,10
1746590223665,PSYC 193L,B01,890921,Hurwitz; Ethan Scott,20,0,30,10
1746590223665,PSYC 193L,C01,890928,Staff,30,0,30,0
1746590224695,RELI 149,A00,886806,Rahimi; Babak,23,0,40,17
1746590225721,SE 9,A01,886814,Staff,7,0,20,13
1746590226752,SE 101B,A01,886816,Chadha; Mayank,3,0,35,32
1746590227776,SE 110B,A00,886818,Zhu; Qiang,4,0,75,71
1746590228801,SE 125,A01,886830,Staff,10,0,30,20
1746590229830,SE 130B,A01,886835,Staff,14,0,40,26
1746590230860,SE 131A,A01,886838,Krysl; Petr,34,0,55,21
1746590231887,SE 154,A00,886840,Staff,28,0,50,22
1746590232915,SE 164GS,A01,886849,Staff,6,0,20,14
1746590233942,SE 167GS,A01,886853,Staff,6,0,20,14
1746590234969,SIO 25,A01,890107,Staff,19,0,30,11
1746590235999,SIO 45,A00,890109,Cook; Geoffrey W,116,0,200,84
1746590237026,SIO 109R,A00,890110,Forman; Fonna,0,16,20,20
1746590238054,SIO 187,A01,890114,Kacev; David,15,0,40,25
1746590239082,SOCI 1,A01,890431,Thorpe; Charles Robert,14,0,30,16
1746590239082,SOCI 1,A02,890518,Thorpe; Charles Robert,30,0,30,0
1746590240107,SOCI 2,A01,957978,Staff,25,0,25,0
1746590240107,SOCI 2,A02,957979,Staff,23,0,25,2
1746590241132,SOCI 20,A01,890523,Calderon-Zaks; Michael Aar,21,0,30,9
1746590241132,SOCI 20,A02,890526,Calderon-Zaks; Michael Aar,29,0,30,1
1746590242159,SOCI 30,A01,890533,Pardo Guerra; Juan Pablo,37,0,40,3
1746590243186,SOCI 40,A01,890535,Staff,27,0,45,18
1746590244214,SOCI 104Q,A00,890559,Staff,18,0,30,12
1746590245242,SOCI 106,A00,890560,Arnal; Maud Marie Leonie,20,0,30,10
1746590246268,SOCI 110,A00,890567,Holkenbrink-Monk; Charlene,19,0,30,11
1746590247297,SOCI 112,A00,890568,Victoria Torres; Pablo,2,0,55,53
1746590248325,SOCI 115,A00,890597,Arnal; Maud Marie Leonie,28,0,45,17
1746590250381,SOCI 121,A00,890604,Pardo Guerra; Juan Pablo,38,0,45,7
1746590251408,SOCI 126,A01,890608,Staff,8,0,10,2
1746590252434,SOCI 127,A00,890609,Staff,18,0,30,12
1746590253461,SOCI 131,A00,890610,Thorpe; Charles Robert,37,0,45,8
1746590254486,SOCI 135,A00,890615,Payne; Christine Anna,14,0,45,31
1746590255511,SOCI 139,A00,890620,Staff,38,0,45,7
1746590256540,SOCI 148E,A00,890622,Calderon-Zaks; Michael Aar,36,0,45,9
1746590257569,SOCI 150,A00,890623,Kohler; Kristopher M.,31,0,45,14
1746590258597,SOCI 157,A00,890625,Jules-Rosette; Bennetta W.,18,0,20,2
1746590259626,SOCI 160,A00,890627,Payne; Christine Anna,21,0,45,24
1746590260651,SYN 1,A00,886855,Fish; Gwendolyn Anne,0,1,0,0
1746590260651,SYN 1,B00,906086,Fish; Gwendolyn Anne,0,2,0,2
1746590261681,SYN 2R,A00,886860,Staff,0,17,15,15
1746590261681,SYN 2R,B00,906106,Atkinson; Arthur Laird,0,16,15,15
1746590262714,SYN 100,A01,886866,Browne; Emily,0,28,20,20
1746590262714,SYN 100,B01,906128,Rock; Martin,0,4,20,20
1746590262714,SYN 100,C01,906140,Deavenport; James Cary,0,4,20,20
1746590262714,SYN 100,D01,907816,Deavenport; James Cary,0,5,20,20
1746590263741,TDAC 1,A00,890286,Walsh; Kim C.,7,0,20,13
1746590264770,TDAC 101,A00,890296,Basso; Beatrice,15,0,20,5
1746590265796,TDDE 131,A00,890297,Staff,47,0,50,3
1746590266825,TDDM 1,A00,890287,Weinberg; Sadie,25,0,30,5
1746590267851,TDGE 11,A00,890288,Fulton; Julia,138,0,200,62
1746590267851,TDGE 11,B00,890289,Castro; Robert Jess,185,0,200,15
1746590268877,TDGE 25,B00,957359,Walsh; Kim C.,5,0,20,15
1746590269902,TDGE 40,A01,890292,Power; Jade Yukana,26,0,30,4
1746590270969,TDGE 124,A00,890298,Havis; Allan,0,2,50,50
1746590271994,TDGE 131R,A00,890299,Burelle; Julie Sara Veronique,15,0,42,27
1746590273024,TDHT 101,A00,890300,Staff,10,0,20,10
1746590274051,TDHT 109,A01,890302,Anderson; Mysia Anyse,31,0,40,9
1746590275077,TDMV 1,A00,890293,Arcidiacono; Kristin,18,0,30,12
1746590276103,TDMV 2,A00,890294,Weinberg; Sadie,23,0,30,7
1746590277129,TDMV 3,A00,957878,Arcidiacono; Kristin,28,0,30,2
1746590279178,TDMV 138,A00,890304,Jun; Grace Shin Hae,25,0,40,15
1746590280203,TDMV 140,A00,890305,Corrales; Joseph Bernales,25,0,30,5
1746590281229,TDMV 142,A00,890307,Caligagan; Tony,32,0,40,8
1746590282256,TDMV 144,A00,890308,Camaya; Michelle Ann,25,0,30,5
1746590283284,TDPW 1,A00,890295,Stein; Deborah Isobel,3,0,20,17
1746590284312,USP 2,A01,890272,Lerner; Amy M,7,0,20,13
1746590285338,USP 3,A01,890274,Staff,12,0,30,18
1746590286364,USP 15,A01,890276,Sun; Feiyang,16,0,30,14
1746590287389,USP 25,A00,890277,Shenkman; Michael Thomas,18,0,25,7
1746590288415,USP 138,A00,890278,Staff,13,0,25,12
1746590289440,USP 143,A00,890279,Staff,22,0,70,48
1746590290466,USP 144,A00,890280,Chowdhury; Muhammed Zohir,16,0,30,14
1746590291492,USP 150,A00,890281,Boomhower; Matthew Charles,4,0,30,26
1746590292517,USP 151,A00,890282,Staff,16,0,20,4
1746590293544,USP 162,A00,890283,Andrews; Abigail Leslie,16,0,20,4
1746590294571,USP 168,A00,920477,Kwak; Nancy,0,0,5,5
1746590295595,USP 181,A00,890284,Staff,3,0,20,17
1746590296621,USP 191A,A00,890285,Staff,12,0,20,8
1746590297649,VIS 101,A00,886512,Staff,26,0,75,49
1746590298679,VIS 103,A00,886513,Cruz; Edwin Teddy,61,0,75,14
1746590299706,VIS 108,A00,886514,Staff,3,0,15,12
1746590300735,VIS 127P,A00,886515,Shen; Kuiyi,79,0,146,67
1746590301761,VIS 149,A00,886516,Yoldas; Pinar,0,0,15,15
1746590302785,VIS 164,A00,886526,Erdmann; Dean,19,0,22,3
1746590303813,VIS 194S,A00,886527,Staff,61,0,75,14
1746590304843,WCWP 10A,C00,886484,Martiniuk; Jill,12,0,15,3
1746590305871,WCWP 10B,A00,886490,Uriarte; Emma,0,0,15,15
1746590305871,WCWP 10B,B00,886491,Dhir; Simrita,8,0,15,7
1746590305871,WCWP 10B,C00,886492,Ornelas; Tricia,0,0,15,15
1746590306896,WCWP 100,A00,886494,Young; Mark T,0,6,15,15
1746590309028,AAS 10,A01,886199,Childs; Dennis R.,0,3,0,0
1746590310052,ANAR 104,A01,886940,Shtienberg; Gilad,27,0,30,3
1746590311079,ANAR 120,A00,886953,Staff,13,0,20,7
1746590312104,ANBI 148,A01,886955,Wilder; Linnea Lorene,30,0,40,10
1746590314160,ANSC 122,A00,886957,Staff,24,0,30,6
1746590315189,ANSC 150,A00,886958,Sloane; Julia Kathryn,2,0,15,13
1746590316217,ANSC 156,A00,886959,Jenkins; Janis A.,0,1,15,15
1746590317244,ANSC 180,A00,886960,Staff,11,0,17,6
1746590318273,ANSC 188,A00,886961,Jassal; Aftab,9,0,25,16
1746590319301,ANSC 190,A00,886962,Jassal; Aftab,14,0,25,11
1746590320326,ANSC 191,A00,886963,Staff,18,0,20,2
1746590321353,ANTH 3,A01,891689,Staff,17,0,20,3
1746590322379,ANTH 5,A00,886933,Semendeferi; Ekaterini,16,0,20,4
1746590323403,ANTH 10,A00,886934,Staff,0,12,30,30
1746590324432,ANTH 21,A01,886936,Staff,41,0,60,19
1746590325460,ANTH 23,A01,886938,Staff,92,0,100,8
1746590326486,ANTH 105,A00,886964,Stewart; Alexander B,84,0,100,16
1746590327511,ANTH 108,A00,886965,Pedersen; David,9,0,20,11
1746590328546,AWP 10,001,886147,Staff,0,0,0,0
1746590328546,AWP 10,002,886148,Staff,0,0,0,0
1746590328546,AWP 10,003,886149,Staff,0,0,0,0
1746590328546,AWP 10,004,886150,Staff,0,0,0,0
1746590328546,AWP 10,005,886151,Staff,0,0,0,0
1746590328546,AWP 10,006,886152,Staff,0,0,0,0
1746590328546,AWP 10,007,886153,Staff,0,0,0,0
1746590328546,AWP 10,008,886154,Staff,0,0,0,0
1746590328546,AWP 10,009,886155,Staff,0,0,0,0
1746590328546,AWP 10,010,886156,Staff,0,0,0,0
1746590328546,AWP 10,011,886158,Staff,0,0,0,0
1746590328546,AWP 10,012,886160,Staff,0,0,0,0
1746590328546,AWP 10,013,886161,Staff,0,0,0,0
1746590328546,AWP 10,014,886162,Staff,0,0,0,0
1746590328546,AWP 10,015,886163,Staff,0,0,0,0
1746590328546,AWP 10,016,886164,Staff,0,0,0,0
1746590328546,AWP 10,017,886165,Staff,0,0,0,0
1746590328546,AWP 10,018,886166,Staff,0,0,0,0
1746590328546,AWP 10,019,886168,Staff,0,0,0,0
1746590328546,AWP 10,020,886170,Staff,0,0,0,0
1746590328546,AWP 10,021,886172,Staff,0,0,0,0
1746590329577,AWP 10R,001,886173,Staff,0,1,0,0
1746590329577,AWP 10R,002,886174,Staff,0,1,0,0
1746590329577,AWP 10R,003,886175,Staff,0,0,0,0
1746590329577,AWP 10R,004,886176,Staff,0,0,0,0
1746590329577,AWP 10R,005,886177,Staff,0,0,0,0
1746590329577,AWP 10R,006,886178,Staff,0,0,0,0
1746590329577,AWP 10R,007,886179,Staff,0,0,0,0
1746590329577,AWP 10R,008,886181,Staff,0,0,0,0
1746590329577,AWP 10R,009,886182,Staff,0,0,0,0
1746590329577,AWP 10R,010,886183,Staff,0,0,0,0
1746590329577,AWP 10R,011,886184,Staff,0,0,0,0
1746590329577,AWP 10R,012,886185,Staff,0,0,0,0
1746590329577,AWP 10R,013,886186,Staff,0,0,0,0
1746590329577,AWP 10R,014,886187,Staff,0,0,0,0
1746590329577,AWP 10R,015,886188,Staff,0,0,0,0
1746590329577,AWP 10R,016,886189,Staff,0,0,0,0
1746590329577,AWP 10R,017,960532,Staff,0,0,0,0
1746590329577,AWP 10R,018,960533,Staff,0,0,0,0
1746590329577,AWP 10R,019,960534,Staff,0,0,0,0
1746590329577,AWP 10R,020,960538,Staff,0,0,0,0
1746590329577,AWP 10R,021,960540,Staff,0,0,0,0
1746590329577,AWP 10R,022,960541,Staff,0,0,0,0
1746590329577,AWP 10R,023,960542,Staff,0,0,0,0
1746590329577,AWP 10R,024,960544,Staff,0,0,0,0
1746590329577,AWP 10R,025,960545,Staff,0,0,0,0
1746590329577,AWP 10R,026,960548,Staff,0,0,0,0
1746590330604,AWP 102R,A00,886190,Staff,0,0,0,0
1746590330604,AWP 102R,B00,886191,Staff,0,0,0,0
1746590331634,BENG 100,A01,886193,Staff,17,0,30,13
1746590332666,BENG 122A,A01,886195,Hasty; Jeff M,13,0,30,17
1746590333691,BENG 166A,A00,886196,Sah; Robert Lie-Yuan,0,3,30,30
1746590334717,BENG 190,A00,958050,Khojah; Reem I,17,0,25,8
1746590335743,BIBC 102,A01,894320,Staff,0,0,46,46
1746590335743,BIBC 102,A02,894321,Staff,0,0,46,46
1746590335743,BIBC 102,A03,894344,Staff,6,0,46,40
1746590335743,BIBC 102,A04,894345,Staff,27,0,47,20
1746590336769,BICD 100R,A01,894365,Smith; Laurie,1,3,58,57
1746590336769,BICD 100R,A02,894366,Smith; Laurie,1,5,58,57
1746590336769,BICD 100R,A03,894367,Smith; Laurie,0,0,59,59
1746590336769,BICD 100R,A04,959869,Smith; Laurie,39,0,59,20
1746590337799,BICD 136,A01,894383,Gustafson-Brown; Cindy,14,0,50,36
1746590338827,BIEB 102,A01,894494,Butler; Shannon Rhey,51,0,130,79
1746590340876,BIEB 150,A01,894617,Wills; Christopher,3,0,20,17
1746590340876,BIEB 150,A02,894631,Wills; Christopher,3,0,20,17
1746590340876,BIEB 150,A03,894937,Wills; Christopher,3,0,20,17
1746590340876,BIEB 150,A04,894946,Wills; Christopher,5,0,20,15
1746590341901,BIEB 194,A00,906141,Kurle; Carolyn M.,5,0,20,15
1746590342927,BILD 1,A01,894154,Staff,3,0,19,16
1746590342927,BILD 1,A02,894155,Staff,14,0,19,5
1746590342927,BILD 1,A03,894160,Staff,13,0,19,6
1746590342927,BILD 1,A04,894161,Staff,15,0,18,3
1746590343956,BILD 2,A01,894168,Staff,0,0,50,50
1746590343956,BILD 2,A02,894169,Staff,0,0,50,50
1746590343956,BILD 2,A03,894179,Staff,0,0,50,50
1746590343956,BILD 2,A04,894203,Staff,23,0,50,27
1746590344982,BILD 3,A01,894213,Staff,23,0,31,8
1746590344982,BILD 3,A02,894214,Staff,26,0,31,5
1746590344982,BILD 3,A03,894235,Staff,28,0,31,3
1746590344982,BILD 3,A04,894236,Staff,28,0,32,4
1746590346007,BILD 4,A01,894253,Reuther; Keefe,5,0,24,19
1746590346007,BILD 4,A02,894258,Reuther; Keefe,16,0,24,8
1746590347032,BILD 5,A01,894276,Reuther; Keefe,34,0,50,16
1746590347032,BILD 5,A02,894277,Reuther; Keefe,45,0,50,5
1746590347032,BILD 5,A03,894290,Reuther; Keefe,44,0,50,6
1746590347032,BILD 5,A04,894291,Reuther; Keefe,48,0,50,2
1746590348057,BILD 24,A01,894297,Pirino; Giorgia,40,0,60,20
1746590349082,BIMM 100,B01,958915,Staff,71,0,100,29
1746590350112,BIMM 101,A01,895017,McDonnell; Lisa Marie,0,5,24,24
1746590350112,BIMM 101,A02,895018,McDonnell; Lisa Marie,0,5,24,24
1746590350112,BIMM 101,B01,895020,McDonnell; Lisa Marie,1,6,24,23
1746590350112,BIMM 101,B02,895021,McDonnell; Lisa Marie,0,4,24,24
1746590351137,BIMM 110,A01,895023,Staff,1,0,25,24
1746590351137,BIMM 110,A02,895024,Staff,9,0,25,16
1746590351137,BIMM 110,A03,895025,Staff,18,0,25,7
1746590351137,BIMM 110,A04,895031,Staff,20,0,25,5
1746590352167,BIMM 120,A01,895114,Gustafson-Brown; Cindy,14,0,28,14
1746590352167,BIMM 120,A02,895126,Gustafson-Brown; Cindy,21,0,27,6
1746590353192,BIPN 100,A01,895130,Yang; Mingyu,0,0,38,38
1746590353192,BIPN 100,A02,895131,Yang; Mingyu,31,0,38,7
1746590353192,BIPN 100,A03,895132,Yang; Mingyu,32,0,38,6
1746590353192,BIPN 100,A04,895133,Yang; Mingyu,27,0,36,9
1746590354219,BIPN 120,A01,895135,Cooke; James Edward,0,3,13,13
1746590354219,BIPN 120,A02,895136,Cooke; James Edward,0,1,13,13
1746590354219,BIPN 120,A03,895137,Cooke; James Edward,0,3,13,13
1746590354219,BIPN 120,A04,895156,Cooke; James Edward,0,2,11,11
1746590355244,BIPN 134,A01,895235,Cooke; James Edward,0,2,25,25
1746590355244,BIPN 134,A02,895237,Cooke; James Edward,0,0,25,25
1746590355244,BIPN 134,A03,895240,Cooke; James Edward,3,0,25,22
1746590355244,BIPN 134,A04,895270,Cooke; James Edward,20,0,25,5
1746590356275,BIPN 189,A00,892103,Staff,0,14,14,14
1746590358325,BISP 194,A00,958008,Staff,0,2,0,0
1746590359351,CAT 124,A01,922009,Staff,0,5,20,20
1746590360377,CAT 125R,A00,886390,Morales; Celeste Georgianna,0,3,20,20
1746590360377,CAT 125R,B00,886391,Irwin; Matthew Joseph,0,4,20,20
1746590360377,CAT 125R,C00,886392,Smith; Lauryn Alissa,0,2,20,20
1746590360377,CAT 125R,D00,886393,Vanderschuit; Maya Alysia,0,3,20,20
1746590360377,CAT 125R,E00,886394,Marchisotto; Jennifer Anne,0,3,20,20
1746590361404,CENG 15,A01,886218,Drews; Aaron,3,0,8,5
1746590362429,CENG 113,A00,886219,Opatkiewicz; Justin Paul,15,0,25,10
1746590363454,CGS 101,A00,887044,Staff,7,0,20,13
1746590364481,CGS 105,A01,887046,Staff,14,0,25,11
1746590365507,CGS 112,A00,887047,Cuong; Marisol,12,0,15,3
1746590366531,CGS 113,A00,887048,Staff,23,0,30,7
1746590367557,CGS 120,A00,887049,Staff,10,0,17,7
1746590368587,CHEM 6A,A01,886336,Lam; Tin Yiu,38,0,50,12
1746590368587,CHEM 6A,A02,886338,Lam; Tin Yiu,37,0,50,13
1746590369616,CHEM 6B,A01,886341,Hopkins; Patrycja Anna,16,0,50,34
1746590369616,CHEM 6B,A02,886343,Hopkins; Patrycja Anna,42,0,50,8
1746590370641,CHEM 6C,A01,886346,Albizati; Kim F.,0,2,50,50
1746590370641,CHEM 6C,A02,886348,Albizati; Kim F.,24,0,50,26
1746590371671,CHEM 40A,A01,886352,Klosterman; Jeremy K,65,0,100,35
1746590372698,CHEM 40B,A01,886356,Klosterman; Jeremy K,0,24,100,100
1746590373723,CHEM 41B,A01,886360,Theodorakis; Emmanuel,25,0,50,25
1746590373723,CHEM 41B,A02,886362,Theodorakis; Emmanuel,47,0,50,3
1746590374795,CHIN 165A,A00,886382,Xu; Li,18,0,20,2
1746590375820,CLAS 120,A00,886387,Myerston Santana; Jacobo,33,0,40,7
1746590376845,COGS 9,A01,886967,Shannon; Kyle Michael,42,0,60,18
1746590377876,COGS 11,A01,886969,Staff,9,0,30,21
1746590378902,COGS 14A,A01,886971,Staff,5,0,60,55
1746590379930,COGS 14B,A01,886973,Hoffman; Drew Ellen,4,0,60,56
1746590380956,COGS 18,A01,886975,Morgan; Eric,34,0,60,26
1746590381981,COGS 20,A01,886977,Staff,2,0,8,6
1746590381981,COGS 20,A02,886978,Staff,4,0,7,3
1746590383027,COGS 100,A01,907783,Staff,1,2,30,29
1746590384058,COGS 101B,A01,886980,Staff,0,4,48,48
1746590385090,COGS 101C,A01,886982,Delgado; Tania,0,5,44,44
1746590386116,COGS 102A,A01,886984,Johnson; Christine M.,3,0,30,27
1746590387142,COGS 118B,A01,886986,Staff,1,5,88,87
1746590388170,COGS 150,A01,886988,Bergen; Benjamin,22,0,50,28
1746590389198,COGS 153,A00,886989,Delgado; Tania,0,3,41,41
1746590390223,COGS 186,A01,886991,Staff,0,0,32,32
1746590391249,COGS 187A,A01,886993,Boyle; Mary E. T.,7,0,30,23
1746590392275,COGS 189,A00,886994,Staff,0,1,30,30
1746590393299,COMM 10,A01,886996,Staff,0,0,20,21
1746590393299,COMM 10,A02,886997,Staff,10,0,20,10
1746590393299,COMM 10,A03,959845,Staff,19,0,20,1
1746590394325,COMM 20,A01,886999,Leuning; Grant Maurstad,24,0,40,16
1746590396378,COMM 100A,A01,887002,Staff,0,0,20,25
1746590396378,COMM 100A,A02,887003,Staff,6,0,20,14
1746590397403,COMM 100B,A01,887005,Staff,0,8,20,24
1746590398445,COMM 106D,A00,887006,Staff,13,0,40,27
1746590399471,COMM 110G,A00,887007,Whitworth-Smith; Andrew C,12,0,40,28
1746590400495,COMM 111B,A00,887008,Staff,31,0,40,9
1746590401522,COMM 113T,A00,887009,Abuelhiga; Soraya Jill,28,0,40,12
1746590401522,COMM 113T,B00,906733,Staff,40,0,40,0
1746590402549,COMM 145,A00,887010,Staff,12,0,40,28
1746590403576,COMM 146,A00,887054,Staff,31,0,40,9
1746590404604,COMM 190,A00,887012,Staff,8,0,23,15
1746590405633,CSE 8A,A50,887015,Cao; Yingjun,56,0,85,29
1746590406666,CSE 11,A01,887017,Cao; Yingjun,11,0,70,59
1746590407694,CSE 20,A01,887019,Staff,30,0,50,20
1746590408722,CSE 21,A01,887021,Staff,78,0,100,22
1746590408722,CSE 21,B01,892583,Braun; Oliver,45,0,50,5
1746590409754,CSE 30,A01,887025,Eldon; John,142,0,200,58
1746590410779,CSE 100,A01,887027,Staff,26,0,50,24
1746590410779,CSE 100,A02,887028,Staff,42,0,50,8
1746590411808,CSE 101,A01,887030,Braun; Oliver,74,0,100,26
1746590411808,CSE 101,B01,887032,Jones; Miles E,0,3,50,50
1746590411808,CSE 101,B02,887033,Jones; Miles E,0,2,50,50
1746590412835,CSE 105,A01,908084,Jones; Miles E,32,0,50,18
1746590412835,CSE 105,A02,908087,Jones; Miles E,31,0,50,19
1746590413864,CSE 135,A01,887035,Powell; Thomas Allan,0,5,50,50
1746590414889,CSE 142,A01,887037,Staff,8,0,60,52
1746590415914,CSE 142L,A01,887039,Staff,34,0,60,26
1746590416940,CSE 151A,A01,887041,Solares; Edwin A,47,0,100,53
1746590417965,CSE 175,A01,887043,Kumar; Rakesh,30,0,30,0
1746590418991,CSS 1,A01,886389,Staff,1,2,40,39
1746590420016,DSC 30,A01,908097,Liao; Soohyun Nam,47,0,75,28
1746590421044,DSC 40A,A01,908099,Shannon; Kyle Michael,30,0,50,20
1746590422070,DSC 40B,A01,908112,Staff,15,0,50,35
1746590423096,DSC 80,A01,908116,Staff,19,0,60,41
1746590424121,DSC 197,001,956863,Eldridge; Justin Matthew,9999,0,9999,0
1746590425146,ECE 5,A01,886400,Morris; Karcher William,1,0,6,5
1746590425146,ECE 5,A02,886401,Morris; Karcher William,3,0,6,3
1746590426175,ECE 148,A01,886403,Silberman; Jack,0,14,14,14
1746590427202,ECON 1,A01,887265,Crane; Meredith Helen,11,0,70,59
1746590427202,ECON 1,B01,887268,Staff,42,0,50,8
1746590428229,ECON 2,A01,887273,Crane; Meredith Helen,54,0,70,16
1746590429255,ECON 3,A01,887279,Rondina; Giacomo,31,0,70,39
1746590430280,ECON 4,A01,887282,Anderson; John Charles,0,2,10,10
1746590431307,ECON 5,A01,887285,Staff,34,0,45,11
1746590431307,ECON 5,B01,887292,Staff,41,0,45,4
1746590432340,ECON 100A,A01,887337,Newhouse; Herbert S,54,0,70,16
1746590432340,ECON 100A,B01,887349,Staff,45,0,50,5
1746590433368,ECON 100B,A01,887361,Du; Songzi,29,0,70,41
1746590434395,ECON 100C,A01,887445,Newhouse; Herbert S,59,0,70,11
1746590435419,ECON 105,A00,887488,Vespa; Emanuel Ignacio,23,0,35,12
1746590436445,ECON 109,A01,887506,Shishkin; Denis,28,0,35,7
1746590437476,ECON 110A,A01,887568,Alon; Titan Michael,1,3,35,34
1746590437476,ECON 110A,B01,907601,Alon; Titan Michael,20,0,35,15
1746590438502,ECON 110B,A01,887598,Levkoff; Steven B.,0,24,70,70
1746590439530,ECON 112,A00,887599,Rondina; Giacomo,19,0,35,16
1746590440554,ECON 120A,A01,887603,Dai; Yinlin,35,0,70,35
1746590441588,ECON 120C,A01,887608,Sun; Yixiao,0,1,35,35
1746590441588,ECON 120C,B01,887614,Sun; Yixiao,0,0,35,35
1746590442613,ECON 138,A00,887621,Bharadwaj; Prashant,0,21,20,20
1746590443638,ECON 144,A00,958007,Squires; Dale E,12,0,35,23
1746590444665,ECON 171,A01,907666,Staff,18,0,35,17
1746590445690,ECON 175,A00,887626,Wu; Pak Yeung,22,0,35,13
1746590446716,ECON 190,A00,887640,Vespa; Emanuel Ignacio,22,0,35,13
1746590447745,EDS 25,A01,888197,Staff,0,0,0,0
1746590447745,EDS 25,A02,888209,Staff,0,0,0,0
1746590447745,EDS 25,A03,888210,Staff,0,0,0,0
1746590447745,EDS 25,A04,888212,Staff,0,0,0,0
1746590447745,EDS 25,A05,888213,Staff,0,0,0,0
1746590447745,EDS 25,A06,888214,Staff,0,0,0,0
1746590447745,EDS 25,A07,888235,Staff,0,2,0,0
1746590447745,EDS 25,A08,888236,Staff,0,0,0,0
1746590447745,EDS 25,A09,888240,Staff,0,0,0,0
1746590447745,EDS 25,A10,888244,Staff,0,0,0,0
1746590447745,EDS 25,B01,888273,Staff,0,0,0,0
1746590447745,EDS 25,B02,888285,Staff,0,0,0,0
1746590447745,EDS 25,B03,888423,Staff,0,0,0,1
1746590447745,EDS 25,B04,888432,Staff,0,0,0,0
1746590447745,EDS 25,B05,888433,Staff,0,0,0,0
1746590447745,EDS 25,B06,888467,Staff,0,0,0,0
1746590447745,EDS 25,B07,888468,Staff,0,0,0,0
1746590447745,EDS 25,B08,888479,Staff,0,0,0,0
1746590447745,EDS 25,B09,888484,Staff,0,0,0,0
1746590447745,EDS 25,B10,888487,Staff,0,0,0,0
1746590448774,EDS 38,A01,907700,Choi; Bailey Miyeon,30,0,30,0
1746590449800,EDS 112,A01,888601,Chapman; Thandeka K,12,0,40,28
1746590450826,EDS 115,A00,888697,Mendez; Kathrina Mendoza,10,0,30,20
1746590451854,EDS 116,A01,888893,Staff,33,0,40,7
1746590453908,EDS 124AR,A00,889133,Staff,29,0,50,21
1746590453908,EDS 124AR,B00,907471,Simon; Elizabeth A,37,0,50,13
1746590454935,EDS 124BR,A00,889134,Simon; Elizabeth A,44,0,100,56
1746590455960,EDS 125,A00,889135,Staff,25,0,30,5
1746590456985,EDS 126,A01,889138,Staff,35,0,40,5
1746590458011,EDS 164R,A01,889142,Wishard Guerra; Alison G.,32,0,50,18
1746590459039,ENG 30,A01,886396,Staff,0,0,0,0
1746590459039,ENG 30,B01,886398,Staff,0,0,0,0
1746590460064,ENVR 102,A00,906150,Montejo; Carolina,23,0,25,2
1746590461096,ETHN 103A,A00,887236,Man; Simeon S,0,2,0,0
1746590462122,ETHN 113,A00,887239,Staff,16,0,30,14
1746590463151,ETHN 116,A00,887240,Staff,16,0,25,9
1746590464176,ETHN 117,A00,887241,Choi; Esther Min,28,0,30,2
1746590465200,ETHN 118,A00,887243,Staff,24,0,30,6
1746590466226,ETHN 127,A00,887248,Cuong; Marisol,11,0,15,4
1746590467254,ETHN 139,A00,887250,Staff,7,0,10,3
1746590468284,ETHN 142,A00,887252,Staff,10,0,30,20
1746590469312,ETHN 161,A00,887253,Browne; Errol Tsekani,24,0,30,6
1746590470336,ETHN 163FR,A00,887255,Burelle; Julie Sara Veronique,0,0,5,5
1746590471362,GLBH 20,A00,889149,Elwardani; Nile Regina,8,0,42,34
1746590473418,GLBH 111,A01,889152,Burgos; Jose L.,17,0,17,0
1746590474444,GLBH 150,A00,889181,Sloane; Julia Kathryn,0,5,15,15
1746590476495,HDS 60,A01,886406,Warstadt; Melissa Fawn,73,0,80,7
1746590477523,HIAF 111,A00,889324,Gyamfi; Bright,25,0,32,7
1746590478548,HIEA 131,A00,889328,Staff,15,0,32,17
1746590479574,HIEA 144,A00,889333,Henry; Todd A.,26,0,32,6
1746590480600,HIEA 154,A00,889336,Henry; Todd A.,24,0,32,8
1746590481627,HIEU 106,A00,889339,Staff,22,0,32,10
1746590483677,HIEU 114,A00,889340,Staff,4,0,32,28
1746590484702,HIEU 135GS,A00,889342,Patterson; Patrick H.,0,0,1,24
1746590485729,HIEU 137,A00,889343,Edington; Claire Ellen,10,0,25,15
1746590486755,HIEU 148,A00,889345,Staff,14,0,32,18
1746590487781,HIEU 154,A00,889346,Biess; Frank Peter,21,0,32,11
1746590488809,HILA 102,A00,889351,Staff,12,0,32,20
1746590489834,HILD 2A,A01,889221,Lewandoski; Julia Mavis,2,10,32,30
1746590490860,HILD 7B,A01,889225,Man; Simeon S,0,12,32,32
1746590491884,HILD 7C,A01,889288,Alvarez; Luis A,0,14,32,32
1746590492912,HILD 30,A01,889323,Staff,0,5,32,32
1746590494963,HISC 119,A00,889383,Golan; Tal,19,0,32,13
1746590495989,HIUS 103,A00,889384,Man; Simeon S,0,0,32,32
1746590497016,HIUS 117,A00,919797,Kwak; Nancy,18,0,32,14
1746590498041,HIUS 142A,A00,919788,Staff,22,0,32,10
1746590500092,HIUS 149,A00,889386,Gyamfi; Bright,26,0,32,6
1746590501118,HIUS 155,A00,889387,Alvarez; Luis A,15,0,32,17
1746590502147,HUM 3,A01,886499,Caldwell; Michael Alan,19,0,50,31
1746590503172,HUM 3GS,A00,886500,Rodriguez; Bretton Sigfred,0,0,0,28
1746590504198,HUM 3R,A01,886502,Markman; Kristina,0,36,50,50
1746590505225,HUM 4,A01,886504,Crum; Matthew Stephen,23,0,50,27
1746590505225,HUM 4,B01,886506,West; Geoffrey Scott,17,0,50,33
1746590506250,HUM 4GS,A00,886507,Staff,0,0,0,19
1746590507276,HUM 5,A01,886509,Staff,32,0,50,18
1746590508305,HUM 5R,A01,886511,Zavodny; Tatiana Sophia,0,39,50,50
1746590509330,JAPN 180,A00,886407,Staff,16,0,40,24
1746590510356,LATI 50,A01,886409,Martin-Cabrera; Luis,3,0,22,19
1746590510356,LATI 50,A02,886410,Martin-Cabrera; Luis,19,0,22,3
1746590510356,LATI 50,A03,886411,Martin-Cabrera; Luis,21,0,22,1
1746590510356,LATI 50,A04,886412,Martin-Cabrera; Luis,8,0,22,14
1746590511383,LAWS 101,A00,907664,Staff,28,0,60,32
1746590512418,LIAB 1A,A00,889388,Saab; Dima,17,0,20,3
1746590513446,LIAB 1AX,A00,889389,El Cheddadi; Youniss,18,0,20,2
1746590514472,LIFR 1C,A00,889391,Van Moer; Vinciane G,8,0,20,12
1746590515501,LIFR 1CX,A00,889392,Van Moer; Vinciane G,7,0,20,13
1746590516528,LIFR 1D,A00,889393,Van Moer; Vinciane G,7,0,20,13
1746590517556,LIFR 1DX,A00,889394,Van Moer; Vinciane G,8,0,20,12
1746590518585,LIGN 7,A00,886923,Staff,24,0,50,26
1746590519614,LIGN 17,A00,886924,Kehler; Andrew Scott,125,0,150,25
1746590520638,LTAM 110,A00,889395,Staff,15,0,30,15
1746590521666,LTAM 110GS,A00,958010,Rodriguez; Bretton Sigfred,0,0,0,28
1746590522691,LTCH 101,A00,889397,Staff,23,0,25,2
1746590523719,LTCS 130,A00,889398,Staff,23,0,25,2
1746590524747,LTEA 138,A00,889399,Staff,24,0,40,16
1746590525773,LTEN 149,A00,889400,Wesling; Megan E.,0,3,25,25
1746590526797,LTEN 169,A00,889401,Staff,20,0,25,5
1746590527824,LTEN 180,A00,889402,Staff,10,0,15,5
1746590528854,LTEN 181,A00,889403,Staff,21,0,25,4
1746590529882,LTWL 100,A00,889404,Myerston Santana; Jacobo,2,0,25,23
1746590530911,LTWL 180GS,A00,889405,Staff,0,0,20,20
1746590531938,LTWL 181,A00,889406,Staff,16,0,25,9
1746590532967,LTWL 184,A00,889475,Mukherjee; Silpa,22,0,25,3
1746590533995,LTWR 102C,A00,889486,Staff,29,0,30,1
1746590535021,LTWR 115W,A00,889491,Staff,0,2,15,15
1746590536046,MAE 8,A01,886905,Staff,0,2,0,0
1746590537072,MAE 11,A00,886906,Bandaru; Prabhakar,0,7,50,50
1746590538099,MAE 20,A00,886907,Evdokimenko; Ekaterina,43,0,70,27
1746590539127,MAE 30B,A00,886909,Ghazinejad; Maziar,26,0,45,19
1746590540153,MAE 101B,A00,886910,Saintillan; David,29,0,45,16
1746590541183,MAE 105,A00,886911,Bandaru; Prabhakar,18,0,50,32
1746590542209,MAE 107,B00,958024,Staff,7,0,50,43
1746590543235,MAE 143B,A00,886913,Bewley; Thomas R,3,0,40,37
1746590544261,MAE 148,A01,886915,Silberman; Jack,0,3,14,14
1746590545286,MAE 160,A00,886916,Evdokimenko; Ekaterina,31,0,60,29
1746590546313,MATH 3C,A01,889681,Staff,0,2,30,30
1746590546313,MATH 3C,A02,960048,Staff,23,0,30,7
1746590547337,MATH 10A,A01,889760,Staff,26,0,30,4
1746590547337,MATH 10A,A02,889783,Staff,29,0,30,1
1746590548369,MATH 10B,A01,889785,Verstraete; Jacques Allan,1,0,35,34
1746590548369,MATH 10B,A02,889795,Verstraete; Jacques Allan,4,0,35,31
1746590548369,MATH 10B,B01,889797,Verstraete; Jacques Allan,3,0,35,32
1746590548369,MATH 10B,B02,889828,Verstraete; Jacques Allan,3,0,35,32
1746590549395,MATH 10C,A01,889849,Habib; Yousaf,8,0,30,22
1746590549395,MATH 10C,A02,889852,Habib; Yousaf,14,0,30,16
1746590549395,MATH 10C,A03,889853,Habib; Yousaf,22,0,30,8
1746590549395,MATH 10C,A04,889858,Habib; Yousaf,20,0,30,10
1746590549395,MATH 10C,B01,889861,Staff,1,0,30,29
1746590549395,MATH 10C,B02,889862,Staff,24,0,30,6
1746590549395,MATH 10C,B03,889863,Staff,27,0,30,3
1746590549395,MATH 10C,B04,889967,Staff,23,0,30,7
1746590550426,MATH 18,A01,889974,Staff,7,0,30,23
1746590550426,MATH 18,A02,889977,Staff,20,0,30,10
1746590550426,MATH 18,B01,889984,Hardiman; Liam,20,0,30,10
1746590550426,MATH 18,B02,889985,Hardiman; Liam,25,0,30,5
1746590551455,MATH 20A,A01,889990,Suk; Andrew Hoon,30,0,35,5
1746590552481,MATH 20B,A01,889993,Ohm; Ko Woon,21,0,30,9
1746590552481,MATH 20B,A02,889994,Ohm; Ko Woon,30,0,30,0
1746590552481,MATH 20B,B01,889996,Ohm; Ko Woon,22,0,30,8
1746590552481,MATH 20B,B02,889997,Ohm; Ko Woon,23,0,30,7
1746590553507,MATH 20C,A01,889999,Hammock; Frances H,17,0,30,13
1746590553507,MATH 20C,A02,890003,Hammock; Frances H,23,0,30,7
1746590553507,MATH 20C,B01,890006,Hammock; Frances H,3,0,30,27
1746590553507,MATH 20C,B02,890007,Hammock; Frances H,12,0,30,18
1746590554533,MATH 20D,A01,890011,Cheng; Hsiao-Bing,1,1,30,29
1746590554533,MATH 20D,A02,890012,Cheng; Hsiao-Bing,14,0,30,16
1746590554533,MATH 20D,B01,890016,Cheng; Hsiao-Bing,13,0,30,17
1746590554533,MATH 20D,B02,890017,Cheng; Hsiao-Bing,13,0,30,17
1746590555564,MATH 20E,A01,890026,Harel; Guershon,1,0,30,29
1746590555564,MATH 20E,A02,890029,Harel; Guershon,22,0,30,8
1746590555564,MATH 20E,B01,890033,Harel; Guershon,7,0,30,23
1746590555564,MATH 20E,B02,890101,Harel; Guershon,21,0,30,9
1746590556590,MATH 102,A01,890104,Staff,18,0,30,12
1746590556590,MATH 102,A02,890105,Staff,27,0,30,3
1746590557621,MATH 103B,A01,890116,Salehi Golsefidy; Alireza,3,0,30,27
1746590557621,MATH 103B,B01,890118,Staff,0,3,34,34
1746590558652,MATH 109,A01,890121,Aliabadi Sr.; Mohsen,0,0,30,30
1746590558652,MATH 109,B01,890124,Upadrashta; Pranav Kumar,18,0,30,12
1746590559682,MATH 120A,A01,890126,Eggers; John Dietrich,13,0,30,17
1746590560711,MATH 142B,A01,890128,Ioana; Adrian,19,0,30,11
1746590560711,MATH 142B,A02,890129,Ioana; Adrian,12,0,30,18
1746590561736,MATH 154,A01,890174,Staff,0,1,30,30
1746590561736,MATH 154,A02,890182,Staff,0,0,30,30
1746590562760,MATH 168A,A01,890197,Dumitriu; Ioana,21,0,35,14
1746590563788,MATH 170A,A01,890240,Nie; Jiawang,1,0,30,29
1746590563788,MATH 170A,A02,890241,Nie; Jiawang,11,0,30,19
1746590563788,MATH 170A,A03,890249,Nie; Jiawang,23,0,30,7
1746590564813,MATH 170B,A01,957891,Nag; Panchali,13,0,35,22
1746590566863,MATH 181A,A01,908025,Staff,0,3,35,35
1746590566863,MATH 181A,A02,960115,Staff,26,0,35,9
1746590567889,MATH 181B,A01,959874,Staff,25,0,30,5
1746590568915,MATH 193B,A01,890265,Staff,0,4,35,35
1746590569940,MGT 4,A01,890311,Anderson; John Charles,42,0,88,46
1746590570965,MGT 5,A00,907740,Staff,12,0,98,86
1746590571996,MGT 12,A00,890312,Lindenberger; Wade Douglas,67,0,98,31
1746590573024,MGT 16,A00,957883,Staff,78,0,98,20
1746590575075,MGT 45,A00,890314,Pecore; Joseph P.,45,0,98,53
1746590576102,MGT 71,A00,890315,Staff,0,12,98,98
1746590577129,MGT 100,A00,890316,Yavorsky; Daniel Ryan,44,0,98,54
1746590578157,MGT 103,A00,890317,Ehrich; Kristine R,73,0,98,25
1746590579187,MGT 105,A00,890356,Bates; Kenneth Walter,0,8,98,98
1746590580211,MGT 112,A00,890360,Ehrich; Kristine R,55,0,98,43
1746590581237,MGT 127R,A00,907732,Zhu; Kevin Xiaoguo,23,0,98,75
1746590582265,MGT 131B,A00,890361,Anderson; John Charles,59,0,98,39
1746590583294,MGT 137,A00,890362,Lindenberger; Wade Douglas,65,0,98,33
1746590584321,MGT 160,A00,890369,Johnson; Erik Barry,9,0,98,89
1746590586375,MGT 164,A00,890372,Zimmermann; Carsten,0,40,98,98
1746590587404,MGT 180,A00,890374,Bliss; Barbara Ann,11,0,98,87
1746590588436,MMW 15,A01,886414,Chang; Edmond Yi-Teh,0,12,28,28
1746590588436,MMW 15,A02,886415,Chang; Edmond Yi-Teh,0,8,28,28
1746590588436,MMW 15,A03,886416,Chang; Edmond Yi-Teh,0,9,28,28
1746590588436,MMW 15,A04,886417,Chang; Edmond Yi-Teh,0,8,28,28
1746590588436,MMW 15,B01,886419,Chang; Edmond Yi-Teh,0,7,28,28
1746590588436,MMW 15,B02,886420,Chang; Edmond Yi-Teh,0,8,28,28
1746590588436,MMW 15,B03,886421,Chang; Edmond Yi-Teh,0,7,28,28
1746590588436,MMW 15,B04,886422,Chang; Edmond Yi-Teh,0,8,28,28
1746590588436,MMW 15,C01,886424,Staff,0,9,28,28
1746590588436,MMW 15,C02,886425,Staff,0,8,28,28
1746590588436,MMW 15,C03,886426,Staff,0,8,28,28
1746590588436,MMW 15,C04,886427,Staff,0,8,28,28
1746590588436,MMW 15,C05,958038,Staff,0,8,28,28
1746590588436,MMW 15,C06,958039,Staff,1,8,28,27
1746590589463,MMW 15GS,A00,906910,Patterson; Patrick H.,4,0,28,24
1746590590490,MMW 122R,A01,886429,Rahimi; Babak,0,13,28,28
1746590590490,MMW 122R,A02,886430,Rahimi; Babak,0,12,28,28
1746590590490,MMW 122R,A03,958040,Rahimi; Babak,0,11,28,28
1746590591516,MUS 1A,A01,890937,Staff,2,0,25,23
1746590591516,MUS 1A,A02,891035,Staff,6,0,25,19
1746590591516,MUS 1A,C01,958912,Staff,24,0,25,1
1746590591516,MUS 1A,C02,958913,Staff,25,0,25,0
1746590593572,MUS 2AK,A00,957092,Ohnishi; Takae,15,0,15,0
1746590594601,MUS 4,A01,891044,Staff,0,0,25,25
1746590594601,MUS 4,A02,891045,Staff,22,0,25,3
1746590594601,MUS 4,B01,891048,Staff,17,0,25,8
1746590594601,MUS 4,B02,891050,Staff,25,0,25,0
1746590595630,MUS 5,A01,957506,Dubnov; Shlomo,0,0,25,25
1746590595630,MUS 5,A02,957622,Dubnov; Shlomo,13,0,25,12
1746590595630,MUS 5,A03,957623,Dubnov; Shlomo,20,0,25,5
1746590596657,MUS 6,A01,891053,Freitas Caetano; Marcelo,24,0,25,1
1746590596657,MUS 6,A02,891054,Freitas Caetano; Marcelo,23,0,25,2
1746590597686,MUS 7,A01,891081,Staff,0,0,25,25
1746590597686,MUS 7,A02,891082,Staff,3,0,25,22
1746590598711,MUS 8GS,A00,891118,Borgo; David Garcia,1,0,25,24
1746590599736,MUS 11,A01,891140,Staff,9,0,25,16
1746590599736,MUS 11,A02,891141,Staff,21,0,25,4
1746590600761,MUS 13,A01,891143,Staff,8,0,25,17
1746590600761,MUS 13,A02,891144,Staff,24,0,25,1
1746590601793,MUS 15,A01,891146,Staff,9,0,25,16
1746590601793,MUS 15,A02,891148,Staff,21,0,25,4
1746590601793,MUS 15,B01,891150,Staff,18,0,25,7
1746590601793,MUS 15,B02,891151,Staff,25,0,25,0
1746590602820,MUS 20,A01,891153,Staff,5,0,20,15
1746590602820,MUS 20,A02,891155,Staff,14,0,20,6
1746590603844,MUS 80,A00,891156,Staff,19,0,25,6
1746590603844,MUS 80,B00,891157,Staff,23,0,25,2
1746590604888,MUS 130,A00,891158,Ohnishi; Takae,35,0,35,0
1746590605916,MUS 150GS,A01,891160,Borgo; David Garcia,1,0,25,24
1746590606945,MUS 170,A01,891162,Freitas Caetano; Marcelo,20,0,25,5
1746590606945,MUS 170,A02,891164,Freitas Caetano; Marcelo,21,0,25,4
1746590607970,NANO 11,A00,886220,Vazquez Mena; Oscar,13,0,15,2
1746590608999,NANO 15,A01,886222,Drews; Aaron,4,0,7,3
1746590610028,NANO 104,A00,886224,Sirbuly; Donald,17,0,25,8
1746590611054,PH 40,A00,886528,Staff,23,0,40,17
1746590612077,PH 45,A01,886799,Staff,35,0,40,5
1746590613105,PH 110,A00,886802,Staff,0,6,40,40
1746590614131,PH 172,A00,906716,Staff,19,0,35,16
1746590615160,PH 191,A00,886803,Staff,6,0,40,34
1746590616188,PHIL 1,A00,889500,Staff,20,0,30,10
1746590617213,PHIL 10,A01,889549,Grush; Rick Scott,16,0,22,6
1746590617213,PHIL 10,A02,889551,Grush; Rick Scott,22,0,22,0
1746590618240,PHIL 28,A01,889559,Lamey; Andy M.,0,2,31,31
1746590618240,PHIL 28,A02,889561,Lamey; Andy M.,0,1,30,30
1746590618240,PHIL 28,A03,889572,Lamey; Andy M.,0,1,30,30
1746590619268,PHIL 35,A00,907839,Staff,13,0,15,2
1746590620292,PHIL 60,A00,889574,Staff,73,0,90,17
1746590621321,PHIL 101,A00,958004,Staff,12,0,15,3
1746590623374,PHIL 136,A00,889582,Fulkerson; Matthew Todd,26,0,45,19
1746590624400,PHIL 163,A01,889601,Staff,21,0,30,9
1746590624400,PHIL 163,B01,889606,Brandt; Reuven A,0,3,0,0
1746590625425,PHIL 164,A00,889610,Staff,16,0,30,14
1746590626450,PHIL 165,A00,889613,Staff,22,0,30,8
1746590627475,PHYS 1A,A00,886431,Staff,30,0,70,40
1746590628500,PHYS 1AL,001,886432,Tsai; Philbert S,1,2,30,29
1746590628500,PHYS 1AL,002,886436,Tsai; Philbert S,13,0,30,17
1746590629526,PHYS 1B,A00,886439,Staff,184,0,240,56
1746590630556,PHYS 1BL,001,886441,Tsai; Philbert S,0,4,30,30
1746590630556,PHYS 1BL,002,886444,Tsai; Philbert S,2,0,30,28
1746590631586,PHYS 1C,A00,896092,Arnold; Kam S,78,0,146,68
1746590632613,PHYS 1CL,001,886448,Tsai; Philbert S,0,0,30,30
1746590632613,PHYS 1CL,002,886449,Tsai; Philbert S,1,0,30,29
1746590632613,PHYS 1CL,003,886450,Tsai; Philbert S,16,0,30,14
1746590632613,PHYS 1CL,004,886451,Tsai; Philbert S,15,0,30,15
1746590633643,PHYS 2B,A01,886457,Staff,67,0,115,48
1746590634672,PHYS 2C,A01,886460,Shotwell; Brian,0,9,65,65
1746590635698,PHYS 2CL,A01,886467,Staff,0,4,28,28
1746590635698,PHYS 2CL,A02,886468,Staff,0,3,28,28
1746590636729,PHYS 2D,A01,886470,Staff,10,0,50,40
1746590637754,PHYS 4B,A01,886475,Grinstein; Benjamin,22,0,40,18
1746590638781,POLI 5,A00,891173,Desposato; Scott,7,0,25,18
1746590639806,POLI 5D,A01,891175,Staff,5,0,5,0
1746590639806,POLI 5D,B01,891178,Staff,5,0,5,0
1746590640835,POLI 11,A00,891179,Ferree; Karen E,2,0,35,33
1746590641863,POLI 12,A00,891180,Staff,16,0,30,14
1746590642893,POLI 27,A01,891182,Staff,12,0,75,63
1746590643920,POLI 30,A00,891183,Staff,8,0,50,42
1746590644947,POLI 100B,A00,891244,Staff,5,1,35,30
1746590645976,POLI 100I,A00,891247,Staff,7,0,30,23
1746590647001,POLI 104J,A00,891248,Nichter; Maysa,14,0,30,16
1746590648026,POLI 104U,A00,891250,Nichter; Maysa,1,0,30,29
1746590650077,POLI 110B,A00,891255,Wiens; David,19,0,25,6
1746590651102,POLI 112A,A00,891256,Wiens; David,6,0,25,19
1746590652127,POLI 114BR,A00,891261,Staff,19,0,30,11
1746590653152,POLI 117R,A00,891262,Forman; Fonna,0,6,50,50
1746590654177,POLI 118,A00,891264,Ingham; Sean,17,0,25,8
1746590655208,POLI 124A,A00,891265,Staff,18,0,20,2
1746590656233,POLI 125D,A00,891266,Nichter; Simeon C,2,0,25,23
1746590657259,POLI 126,A00,891268,Nichter; Simeon C,7,0,25,18
1746590658288,POLI 126AA,A00,891272,Staff,15,0,25,10
1746590659317,POLI 130AA,A00,891273,Staff,15,0,20,5
1746590660341,POLI 134AA,A00,891274,Staff,4,0,20,16
1746590662394,POLI 138,A00,891278,Staff,21,0,25,4
1746590663421,POLI 142K,A00,891280,Staff,10,0,25,15
1746590664450,POLI 142M,A00,891281,Gartzke; Erik,16,0,30,14
1746590665475,POLI 142P,A00,891284,Staff,20,0,30,10
1746590666502,POLI 143,A00,891285,Gartzke; Erik,12,0,30,18
1746590667528,POLI 153,A00,891286,Staff,19,0,20,1
1746590669581,POLI 175,A00,891290,Staff,15,0,20,5
1746590670611,PSYC 1,A00,890674,Steiner; Eric Tomas,0,11,45,45
1746590671638,PSYC 2,A00,890676,Albright; Thomas D,20,0,35,15
1746590672664,PSYC 3,A00,890679,Staff,17,0,20,3
1746590673696,PSYC 6,A00,959858,Staff,19,0,20,1
1746590674724,PSYC 60,A01,890684,Rickard; Timothy C.,0,6,45,45
1746590675750,PSYC 70,A01,890689,Geller; Emma Harlan,6,0,30,24
1746590676779,PSYC 71,A01,959860,Staff,21,0,25,4
1746590677808,PSYC 100,A00,890690,Lacefield; Katharine I,0,50,180,180
1746590678838,PSYC 102,A00,890695,Staff,18,0,40,22
1746590679865,PSYC 105,A00,890699,Geller; Emma Harlan,70,0,100,30
1746590680904,PSYC 106,A00,890701,Gorman; Michael R.,5,0,30,25
1746590681933,PSYC 108,A00,890704,Adrian; Julia Anna,0,29,50,50
1746590682958,PSYC 118,A01,890712,Staff,11,0,30,19
1746590683982,PSYC 124,A00,890716,Chapman; Eddie Nathaniel,25,0,60,35
1746590685010,PSYC 131,A00,890717,Anagnostaras; Stephan,0,7,80,80
1746590686036,PSYC 137,A00,890719,Winkielman; Piotr,0,11,30,30
1746590687064,PSYC 144,A00,890721,Adrian; Julia Anna,0,9,45,45
1746590688091,PSYC 162,A00,890805,Staff,0,1,75,75
1746590689117,PSYC 169,A00,890810,Staff,0,15,30,30
1746590690141,PSYC 172,A00,890814,Gorman; Michael R.,9,0,30,21
1746590691169,PSYC 181,A00,890818,Anagnostaras; Stephan,7,0,200,193
1746590692196,PSYC 184,A00,959861,Staff,163,0,175,12
1746590693220,PSYC 189,A00,890823,Staff,0,2,30,30
1746590694245,PSYC 191,A00,890884,Rickard; Timothy C.,0,12,35,35
1746590695270,PSYC 193,A00,890913,Staff,19,0,30,11
1746590695270,PSYC 193,B00,890914,Chapman; Eddie Nathaniel,24,0,30,6
1746590696298,PSYC 193L,A01,890918,Lowe; Angela Beth,20,0,30,10
1746590696298,PSYC 193L,B01,890921,Hurwitz; Ethan Scott,20,0,30,10
1746590696298,PSYC 193L,C01,890928,Staff,30,0,30,0
1746590697327,RELI 149,A00,886806,Rahimi; Babak,23,0,40,17
1746590698354,SE 9,A01,886814,Staff,7,0,20,13
1746590699385,SE 101B,A01,886816,Chadha; Mayank,3,0,35,32
1746590700414,SE 110B,A00,886818,Zhu; Qiang,4,0,75,71
1746590701438,SE 125,A01,886830,Staff,10,0,30,20
1746590702464,SE 130B,A01,886835,Staff,14,0,40,26
1746590703490,SE 131A,A01,886838,Krysl; Petr,34,0,55,21
1746590704517,SE 154,A00,886840,Staff,28,0,50,22
1746590705547,SE 164GS,A01,886849,Staff,6,0,20,14
1746590706575,SE 167GS,A01,886853,Staff,6,0,20,14
1746590707605,SIO 25,A01,890107,Staff,19,0,30,11
1746590708631,SIO 45,A00,890109,Cook; Geoffrey W,116,0,200,84
1746590709660,SIO 109R,A00,890110,Forman; Fonna,0,16,20,20
1746590710685,SIO 187,A01,890114,Kacev; David,15,0,40,25
1746590711712,SOCI 1,A01,890431,Thorpe; Charles Robert,14,0,30,16
1746590711712,SOCI 1,A02,890518,Thorpe; Charles Robert,30,0,30,0
1746590712740,SOCI 2,A01,957978,Staff,25,0,25,0
1746590712740,SOCI 2,A02,957979,Staff,23,0,25,2
1746590713767,SOCI 20,A01,890523,Calderon-Zaks; Michael Aar,21,0,30,9
1746590713767,SOCI 20,A02,890526,Calderon-Zaks; Michael Aar,29,0,30,1
1746590714793,SOCI 30,A01,890533,Pardo Guerra; Juan Pablo,37,0,40,3
1746590715821,SOCI 40,A01,890535,Staff,27,0,45,18
1746590716851,SOCI 104Q,A00,890559,Staff,18,0,30,12
1746590717876,SOCI 106,A00,890560,Arnal; Maud Marie Leonie,20,0,30,10
1746590718900,SOCI 110,A00,890567,Holkenbrink-Monk; Charlene,19,0,30,11
1746590719929,SOCI 112,A00,890568,Victoria Torres; Pablo,2,0,55,53
1746590720957,SOCI 115,A00,890597,Arnal; Maud Marie Leonie,28,0,45,17
1746590723010,SOCI 121,A00,890604,Pardo Guerra; Juan Pablo,38,0,45,7
1746590724034,SOCI 126,A01,890608,Staff,8,0,10,2
1746590725062,SOCI 127,A00,890609,Staff,18,0,30,12
1746590726085,SOCI 131,A00,890610,Thorpe; Charles Robert,37,0,45,8
1746590727110,SOCI 135,A00,890615,Payne; Christine Anna,14,0,45,31
1746590728135,SOCI 139,A00,890620,Staff,38,0,45,7
1746590729164,SOCI 148E,A00,890622,Calderon-Zaks; Michael Aar,36,0,45,9
1746590730190,SOCI 150,A00,890623,Kohler; Kristopher M.,31,0,45,14
1746590731216,SOCI 157,A00,890625,Jules-Rosette; Bennetta W.,18,0,20,2
1746590732244,SOCI 160,A00,890627,Payne; Christine Anna,21,0,45,24
1746590733269,SYN 1,A00,886855,Fish; Gwendolyn Anne,0,1,0,0
1746590733269,SYN 1,B00,906086,Fish; Gwendolyn Anne,0,2,0,2
1746590734294,SYN 2R,A00,886860,Staff,0,17,15,15
1746590734294,SYN 2R,B00,906106,Atkinson; Arthur Laird,0,16,15,15
1746590735326,SYN 100,A01,886866,Browne; Emily,0,28,20,20
1746590735326,SYN 100,B01,906128,Rock; Martin,0,4,20,20
1746590735326,SYN 100,C01,906140,Deavenport; James Cary,0,4,20,20
1746590735326,SYN 100,D01,907816,Deavenport; James Cary,0,5,20,20
1746590736353,TDAC 1,A00,890286,Walsh; Kim C.,7,0,20,13
1746590737380,TDAC 101,A00,890296,Basso; Beatrice,15,0,20,5
1746590738405,TDDE 131,A00,890297,Staff,47,0,50,3
1746590739434,TDDM 1,A00,890287,Weinberg; Sadie,25,0,30,5
1746590740460,TDGE 11,A00,890288,Fulton; Julia,138,0,200,62
1746590740460,TDGE 11,B00,890289,Castro; Robert Jess,185,0,200,15
1746590741489,TDGE 25,B00,957359,Walsh; Kim C.,5,0,20,15
1746590742515,TDGE 40,A01,890292,Power; Jade Yukana,26,0,30,4
1746590743545,TDGE 124,A00,890298,Havis; Allan,0,2,50,50
1746590744571,TDGE 131R,A00,890299,Burelle; Julie Sara Veronique,15,0,42,27
1746590745601,TDHT 101,A00,890300,Staff,10,0,20,10
1746590746626,TDHT 109,A01,890302,Anderson; Mysia Anyse,31,0,40,9
1746590747651,TDMV 1,A00,890293,Arcidiacono; Kristin,18,0,30,12
1746590748678,TDMV 2,A00,890294,Weinberg; Sadie,23,0,30,7
1746590749705,TDMV 3,A00,957878,Arcidiacono; Kristin,28,0,30,2
1746590751818,TDMV 138,A00,890304,Jun; Grace Shin Hae,25,0,40,15
1746590752841,TDMV 140,A00,890305,Corrales; Joseph Bernales,25,0,30,5
1746590753870,TDMV 142,A00,890307,Caligagan; Tony,32,0,40,8
1746590754894,TDMV 144,A00,890308,Camaya; Michelle Ann,25,0,30,5
1746590755919,TDPW 1,A00,890295,Stein; Deborah Isobel,3,0,20,17
1746590756947,USP 2,A01,890272,Lerner; Amy M,7,0,20,13
1746590757973,USP 3,A01,890274,Staff,12,0,30,18
1746590758998,USP 15,A01,890276,Sun; Feiyang,16,0,30,14
1746590760031,USP 25,A00,890277,Shenkman; Michael Thomas,18,0,25,7
1746590761056,USP 138,A00,890278,Staff,13,0,25,12
1746590762082,USP 143,A00,890279,Staff,22,0,70,48
1746590763111,USP 144,A00,890280,Chowdhury; Muhammed Zohir,16,0,30,14
1746590764135,USP 150,A00,890281,Boomhower; Matthew Charles,4,0,30,26
1746590765161,USP 151,A00,890282,Staff,16,0,20,4
1746590766188,USP 162,A00,890283,Andrews; Abigail Leslie,16,0,20,4
1746590767215,USP 168,A00,920477,Kwak; Nancy,0,0,5,5
1746590768242,USP 181,A00,890284,Staff,3,0,20,17
1746590769268,USP 191A,A00,890285,Staff,12,0,20,8
1746590770295,VIS 101,A00,886512,Staff,26,0,75,49
1746590771320,VIS 103,A00,886513,Cruz; Edwin Teddy,61,0,75,14
1746590772348,VIS 108,A00,886514,Staff,3,0,15,12
1746590773373,VIS 127P,A00,886515,Shen; Kuiyi,79,0,146,67
1746590774397,VIS 149,A00,886516,Yoldas; Pinar,0,0,15,15
1746590775423,VIS 164,A00,886526,Erdmann; Dean,19,0,22,3
1746590776456,VIS 194S,A00,886527,Staff,61,0,75,14
1746590777484,WCWP 10A,C00,886484,Martiniuk; Jill,12,0,15,3
1746590778509,WCWP 10B,A00,886490,Uriarte; Emma,0,0,15,15
1746590778509,WCWP 10B,B00,886491,Dhir; Simrita,8,0,15,7
1746590778509,WCWP 10B,C00,886492,Ornelas; Tricia,0,0,15,15
1746590779536,WCWP 100,A00,886494,Young; Mark T,0,6,15,15
1746590781628,AAS 10,A01,886199,Childs; Dennis R.,0,3,0,0
1746590782656,ANAR 104,A01,886940,Shtienberg; Gilad,27,0,30,3
1746590783681,ANAR 120,A00,886953,Staff,13,0,20,7
1746590784707,ANBI 148,A01,886955,Wilder; Linnea Lorene,30,0,40,10
1746590786761,ANSC 122,A00,886957,Staff,24,0,30,6
1746590787790,ANSC 150,A00,886958,Sloane; Julia Kathryn,2,0,15,13
1746590788818,ANSC 156,A00,886959,Jenkins; Janis A.,0,1,15,15
1746590789845,ANSC 180,A00,886960,Staff,11,0,17,6
1746590790870,ANSC 188,A00,886961,Jassal; Aftab,9,0,25,16
1746590791896,ANSC 190,A00,886962,Jassal; Aftab,14,0,25,11
1746590792922,ANSC 191,A00,886963,Staff,18,0,20,2
1746590793952,ANTH 3,A01,891689,Staff,17,0,20,3
1746590794979,ANTH 5,A00,886933,Semendeferi; Ekaterini,16,0,20,4
1746590796010,ANTH 10,A00,886934,Staff,0,12,30,30
1746590797036,ANTH 21,A01,886936,Staff,41,0,60,19
1746590798060,ANTH 23,A01,886938,Staff,92,0,100,8
1746590799091,ANTH 105,A00,886964,Stewart; Alexander B,84,0,100,16
1746590800122,ANTH 108,A00,886965,Pedersen; David,9,0,20,11
1746590801149,AWP 10,001,886147,Staff,0,0,0,0
1746590801149,AWP 10,002,886148,Staff,0,0,0,0
1746590801149,AWP 10,003,886149,Staff,0,0,0,0
1746590801149,AWP 10,004,886150,Staff,0,0,0,0
1746590801149,AWP 10,005,886151,Staff,0,0,0,0
1746590801149,AWP 10,006,886152,Staff,0,0,0,0
1746590801149,AWP 10,007,886153,Staff,0,0,0,0
1746590801149,AWP 10,008,886154,Staff,0,0,0,0
1746590801149,AWP 10,009,886155,Staff,0,0,0,0
1746590801149,AWP 10,010,886156,Staff,0,0,0,0
1746590801149,AWP 10,011,886158,Staff,0,0,0,0
1746590801149,AWP 10,012,886160,Staff,0,0,0,0
1746590801149,AWP 10,013,886161,Staff,0,0,0,0
1746590801149,AWP 10,014,886162,Staff,0,0,0,0
1746590801149,AWP 10,015,886163,Staff,0,0,0,0
1746590801149,AWP 10,016,886164,Staff,0,0,0,0
1746590801149,AWP 10,017,886165,Staff,0,0,0,0
1746590801149,AWP 10,018,886166,Staff,0,0,0,0
1746590801149,AWP 10,019,886168,Staff,0,0,0,0
1746590801149,AWP 10,020,886170,Staff,0,0,0,0
1746590801149,AWP 10,021,886172,Staff,0,0,0,0
1746590802183,AWP 10R,001,886173,Staff,0,1,0,0
1746590802183,AWP 10R,002,886174,Staff,0,1,0,0
1746590802183,AWP 10R,003,886175,Staff,0,0,0,0
1746590802183,AWP 10R,004,886176,Staff,0,0,0,0
1746590802183,AWP 10R,005,886177,Staff,0,0,0,0
1746590802183,AWP 10R,006,886178,Staff,0,0,0,0
1746590802183,AWP 10R,007,886179,Staff,0,0,0,0
1746590802183,AWP 10R,008,886181,Staff,0,0,0,0
1746590802183,AWP 10R,009,886182,Staff,0,0,0,0
1746590802183,AWP 10R,010,886183,Staff,0,0,0,0
1746590802183,AWP 10R,011,886184,Staff,0,0,0,0
1746590802183,AWP 10R,012,886185,Staff,0,0,0,0
1746590802183,AWP 10R,013,886186,Staff,0,0,0,0
1746590802183,AWP 10R,014,886187,Staff,0,0,0,0
1746590802183,AWP 10R,015,886188,Staff,0,0,0,0
1746590802183,AWP 10R,016,886189,Staff,0,0,0,0
1746590802183,AWP 10R,017,960532,Staff,0,0,0,0
1746590802183,AWP 10R,018,960533,Staff,0,0,0,0
1746590802183,AWP 10R,019,960534,Staff,0,0,0,0
1746590802183,AWP 10R,020,960538,Staff,0,0,0,0
1746590802183,AWP 10R,021,960540,Staff,0,0,0,0
1746590802183,AWP 10R,022,960541,Staff,0,0,0,0
1746590802183,AWP 10R,023,960542,Staff,0,0,0,0
1746590802183,AWP 10R,024,960544,Staff,0,0,0,0
1746590802183,AWP 10R,025,960545,Staff,0,0,0,0
1746590802183,AWP 10R,026,960548,Staff,0,0,0,0
1746590803207,AWP 102R,A00,886190,Staff,0,0,0,0
1746590803207,AWP 102R,B00,886191,Staff,0,0,0,0
1746590804237,BENG 100,A01,886193,Staff,17,0,30,13
1746590805261,BENG 122A,A01,886195,Hasty; Jeff M,13,0,30,17
1746590806287,BENG 166A,A00,886196,Sah; Robert Lie-Yuan,0,3,30,30
1746590807311,BENG 190,A00,958050,Khojah; Reem I,17,0,25,8
1746590808339,BIBC 102,A01,894320,Staff,0,0,46,46
1746590808339,BIBC 102,A02,894321,Staff,0,0,46,46
1746590808339,BIBC 102,A03,894344,Staff,6,0,46,40
1746590808339,BIBC 102,A04,894345,Staff,27,0,47,20
1746590809370,BICD 100R,A01,894365,Smith; Laurie,1,3,58,57
1746590809370,BICD 100R,A02,894366,Smith; Laurie,1,5,58,57
1746590809370,BICD 100R,A03,894367,Smith; Laurie,0,0,59,59
1746590809370,BICD 100R,A04,959869,Smith; Laurie,39,0,59,20
1746590810397,BICD 136,A01,894383,Gustafson-Brown; Cindy,14,0,50,36
1746590811423,BIEB 102,A01,894494,Butler; Shannon Rhey,51,0,130,79
1746590813520,BIEB 150,A01,894617,Wills; Christopher,3,0,20,17
1746590813520,BIEB 150,A02,894631,Wills; Christopher,3,0,20,17
1746590813520,BIEB 150,A03,894937,Wills; Christopher,3,0,20,17
1746590813520,BIEB 150,A04,894946,Wills; Christopher,5,0,20,15
1746590814546,BIEB 194,A00,906141,Kurle; Carolyn M.,5,0,20,15
1746590815577,BILD 1,A01,894154,Staff,3,0,19,16
1746590815577,BILD 1,A02,894155,Staff,14,0,19,5
1746590815577,BILD 1,A03,894160,Staff,13,0,19,6
1746590815577,BILD 1,A04,894161,Staff,15,0,18,3
1746590816603,BILD 2,A01,894168,Staff,0,0,50,50
1746590816603,BILD 2,A02,894169,Staff,0,0,50,50
1746590816603,BILD 2,A03,894179,Staff,0,0,50,50
1746590816603,BILD 2,A04,894203,Staff,23,0,50,27
1746590817628,BILD 3,A01,894213,Staff,23,0,31,8
1746590817628,BILD 3,A02,894214,Staff,26,0,31,5
1746590817628,BILD 3,A03,894235,Staff,28,0,31,3
1746590817628,BILD 3,A04,894236,Staff,28,0,32,4
1746590818655,BILD 4,A01,894253,Reuther; Keefe,5,0,24,19
1746590818655,BILD 4,A02,894258,Reuther; Keefe,16,0,24,8
1746590819685,BILD 5,A01,894276,Reuther; Keefe,34,0,50,16
1746590819685,BILD 5,A02,894277,Reuther; Keefe,45,0,50,5
1746590819685,BILD 5,A03,894290,Reuther; Keefe,44,0,50,6
1746590819685,BILD 5,A04,894291,Reuther; Keefe,48,0,50,2
1746590820710,BILD 24,A01,894297,Pirino; Giorgia,40,0,60,20
1746590821738,BIMM 100,B01,958915,Staff,71,0,100,29
1746590822767,BIMM 101,A01,895017,McDonnell; Lisa Marie,0,5,24,24
1746590822767,BIMM 101,A02,895018,McDonnell; Lisa Marie,0,5,24,24
1746590822767,BIMM 101,B01,895020,McDonnell; Lisa Marie,1,6,24,23
1746590822767,BIMM 101,B02,895021,McDonnell; Lisa Marie,0,4,24,24
1746590823796,BIMM 110,A01,895023,Staff,1,0,25,24
1746590823796,BIMM 110,A02,895024,Staff,9,0,25,16
1746590823796,BIMM 110,A03,895025,Staff,18,0,25,7
1746590823796,BIMM 110,A04,895031,Staff,20,0,25,5
1746590824821,BIMM 120,A01,895114,Gustafson-Brown; Cindy,14,0,28,14
1746590824821,BIMM 120,A02,895126,Gustafson-Brown; Cindy,21,0,27,6
1746590825847,BIPN 100,A01,895130,Yang; Mingyu,0,0,38,38
1746590825847,BIPN 100,A02,895131,Yang; Mingyu,31,0,38,7
1746590825847,BIPN 100,A03,895132,Yang; Mingyu,32,0,38,6
1746590825847,BIPN 100,A04,895133,Yang; Mingyu,27,0,36,9
1746590826871,BIPN 120,A01,895135,Cooke; James Edward,0,3,13,13
1746590826871,BIPN 120,A02,895136,Cooke; James Edward,0,1,13,13
1746590826871,BIPN 120,A03,895137,Cooke; James Edward,0,3,13,13
1746590826871,BIPN 120,A04,895156,Cooke; James Edward,0,2,11,11
1746590827896,BIPN 134,A01,895235,Cooke; James Edward,0,1,25,25
1746590827896,BIPN 134,A02,895237,Cooke; James Edward,0,0,25,25
1746590827896,BIPN 134,A03,895240,Cooke; James Edward,2,0,25,23
1746590827896,BIPN 134,A04,895270,Cooke; James Edward,20,0,25,5
1746590828923,BIPN 189,A00,892103,Staff,0,14,14,14
1746590830976,BISP 194,A00,958008,Staff,0,2,0,0
1746590832002,CAT 124,A01,922009,Staff,0,5,20,20
1746590833027,CAT 125R,A00,886390,Morales; Celeste Georgianna,0,3,20,20
1746590833027,CAT 125R,B00,886391,Irwin; Matthew Joseph,0,4,20,20
1746590833027,CAT 125R,C00,886392,Smith; Lauryn Alissa,0,2,20,20
1746590833027,CAT 125R,D00,886393,Vanderschuit; Maya Alysia,0,3,20,20
1746590833027,CAT 125R,E00,886394,Marchisotto; Jennifer Anne,0,3,20,20
1746590834056,CENG 15,A01,886218,Drews; Aaron,3,0,8,5
1746590835080,CENG 113,A00,886219,Opatkiewicz; Justin Paul,15,0,25,10
1746590836105,CGS 101,A00,887044,Staff,7,0,20,13
1746590837134,CGS 105,A01,887046,Staff,14,0,25,11
1746590838162,CGS 112,A00,887047,Cuong; Marisol,12,0,15,3
1746590839187,CGS 113,A00,887048,Staff,23,0,30,7
1746590840215,CGS 120,A00,887049,Staff,10,0,17,7
1746590841270,CHEM 6A,A01,886336,Lam; Tin Yiu,38,0,50,12
1746590841270,CHEM 6A,A02,886338,Lam; Tin Yiu,37,0,50,13
1746590842296,CHEM 6B,A01,886341,Hopkins; Patrycja Anna,16,0,50,34
1746590842296,CHEM 6B,A02,886343,Hopkins; Patrycja Anna,42,0,50,8
1746590843325,CHEM 6C,A01,886346,Albizati; Kim F.,0,2,50,50
1746590843325,CHEM 6C,A02,886348,Albizati; Kim F.,24,0,50,26
1746590844351,CHEM 40A,A01,886352,Klosterman; Jeremy K,65,0,100,35
1746590845382,CHEM 40B,A01,886356,Klosterman; Jeremy K,0,24,100,100
1746590846407,CHEM 41B,A01,886360,Theodorakis; Emmanuel,25,0,50,25
1746590846407,CHEM 41B,A02,886362,Theodorakis; Emmanuel,47,0,50,3
1746590847436,CHIN 165A,A00,886382,Xu; Li,18,0,20,2
1746590848462,CLAS 120,A00,886387,Myerston Santana; Jacobo,33,0,40,7
1746590849489,COGS 9,A01,886967,Shannon; Kyle Michael,42,0,60,18
1746590850517,COGS 11,A01,886969,Staff,9,0,30,21
1746590851543,COGS 14A,A01,886971,Staff,5,0,60,55
1746590852569,COGS 14B,A01,886973,Hoffman; Drew Ellen,4,0,60,56
1746590853594,COGS 18,A01,886975,Morgan; Eric,34,0,60,26
1746590854620,COGS 20,A01,886977,Staff,2,0,8,6
1746590854620,COGS 20,A02,886978,Staff,4,0,7,3
1746590855645,COGS 100,A01,907783,Staff,1,2,30,29
1746590856674,COGS 101B,A01,886980,Staff,0,4,48,48
1746590857701,COGS 101C,A01,886982,Delgado; Tania,0,5,44,44
1746590858728,COGS 102A,A01,886984,Johnson; Christine M.,3,0,30,27
1746590859755,COGS 118B,A01,886986,Staff,1,5,88,87
1746590860783,COGS 150,A01,886988,Bergen; Benjamin,22,0,50,28
1746590861809,COGS 153,A00,886989,Delgado; Tania,0,3,41,41
1746590862836,COGS 186,A01,886991,Staff,0,0,32,32
1746590863863,COGS 187A,A01,886993,Boyle; Mary E. T.,7,0,30,23
1746590864888,COGS 189,A00,886994,Staff,0,1,30,30
1746590865913,COMM 10,A01,886996,Staff,0,0,20,21
1746590865913,COMM 10,A02,886997,Staff,10,0,20,10
1746590865913,COMM 10,A03,959845,Staff,19,0,20,1
1746590866937,COMM 20,A01,886999,Leuning; Grant Maurstad,24,0,40,16
1746590868987,COMM 100A,A01,887002,Staff,0,0,20,25
1746590868987,COMM 100A,A02,887003,Staff,6,0,20,14
1746590870018,COMM 100B,A01,887005,Staff,0,8,20,24
1746590871049,COMM 106D,A00,887006,Staff,13,0,40,27
1746590872143,COMM 110G,A00,887007,Whitworth-Smith; Andrew C,12,0,40,28
1746590873169,COMM 111B,A00,887008,Staff,31,0,40,9
1746590874195,COMM 113T,A00,887009,Abuelhiga; Soraya Jill,28,0,40,12
1746590874195,COMM 113T,B00,906733,Staff,40,0,40,0
1746590875226,COMM 145,A00,887010,Staff,12,0,40,28
1746590876254,COMM 146,A00,887054,Staff,31,0,40,9
1746590877279,COMM 190,A00,887012,Staff,8,0,23,15
1746590878308,CSE 8A,A50,887015,Cao; Yingjun,56,0,85,29
1746590879332,CSE 11,A01,887017,Cao; Yingjun,11,0,70,59
1746590880359,CSE 20,A01,887019,Staff,30,0,50,20
1746590881385,CSE 21,A01,887021,Staff,78,0,100,22
1746590881385,CSE 21,B01,892583,Braun; Oliver,45,0,50,5
1746590882428,CSE 30,A01,887025,Eldon; John,142,0,200,58
1746590883455,CSE 100,A01,887027,Staff,26,0,50,24
1746590883455,CSE 100,A02,887028,Staff,42,0,50,8
1746590884478,CSE 101,A01,887030,Braun; Oliver,74,0,100,26
1746590884478,CSE 101,B01,887032,Jones; Miles E,0,3,50,50
1746590884478,CSE 101,B02,887033,Jones; Miles E,0,2,50,50
1746590885504,CSE 105,A01,908084,Jones; Miles E,32,0,50,18
1746590885504,CSE 105,A02,908087,Jones; Miles E,31,0,50,19
1746590886529,CSE 135,A01,887035,Powell; Thomas Allan,0,5,50,50
1746590887553,CSE 142,A01,887037,Staff,8,0,60,52
1746590888580,CSE 142L,A01,887039,Staff,34,0,60,26
1746590889605,CSE 151A,A01,887041,Solares; Edwin A,47,0,100,53
1746590890635,CSE 175,A01,887043,Kumar; Rakesh,30,0,30,0
1746590891663,CSS 1,A01,886389,Staff,1,2,40,39
1746590892692,DSC 30,A01,908097,Liao; Soohyun Nam,47,0,75,28
1746590893716,DSC 40A,A01,908099,Shannon; Kyle Michael,30,0,50,20
1746590894745,DSC 40B,A01,908112,Staff,15,0,50,35
1746590895770,DSC 80,A01,908116,Staff,19,0,60,41
1746590896798,DSC 197,001,956863,Eldridge; Justin Matthew,9999,0,9999,0
1746590897824,ECE 5,A01,886400,Morris; Karcher William,1,0,6,5
1746590897824,ECE 5,A02,886401,Morris; Karcher William,3,0,6,3
1746590898871,ECE 148,A01,886403,Silberman; Jack,0,14,14,14
1746590899904,ECON 1,A01,887265,Crane; Meredith Helen,11,0,70,59
1746590899904,ECON 1,B01,887268,Staff,42,0,50,8
1746590900930,ECON 2,A01,887273,Crane; Meredith Helen,54,0,70,16
1746590901958,ECON 3,A01,887279,Rondina; Giacomo,31,0,70,39
1746590902983,ECON 4,A01,887282,Anderson; John Charles,0,2,10,10
1746590904010,ECON 5,A01,887285,Staff,34,0,45,11
1746590904010,ECON 5,B01,887292,Staff,41,0,45,4
1746590905035,ECON 100A,A01,887337,Newhouse; Herbert S,54,0,70,16
1746590905035,ECON 100A,B01,887349,Staff,45,0,50,5
1746590906064,ECON 100B,A01,887361,Du; Songzi,29,0,70,41
1746590907090,ECON 100C,A01,887445,Newhouse; Herbert S,59,0,70,11
1746590908114,ECON 105,A00,887488,Vespa; Emanuel Ignacio,23,0,35,12
1746590909139,ECON 109,A01,887506,Shishkin; Denis,28,0,35,7
1746590910170,ECON 110A,A01,887568,Alon; Titan Michael,1,3,35,34
1746590910170,ECON 110A,B01,907601,Alon; Titan Michael,20,0,35,15
1746590911196,ECON 110B,A01,887598,Levkoff; Steven B.,0,24,70,70
1746590912224,ECON 112,A00,887599,Rondina; Giacomo,19,0,35,16
1746590913252,ECON 120A,A01,887603,Dai; Yinlin,35,0,70,35
1746590914281,ECON 120C,A01,887608,Sun; Yixiao,0,1,35,35
1746590914281,ECON 120C,B01,887614,Sun; Yixiao,0,0,35,35
1746590915311,ECON 138,A00,887621,Bharadwaj; Prashant,0,21,20,20
1746590916339,ECON 144,A00,958007,Squires; Dale E,12,0,35,23
1746590917364,ECON 171,A01,907666,Staff,18,0,35,17
1746590918388,ECON 175,A00,887626,Wu; Pak Yeung,22,0,35,13
1746590919413,ECON 190,A00,887640,Vespa; Emanuel Ignacio,22,0,35,13
1746590920442,EDS 25,A01,888197,Staff,0,0,0,0
1746590920442,EDS 25,A02,888209,Staff,0,0,0,0
1746590920442,EDS 25,A03,888210,Staff,0,0,0,0
1746590920442,EDS 25,A04,888212,Staff,0,0,0,0
1746590920442,EDS 25,A05,888213,Staff,0,0,0,0
1746590920442,EDS 25,A06,888214,Staff,0,0,0,0
1746590920442,EDS 25,A07,888235,Staff,0,2,0,0
1746590920442,EDS 25,A08,888236,Staff,0,0,0,0
1746590920442,EDS 25,A09,888240,Staff,0,0,0,0
1746590920442,EDS 25,A10,888244,Staff,0,0,0,0
1746590920442,EDS 25,B01,888273,Staff,0,0,0,0
1746590920442,EDS 25,B02,888285,Staff,0,0,0,0
1746590920442,EDS 25,B03,888423,Staff,0,0,0,1
1746590920442,EDS 25,B04,888432,Staff,0,0,0,0
1746590920442,EDS 25,B05,888433,Staff,0,0,0,0
1746590920442,EDS 25,B06,888467,Staff,0,0,0,0
1746590920442,EDS 25,B07,888468,Staff,0,0,0,0
1746590920442,EDS 25,B08,888479,Staff,0,0,0,0
1746590920442,EDS 25,B09,888484,Staff,0,0,0,0
1746590920442,EDS 25,B10,888487,Staff,0,0,0,0
1746590921472,EDS 38,A01,907700,Choi; Bailey Miyeon,30,0,30,0
1746590922497,EDS 112,A01,888601,Chapman; Thandeka K,12,0,40,28
1746590923522,EDS 115,A00,888697,Mendez; Kathrina Mendoza,10,0,30,20
1746590924552,EDS 116,A01,888893,Staff,33,0,40,7
1746590926607,EDS 124AR,A00,889133,Staff,29,0,50,21
1746590926607,EDS 124AR,B00,907471,Simon; Elizabeth A,37,0,50,13
1746590927636,EDS 124BR,A00,889134,Simon; Elizabeth A,44,0,100,56
1746590928662,EDS 125,A00,889135,Staff,25,0,30,5
1746590929687,EDS 126,A01,889138,Staff,35,0,40,5
1746590930716,EDS 164R,A01,889142,Wishard Guerra; Alison G.,32,0,50,18
1746590931741,ENG 30,A01,886396,Staff,0,0,0,0
1746590931741,ENG 30,B01,886398,Staff,0,0,0,0
1746590932769,ENVR 102,A00,906150,Montejo; Carolina,23,0,25,2
1746590933798,ETHN 103A,A00,887236,Man; Simeon S,0,2,0,0
1746590934827,ETHN 113,A00,887239,Staff,16,0,30,14
1746590935857,ETHN 116,A00,887240,Staff,16,0,25,9
1746590936886,ETHN 117,A00,887241,Choi; Esther Min,28,0,30,2
1746590937915,ETHN 118,A00,887243,Staff,24,0,30,6
1746590938944,ETHN 127,A00,887248,Cuong; Marisol,11,0,15,4
1746590939970,ETHN 139,A00,887250,Staff,7,0,10,3
1746590941002,ETHN 142,A00,887252,Staff,10,0,30,20
1746590942030,ETHN 161,A00,887253,Browne; Errol Tsekani,24,0,30,6
1746590943057,ETHN 163FR,A00,887255,Burelle; Julie Sara Veronique,0,0,5,5
1746590944084,GLBH 20,A00,889149,Elwardani; Nile Regina,8,0,42,34
1746590946144,GLBH 111,A01,889152,Burgos; Jose L.,17,0,17,0
1746590947168,GLBH 150,A00,889181,Sloane; Julia Kathryn,0,5,15,15
1746590949222,HDS 60,A01,886406,Warstadt; Melissa Fawn,73,0,80,7
1746590950249,HIAF 111,A00,889324,Gyamfi; Bright,25,0,32,7
1746590951278,HIEA 131,A00,889328,Staff,15,0,32,17
1746590952304,HIEA 144,A00,889333,Henry; Todd A.,26,0,32,6
1746590953328,HIEA 154,A00,889336,Henry; Todd A.,24,0,32,8
1746590954353,HIEU 106,A00,889339,Staff,22,0,32,10
1746590956405,HIEU 114,A00,889340,Staff,4,0,32,28
1746590957434,HIEU 135GS,A00,889342,Patterson; Patrick H.,0,0,1,24
1746590958460,HIEU 137,A00,889343,Edington; Claire Ellen,10,0,25,15
1746590959483,HIEU 148,A00,889345,Staff,14,0,32,18
1746590960509,HIEU 154,A00,889346,Biess; Frank Peter,21,0,32,11
1746590961536,HILA 102,A00,889351,Staff,12,0,32,20
1746590962561,HILD 2A,A01,889221,Lewandoski; Julia Mavis,2,10,32,30
1746590963587,HILD 7B,A01,889225,Man; Simeon S,0,12,32,32
1746590964611,HILD 7C,A01,889288,Alvarez; Luis A,0,14,32,32
1746590965639,HILD 30,A01,889323,Staff,0,5,32,32
1746590967689,HISC 119,A00,889383,Golan; Tal,19,0,32,13
1746590968715,HIUS 103,A00,889384,Man; Simeon S,0,0,32,32
1746590969740,HIUS 117,A00,919797,Kwak; Nancy,18,0,32,14
1746590970769,HIUS 142A,A00,919788,Staff,22,0,32,10
1746590972822,HIUS 149,A00,889386,Gyamfi; Bright,26,0,32,6
1746590973847,HIUS 155,A00,889387,Alvarez; Luis A,15,0,32,17
1746590974873,HUM 3,A01,886499,Caldwell; Michael Alan,19,0,50,31
1746590975898,HUM 3GS,A00,886500,Rodriguez; Bretton Sigfred,0,0,0,28
1746590976922,HUM 3R,A01,886502,Markman; Kristina,0,36,50,50
1746590977947,HUM 4,A01,886504,Crum; Matthew Stephen,23,0,50,27
1746590977947,HUM 4,B01,886506,West; Geoffrey Scott,17,0,50,33
1746590978975,HUM 4GS,A00,886507,Staff,0,0,0,19
1746590980002,HUM 5,A01,886509,Staff,31,0,50,19
1746590981026,HUM 5R,A01,886511,Zavodny; Tatiana Sophia,0,39,50,50
1746590982056,JAPN 180,A00,886407,Staff,16,0,40,24
1746590983083,LATI 50,A01,886409,Martin-Cabrera; Luis,3,0,22,19
1746590983083,LATI 50,A02,886410,Martin-Cabrera; Luis,19,0,22,3
1746590983083,LATI 50,A03,886411,Martin-Cabrera; Luis,21,0,22,1
1746590983083,LATI 50,A04,886412,Martin-Cabrera; Luis,8,0,22,14
1746590984113,LAWS 101,A00,907664,Staff,28,0,60,32
1746590985140,LIAB 1A,A00,889388,Saab; Dima,17,0,20,3
1746590986165,LIAB 1AX,A00,889389,El Cheddadi; Youniss,18,0,20,2
1746590987191,LIFR 1C,A00,889391,Van Moer; Vinciane G,8,0,20,12
1746590988217,LIFR 1CX,A00,889392,Van Moer; Vinciane G,7,0,20,13
1746590989243,LIFR 1D,A00,889393,Van Moer; Vinciane G,7,0,20,13
1746590990273,LIFR 1DX,A00,889394,Van Moer; Vinciane G,8,0,20,12
1746590991299,LIGN 7,A00,886923,Staff,24,0,50,26
1746590992328,LIGN 17,A00,886924,Kehler; Andrew Scott,125,0,150,25
1746590993355,LTAM 110,A00,889395,Staff,15,0,30,15
1746590994382,LTAM 110GS,A00,958010,Rodriguez; Bretton Sigfred,0,0,0,28
1746590995409,LTCH 101,A00,889397,Staff,23,0,25,2
1746590996437,LTCS 130,A00,889398,Staff,23,0,25,2
1746590997465,LTEA 138,A00,889399,Staff,24,0,40,16
1746590998489,LTEN 149,A00,889400,Wesling; Megan E.,0,3,25,25
1746590999514,LTEN 169,A00,889401,Staff,20,0,25,5
1746591000539,LTEN 180,A00,889402,Staff,10,0,15,5
1746591001565,LTEN 181,A00,889403,Staff,21,0,25,4
1746591002594,LTWL 100,A00,889404,Myerston Santana; Jacobo,2,0,25,23
1746591003618,LTWL 180GS,A00,889405,Staff,0,0,20,20
1746591004648,LTWL 181,A00,889406,Staff,16,0,25,9
1746591005679,LTWL 184,A00,889475,Mukherjee; Silpa,22,0,25,3
1746591006707,LTWR 102C,A00,889486,Staff,29,0,30,1
1746591007732,LTWR 115W,A00,889491,Staff,0,2,15,15
1746591008758,MAE 8,A01,886905,Staff,0,2,0,0
1746591009785,MAE 11,A00,886906,Bandaru; Prabhakar,0,7,50,50
1746591010815,MAE 20,A00,886907,Evdokimenko; Ekaterina,43,0,70,27
1746591011840,MAE 30B,A00,886909,Ghazinejad; Maziar,26,0,45,19
1746591012865,MAE 101B,A00,886910,Saintillan; David,29,0,45,16
1746591013892,MAE 105,A00,886911,Bandaru; Prabhakar,18,0,50,32
1746591014918,MAE 107,B00,958024,Staff,7,0,50,43
1746591015948,MAE 143B,A00,886913,Bewley; Thomas R,3,0,40,37
1746591016975,MAE 148,A01,886915,Silberman; Jack,0,3,14,14
1746591018006,MAE 160,A00,886916,Evdokimenko; Ekaterina,31,0,60,29
1746591019034,MATH 3C,A01,889681,Staff,0,2,30,30
1746591019034,MATH 3C,A02,960048,Staff,23,0,30,7
1746591020063,MATH 10A,A01,889760,Staff,26,0,30,4
1746591020063,MATH 10A,A02,889783,Staff,29,0,30,1
1746591021140,MATH 10B,A01,889785,Verstraete; Jacques Allan,1,0,35,34
1746591021140,MATH 10B,A02,889795,Verstraete; Jacques Allan,4,0,35,31
1746591021140,MATH 10B,B01,889797,Verstraete; Jacques Allan,3,0,35,32
1746591021140,MATH 10B,B02,889828,Verstraete; Jacques Allan,3,0,35,32
1746591022172,MATH 10C,A01,889849,Habib; Yousaf,8,0,30,22
1746591022172,MATH 10C,A02,889852,Habib; Yousaf,14,0,30,16
1746591022172,MATH 10C,A03,889853,Habib; Yousaf,22,0,30,8
1746591022172,MATH 10C,A04,889858,Habib; Yousaf,20,0,30,10
1746591022172,MATH 10C,B01,889861,Staff,1,0,30,29
1746591022172,MATH 10C,B02,889862,Staff,24,0,30,6
1746591022172,MATH 10C,B03,889863,Staff,27,0,30,3
1746591022172,MATH 10C,B04,889967,Staff,23,0,30,7
1746591023198,MATH 18,A01,889974,Staff,7,0,30,23
1746591023198,MATH 18,A02,889977,Staff,20,0,30,10
1746591023198,MATH 18,B01,889984,Hardiman; Liam,20,0,30,10
1746591023198,MATH 18,B02,889985,Hardiman; Liam,25,0,30,5
1746591024224,MATH 20A,A01,889990,Suk; Andrew Hoon,30,0,35,5
1746591025255,MATH 20B,A01,889993,Ohm; Ko Woon,21,0,30,9
1746591025255,MATH 20B,A02,889994,Ohm; Ko Woon,30,0,30,0
1746591025255,MATH 20B,B01,889996,Ohm; Ko Woon,22,0,30,8
1746591025255,MATH 20B,B02,889997,Ohm; Ko Woon,23,0,30,7
1746591026285,MATH 20C,A01,889999,Hammock; Frances H,17,0,30,13
1746591026285,MATH 20C,A02,890003,Hammock; Frances H,23,0,30,7
1746591026285,MATH 20C,B01,890006,Hammock; Frances H,3,0,30,27
1746591026285,MATH 20C,B02,890007,Hammock; Frances H,12,0,30,18
1746591027313,MATH 20D,A01,890011,Cheng; Hsiao-Bing,1,1,30,29
1746591027313,MATH 20D,A02,890012,Cheng; Hsiao-Bing,14,0,30,16
1746591027313,MATH 20D,B01,890016,Cheng; Hsiao-Bing,13,0,30,17
1746591027313,MATH 20D,B02,890017,Cheng; Hsiao-Bing,13,0,30,17
1746591028343,MATH 20E,A01,890026,Harel; Guershon,1,0,30,29
1746591028343,MATH 20E,A02,890029,Harel; Guershon,22,0,30,8
1746591028343,MATH 20E,B01,890033,Harel; Guershon,7,0,30,23
1746591028343,MATH 20E,B02,890101,Harel; Guershon,21,0,30,9
1746591029373,MATH 102,A01,890104,Staff,18,0,30,12
1746591029373,MATH 102,A02,890105,Staff,27,0,30,3
1746591030397,MATH 103B,A01,890116,Salehi Golsefidy; Alireza,3,0,30,27
1746591030397,MATH 103B,B01,890118,Staff,0,3,34,34
1746591031423,MATH 109,A01,890121,Aliabadi Sr.; Mohsen,0,0,30,30
1746591031423,MATH 109,B01,890124,Upadrashta; Pranav Kumar,18,0,30,12
1746591032450,MATH 120A,A01,890126,Eggers; John Dietrich,13,0,30,17
1746591033476,MATH 142B,A01,890128,Ioana; Adrian,19,0,30,11
1746591033476,MATH 142B,A02,890129,Ioana; Adrian,12,0,30,18
1746591034505,MATH 154,A01,890174,Staff,0,1,30,30
1746591034505,MATH 154,A02,890182,Staff,0,0,30,30
1746591035535,MATH 168A,A01,890197,Dumitriu; Ioana,21,0,35,14
1746591036776,MATH 170A,A01,890240,Nie; Jiawang,1,0,30,29
1746591036776,MATH 170A,A02,890241,Nie; Jiawang,11,0,30,19
1746591036776,MATH 170A,A03,890249,Nie; Jiawang,23,0,30,7
1746591037805,MATH 170B,A01,957891,Nag; Panchali,13,0,35,22
1746591039862,MATH 181A,A01,908025,Staff,0,3,35,35
1746591039862,MATH 181A,A02,960115,Staff,26,0,35,9
1746591040889,MATH 181B,A01,959874,Staff,25,0,30,5
1746591041916,MATH 193B,A01,890265,Staff,0,4,35,35
1746591042942,MGT 4,A01,890311,Anderson; John Charles,42,0,88,46
1746591043972,MGT 5,A00,907740,Staff,12,0,98,86
1746591044997,MGT 12,A00,890312,Lindenberger; Wade Douglas,67,0,98,31
1746591046023,MGT 16,A00,957883,Staff,78,0,98,20
1746591048078,MGT 45,A00,890314,Pecore; Joseph P.,45,0,98,53
1746591049105,MGT 71,A00,890315,Staff,0,12,98,98
1746591050134,MGT 100,A00,890316,Yavorsky; Daniel Ryan,44,0,98,54
1746591051160,MGT 103,A00,890317,Ehrich; Kristine R,73,0,98,25
1746591052190,MGT 105,A00,890356,Bates; Kenneth Walter,0,8,98,98
1746591053218,MGT 112,A00,890360,Ehrich; Kristine R,55,0,98,43
1746591054243,MGT 127R,A00,907732,Zhu; Kevin Xiaoguo,23,0,98,75
1746591055273,MGT 131B,A00,890361,Anderson; John Charles,59,0,98,39
1746591056299,MGT 137,A00,890362,Lindenberger; Wade Douglas,65,0,98,33
1746591057326,MGT 160,A00,890369,Johnson; Erik Barry,9,0,98,89
1746591059377,MGT 164,A00,890372,Zimmermann; Carsten,0,40,98,98
1746591060407,MGT 180,A00,890374,Bliss; Barbara Ann,11,0,98,87
1746591061440,MMW 15,A01,886414,Chang; Edmond Yi-Teh,0,12,28,28
1746591061440,MMW 15,A02,886415,Chang; Edmond Yi-Teh,0,8,28,28
1746591061440,MMW 15,A03,886416,Chang; Edmond Yi-Teh,0,9,28,28
1746591061440,MMW 15,A04,886417,Chang; Edmond Yi-Teh,0,8,28,28
1746591061440,MMW 15,B01,886419,Chang; Edmond Yi-Teh,0,7,28,28
1746591061440,MMW 15,B02,886420,Chang; Edmond Yi-Teh,0,8,28,28
1746591061440,MMW 15,B03,886421,Chang; Edmond Yi-Teh,0,7,28,28
1746591061440,MMW 15,B04,886422,Chang; Edmond Yi-Teh,0,8,28,28
1746591061440,MMW 15,C01,886424,Staff,0,9,28,28
1746591061440,MMW 15,C02,886425,Staff,0,8,28,28
1746591061440,MMW 15,C03,886426,Staff,0,8,28,28
1746591061440,MMW 15,C04,886427,Staff,0,8,28,28
1746591061440,MMW 15,C05,958038,Staff,0,8,28,28
1746591061440,MMW 15,C06,958039,Staff,1,8,28,27
1746591062465,MMW 15GS,A00,906910,Patterson; Patrick H.,4,0,28,24
1746591063491,MMW 122R,A01,886429,Rahimi; Babak,0,13,28,28
1746591063491,MMW 122R,A02,886430,Rahimi; Babak,0,12,28,28
1746591063491,MMW 122R,A03,958040,Rahimi; Babak,0,11,28,28
1746591064522,MUS 1A,A01,890937,Staff,2,0,25,23
1746591064522,MUS 1A,A02,891035,Staff,6,0,25,19
1746591064522,MUS 1A,C01,958912,Staff,24,0,25,1
1746591064522,MUS 1A,C02,958913,Staff,25,0,25,0
1746591066576,MUS 2AK,A00,957092,Ohnishi; Takae,15,0,15,0
1746591067606,MUS 4,A01,891044,Staff,0,0,25,25
1746591067606,MUS 4,A02,891045,Staff,22,0,25,3
1746591067606,MUS 4,B01,891048,Staff,17,0,25,8
1746591067606,MUS 4,B02,891050,Staff,25,0,25,0
1746591068636,MUS 5,A01,957506,Dubnov; Shlomo,0,0,25,25
1746591068636,MUS 5,A02,957622,Dubnov; Shlomo,13,0,25,12
1746591068636,MUS 5,A03,957623,Dubnov; Shlomo,20,0,25,5
1746591069662,MUS 6,A01,891053,Freitas Caetano; Marcelo,24,0,25,1
1746591069662,MUS 6,A02,891054,Freitas Caetano; Marcelo,23,0,25,2
1746591070692,MUS 7,A01,891081,Staff,0,0,25,25
1746591070692,MUS 7,A02,891082,Staff,3,0,25,22
1746591071716,MUS 8GS,A00,891118,Borgo; David Garcia,1,0,25,24
1746591072743,MUS 11,A01,891140,Staff,9,0,25,16
1746591072743,MUS 11,A02,891141,Staff,21,0,25,4
1746591073771,MUS 13,A01,891143,Staff,8,0,25,17
1746591073771,MUS 13,A02,891144,Staff,24,0,25,1
1746591074797,MUS 15,A01,891146,Staff,9,0,25,16
1746591074797,MUS 15,A02,891148,Staff,21,0,25,4
1746591074797,MUS 15,B01,891150,Staff,18,0,25,7
1746591074797,MUS 15,B02,891151,Staff,25,0,25,0
1746591075823,MUS 20,A01,891153,Staff,5,0,20,15
1746591075823,MUS 20,A02,891155,Staff,14,0,20,6
1746591076847,MUS 80,A00,891156,Staff,19,0,25,6
1746591076847,MUS 80,B00,891157,Staff,23,0,25,2
1746591077874,MUS 130,A00,891158,Ohnishi; Takae,35,0,35,0
1746591078899,MUS 150GS,A01,891160,Borgo; David Garcia,1,0,25,24
1746591079925,MUS 170,A01,891162,Freitas Caetano; Marcelo,20,0,25,5
1746591079925,MUS 170,A02,891164,Freitas Caetano; Marcelo,21,0,25,4
1746591080954,NANO 11,A00,886220,Vazquez Mena; Oscar,13,0,15,2
1746591081981,NANO 15,A01,886222,Drews; Aaron,4,0,7,3
1746591083008,NANO 104,A00,886224,Sirbuly; Donald,17,0,25,8
1746591084033,PH 40,A00,886528,Staff,23,0,40,17
1746591085059,PH 45,A01,886799,Staff,35,0,40,5
1746591086086,PH 110,A00,886802,Staff,0,6,40,40
1746591087113,PH 172,A00,906716,Staff,19,0,35,16
1746591088138,PH 191,A00,886803,Staff,6,0,40,34
1746591089164,PHIL 1,A00,889500,Staff,20,0,30,10
1746591090189,PHIL 10,A01,889549,Grush; Rick Scott,16,0,22,6
1746591090189,PHIL 10,A02,889551,Grush; Rick Scott,22,0,22,0
1746591091217,PHIL 28,A01,889559,Lamey; Andy M.,0,2,31,31
1746591091217,PHIL 28,A02,889561,Lamey; Andy M.,0,1,30,30
1746591091217,PHIL 28,A03,889572,Lamey; Andy M.,0,1,30,30
1746591092241,PHIL 35,A00,907839,Staff,13,0,15,2
1746591093266,PHIL 60,A00,889574,Staff,73,0,90,17
1746591094294,PHIL 101,A00,958004,Staff,12,0,15,3
1746591096353,PHIL 136,A00,889582,Fulkerson; Matthew Todd,26,0,45,19
1746591097379,PHIL 163,A01,889601,Staff,21,0,30,9
1746591097379,PHIL 163,B01,889606,Brandt; Reuven A,0,3,0,0
1746591098410,PHIL 164,A00,889610,Staff,16,0,30,14
1746591099434,PHIL 165,A00,889613,Staff,22,0,30,8
1746591100460,PHYS 1A,A00,886431,Staff,30,0,70,40
1746591101488,PHYS 1AL,001,886432,Tsai; Philbert S,1,2,30,29
1746591101488,PHYS 1AL,002,886436,Tsai; Philbert S,13,0,30,17
1746591102513,PHYS 1B,A00,886439,Staff,184,0,240,56
1746591103542,PHYS 1BL,001,886441,Tsai; Philbert S,0,4,30,30
1746591103542,PHYS 1BL,002,886444,Tsai; Philbert S,2,0,30,28
1746591104566,PHYS 1C,A00,896092,Arnold; Kam S,78,0,146,68
1746591105596,PHYS 1CL,001,886448,Tsai; Philbert S,0,0,30,30
1746591105596,PHYS 1CL,002,886449,Tsai; Philbert S,1,0,30,29
1746591105596,PHYS 1CL,003,886450,Tsai; Philbert S,16,0,30,14
1746591105596,PHYS 1CL,004,886451,Tsai; Philbert S,15,0,30,15
1746591106624,PHYS 2B,A01,886457,Staff,67,0,115,48
1746591107649,PHYS 2C,A01,886460,Shotwell; Brian,0,9,65,65
1746591108675,PHYS 2CL,A01,886467,Staff,0,4,28,28
1746591108675,PHYS 2CL,A02,886468,Staff,0,3,28,28
1746591109702,PHYS 2D,A01,886470,Staff,10,0,50,40
1746591110730,PHYS 4B,A01,886475,Grinstein; Benjamin,22,0,40,18
1746591111755,POLI 5,A00,891173,Desposato; Scott,7,0,25,18
1746591112781,POLI 5D,A01,891175,Staff,5,0,5,0
1746591112781,POLI 5D,B01,891178,Staff,5,0,5,0
1746591113807,POLI 11,A00,891179,Ferree; Karen E,2,0,35,33
1746591114834,POLI 12,A00,891180,Staff,16,0,30,14
1746591115860,POLI 27,A01,891182,Staff,12,0,75,63
1746591116886,POLI 30,A00,891183,Staff,8,0,50,42
1746591117911,POLI 100B,A00,891244,Staff,5,1,35,30
1746591118937,POLI 100I,A00,891247,Staff,7,0,30,23
1746591119962,POLI 104J,A00,891248,Nichter; Maysa,14,0,30,16
1746591120989,POLI 104U,A00,891250,Nichter; Maysa,1,0,30,29
1746591123041,POLI 110B,A00,891255,Wiens; David,19,0,25,6
1746591124069,POLI 112A,A00,891256,Wiens; David,6,0,25,19
1746591125153,POLI 114BR,A00,891261,Staff,19,0,30,11
1746591126177,POLI 117R,A00,891262,Forman; Fonna,0,6,50,50
1746591127201,POLI 118,A00,891264,Ingham; Sean,17,0,25,8
1746591128226,POLI 124A,A00,891265,Staff,18,0,20,2
1746591129251,POLI 125D,A00,891266,Nichter; Simeon C,2,0,25,23
1746591130276,POLI 126,A00,891268,Nichter; Simeon C,7,0,25,18
1746591131307,POLI 126AA,A00,891272,Staff,15,0,25,10
1746591132335,POLI 130AA,A00,891273,Staff,15,0,20,5
1746591133363,POLI 134AA,A00,891274,Staff,4,0,20,16
1746591135416,POLI 138,A00,891278,Staff,21,0,25,4
1746591136441,POLI 142K,A00,891280,Staff,10,0,25,15
1746591137469,POLI 142M,A00,891281,Gartzke; Erik,16,0,30,14
1746591138493,POLI 142P,A00,891284,Staff,20,0,30,10
1746591139522,POLI 143,A00,891285,Gartzke; Erik,12,0,30,18
1746591140546,POLI 153,A00,891286,Staff,19,0,20,1
1746591142597,POLI 175,A00,891290,Staff,15,0,20,5
1746591143622,PSYC 1,A00,890674,Steiner; Eric Tomas,0,11,45,45
1746591144651,PSYC 2,A00,890676,Albright; Thomas D,20,0,35,15
1746591145676,PSYC 3,A00,890679,Staff,17,0,20,3
1746591146704,PSYC 6,A00,959858,Staff,19,0,20,1
1746591147737,PSYC 60,A01,890684,Rickard; Timothy C.,0,6,45,45
1746591148765,PSYC 70,A01,890689,Geller; Emma Harlan,6,0,30,24
1746591149794,PSYC 71,A01,959860,Staff,21,0,25,4
1746591150823,PSYC 100,A00,890690,Lacefield; Katharine I,0,50,180,180
1746591151852,PSYC 102,A00,890695,Staff,18,0,40,22
1746591152878,PSYC 105,A00,890699,Geller; Emma Harlan,70,0,100,30
1746591153902,PSYC 106,A00,890701,Gorman; Michael R.,5,0,30,25
1746591154931,PSYC 108,A00,890704,Adrian; Julia Anna,0,29,50,50
1746591155954,PSYC 118,A01,890712,Staff,11,0,30,19
1746591156980,PSYC 124,A00,890716,Chapman; Eddie Nathaniel,25,0,60,35
1746591158008,PSYC 131,A00,890717,Anagnostaras; Stephan,0,7,80,80
1746591159032,PSYC 137,A00,890719,Winkielman; Piotr,0,11,30,30
1746591160063,PSYC 144,A00,890721,Adrian; Julia Anna,0,9,45,45
1746591161090,PSYC 162,A00,890805,Staff,0,1,75,75
1746591162116,PSYC 169,A00,890810,Staff,0,15,30,30
1746591163145,PSYC 172,A00,890814,Gorman; Michael R.,9,0,30,21
1746591164172,PSYC 181,A00,890818,Anagnostaras; Stephan,7,0,200,193
1746591165201,PSYC 184,A00,959861,Staff,163,0,175,12
1746591166224,PSYC 189,A00,890823,Staff,0,2,30,30
1746591167248,PSYC 191,A00,890884,Rickard; Timothy C.,0,12,35,35
1746591168275,PSYC 193,A00,890913,Staff,19,0,30,11
1746591168275,PSYC 193,B00,890914,Chapman; Eddie Nathaniel,24,0,30,6
1746591169299,PSYC 193L,A01,890918,Lowe; Angela Beth,20,0,30,10
1746591169299,PSYC 193L,B01,890921,Hurwitz; Ethan Scott,20,0,30,10
1746591169299,PSYC 193L,C01,890928,Staff,30,0,30,0
1746591170325,RELI 149,A00,886806,Rahimi; Babak,23,0,40,17
1746591171350,SE 9,A01,886814,Staff,7,0,20,13
1746591172375,SE 101B,A01,886816,Chadha; Mayank,3,0,35,32
1746591173400,SE 110B,A00,886818,Zhu; Qiang,4,0,75,71
1746591174428,SE 125,A01,886830,Staff,10,0,30,20
1746591175457,SE 130B,A01,886835,Staff,14,0,40,26
1746591176483,SE 131A,A01,886838,Krysl; Petr,34,0,55,21
1746591177508,SE 154,A00,886840,Staff,28,0,50,22
1746591178536,SE 164GS,A01,886849,Staff,6,0,20,14
1746591179565,SE 167GS,A01,886853,Staff,6,0,20,14
1746591180593,SIO 25,A01,890107,Staff,19,0,30,11
1746591181622,SIO 45,A00,890109,Cook; Geoffrey W,116,0,200,84
1746591182647,SIO 109R,A00,890110,Forman; Fonna,0,16,20,20
1746591183672,SIO 187,A01,890114,Kacev; David,15,0,40,25
1746591184698,SOCI 1,A01,890431,Thorpe; Charles Robert,14,0,30,16
1746591184698,SOCI 1,A02,890518,Thorpe; Charles Robert,30,0,30,0
1746591185726,SOCI 2,A01,957978,Staff,25,0,25,0
1746591185726,SOCI 2,A02,957979,Staff,23,0,25,2
1746591186753,SOCI 20,A01,890523,Calderon-Zaks; Michael Aar,21,0,30,9
1746591186753,SOCI 20,A02,890526,Calderon-Zaks; Michael Aar,29,0,30,1
1746591187782,SOCI 30,A01,890533,Pardo Guerra; Juan Pablo,37,0,40,3
1746591188811,SOCI 40,A01,890535,Staff,27,0,45,18
1746591189837,SOCI 104Q,A00,890559,Staff,18,0,30,12
1746591190865,SOCI 106,A00,890560,Arnal; Maud Marie Leonie,20,0,30,10
1746591191890,SOCI 110,A00,890567,Holkenbrink-Monk; Charlene,19,0,30,11
1746591192917,SOCI 112,A00,890568,Victoria Torres; Pablo,2,0,55,53
1746591193943,SOCI 115,A00,890597,Arnal; Maud Marie Leonie,28,0,45,17
1746591195998,SOCI 121,A00,890604,Pardo Guerra; Juan Pablo,38,0,45,7
1746591197023,SOCI 126,A01,890608,Staff,8,0,10,2
1746591198049,SOCI 127,A00,890609,Staff,18,0,30,12
1746591199091,SOCI 131,A00,890610,Thorpe; Charles Robert,37,0,45,8
1746591200118,SOCI 135,A00,890615,Payne; Christine Anna,14,0,45,31
1746591201144,SOCI 139,A00,890620,Staff,38,0,45,7
1746591202169,SOCI 148E,A00,890622,Calderon-Zaks; Michael Aar,36,0,45,9
1746591203192,SOCI 150,A00,890623,Kohler; Kristopher M.,31,0,45,14
1746591204217,SOCI 157,A00,890625,Jules-Rosette; Bennetta W.,18,0,20,2
1746591205245,SOCI 160,A00,890627,Payne; Christine Anna,21,0,45,24
1746591206270,SYN 1,A00,886855,Fish; Gwendolyn Anne,0,1,0,0
1746591206270,SYN 1,B00,906086,Fish; Gwendolyn Anne,0,2,0,2
1746591207296,SYN 2R,A00,886860,Staff,0,17,15,15
1746591207296,SYN 2R,B00,906106,Atkinson; Arthur Laird,0,16,15,15
1746591208324,SYN 100,A01,886866,Browne; Emily,0,28,20,20
1746591208324,SYN 100,B01,906128,Rock; Martin,0,4,20,20
1746591208324,SYN 100,C01,906140,Deavenport; James Cary,0,4,20,20
1746591208324,SYN 100,D01,907816,Deavenport; James Cary,0,5,20,20
1746591209351,TDAC 1,A00,890286,Walsh; Kim C.,7,0,20,13
1746591210377,TDAC 101,A00,890296,Basso; Beatrice,15,0,20,5
1746591211402,TDDE 131,A00,890297,Staff,47,0,50,3
1746591212428,TDDM 1,A00,890287,Weinberg; Sadie,25,0,30,5
1746591213457,TDGE 11,A00,890288,Fulton; Julia,138,0,200,62
1746591213457,TDGE 11,B00,890289,Castro; Robert Jess,185,0,200,15
1746591214481,TDGE 25,B00,957359,Walsh; Kim C.,5,0,20,15
1746591215508,TDGE 40,A01,890292,Power; Jade Yukana,26,0,30,4
1746591216534,TDGE 124,A00,890298,Havis; Allan,0,2,50,50
1746591217560,TDGE 131R,A00,890299,Burelle; Julie Sara Veronique,15,0,42,27
1746591218585,TDHT 101,A00,890300,Staff,10,0,20,10
1746591219615,TDHT 109,A01,890302,Anderson; Mysia Anyse,31,0,40,9
1746591220645,TDMV 1,A00,890293,Arcidiacono; Kristin,18,0,30,12
1746591221673,TDMV 2,A00,890294,Weinberg; Sadie,23,0,30,7
1746591222698,TDMV 3,A00,957878,Arcidiacono; Kristin,28,0,30,2
1746591224749,TDMV 138,A00,890304,Jun; Grace Shin Hae,25,0,40,15
1746591225776,TDMV 140,A00,890305,Corrales; Joseph Bernales,25,0,30,5
1746591226803,TDMV 142,A00,890307,Caligagan; Tony,32,0,40,8
1746591227831,TDMV 144,A00,890308,Camaya; Michelle Ann,25,0,30,5
1746591228896,TDPW 1,A00,890295,Stein; Deborah Isobel,3,0,20,17
1746591229923,USP 2,A01,890272,Lerner; Amy M,7,0,20,13
1746591230948,USP 3,A01,890274,Staff,12,0,30,18
1746591231978,USP 15,A01,890276,Sun; Feiyang,16,0,30,14
1746591233006,USP 25,A00,890277,Shenkman; Michael Thomas,18,0,25,7
1746591234031,USP 138,A00,890278,Staff,13,0,25,12
1746591235059,USP 143,A00,890279,Staff,22,0,70,48
1746591236085,USP 144,A00,890280,Chowdhury; Muhammed Zohir,16,0,30,14
1746591237110,USP 150,A00,890281,Boomhower; Matthew Charles,4,0,30,26
1746591238136,USP 151,A00,890282,Staff,16,0,20,4
1746591239163,USP 162,A00,890283,Andrews; Abigail Leslie,16,0,20,4
1746591240191,USP 168,A00,920477,Kwak; Nancy,0,0,5,5
1746591241219,USP 181,A00,890284,Staff,3,0,20,17
1746591242245,USP 191A,A00,890285,Staff,12,0,20,8
1746591243270,VIS 101,A00,886512,Staff,26,0,75,49
1746591244296,VIS 103,A00,886513,Cruz; Edwin Teddy,61,0,75,14
1746591245324,VIS 108,A00,886514,Staff,3,0,15,12
1746591246350,VIS 127P,A00,886515,Shen; Kuiyi,79,0,146,67
1746591247375,VIS 149,A00,886516,Yoldas; Pinar,0,0,15,15
1746591248400,VIS 164,A00,886526,Erdmann; Dean,19,0,22,3
1746591249427,VIS 194S,A00,886527,Staff,61,0,75,14
1746591250456,WCWP 10A,C00,886484,Martiniuk; Jill,12,0,15,3
1746591251480,WCWP 10B,A00,886490,Uriarte; Emma,0,0,15,15
1746591251480,WCWP 10B,B00,886491,Dhir; Simrita,8,0,15,7
1746591251480,WCWP 10B,C00,886492,Ornelas; Tricia,0,0,15,15
1746591252510,WCWP 100,A00,886494,Young; Mark T,0,6,15,15
1746591254630,AAS 10,A01,886199,Childs; Dennis R.,0,3,0,0
1746591255661,ANAR 104,A01,886940,Shtienberg; Gilad,27,0,30,3
1746591256686,ANAR 120,A00,886953,Staff,13,0,20,7
1746591257716,ANBI 148,A01,886955,Wilder; Linnea Lorene,30,0,40,10
1746591259771,ANSC 122,A00,886957,Staff,24,0,30,6
1746591260799,ANSC 150,A00,886958,Sloane; Julia Kathryn,2,0,15,13
1746591261823,ANSC 156,A00,886959,Jenkins; Janis A.,0,1,15,15
1746591262849,ANSC 180,A00,886960,Staff,11,0,17,6
1746591263874,ANSC 188,A00,886961,Jassal; Aftab,9,0,25,16
1746591264900,ANSC 190,A00,886962,Jassal; Aftab,14,0,25,11
1746591265926,ANSC 191,A00,886963,Staff,18,0,20,2
1746591266952,ANTH 3,A01,891689,Staff,17,0,20,3
1746591267978,ANTH 5,A00,886933,Semendeferi; Ekaterini,16,0,20,4
1746591269002,ANTH 10,A00,886934,Staff,0,12,30,30
1746591270030,ANTH 21,A01,886936,Staff,41,0,60,19
1746591271057,ANTH 23,A01,886938,Staff,92,0,100,8
1746591272085,ANTH 105,A00,886964,Stewart; Alexander B,84,0,100,16
1746591273111,ANTH 108,A00,886965,Pedersen; David,9,0,20,11
1746591274142,AWP 10,001,886147,Staff,0,0,0,0
1746591274142,AWP 10,002,886148,Staff,0,0,0,0
1746591274142,AWP 10,003,886149,Staff,0,0,0,0
1746591274142,AWP 10,004,886150,Staff,0,0,0,0
1746591274142,AWP 10,005,886151,Staff,0,0,0,0
1746591274142,AWP 10,006,886152,Staff,0,0,0,0
1746591274142,AWP 10,007,886153,Staff,0,0,0,0
1746591274142,AWP 10,008,886154,Staff,0,0,0,0
1746591274142,AWP 10,009,886155,Staff,0,0,0,0
1746591274142,AWP 10,010,886156,Staff,0,0,0,0
1746591274142,AWP 10,011,886158,Staff,0,0,0,0
1746591274142,AWP 10,012,886160,Staff,0,0,0,0
1746591274142,AWP 10,013,886161,Staff,0,0,0,0
1746591274142,AWP 10,014,886162,Staff,0,0,0,0
1746591274142,AWP 10,015,886163,Staff,0,0,0,0
1746591274142,AWP 10,016,886164,Staff,0,0,0,0
1746591274142,AWP 10,017,886165,Staff,0,0,0,0
1746591274142,AWP 10,018,886166,Staff,0,0,0,0
1746591274142,AWP 10,019,886168,Staff,0,0,0,0
1746591274142,AWP 10,020,886170,Staff,0,0,0,0
1746591274142,AWP 10,021,886172,Staff,0,0,0,0
1746591275173,AWP 10R,001,886173,Staff,0,1,0,0
1746591275173,AWP 10R,002,886174,Staff,0,1,0,0
1746591275173,AWP 10R,003,886175,Staff,0,0,0,0
1746591275173,AWP 10R,004,886176,Staff,0,0,0,0
1746591275173,AWP 10R,005,886177,Staff,0,0,0,0
1746591275173,AWP 10R,006,886178,Staff,0,0,0,0
1746591275173,AWP 10R,007,886179,Staff,0,0,0,0
1746591275173,AWP 10R,008,886181,Staff,0,0,0,0
1746591275173,AWP 10R,009,886182,Staff,0,0,0,0
1746591275173,AWP 10R,010,886183,Staff,0,0,0,0
1746591275173,AWP 10R,011,886184,Staff,0,0,0,0
1746591275173,AWP 10R,012,886185,Staff,0,0,0,0
1746591275173,AWP 10R,013,886186,Staff,0,0,0,0
1746591275173,AWP 10R,014,886187,Staff,0,0,0,0
1746591275173,AWP 10R,015,886188,Staff,0,0,0,0
1746591275173,AWP 10R,016,886189,Staff,0,0,0,0
1746591275173,AWP 10R,017,960532,Staff,0,0,0,0
1746591275173,AWP 10R,018,960533,Staff,0,0,0,0
1746591275173,AWP 10R,019,960534,Staff,0,0,0,0
1746591275173,AWP 10R,020,960538,Staff,0,0,0,0
1746591275173,AWP 10R,021,960540,Staff,0,0,0,0
1746591275173,AWP 10R,022,960541,Staff,0,0,0,0
1746591275173,AWP 10R,023,960542,Staff,0,0,0,0
1746591275173,AWP 10R,024,960544,Staff,0,0,0,0
1746591275173,AWP 10R,025,960545,Staff,0,0,0,0
1746591275173,AWP 10R,026,960548,Staff,0,0,0,0
1746591276198,AWP 102R,A00,886190,Staff,0,0,0,0
1746591276198,AWP 102R,B00,886191,Staff,0,0,0,0
1746591277235,BENG 100,A01,886193,Staff,17,0,30,13
1746591278262,BENG 122A,A01,886195,Hasty; Jeff M,13,0,30,17
1746591279290,BENG 166A,A00,886196,Sah; Robert Lie-Yuan,0,3,30,30
1746591280315,BENG 190,A00,958050,Khojah; Reem I,17,0,25,8
1746591281344,BIBC 102,A01,894320,Staff,0,0,46,46
1746591281344,BIBC 102,A02,894321,Staff,0,0,46,46
1746591281344,BIBC 102,A03,894344,Staff,6,0,46,40
1746591281344,BIBC 102,A04,894345,Staff,27,0,47,20
1746591282374,BICD 100R,A01,894365,Smith; Laurie,1,3,58,57
1746591282374,BICD 100R,A02,894366,Smith; Laurie,1,5,58,57
1746591282374,BICD 100R,A03,894367,Smith; Laurie,0,0,59,59
1746591282374,BICD 100R,A04,959869,Smith; Laurie,39,0,59,20
1746591283400,BICD 136,A01,894383,Gustafson-Brown; Cindy,14,0,50,36
1746591284425,BIEB 102,A01,894494,Butler; Shannon Rhey,51,0,130,79
1746591286475,BIEB 150,A01,894617,Wills; Christopher,3,0,20,17
1746591286475,BIEB 150,A02,894631,Wills; Christopher,3,0,20,17
1746591286475,BIEB 150,A03,894937,Wills; Christopher,3,0,20,17
1746591286475,BIEB 150,A04,894946,Wills; Christopher,5,0,20,15
1746591287504,BIEB 194,A00,906141,Kurle; Carolyn M.,5,0,20,15
1746591288529,BILD 1,A01,894154,Staff,3,0,19,16
1746591288529,BILD 1,A02,894155,Staff,14,0,19,5
1746591288529,BILD 1,A03,894160,Staff,13,0,19,6
1746591288529,BILD 1,A04,894161,Staff,15,0,18,3
1746591289555,BILD 2,A01,894168,Staff,0,0,50,50
1746591289555,BILD 2,A02,894169,Staff,0,0,50,50
1746591289555,BILD 2,A03,894179,Staff,0,0,50,50
1746591289555,BILD 2,A04,894203,Staff,23,0,50,27
1746591290584,BILD 3,A01,894213,Staff,23,0,31,8
1746591290584,BILD 3,A02,894214,Staff,26,0,31,5
1746591290584,BILD 3,A03,894235,Staff,28,0,31,3
1746591290584,BILD 3,A04,894236,Staff,28,0,32,4
1746591291614,BILD 4,A01,894253,Reuther; Keefe,5,0,24,19
1746591291614,BILD 4,A02,894258,Reuther; Keefe,16,0,24,8
1746591292642,BILD 5,A01,894276,Reuther; Keefe,34,0,50,16
1746591292642,BILD 5,A02,894277,Reuther; Keefe,45,0,50,5
1746591292642,BILD 5,A03,894290,Reuther; Keefe,44,0,50,6
1746591292642,BILD 5,A04,894291,Reuther; Keefe,48,0,50,2
1746591293672,BILD 24,A01,894297,Pirino; Giorgia,40,0,60,20
1746591294698,BIMM 100,B01,958915,Staff,71,0,100,29
1746591295729,BIMM 101,A01,895017,McDonnell; Lisa Marie,0,5,24,24
1746591295729,BIMM 101,A02,895018,McDonnell; Lisa Marie,0,5,24,24
1746591295729,BIMM 101,B01,895020,McDonnell; Lisa Marie,1,6,24,23
1746591295729,BIMM 101,B02,895021,McDonnell; Lisa Marie,0,4,24,24
1746591296755,BIMM 110,A01,895023,Staff,1,0,25,24
1746591296755,BIMM 110,A02,895024,Staff,9,0,25,16
1746591296755,BIMM 110,A03,895025,Staff,18,0,25,7
1746591296755,BIMM 110,A04,895031,Staff,20,0,25,5
1746591297783,BIMM 120,A01,895114,Gustafson-Brown; Cindy,14,0,28,14
1746591297783,BIMM 120,A02,895126,Gustafson-Brown; Cindy,21,0,27,6
1746591298811,BIPN 100,A01,895130,Yang; Mingyu,0,0,38,38
1746591298811,BIPN 100,A02,895131,Yang; Mingyu,31,0,38,7
1746591298811,BIPN 100,A03,895132,Yang; Mingyu,32,0,38,6
1746591298811,BIPN 100,A04,895133,Yang; Mingyu,27,0,36,9
1746591299842,BIPN 120,A01,895135,Cooke; James Edward,0,3,13,13
1746591299842,BIPN 120,A02,895136,Cooke; James Edward,0,1,13,13
1746591299842,BIPN 120,A03,895137,Cooke; James Edward,0,3,13,13
1746591299842,BIPN 120,A04,895156,Cooke; James Edward,0,2,11,11
1746591300867,BIPN 134,A01,895235,Cooke; James Edward,0,1,25,25
1746591300867,BIPN 134,A02,895237,Cooke; James Edward,0,0,25,25
1746591300867,BIPN 134,A03,895240,Cooke; James Edward,2,0,25,23
1746591300867,BIPN 134,A04,895270,Cooke; James Edward,20,0,25,5
1746591301893,BIPN 189,A00,892103,Staff,0,14,14,14
1746591303951,BISP 194,A00,958008,Staff,0,2,0,0
1746591304976,CAT 124,A01,922009,Staff,0,5,20,20
1746591306006,CAT 125R,A00,886390,Morales; Celeste Georgianna,0,3,20,20
1746591306006,CAT 125R,B00,886391,Irwin; Matthew Joseph,0,4,20,20
1746591306006,CAT 125R,C00,886392,Smith; Lauryn Alissa,0,2,20,20
1746591306006,CAT 125R,D00,886393,Vanderschuit; Maya Alysia,0,3,20,20
1746591306006,CAT 125R,E00,886394,Marchisotto; Jennifer Anne,0,3,20,20
1746591307034,CENG 15,A01,886218,Drews; Aaron,3,0,8,5
1746591308058,CENG 113,A00,886219,Opatkiewicz; Justin Paul,15,0,25,10
1746591309084,CGS 101,A00,887044,Staff,7,0,20,13
1746591310110,CGS 105,A01,887046,Staff,14,0,25,11
1746591311134,CGS 112,A00,887047,Cuong; Marisol,12,0,15,3
1746591312193,CGS 113,A00,887048,Staff,23,0,30,7
1746591313217,CGS 120,A00,887049,Staff,10,0,17,7
1746591314244,CHEM 6A,A01,886336,Lam; Tin Yiu,38,0,50,12
1746591314244,CHEM 6A,A02,886338,Lam; Tin Yiu,37,0,50,13
1746591315272,CHEM 6B,A01,886341,Hopkins; Patrycja Anna,16,0,50,34
1746591315272,CHEM 6B,A02,886343,Hopkins; Patrycja Anna,42,0,50,8
1746591316301,CHEM 6C,A01,886346,Albizati; Kim F.,0,2,50,50
1746591316301,CHEM 6C,A02,886348,Albizati; Kim F.,24,0,50,26
1746591317329,CHEM 40A,A01,886352,Klosterman; Jeremy K,65,0,100,35
1746591318360,CHEM 40B,A01,886356,Klosterman; Jeremy K,0,24,100,100
1746591319386,CHEM 41B,A01,886360,Theodorakis; Emmanuel,25,0,50,25
1746591319386,CHEM 41B,A02,886362,Theodorakis; Emmanuel,47,0,50,3
1746591320410,CHIN 165A,A00,886382,Xu; Li,18,0,20,2
1746591321439,CLAS 120,A00,886387,Myerston Santana; Jacobo,33,0,40,7
1746591322464,COGS 9,A01,886967,Shannon; Kyle Michael,42,0,60,18
1746591323488,COGS 11,A01,886969,Staff,9,0,30,21
1746591324518,COGS 14A,A01,886971,Staff,5,0,60,55
1746591325592,COGS 14B,A01,886973,Hoffman; Drew Ellen,4,0,60,56
1746591326618,COGS 18,A01,886975,Morgan; Eric,34,0,60,26
1746591327752,COGS 20,A01,886977,Staff,2,0,8,6
1746591327752,COGS 20,A02,886978,Staff,4,0,7,3
1746591328775,COGS 100,A01,907783,Staff,1,2,30,29
1746591329803,COGS 101B,A01,886980,Staff,0,4,48,48
1746591330833,COGS 101C,A01,886982,Delgado; Tania,0,5,44,44
1746591331859,COGS 102A,A01,886984,Johnson; Christine M.,3,0,30,27
1746591332884,COGS 118B,A01,886986,Staff,1,5,88,87
1746591333913,COGS 150,A01,886988,Bergen; Benjamin,22,0,50,28
1746591334940,COGS 153,A00,886989,Delgado; Tania,0,3,41,41
1746591335966,COGS 186,A01,886991,Staff,0,0,32,32
1746591336994,COGS 187A,A01,886993,Boyle; Mary E. T.,7,0,30,23
1746591338019,COGS 189,A00,886994,Staff,0,1,30,30
1746591339045,COMM 10,A01,886996,Staff,0,0,20,21
1746591339045,COMM 10,A02,886997,Staff,10,0,20,10
1746591339045,COMM 10,A03,959845,Staff,19,0,20,1
1746591340072,COMM 20,A01,886999,Leuning; Grant Maurstad,24,0,40,16
1746591342127,COMM 100A,A01,887002,Staff,0,0,20,25
1746591342127,COMM 100A,A02,887003,Staff,6,0,20,14
1746591343156,COMM 100B,A01,887005,Staff,0,8,20,24
1746591344183,COMM 106D,A00,887006,Staff,13,0,40,27
1746591345208,COMM 110G,A00,887007,Whitworth-Smith; Andrew C,12,0,40,28
1746591346238,COMM 111B,A00,887008,Staff,31,0,40,9
1746591347268,COMM 113T,A00,887009,Abuelhiga; Soraya Jill,28,0,40,12
1746591347268,COMM 113T,B00,906733,Staff,40,0,40,0
1746591348299,COMM 145,A00,887010,Staff,12,0,40,28
1746591349326,COMM 146,A00,887054,Staff,31,0,40,9
1746591350352,COMM 190,A00,887012,Staff,8,0,23,15
1746591351378,CSE 8A,A50,887015,Cao; Yingjun,56,0,85,29
1746591352406,CSE 11,A01,887017,Cao; Yingjun,11,0,70,59
1746591353430,CSE 20,A01,887019,Staff,30,0,50,20
1746591354462,CSE 21,A01,887021,Staff,79,0,100,21
1746591354462,CSE 21,B01,892583,Braun; Oliver,45,0,50,5
1746591355486,CSE 30,A01,887025,Eldon; John,142,0,200,58
1746591356510,CSE 100,A01,887027,Staff,26,0,50,24
1746591356510,CSE 100,A02,887028,Staff,42,0,50,8
1746591357537,CSE 101,A01,887030,Braun; Oliver,74,0,100,26
1746591357537,CSE 101,B01,887032,Jones; Miles E,0,3,50,50
1746591357537,CSE 101,B02,887033,Jones; Miles E,0,2,50,50
1746591358564,CSE 105,A01,908084,Jones; Miles E,32,0,50,18
1746591358564,CSE 105,A02,908087,Jones; Miles E,31,0,50,19
1746591359590,CSE 135,A01,887035,Powell; Thomas Allan,0,5,50,50
1746591360618,CSE 142,A01,887037,Staff,8,0,60,52
1746591361645,CSE 142L,A01,887039,Staff,34,0,60,26
1746591362670,CSE 151A,A01,887041,Solares; Edwin A,47,0,100,53
1746591363694,CSE 175,A01,887043,Kumar; Rakesh,30,0,30,0
1746591364723,CSS 1,A01,886389,Staff,1,2,40,39
1746591365753,DSC 30,A01,908097,Liao; Soohyun Nam,47,0,75,28
1746591366779,DSC 40A,A01,908099,Shannon; Kyle Michael,30,0,50,20
1746591367803,DSC 40B,A01,908112,Staff,15,0,50,35
1746591368831,DSC 80,A01,908116,Staff,19,0,60,41
1746591369860,DSC 197,001,956863,Eldridge; Justin Matthew,9999,0,9999,0
1746591370887,ECE 5,A01,886400,Morris; Karcher William,1,0,6,5
1746591370887,ECE 5,A02,886401,Morris; Karcher William,3,0,6,3
1746591371911,ECE 148,A01,886403,Silberman; Jack,0,14,14,14
1746591372940,ECON 1,A01,887265,Crane; Meredith Helen,11,0,70,59
1746591372940,ECON 1,B01,887268,Staff,42,0,50,8
1746591373967,ECON 2,A01,887273,Crane; Meredith Helen,54,0,70,16
1746591374996,ECON 3,A01,887279,Rondina; Giacomo,31,0,70,39
1746591376022,ECON 4,A01,887282,Anderson; John Charles,0,2,10,10
1746591377052,ECON 5,A01,887285,Staff,34,0,45,11
1746591377052,ECON 5,B01,887292,Staff,41,0,45,4
1746591378077,ECON 100A,A01,887337,Newhouse; Herbert S,54,0,70,16
1746591378077,ECON 100A,B01,887349,Staff,45,0,50,5
1746591379106,ECON 100B,A01,887361,Du; Songzi,29,0,70,41
1746591380136,ECON 100C,A01,887445,Newhouse; Herbert S,59,0,70,11
1746591381161,ECON 105,A00,887488,Vespa; Emanuel Ignacio,23,0,35,12
1746591382185,ECON 109,A01,887506,Shishkin; Denis,28,0,35,7
1746591383214,ECON 110A,A01,887568,Alon; Titan Michael,1,3,35,34
1746591383214,ECON 110A,B01,907601,Alon; Titan Michael,20,0,35,15
1746591384239,ECON 110B,A01,887598,Levkoff; Steven B.,0,24,70,70
1746591385264,ECON 112,A00,887599,Rondina; Giacomo,19,0,35,16
1746591386289,ECON 120A,A01,887603,Dai; Yinlin,35,0,70,35
1746591387317,ECON 120C,A01,887608,Sun; Yixiao,0,1,35,35
1746591387317,ECON 120C,B01,887614,Sun; Yixiao,0,0,35,35
1746591388342,ECON 138,A00,887621,Bharadwaj; Prashant,0,21,20,20
1746591389368,ECON 144,A00,958007,Squires; Dale E,12,0,35,23
1746591390393,ECON 171,A01,907666,Staff,18,0,35,17
1746591391422,ECON 175,A00,887626,Wu; Pak Yeung,22,0,35,13
1746591392448,ECON 190,A00,887640,Vespa; Emanuel Ignacio,22,0,35,13
1746591393484,EDS 25,A01,888197,Staff,0,0,0,0
1746591393484,EDS 25,A02,888209,Staff,0,0,0,0
1746591393484,EDS 25,A03,888210,Staff,0,0,0,0
1746591393484,EDS 25,A04,888212,Staff,0,0,0,0
1746591393484,EDS 25,A05,888213,Staff,0,0,0,0
1746591393484,EDS 25,A06,888214,Staff,0,0,0,0
1746591393484,EDS 25,A07,888235,Staff,0,2,0,0
1746591393484,EDS 25,A08,888236,Staff,0,0,0,0
1746591393484,EDS 25,A09,888240,Staff,0,0,0,0
1746591393484,EDS 25,A10,888244,Staff,0,0,0,0
1746591393484,EDS 25,B01,888273,Staff,0,0,0,0
1746591393484,EDS 25,B02,888285,Staff,0,0,0,0
1746591393484,EDS 25,B03,888423,Staff,0,0,0,1
1746591393484,EDS 25,B04,888432,Staff,0,0,0,0
1746591393484,EDS 25,B05,888433,Staff,0,0,0,0
1746591393484,EDS 25,B06,888467,Staff,0,0,0,0
1746591393484,EDS 25,B07,888468,Staff,0,0,0,0
1746591393484,EDS 25,B08,888479,Staff,0,0,0,0
1746591393484,EDS 25,B09,888484,Staff,0,0,0,0
1746591393484,EDS 25,B10,888487,Staff,0,0,0,0
1746591394511,EDS 38,A01,907700,Choi; Bailey Miyeon,30,0,30,0
1746591395536,EDS 112,A01,888601,Chapman; Thandeka K,12,0,40,28
1746591396563,EDS 115,A00,888697,Mendez; Kathrina Mendoza,10,0,30,20
1746591397591,EDS 116,A01,888893,Staff,33,0,40,7
1746591399644,EDS 124AR,A00,889133,Staff,29,0,50,21
1746591399644,EDS 124AR,B00,907471,Simon; Elizabeth A,37,0,50,13
1746591400670,EDS 124BR,A00,889134,Simon; Elizabeth A,44,0,100,56
1746591401700,EDS 125,A00,889135,Staff,25,0,30,5
1746591402727,EDS 126,A01,889138,Staff,35,0,40,5
1746591403752,EDS 164R,A01,889142,Wishard Guerra; Alison G.,32,0,50,18
1746591404781,ENG 30,A01,886396,Staff,0,0,0,0
1746591404781,ENG 30,B01,886398,Staff,0,0,0,0
1746591405811,ENVR 102,A00,906150,Montejo; Carolina,23,0,25,2
1746591406841,ETHN 103A,A00,887236,Man; Simeon S,0,2,0,0
1746591407868,ETHN 113,A00,887239,Staff,16,0,30,14
1746591408897,ETHN 116,A00,887240,Staff,16,0,25,9
1746591409921,ETHN 117,A00,887241,Choi; Esther Min,28,0,30,2
1746591410947,ETHN 118,A00,887243,Staff,24,0,30,6
1746591411975,ETHN 127,A00,887248,Cuong; Marisol,11,0,15,4
1746591413000,ETHN 139,A00,887250,Staff,7,0,10,3
1746591414026,ETHN 142,A00,887252,Staff,10,0,30,20
1746591415052,ETHN 161,A00,887253,Browne; Errol Tsekani,24,0,30,6
1746591416076,ETHN 163FR,A00,887255,Burelle; Julie Sara Veronique,0,0,5,5
1746591417103,GLBH 20,A00,889149,Elwardani; Nile Regina,8,0,42,34
1746591419155,GLBH 111,A01,889152,Burgos; Jose L.,17,0,17,0
1746591420184,GLBH 150,A00,889181,Sloane; Julia Kathryn,0,5,15,15
1746591422241,HDS 60,A01,886406,Warstadt; Melissa Fawn,72,0,80,8
1746591423266,HIAF 111,A00,889324,Gyamfi; Bright,25,0,32,7
1746591424291,HIEA 131,A00,889328,Staff,15,0,32,17
1746591425320,HIEA 144,A00,889333,Henry; Todd A.,26,0,32,6
1746591426348,HIEA 154,A00,889336,Henry; Todd A.,24,0,32,8
1746591427374,HIEU 106,A00,889339,Staff,22,0,32,10
1746591429428,HIEU 114,A00,889340,Staff,4,0,32,28
1746591430455,HIEU 135GS,A00,889342,Patterson; Patrick H.,0,0,1,24
1746591431480,HIEU 137,A00,889343,Edington; Claire Ellen,10,0,25,15
1746591432507,HIEU 148,A00,889345,Staff,14,0,32,18
1746591433532,HIEU 154,A00,889346,Biess; Frank Peter,21,0,32,11
1746591434560,HILA 102,A00,889351,Staff,12,0,32,20
1746591435586,HILD 2A,A01,889221,Lewandoski; Julia Mavis,2,10,32,30
1746591436652,HILD 7B,A01,889225,Man; Simeon S,0,12,32,32
1746591437680,HILD 7C,A01,889288,Alvarez; Luis A,0,14,32,32
1746591438705,HILD 30,A01,889323,Staff,0,5,32,32
1746591440760,HISC 119,A00,889383,Golan; Tal,19,0,32,13
1746591441789,HIUS 103,A00,889384,Man; Simeon S,0,0,32,32
1746591442817,HIUS 117,A00,919797,Kwak; Nancy,18,0,32,14
1746591443844,HIUS 142A,A00,919788,Staff,22,0,32,10
1746591445897,HIUS 149,A00,889386,Gyamfi; Bright,26,0,32,6
1746591446924,HIUS 155,A00,889387,Alvarez; Luis A,15,0,32,17
1746591447953,HUM 3,A01,886499,Caldwell; Michael Alan,19,0,50,31
1746591448983,HUM 3GS,A00,886500,Rodriguez; Bretton Sigfred,0,0,0,28
1746591450009,HUM 3R,A01,886502,Markman; Kristina,0,36,50,50
1746591451039,HUM 4,A01,886504,Crum; Matthew Stephen,23,0,50,27
1746591451039,HUM 4,B01,886506,West; Geoffrey Scott,17,0,50,33
1746591452065,HUM 4GS,A00,886507,Staff,0,0,0,19
1746591453093,HUM 5,A01,886509,Staff,31,0,50,19
1746591454126,HUM 5R,A01,886511,Zavodny; Tatiana Sophia,0,39,50,50
1746591455154,JAPN 180,A00,886407,Staff,16,0,40,24
1746591456184,LATI 50,A01,886409,Martin-Cabrera; Luis,3,0,22,19
1746591456184,LATI 50,A02,886410,Martin-Cabrera; Luis,19,0,22,3
1746591456184,LATI 50,A03,886411,Martin-Cabrera; Luis,21,0,22,1
1746591456184,LATI 50,A04,886412,Martin-Cabrera; Luis,8,0,22,14
1746591457209,LAWS 101,A00,907664,Staff,28,0,60,32
1746591458237,LIAB 1A,A00,889388,Saab; Dima,17,0,20,3
1746591459265,LIAB 1AX,A00,889389,El Cheddadi; Youniss,18,0,20,2
1746591460296,LIFR 1C,A00,889391,Van Moer; Vinciane G,8,0,20,12
1746591461322,LIFR 1CX,A00,889392,Van Moer; Vinciane G,7,0,20,13
1746591462348,LIFR 1D,A00,889393,Van Moer; Vinciane G,7,0,20,13
1746591463374,LIFR 1DX,A00,889394,Van Moer; Vinciane G,8,0,20,12
1746591464400,LIGN 7,A00,886923,Staff,24,0,50,26
1746591465428,LIGN 17,A00,886924,Kehler; Andrew Scott,125,0,150,25
1746591466455,LTAM 110,A00,889395,Staff,15,0,30,15
1746591467480,LTAM 110GS,A00,958010,Rodriguez; Bretton Sigfred,0,0,0,28
1746591468505,LTCH 101,A00,889397,Staff,23,0,25,2
1746591469531,LTCS 130,A00,889398,Staff,23,0,25,2
1746591470558,LTEA 138,A00,889399,Staff,24,0,40,16
1746591471586,LTEN 149,A00,889400,Wesling; Megan E.,0,3,25,25
1746591472612,LTEN 169,A00,889401,Staff,20,0,25,5
1746591473638,LTEN 180,A00,889402,Staff,10,0,15,5
1746591474666,LTEN 181,A00,889403,Staff,21,0,25,4
1746591475691,LTWL 100,A00,889404,Myerston Santana; Jacobo,2,0,25,23
1746591476718,LTWL 180GS,A00,889405,Staff,0,0,20,20
1746591477759,LTWL 181,A00,889406,Staff,16,0,25,9
1746591478785,LTWL 184,A00,889475,Mukherjee; Silpa,22,0,25,3
1746591479811,LTWR 102C,A00,889486,Staff,29,0,30,1
1746591480837,LTWR 115W,A00,889491,Staff,0,2,15,15
1746591481863,MAE 8,A01,886905,Staff,0,2,0,0
1746591482890,MAE 11,A00,886906,Bandaru; Prabhakar,0,7,50,50
1746591483917,MAE 20,A00,886907,Evdokimenko; Ekaterina,43,0,70,27
1746591484946,MAE 30B,A00,886909,Ghazinejad; Maziar,25,0,45,20
1746591485971,MAE 101B,A00,886910,Saintillan; David,29,0,45,16
1746591487000,MAE 105,A00,886911,Bandaru; Prabhakar,18,0,50,32
1746591488029,MAE 107,B00,958024,Staff,7,0,50,43
1746591489059,MAE 143B,A00,886913,Bewley; Thomas R,3,0,40,37
1746591490088,MAE 148,A01,886915,Silberman; Jack,0,3,14,14
1746591491114,MAE 160,A00,886916,Evdokimenko; Ekaterina,31,0,60,29
1746591492144,MATH 3C,A01,889681,Staff,0,2,30,30
1746591492144,MATH 3C,A02,960048,Staff,23,0,30,7
1746591493168,MATH 10A,A01,889760,Staff,26,0,30,4
1746591493168,MATH 10A,A02,889783,Staff,29,0,30,1
1746591494196,MATH 10B,A01,889785,Verstraete; Jacques Allan,1,0,35,34
1746591494196,MATH 10B,A02,889795,Verstraete; Jacques Allan,4,0,35,31
1746591494196,MATH 10B,B01,889797,Verstraete; Jacques Allan,3,0,35,32
1746591494196,MATH 10B,B02,889828,Verstraete; Jacques Allan,3,0,35,32
1746591495223,MATH 10C,A01,889849,Habib; Yousaf,8,0,30,22
1746591495223,MATH 10C,A02,889852,Habib; Yousaf,14,0,30,16
1746591495223,MATH 10C,A03,889853,Habib; Yousaf,22,0,30,8
1746591495223,MATH 10C,A04,889858,Habib; Yousaf,20,0,30,10
1746591495223,MATH 10C,B01,889861,Staff,1,0,30,29
1746591495223,MATH 10C,B02,889862,Staff,24,0,30,6
1746591495223,MATH 10C,B03,889863,Staff,27,0,30,3
1746591495223,MATH 10C,B04,889967,Staff,23,0,30,7
1746591496248,MATH 18,A01,889974,Staff,7,0,30,23
1746591496248,MATH 18,A02,889977,Staff,20,0,30,10
1746591496248,MATH 18,B01,889984,Hardiman; Liam,20,0,30,10
1746591496248,MATH 18,B02,889985,Hardiman; Liam,25,0,30,5
1746591497278,MATH 20A,A01,889990,Suk; Andrew Hoon,30,0,35,5
1746591498304,MATH 20B,A01,889993,Ohm; Ko Woon,21,0,30,9
1746591498304,MATH 20B,A02,889994,Ohm; Ko Woon,30,0,30,0
1746591498304,MATH 20B,B01,889996,Ohm; Ko Woon,22,0,30,8
1746591498304,MATH 20B,B02,889997,Ohm; Ko Woon,23,0,30,7
1746591499333,MATH 20C,A01,889999,Hammock; Frances H,17,0,30,13
1746591499333,MATH 20C,A02,890003,Hammock; Frances H,23,0,30,7
1746591499333,MATH 20C,B01,890006,Hammock; Frances H,3,0,30,27
1746591499333,MATH 20C,B02,890007,Hammock; Frances H,12,0,30,18
1746591500363,MATH 20D,A01,890011,Cheng; Hsiao-Bing,1,1,30,29
1746591500363,MATH 20D,A02,890012,Cheng; Hsiao-Bing,14,0,30,16
1746591500363,MATH 20D,B01,890016,Cheng; Hsiao-Bing,13,0,30,17
1746591500363,MATH 20D,B02,890017,Cheng; Hsiao-Bing,13,0,30,17
1746591501389,MATH 20E,A01,890026,Harel; Guershon,1,0,30,29
1746591501389,MATH 20E,A02,890029,Harel; Guershon,22,0,30,8
1746591501389,MATH 20E,B01,890033,Harel; Guershon,7,0,30,23
1746591501389,MATH 20E,B02,890101,Harel; Guershon,21,0,30,9
1746591502425,MATH 102,A01,890104,Staff,18,0,30,12
1746591502425,MATH 102,A02,890105,Staff,27,0,30,3
1746591503451,MATH 103B,A01,890116,Salehi Golsefidy; Alireza,3,0,30,27
1746591503451,MATH 103B,B01,890118,Staff,0,3,34,34
1746591504481,MATH 109,A01,890121,Aliabadi Sr.; Mohsen,0,0,30,30
1746591504481,MATH 109,B01,890124,Upadrashta; Pranav Kumar,18,0,30,12
1746591505507,MATH 120A,A01,890126,Eggers; John Dietrich,13,0,30,17
1746591506537,MATH 142B,A01,890128,Ioana; Adrian,19,0,30,11
1746591506537,MATH 142B,A02,890129,Ioana; Adrian,12,0,30,18
1746591507564,MATH 154,A01,890174,Staff,0,1,30,30
1746591507564,MATH 154,A02,890182,Staff,0,0,30,30
1746591508592,MATH 168A,A01,890197,Dumitriu; Ioana,21,0,35,14
1746591509617,MATH 170A,A01,890240,Nie; Jiawang,1,0,30,29
1746591509617,MATH 170A,A02,890241,Nie; Jiawang,11,0,30,19
1746591509617,MATH 170A,A03,890249,Nie; Jiawang,23,0,30,7
1746591510646,MATH 170B,A01,957891,Nag; Panchali,13,0,35,22
1746591512702,MATH 181A,A01,908025,Staff,0,3,35,35
1746591512702,MATH 181A,A02,960115,Staff,26,0,35,9
1746591513738,MATH 181B,A01,959874,Staff,25,0,30,5
1746591514765,MATH 193B,A01,890265,Staff,0,4,35,35
1746591515790,MGT 4,A01,890311,Anderson; John Charles,42,0,88,46
1746591516819,MGT 5,A00,907740,Staff,12,0,98,86
1746591517843,MGT 12,A00,890312,Lindenberger; Wade Douglas,67,0,98,31
1746591518873,MGT 16,A00,957883,Staff,78,0,98,20
1746591520925,MGT 45,A00,890314,Pecore; Joseph P.,45,0,98,53
1746591521951,MGT 71,A00,890315,Staff,0,12,98,98
1746591522975,MGT 100,A00,890316,Yavorsky; Daniel Ryan,44,0,98,54
1746591524001,MGT 103,A00,890317,Ehrich; Kristine R,73,0,98,25
1746591525025,MGT 105,A00,890356,Bates; Kenneth Walter,0,8,98,98
1746591526050,MGT 112,A00,890360,Ehrich; Kristine R,55,0,98,43
1746591527076,MGT 127R,A00,907732,Zhu; Kevin Xiaoguo,23,0,98,75
1746591528105,MGT 131B,A00,890361,Anderson; John Charles,59,0,98,39
1746591529132,MGT 137,A00,890362,Lindenberger; Wade Douglas,65,0,98,33
1746591530162,MGT 160,A00,890369,Johnson; Erik Barry,9,0,98,89
1746591532215,MGT 164,A00,890372,Zimmermann; Carsten,0,40,98,98
1746591533244,MGT 180,A00,890374,Bliss; Barbara Ann,11,0,98,87
1746591534270,MMW 15,A01,886414,Chang; Edmond Yi-Teh,0,12,28,28
1746591534270,MMW 15,A02,886415,Chang; Edmond Yi-Teh,0,8,28,28
1746591534270,MMW 15,A03,886416,Chang; Edmond Yi-Teh,0,9,28,28
1746591534270,MMW 15,A04,886417,Chang; Edmond Yi-Teh,0,8,28,28
1746591534270,MMW 15,B01,886419,Chang; Edmond Yi-Teh,0,7,28,28
1746591534270,MMW 15,B02,886420,Chang; Edmond Yi-Teh,0,8,28,28
1746591534270,MMW 15,B03,886421,Chang; Edmond Yi-Teh,0,7,28,28
1746591534270,MMW 15,B04,886422,Chang; Edmond Yi-Teh,0,8,28,28
1746591534270,MMW 15,C01,886424,Staff,0,9,28,28
1746591534270,MMW 15,C02,886425,Staff,0,8,28,28
1746591534270,MMW 15,C03,886426,Staff,0,8,28,28
1746591534270,MMW 15,C04,886427,Staff,0,8,28,28
1746591534270,MMW 15,C05,958038,Staff,0,8,28,28
1746591534270,MMW 15,C06,958039,Staff,1,8,28,27
1746591535298,MMW 15GS,A00,906910,Patterson; Patrick H.,4,0,28,24
1746591536327,MMW 122R,A01,886429,Rahimi; Babak,0,13,28,28
1746591536327,MMW 122R,A02,886430,Rahimi; Babak,0,12,28,28
1746591536327,MMW 122R,A03,958040,Rahimi; Babak,0,11,28,28
1746591537356,MUS 1A,A01,890937,Staff,2,0,25,23
1746591537356,MUS 1A,A02,891035,Staff,6,0,25,19
1746591537356,MUS 1A,C01,958912,Staff,24,0,25,1
1746591537356,MUS 1A,C02,958913,Staff,25,0,25,0
1746591539409,MUS 2AK,A00,957092,Ohnishi; Takae,15,0,15,0
1746591540478,MUS 4,A01,891044,Staff,0,0,25,25
1746591540478,MUS 4,A02,891045,Staff,22,0,25,3
1746591540478,MUS 4,B01,891048,Staff,17,0,25,8
1746591540478,MUS 4,B02,891050,Staff,25,0,25,0
1746591541505,MUS 5,A01,957506,Dubnov; Shlomo,0,0,25,25
1746591541505,MUS 5,A02,957622,Dubnov; Shlomo,13,0,25,12
1746591541505,MUS 5,A03,957623,Dubnov; Shlomo,20,0,25,5
1746591542530,MUS 6,A01,891053,Freitas Caetano; Marcelo,24,0,25,1
1746591542530,MUS 6,A02,891054,Freitas Caetano; Marcelo,23,0,25,2
1746591543558,MUS 7,A01,891081,Staff,0,0,25,25
1746591543558,MUS 7,A02,891082,Staff,3,0,25,22
1746591544586,MUS 8GS,A00,891118,Borgo; David Garcia,1,0,25,24
1746591545612,MUS 11,A01,891140,Staff,9,0,25,16
1746591545612,MUS 11,A02,891141,Staff,21,0,25,4
1746591546638,MUS 13,A01,891143,Staff,8,0,25,17
1746591546638,MUS 13,A02,891144,Staff,24,0,25,1
1746591547667,MUS 15,A01,891146,Staff,9,0,25,16
1746591547667,MUS 15,A02,891148,Staff,21,0,25,4
1746591547667,MUS 15,B01,891150,Staff,18,0,25,7
1746591547667,MUS 15,B02,891151,Staff,25,0,25,0
1746591548696,MUS 20,A01,891153,Staff,5,0,20,15
1746591548696,MUS 20,A02,891155,Staff,14,0,20,6
1746591549722,MUS 80,A00,891156,Staff,19,0,25,6
1746591549722,MUS 80,B00,891157,Staff,23,0,25,2
1746591550748,MUS 130,A00,891158,Ohnishi; Takae,35,0,35,0
1746591551772,MUS 150GS,A01,891160,Borgo; David Garcia,1,0,25,24
1746591552802,MUS 170,A01,891162,Freitas Caetano; Marcelo,20,0,25,5
1746591552802,MUS 170,A02,891164,Freitas Caetano; Marcelo,21,0,25,4
1746591553832,NANO 11,A00,886220,Vazquez Mena; Oscar,13,0,15,2
1746591554860,NANO 15,A01,886222,Drews; Aaron,4,0,7,3
1746591555887,NANO 104,A00,886224,Sirbuly; Donald,17,0,25,8
1746591556914,PH 40,A00,886528,Staff,23,0,40,17
1746591557939,PH 45,A01,886799,Staff,35,0,40,5
1746591558966,PH 110,A00,886802,Staff,0,6,40,40
1746591559992,PH 172,A00,906716,Staff,19,0,35,16
1746591561021,PH 191,A00,886803,Staff,6,0,40,34
1746591562047,PHIL 1,A00,889500,Staff,20,0,30,10
1746591563071,PHIL 10,A01,889549,Grush; Rick Scott,16,0,22,6
1746591563071,PHIL 10,A02,889551,Grush; Rick Scott,22,0,22,0
1746591564097,PHIL 28,A01,889559,Lamey; Andy M.,0,2,31,31
1746591564097,PHIL 28,A02,889561,Lamey; Andy M.,0,1,30,30
1746591564097,PHIL 28,A03,889572,Lamey; Andy M.,0,1,30,30
1746591565121,PHIL 35,A00,907839,Staff,13,0,15,2
1746591566146,PHIL 60,A00,889574,Staff,73,0,90,17
1746591567171,PHIL 101,A00,958004,Staff,12,0,15,3
1746591569224,PHIL 136,A00,889582,Fulkerson; Matthew Todd,26,0,45,19
1746591570250,PHIL 163,A01,889601,Staff,21,0,30,9
1746591570250,PHIL 163,B01,889606,Brandt; Reuven A,0,3,0,0
1746591571276,PHIL 164,A00,889610,Staff,16,0,30,14
1746591572301,PHIL 165,A00,889613,Staff,22,0,30,8
1746591573327,PHYS 1A,A00,886431,Staff,30,0,70,40
1746591574353,PHYS 1AL,001,886432,Tsai; Philbert S,1,2,30,29
1746591574353,PHYS 1AL,002,886436,Tsai; Philbert S,13,0,30,17
1746591575378,PHYS 1B,A00,886439,Staff,184,0,240,56
1746591576406,PHYS 1BL,001,886441,Tsai; Philbert S,0,4,30,30
1746591576406,PHYS 1BL,002,886444,Tsai; Philbert S,2,0,30,28
1746591577431,PHYS 1C,A00,896092,Arnold; Kam S,78,0,146,68
1746591578458,PHYS 1CL,001,886448,Tsai; Philbert S,0,0,30,30
1746591578458,PHYS 1CL,002,886449,Tsai; Philbert S,1,0,30,29
1746591578458,PHYS 1CL,003,886450,Tsai; Philbert S,16,0,30,14
1746591578458,PHYS 1CL,004,886451,Tsai; Philbert S,15,0,30,15
1746591579483,PHYS 2B,A01,886457,Staff,67,0,115,48
1746591580510,PHYS 2C,A01,886460,Shotwell; Brian,0,9,65,65
1746591581536,PHYS 2CL,A01,886467,Staff,0,4,28,28
1746591581536,PHYS 2CL,A02,886468,Staff,0,3,28,28
1746591582562,PHYS 2D,A01,886470,Staff,10,0,50,40
1746591583589,PHYS 4B,A01,886475,Grinstein; Benjamin,22,0,40,18
1746591584613,POLI 5,A00,891173,Desposato; Scott,7,0,25,18
1746591585639,POLI 5D,A01,891175,Staff,5,0,5,0
1746591585639,POLI 5D,B01,891178,Staff,5,0,5,0
1746591586663,POLI 11,A00,891179,Ferree; Karen E,2,0,35,33
1746591587692,POLI 12,A00,891180,Staff,16,0,30,14
1746591588718,POLI 27,A01,891182,Staff,12,0,75,63
1746591589742,POLI 30,A00,891183,Staff,8,0,50,42
1746591590769,POLI 100B,A00,891244,Staff,5,1,35,30
1746591591794,POLI 100I,A00,891247,Staff,7,0,30,23
1746591592824,POLI 104J,A00,891248,Nichter; Maysa,14,0,30,16
1746591593851,POLI 104U,A00,891250,Nichter; Maysa,1,0,30,29
1746591595901,POLI 110B,A00,891255,Wiens; David,19,0,25,6
1746591596927,POLI 112A,A00,891256,Wiens; David,6,0,25,19
1746591597953,POLI 114BR,A00,891261,Staff,19,0,30,11
1746591598982,POLI 117R,A00,891262,Forman; Fonna,0,6,50,50
1746591600007,POLI 118,A00,891264,Ingham; Sean,17,0,25,8
1746591601035,POLI 124A,A00,891265,Staff,18,0,20,2
1746591602060,POLI 125D,A00,891266,Nichter; Simeon C,2,0,25,23
1746591603087,POLI 126,A00,891268,Nichter; Simeon C,7,0,25,18
1746591604114,POLI 126AA,A00,891272,Staff,15,0,25,10
1746591605138,POLI 130AA,A00,891273,Staff,15,0,20,5
1746591606167,POLI 134AA,A00,891274,Staff,4,0,20,16
1746591608222,POLI 138,A00,891278,Staff,21,0,25,4
1746591609248,POLI 142K,A00,891280,Staff,10,0,25,15
1746591610277,POLI 142M,A00,891281,Gartzke; Erik,16,0,30,14
1746591611304,POLI 142P,A00,891284,Staff,20,0,30,10
1746591612334,POLI 143,A00,891285,Gartzke; Erik,12,0,30,18
1746591613361,POLI 153,A00,891286,Staff,19,0,20,1
1746591615417,POLI 175,A00,891290,Staff,15,0,20,5
1746591616442,PSYC 1,A00,890674,Steiner; Eric Tomas,0,11,45,45
1746591617469,PSYC 2,A00,890676,Albright; Thomas D,20,0,35,15
1746591618494,PSYC 3,A00,890679,Staff,17,0,20,3
1746591619520,PSYC 6,A00,959858,Staff,19,0,20,1
1746591620545,PSYC 60,A01,890684,Rickard; Timothy C.,0,6,45,45
1746591621574,PSYC 70,A01,890689,Geller; Emma Harlan,6,0,30,24
1746591622600,PSYC 71,A01,959860,Staff,21,0,25,4
1746591623626,PSYC 100,A00,890690,Lacefield; Katharine I,0,50,180,180
1746591624653,PSYC 102,A00,890695,Staff,18,0,40,22
1746591625680,PSYC 105,A00,890699,Geller; Emma Harlan,70,0,100,30
1746591626705,PSYC 106,A00,890701,Gorman; Michael R.,5,0,30,25
1746591627734,PSYC 108,A00,890704,Adrian; Julia Anna,0,29,50,50
1746591628759,PSYC 118,A01,890712,Staff,11,0,30,19
1746591629789,PSYC 124,A00,890716,Chapman; Eddie Nathaniel,25,0,60,35
1746591630815,PSYC 131,A00,890717,Anagnostaras; Stephan,0,7,80,80
1746591631841,PSYC 137,A00,890719,Winkielman; Piotr,0,11,30,30
1746591632868,PSYC 144,A00,890721,Adrian; Julia Anna,0,9,45,45
1746591633896,PSYC 162,A00,890805,Staff,0,1,75,75
1746591634921,PSYC 169,A00,890810,Staff,0,15,30,30
1746591635945,PSYC 172,A00,890814,Gorman; Michael R.,9,0,30,21
1746591636972,PSYC 181,A00,890818,Anagnostaras; Stephan,7,0,200,193
1746591637998,PSYC 184,A00,959861,Staff,163,0,175,12
1746591639025,PSYC 189,A00,890823,Staff,0,2,30,30
1746591640055,PSYC 191,A00,890884,Rickard; Timothy C.,0,12,35,35
1746591641079,PSYC 193,A00,890913,Staff,19,0,30,11
1746591641079,PSYC 193,B00,890914,Chapman; Eddie Nathaniel,24,0,30,6
1746591642108,PSYC 193L,A01,890918,Lowe; Angela Beth,20,0,30,10
1746591642108,PSYC 193L,B01,890921,Hurwitz; Ethan Scott,20,0,30,10
1746591642108,PSYC 193L,C01,890928,Staff,30,0,30,0
1746591643133,RELI 149,A00,886806,Rahimi; Babak,23,0,40,17
1746591644213,SE 9,A01,886814,Staff,7,0,20,13
1746591645238,SE 101B,A01,886816,Chadha; Mayank,3,0,35,32
1746591646266,SE 110B,A00,886818,Zhu; Qiang,4,0,75,71
1746591647294,SE 125,A01,886830,Staff,10,0,30,20
1746591648320,SE 130B,A01,886835,Staff,14,0,40,26
1746591649345,SE 131A,A01,886838,Krysl; Petr,34,0,55,21
1746591650373,SE 154,A00,886840,Staff,28,0,50,22
1746591651401,SE 164GS,A01,886849,Staff,6,0,20,14
1746591652427,SE 167GS,A01,886853,Staff,6,0,20,14
1746591653453,SIO 25,A01,890107,Staff,19,0,30,11
1746591654478,SIO 45,A00,890109,Cook; Geoffrey W,116,0,200,84
1746591655503,SIO 109R,A00,890110,Forman; Fonna,0,16,20,20
1746591656529,SIO 187,A01,890114,Kacev; David,15,0,40,25
1746591657557,SOCI 1,A01,890431,Thorpe; Charles Robert,14,0,30,16
1746591657557,SOCI 1,A02,890518,Thorpe; Charles Robert,30,0,30,0
1746591658584,SOCI 2,A01,957978,Staff,25,0,25,0
1746591658584,SOCI 2,A02,957979,Staff,23,0,25,2
1746591659608,SOCI 20,A01,890523,Calderon-Zaks; Michael Aar,21,0,30,9
1746591659608,SOCI 20,A02,890526,Calderon-Zaks; Michael Aar,29,0,30,1
1746591660638,SOCI 30,A01,890533,Pardo Guerra; Juan Pablo,37,0,40,3
1746591661666,SOCI 40,A01,890535,Staff,27,0,45,18
1746591662695,SOCI 104Q,A00,890559,Staff,18,0,30,12
1746591663720,SOCI 106,A00,890560,Arnal; Maud Marie Leonie,20,0,30,10
1746591664744,SOCI 110,A00,890567,Holkenbrink-Monk; Charlene,19,0,30,11
1746591665772,SOCI 112,A00,890568,Victoria Torres; Pablo,2,0,55,53
1746591666800,SOCI 115,A00,890597,Arnal; Maud Marie Leonie,28,0,45,17
1746591668852,SOCI 121,A00,890604,Pardo Guerra; Juan Pablo,38,0,45,7
1746591669877,SOCI 126,A01,890608,Staff,8,0,10,2
1746591670903,SOCI 127,A00,890609,Staff,18,0,30,12
1746591671927,SOCI 131,A00,890610,Thorpe; Charles Robert,37,0,45,8
1746591672955,SOCI 135,A00,890615,Payne; Christine Anna,14,0,45,31
1746591673982,SOCI 139,A00,890620,Staff,38,0,45,7
1746591675007,SOCI 148E,A00,890622,Calderon-Zaks; Michael Aar,36,0,45,9
1746591676034,SOCI 150,A00,890623,Kohler; Kristopher M.,31,0,45,14
1746591677059,SOCI 157,A00,890625,Jules-Rosette; Bennetta W.,18,0,20,2
1746591678084,SOCI 160,A00,890627,Payne; Christine Anna,21,0,45,24
1746591679110,SYN 1,A00,886855,Fish; Gwendolyn Anne,0,1,0,0
1746591679110,SYN 1,B00,906086,Fish; Gwendolyn Anne,0,2,0,2
1746591680137,SYN 2R,A00,886860,Staff,0,17,15,15
1746591680137,SYN 2R,B00,906106,Atkinson; Arthur Laird,0,16,15,15
1746591681162,SYN 100,A01,886866,Browne; Emily,0,28,20,20
1746591681162,SYN 100,B01,906128,Rock; Martin,0,4,20,20
1746591681162,SYN 100,C01,906140,Deavenport; James Cary,0,4,20,20
1746591681162,SYN 100,D01,907816,Deavenport; James Cary,0,5,20,20
1746591682190,TDAC 1,A00,890286,Walsh; Kim C.,7,0,20,13
1746591683219,TDAC 101,A00,890296,Basso; Beatrice,15,0,20,5
1746591684244,TDDE 131,A00,890297,Staff,47,0,50,3
1746591685268,TDDM 1,A00,890287,Weinberg; Sadie,25,0,30,5
1746591686299,TDGE 11,A00,890288,Fulton; Julia,138,0,200,62
1746591686299,TDGE 11,B00,890289,Castro; Robert Jess,185,0,200,15
1746591687324,TDGE 25,B00,957359,Walsh; Kim C.,5,0,20,15
1746591688349,TDGE 40,A01,890292,Power; Jade Yukana,26,0,30,4
1746591689377,TDGE 124,A00,890298,Havis; Allan,0,2,50,50
1746591690402,TDGE 131R,A00,890299,Burelle; Julie Sara Veronique,15,0,42,27
1746591691430,TDHT 101,A00,890300,Staff,10,0,20,10
1746591692461,TDHT 109,A01,890302,Anderson; Mysia Anyse,31,0,40,9
1746591693487,TDMV 1,A00,890293,Arcidiacono; Kristin,18,0,30,12
1746591694515,TDMV 2,A00,890294,Weinberg; Sadie,23,0,30,7
1746591695541,TDMV 3,A00,957878,Arcidiacono; Kristin,28,0,30,2
1746591697597,TDMV 138,A00,890304,Jun; Grace Shin Hae,25,0,40,15
1746591698621,TDMV 140,A00,890305,Corrales; Joseph Bernales,25,0,30,5
1746591699647,TDMV 142,A00,890307,Caligagan; Tony,32,0,40,8
1746591700674,TDMV 144,A00,890308,Camaya; Michelle Ann,25,0,30,5
1746591701698,TDPW 1,A00,890295,Stein; Deborah Isobel,3,0,20,17
1746591702727,USP 2,A01,890272,Lerner; Amy M,7,0,20,13
1746591703755,USP 3,A01,890274,Staff,12,0,30,18
1746591704785,USP 15,A01,890276,Sun; Feiyang,16,0,30,14
1746591705811,USP 25,A00,890277,Shenkman; Michael Thomas,18,0,25,7
1746591706841,USP 138,A00,890278,Staff,13,0,25,12
1746591707867,USP 143,A00,890279,Staff,22,0,70,48
1746591708892,USP 144,A00,890280,Chowdhury; Muhammed Zohir,16,0,30,14
1746591709917,USP 150,A00,890281,Boomhower; Matthew Charles,4,0,30,26
1746591710947,USP 151,A00,890282,Staff,16,0,20,4
1746591711976,USP 162,A00,890283,Andrews; Abigail Leslie,16,0,20,4
1746591713001,USP 168,A00,920477,Kwak; Nancy,0,0,5,5
1746591714026,USP 181,A00,890284,Staff,3,0,20,17
1746591715050,USP 191A,A00,890285,Staff,12,0,20,8
1746591716075,VIS 101,A00,886512,Staff,26,0,75,49
1746591717100,VIS 103,A00,886513,Cruz; Edwin Teddy,61,0,75,14
1746591718125,VIS 108,A00,886514,Staff,3,0,15,12
1746591719152,VIS 127P,A00,886515,Shen; Kuiyi,79,0,146,67
1746591720181,VIS 149,A00,886516,Yoldas; Pinar,0,0,15,15
1746591721209,VIS 164,A00,886526,Erdmann; Dean,19,0,22,3
1746591722235,VIS 194S,A00,886527,Staff,61,0,75,14
1746591723259,WCWP 10A,C00,886484,Martiniuk; Jill,12,0,15,3
1746591724284,WCWP 10B,A00,886490,Uriarte; Emma,0,0,15,15
1746591724284,WCWP 10B,B00,886491,Dhir; Simrita,8,0,15,7
1746591724284,WCWP 10B,C00,886492,Ornelas; Tricia,0,0,15,15
1746591725315,WCWP 100,A00,886494,Young; Mark T,0,6,15,15
1746591727462,AAS 10,A01,886199,Childs; Dennis R.,0,3,0,0
1746591728491,ANAR 104,A01,886940,Shtienberg; Gilad,27,0,30,3
1746591729516,ANAR 120,A00,886953,Staff,13,0,20,7
1746591730542,ANBI 148,A01,886955,Wilder; Linnea Lorene,30,0,40,10
1746591732601,ANSC 122,A00,886957,Staff,24,0,30,6
1746591733631,ANSC 150,A00,886958,Sloane; Julia Kathryn,2,0,15,13
1746591734656,ANSC 156,A00,886959,Jenkins; Janis A.,0,1,15,15
1746591735683,ANSC 180,A00,886960,Staff,11,0,17,6
1746591736708,ANSC 188,A00,886961,Jassal; Aftab,9,0,25,16
1746591737741,ANSC 190,A00,886962,Jassal; Aftab,14,0,25,11
1746591738766,ANSC 191,A00,886963,Staff,18,0,20,2
1746591739794,ANTH 3,A01,891689,Staff,17,0,20,3
1746591740819,ANTH 5,A00,886933,Semendeferi; Ekaterini,16,0,20,4
1746591741846,ANTH 10,A00,886934,Staff,0,12,30,30
1746591742875,ANTH 21,A01,886936,Staff,41,0,60,19
1746591743901,ANTH 23,A01,886938,Staff,92,0,100,8
1746591744932,ANTH 105,A00,886964,Stewart; Alexander B,84,0,100,16
1746591745957,ANTH 108,A00,886965,Pedersen; David,9,0,20,11
1746591746983,AWP 10,001,886147,Staff,0,0,0,0
1746591746983,AWP 10,002,886148,Staff,0,0,0,0
1746591746983,AWP 10,003,886149,Staff,0,0,0,0
1746591746983,AWP 10,004,886150,Staff,0,0,0,0
1746591746983,AWP 10,005,886151,Staff,0,0,0,0
1746591746983,AWP 10,006,886152,Staff,0,0,0,0
1746591746983,AWP 10,007,886153,Staff,0,0,0,0
1746591746983,AWP 10,008,886154,Staff,0,0,0,0
1746591746983,AWP 10,009,886155,Staff,0,0,0,0
1746591746983,AWP 10,010,886156,Staff,0,0,0,0
1746591746983,AWP 10,011,886158,Staff,0,0,0,0
1746591746983,AWP 10,012,886160,Staff,0,0,0,0
1746591746983,AWP 10,013,886161,Staff,0,0,0,0
1746591746983,AWP 10,014,886162,Staff,0,0,0,0
1746591746983,AWP 10,015,886163,Staff,0,0,0,0
1746591746983,AWP 10,016,886164,Staff,0,0,0,0
1746591746983,AWP 10,017,886165,Staff,0,0,0,0
1746591746983,AWP 10,018,886166,Staff,0,0,0,0
1746591746983,AWP 10,019,886168,Staff,0,0,0,0
1746591746983,AWP 10,020,886170,Staff,0,0,0,0
1746591746983,AWP 10,021,886172,Staff,0,0,0,0
1746591748014,AWP 10R,001,886173,Staff,0,1,0,0
1746591748014,AWP 10R,002,886174,Staff,0,1,0,0
1746591748014,AWP 10R,003,886175,Staff,0,0,0,0
1746591748014,AWP 10R,004,886176,Staff,0,0,0,0
1746591748014,AWP 10R,005,886177,Staff,0,0,0,0
1746591748014,AWP 10R,006,886178,Staff,0,0,0,0
1746591748014,AWP 10R,007,886179,Staff,0,0,0,0
1746591748014,AWP 10R,008,886181,Staff,0,0,0,0
1746591748014,AWP 10R,009,886182,Staff,0,0,0,0
1746591748014,AWP 10R,010,886183,Staff,0,0,0,0
1746591748014,AWP 10R,011,886184,Staff,0,0,0,0
1746591748014,AWP 10R,012,886185,Staff,0,0,0,0
1746591748014,AWP 10R,013,886186,Staff,0,0,0,0
1746591748014,AWP 10R,014,886187,Staff,0,0,0,0
1746591748014,AWP 10R,015,886188,Staff,0,0,0,0
1746591748014,AWP 10R,016,886189,Staff,0,0,0,0
1746591748014,AWP 10R,017,960532,Staff,0,0,0,0
1746591748014,AWP 10R,018,960533,Staff,0,0,0,0
1746591748014,AWP 10R,019,960534,Staff,0,0,0,0
1746591748014,AWP 10R,020,960538,Staff,0,0,0,0
1746591748014,AWP 10R,021,960540,Staff,0,0,0,0
1746591748014,AWP 10R,022,960541,Staff,0,0,0,0
1746591748014,AWP 10R,023,960542,Staff,0,0,0,0
1746591748014,AWP 10R,024,960544,Staff,0,0,0,0
1746591748014,AWP 10R,025,960545,Staff,0,0,0,0
1746591748014,AWP 10R,026,960548,Staff,0,0,0,0
1746591749040,AWP 102R,A00,886190,Staff,0,0,0,0
1746591749040,AWP 102R,B00,886191,Staff,0,0,0,0
1746591750067,BENG 100,A01,886193,Staff,17,0,30,13
1746591751093,BENG 122A,A01,886195,Hasty; Jeff M,13,0,30,17
1746591752122,BENG 166A,A00,886196,Sah; Robert Lie-Yuan,0,3,30,30
1746591753147,BENG 190,A00,958050,Khojah; Reem I,17,0,25,8
1746591754171,BIBC 102,A01,894320,Staff,0,0,46,46
1746591754171,BIBC 102,A02,894321,Staff,0,0,46,46
1746591754171,BIBC 102,A03,894344,Staff,6,0,46,40
1746591754171,BIBC 102,A04,894345,Staff,27,0,47,20
1746591755201,BICD 100R,A01,894365,Smith; Laurie,1,3,58,57
1746591755201,BICD 100R,A02,894366,Smith; Laurie,1,5,58,57
1746591755201,BICD 100R,A03,894367,Smith; Laurie,0,0,59,59
1746591755201,BICD 100R,A04,959869,Smith; Laurie,39,0,59,20
1746591756227,BICD 136,A01,894383,Gustafson-Brown; Cindy,14,0,50,36
1746591757252,BIEB 102,A01,894494,Butler; Shannon Rhey,51,0,130,79
1746591759307,BIEB 150,A01,894617,Wills; Christopher,3,0,20,17
1746591759307,BIEB 150,A02,894631,Wills; Christopher,3,0,20,17
1746591759307,BIEB 150,A03,894937,Wills; Christopher,3,0,20,17
1746591759307,BIEB 150,A04,894946,Wills; Christopher,5,0,20,15
1746591760336,BIEB 194,A00,906141,Kurle; Carolyn M.,5,0,20,15
1746591761363,BILD 1,A01,894154,Staff,3,0,19,16
1746591761363,BILD 1,A02,894155,Staff,14,0,19,5
1746591761363,BILD 1,A03,894160,Staff,13,0,19,6
1746591761363,BILD 1,A04,894161,Staff,15,0,18,3
1746591762398,BILD 2,A01,894168,Staff,0,0,50,50
1746591762398,BILD 2,A02,894169,Staff,0,0,50,50
1746591762398,BILD 2,A03,894179,Staff,0,0,50,50
1746591762398,BILD 2,A04,894203,Staff,23,0,50,27
1746591763423,BILD 3,A01,894213,Staff,23,0,31,8
1746591763423,BILD 3,A02,894214,Staff,26,0,31,5
1746591763423,BILD 3,A03,894235,Staff,28,0,31,3
1746591763423,BILD 3,A04,894236,Staff,28,0,32,4
1746591764452,BILD 4,A01,894253,Reuther; Keefe,5,0,24,19
1746591764452,BILD 4,A02,894258,Reuther; Keefe,16,0,24,8
1746591765478,BILD 5,A01,894276,Reuther; Keefe,34,0,50,16
1746591765478,BILD 5,A02,894277,Reuther; Keefe,45,0,50,5
1746591765478,BILD 5,A03,894290,Reuther; Keefe,44,0,50,6
1746591765478,BILD 5,A04,894291,Reuther; Keefe,48,0,50,2
1746591766505,BILD 24,A01,894297,Pirino; Giorgia,40,0,60,20
1746591767535,BIMM 100,B01,958915,Staff,71,0,100,29
1746591768562,BIMM 101,A01,895017,McDonnell; Lisa Marie,0,5,24,24
1746591768562,BIMM 101,A02,895018,McDonnell; Lisa Marie,0,5,24,24
1746591768562,BIMM 101,B01,895020,McDonnell; Lisa Marie,1,6,24,23
1746591768562,BIMM 101,B02,895021,McDonnell; Lisa Marie,0,4,24,24
1746591769587,BIMM 110,A01,895023,Staff,1,0,25,24
1746591769587,BIMM 110,A02,895024,Staff,9,0,25,16
1746591769587,BIMM 110,A03,895025,Staff,18,0,25,7
1746591769587,BIMM 110,A04,895031,Staff,20,0,25,5
1746591770612,BIMM 120,A01,895114,Gustafson-Brown; Cindy,14,0,28,14
1746591770612,BIMM 120,A02,895126,Gustafson-Brown; Cindy,21,0,27,6
1746591771641,BIPN 100,A01,895130,Yang; Mingyu,0,0,38,38
1746591771641,BIPN 100,A02,895131,Yang; Mingyu,31,0,38,7
1746591771641,BIPN 100,A03,895132,Yang; Mingyu,32,0,38,6
1746591771641,BIPN 100,A04,895133,Yang; Mingyu,27,0,36,9
1746591772668,BIPN 120,A01,895135,Cooke; James Edward,0,3,13,13
1746591772668,BIPN 120,A02,895136,Cooke; James Edward,0,1,13,13
1746591772668,BIPN 120,A03,895137,Cooke; James Edward,0,3,13,13
1746591772668,BIPN 120,A04,895156,Cooke; James Edward,0,2,11,11
1746591773694,BIPN 134,A01,895235,Cooke; James Edward,0,1,25,25
1746591773694,BIPN 134,A02,895237,Cooke; James Edward,0,0,25,25
1746591773694,BIPN 134,A03,895240,Cooke; James Edward,2,0,25,23
1746591773694,BIPN 134,A04,895270,Cooke; James Edward,20,0,25,5
1746591774720,BIPN 189,A00,892103,Staff,0,14,14,14
1746591776772,BISP 194,A00,958008,Staff,0,2,0,0
1746591777796,CAT 124,A01,922009,Staff,0,5,20,20
1746591778823,CAT 125R,A00,886390,Morales; Celeste Georgianna,0,3,20,20
1746591778823,CAT 125R,B00,886391,Irwin; Matthew Joseph,0,4,20,20
1746591778823,CAT 125R,C00,886392,Smith; Lauryn Alissa,0,2,20,20
1746591778823,CAT 125R,D00,886393,Vanderschuit; Maya Alysia,0,3,20,20
1746591778823,CAT 125R,E00,886394,Marchisotto; Jennifer Anne,0,3,20,20
1746591779849,CENG 15,A01,886218,Drews; Aaron,3,0,8,5
1746591780876,CENG 113,A00,886219,Opatkiewicz; Justin Paul,15,0,25,10
1746591781901,CGS 101,A00,887044,Staff,7,0,20,13
1746591782926,CGS 105,A01,887046,Staff,14,0,25,11
1746591783955,CGS 112,A00,887047,Cuong; Marisol,12,0,15,3
1746591784981,CGS 113,A00,887048,Staff,23,0,30,7
1746591786008,CGS 120,A00,887049,Staff,10,0,17,7
1746591787035,CHEM 6A,A01,886336,Lam; Tin Yiu,38,0,50,12
1746591787035,CHEM 6A,A02,886338,Lam; Tin Yiu,37,0,50,13
1746591788061,CHEM 6B,A01,886341,Hopkins; Patrycja Anna,16,0,50,34
1746591788061,CHEM 6B,A02,886343,Hopkins; Patrycja Anna,42,0,50,8
1746591789086,CHEM 6C,A01,886346,Albizati; Kim F.,0,2,50,50
1746591789086,CHEM 6C,A02,886348,Albizati; Kim F.,24,0,50,26
1746591790115,CHEM 40A,A01,886352,Klosterman; Jeremy K,65,0,100,35
1746591791141,CHEM 40B,A01,886356,Klosterman; Jeremy K,0,24,100,100
1746591792172,CHEM 41B,A01,886360,Theodorakis; Emmanuel,25,0,50,25
1746591792172,CHEM 41B,A02,886362,Theodorakis; Emmanuel,47,0,50,3
1746591793197,CHIN 165A,A00,886382,Xu; Li,18,0,20,2
1746591794223,CLAS 120,A00,886387,Myerston Santana; Jacobo,33,0,40,7
1746591795253,COGS 9,A01,886967,Shannon; Kyle Michael,42,0,60,18
1746591796276,COGS 11,A01,886969,Staff,9,0,30,21
1746591797305,COGS 14A,A01,886971,Staff,5,0,60,55
1746591798335,COGS 14B,A01,886973,Hoffman; Drew Ellen,4,0,60,56
1746591799360,COGS 18,A01,886975,Morgan; Eric,34,0,60,26
1746591800386,COGS 20,A01,886977,Staff,2,0,8,6
1746591800386,COGS 20,A02,886978,Staff,4,0,7,3
1746591801414,COGS 100,A01,907783,Staff,1,2,30,29
1746591802440,COGS 101B,A01,886980,Staff,0,4,48,48
1746591803468,COGS 101C,A01,886982,Delgado; Tania,0,5,44,44
1746591804497,COGS 102A,A01,886984,Johnson; Christine M.,3,0,30,27
1746591805522,COGS 118B,A01,886986,Staff,1,5,88,87
1746591806545,COGS 150,A01,886988,Bergen; Benjamin,22,0,50,28
1746591807572,COGS 153,A00,886989,Delgado; Tania,0,3,41,41
1746591808598,COGS 186,A01,886991,Staff,0,0,32,32
1746591809623,COGS 187A,A01,886993,Boyle; Mary E. T.,7,0,30,23
1746591810649,COGS 189,A00,886994,Staff,0,1,30,30
1746591811678,COMM 10,A01,886996,Staff,0,0,20,21
1746591811678,COMM 10,A02,886997,Staff,10,0,20,10
1746591811678,COMM 10,A03,959845,Staff,19,0,20,1
1746591812707,COMM 20,A01,886999,Leuning; Grant Maurstad,24,0,40,16
1746591814761,COMM 100A,A01,887002,Staff,0,0,20,25
1746591814761,COMM 100A,A02,887003,Staff,6,0,20,14
1746591815789,COMM 100B,A01,887005,Staff,0,8,20,24
1746591816813,COMM 106D,A00,887006,Staff,13,0,40,27
1746591817838,COMM 110G,A00,887007,Whitworth-Smith; Andrew C,12,0,40,28
1746591818865,COMM 111B,A00,887008,Staff,31,0,40,9
1746591819890,COMM 113T,A00,887009,Abuelhiga; Soraya Jill,28,0,40,12
1746591819890,COMM 113T,B00,906733,Staff,40,0,40,0
1746591820915,COMM 145,A00,887010,Staff,12,0,40,28
1746591821942,COMM 146,A00,887054,Staff,31,0,40,9
1746591822968,COMM 190,A00,887012,Staff,8,0,23,15
1746591823996,CSE 8A,A50,887015,Cao; Yingjun,56,0,85,29
1746591825024,CSE 11,A01,887017,Cao; Yingjun,11,0,70,59
1746591826049,CSE 20,A01,887019,Staff,30,0,50,20
1746591827077,CSE 21,A01,887021,Staff,79,0,100,21
1746591827077,CSE 21,B01,892583,Braun; Oliver,45,0,50,5
1746591828102,CSE 30,A01,887025,Eldon; John,142,0,200,58
1746591829129,CSE 100,A01,887027,Staff,26,0,50,24
1746591829129,CSE 100,A02,887028,Staff,42,0,50,8
1746591830154,CSE 101,A01,887030,Braun; Oliver,74,0,100,26
1746591830154,CSE 101,B01,887032,Jones; Miles E,0,3,50,50
1746591830154,CSE 101,B02,887033,Jones; Miles E,0,2,50,50
1746591831184,CSE 105,A01,908084,Jones; Miles E,32,0,50,18
1746591831184,CSE 105,A02,908087,Jones; Miles E,31,0,50,19
1746591832209,CSE 135,A01,887035,Powell; Thomas Allan,0,5,50,50
1746591833238,CSE 142,A01,887037,Staff,8,0,60,52
1746591834266,CSE 142L,A01,887039,Staff,34,0,60,26
1746591835294,CSE 151A,A01,887041,Solares; Edwin A,47,0,100,53
1746591836320,CSE 175,A01,887043,Kumar; Rakesh,30,0,30,0
1746591837359,CSS 1,A01,886389,Staff,1,2,40,39
1746591838385,DSC 30,A01,908097,Liao; Soohyun Nam,47,0,75,28
1746591839411,DSC 40A,A01,908099,Shannon; Kyle Michael,30,0,50,20
1746591840439,DSC 40B,A01,908112,Staff,15,0,50,35
1746591841465,DSC 80,A01,908116,Staff,19,0,60,41
1746591842494,DSC 197,001,956863,Eldridge; Justin Matthew,9999,0,9999,0
1746591843524,ECE 5,A01,886400,Morris; Karcher William,1,0,6,5
1746591843524,ECE 5,A02,886401,Morris; Karcher William,3,0,6,3
1746591844548,ECE 148,A01,886403,Silberman; Jack,0,14,14,14
1746591845576,ECON 1,A01,887265,Crane; Meredith Helen,11,0,70,59
1746591845576,ECON 1,B01,887268,Staff,42,0,50,8
1746591846601,ECON 2,A01,887273,Crane; Meredith Helen,54,0,70,16
1746591847628,ECON 3,A01,887279,Rondina; Giacomo,31,0,70,39
1746591848652,ECON 4,A01,887282,Anderson; John Charles,0,2,10,10
1746591849676,ECON 5,A01,887285,Staff,34,0,45,11
1746591849676,ECON 5,B01,887292,Staff,41,0,45,4
1746591850705,ECON 100A,A01,887337,Newhouse; Herbert S,54,0,70,16
1746591850705,ECON 100A,B01,887349,Staff,45,0,50,5
1746591851730,ECON 100B,A01,887361,Du; Songzi,29,0,70,41
1746591852757,ECON 100C,A01,887445,Newhouse; Herbert S,59,0,70,11
1746591853785,ECON 105,A00,887488,Vespa; Emanuel Ignacio,23,0,35,12
1746591854815,ECON 109,A01,887506,Shishkin; Denis,28,0,35,7
1746591855842,ECON 110A,A01,887568,Alon; Titan Michael,1,3,35,34
1746591855842,ECON 110A,B01,907601,Alon; Titan Michael,20,0,35,15
1746591856872,ECON 110B,A01,887598,Levkoff; Steven B.,0,24,70,70
1746591857896,ECON 112,A00,887599,Rondina; Giacomo,19,0,35,16
1746591858926,ECON 120A,A01,887603,Dai; Yinlin,35,0,70,35
1746591859957,ECON 120C,A01,887608,Sun; Yixiao,0,1,35,35
1746591859957,ECON 120C,B01,887614,Sun; Yixiao,0,0,35,35
1746591860989,ECON 138,A00,887621,Bharadwaj; Prashant,0,21,20,20
1746591862015,ECON 144,A00,958007,Squires; Dale E,12,0,35,23
1746591863040,ECON 171,A01,907666,Staff,18,0,35,17
1746591864066,ECON 175,A00,887626,Wu; Pak Yeung,22,0,35,13
1746591865091,ECON 190,A00,887640,Vespa; Emanuel Ignacio,22,0,35,13
1746591866117,EDS 25,A01,888197,Staff,0,0,0,0
1746591866117,EDS 25,A02,888209,Staff,0,0,0,0
1746591866117,EDS 25,A03,888210,Staff,0,0,0,0
1746591866117,EDS 25,A04,888212,Staff,0,0,0,0
1746591866117,EDS 25,A05,888213,Staff,0,0,0,0
1746591866117,EDS 25,A06,888214,Staff,0,0,0,0
1746591866117,EDS 25,A07,888235,Staff,0,2,0,0
1746591866117,EDS 25,A08,888236,Staff,0,0,0,0
1746591866117,EDS 25,A09,888240,Staff,0,0,0,0
1746591866117,EDS 25,A10,888244,Staff,0,0,0,0
1746591866117,EDS 25,B01,888273,Staff,0,0,0,0
1746591866117,EDS 25,B02,888285,Staff,0,0,0,0
1746591866117,EDS 25,B03,888423,Staff,0,0,0,1
1746591866117,EDS 25,B04,888432,Staff,0,0,0,0
1746591866117,EDS 25,B05,888433,Staff,0,0,0,0
1746591866117,EDS 25,B06,888467,Staff,0,0,0,0
1746591866117,EDS 25,B07,888468,Staff,0,0,0,0
1746591866117,EDS 25,B08,888479,Staff,0,0,0,0
1746591866117,EDS 25,B09,888484,Staff,0,0,0,0
1746591866117,EDS 25,B10,888487,Staff,0,0,0,0
1746591867142,EDS 38,A01,907700,Choi; Bailey Miyeon,30,0,30,0
1746591868171,EDS 112,A01,888601,Chapman; Thandeka K,12,0,40,28
1746591869199,EDS 115,A00,888697,Mendez; Kathrina Mendoza,10,0,30,20
1746591870224,EDS 116,A01,888893,Staff,33,0,40,7
1746591872274,EDS 124AR,A00,889133,Staff,29,0,50,21
1746591872274,EDS 124AR,B00,907471,Simon; Elizabeth A,37,0,50,13
1746591873301,EDS 124BR,A00,889134,Simon; Elizabeth A,44,0,100,56
1746591874325,EDS 125,A00,889135,Staff,25,0,30,5
1746591875353,EDS 126,A01,889138,Staff,35,0,40,5
1746591876378,EDS 164R,A01,889142,Wishard Guerra; Alison G.,32,0,50,18
1746591877403,ENG 30,A01,886396,Staff,0,0,0,0
1746591877403,ENG 30,B01,886398,Staff,0,0,0,0
1746591878430,ENVR 102,A00,906150,Montejo; Carolina,23,0,25,2
1746591879455,ETHN 103A,A00,887236,Man; Simeon S,0,2,0,0
1746591880483,ETHN 113,A00,887239,Staff,16,0,30,14
1746591881507,ETHN 116,A00,887240,Staff,16,0,25,9
1746591882533,ETHN 117,A00,887241,Choi; Esther Min,28,0,30,2
1746591883560,ETHN 118,A00,887243,Staff,24,0,30,6
1746591884586,ETHN 127,A00,887248,Cuong; Marisol,11,0,15,4
1746591885610,ETHN 139,A00,887250,Staff,7,0,10,3
1746591886636,ETHN 142,A00,887252,Staff,10,0,30,20
1746591887664,ETHN 161,A00,887253,Browne; Errol Tsekani,24,0,30,6
1746591888693,ETHN 163FR,A00,887255,Burelle; Julie Sara Veronique,0,0,5,5
1746591889720,GLBH 20,A00,889149,Elwardani; Nile Regina,8,0,42,34
1746591891771,GLBH 111,A01,889152,Burgos; Jose L.,17,0,17,0
1746591892796,GLBH 150,A00,889181,Sloane; Julia Kathryn,0,5,15,15
1746591894850,HDS 60,A01,886406,Warstadt; Melissa Fawn,72,0,80,8
1746591895879,HIAF 111,A00,889324,Gyamfi; Bright,25,0,32,7
1746591896906,HIEA 131,A00,889328,Staff,15,0,32,17
1746591897931,HIEA 144,A00,889333,Henry; Todd A.,26,0,32,6
1746591898960,HIEA 154,A00,889336,Henry; Todd A.,24,0,32,8
1746591899989,HIEU 106,A00,889339,Staff,22,0,32,10
1746591902051,HIEU 114,A00,889340,Staff,4,0,32,28
1746591903081,HIEU 135GS,A00,889342,Patterson; Patrick H.,0,0,1,24
1746591904106,HIEU 137,A00,889343,Edington; Claire Ellen,10,0,25,15
1746591905134,HIEU 148,A00,889345,Staff,14,0,32,18
1746591906159,HIEU 154,A00,889346,Biess; Frank Peter,21,0,32,11
1746591907185,HILA 102,A00,889351,Staff,12,0,32,20
1746591908211,HILD 2A,A01,889221,Lewandoski; Julia Mavis,2,10,32,30
1746591909240,HILD 7B,A01,889225,Man; Simeon S,0,12,32,32
1746591910268,HILD 7C,A01,889288,Alvarez; Luis A,0,14,32,32
1746591911295,HILD 30,A01,889323,Staff,0,5,32,32
1746591913345,HISC 119,A00,889383,Golan; Tal,19,0,32,13
1746591914371,HIUS 103,A00,889384,Man; Simeon S,0,0,32,32
1746591915400,HIUS 117,A00,919797,Kwak; Nancy,18,0,32,14
1746591916425,HIUS 142A,A00,919788,Staff,22,0,32,10
1746591918479,HIUS 149,A00,889386,Gyamfi; Bright,26,0,32,6
1746591919507,HIUS 155,A00,889387,Alvarez; Luis A,15,0,32,17
1746591920533,HUM 3,A01,886499,Caldwell; Michael Alan,19,0,50,31
1746591921560,HUM 3GS,A00,886500,Rodriguez; Bretton Sigfred,0,0,0,28
1746591922587,HUM 3R,A01,886502,Markman; Kristina,0,36,50,50
1746591923614,HUM 4,A01,886504,Crum; Matthew Stephen,23,0,50,27
1746591923614,HUM 4,B01,886506,West; Geoffrey Scott,17,0,50,33
1746591924642,HUM 4GS,A00,886507,Staff,0,0,0,19
1746591925668,HUM 5,A01,886509,Staff,31,0,50,19
1746591926693,HUM 5R,A01,886511,Zavodny; Tatiana Sophia,0,39,50,50
1746591927722,JAPN 180,A00,886407,Staff,16,0,40,24
1746591928754,LATI 50,A01,886409,Martin-Cabrera; Luis,3,0,22,19
1746591928754,LATI 50,A02,886410,Martin-Cabrera; Luis,19,0,22,3
1746591928754,LATI 50,A03,886411,Martin-Cabrera; Luis,21,0,22,1
1746591928754,LATI 50,A04,886412,Martin-Cabrera; Luis,8,0,22,14
1746591929781,LAWS 101,A00,907664,Staff,28,0,60,32
1746591930809,LIAB 1A,A00,889388,Saab; Dima,17,0,20,3
1746591931835,LIAB 1AX,A00,889389,El Cheddadi; Youniss,18,0,20,2
1746591932861,LIFR 1C,A00,889391,Van Moer; Vinciane G,8,0,20,12
1746591933885,LIFR 1CX,A00,889392,Van Moer; Vinciane G,7,0,20,13
1746591934914,LIFR 1D,A00,889393,Van Moer; Vinciane G,7,0,20,13
1746591935944,LIFR 1DX,A00,889394,Van Moer; Vinciane G,8,0,20,12
1746591936970,LIGN 7,A00,886923,Staff,24,0,50,26
1746591938002,LIGN 17,A00,886924,Kehler; Andrew Scott,125,0,150,25
1746591939029,LTAM 110,A00,889395,Staff,15,0,30,15
1746591940054,LTAM 110GS,A00,958010,Rodriguez; Bretton Sigfred,0,0,0,28
1746591941082,LTCH 101,A00,889397,Staff,23,0,25,2
1746591942107,LTCS 130,A00,889398,Staff,23,0,25,2
1746591943136,LTEA 138,A00,889399,Staff,24,0,40,16
1746591944167,LTEN 149,A00,889400,Wesling; Megan E.,0,3,25,25
1746591945195,LTEN 169,A00,889401,Staff,20,0,25,5
1746591946224,LTEN 180,A00,889402,Staff,10,0,15,5
1746591947266,LTEN 181,A00,889403,Staff,21,0,25,4
1746591948292,LTWL 100,A00,889404,Myerston Santana; Jacobo,2,0,25,23
1746591949319,LTWL 180GS,A00,889405,Staff,0,0,20,20
1746591950345,LTWL 181,A00,889406,Staff,16,0,25,9
1746591951374,LTWL 184,A00,889475,Mukherjee; Silpa,22,0,25,3
1746591952398,LTWR 102C,A00,889486,Staff,29,0,30,1
1746591953425,LTWR 115W,A00,889491,Staff,0,2,15,15
1746591954451,MAE 8,A01,886905,Staff,0,2,0,0
1746591955476,MAE 11,A00,886906,Bandaru; Prabhakar,0,7,50,50
1746591956502,MAE 20,A00,886907,Evdokimenko; Ekaterina,43,0,70,27
1746591957526,MAE 30B,A00,886909,Ghazinejad; Maziar,25,0,45,20
1746591958555,MAE 101B,A00,886910,Saintillan; David,29,0,45,16
1746591959582,MAE 105,A00,886911,Bandaru; Prabhakar,18,0,50,32
1746591960607,MAE 107,B00,958024,Staff,7,0,50,43
1746591961635,MAE 143B,A00,886913,Bewley; Thomas R,3,0,40,37
1746591962663,MAE 148,A01,886915,Silberman; Jack,0,3,14,14
1746591963688,MAE 160,A00,886916,Evdokimenko; Ekaterina,31,0,60,29
1746591964712,MATH 3C,A01,889681,Staff,0,2,30,30
1746591964712,MATH 3C,A02,960048,Staff,23,0,30,7
1746591965737,MATH 10A,A01,889760,Staff,26,0,30,4
1746591965737,MATH 10A,A02,889783,Staff,29,0,30,1
1746591966762,MATH 10B,A01,889785,Verstraete; Jacques Allan,1,0,35,34
1746591966762,MATH 10B,A02,889795,Verstraete; Jacques Allan,4,0,35,31
1746591966762,MATH 10B,B01,889797,Verstraete; Jacques Allan,3,0,35,32
1746591966762,MATH 10B,B02,889828,Verstraete; Jacques Allan,3,0,35,32
1746591967794,MATH 10C,A01,889849,Habib; Yousaf,8,0,30,22
1746591967794,MATH 10C,A02,889852,Habib; Yousaf,14,0,30,16
1746591967794,MATH 10C,A03,889853,Habib; Yousaf,22,0,30,8
1746591967794,MATH 10C,A04,889858,Habib; Yousaf,20,0,30,10
1746591967794,MATH 10C,B01,889861,Staff,1,0,30,29
1746591967794,MATH 10C,B02,889862,Staff,24,0,30,6
1746591967794,MATH 10C,B03,889863,Staff,27,0,30,3
1746591967794,MATH 10C,B04,889967,Staff,23,0,30,7
1746591968819,MATH 18,A01,889974,Staff,7,0,30,23
1746591968819,MATH 18,A02,889977,Staff,20,0,30,10
1746591968819,MATH 18,B01,889984,Hardiman; Liam,20,0,30,10
1746591968819,MATH 18,B02,889985,Hardiman; Liam,25,0,30,5
1746591969846,MATH 20A,A01,889990,Suk; Andrew Hoon,30,0,35,5
1746591970876,MATH 20B,A01,889993,Ohm; Ko Woon,21,0,30,9
1746591970876,MATH 20B,A02,889994,Ohm; Ko Woon,30,0,30,0
1746591970876,MATH 20B,B01,889996,Ohm; Ko Woon,22,0,30,8
1746591970876,MATH 20B,B02,889997,Ohm; Ko Woon,23,0,30,7
1746591971906,MATH 20C,A01,889999,Hammock; Frances H,17,0,30,13
1746591971906,MATH 20C,A02,890003,Hammock; Frances H,23,0,30,7
1746591971906,MATH 20C,B01,890006,Hammock; Frances H,3,0,30,27
1746591971906,MATH 20C,B02,890007,Hammock; Frances H,12,0,30,18
1746591972938,MATH 20D,A01,890011,Cheng; Hsiao-Bing,1,1,30,29
1746591972938,MATH 20D,A02,890012,Cheng; Hsiao-Bing,14,0,30,16
1746591972938,MATH 20D,B01,890016,Cheng; Hsiao-Bing,13,0,30,17
1746591972938,MATH 20D,B02,890017,Cheng; Hsiao-Bing,13,0,30,17
1746591973966,MATH 20E,A01,890026,Harel; Guershon,1,0,30,29
1746591973966,MATH 20E,A02,890029,Harel; Guershon,22,0,30,8
1746591973966,MATH 20E,B01,890033,Harel; Guershon,7,0,30,23
1746591973966,MATH 20E,B02,890101,Harel; Guershon,21,0,30,9
1746591974992,MATH 102,A01,890104,Staff,18,0,30,12
1746591974992,MATH 102,A02,890105,Staff,27,0,30,3
1746591976022,MATH 103B,A01,890116,Salehi Golsefidy; Alireza,3,0,30,27
1746591976022,MATH 103B,B01,890118,Staff,0,3,34,34
1746591977049,MATH 109,A01,890121,Aliabadi Sr.; Mohsen,0,0,30,30
1746591977049,MATH 109,B01,890124,Upadrashta; Pranav Kumar,18,0,30,12
1746591978078,MATH 120A,A01,890126,Eggers; John Dietrich,13,0,30,17
1746591979103,MATH 142B,A01,890128,Ioana; Adrian,19,0,30,11
1746591979103,MATH 142B,A02,890129,Ioana; Adrian,12,0,30,18
1746591980128,MATH 154,A01,890174,Staff,0,1,30,30
1746591980128,MATH 154,A02,890182,Staff,0,0,30,30
1746591981152,MATH 168A,A01,890197,Dumitriu; Ioana,21,0,35,14
1746591982183,MATH 170A,A01,890240,Nie; Jiawang,1,0,30,29
1746591982183,MATH 170A,A02,890241,Nie; Jiawang,11,0,30,19
1746591982183,MATH 170A,A03,890249,Nie; Jiawang,23,0,30,7
1746591983209,MATH 170B,A01,957891,Nag; Panchali,13,0,35,22
1746591985263,MATH 181A,A01,908025,Staff,0,3,35,35
1746591985263,MATH 181A,A02,960115,Staff,26,0,35,9
1746591986289,MATH 181B,A01,959874,Staff,24,0,30,6
1746591987314,MATH 193B,A01,890265,Staff,0,4,35,35
1746591988338,MGT 4,A01,890311,Anderson; John Charles,42,0,88,46
1746591989364,MGT 5,A00,907740,Staff,12,0,98,86
1746591990389,MGT 12,A00,890312,Lindenberger; Wade Douglas,67,0,98,31
1746591991414,MGT 16,A00,957883,Staff,78,0,98,20
1746591993463,MGT 45,A00,890314,Pecore; Joseph P.,45,0,98,53
1746591994492,MGT 71,A00,890315,Staff,0,12,98,98
1746591995522,MGT 100,A00,890316,Yavorsky; Daniel Ryan,44,0,98,54
1746591996548,MGT 103,A00,890317,Ehrich; Kristine R,73,0,98,25
1746591997577,MGT 105,A00,890356,Bates; Kenneth Walter,0,8,98,98
1746591998603,MGT 112,A00,890360,Ehrich; Kristine R,55,0,98,43
1746591999631,MGT 127R,A00,907732,Zhu; Kevin Xiaoguo,23,0,98,75
1746592000657,MGT 131B,A00,890361,Anderson; John Charles,59,0,98,39
1746592001684,MGT 137,A00,890362,Lindenberger; Wade Douglas,65,0,98,33
1746592002716,MGT 160,A00,890369,Johnson; Erik Barry,9,0,98,89
1746592004765,MGT 164,A00,890372,Zimmermann; Carsten,0,40,98,98
1746592005791,MGT 180,A00,890374,Bliss; Barbara Ann,11,0,98,87
1746592006821,MMW 15,A01,886414,Chang; Edmond Yi-Teh,0,12,28,28
1746592006821,MMW 15,A02,886415,Chang; Edmond Yi-Teh,0,8,28,28
1746592006821,MMW 15,A03,886416,Chang; Edmond Yi-Teh,0,9,28,28
1746592006821,MMW 15,A04,886417,Chang; Edmond Yi-Teh,0,8,28,28
1746592006821,MMW 15,B01,886419,Chang; Edmond Yi-Teh,0,7,28,28
1746592006821,MMW 15,B02,886420,Chang; Edmond Yi-Teh,0,8,28,28
1746592006821,MMW 15,B03,886421,Chang; Edmond Yi-Teh,0,7,28,28
1746592006821,MMW 15,B04,886422,Chang; Edmond Yi-Teh,0,8,28,28
1746592006821,MMW 15,C01,886424,Staff,0,9,28,28
1746592006821,MMW 15,C02,886425,Staff,0,8,28,28
1746592006821,MMW 15,C03,886426,Staff,0,8,28,28
1746592006821,MMW 15,C04,886427,Staff,0,8,28,28
1746592006821,MMW 15,C05,958038,Staff,0,8,28,28
1746592006821,MMW 15,C06,958039,Staff,1,8,28,27
1746592007847,MMW 15GS,A00,906910,Patterson; Patrick H.,4,0,28,24
1746592008875,MMW 122R,A01,886429,Rahimi; Babak,0,13,28,28
1746592008875,MMW 122R,A02,886430,Rahimi; Babak,0,12,28,28
1746592008875,MMW 122R,A03,958040,Rahimi; Babak,0,11,28,28
1746592009900,MUS 1A,A01,890937,Staff,2,0,25,23
1746592009900,MUS 1A,A02,891035,Staff,6,0,25,19
1746592009900,MUS 1A,C01,958912,Staff,24,0,25,1
1746592009900,MUS 1A,C02,958913,Staff,25,0,25,0
1746592011949,MUS 2AK,A00,957092,Ohnishi; Takae,15,0,15,0
1746592012976,MUS 4,A01,891044,Staff,0,0,25,25
1746592012976,MUS 4,A02,891045,Staff,22,0,25,3
1746592012976,MUS 4,B01,891048,Staff,17,0,25,8
1746592012976,MUS 4,B02,891050,Staff,25,0,25,0
1746592014005,MUS 5,A01,957506,Dubnov; Shlomo,0,0,25,25
1746592014005,MUS 5,A02,957622,Dubnov; Shlomo,13,0,25,12
1746592014005,MUS 5,A03,957623,Dubnov; Shlomo,20,0,25,5
1746592015033,MUS 6,A01,891053,Freitas Caetano; Marcelo,24,0,25,1
1746592015033,MUS 6,A02,891054,Freitas Caetano; Marcelo,23,0,25,2
1746592016061,MUS 7,A01,891081,Staff,0,0,25,25
1746592016061,MUS 7,A02,891082,Staff,3,0,25,22
1746592017085,MUS 8GS,A00,891118,Borgo; David Garcia,1,0,25,24
1746592018133,MUS 11,A01,891140,Staff,9,0,25,16
1746592018133,MUS 11,A02,891141,Staff,21,0,25,4
1746592019158,MUS 13,A01,891143,Staff,8,0,25,17
1746592019158,MUS 13,A02,891144,Staff,24,0,25,1
1746592020188,MUS 15,A01,891146,Staff,9,0,25,16
1746592020188,MUS 15,A02,891148,Staff,21,0,25,4
1746592020188,MUS 15,B01,891150,Staff,18,0,25,7
1746592020188,MUS 15,B02,891151,Staff,25,0,25,0
1746592021216,MUS 20,A01,891153,Staff,5,0,20,15
1746592021216,MUS 20,A02,891155,Staff,14,0,20,6
1746592022240,MUS 80,A00,891156,Staff,19,0,25,6
1746592022240,MUS 80,B00,891157,Staff,23,0,25,2
1746592023268,MUS 130,A00,891158,Ohnishi; Takae,35,0,35,0
1746592024295,MUS 150GS,A01,891160,Borgo; David Garcia,1,0,25,24
1746592025324,MUS 170,A01,891162,Freitas Caetano; Marcelo,20,0,25,5
1746592025324,MUS 170,A02,891164,Freitas Caetano; Marcelo,21,0,25,4
1746592026352,NANO 11,A00,886220,Vazquez Mena; Oscar,13,0,15,2
1746592027377,NANO 15,A01,886222,Drews; Aaron,4,0,7,3
1746592028400,NANO 104,A00,886224,Sirbuly; Donald,17,0,25,8
1746592029427,PH 40,A00,886528,Staff,23,0,40,17
1746592030455,PH 45,A01,886799,Staff,35,0,40,5
1746592031481,PH 110,A00,886802,Staff,0,6,40,40
1746592032506,PH 172,A00,906716,Staff,19,0,35,16
1746592033531,PH 191,A00,886803,Staff,6,0,40,34
1746592034555,PHIL 1,A00,889500,Staff,20,0,30,10
1746592035579,PHIL 10,A01,889549,Grush; Rick Scott,16,0,22,6
1746592035579,PHIL 10,A02,889551,Grush; Rick Scott,22,0,22,0
1746592036605,PHIL 28,A01,889559,Lamey; Andy M.,0,2,31,31
1746592036605,PHIL 28,A02,889561,Lamey; Andy M.,0,1,30,30
1746592036605,PHIL 28,A03,889572,Lamey; Andy M.,0,1,30,30
1746592037628,PHIL 35,A00,907839,Staff,13,0,15,2
1746592038657,PHIL 60,A00,889574,Staff,73,0,90,17
1746592039682,PHIL 101,A00,958004,Staff,12,0,15,3
1746592041731,PHIL 136,A00,889582,Fulkerson; Matthew Todd,26,0,45,19
1746592042761,PHIL 163,A01,889601,Staff,21,0,30,9
1746592042761,PHIL 163,B01,889606,Brandt; Reuven A,0,3,0,0
1746592043786,PHIL 164,A00,889610,Staff,16,0,30,14
1746592044812,PHIL 165,A00,889613,Staff,22,0,30,8
1746592045836,PHYS 1A,A00,886431,Staff,30,0,70,40
1746592046864,PHYS 1AL,001,886432,Tsai; Philbert S,1,2,30,29
1746592046864,PHYS 1AL,002,886436,Tsai; Philbert S,13,0,30,17
1746592047889,PHYS 1B,A00,886439,Staff,184,0,240,56
1746592048913,PHYS 1BL,001,886441,Tsai; Philbert S,0,4,30,30
1746592048913,PHYS 1BL,002,886444,Tsai; Philbert S,2,0,30,28
1746592049942,PHYS 1C,A00,896092,Arnold; Kam S,78,0,146,68
1746592050966,PHYS 1CL,001,886448,Tsai; Philbert S,0,0,30,30
1746592050966,PHYS 1CL,002,886449,Tsai; Philbert S,1,0,30,29
1746592050966,PHYS 1CL,003,886450,Tsai; Philbert S,16,0,30,14
1746592050966,PHYS 1CL,004,886451,Tsai; Philbert S,15,0,30,15
1746592051993,PHYS 2B,A01,886457,Staff,67,0,115,48
1746592053018,PHYS 2C,A01,886460,Shotwell; Brian,0,9,65,65
1746592054046,PHYS 2CL,A01,886467,Staff,0,4,28,28
1746592054046,PHYS 2CL,A02,886468,Staff,0,3,28,28
1746592055071,PHYS 2D,A01,886470,Staff,10,0,50,40
1746592056095,PHYS 4B,A01,886475,Grinstein; Benjamin,22,0,40,18
1746592057120,POLI 5,A00,891173,Desposato; Scott,7,0,25,18
1746592058147,POLI 5D,A01,891175,Staff,5,0,5,0
1746592058147,POLI 5D,B01,891178,Staff,5,0,5,0
1746592059174,POLI 11,A00,891179,Ferree; Karen E,2,0,35,33
1746592060197,POLI 12,A00,891180,Staff,16,0,30,14
1746592061221,POLI 27,A01,891182,Staff,12,0,75,63
1746592062245,POLI 30,A00,891183,Staff,8,0,50,42
1746592063269,POLI 100B,A00,891244,Staff,5,1,35,30
1746592064294,POLI 100I,A00,891247,Staff,7,0,30,23
1746592065321,POLI 104J,A00,891248,Nichter; Maysa,14,0,30,16
1746592066346,POLI 104U,A00,891250,Nichter; Maysa,1,0,30,29
1746592068397,POLI 110B,A00,891255,Wiens; David,19,0,25,6
1746592069424,POLI 112A,A00,891256,Wiens; David,6,0,25,19
1746592070453,POLI 114BR,A00,891261,Staff,19,0,30,11
1746592071480,POLI 117R,A00,891262,Forman; Fonna,0,6,50,50
1746592072504,POLI 118,A00,891264,Ingham; Sean,17,0,25,8
1746592073530,POLI 124A,A00,891265,Staff,18,0,20,2
1746592074560,POLI 125D,A00,891266,Nichter; Simeon C,2,0,25,23
1746592075588,POLI 126,A00,891268,Nichter; Simeon C,7,0,25,18
1746592076616,POLI 126AA,A00,891272,Staff,15,0,25,10
1746592077645,POLI 130AA,A00,891273,Staff,15,0,20,5
1746592078671,POLI 134AA,A00,891274,Staff,4,0,20,16
1746592080725,POLI 138,A00,891278,Staff,21,0,25,4
1746592081756,POLI 142K,A00,891280,Staff,10,0,25,15
1746592082782,POLI 142M,A00,891281,Gartzke; Erik,16,0,30,14
1746592083806,POLI 142P,A00,891284,Staff,20,0,30,10
1746592084832,POLI 143,A00,891285,Gartzke; Erik,12,0,30,18
1746592085858,POLI 153,A00,891286,Staff,19,0,20,1
1746592087911,POLI 175,A00,891290,Staff,15,0,20,5
1746592088939,PSYC 1,A00,890674,Steiner; Eric Tomas,0,11,45,45
1746592089964,PSYC 2,A00,890676,Albright; Thomas D,20,0,35,15
1746592090991,PSYC 3,A00,890679,Staff,17,0,20,3
1746592092019,PSYC 6,A00,959858,Staff,19,0,20,1
1746592093050,PSYC 60,A01,890684,Rickard; Timothy C.,0,6,45,45
1746592094077,PSYC 70,A01,890689,Geller; Emma Harlan,6,0,30,24
1746592095106,PSYC 71,A01,959860,Staff,21,0,25,4
1746592096135,PSYC 100,A00,890690,Lacefield; Katharine I,0,50,180,180
1746592097162,PSYC 102,A00,890695,Staff,18,0,40,22
1746592098187,PSYC 105,A00,890699,Geller; Emma Harlan,70,0,100,30
1746592099214,PSYC 106,A00,890701,Gorman; Michael R.,5,0,30,25
1746592100244,PSYC 108,A00,890704,Adrian; Julia Anna,0,29,50,50
1746592101269,PSYC 118,A01,890712,Staff,11,0,30,19
1746592102296,PSYC 124,A00,890716,Chapman; Eddie Nathaniel,25,0,60,35
1746592103320,PSYC 131,A00,890717,Anagnostaras; Stephan,0,7,80,80
1746592104364,PSYC 137,A00,890719,Winkielman; Piotr,0,11,30,30
1746592105388,PSYC 144,A00,890721,Adrian; Julia Anna,0,9,45,45
1746592106412,PSYC 162,A00,890805,Staff,0,1,75,75
1746592107441,PSYC 169,A00,890810,Staff,0,15,30,30
1746592108469,PSYC 172,A00,890814,Gorman; Michael R.,9,0,30,21
1746592109494,PSYC 181,A00,890818,Anagnostaras; Stephan,7,0,200,193
1746592110519,PSYC 184,A00,959861,Staff,163,0,175,12
1746592111547,PSYC 189,A00,890823,Staff,0,2,30,30
1746592112575,PSYC 191,A00,890884,Rickard; Timothy C.,0,12,35,35
1746592113604,PSYC 193,A00,890913,Staff,19,0,30,11
1746592113604,PSYC 193,B00,890914,Chapman; Eddie Nathaniel,24,0,30,6
1746592114630,PSYC 193L,A01,890918,Lowe; Angela Beth,20,0,30,10
1746592114630,PSYC 193L,B01,890921,Hurwitz; Ethan Scott,20,0,30,10
1746592114630,PSYC 193L,C01,890928,Staff,30,0,30,0
1746592115660,RELI 149,A00,886806,Rahimi; Babak,23,0,40,17
1746592116685,SE 9,A01,886814,Staff,7,0,20,13
1746592117711,SE 101B,A01,886816,Chadha; Mayank,3,0,35,32
1746592118740,SE 110B,A00,886818,Zhu; Qiang,4,0,75,71
1746592119773,SE 125,A01,886830,Staff,10,0,30,20
1746592120806,SE 130B,A01,886835,Staff,14,0,40,26
1746592121830,SE 131A,A01,886838,Krysl; Petr,34,0,55,21
1746592122855,SE 154,A00,886840,Staff,28,0,50,22
1746592123881,SE 164GS,A01,886849,Staff,6,0,20,14
1746592124905,SE 167GS,A01,886853,Staff,6,0,20,14
1746592125936,SIO 25,A01,890107,Staff,19,0,30,11
1746592126962,SIO 45,A00,890109,Cook; Geoffrey W,116,0,200,84
1746592127992,SIO 109R,A00,890110,Forman; Fonna,0,16,20,20
1746592129017,SIO 187,A01,890114,Kacev; David,15,0,40,25
1746592130044,SOCI 1,A01,890431,Thorpe; Charles Robert,14,0,30,16
1746592130044,SOCI 1,A02,890518,Thorpe; Charles Robert,30,0,30,0
1746592131071,SOCI 2,A01,957978,Staff,25,0,25,0
1746592131071,SOCI 2,A02,957979,Staff,23,0,25,2
1746592132101,SOCI 20,A01,890523,Calderon-Zaks; Michael Aar,21,0,30,9
1746592132101,SOCI 20,A02,890526,Calderon-Zaks; Michael Aar,29,0,30,1
1746592133129,SOCI 30,A01,890533,Pardo Guerra; Juan Pablo,37,0,40,3
1746592134156,SOCI 40,A01,890535,Staff,27,0,45,18
1746592135181,SOCI 104Q,A00,890559,Staff,18,0,30,12
1746592136210,SOCI 106,A00,890560,Arnal; Maud Marie Leonie,20,0,30,10
1746592137238,SOCI 110,A00,890567,Holkenbrink-Monk; Charlene,19,0,30,11
1746592138266,SOCI 112,A00,890568,Victoria Torres; Pablo,2,0,55,53
1746592139291,SOCI 115,A00,890597,Arnal; Maud Marie Leonie,28,0,45,17
1746592141342,SOCI 121,A00,890604,Pardo Guerra; Juan Pablo,38,0,45,7
1746592142371,SOCI 126,A01,890608,Staff,8,0,10,2
1746592143414,SOCI 127,A00,890609,Staff,18,0,30,12
1746592144438,SOCI 131,A00,890610,Thorpe; Charles Robert,37,0,45,8
1746592145463,SOCI 135,A00,890615,Payne; Christine Anna,14,0,45,31
1746592146492,SOCI 139,A00,890620,Staff,38,0,45,7
1746592147516,SOCI 148E,A00,890622,Calderon-Zaks; Michael Aar,36,0,45,9
1746592148543,SOCI 150,A00,890623,Kohler; Kristopher M.,31,0,45,14
1746592149567,SOCI 157,A00,890625,Jules-Rosette; Bennetta W.,18,0,20,2
1746592150596,SOCI 160,A00,890627,Payne; Christine Anna,21,0,45,24
1746592151621,SYN 1,A00,886855,Fish; Gwendolyn Anne,0,1,0,0
1746592151621,SYN 1,B00,906086,Fish; Gwendolyn Anne,0,2,0,2
1746592152648,SYN 2R,A00,886860,Staff,0,17,15,15
1746592152648,SYN 2R,B00,906106,Atkinson; Arthur Laird,0,16,15,15
1746592153675,SYN 100,A01,886866,Browne; Emily,0,28,20,20
1746592153675,SYN 100,B01,906128,Rock; Martin,0,4,20,20
1746592153675,SYN 100,C01,906140,Deavenport; James Cary,0,4,20,20
1746592153675,SYN 100,D01,907816,Deavenport; James Cary,0,5,20,20
1746592154700,TDAC 1,A00,890286,Walsh; Kim C.,7,0,20,13
1746592155723,TDAC 101,A00,890296,Basso; Beatrice,15,0,20,5
1746592156746,TDDE 131,A00,890297,Staff,47,0,50,3
1746592157771,TDDM 1,A00,890287,Weinberg; Sadie,25,0,30,5
1746592158799,TDGE 11,A00,890288,Fulton; Julia,138,0,200,62
1746592158799,TDGE 11,B00,890289,Castro; Robert Jess,185,0,200,15
1746592159846,TDGE 25,B00,957359,Walsh; Kim C.,5,0,20,15
1746592160879,TDGE 40,A01,890292,Power; Jade Yukana,26,0,30,4
1746592161905,TDGE 124,A00,890298,Havis; Allan,0,2,50,50
1746592162930,TDGE 131R,A00,890299,Burelle; Julie Sara Veronique,15,0,42,27
1746592163958,TDHT 101,A00,890300,Staff,10,0,20,10
1746592164984,TDHT 109,A01,890302,Anderson; Mysia Anyse,31,0,40,9
1746592166010,TDMV 1,A00,890293,Arcidiacono; Kristin,18,0,30,12
1746592167036,TDMV 2,A00,890294,Weinberg; Sadie,23,0,30,7
1746592168060,TDMV 3,A00,957878,Arcidiacono; Kristin,28,0,30,2
1746592170115,TDMV 138,A00,890304,Jun; Grace Shin Hae,25,0,40,15
1746592171140,TDMV 140,A00,890305,Corrales; Joseph Bernales,25,0,30,5
1746592172168,TDMV 142,A00,890307,Caligagan; Tony,32,0,40,8
1746592173196,TDMV 144,A00,890308,Camaya; Michelle Ann,25,0,30,5
1746592174221,TDPW 1,A00,890295,Stein; Deborah Isobel,3,0,20,17
1746592175248,USP 2,A01,890272,Lerner; Amy M,7,0,20,13
1746592176279,USP 3,A01,890274,Staff,12,0,30,18
1746592177308,USP 15,A01,890276,Sun; Feiyang,16,0,30,14
1746592178332,USP 25,A00,890277,Shenkman; Michael Thomas,18,0,25,7
1746592179360,USP 138,A00,890278,Staff,13,0,25,12
1746592180387,USP 143,A00,890279,Staff,22,0,70,48
1746592181412,USP 144,A00,890280,Chowdhury; Muhammed Zohir,16,0,30,14
1746592182440,USP 150,A00,890281,Boomhower; Matthew Charles,4,0,30,26
1746592183488,USP 151,A00,890282,Staff,16,0,20,4
1746592184512,USP 162,A00,890283,Andrews; Abigail Leslie,16,0,20,4
1746592185537,USP 168,A00,920477,Kwak; Nancy,0,0,5,5
1746592186561,USP 181,A00,890284,Staff,3,0,20,17
1746592187586,USP 191A,A00,890285,Staff,12,0,20,8
1746592188611,VIS 101,A00,886512,Staff,26,0,75,49
1746592189635,VIS 103,A00,886513,Cruz; Edwin Teddy,61,0,75,14
1746592190663,VIS 108,A00,886514,Staff,3,0,15,12
1746592191693,VIS 127P,A00,886515,Shen; Kuiyi,79,0,146,67
1746592192720,VIS 149,A00,886516,Yoldas; Pinar,0,0,15,15
1746592193743,VIS 164,A00,886526,Erdmann; Dean,19,0,22,3
1746592194767,VIS 194S,A00,886527,Staff,61,0,75,14
1746592195793,WCWP 10A,C00,886484,Martiniuk; Jill,12,0,15,3
1746592196820,WCWP 10B,A00,886490,Uriarte; Emma,0,0,15,15
1746592196820,WCWP 10B,B00,886491,Dhir; Simrita,8,0,15,7
1746592196820,WCWP 10B,C00,886492,Ornelas; Tricia,0,0,15,15
1746592197846,WCWP 100,A00,886494,Young; Mark T,0,6,15,15
1746592199959,AAS 10,A01,886199,Childs; Dennis R.,0,3,0,0
1746592200986,ANAR 104,A01,886940,Shtienberg; Gilad,27,0,30,3
1746592202010,ANAR 120,A00,886953,Staff,13,0,20,7
1746592203038,ANBI 148,A01,886955,Wilder; Linnea Lorene,30,0,40,10
1746592205089,ANSC 122,A00,886957,Staff,24,0,30,6
1746592206115,ANSC 150,A00,886958,Sloane; Julia Kathryn,2,0,15,13
1746592207142,ANSC 156,A00,886959,Jenkins; Janis A.,0,1,15,15
1746592208167,ANSC 180,A00,886960,Staff,11,0,17,6
1746592209194,ANSC 188,A00,886961,Jassal; Aftab,9,0,25,16
1746592210221,ANSC 190,A00,886962,Jassal; Aftab,14,0,25,11
1746592211248,ANSC 191,A00,886963,Staff,18,0,20,2
1746592212274,ANTH 3,A01,891689,Staff,17,0,20,3
1746592213298,ANTH 5,A00,886933,Semendeferi; Ekaterini,16,0,20,4
1746592214323,ANTH 10,A00,886934,Staff,0,12,30,30
1746592215349,ANTH 21,A01,886936,Staff,41,0,60,19
1746592216373,ANTH 23,A01,886938,Staff,92,0,100,8
1746592217401,ANTH 105,A00,886964,Stewart; Alexander B,84,0,100,16
1746592218428,ANTH 108,A00,886965,Pedersen; David,9,0,20,11
1746592219457,AWP 10,001,886147,Staff,0,0,0,0
1746592219457,AWP 10,002,886148,Staff,0,0,0,0
1746592219457,AWP 10,003,886149,Staff,0,0,0,0
1746592219457,AWP 10,004,886150,Staff,0,0,0,0
1746592219457,AWP 10,005,886151,Staff,0,0,0,0
1746592219457,AWP 10,006,886152,Staff,0,0,0,0
1746592219457,AWP 10,007,886153,Staff,0,0,0,0
1746592219457,AWP 10,008,886154,Staff,0,0,0,0
1746592219457,AWP 10,009,886155,Staff,0,0,0,0
1746592219457,AWP 10,010,886156,Staff,0,0,0,0
1746592219457,AWP 10,011,886158,Staff,0,0,0,0
1746592219457,AWP 10,012,886160,Staff,0,0,0,0
1746592219457,AWP 10,013,886161,Staff,0,0,0,0
1746592219457,AWP 10,014,886162,Staff,0,0,0,0
1746592219457,AWP 10,015,886163,Staff,0,0,0,0
1746592219457,AWP 10,016,886164,Staff,0,0,0,0
1746592219457,AWP 10,017,886165,Staff,0,0,0,0
1746592219457,AWP 10,018,886166,Staff,0,0,0,0
1746592219457,AWP 10,019,886168,Staff,0,0,0,0
1746592219457,AWP 10,020,886170,Staff,0,0,0,0
1746592219457,AWP 10,021,886172,Staff,0,0,0,0
1746592220484,AWP 10R,001,886173,Staff,0,1,0,0
1746592220484,AWP 10R,002,886174,Staff,0,1,0,0
1746592220484,AWP 10R,003,886175,Staff,0,0,0,0
1746592220484,AWP 10R,004,886176,Staff,0,0,0,0
1746592220484,AWP 10R,005,886177,Staff,0,0,0,0
1746592220484,AWP 10R,006,886178,Staff,0,0,0,0
1746592220484,AWP 10R,007,886179,Staff,0,0,0,0
1746592220484,AWP 10R,008,886181,Staff,0,0,0,0
1746592220484,AWP 10R,009,886182,Staff,0,0,0,0
1746592220484,AWP 10R,010,886183,Staff,0,0,0,0
1746592220484,AWP 10R,011,886184,Staff,0,0,0,0
1746592220484,AWP 10R,012,886185,Staff,0,0,0,0
1746592220484,AWP 10R,013,886186,Staff,0,0,0,0
1746592220484,AWP 10R,014,886187,Staff,0,0,0,0
1746592220484,AWP 10R,015,886188,Staff,0,0,0,0
1746592220484,AWP 10R,016,886189,Staff,0,0,0,0
1746592220484,AWP 10R,017,960532,Staff,0,0,0,0
1746592220484,AWP 10R,018,960533,Staff,0,0,0,0
1746592220484,AWP 10R,019,960534,Staff,0,0,0,0
1746592220484,AWP 10R,020,960538,Staff,0,0,0,0
1746592220484,AWP 10R,021,960540,Staff,0,0,0,0
1746592220484,AWP 10R,022,960541,Staff,0,0,0,0
1746592220484,AWP 10R,023,960542,Staff,0,0,0,0
1746592220484,AWP 10R,024,960544,Staff,0,0,0,0
1746592220484,AWP 10R,025,960545,Staff,0,0,0,0
1746592220484,AWP 10R,026,960548,Staff,0,0,0,0
1746592221508,AWP 102R,A00,886190,Staff,0,0,0,0
1746592221508,AWP 102R,B00,886191,Staff,0,0,0,0
1746592222532,BENG 100,A01,886193,Staff,17,0,30,13
1746592223557,BENG 122A,A01,886195,Hasty; Jeff M,13,0,30,17
1746592224582,BENG 166A,A00,886196,Sah; Robert Lie-Yuan,0,3,30,30
1746592225606,BENG 190,A00,958050,Khojah; Reem I,17,0,25,8
1746592226632,BIBC 102,A01,894320,Staff,0,0,46,46
1746592226632,BIBC 102,A02,894321,Staff,0,0,46,46
1746592226632,BIBC 102,A03,894344,Staff,6,0,46,40
1746592226632,BIBC 102,A04,894345,Staff,27,0,47,20
1746592227657,BICD 100R,A01,894365,Smith; Laurie,1,3,58,57
1746592227657,BICD 100R,A02,894366,Smith; Laurie,1,5,58,57
1746592227657,BICD 100R,A03,894367,Smith; Laurie,0,0,59,59
1746592227657,BICD 100R,A04,959869,Smith; Laurie,39,0,59,20
1746592228683,BICD 136,A01,894383,Gustafson-Brown; Cindy,14,0,50,36
1746592229711,BIEB 102,A01,894494,Butler; Shannon Rhey,51,0,130,79
1746592231763,BIEB 150,A01,894617,Wills; Christopher,3,0,20,17
1746592231763,BIEB 150,A02,894631,Wills; Christopher,3,0,20,17
1746592231763,BIEB 150,A03,894937,Wills; Christopher,3,0,20,17
1746592231763,BIEB 150,A04,894946,Wills; Christopher,5,0,20,15
1746592232789,BIEB 194,A00,906141,Kurle; Carolyn M.,5,0,20,15
1746592233818,BILD 1,A01,894154,Staff,3,0,19,16
1746592233818,BILD 1,A02,894155,Staff,14,0,19,5
1746592233818,BILD 1,A03,894160,Staff,13,0,19,6
1746592233818,BILD 1,A04,894161,Staff,15,0,18,3
1746592234848,BILD 2,A01,894168,Staff,0,0,50,50
1746592234848,BILD 2,A02,894169,Staff,0,0,50,50
1746592234848,BILD 2,A03,894179,Staff,0,0,50,50
1746592234848,BILD 2,A04,894203,Staff,23,0,50,27
1746592236077,BILD 3,A01,894213,Staff,23,0,31,8
1746592236077,BILD 3,A02,894214,Staff,26,0,31,5
1746592236077,BILD 3,A03,894235,Staff,28,0,31,3
1746592236077,BILD 3,A04,894236,Staff,28,0,32,4
1746592237101,BILD 4,A01,894253,Reuther; Keefe,5,0,24,19
1746592237101,BILD 4,A02,894258,Reuther; Keefe,16,0,24,8
1746592238133,BILD 5,A01,894276,Reuther; Keefe,34,0,50,16
1746592238133,BILD 5,A02,894277,Reuther; Keefe,45,0,50,5
1746592238133,BILD 5,A03,894290,Reuther; Keefe,44,0,50,6
1746592238133,BILD 5,A04,894291,Reuther; Keefe,48,0,50,2
1746592239159,BILD 24,A01,894297,Pirino; Giorgia,40,0,60,20
1746592240184,BIMM 100,B01,958915,Staff,71,0,100,29
1746592241210,BIMM 101,A01,895017,McDonnell; Lisa Marie,0,5,24,24
1746592241210,BIMM 101,A02,895018,McDonnell; Lisa Marie,0,5,24,24
1746592241210,BIMM 101,B01,895020,McDonnell; Lisa Marie,1,6,24,23
1746592241210,BIMM 101,B02,895021,McDonnell; Lisa Marie,0,4,24,24
1746592242237,BIMM 110,A01,895023,Staff,1,0,25,24
1746592242237,BIMM 110,A02,895024,Staff,9,0,25,16
1746592242237,BIMM 110,A03,895025,Staff,18,0,25,7
1746592242237,BIMM 110,A04,895031,Staff,20,0,25,5
1746592243262,BIMM 120,A01,895114,Gustafson-Brown; Cindy,14,0,28,14
1746592243262,BIMM 120,A02,895126,Gustafson-Brown; Cindy,21,0,27,6
1746592244292,BIPN 100,A01,895130,Yang; Mingyu,0,0,38,38
1746592244292,BIPN 100,A02,895131,Yang; Mingyu,31,0,38,7
1746592244292,BIPN 100,A03,895132,Yang; Mingyu,32,0,38,6
1746592244292,BIPN 100,A04,895133,Yang; Mingyu,27,0,36,9
1746592245318,BIPN 120,A01,895135,Cooke; James Edward,0,3,13,13
1746592245318,BIPN 120,A02,895136,Cooke; James Edward,0,1,13,13
1746592245318,BIPN 120,A03,895137,Cooke; James Edward,0,3,13,13
1746592245318,BIPN 120,A04,895156,Cooke; James Edward,0,2,11,11
1746592246344,BIPN 134,A01,895235,Cooke; James Edward,0,1,25,25
1746592246344,BIPN 134,A02,895237,Cooke; James Edward,0,0,25,25
1746592246344,BIPN 134,A03,895240,Cooke; James Edward,2,0,25,23
1746592246344,BIPN 134,A04,895270,Cooke; James Edward,20,0,25,5
1746592247372,BIPN 189,A00,892103,Staff,0,14,14,14
1746592249427,BISP 194,A00,958008,Staff,0,2,0,0
1746592250453,CAT 124,A01,922009,Staff,0,5,20,20
1746592251486,CAT 125R,A00,886390,Morales; Celeste Georgianna,0,3,20,20
1746592251486,CAT 125R,B00,886391,Irwin; Matthew Joseph,0,4,20,20
1746592251486,CAT 125R,C00,886392,Smith; Lauryn Alissa,0,2,20,20
1746592251486,CAT 125R,D00,886393,Vanderschuit; Maya Alysia,0,3,20,20
1746592251486,CAT 125R,E00,886394,Marchisotto; Jennifer Anne,0,3,20,20
1746592252513,CENG 15,A01,886218,Drews; Aaron,3,0,8,5
1746592253542,CENG 113,A00,886219,Opatkiewicz; Justin Paul,15,0,25,10
1746592254569,CGS 101,A00,887044,Staff,7,0,20,13
1746592255597,CGS 105,A01,887046,Staff,14,0,25,11
1746592256626,CGS 112,A00,887047,Cuong; Marisol,12,0,15,3
1746592257651,CGS 113,A00,887048,Staff,23,0,30,7
1746592258677,CGS 120,A00,887049,Staff,10,0,17,7
1746592259713,CHEM 6A,A01,886336,Lam; Tin Yiu,38,0,50,12
1746592259713,CHEM 6A,A02,886338,Lam; Tin Yiu,37,0,50,13
1746592260740,CHEM 6B,A01,886341,Hopkins; Patrycja Anna,16,0,50,34
1746592260740,CHEM 6B,A02,886343,Hopkins; Patrycja Anna,42,0,50,8
1746592261766,CHEM 6C,A01,886346,Albizati; Kim F.,0,2,50,50
1746592261766,CHEM 6C,A02,886348,Albizati; Kim F.,24,0,50,26
1746592262793,CHEM 40A,A01,886352,Klosterman; Jeremy K,65,0,100,35
1746592263819,CHEM 40B,A01,886356,Klosterman; Jeremy K,0,24,100,100
1746592264847,CHEM 41B,A01,886360,Theodorakis; Emmanuel,25,0,50,25
1746592264847,CHEM 41B,A02,886362,Theodorakis; Emmanuel,47,0,50,3
1746592265877,CHIN 165A,A00,886382,Xu; Li,18,0,20,2
1746592266903,CLAS 120,A00,886387,Myerston Santana; Jacobo,33,0,40,7
1746592267928,COGS 9,A01,886967,Shannon; Kyle Michael,42,0,60,18
1746592268955,COGS 11,A01,886969,Staff,9,0,30,21
1746592269981,COGS 14A,A01,886971,Staff,5,0,60,55
1746592271009,COGS 14B,A01,886973,Hoffman; Drew Ellen,4,0,60,56
1746592272038,COGS 18,A01,886975,Morgan; Eric,34,0,60,26
1746592273069,COGS 20,A01,886977,Staff,2,0,8,6
1746592273069,COGS 20,A02,886978,Staff,4,0,7,3
1746592274093,COGS 100,A01,907783,Staff,1,2,30,29
1746592275124,COGS 101B,A01,886980,Staff,0,4,48,48
1746592276154,COGS 101C,A01,886982,Delgado; Tania,0,5,44,44
1746592277179,COGS 102A,A01,886984,Johnson; Christine M.,3,0,30,27
1746592278207,COGS 118B,A01,886986,Staff,1,5,88,87
1746592279235,COGS 150,A01,886988,Bergen; Benjamin,22,0,50,28
1746592280264,COGS 153,A00,886989,Delgado; Tania,0,3,41,41
1746592281291,COGS 186,A01,886991,Staff,0,0,32,32
1746592282316,COGS 187A,A01,886993,Boyle; Mary E. T.,7,0,30,23
1746592283344,COGS 189,A00,886994,Staff,0,1,30,30
1746592284370,COMM 10,A01,886996,Staff,0,0,20,21
1746592284370,COMM 10,A02,886997,Staff,10,0,20,10
1746592284370,COMM 10,A03,959845,Staff,19,0,20,1
1746592285397,COMM 20,A01,886999,Leuning; Grant Maurstad,24,0,40,16
1746592287453,COMM 100A,A01,887002,Staff,0,0,20,25
1746592287453,COMM 100A,A02,887003,Staff,6,0,20,14
1746592288480,COMM 100B,A01,887005,Staff,0,8,20,24
1746592289508,COMM 106D,A00,887006,Staff,13,0,40,27
1746592290533,COMM 110G,A00,887007,Whitworth-Smith; Andrew C,12,0,40,28
1746592291558,COMM 111B,A00,887008,Staff,31,0,40,9
1746592292585,COMM 113T,A00,887009,Abuelhiga; Soraya Jill,28,0,40,12
1746592292585,COMM 113T,B00,906733,Staff,40,0,40,0
1746592293610,COMM 145,A00,887010,Staff,12,0,40,28
1746592294636,COMM 146,A00,887054,Staff,31,0,40,9
1746592295666,COMM 190,A00,887012,Staff,8,0,23,15
1746592296692,CSE 8A,A50,887015,Cao; Yingjun,56,0,85,29
1746592297717,CSE 11,A01,887017,Cao; Yingjun,11,0,70,59
1746592298748,CSE 20,A01,887019,Staff,30,0,50,20
1746592299774,CSE 21,A01,887021,Staff,79,0,100,21
1746592299774,CSE 21,B01,892583,Braun; Oliver,45,0,50,5
1746592300802,CSE 30,A01,887025,Eldon; John,142,0,200,58
1746592301827,CSE 100,A01,887027,Staff,26,0,50,24
1746592301827,CSE 100,A02,887028,Staff,42,0,50,8
1746592302854,CSE 101,A01,887030,Braun; Oliver,74,0,100,26
1746592302854,CSE 101,B01,887032,Jones; Miles E,0,3,50,50
1746592302854,CSE 101,B02,887033,Jones; Miles E,0,2,50,50
1746592303879,CSE 105,A01,908084,Jones; Miles E,32,0,50,18
1746592303879,CSE 105,A02,908087,Jones; Miles E,31,0,50,19
1746592304911,CSE 135,A01,887035,Powell; Thomas Allan,0,5,50,50
1746592305941,CSE 142,A01,887037,Staff,8,0,60,52
1746592306967,CSE 142L,A01,887039,Staff,34,0,60,26
1746592307999,CSE 151A,A01,887041,Solares; Edwin A,47,0,100,53
1746592309028,CSE 175,A01,887043,Kumar; Rakesh,30,0,30,0
1746592310057,CSS 1,A01,886389,Staff,1,2,40,39
1746592311082,DSC 30,A01,908097,Liao; Soohyun Nam,47,0,75,28
1746592312113,DSC 40A,A01,908099,Shannon; Kyle Michael,30,0,50,20
1746592313138,DSC 40B,A01,908112,Staff,15,0,50,35
1746592314163,DSC 80,A01,908116,Staff,19,0,60,41
1746592315190,DSC 197,001,956863,Eldridge; Justin Matthew,9999,0,9999,0
1746592316216,ECE 5,A01,886400,Morris; Karcher William,1,0,6,5
1746592316216,ECE 5,A02,886401,Morris; Karcher William,3,0,6,3
1746592317241,ECE 148,A01,886403,Silberman; Jack,0,14,14,14
1746592318266,ECON 1,A01,887265,Crane; Meredith Helen,11,0,70,59
1746592318266,ECON 1,B01,887268,Staff,42,0,50,8
1746592319291,ECON 2,A01,887273,Crane; Meredith Helen,54,0,70,16
1746592320317,ECON 3,A01,887279,Rondina; Giacomo,31,0,70,39
1746592321343,ECON 4,A01,887282,Anderson; John Charles,0,2,10,10
1746592322374,ECON 5,A01,887285,Staff,34,0,45,11
1746592322374,ECON 5,B01,887292,Staff,41,0,45,4
1746592323401,ECON 100A,A01,887337,Newhouse; Herbert S,54,0,70,16
1746592323401,ECON 100A,B01,887349,Staff,45,0,50,5
1746592324425,ECON 100B,A01,887361,Du; Songzi,29,0,70,41
1746592325453,ECON 100C,A01,887445,Newhouse; Herbert S,59,0,70,11
1746592326482,ECON 105,A00,887488,Vespa; Emanuel Ignacio,23,0,35,12
1746592327511,ECON 109,A01,887506,Shishkin; Denis,28,0,35,7
1746592328538,ECON 110A,A01,887568,Alon; Titan Michael,1,3,35,34
1746592328538,ECON 110A,B01,907601,Alon; Titan Michael,20,0,35,15
1746592329565,ECON 110B,A01,887598,Levkoff; Steven B.,0,24,70,70
1746592330594,ECON 112,A00,887599,Rondina; Giacomo,19,0,35,16
1746592331621,ECON 120A,A01,887603,Dai; Yinlin,35,0,70,35
1746592332650,ECON 120C,A01,887608,Sun; Yixiao,0,1,35,35
1746592332650,ECON 120C,B01,887614,Sun; Yixiao,0,0,35,35
1746592333678,ECON 138,A00,887621,Bharadwaj; Prashant,0,21,20,20
1746592334703,ECON 144,A00,958007,Squires; Dale E,12,0,35,23
1746592335727,ECON 171,A01,907666,Staff,18,0,35,17
1746592336758,ECON 175,A00,887626,Wu; Pak Yeung,22,0,35,13
1746592337784,ECON 190,A00,887640,Vespa; Emanuel Ignacio,22,0,35,13
1746592338818,EDS 25,A01,888197,Staff,0,0,0,0
1746592338818,EDS 25,A02,888209,Staff,0,0,0,0
1746592338818,EDS 25,A03,888210,Staff,0,0,0,0
1746592338818,EDS 25,A04,888212,Staff,0,0,0,0
1746592338818,EDS 25,A05,888213,Staff,0,0,0,0
1746592338818,EDS 25,A06,888214,Staff,0,0,0,0
1746592338818,EDS 25,A07,888235,Staff,0,2,0,0
1746592338818,EDS 25,A08,888236,Staff,0,0,0,0
1746592338818,EDS 25,A09,888240,Staff,0,0,0,0
1746592338818,EDS 25,A10,888244,Staff,0,0,0,0
1746592338818,EDS 25,B01,888273,Staff,0,0,0,0
1746592338818,EDS 25,B02,888285,Staff,0,0,0,0
1746592338818,EDS 25,B03,888423,Staff,0,0,0,1
1746592338818,EDS 25,B04,888432,Staff,0,0,0,0
1746592338818,EDS 25,B05,888433,Staff,0,0,0,0
1746592338818,EDS 25,B06,888467,Staff,0,0,0,0
1746592338818,EDS 25,B07,888468,Staff,0,0,0,0
1746592338818,EDS 25,B08,888479,Staff,0,0,0,0
1746592338818,EDS 25,B09,888484,Staff,0,0,0,0
1746592338818,EDS 25,B10,888487,Staff,0,0,0,0
1746592339849,EDS 38,A01,907700,Choi; Bailey Miyeon,30,0,30,0
1746592340872,EDS 112,A01,888601,Chapman; Thandeka K,12,0,40,28
1746592341897,EDS 115,A00,888697,Mendez; Kathrina Mendoza,10,0,30,20
1746592342924,EDS 116,A01,888893,Staff,33,0,40,7
1746592344977,EDS 124AR,A00,889133,Staff,29,0,50,21
1746592344977,EDS 124AR,B00,907471,Simon; Elizabeth A,37,0,50,13
1746592346004,EDS 124BR,A00,889134,Simon; Elizabeth A,44,0,100,56
1746592347032,EDS 125,A00,889135,Staff,25,0,30,5
1746592348056,EDS 126,A01,889138,Staff,35,0,40,5
1746592349081,EDS 164R,A01,889142,Wishard Guerra; Alison G.,32,0,50,18
1746592350111,ENG 30,A01,886396,Staff,0,0,0,0
1746592350111,ENG 30,B01,886398,Staff,0,0,0,0
1746592351146,ENVR 102,A00,906150,Montejo; Carolina,23,0,25,2
1746592352173,ETHN 103A,A00,887236,Man; Simeon S,0,2,0,0
1746592353198,ETHN 113,A00,887239,Staff,16,0,30,14
1746592354224,ETHN 116,A00,887240,Staff,16,0,25,9
1746592355256,ETHN 117,A00,887241,Choi; Esther Min,28,0,30,2
1746592356284,ETHN 118,A00,887243,Staff,24,0,30,6
1746592357312,ETHN 127,A00,887248,Cuong; Marisol,11,0,15,4
1746592358341,ETHN 139,A00,887250,Staff,7,0,10,3
1746592359369,ETHN 142,A00,887252,Staff,10,0,30,20
1746592360398,ETHN 161,A00,887253,Browne; Errol Tsekani,24,0,30,6
1746592361426,ETHN 163FR,A00,887255,Burelle; Julie Sara Veronique,0,0,5,5
1746592362451,GLBH 20,A00,889149,Elwardani; Nile Regina,8,0,42,34
1746592364502,GLBH 111,A01,889152,Burgos; Jose L.,17,0,17,0
1746592365529,GLBH 150,A00,889181,Sloane; Julia Kathryn,0,5,15,15
1746592367580,HDS 60,A01,886406,Warstadt; Melissa Fawn,72,0,80,8
1746592368606,HIAF 111,A00,889324,Gyamfi; Bright,25,0,32,7
1746592369631,HIEA 131,A00,889328,Staff,15,0,32,17
1746592370662,HIEA 144,A00,889333,Henry; Todd A.,26,0,32,6
1746592371690,HIEA 154,A00,889336,Henry; Todd A.,24,0,32,8
1746592372714,HIEU 106,A00,889339,Staff,22,0,32,10
1746592374792,HIEU 114,A00,889340,Staff,4,0,32,28
1746592375818,HIEU 135GS,A00,889342,Patterson; Patrick H.,0,0,1,24
1746592376842,HIEU 137,A00,889343,Edington; Claire Ellen,10,0,25,15
1746592377870,HIEU 148,A00,889345,Staff,14,0,32,18
1746592378898,HIEU 154,A00,889346,Biess; Frank Peter,21,0,32,11
1746592379926,HILA 102,A00,889351,Staff,12,0,32,20
1746592380954,HILD 2A,A01,889221,Lewandoski; Julia Mavis,2,10,32,30
1746592381982,HILD 7B,A01,889225,Man; Simeon S,0,12,32,32
1746592383009,HILD 7C,A01,889288,Alvarez; Luis A,0,14,32,32
1746592384038,HILD 30,A01,889323,Staff,0,5,32,32
1746592386086,HISC 119,A00,889383,Golan; Tal,19,0,32,13
1746592387111,HIUS 103,A00,889384,Man; Simeon S,0,0,32,32
1746592388140,HIUS 117,A00,919797,Kwak; Nancy,18,0,32,14
1746592389165,HIUS 142A,A00,919788,Staff,22,0,32,10
1746592391222,HIUS 149,A00,889386,Gyamfi; Bright,26,0,32,6
1746592392250,HIUS 155,A00,889387,Alvarez; Luis A,15,0,32,17
1746592393275,HUM 3,A01,886499,Caldwell; Michael Alan,19,0,50,31
1746592394305,HUM 3GS,A00,886500,Rodriguez; Bretton Sigfred,0,0,0,28
1746592395329,HUM 3R,A01,886502,Markman; Kristina,0,36,50,50
1746592396358,HUM 4,A01,886504,Crum; Matthew Stephen,23,0,50,27
1746592396358,HUM 4,B01,886506,West; Geoffrey Scott,17,0,50,33
1746592397381,HUM 4GS,A00,886507,Staff,0,0,0,19
1746592398406,HUM 5,A01,886509,Staff,31,0,50,19
1746592399430,HUM 5R,A01,886511,Zavodny; Tatiana Sophia,0,39,50,50
1746592400459,JAPN 180,A00,886407,Staff,16,0,40,24
1746592401485,LATI 50,A01,886409,Martin-Cabrera; Luis,3,0,22,19
1746592401485,LATI 50,A02,886410,Martin-Cabrera; Luis,19,0,22,3
1746592401485,LATI 50,A03,886411,Martin-Cabrera; Luis,21,0,22,1
1746592401485,LATI 50,A04,886412,Martin-Cabrera; Luis,8,0,22,14
1746592402508,LAWS 101,A00,907664,Staff,28,0,60,32
1746592403532,LIAB 1A,A00,889388,Saab; Dima,17,0,20,3
1746592404558,LIAB 1AX,A00,889389,El Cheddadi; Youniss,18,0,20,2
1746592405585,LIFR 1C,A00,889391,Van Moer; Vinciane G,8,0,20,12
1746592406611,LIFR 1CX,A00,889392,Van Moer; Vinciane G,7,0,20,13
1746592407640,LIFR 1D,A00,889393,Van Moer; Vinciane G,7,0,20,13
1746592408665,LIFR 1DX,A00,889394,Van Moer; Vinciane G,8,0,20,12
1746592409691,LIGN 7,A00,886923,Staff,24,0,50,26
1746592410716,LIGN 17,A00,886924,Kehler; Andrew Scott,125,0,150,25
1746592411740,LTAM 110,A00,889395,Staff,15,0,30,15
1746592412766,LTAM 110GS,A00,958010,Rodriguez; Bretton Sigfred,0,0,0,28
1746592413793,LTCH 101,A00,889397,Staff,23,0,25,2
1746592414818,LTCS 130,A00,889398,Staff,23,0,25,2
1746592415843,LTEA 138,A00,889399,Staff,24,0,40,16
1746592416869,LTEN 149,A00,889400,Wesling; Megan E.,0,3,25,25
1746592417896,LTEN 169,A00,889401,Staff,20,0,25,5
1746592418923,LTEN 180,A00,889402,Staff,10,0,15,5
1746592419946,LTEN 181,A00,889403,Staff,21,0,25,4
1746592420975,LTWL 100,A00,889404,Myerston Santana; Jacobo,2,0,25,23
1746592422001,LTWL 180GS,A00,889405,Staff,0,0,20,20
1746592423030,LTWL 181,A00,889406,Staff,16,0,25,9
1746592424056,LTWL 184,A00,889475,Mukherjee; Silpa,22,0,25,3
1746592425083,LTWR 102C,A00,889486,Staff,29,0,30,1
1746592426113,LTWR 115W,A00,889491,Staff,0,2,15,15
1746592427138,MAE 8,A01,886905,Staff,0,2,0,0
1746592428184,MAE 11,A00,886906,Bandaru; Prabhakar,0,7,50,50
1746592429215,MAE 20,A00,886907,Evdokimenko; Ekaterina,43,0,70,27
1746592430245,MAE 30B,A00,886909,Ghazinejad; Maziar,25,0,45,20
1746592431269,MAE 101B,A00,886910,Saintillan; David,29,0,45,16
1746592432296,MAE 105,A00,886911,Bandaru; Prabhakar,18,0,50,32
1746592433325,MAE 107,B00,958024,Staff,7,0,50,43
1746592434352,MAE 143B,A00,886913,Bewley; Thomas R,3,0,40,37
1746592435377,MAE 148,A01,886915,Silberman; Jack,0,3,14,14
1746592436406,MAE 160,A00,886916,Evdokimenko; Ekaterina,31,0,60,29
1746592437451,MATH 3C,A01,889681,Staff,0,2,30,30
1746592437451,MATH 3C,A02,960048,Staff,23,0,30,7
1746592438481,MATH 10A,A01,889760,Staff,26,0,30,4
1746592438481,MATH 10A,A02,889783,Staff,29,0,30,1
1746592439507,MATH 10B,A01,889785,Verstraete; Jacques Allan,1,0,35,34
1746592439507,MATH 10B,A02,889795,Verstraete; Jacques Allan,4,0,35,31
1746592439507,MATH 10B,B01,889797,Verstraete; Jacques Allan,3,0,35,32
1746592439507,MATH 10B,B02,889828,Verstraete; Jacques Allan,3,0,35,32
1746592440544,MATH 10C,A01,889849,Habib; Yousaf,8,0,30,22
1746592440544,MATH 10C,A02,889852,Habib; Yousaf,14,0,30,16
1746592440544,MATH 10C,A03,889853,Habib; Yousaf,22,0,30,8
1746592440544,MATH 10C,A04,889858,Habib; Yousaf,20,0,30,10
1746592440544,MATH 10C,B01,889861,Staff,1,0,30,29
1746592440544,MATH 10C,B02,889862,Staff,24,0,30,6
1746592440544,MATH 10C,B03,889863,Staff,27,0,30,3
1746592440544,MATH 10C,B04,889967,Staff,23,0,30,7
1746592441571,MATH 18,A01,889974,Staff,7,0,30,23
1746592441571,MATH 18,A02,889977,Staff,20,0,30,10
1746592441571,MATH 18,B01,889984,Hardiman; Liam,20,0,30,10
1746592441571,MATH 18,B02,889985,Hardiman; Liam,25,0,30,5
1746592442598,MATH 20A,A01,889990,Suk; Andrew Hoon,30,0,35,5
1746592443623,MATH 20B,A01,889993,Ohm; Ko Woon,21,0,30,9
1746592443623,MATH 20B,A02,889994,Ohm; Ko Woon,30,0,30,0
1746592443623,MATH 20B,B01,889996,Ohm; Ko Woon,22,0,30,8
1746592443623,MATH 20B,B02,889997,Ohm; Ko Woon,23,0,30,7
1746592444649,MATH 20C,A01,889999,Hammock; Frances H,17,0,30,13
1746592444649,MATH 20C,A02,890003,Hammock; Frances H,23,0,30,7
1746592444649,MATH 20C,B01,890006,Hammock; Frances H,3,0,30,27
1746592444649,MATH 20C,B02,890007,Hammock; Frances H,12,0,30,18
1746592445683,MATH 20D,A01,890011,Cheng; Hsiao-Bing,1,1,30,29
1746592445683,MATH 20D,A02,890012,Cheng; Hsiao-Bing,14,0,30,16
1746592445683,MATH 20D,B01,890016,Cheng; Hsiao-Bing,13,0,30,17
1746592445683,MATH 20D,B02,890017,Cheng; Hsiao-Bing,13,0,30,17
1746592446708,MATH 20E,A01,890026,Harel; Guershon,1,0,30,29
1746592446708,MATH 20E,A02,890029,Harel; Guershon,22,0,30,8
1746592446708,MATH 20E,B01,890033,Harel; Guershon,7,0,30,23
1746592446708,MATH 20E,B02,890101,Harel; Guershon,21,0,30,9
1746592447736,MATH 102,A01,890104,Staff,18,0,30,12
1746592447736,MATH 102,A02,890105,Staff,27,0,30,3
1746592448763,MATH 103B,A01,890116,Salehi Golsefidy; Alireza,3,0,30,27
1746592448763,MATH 103B,B01,890118,Staff,0,3,34,34
1746592449789,MATH 109,A01,890121,Aliabadi Sr.; Mohsen,0,0,30,30
1746592449789,MATH 109,B01,890124,Upadrashta; Pranav Kumar,18,0,30,12
1746592450815,MATH 120A,A01,890126,Eggers; John Dietrich,13,0,30,17
1746592451840,MATH 142B,A01,890128,Ioana; Adrian,19,0,30,11
1746592451840,MATH 142B,A02,890129,Ioana; Adrian,12,0,30,18
1746592452868,MATH 154,A01,890174,Staff,0,1,30,30
1746592452868,MATH 154,A02,890182,Staff,0,0,30,30
1746592453894,MATH 168A,A01,890197,Dumitriu; Ioana,21,0,35,14
1746592454921,MATH 170A,A01,890240,Nie; Jiawang,1,0,30,29
1746592454921,MATH 170A,A02,890241,Nie; Jiawang,11,0,30,19
1746592454921,MATH 170A,A03,890249,Nie; Jiawang,23,0,30,7
1746592455945,MATH 170B,A01,957891,Nag; Panchali,13,0,35,22
1746592457994,MATH 181A,A01,908025,Staff,0,3,35,35
1746592457994,MATH 181A,A02,960115,Staff,26,0,35,9
1746592459019,MATH 181B,A01,959874,Staff,24,0,30,6
1746592460044,MATH 193B,A01,890265,Staff,0,4,35,35
1746592461072,MGT 4,A01,890311,Anderson; John Charles,42,0,88,46
1746592462098,MGT 5,A00,907740,Staff,12,0,98,86
1746592463122,MGT 12,A00,890312,Lindenberger; Wade Douglas,67,0,98,31
1746592464146,MGT 16,A00,957883,Staff,78,0,98,20
1746592466199,MGT 45,A00,890314,Pecore; Joseph P.,45,0,98,53
1746592467223,MGT 71,A00,890315,Staff,0,12,98,98
1746592468248,MGT 100,A00,890316,Yavorsky; Daniel Ryan,44,0,98,54
1746592469272,MGT 103,A00,890317,Ehrich; Kristine R,73,0,98,25
1746592470297,MGT 105,A00,890356,Bates; Kenneth Walter,0,8,98,98
1746592471320,MGT 112,A00,890360,Ehrich; Kristine R,55,0,98,43
1746592472349,MGT 127R,A00,907732,Zhu; Kevin Xiaoguo,23,0,98,75
1746592473374,MGT 131B,A00,890361,Anderson; John Charles,59,0,98,39
1746592474398,MGT 137,A00,890362,Lindenberger; Wade Douglas,65,0,98,33
1746592475430,MGT 160,A00,890369,Johnson; Erik Barry,9,0,98,89
1746592477482,MGT 164,A00,890372,Zimmermann; Carsten,0,40,98,98
1746592478509,MGT 180,A00,890374,Bliss; Barbara Ann,11,0,98,87
1746592479535,MMW 15,A01,886414,Chang; Edmond Yi-Teh,0,12,28,28
1746592479535,MMW 15,A02,886415,Chang; Edmond Yi-Teh,0,8,28,28
1746592479535,MMW 15,A03,886416,Chang; Edmond Yi-Teh,0,9,28,28
1746592479535,MMW 15,A04,886417,Chang; Edmond Yi-Teh,0,8,28,28
1746592479535,MMW 15,B01,886419,Chang; Edmond Yi-Teh,0,7,28,28
1746592479535,MMW 15,B02,886420,Chang; Edmond Yi-Teh,0,8,28,28
1746592479535,MMW 15,B03,886421,Chang; Edmond Yi-Teh,0,7,28,28
1746592479535,MMW 15,B04,886422,Chang; Edmond Yi-Teh,0,8,28,28
1746592479535,MMW 15,C01,886424,Staff,0,9,28,28
1746592479535,MMW 15,C02,886425,Staff,0,8,28,28
1746592479535,MMW 15,C03,886426,Staff,0,8,28,28
1746592479535,MMW 15,C04,886427,Staff,0,8,28,28
1746592479535,MMW 15,C05,958038,Staff,0,8,28,28
1746592479535,MMW 15,C06,958039,Staff,1,8,28,27
1746592480560,MMW 15GS,A00,906910,Patterson; Patrick H.,4,0,28,24
1746592481586,MMW 122R,A01,886429,Rahimi; Babak,0,13,28,28
1746592481586,MMW 122R,A02,886430,Rahimi; Babak,0,12,28,28
1746592481586,MMW 122R,A03,958040,Rahimi; Babak,0,11,28,28
1746592482612,MUS 1A,A01,890937,Staff,2,0,25,23
1746592482612,MUS 1A,A02,891035,Staff,6,0,25,19
1746592482612,MUS 1A,C01,958912,Staff,24,0,25,1
1746592482612,MUS 1A,C02,958913,Staff,25,0,25,0
1746592484665,MUS 2AK,A00,957092,Ohnishi; Takae,15,0,15,0
1746592485692,MUS 4,A01,891044,Staff,0,0,25,25
1746592485692,MUS 4,A02,891045,Staff,22,0,25,3
1746592485692,MUS 4,B01,891048,Staff,17,0,25,8
1746592485692,MUS 4,B02,891050,Staff,25,0,25,0
1746592486717,MUS 5,A01,957506,Dubnov; Shlomo,0,0,25,25
1746592486717,MUS 5,A02,957622,Dubnov; Shlomo,13,0,25,12
1746592486717,MUS 5,A03,957623,Dubnov; Shlomo,20,0,25,5
1746592487744,MUS 6,A01,891053,Freitas Caetano; Marcelo,24,0,25,1
1746592487744,MUS 6,A02,891054,Freitas Caetano; Marcelo,23,0,25,2
1746592488770,MUS 7,A01,891081,Staff,0,0,25,25
1746592488770,MUS 7,A02,891082,Staff,3,0,25,22
1746592489796,MUS 8GS,A00,891118,Borgo; David Garcia,1,0,25,24
1746592490824,MUS 11,A01,891140,Staff,9,0,25,16
1746592490824,MUS 11,A02,891141,Staff,21,0,25,4
1746592491849,MUS 13,A01,891143,Staff,8,0,25,17
1746592491849,MUS 13,A02,891144,Staff,24,0,25,1
1746592492876,MUS 15,A01,891146,Staff,9,0,25,16
1746592492876,MUS 15,A02,891148,Staff,21,0,25,4
1746592492876,MUS 15,B01,891150,Staff,18,0,25,7
1746592492876,MUS 15,B02,891151,Staff,25,0,25,0
1746592493903,MUS 20,A01,891153,Staff,5,0,20,15
1746592493903,MUS 20,A02,891155,Staff,14,0,20,6
1746592494930,MUS 80,A00,891156,Staff,19,0,25,6
1746592494930,MUS 80,B00,891157,Staff,23,0,25,2
1746592495957,MUS 130,A00,891158,Ohnishi; Takae,35,0,35,0
1746592496983,MUS 150GS,A01,891160,Borgo; David Garcia,1,0,25,24
1746592498011,MUS 170,A01,891162,Freitas Caetano; Marcelo,20,0,25,5
1746592498011,MUS 170,A02,891164,Freitas Caetano; Marcelo,21,0,25,4
1746592499037,NANO 11,A00,886220,Vazquez Mena; Oscar,13,0,15,2
1746592500064,NANO 15,A01,886222,Drews; Aaron,4,0,7,3
1746592501093,NANO 104,A00,886224,Sirbuly; Donald,17,0,25,8
1746592502119,PH 40,A00,886528,Staff,23,0,40,17
1746592503145,PH 45,A01,886799,Staff,35,0,40,5
1746592504177,PH 110,A00,886802,Staff,0,6,40,40
1746592505206,PH 172,A00,906716,Staff,19,0,35,16
1746592506233,PH 191,A00,886803,Staff,6,0,40,34
1746592507261,PHIL 1,A00,889500,Staff,20,0,30,10
1746592508285,PHIL 10,A01,889549,Grush; Rick Scott,16,0,22,6
1746592508285,PHIL 10,A02,889551,Grush; Rick Scott,22,0,22,0
1746592509313,PHIL 28,A01,889559,Lamey; Andy M.,0,2,31,31
1746592509313,PHIL 28,A02,889561,Lamey; Andy M.,0,1,30,30
1746592509313,PHIL 28,A03,889572,Lamey; Andy M.,0,1,30,30
1746592510339,PHIL 35,A00,907839,Staff,13,0,15,2
1746592511364,PHIL 60,A00,889574,Staff,73,0,90,17
1746592512404,PHIL 101,A00,958004,Staff,12,0,15,3
1746592514455,PHIL 136,A00,889582,Fulkerson; Matthew Todd,26,0,45,19
1746592515479,PHIL 163,A01,889601,Staff,21,0,30,9
1746592515479,PHIL 163,B01,889606,Brandt; Reuven A,0,3,0,0
1746592516508,PHIL 164,A00,889610,Staff,16,0,30,14
1746592517532,PHIL 165,A00,889613,Staff,22,0,30,8
1746592518558,PHYS 1A,A00,886431,Staff,30,0,70,40
1746592519584,PHYS 1AL,001,886432,Tsai; Philbert S,1,2,30,29
1746592519584,PHYS 1AL,002,886436,Tsai; Philbert S,13,0,30,17
1746592520610,PHYS 1B,A00,886439,Staff,184,0,240,56
1746592521635,PHYS 1BL,001,886441,Tsai; Philbert S,0,4,30,30
1746592521635,PHYS 1BL,002,886444,Tsai; Philbert S,2,0,30,28
1746592522662,PHYS 1C,A00,896092,Arnold; Kam S,78,0,146,68
1746592523688,PHYS 1CL,001,886448,Tsai; Philbert S,0,0,30,30
1746592523688,PHYS 1CL,002,886449,Tsai; Philbert S,1,0,30,29
1746592523688,PHYS 1CL,003,886450,Tsai; Philbert S,16,0,30,14
1746592523688,PHYS 1CL,004,886451,Tsai; Philbert S,15,0,30,15
1746592524713,PHYS 2B,A01,886457,Staff,67,0,115,48
1746592525739,PHYS 2C,A01,886460,Shotwell; Brian,0,9,65,65
1746592526768,PHYS 2CL,A01,886467,Staff,0,4,28,28
1746592526768,PHYS 2CL,A02,886468,Staff,0,3,28,28
1746592527798,PHYS 2D,A01,886470,Staff,10,0,50,40
1746592528824,PHYS 4B,A01,886475,Grinstein; Benjamin,22,0,40,18
1746592529854,POLI 5,A00,891173,Desposato; Scott,7,0,25,18
1746592530881,POLI 5D,A01,891175,Staff,5,0,5,0
1746592530881,POLI 5D,B01,891178,Staff,5,0,5,0
1746592531910,POLI 11,A00,891179,Ferree; Karen E,1,0,35,34
1746592532934,POLI 12,A00,891180,Staff,16,0,30,14
1746592533963,POLI 27,A01,891182,Staff,12,0,75,63
1746592534989,POLI 30,A00,891183,Staff,8,0,50,42
1746592536019,POLI 100B,A00,891244,Staff,5,1,35,30
1746592537045,POLI 100I,A00,891247,Staff,7,0,30,23
1746592538071,POLI 104J,A00,891248,Nichter; Maysa,14,0,30,16
1746592539102,POLI 104U,A00,891250,Nichter; Maysa,1,0,30,29
1746592541166,POLI 110B,A00,891255,Wiens; David,19,0,25,6
1746592542194,POLI 112A,A00,891256,Wiens; David,6,0,25,19
1746592543220,POLI 114BR,A00,891261,Staff,19,0,30,11
1746592544244,POLI 117R,A00,891262,Forman; Fonna,0,6,50,50
1746592545272,POLI 118,A00,891264,Ingham; Sean,17,0,25,8
1746592546297,POLI 124A,A00,891265,Staff,18,0,20,2
1746592547323,POLI 125D,A00,891266,Nichter; Simeon C,2,0,25,23
1746592548348,POLI 126,A00,891268,Nichter; Simeon C,7,0,25,18
1746592549374,POLI 126AA,A00,891272,Staff,15,0,25,10
1746592550401,POLI 130AA,A00,891273,Staff,15,0,20,5
1746592551430,POLI 134AA,A00,891274,Staff,4,0,20,16
1746592553482,POLI 138,A00,891278,Staff,21,0,25,4
1746592554508,POLI 142K,A00,891280,Staff,10,0,25,15
1746592555534,POLI 142M,A00,891281,Gartzke; Erik,16,0,30,14
1746592556560,POLI 142P,A00,891284,Staff,20,0,30,10
1746592557586,POLI 143,A00,891285,Gartzke; Erik,12,0,30,18
1746592558615,POLI 153,A00,891286,Staff,19,0,20,1
1746592560667,POLI 175,A00,891290,Staff,15,0,20,5
1746592561696,PSYC 1,A00,890674,Steiner; Eric Tomas,0,11,45,45
1746592562726,PSYC 2,A00,890676,Albright; Thomas D,20,0,35,15
1746592563756,PSYC 3,A00,890679,Staff,17,0,20,3
1746592564785,PSYC 6,A00,959858,Staff,19,0,20,1
1746592565813,PSYC 60,A01,890684,Rickard; Timothy C.,0,6,45,45
1746592566840,PSYC 70,A01,890689,Geller; Emma Harlan,6,0,30,24
1746592567869,PSYC 71,A01,959860,Staff,21,0,25,4
1746592568897,PSYC 100,A00,890690,Lacefield; Katharine I,0,50,180,180
1746592569924,PSYC 102,A00,890695,Staff,18,0,40,22
1746592570952,PSYC 105,A00,890699,Geller; Emma Harlan,70,0,100,30
1746592571978,PSYC 106,A00,890701,Gorman; Michael R.,5,0,30,25
1746592573004,PSYC 108,A00,890704,Adrian; Julia Anna,0,29,50,50
1746592574033,PSYC 118,A01,890712,Staff,11,0,30,19
1746592575058,PSYC 124,A00,890716,Chapman; Eddie Nathaniel,25,0,60,35
1746592576085,PSYC 131,A00,890717,Anagnostaras; Stephan,0,7,80,80
1746592577111,PSYC 137,A00,890719,Winkielman; Piotr,0,11,30,30
1746592578139,PSYC 144,A00,890721,Adrian; Julia Anna,0,9,45,45
1746592579168,PSYC 162,A00,890805,Staff,0,1,75,75
1746592580197,PSYC 169,A00,890810,Staff,0,15,30,30
1746592581223,PSYC 172,A00,890814,Gorman; Michael R.,9,0,30,21
1746592582248,PSYC 181,A00,890818,Anagnostaras; Stephan,7,0,200,193
1746592583277,PSYC 184,A00,959861,Staff,163,0,175,12
1746592584302,PSYC 189,A00,890823,Staff,0,2,30,30
1746592585329,PSYC 191,A00,890884,Rickard; Timothy C.,0,12,35,35
1746592586358,PSYC 193,A00,890913,Staff,19,0,30,11
1746592586358,PSYC 193,B00,890914,Chapman; Eddie Nathaniel,24,0,30,6
1746592587384,PSYC 193L,A01,890918,Lowe; Angela Beth,20,0,30,10
1746592587384,PSYC 193L,B01,890921,Hurwitz; Ethan Scott,20,0,30,10
1746592587384,PSYC 193L,C01,890928,Staff,30,0,30,0
1746592588409,RELI 149,A00,886806,Rahimi; Babak,23,0,40,17
1746592589438,SE 9,A01,886814,Staff,7,0,20,13
1746592590464,SE 101B,A01,886816,Chadha; Mayank,3,0,35,32
1746592591490,SE 110B,A00,886818,Zhu; Qiang,4,0,75,71
1746592592518,SE 125,A01,886830,Staff,10,0,30,20
1746592593545,SE 130B,A01,886835,Staff,14,0,40,26
1746592594575,SE 131A,A01,886838,Krysl; Petr,34,0,55,21
1746592595602,SE 154,A00,886840,Staff,28,0,50,22
1746592596630,SE 164GS,A01,886849,Staff,6,0,20,14
1746592597660,SE 167GS,A01,886853,Staff,6,0,20,14
1746592598684,SIO 25,A01,890107,Staff,19,0,30,11
1746592599709,SIO 45,A00,890109,Cook; Geoffrey W,116,0,200,84
1746592600736,SIO 109R,A00,890110,Forman; Fonna,0,16,20,20
1746592601762,SIO 187,A01,890114,Kacev; David,15,0,40,25
1746592602790,SOCI 1,A01,890431,Thorpe; Charles Robert,14,0,30,16
1746592602790,SOCI 1,A02,890518,Thorpe; Charles Robert,30,0,30,0
1746592603817,SOCI 2,A01,957978,Staff,25,0,25,0
1746592603817,SOCI 2,A02,957979,Staff,23,0,25,2
1746592604847,SOCI 20,A01,890523,Calderon-Zaks; Michael Aar,21,0,30,9
1746592604847,SOCI 20,A02,890526,Calderon-Zaks; Michael Aar,29,0,30,1
1746592605877,SOCI 30,A01,890533,Pardo Guerra; Juan Pablo,37,0,40,3
1746592606905,SOCI 40,A01,890535,Staff,27,0,45,18
1746592607934,SOCI 104Q,A00,890559,Staff,18,0,30,12
1746592608959,SOCI 106,A00,890560,Arnal; Maud Marie Leonie,20,0,30,10
1746592609986,SOCI 110,A00,890567,Holkenbrink-Monk; Charlene,19,0,30,11
1746592611011,SOCI 112,A00,890568,Victoria Torres; Pablo,2,0,55,53
1746592612042,SOCI 115,A00,890597,Arnal; Maud Marie Leonie,28,0,45,17
1746592614095,SOCI 121,A00,890604,Pardo Guerra; Juan Pablo,38,0,45,7
1746592615120,SOCI 126,A01,890608,Staff,8,0,10,2
1746592616147,SOCI 127,A00,890609,Staff,18,0,30,12
1746592617173,SOCI 131,A00,890610,Thorpe; Charles Robert,37,0,45,8
1746592618201,SOCI 135,A00,890615,Payne; Christine Anna,14,0,45,31
1746592619228,SOCI 139,A00,890620,Staff,38,0,45,7
1746592620257,SOCI 148E,A00,890622,Calderon-Zaks; Michael Aar,36,0,45,9
1746592621283,SOCI 150,A00,890623,Kohler; Kristopher M.,31,0,45,14
1746592622309,SOCI 157,A00,890625,Jules-Rosette; Bennetta W.,18,0,20,2
1746592623334,SOCI 160,A00,890627,Payne; Christine Anna,21,0,45,24
1746592624359,SYN 1,A00,886855,Fish; Gwendolyn Anne,0,1,0,0
1746592624359,SYN 1,B00,906086,Fish; Gwendolyn Anne,0,2,0,2
1746592625385,SYN 2R,A00,886860,Staff,0,17,15,15
1746592625385,SYN 2R,B00,906106,Atkinson; Arthur Laird,0,16,15,15
1746592626418,SYN 100,A01,886866,Browne; Emily,0,28,20,20
1746592626418,SYN 100,B01,906128,Rock; Martin,0,4,20,20
1746592626418,SYN 100,C01,906140,Deavenport; James Cary,0,4,20,20
1746592626418,SYN 100,D01,907816,Deavenport; James Cary,0,5,20,20
1746592627444,TDAC 1,A00,890286,Walsh; Kim C.,7,0,20,13
1746592628474,TDAC 101,A00,890296,Basso; Beatrice,15,0,20,5
1746592629503,TDDE 131,A00,890297,Staff,47,0,50,3
1746592630531,TDDM 1,A00,890287,Weinberg; Sadie,25,0,30,5
1746592631556,TDGE 11,A00,890288,Fulton; Julia,138,0,200,62
1746592631556,TDGE 11,B00,890289,Castro; Robert Jess,185,0,200,15
1746592632582,TDGE 25,B00,957359,Walsh; Kim C.,5,0,20,15
1746592633614,TDGE 40,A01,890292,Power; Jade Yukana,26,0,30,4
1746592634641,TDGE 124,A00,890298,Havis; Allan,0,2,50,50
1746592635668,TDGE 131R,A00,890299,Burelle; Julie Sara Veronique,15,0,42,27
1746592636694,TDHT 101,A00,890300,Staff,10,0,20,10
1746592637723,TDHT 109,A01,890302,Anderson; Mysia Anyse,31,0,40,9
1746592638748,TDMV 1,A00,890293,Arcidiacono; Kristin,18,0,30,12
1746592639773,TDMV 2,A00,890294,Weinberg; Sadie,23,0,30,7
1746592640799,TDMV 3,A00,957878,Arcidiacono; Kristin,28,0,30,2
1746592642852,TDMV 138,A00,890304,Jun; Grace Shin Hae,25,0,40,15
1746592643880,TDMV 140,A00,890305,Corrales; Joseph Bernales,25,0,30,5
1746592644904,TDMV 142,A00,890307,Caligagan; Tony,32,0,40,8
1746592645929,TDMV 144,A00,890308,Camaya; Michelle Ann,25,0,30,5
1746592646958,TDPW 1,A00,890295,Stein; Deborah Isobel,3,0,20,17
1746592647984,USP 2,A01,890272,Lerner; Amy M,7,0,20,13
1746592649008,USP 3,A01,890274,Staff,12,0,30,18
1746592650034,USP 15,A01,890276,Sun; Feiyang,16,0,30,14
1746592651059,USP 25,A00,890277,Shenkman; Michael Thomas,18,0,25,7
1746592652085,USP 138,A00,890278,Staff,13,0,25,12
1746592653112,USP 143,A00,890279,Staff,22,0,70,48
1746592654136,USP 144,A00,890280,Chowdhury; Muhammed Zohir,16,0,30,14
1746592655162,USP 150,A00,890281,Boomhower; Matthew Charles,4,0,30,26
1746592656189,USP 151,A00,890282,Staff,16,0,20,4
1746592657214,USP 162,A00,890283,Andrews; Abigail Leslie,16,0,20,4
1746592658239,USP 168,A00,920477,Kwak; Nancy,0,0,5,5
1746592659266,USP 181,A00,890284,Staff,3,0,20,17
1746592660295,USP 191A,A00,890285,Staff,12,0,20,8
1746592661320,VIS 101,A00,886512,Staff,26,0,75,49
1746592662345,VIS 103,A00,886513,Cruz; Edwin Teddy,61,0,75,14
1746592663371,VIS 108,A00,886514,Staff,3,0,15,12
1746592664400,VIS 127P,A00,886515,Shen; Kuiyi,79,0,146,67
1746592665425,VIS 149,A00,886516,Yoldas; Pinar,0,0,15,15
1746592666450,VIS 164,A00,886526,Erdmann; Dean,19,0,22,3
1746592667477,VIS 194S,A00,886527,Staff,61,0,75,14
1746592668502,WCWP 10A,C00,886484,Martiniuk; Jill,12,0,15,3
1746592669528,WCWP 10B,A00,886490,Uriarte; Emma,0,0,15,15
1746592669528,WCWP 10B,B00,886491,Dhir; Simrita,8,0,15,7
1746592669528,WCWP 10B,C00,886492,Ornelas; Tricia,0,0,15,15
1746592670554,WCWP 100,A00,886494,Young; Mark T,0,6,15,15
1746592672660,AAS 10,A01,886199,Childs; Dennis R.,0,3,0,0
1746592673688,ANAR 104,A01,886940,Shtienberg; Gilad,27,0,30,3
1746592674716,ANAR 120,A00,886953,Staff,13,0,20,7
1746592675744,ANBI 148,A01,886955,Wilder; Linnea Lorene,30,0,40,10
1746592677800,ANSC 122,A00,886957,Staff,24,0,30,6
1746592678829,ANSC 150,A00,886958,Sloane; Julia Kathryn,2,0,15,13
1746592679853,ANSC 156,A00,886959,Jenkins; Janis A.,0,1,15,15
1746592680879,ANSC 180,A00,886960,Staff,11,0,17,6
1746592681948,ANSC 188,A00,886961,Jassal; Aftab,9,0,25,16
1746592682976,ANSC 190,A00,886962,Jassal; Aftab,14,0,25,11
1746592684004,ANSC 191,A00,886963,Staff,18,0,20,2
1746592685038,ANTH 3,A01,891689,Staff,17,0,20,3
1746592686067,ANTH 5,A00,886933,Semendeferi; Ekaterini,16,0,20,4
1746592687093,ANTH 10,A00,886934,Staff,0,12,30,30
1746592688119,ANTH 21,A01,886936,Staff,41,0,60,19
1746592689148,ANTH 23,A01,886938,Staff,92,0,100,8
1746592690174,ANTH 105,A00,886964,Stewart; Alexander B,84,0,100,16
1746592691199,ANTH 108,A00,886965,Pedersen; David,9,0,20,11
1746592692232,AWP 10,001,886147,Staff,0,0,0,0
1746592692232,AWP 10,002,886148,Staff,0,0,0,0
1746592692232,AWP 10,003,886149,Staff,0,0,0,0
1746592692232,AWP 10,004,886150,Staff,0,0,0,0
1746592692232,AWP 10,005,886151,Staff,0,0,0,0
1746592692232,AWP 10,006,886152,Staff,0,0,0,0
1746592692232,AWP 10,007,886153,Staff,0,0,0,0
1746592692232,AWP 10,008,886154,Staff,0,0,0,0
1746592692232,AWP 10,009,886155,Staff,0,0,0,0
1746592692232,AWP 10,010,886156,Staff,0,0,0,0
1746592692232,AWP 10,011,886158,Staff,0,0,0,0
1746592692232,AWP 10,012,886160,Staff,0,0,0,0
1746592692232,AWP 10,013,886161,Staff,0,0,0,0
1746592692232,AWP 10,014,886162,Staff,0,0,0,0
1746592692232,AWP 10,015,886163,Staff,0,0,0,0
1746592692232,AWP 10,016,886164,Staff,0,0,0,0
1746592692232,AWP 10,017,886165,Staff,0,0,0,0
1746592692232,AWP 10,018,886166,Staff,0,0,0,0
1746592692232,AWP 10,019,886168,Staff,0,0,0,0
1746592692232,AWP 10,020,886170,Staff,0,0,0,0
1746592692232,AWP 10,021,886172,Staff,0,0,0,0
1746592693261,AWP 10R,001,886173,Staff,0,1,0,0
1746592693261,AWP 10R,002,886174,Staff,0,1,0,0
1746592693261,AWP 10R,003,886175,Staff,0,0,0,0
1746592693261,AWP 10R,004,886176,Staff,0,0,0,0
1746592693261,AWP 10R,005,886177,Staff,0,0,0,0
1746592693261,AWP 10R,006,886178,Staff,0,0,0,0
1746592693261,AWP 10R,007,886179,Staff,0,0,0,0
1746592693261,AWP 10R,008,886181,Staff,0,0,0,0
1746592693261,AWP 10R,009,886182,Staff,0,0,0,0
1746592693261,AWP 10R,010,886183,Staff,0,0,0,0
1746592693261,AWP 10R,011,886184,Staff,0,0,0,0
1746592693261,AWP 10R,012,886185,Staff,0,0,0,0
1746592693261,AWP 10R,013,886186,Staff,0,0,0,0
1746592693261,AWP 10R,014,886187,Staff,0,0,0,0
1746592693261,AWP 10R,015,886188,Staff,0,0,0,0
1746592693261,AWP 10R,016,886189,Staff,0,0,0,0
1746592693261,AWP 10R,017,960532,Staff,0,0,0,0
1746592693261,AWP 10R,018,960533,Staff,0,0,0,0
1746592693261,AWP 10R,019,960534,Staff,0,0,0,0
1746592693261,AWP 10R,020,960538,Staff,0,0,0,0
1746592693261,AWP 10R,021,960540,Staff,0,0,0,0
1746592693261,AWP 10R,022,960541,Staff,0,0,0,0
1746592693261,AWP 10R,023,960542,Staff,0,0,0,0
1746592693261,AWP 10R,024,960544,Staff,0,0,0,0
1746592693261,AWP 10R,025,960545,Staff,0,0,0,0
1746592693261,AWP 10R,026,960548,Staff,0,0,0,0
1746592694290,AWP 102R,A00,886190,Staff,0,0,0,0
1746592694290,AWP 102R,B00,886191,Staff,0,0,0,0
1746592695317,BENG 100,A01,886193,Staff,17,0,30,13
1746592696342,BENG 122A,A01,886195,Hasty; Jeff M,13,0,30,17
1746592697369,BENG 166A,A00,886196,Sah; Robert Lie-Yuan,0,3,30,30
1746592698398,BENG 190,A00,958050,Khojah; Reem I,17,0,25,8
1746592699426,BIBC 102,A01,894320,Staff,0,0,46,46
1746592699426,BIBC 102,A02,894321,Staff,0,0,46,46
1746592699426,BIBC 102,A03,894344,Staff,6,0,46,40
1746592699426,BIBC 102,A04,894345,Staff,27,0,47,20
1746592700452,BICD 100R,A01,894365,Smith; Laurie,1,3,58,57
1746592700452,BICD 100R,A02,894366,Smith; Laurie,1,5,58,57
1746592700452,BICD 100R,A03,894367,Smith; Laurie,0,0,59,59
1746592700452,BICD 100R,A04,959869,Smith; Laurie,39,0,59,20
1746592701477,BICD 136,A01,894383,Gustafson-Brown; Cindy,14,0,50,36
1746592702506,BIEB 102,A01,894494,Butler; Shannon Rhey,51,0,130,79
1746592704563,BIEB 150,A01,894617,Wills; Christopher,3,0,20,17
1746592704563,BIEB 150,A02,894631,Wills; Christopher,3,0,20,17
1746592704563,BIEB 150,A03,894937,Wills; Christopher,3,0,20,17
1746592704563,BIEB 150,A04,894946,Wills; Christopher,5,0,20,15
1746592705596,BIEB 194,A00,906141,Kurle; Carolyn M.,5,0,20,15
1746592706625,BILD 1,A01,894154,Staff,3,0,19,16
1746592706625,BILD 1,A02,894155,Staff,14,0,19,5
1746592706625,BILD 1,A03,894160,Staff,13,0,19,6
1746592706625,BILD 1,A04,894161,Staff,15,0,18,3
1746592707651,BILD 2,A01,894168,Staff,0,0,50,50
1746592707651,BILD 2,A02,894169,Staff,0,0,50,50
1746592707651,BILD 2,A03,894179,Staff,0,0,50,50
1746592707651,BILD 2,A04,894203,Staff,23,0,50,27
1746592708676,BILD 3,A01,894213,Staff,23,0,31,8
1746592708676,BILD 3,A02,894214,Staff,26,0,31,5
1746592708676,BILD 3,A03,894235,Staff,28,0,31,3
1746592708676,BILD 3,A04,894236,Staff,28,0,32,4
1746592709703,BILD 4,A01,894253,Reuther; Keefe,5,0,24,19
1746592709703,BILD 4,A02,894258,Reuther; Keefe,16,0,24,8
1746592710733,BILD 5,A01,894276,Reuther; Keefe,34,0,50,16
1746592710733,BILD 5,A02,894277,Reuther; Keefe,45,0,50,5
1746592710733,BILD 5,A03,894290,Reuther; Keefe,44,0,50,6
1746592710733,BILD 5,A04,894291,Reuther; Keefe,48,0,50,2
1746592711758,BILD 24,A01,894297,Pirino; Giorgia,40,0,60,20
1746592712785,BIMM 100,B01,958915,Staff,71,0,100,29
1746592713810,BIMM 101,A01,895017,McDonnell; Lisa Marie,0,5,24,24
1746592713810,BIMM 101,A02,895018,McDonnell; Lisa Marie,0,5,24,24
1746592713810,BIMM 101,B01,895020,McDonnell; Lisa Marie,1,6,24,23
1746592713810,BIMM 101,B02,895021,McDonnell; Lisa Marie,0,4,24,24
1746592714836,BIMM 110,A01,895023,Staff,1,0,25,24
1746592714836,BIMM 110,A02,895024,Staff,9,0,25,16
1746592714836,BIMM 110,A03,895025,Staff,18,0,25,7
1746592714836,BIMM 110,A04,895031,Staff,20,0,25,5
1746592715860,BIMM 120,A01,895114,Gustafson-Brown; Cindy,14,0,28,14
1746592715860,BIMM 120,A02,895126,Gustafson-Brown; Cindy,21,0,27,6
1746592716888,BIPN 100,A01,895130,Yang; Mingyu,0,0,38,38
1746592716888,BIPN 100,A02,895131,Yang; Mingyu,31,0,38,7
1746592716888,BIPN 100,A03,895132,Yang; Mingyu,32,0,38,6
1746592716888,BIPN 100,A04,895133,Yang; Mingyu,27,0,36,9
1746592717913,BIPN 120,A01,895135,Cooke; James Edward,0,3,13,13
1746592717913,BIPN 120,A02,895136,Cooke; James Edward,0,1,13,13
1746592717913,BIPN 120,A03,895137,Cooke; James Edward,0,3,13,13
1746592717913,BIPN 120,A04,895156,Cooke; James Edward,0,2,11,11
1746592718938,BIPN 134,A01,895235,Cooke; James Edward,0,1,25,25
1746592718938,BIPN 134,A02,895237,Cooke; James Edward,0,0,25,25
1746592718938,BIPN 134,A03,895240,Cooke; James Edward,2,0,25,23
1746592718938,BIPN 134,A04,895270,Cooke; James Edward,20,0,25,5
1746592719965,BIPN 189,A00,892103,Staff,0,14,14,14
1746592722017,BISP 194,A00,958008,Staff,0,2,0,0
1746592723044,CAT 124,A01,922009,Staff,0,5,20,20
1746592724070,CAT 125R,A00,886390,Morales; Celeste Georgianna,0,3,20,20
1746592724070,CAT 125R,B00,886391,Irwin; Matthew Joseph,0,4,20,20
1746592724070,CAT 125R,C00,886392,Smith; Lauryn Alissa,0,2,20,20
1746592724070,CAT 125R,D00,886393,Vanderschuit; Maya Alysia,0,3,20,20
1746592724070,CAT 125R,E00,886394,Marchisotto; Jennifer Anne,0,3,20,20
1746592725096,CENG 15,A01,886218,Drews; Aaron,3,0,8,5
1746592726121,CENG 113,A00,886219,Opatkiewicz; Justin Paul,15,0,25,10
1746592727148,CGS 101,A00,887044,Staff,7,0,20,13
1746592728172,CGS 105,A01,887046,Staff,14,0,25,11
1746592729195,CGS 112,A00,887047,Cuong; Marisol,12,0,15,3
1746592730224,CGS 113,A00,887048,Staff,23,0,30,7
1746592731252,CGS 120,A00,887049,Staff,10,0,17,7
1746592732277,CHEM 6A,A01,886336,Lam; Tin Yiu,38,0,50,12
1746592732277,CHEM 6A,A02,886338,Lam; Tin Yiu,37,0,50,13
1746592733306,CHEM 6B,A01,886341,Hopkins; Patrycja Anna,16,0,50,34
1746592733306,CHEM 6B,A02,886343,Hopkins; Patrycja Anna,42,0,50,8
1746592734333,CHEM 6C,A01,886346,Albizati; Kim F.,0,2,50,50
1746592734333,CHEM 6C,A02,886348,Albizati; Kim F.,24,0,50,26
1746592735358,CHEM 40A,A01,886352,Klosterman; Jeremy K,65,0,100,35
1746592736385,CHEM 40B,A01,886356,Klosterman; Jeremy K,0,24,100,100
1746592737411,CHEM 41B,A01,886360,Theodorakis; Emmanuel,25,0,50,25
1746592737411,CHEM 41B,A02,886362,Theodorakis; Emmanuel,47,0,50,3
1746592738438,CHIN 165A,A00,886382,Xu; Li,18,0,20,2
1746592739463,CLAS 120,A00,886387,Myerston Santana; Jacobo,33,0,40,7
1746592740494,COGS 9,A01,886967,Shannon; Kyle Michael,42,0,60,18
1746592741518,COGS 11,A01,886969,Staff,9,0,30,21
1746592742546,COGS 14A,A01,886971,Staff,5,0,60,55
1746592743574,COGS 14B,A01,886973,Hoffman; Drew Ellen,4,0,60,56
1746592744600,COGS 18,A01,886975,Morgan; Eric,34,0,60,26
1746592745627,COGS 20,A01,886977,Staff,2,0,8,6
1746592745627,COGS 20,A02,886978,Staff,4,0,7,3
1746592746652,COGS 100,A01,907783,Staff,1,2,30,29
1746592747676,COGS 101B,A01,886980,Staff,0,4,48,48
1746592748706,COGS 101C,A01,886982,Delgado; Tania,0,5,44,44
1746592749731,COGS 102A,A01,886984,Johnson; Christine M.,3,0,30,27
1746592750755,COGS 118B,A01,886986,Staff,1,5,88,87
1746592751780,COGS 150,A01,886988,Bergen; Benjamin,22,0,50,28
1746592752805,COGS 153,A00,886989,Delgado; Tania,0,3,41,41
1746592753835,COGS 186,A01,886991,Staff,0,0,32,32
1746592754861,COGS 187A,A01,886993,Boyle; Mary E. T.,7,0,30,23
1746592755887,COGS 189,A00,886994,Staff,0,1,30,30
1746592756915,COMM 10,A01,886996,Staff,0,0,20,21
1746592756915,COMM 10,A02,886997,Staff,10,0,20,10
1746592756915,COMM 10,A03,959845,Staff,19,0,20,1
1746592757941,COMM 20,A01,886999,Leuning; Grant Maurstad,24,0,40,16
1746592759997,COMM 100A,A01,887002,Staff,0,0,20,25
1746592759997,COMM 100A,A02,887003,Staff,5,0,20,15
1746592761022,COMM 100B,A01,887005,Staff,0,8,20,24
1746592762051,COMM 106D,A00,887006,Staff,13,0,40,27
1746592763078,COMM 110G,A00,887007,Whitworth-Smith; Andrew C,12,0,40,28
1746592764104,COMM 111B,A00,887008,Staff,31,0,40,9
1746592765132,COMM 113T,A00,887009,Abuelhiga; Soraya Jill,28,0,40,12
1746592765132,COMM 113T,B00,906733,Staff,40,0,40,0
1746592766157,COMM 145,A00,887010,Staff,12,0,40,28
1746592767183,COMM 146,A00,887054,Staff,31,0,40,9
1746592768208,COMM 190,A00,887012,Staff,8,0,23,15
1746592769235,CSE 8A,A50,887015,Cao; Yingjun,56,0,85,29
1746592770263,CSE 11,A01,887017,Cao; Yingjun,11,0,70,59
1746592771288,CSE 20,A01,887019,Staff,30,0,50,20
1746592772316,CSE 21,A01,887021,Staff,79,0,100,21
1746592772316,CSE 21,B01,892583,Braun; Oliver,45,0,50,5
1746592773341,CSE 30,A01,887025,Eldon; John,142,0,200,58
1746592774365,CSE 100,A01,887027,Staff,26,0,50,24
1746592774365,CSE 100,A02,887028,Staff,42,0,50,8
1746592775392,CSE 101,A01,887030,Braun; Oliver,74,0,100,26
1746592775392,CSE 101,B01,887032,Jones; Miles E,0,3,50,50
1746592775392,CSE 101,B02,887033,Jones; Miles E,0,2,50,50
1746592776417,CSE 105,A01,908084,Jones; Miles E,32,0,50,18
1746592776417,CSE 105,A02,908087,Jones; Miles E,31,0,50,19
1746592777445,CSE 135,A01,887035,Powell; Thomas Allan,0,5,50,50
1746592778470,CSE 142,A01,887037,Staff,8,0,60,52
1746592779496,CSE 142L,A01,887039,Staff,34,0,60,26
1746592780526,CSE 151A,A01,887041,Solares; Edwin A,47,0,100,53
1746592781555,CSE 175,A01,887043,Kumar; Rakesh,30,0,30,0
1746592782585,CSS 1,A01,886389,Staff,1,2,40,39
1746592783613,DSC 30,A01,908097,Liao; Soohyun Nam,47,0,75,28
1746592784642,DSC 40A,A01,908099,Shannon; Kyle Michael,30,0,50,20
1746592785710,DSC 40B,A01,908112,Staff,15,0,50,35
1746592786738,DSC 80,A01,908116,Staff,19,0,60,41
1746592787767,DSC 197,001,956863,Eldridge; Justin Matthew,9999,0,9999,0
1746592788793,ECE 5,A01,886400,Morris; Karcher William,1,0,6,5
1746592788793,ECE 5,A02,886401,Morris; Karcher William,3,0,6,3
1746592789816,ECE 148,A01,886403,Silberman; Jack,0,14,14,14
1746592790841,ECON 1,A01,887265,Crane; Meredith Helen,11,0,70,59
1746592790841,ECON 1,B01,887268,Staff,42,0,50,8
1746592791870,ECON 2,A01,887273,Crane; Meredith Helen,54,0,70,16
1746592792900,ECON 3,A01,887279,Rondina; Giacomo,31,0,70,39
1746592793927,ECON 4,A01,887282,Anderson; John Charles,0,2,10,10
1746592794954,ECON 5,A01,887285,Staff,34,0,45,11
1746592794954,ECON 5,B01,887292,Staff,41,0,45,4
1746592795979,ECON 100A,A01,887337,Newhouse; Herbert S,54,0,70,16
1746592795979,ECON 100A,B01,887349,Staff,45,0,50,5
1746592797008,ECON 100B,A01,887361,Du; Songzi,29,0,70,41
1746592798039,ECON 100C,A01,887445,Newhouse; Herbert S,59,0,70,11
1746592799068,ECON 105,A00,887488,Vespa; Emanuel Ignacio,23,0,35,12
1746592800094,ECON 109,A01,887506,Shishkin; Denis,28,0,35,7
1746592801121,ECON 110A,A01,887568,Alon; Titan Michael,1,3,35,34
1746592801121,ECON 110A,B01,907601,Alon; Titan Michael,20,0,35,15
1746592802150,ECON 110B,A01,887598,Levkoff; Steven B.,0,24,70,70
1746592803187,ECON 112,A00,887599,Rondina; Giacomo,19,0,35,16
1746592804215,ECON 120A,A01,887603,Dai; Yinlin,35,0,70,35
1746592805246,ECON 120C,A01,887608,Sun; Yixiao,0,1,35,35
1746592805246,ECON 120C,B01,887614,Sun; Yixiao,0,0,35,35
1746592806274,ECON 138,A00,887621,Bharadwaj; Prashant,0,21,20,20
1746592807303,ECON 144,A00,958007,Squires; Dale E,12,0,35,23
1746592808332,ECON 171,A01,907666,Staff,18,0,35,17
1746592809357,ECON 175,A00,887626,Wu; Pak Yeung,22,0,35,13
1746592810382,ECON 190,A00,887640,Vespa; Emanuel Ignacio,22,0,35,13
1746592811419,EDS 25,A01,888197,Staff,0,0,0,0
1746592811419,EDS 25,A02,888209,Staff,0,0,0,0
1746592811419,EDS 25,A03,888210,Staff,0,0,0,0
1746592811419,EDS 25,A04,888212,Staff,0,0,0,0
1746592811419,EDS 25,A05,888213,Staff,0,0,0,0
1746592811419,EDS 25,A06,888214,Staff,0,0,0,0
1746592811419,EDS 25,A07,888235,Staff,0,2,0,0
1746592811419,EDS 25,A08,888236,Staff,0,0,0,0
1746592811419,EDS 25,A09,888240,Staff,0,0,0,0
1746592811419,EDS 25,A10,888244,Staff,0,0,0,0
1746592811419,EDS 25,B01,888273,Staff,0,0,0,0
1746592811419,EDS 25,B02,888285,Staff,0,0,0,0
1746592811419,EDS 25,B03,888423,Staff,0,0,0,1
1746592811419,EDS 25,B04,888432,Staff,0,0,0,0
1746592811419,EDS 25,B05,888433,Staff,0,0,0,0
1746592811419,EDS 25,B06,888467,Staff,0,0,0,0
1746592811419,EDS 25,B07,888468,Staff,0,0,0,0
1746592811419,EDS 25,B08,888479,Staff,0,0,0,0
1746592811419,EDS 25,B09,888484,Staff,0,0,0,0
1746592811419,EDS 25,B10,888487,Staff,0,0,0,0
1746592812446,EDS 38,A01,907700,Choi; Bailey Miyeon,30,0,30,0
1746592813474,EDS 112,A01,888601,Chapman; Thandeka K,12,0,40,28
1746592814503,EDS 115,A00,888697,Mendez; Kathrina Mendoza,10,0,30,20
1746592815535,EDS 116,A01,888893,Staff,33,0,40,7
1746592817586,EDS 124AR,A00,889133,Staff,29,0,50,21
1746592817586,EDS 124AR,B00,907471,Simon; Elizabeth A,37,0,50,13
1746592818611,EDS 124BR,A00,889134,Simon; Elizabeth A,44,0,100,56
1746592819636,EDS 125,A00,889135,Staff,25,0,30,5
1746592820665,EDS 126,A01,889138,Staff,35,0,40,5
1746592821694,EDS 164R,A01,889142,Wishard Guerra; Alison G.,32,0,50,18
1746592822722,ENG 30,A01,886396,Staff,0,0,0,0
1746592822722,ENG 30,B01,886398,Staff,0,0,0,0
1746592823748,ENVR 102,A00,906150,Montejo; Carolina,23,0,25,2
1746592824775,ETHN 103A,A00,887236,Man; Simeon S,0,2,0,0
1746592825805,ETHN 113,A00,887239,Staff,16,0,30,14
1746592826829,ETHN 116,A00,887240,Staff,16,0,25,9
1746592827859,ETHN 117,A00,887241,Choi; Esther Min,28,0,30,2
1746592828887,ETHN 118,A00,887243,Staff,24,0,30,6
1746592829914,ETHN 127,A00,887248,Cuong; Marisol,11,0,15,4
1746592830944,ETHN 139,A00,887250,Staff,7,0,10,3
1746592831969,ETHN 142,A00,887252,Staff,10,0,30,20
1746592832994,ETHN 161,A00,887253,Browne; Errol Tsekani,24,0,30,6
1746592834018,ETHN 163FR,A00,887255,Burelle; Julie Sara Veronique,0,0,5,5
1746592835046,GLBH 20,A00,889149,Elwardani; Nile Regina,8,0,42,34
1746592837100,GLBH 111,A01,889152,Burgos; Jose L.,17,0,17,0
1746592838127,GLBH 150,A00,889181,Sloane; Julia Kathryn,0,5,15,15
1746592840182,HDS 60,A01,886406,Warstadt; Melissa Fawn,72,0,80,8
1746592841209,HIAF 111,A00,889324,Gyamfi; Bright,25,0,32,7
1746592842236,HIEA 131,A00,889328,Staff,15,0,32,17
1746592843262,HIEA 144,A00,889333,Henry; Todd A.,26,0,32,6
1746592844286,HIEA 154,A00,889336,Henry; Todd A.,24,0,32,8
1746592845313,HIEU 106,A00,889339,Staff,22,0,32,10
1746592847367,HIEU 114,A00,889340,Staff,4,0,32,28
1746592848396,HIEU 135GS,A00,889342,Patterson; Patrick H.,0,0,1,24
1746592849421,HIEU 137,A00,889343,Edington; Claire Ellen,10,0,25,15
1746592850447,HIEU 148,A00,889345,Staff,14,0,32,18
1746592851475,HIEU 154,A00,889346,Biess; Frank Peter,21,0,32,11
1746592852503,HILA 102,A00,889351,Staff,12,0,32,20
1746592853529,HILD 2A,A01,889221,Lewandoski; Julia Mavis,2,10,32,30
1746592854558,HILD 7B,A01,889225,Man; Simeon S,0,12,32,32
1746592855584,HILD 7C,A01,889288,Alvarez; Luis A,0,14,32,32
1746592856610,HILD 30,A01,889323,Staff,0,5,32,32
1746592858662,HISC 119,A00,889383,Golan; Tal,20,0,32,12
1746592859692,HIUS 103,A00,889384,Man; Simeon S,0,0,32,32
1746592860718,HIUS 117,A00,919797,Kwak; Nancy,18,0,32,14
1746592861743,HIUS 142A,A00,919788,Staff,22,0,32,10
1746592863799,HIUS 149,A00,889386,Gyamfi; Bright,26,0,32,6
1746592864824,HIUS 155,A00,889387,Alvarez; Luis A,15,0,32,17
1746592865852,HUM 3,A01,886499,Caldwell; Michael Alan,19,0,50,31
1746592866879,HUM 3GS,A00,886500,Rodriguez; Bretton Sigfred,0,0,0,28
1746592867904,HUM 3R,A01,886502,Markman; Kristina,0,36,50,50
1746592868931,HUM 4,A01,886504,Crum; Matthew Stephen,23,0,50,27
1746592868931,HUM 4,B01,886506,West; Geoffrey Scott,17,0,50,33
1746592869956,HUM 4GS,A00,886507,Staff,0,0,0,19
1746592870982,HUM 5,A01,886509,Staff,31,0,50,19
1746592872008,HUM 5R,A01,886511,Zavodny; Tatiana Sophia,0,39,50,50
1746592873036,JAPN 180,A00,886407,Staff,16,0,40,24
1746592874067,LATI 50,A01,886409,Martin-Cabrera; Luis,3,0,22,19
1746592874067,LATI 50,A02,886410,Martin-Cabrera; Luis,19,0,22,3
1746592874067,LATI 50,A03,886411,Martin-Cabrera; Luis,21,0,22,1
1746592874067,LATI 50,A04,886412,Martin-Cabrera; Luis,8,0,22,14
1746592875094,LAWS 101,A00,907664,Staff,28,0,60,32
1746592876125,LIAB 1A,A00,889388,Saab; Dima,17,0,20,3
1746592877150,LIAB 1AX,A00,889389,El Cheddadi; Youniss,18,0,20,2
1746592878176,LIFR 1C,A00,889391,Van Moer; Vinciane G,8,0,20,12
1746592879205,LIFR 1CX,A00,889392,Van Moer; Vinciane G,7,0,20,13
1746592880231,LIFR 1D,A00,889393,Van Moer; Vinciane G,7,0,20,13
1746592881261,LIFR 1DX,A00,889394,Van Moer; Vinciane G,8,0,20,12
1746592882285,LIGN 7,A00,886923,Staff,24,0,50,26
1746592883311,LIGN 17,A00,886924,Kehler; Andrew Scott,126,0,150,24
1746592884334,LTAM 110,A00,889395,Staff,15,0,30,15
1746592885362,LTAM 110GS,A00,958010,Rodriguez; Bretton Sigfred,0,0,0,28
1746592886387,LTCH 101,A00,889397,Staff,23,0,25,2
1746592887417,LTCS 130,A00,889398,Staff,23,0,25,2
1746592888445,LTEA 138,A00,889399,Staff,24,0,40,16
1746592889525,LTEN 149,A00,889400,Wesling; Megan E.,0,3,25,25
1746592890554,LTEN 169,A00,889401,Staff,20,0,25,5
1746592891583,LTEN 180,A00,889402,Staff,10,0,15,5
1746592892608,LTEN 181,A00,889403,Staff,21,0,25,4
1746592893634,LTWL 100,A00,889404,Myerston Santana; Jacobo,2,0,25,23
1746592894659,LTWL 180GS,A00,889405,Staff,0,0,20,20
1746592895684,LTWL 181,A00,889406,Staff,16,0,25,9
1746592896746,LTWL 184,A00,889475,Mukherjee; Silpa,22,0,25,3
1746592897773,LTWR 102C,A00,889486,Staff,29,0,30,1
1746592898798,LTWR 115W,A00,889491,Staff,0,2,15,15
1746592899825,MAE 8,A01,886905,Staff,0,2,0,0
1746592900855,MAE 11,A00,886906,Bandaru; Prabhakar,0,7,50,50
1746592901882,MAE 20,A00,886907,Evdokimenko; Ekaterina,43,0,70,27
1746592902908,MAE 30B,A00,886909,Ghazinejad; Maziar,25,0,45,20
1746592903935,MAE 101B,A00,886910,Saintillan; David,30,0,45,15
1746592904965,MAE 105,A00,886911,Bandaru; Prabhakar,18,0,50,32
1746592905991,MAE 107,B00,958024,Staff,7,0,50,43
1746592907015,MAE 143B,A00,886913,Bewley; Thomas R,2,0,40,38
1746592908042,MAE 148,A01,886915,Silberman; Jack,0,3,14,14
1746592909067,MAE 160,A00,886916,Evdokimenko; Ekaterina,31,0,60,29
1746592910091,MATH 3C,A01,889681,Staff,0,2,30,30
1746592910091,MATH 3C,A02,960048,Staff,23,0,30,7
1746592911116,MATH 10A,A01,889760,Staff,26,0,30,4
1746592911116,MATH 10A,A02,889783,Staff,29,0,30,1
1746592912152,MATH 10B,A01,889785,Verstraete; Jacques Allan,1,0,35,34
1746592912152,MATH 10B,A02,889795,Verstraete; Jacques Allan,4,0,35,31
1746592912152,MATH 10B,B01,889797,Verstraete; Jacques Allan,3,0,35,32
1746592912152,MATH 10B,B02,889828,Verstraete; Jacques Allan,3,0,35,32
1746592913178,MATH 10C,A01,889849,Habib; Yousaf,8,0,30,22
1746592913178,MATH 10C,A02,889852,Habib; Yousaf,14,0,30,16
1746592913178,MATH 10C,A03,889853,Habib; Yousaf,22,0,30,8
1746592913178,MATH 10C,A04,889858,Habib; Yousaf,20,0,30,10
1746592913178,MATH 10C,B01,889861,Staff,1,0,30,29
1746592913178,MATH 10C,B02,889862,Staff,24,0,30,6
1746592913178,MATH 10C,B03,889863,Staff,27,0,30,3
1746592913178,MATH 10C,B04,889967,Staff,23,0,30,7
1746592914205,MATH 18,A01,889974,Staff,7,0,30,23
1746592914205,MATH 18,A02,889977,Staff,20,0,30,10
1746592914205,MATH 18,B01,889984,Hardiman; Liam,20,0,30,10
1746592914205,MATH 18,B02,889985,Hardiman; Liam,25,0,30,5
1746592915232,MATH 20A,A01,889990,Suk; Andrew Hoon,30,0,35,5
1746592916263,MATH 20B,A01,889993,Ohm; Ko Woon,21,0,30,9
1746592916263,MATH 20B,A02,889994,Ohm; Ko Woon,30,0,30,0
1746592916263,MATH 20B,B01,889996,Ohm; Ko Woon,22,0,30,8
1746592916263,MATH 20B,B02,889997,Ohm; Ko Woon,23,0,30,7
1746592917296,MATH 20C,A01,889999,Hammock; Frances H,17,0,30,13
1746592917296,MATH 20C,A02,890003,Hammock; Frances H,23,0,30,7
1746592917296,MATH 20C,B01,890006,Hammock; Frances H,3,0,30,27
1746592917296,MATH 20C,B02,890007,Hammock; Frances H,12,0,30,18
1746592918322,MATH 20D,A01,890011,Cheng; Hsiao-Bing,1,1,30,29
1746592918322,MATH 20D,A02,890012,Cheng; Hsiao-Bing,14,0,30,16
1746592918322,MATH 20D,B01,890016,Cheng; Hsiao-Bing,13,0,30,17
1746592918322,MATH 20D,B02,890017,Cheng; Hsiao-Bing,13,0,30,17
1746592919354,MATH 20E,A01,890026,Harel; Guershon,1,0,30,29
1746592919354,MATH 20E,A02,890029,Harel; Guershon,22,0,30,8
1746592919354,MATH 20E,B01,890033,Harel; Guershon,7,0,30,23
1746592919354,MATH 20E,B02,890101,Harel; Guershon,21,0,30,9
1746592920379,MATH 102,A01,890104,Staff,18,0,30,12
1746592920379,MATH 102,A02,890105,Staff,27,0,30,3
1746592921407,MATH 103B,A01,890116,Salehi Golsefidy; Alireza,3,0,30,27
1746592921407,MATH 103B,B01,890118,Staff,0,3,34,34
1746592922433,MATH 109,A01,890121,Aliabadi Sr.; Mohsen,0,0,30,30
1746592922433,MATH 109,B01,890124,Upadrashta; Pranav Kumar,18,0,30,12
1746592923462,MATH 120A,A01,890126,Eggers; John Dietrich,13,0,30,17
1746592924488,MATH 142B,A01,890128,Ioana; Adrian,19,0,30,11
1746592924488,MATH 142B,A02,890129,Ioana; Adrian,12,0,30,18
1746592925515,MATH 154,A01,890174,Staff,0,1,30,30
1746592925515,MATH 154,A02,890182,Staff,0,0,30,30
1746592926547,MATH 168A,A01,890197,Dumitriu; Ioana,21,0,35,14
1746592927577,MATH 170A,A01,890240,Nie; Jiawang,1,0,30,29
1746592927577,MATH 170A,A02,890241,Nie; Jiawang,11,0,30,19
1746592927577,MATH 170A,A03,890249,Nie; Jiawang,23,0,30,7
1746592928605,MATH 170B,A01,957891,Nag; Panchali,13,0,35,22
1746592930659,MATH 181A,A01,908025,Staff,0,3,35,35
1746592930659,MATH 181A,A02,960115,Staff,26,0,35,9
1746592931688,MATH 181B,A01,959874,Staff,24,0,30,6
1746592932717,MATH 193B,A01,890265,Staff,0,4,35,35
1746592933741,MGT 4,A01,890311,Anderson; John Charles,42,0,88,46
1746592934765,MGT 5,A00,907740,Staff,12,0,98,86
1746592935791,MGT 12,A00,890312,Lindenberger; Wade Douglas,67,0,98,31
1746592936820,MGT 16,A00,957883,Staff,78,0,98,20
1746592938873,MGT 45,A00,890314,Pecore; Joseph P.,45,0,98,53
1746592939900,MGT 71,A00,890315,Staff,0,12,98,98
1746592940927,MGT 100,A00,890316,Yavorsky; Daniel Ryan,44,0,98,54
1746592941956,MGT 103,A00,890317,Ehrich; Kristine R,73,0,98,25
1746592942984,MGT 105,A00,890356,Bates; Kenneth Walter,0,8,98,98
1746592944009,MGT 112,A00,890360,Ehrich; Kristine R,55,0,98,43
1746592945034,MGT 127R,A00,907732,Zhu; Kevin Xiaoguo,23,0,98,75
1746592946062,MGT 131B,A00,890361,Anderson; John Charles,59,0,98,39
1746592947085,MGT 137,A00,890362,Lindenberger; Wade Douglas,65,0,98,33
1746592948112,MGT 160,A00,890369,Johnson; Erik Barry,9,0,98,89
1746592950163,MGT 164,A00,890372,Zimmermann; Carsten,0,40,98,98
1746592951188,MGT 180,A00,890374,Bliss; Barbara Ann,11,0,98,87
1746592952219,MMW 15,A01,886414,Chang; Edmond Yi-Teh,0,12,28,28
1746592952219,MMW 15,A02,886415,Chang; Edmond Yi-Teh,0,8,28,28
1746592952219,MMW 15,A03,886416,Chang; Edmond Yi-Teh,0,9,28,28
1746592952219,MMW 15,A04,886417,Chang; Edmond Yi-Teh,0,8,28,28
1746592952219,MMW 15,B01,886419,Chang; Edmond Yi-Teh,0,7,28,28
1746592952219,MMW 15,B02,886420,Chang; Edmond Yi-Teh,0,8,28,28
1746592952219,MMW 15,B03,886421,Chang; Edmond Yi-Teh,0,7,28,28
1746592952219,MMW 15,B04,886422,Chang; Edmond Yi-Teh,0,8,28,28
1746592952219,MMW 15,C01,886424,Staff,0,9,28,28
1746592952219,MMW 15,C02,886425,Staff,0,8,28,28
1746592952219,MMW 15,C03,886426,Staff,0,8,28,28
1746592952219,MMW 15,C04,886427,Staff,0,8,28,28
1746592952219,MMW 15,C05,958038,Staff,0,8,28,28
1746592952219,MMW 15,C06,958039,Staff,1,8,28,27
1746592953244,MMW 15GS,A00,906910,Patterson; Patrick H.,4,0,28,24
1746592954273,MMW 122R,A01,886429,Rahimi; Babak,0,13,28,28
1746592954273,MMW 122R,A02,886430,Rahimi; Babak,0,12,28,28
1746592954273,MMW 122R,A03,958040,Rahimi; Babak,0,11,28,28
1746592955301,MUS 1A,A01,890937,Staff,2,0,25,23
1746592955301,MUS 1A,A02,891035,Staff,6,0,25,19
1746592955301,MUS 1A,C01,958912,Staff,24,0,25,1
1746592955301,MUS 1A,C02,958913,Staff,25,0,25,0
1746592957354,MUS 2AK,A00,957092,Ohnishi; Takae,15,0,15,0
1746592958378,MUS 4,A01,891044,Staff,0,0,25,25
1746592958378,MUS 4,A02,891045,Staff,22,0,25,3
1746592958378,MUS 4,B01,891048,Staff,17,0,25,8
1746592958378,MUS 4,B02,891050,Staff,25,0,25,0
1746592959404,MUS 5,A01,957506,Dubnov; Shlomo,0,0,25,25
1746592959404,MUS 5,A02,957622,Dubnov; Shlomo,13,0,25,12
1746592959404,MUS 5,A03,957623,Dubnov; Shlomo,20,0,25,5
1746592960432,MUS 6,A01,891053,Freitas Caetano; Marcelo,24,0,25,1
1746592960432,MUS 6,A02,891054,Freitas Caetano; Marcelo,23,0,25,2
1746592961460,MUS 7,A01,891081,Staff,0,0,25,25
1746592961460,MUS 7,A02,891082,Staff,3,0,25,22
1746592962488,MUS 8GS,A00,891118,Borgo; David Garcia,1,0,25,24
1746592963513,MUS 11,A01,891140,Staff,9,0,25,16
1746592963513,MUS 11,A02,891141,Staff,21,0,25,4
1746592964542,MUS 13,A01,891143,Staff,8,0,25,17
1746592964542,MUS 13,A02,891144,Staff,24,0,25,1
1746592965568,MUS 15,A01,891146,Staff,9,0,25,16
1746592965568,MUS 15,A02,891148,Staff,21,0,25,4
1746592965568,MUS 15,B01,891150,Staff,18,0,25,7
1746592965568,MUS 15,B02,891151,Staff,25,0,25,0
1746592966593,MUS 20,A01,891153,Staff,5,0,20,15
1746592966593,MUS 20,A02,891155,Staff,14,0,20,6
1746592967618,MUS 80,A00,891156,Staff,19,0,25,6
1746592967618,MUS 80,B00,891157,Staff,23,0,25,2
1746592968645,MUS 130,A00,891158,Ohnishi; Takae,35,0,35,0
1746592969674,MUS 150GS,A01,891160,Borgo; David Garcia,1,0,25,24
1746592970703,MUS 170,A01,891162,Freitas Caetano; Marcelo,20,0,25,5
1746592970703,MUS 170,A02,891164,Freitas Caetano; Marcelo,21,0,25,4
1746592971732,NANO 11,A00,886220,Vazquez Mena; Oscar,13,0,15,2
1746592972762,NANO 15,A01,886222,Drews; Aaron,4,0,7,3
1746592973787,NANO 104,A00,886224,Sirbuly; Donald,17,0,25,8
1746592974811,PH 40,A00,886528,Staff,23,0,40,17
1746592975837,PH 45,A01,886799,Staff,35,0,40,5
1746592976866,PH 110,A00,886802,Staff,0,6,40,40
1746592977890,PH 172,A00,906716,Staff,19,0,35,16
1746592978915,PH 191,A00,886803,Staff,6,0,40,34
1746592979941,PHIL 1,A00,889500,Staff,20,0,30,10
1746592980965,PHIL 10,A01,889549,Grush; Rick Scott,16,0,22,6
1746592980965,PHIL 10,A02,889551,Grush; Rick Scott,22,0,22,0
1746592981992,PHIL 28,A01,889559,Lamey; Andy M.,0,2,31,31
1746592981992,PHIL 28,A02,889561,Lamey; Andy M.,0,1,30,30
1746592981992,PHIL 28,A03,889572,Lamey; Andy M.,0,1,30,30
1746592983018,PHIL 35,A00,907839,Staff,13,0,15,2
1746592984043,PHIL 60,A00,889574,Staff,73,0,90,17
1746592985072,PHIL 101,A00,958004,Staff,12,0,15,3
1746592987125,PHIL 136,A00,889582,Fulkerson; Matthew Todd,26,0,45,19
1746592988149,PHIL 163,A01,889601,Staff,21,0,30,9
1746592988149,PHIL 163,B01,889606,Brandt; Reuven A,0,3,0,0
1746592989178,PHIL 164,A00,889610,Staff,16,0,30,14
1746592990204,PHIL 165,A00,889613,Staff,22,0,30,8
1746592991230,PHYS 1A,A00,886431,Staff,30,0,70,40
1746592992259,PHYS 1AL,001,886432,Tsai; Philbert S,1,2,30,29
1746592992259,PHYS 1AL,002,886436,Tsai; Philbert S,13,0,30,17
1746592993285,PHYS 1B,A00,886439,Staff,184,0,240,56
1746592994348,PHYS 1BL,001,886441,Tsai; Philbert S,0,4,30,30
1746592994348,PHYS 1BL,002,886444,Tsai; Philbert S,2,0,30,28
1746592995374,PHYS 1C,A00,896092,Arnold; Kam S,78,0,146,68
1746592996398,PHYS 1CL,001,886448,Tsai; Philbert S,0,0,30,30
1746592996398,PHYS 1CL,002,886449,Tsai; Philbert S,1,0,30,29
1746592996398,PHYS 1CL,003,886450,Tsai; Philbert S,16,0,30,14
1746592996398,PHYS 1CL,004,886451,Tsai; Philbert S,15,0,30,15
1746592997427,PHYS 2B,A01,886457,Staff,67,0,115,48
1746592998452,PHYS 2C,A01,886460,Shotwell; Brian,0,9,65,65
1746592999477,PHYS 2CL,A01,886467,Staff,0,4,28,28
1746592999477,PHYS 2CL,A02,886468,Staff,0,3,28,28
1746593000502,PHYS 2D,A01,886470,Staff,10,0,50,40
1746593001533,PHYS 4B,A01,886475,Grinstein; Benjamin,22,0,40,18
1746593002561,POLI 5,A00,891173,Desposato; Scott,7,0,25,18
1746593003588,POLI 5D,A01,891175,Staff,5,0,5,0
1746593003588,POLI 5D,B01,891178,Staff,5,0,5,0
1746593004613,POLI 11,A00,891179,Ferree; Karen E,1,0,35,34
1746593005638,POLI 12,A00,891180,Staff,15,0,30,15
1746593006664,POLI 27,A01,891182,Staff,12,0,75,63
1746593007690,POLI 30,A00,891183,Staff,8,0,50,42
1746593008715,POLI 100B,A00,891244,Staff,5,1,35,30
1746593009744,POLI 100I,A00,891247,Staff,7,0,30,23
1746593010771,POLI 104J,A00,891248,Nichter; Maysa,14,0,30,16
1746593011797,POLI 104U,A00,891250,Nichter; Maysa,1,0,30,29
1746593013854,POLI 110B,A00,891255,Wiens; David,19,0,25,6
1746593014880,POLI 112A,A00,891256,Wiens; David,6,0,25,19
1746593015905,POLI 114BR,A00,891261,Staff,19,0,30,11
1746593016931,POLI 117R,A00,891262,Forman; Fonna,0,6,50,50
1746593017958,POLI 118,A00,891264,Ingham; Sean,17,0,25,8
1746593018986,POLI 124A,A00,891265,Staff,18,0,20,2
1746593020012,POLI 125D,A00,891266,Nichter; Simeon C,2,0,25,23
1746593021038,POLI 126,A00,891268,Nichter; Simeon C,7,0,25,18
1746593022065,POLI 126AA,A00,891272,Staff,15,0,25,10
1746593023094,POLI 130AA,A00,891273,Staff,15,0,20,5
1746593024120,POLI 134AA,A00,891274,Staff,4,0,20,16
1746593026168,POLI 138,A00,891278,Staff,21,0,25,4
1746593027198,POLI 142K,A00,891280,Staff,10,0,25,15
1746593028225,POLI 142M,A00,891281,Gartzke; Erik,16,0,30,14
1746593029250,POLI 142P,A00,891284,Staff,20,0,30,10
1746593030279,POLI 143,A00,891285,Gartzke; Erik,12,0,30,18
1746593031306,POLI 153,A00,891286,Staff,19,0,20,1
1746593033367,POLI 175,A00,891290,Staff,15,0,20,5
1746593034392,PSYC 1,A00,890674,Steiner; Eric Tomas,0,11,45,45
1746593035420,PSYC 2,A00,890676,Albright; Thomas D,20,0,35,15
1746593036447,PSYC 3,A00,890679,Staff,17,0,20,3
1746593037472,PSYC 6,A00,959858,Staff,19,0,20,1
1746593038496,PSYC 60,A01,890684,Rickard; Timothy C.,0,6,45,45
1746593039522,PSYC 70,A01,890689,Geller; Emma Harlan,6,0,30,24
1746593040558,PSYC 71,A01,959860,Staff,21,0,25,4
1746593041583,PSYC 100,A00,890690,Lacefield; Katharine I,0,50,180,180
1746593042608,PSYC 102,A00,890695,Staff,18,0,40,22
1746593043633,PSYC 105,A00,890699,Geller; Emma Harlan,70,0,100,30
1746593044661,PSYC 106,A00,890701,Gorman; Michael R.,5,0,30,25
1746593045689,PSYC 108,A00,890704,Adrian; Julia Anna,0,29,50,50
1746593046718,PSYC 118,A01,890712,Staff,11,0,30,19
1746593047743,PSYC 124,A00,890716,Chapman; Eddie Nathaniel,25,0,60,35
1746593048849,PSYC 131,A00,890717,Anagnostaras; Stephan,0,7,80,80
1746593049877,PSYC 137,A00,890719,Winkielman; Piotr,0,11,30,30
1746593050903,PSYC 144,A00,890721,Adrian; Julia Anna,0,9,45,45
1746593051930,PSYC 162,A00,890805,Staff,0,1,75,75
1746593052958,PSYC 169,A00,890810,Staff,0,15,30,30
1746593053984,PSYC 172,A00,890814,Gorman; Michael R.,9,0,30,21
1746593055010,PSYC 181,A00,890818,Anagnostaras; Stephan,7,0,200,193
1746593056036,PSYC 184,A00,959861,Staff,163,0,175,12
1746593057063,PSYC 189,A00,890823,Staff,0,2,30,30
1746593058090,PSYC 191,A00,890884,Rickard; Timothy C.,0,12,35,35
1746593059114,PSYC 193,A00,890913,Staff,19,0,30,11
1746593059114,PSYC 193,B00,890914,Chapman; Eddie Nathaniel,24,0,30,6
1746593060141,PSYC 193L,A01,890918,Lowe; Angela Beth,20,0,30,10
1746593060141,PSYC 193L,B01,890921,Hurwitz; Ethan Scott,20,0,30,10
1746593060141,PSYC 193L,C01,890928,Staff,30,0,30,0
1746593061166,RELI 149,A00,886806,Rahimi; Babak,23,0,40,17
1746593062191,SE 9,A01,886814,Staff,7,0,20,13
1746593063218,SE 101B,A01,886816,Chadha; Mayank,3,0,35,32
1746593064246,SE 110B,A00,886818,Zhu; Qiang,4,0,75,71
1746593065271,SE 125,A01,886830,Staff,10,0,30,20
1746593066297,SE 130B,A01,886835,Staff,14,0,40,26
1746593067327,SE 131A,A01,886838,Krysl; Petr,34,0,55,21
1746593068353,SE 154,A00,886840,Staff,28,0,50,22
1746593069380,SE 164GS,A01,886849,Staff,6,0,20,14
1746593070405,SE 167GS,A01,886853,Staff,6,0,20,14
1746593071434,SIO 25,A01,890107,Staff,19,0,30,11
1746593072499,SIO 45,A00,890109,Cook; Geoffrey W,116,0,200,84
1746593073523,SIO 109R,A00,890110,Forman; Fonna,0,16,20,20
1746593074547,SIO 187,A01,890114,Kacev; David,15,0,40,25
1746593075575,SOCI 1,A01,890431,Thorpe; Charles Robert,14,0,30,16
1746593075575,SOCI 1,A02,890518,Thorpe; Charles Robert,30,0,30,0
1746593076601,SOCI 2,A01,957978,Staff,25,0,25,0
1746593076601,SOCI 2,A02,957979,Staff,23,0,25,2
1746593077631,SOCI 20,A01,890523,Calderon-Zaks; Michael Aar,21,0,30,9
1746593077631,SOCI 20,A02,890526,Calderon-Zaks; Michael Aar,29,0,30,1
1746593078660,SOCI 30,A01,890533,Pardo Guerra; Juan Pablo,37,0,40,3
1746593079687,SOCI 40,A01,890535,Staff,27,0,45,18
1746593080714,SOCI 104Q,A00,890559,Staff,18,0,30,12
1746593081739,SOCI 106,A00,890560,Arnal; Maud Marie Leonie,20,0,30,10
1746593082766,SOCI 110,A00,890567,Holkenbrink-Monk; Charlene,19,0,30,11
1746593083792,SOCI 112,A00,890568,Victoria Torres; Pablo,2,0,55,53
1746593084819,SOCI 115,A00,890597,Arnal; Maud Marie Leonie,28,0,45,17
1746593086869,SOCI 121,A00,890604,Pardo Guerra; Juan Pablo,38,0,45,7
1746593087895,SOCI 126,A01,890608,Staff,8,0,10,2
1746593088922,SOCI 127,A00,890609,Staff,18,0,30,12
1746593089948,SOCI 131,A00,890610,Thorpe; Charles Robert,37,0,45,8
1746593090976,SOCI 135,A00,890615,Payne; Christine Anna,14,0,45,31
1746593092002,SOCI 139,A00,890620,Staff,38,0,45,7
1746593093031,SOCI 148E,A00,890622,Calderon-Zaks; Michael Aar,36,0,45,9
1746593094058,SOCI 150,A00,890623,Kohler; Kristopher M.,31,0,45,14
1746593095085,SOCI 157,A00,890625,Jules-Rosette; Bennetta W.,18,0,20,2
1746593096111,SOCI 160,A00,890627,Payne; Christine Anna,21,0,45,24
1746593097140,SYN 1,A00,886855,Fish; Gwendolyn Anne,0,1,0,0
1746593097140,SYN 1,B00,906086,Fish; Gwendolyn Anne,0,2,0,2
1746593098222,SYN 2R,A00,886860,Staff,0,17,15,15
1746593098222,SYN 2R,B00,906106,Atkinson; Arthur Laird,0,16,15,15
1746593099251,SYN 100,A01,886866,Browne; Emily,0,28,20,20
1746593099251,SYN 100,B01,906128,Rock; Martin,0,4,20,20
1746593099251,SYN 100,C01,906140,Deavenport; James Cary,0,4,20,20
1746593099251,SYN 100,D01,907816,Deavenport; James Cary,0,5,20,20
1746593100278,TDAC 1,A00,890286,Walsh; Kim C.,7,0,20,13
1746593101305,TDAC 101,A00,890296,Basso; Beatrice,15,0,20,5
1746593102334,TDDE 131,A00,890297,Staff,47,0,50,3
1746593103362,TDDM 1,A00,890287,Weinberg; Sadie,25,0,30,5
1746593104389,TDGE 11,A00,890288,Fulton; Julia,138,0,200,62
1746593104389,TDGE 11,B00,890289,Castro; Robert Jess,185,0,200,15
1746593105416,TDGE 25,B00,957359,Walsh; Kim C.,5,0,20,15
1746593106444,TDGE 40,A01,890292,Power; Jade Yukana,26,0,30,4
1746593107469,TDGE 124,A00,890298,Havis; Allan,0,2,50,50
1746593108495,TDGE 131R,A00,890299,Burelle; Julie Sara Veronique,15,0,42,27
1746593109519,TDHT 101,A00,890300,Staff,10,0,20,10
1746593110548,TDHT 109,A01,890302,Anderson; Mysia Anyse,31,0,40,9
1746593111574,TDMV 1,A00,890293,Arcidiacono; Kristin,18,0,30,12
1746593112601,TDMV 2,A00,890294,Weinberg; Sadie,23,0,30,7
1746593113627,TDMV 3,A00,957878,Arcidiacono; Kristin,28,0,30,2
1746593115680,TDMV 138,A00,890304,Jun; Grace Shin Hae,25,0,40,15
1746593116705,TDMV 140,A00,890305,Corrales; Joseph Bernales,25,0,30,5
1746593117735,TDMV 142,A00,890307,Caligagan; Tony,32,0,40,8
1746593118761,TDMV 144,A00,890308,Camaya; Michelle Ann,25,0,30,5
1746593119787,TDPW 1,A00,890295,Stein; Deborah Isobel,3,0,20,17
1746593120814,USP 2,A01,890272,Lerner; Amy M,7,0,20,13
1746593121839,USP 3,A01,890274,Staff,12,0,30,18
1746593122866,USP 15,A01,890276,Sun; Feiyang,16,0,30,14
1746593123890,USP 25,A00,890277,Shenkman; Michael Thomas,18,0,25,7
1746593124916,USP 138,A00,890278,Staff,13,0,25,12
1746593125944,USP 143,A00,890279,Staff,22,0,70,48
1746593126972,USP 144,A00,890280,Chowdhury; Muhammed Zohir,16,0,30,14
1746593127999,USP 150,A00,890281,Boomhower; Matthew Charles,4,0,30,26
1746593129026,USP 151,A00,890282,Staff,16,0,20,4
1746593130050,USP 162,A00,890283,Andrews; Abigail Leslie,16,0,20,4
1746593131075,USP 168,A00,920477,Kwak; Nancy,0,0,5,5
1746593132102,USP 181,A00,890284,Staff,3,0,20,17
1746593133130,USP 191A,A00,890285,Staff,12,0,20,8
1746593134155,VIS 101,A00,886512,Staff,26,0,75,49
1746593135181,VIS 103,A00,886513,Cruz; Edwin Teddy,61,0,75,14
1746593136208,VIS 108,A00,886514,Staff,3,0,15,12
1746593137234,VIS 127P,A00,886515,Shen; Kuiyi,79,0,146,67
1746593138263,VIS 149,A00,886516,Yoldas; Pinar,0,0,15,15
1746593139291,VIS 164,A00,886526,Erdmann; Dean,19,0,22,3
1746593140320,VIS 194S,A00,886527,Staff,61,0,75,14
1746593141350,WCWP 10A,C00,886484,Martiniuk; Jill,12,0,15,3
1746593142378,WCWP 10B,A00,886490,Uriarte; Emma,0,0,15,15
1746593142378,WCWP 10B,B00,886491,Dhir; Simrita,8,0,15,7
1746593142378,WCWP 10B,C00,886492,Ornelas; Tricia,0,0,15,15
1746593143406,WCWP 100,A00,886494,Young; Mark T,0,6,15,15
1746593145485,AAS 10,A01,886199,Childs; Dennis R.,0,3,0,0
1746593146511,ANAR 104,A01,886940,Shtienberg; Gilad,27,0,30,3
1746593147538,ANAR 120,A00,886953,Staff,13,0,20,7
1746593148566,ANBI 148,A01,886955,Wilder; Linnea Lorene,30,0,40,10
1746593150616,ANSC 122,A00,886957,Staff,24,0,30,6
1746593151644,ANSC 150,A00,886958,Sloane; Julia Kathryn,2,0,15,13
1746593152669,ANSC 156,A00,886959,Jenkins; Janis A.,0,1,15,15
1746593153695,ANSC 180,A00,886960,Staff,11,0,17,6
1746593154720,ANSC 188,A00,886961,Jassal; Aftab,9,0,25,16
1746593155746,ANSC 190,A00,886962,Jassal; Aftab,14,0,25,11
1746593156774,ANSC 191,A00,886963,Staff,18,0,20,2
1746593157799,ANTH 3,A01,891689,Staff,17,0,20,3
1746593158824,ANTH 5,A00,886933,Semendeferi; Ekaterini,16,0,20,4
1746593159851,ANTH 10,A00,886934,Staff,0,12,30,30
1746593160880,ANTH 21,A01,886936,Staff,41,0,60,19
1746593161909,ANTH 23,A01,886938,Staff,92,0,100,8
1746593162936,ANTH 105,A00,886964,Stewart; Alexander B,84,0,100,16
1746593163963,ANTH 108,A00,886965,Pedersen; David,9,0,20,11
1746593164998,AWP 10,001,886147,Staff,0,0,0,0
1746593164998,AWP 10,002,886148,Staff,0,0,0,0
1746593164998,AWP 10,003,886149,Staff,0,0,0,0
1746593164998,AWP 10,004,886150,Staff,0,0,0,0
1746593164998,AWP 10,005,886151,Staff,0,0,0,0
1746593164998,AWP 10,006,886152,Staff,0,0,0,0
1746593164998,AWP 10,007,886153,Staff,0,0,0,0
1746593164998,AWP 10,008,886154,Staff,0,0,0,0
1746593164998,AWP 10,009,886155,Staff,0,0,0,0
1746593164998,AWP 10,010,886156,Staff,0,0,0,0
1746593164998,AWP 10,011,886158,Staff,0,0,0,0
1746593164998,AWP 10,012,886160,Staff,0,0,0,0
1746593164998,AWP 10,013,886161,Staff,0,0,0,0
1746593164998,AWP 10,014,886162,Staff,0,0,0,0
1746593164998,AWP 10,015,886163,Staff,0,0,0,0
1746593164998,AWP 10,016,886164,Staff,0,0,0,0
1746593164998,AWP 10,017,886165,Staff,0,0,0,0
1746593164998,AWP 10,018,886166,Staff,0,0,0,0
1746593164998,AWP 10,019,886168,Staff,0,0,0,0
1746593164998,AWP 10,020,886170,Staff,0,0,0,0
1746593164998,AWP 10,021,886172,Staff,0,0,0,0
1746593166026,AWP 10R,001,886173,Staff,0,1,0,0
1746593166026,AWP 10R,002,886174,Staff,0,1,0,0
1746593166026,AWP 10R,003,886175,Staff,0,0,0,0
1746593166026,AWP 10R,004,886176,Staff,0,0,0,0
1746593166026,AWP 10R,005,886177,Staff,0,0,0,0
1746593166026,AWP 10R,006,886178,Staff,0,0,0,0
1746593166026,AWP 10R,007,886179,Staff,0,0,0,0
1746593166026,AWP 10R,008,886181,Staff,0,0,0,0
1746593166026,AWP 10R,009,886182,Staff,0,0,0,0
1746593166026,AWP 10R,010,886183,Staff,0,0,0,0
1746593166026,AWP 10R,011,886184,Staff,0,0,0,0
1746593166026,AWP 10R,012,886185,Staff,0,0,0,0
1746593166026,AWP 10R,013,886186,Staff,0,0,0,0
1746593166026,AWP 10R,014,886187,Staff,0,0,0,0
1746593166026,AWP 10R,015,886188,Staff,0,0,0,0
1746593166026,AWP 10R,016,886189,Staff,0,0,0,0
1746593166026,AWP 10R,017,960532,Staff,0,0,0,0
1746593166026,AWP 10R,018,960533,Staff,0,0,0,0
1746593166026,AWP 10R,019,960534,Staff,0,0,0,0
1746593166026,AWP 10R,020,960538,Staff,0,0,0,0
1746593166026,AWP 10R,021,960540,Staff,0,0,0,0
1746593166026,AWP 10R,022,960541,Staff,0,0,0,0
1746593166026,AWP 10R,023,960542,Staff,0,0,0,0
1746593166026,AWP 10R,024,960544,Staff,0,0,0,0
1746593166026,AWP 10R,025,960545,Staff,0,0,0,0
1746593166026,AWP 10R,026,960548,Staff,0,0,0,0
1746593167054,AWP 102R,A00,886190,Staff,0,0,0,0
1746593167054,AWP 102R,B00,886191,Staff,0,0,0,0
1746593168083,BENG 100,A01,886193,Staff,17,0,30,13
1746593169113,BENG 122A,A01,886195,Hasty; Jeff M,13,0,30,17
1746593170138,BENG 166A,A00,886196,Sah; Robert Lie-Yuan,0,3,30,30
1746593171165,BENG 190,A00,958050,Khojah; Reem I,17,0,25,8
1746593172192,BIBC 102,A01,894320,Staff,0,0,46,46
1746593172192,BIBC 102,A02,894321,Staff,0,0,46,46
1746593172192,BIBC 102,A03,894344,Staff,6,0,46,40
1746593172192,BIBC 102,A04,894345,Staff,27,0,47,20
1746593173219,BICD 100R,A01,894365,Smith; Laurie,1,3,58,57
1746593173219,BICD 100R,A02,894366,Smith; Laurie,1,5,58,57
1746593173219,BICD 100R,A03,894367,Smith; Laurie,0,0,59,59
1746593173219,BICD 100R,A04,959869,Smith; Laurie,39,0,59,20
1746593174245,BICD 136,A01,894383,Gustafson-Brown; Cindy,14,0,50,36
1746593175280,BIEB 102,A01,894494,Butler; Shannon Rhey,51,0,130,79
1746593177337,BIEB 150,A01,894617,Wills; Christopher,3,0,20,17
1746593177337,BIEB 150,A02,894631,Wills; Christopher,3,0,20,17
1746593177337,BIEB 150,A03,894937,Wills; Christopher,3,0,20,17
1746593177337,BIEB 150,A04,894946,Wills; Christopher,5,0,20,15
1746593178366,BIEB 194,A00,906141,Kurle; Carolyn M.,5,0,20,15
1746593179394,BILD 1,A01,894154,Staff,3,0,19,16
1746593179394,BILD 1,A02,894155,Staff,14,0,19,5
1746593179394,BILD 1,A03,894160,Staff,13,0,19,6
1746593179394,BILD 1,A04,894161,Staff,15,0,18,3
1746593180421,BILD 2,A01,894168,Staff,0,0,50,50
1746593180421,BILD 2,A02,894169,Staff,0,0,50,50
1746593180421,BILD 2,A03,894179,Staff,0,0,50,50
1746593180421,BILD 2,A04,894203,Staff,23,0,50,27
1746593181452,BILD 3,A01,894213,Staff,23,0,31,8
1746593181452,BILD 3,A02,894214,Staff,26,0,31,5
1746593181452,BILD 3,A03,894235,Staff,28,0,31,3
1746593181452,BILD 3,A04,894236,Staff,28,0,32,4
1746593182481,BILD 4,A01,894253,Reuther; Keefe,5,0,24,19
1746593182481,BILD 4,A02,894258,Reuther; Keefe,16,0,24,8
1746593183508,BILD 5,A01,894276,Reuther; Keefe,34,0,50,16
1746593183508,BILD 5,A02,894277,Reuther; Keefe,45,0,50,5
1746593183508,BILD 5,A03,894290,Reuther; Keefe,44,0,50,6
1746593183508,BILD 5,A04,894291,Reuther; Keefe,48,0,50,2
1746593184536,BILD 24,A01,894297,Pirino; Giorgia,40,0,60,20
1746593185565,BIMM 100,B01,958915,Staff,71,0,100,29
1746593186596,BIMM 101,A01,895017,McDonnell; Lisa Marie,0,5,24,24
1746593186596,BIMM 101,A02,895018,McDonnell; Lisa Marie,0,5,24,24
1746593186596,BIMM 101,B01,895020,McDonnell; Lisa Marie,1,6,24,23
1746593186596,BIMM 101,B02,895021,McDonnell; Lisa Marie,0,4,24,24
1746593187623,BIMM 110,A01,895023,Staff,1,0,25,24
1746593187623,BIMM 110,A02,895024,Staff,9,0,25,16
1746593187623,BIMM 110,A03,895025,Staff,18,0,25,7
1746593187623,BIMM 110,A04,895031,Staff,20,0,25,5
1746593188650,BIMM 120,A01,895114,Gustafson-Brown; Cindy,14,0,28,14
1746593188650,BIMM 120,A02,895126,Gustafson-Brown; Cindy,21,0,27,6
1746593189676,BIPN 100,A01,895130,Yang; Mingyu,0,0,38,38
1746593189676,BIPN 100,A02,895131,Yang; Mingyu,31,0,38,7
1746593189676,BIPN 100,A03,895132,Yang; Mingyu,32,0,38,6
1746593189676,BIPN 100,A04,895133,Yang; Mingyu,27,0,36,9
1746593190704,BIPN 120,A01,895135,Cooke; James Edward,0,3,13,13
1746593190704,BIPN 120,A02,895136,Cooke; James Edward,0,1,13,13
1746593190704,BIPN 120,A03,895137,Cooke; James Edward,0,3,13,13
1746593190704,BIPN 120,A04,895156,Cooke; James Edward,0,2,11,11
1746593191734,BIPN 134,A01,895235,Cooke; James Edward,0,1,25,25
1746593191734,BIPN 134,A02,895237,Cooke; James Edward,0,0,25,25
1746593191734,BIPN 134,A03,895240,Cooke; James Edward,2,0,25,23
1746593191734,BIPN 134,A04,895270,Cooke; James Edward,20,0,25,5
1746593192762,BIPN 189,A00,892103,Staff,0,14,14,14
1746593194814,BISP 194,A00,958008,Staff,0,2,0,0
1746593195843,CAT 124,A01,922009,Staff,0,5,20,20
1746593196876,CAT 125R,A00,886390,Morales; Celeste Georgianna,0,3,20,20
1746593196876,CAT 125R,B00,886391,Irwin; Matthew Joseph,0,4,20,20
1746593196876,CAT 125R,C00,886392,Smith; Lauryn Alissa,0,2,20,20
1746593196876,CAT 125R,D00,886393,Vanderschuit; Maya Alysia,0,3,20,20
1746593196876,CAT 125R,E00,886394,Marchisotto; Jennifer Anne,0,3,20,20
1746593197900,CENG 15,A01,886218,Drews; Aaron,3,0,8,5
1746593198931,CENG 113,A00,886219,Opatkiewicz; Justin Paul,15,0,25,10
1746593199961,CGS 101,A00,887044,Staff,7,0,20,13
1746593200987,CGS 105,A01,887046,Staff,14,0,25,11
1746593202012,CGS 112,A00,887047,Cuong; Marisol,12,0,15,3
1746593203040,CGS 113,A00,887048,Staff,23,0,30,7
1746593204069,CGS 120,A00,887049,Staff,10,0,17,7
1746593205097,CHEM 6A,A01,886336,Lam; Tin Yiu,38,0,50,12
1746593205097,CHEM 6A,A02,886338,Lam; Tin Yiu,37,0,50,13
1746593206126,CHEM 6B,A01,886341,Hopkins; Patrycja Anna,16,0,50,34
1746593206126,CHEM 6B,A02,886343,Hopkins; Patrycja Anna,42,0,50,8
1746593207153,CHEM 6C,A01,886346,Albizati; Kim F.,0,2,50,50
1746593207153,CHEM 6C,A02,886348,Albizati; Kim F.,24,0,50,26
1746593208181,CHEM 40A,A01,886352,Klosterman; Jeremy K,65,0,100,35
1746593209212,CHEM 40B,A01,886356,Klosterman; Jeremy K,0,24,100,100
1746593210239,CHEM 41B,A01,886360,Theodorakis; Emmanuel,25,0,50,25
1746593210239,CHEM 41B,A02,886362,Theodorakis; Emmanuel,47,0,50,3
1746593211265,CHIN 165A,A00,886382,Xu; Li,18,0,20,2
1746593212291,CLAS 120,A00,886387,Myerston Santana; Jacobo,33,0,40,7
1746593213321,COGS 9,A01,886967,Shannon; Kyle Michael,42,0,60,18
1746593214349,COGS 11,A01,886969,Staff,9,0,30,21
1746593215378,COGS 14A,A01,886971,Staff,5,0,60,55
1746593216404,COGS 14B,A01,886973,Hoffman; Drew Ellen,4,0,60,56
1746593217430,COGS 18,A01,886975,Morgan; Eric,34,0,60,26
1746593218455,COGS 20,A01,886977,Staff,2,0,8,6
1746593218455,COGS 20,A02,886978,Staff,4,0,7,3
1746593219479,COGS 100,A01,907783,Staff,1,2,30,29
1746593220504,COGS 101B,A01,886980,Staff,0,4,48,48
1746593221531,COGS 101C,A01,886982,Delgado; Tania,0,5,44,44
1746593222557,COGS 102A,A01,886984,Johnson; Christine M.,3,0,30,27
1746593223586,COGS 118B,A01,886986,Staff,1,5,88,87
1746593224611,COGS 150,A01,886988,Bergen; Benjamin,22,0,50,28
1746593225639,COGS 153,A00,886989,Delgado; Tania,0,3,41,41
1746593226663,COGS 186,A01,886991,Staff,0,0,32,32
1746593227692,COGS 187A,A01,886993,Boyle; Mary E. T.,7,0,30,23
1746593228717,COGS 189,A00,886994,Staff,0,1,30,30
1746593229744,COMM 10,A01,886996,Staff,0,0,20,21
1746593229744,COMM 10,A02,886997,Staff,10,0,20,10
1746593229744,COMM 10,A03,959845,Staff,19,0,20,1
1746593230772,COMM 20,A01,886999,Leuning; Grant Maurstad,24,0,40,16
1746593232822,COMM 100A,A01,887002,Staff,0,0,20,25
1746593232822,COMM 100A,A02,887003,Staff,5,0,20,15
1746593233848,COMM 100B,A01,887005,Staff,0,8,20,24
1746593234875,COMM 106D,A00,887006,Staff,13,0,40,27
1746593235904,COMM 110G,A00,887007,Whitworth-Smith; Andrew C,12,0,40,28
1746593236932,COMM 111B,A00,887008,Staff,31,0,40,9
1746593237960,COMM 113T,A00,887009,Abuelhiga; Soraya Jill,28,0,40,12
1746593237960,COMM 113T,B00,906733,Staff,39,0,40,1
1746593238986,COMM 145,A00,887010,Staff,12,0,40,28
1746593240015,COMM 146,A00,887054,Staff,31,0,40,9
1746593241043,COMM 190,A00,887012,Staff,8,0,23,15
1746593242072,CSE 8A,A50,887015,Cao; Yingjun,56,0,85,29
1746593243099,CSE 11,A01,887017,Cao; Yingjun,11,0,70,59
1746593244127,CSE 20,A01,887019,Staff,30,0,50,20
1746593245153,CSE 21,A01,887021,Staff,79,0,100,21
1746593245153,CSE 21,B01,892583,Braun; Oliver,45,0,50,5
1746593246179,CSE 30,A01,887025,Eldon; John,142,0,200,58
1746593247205,CSE 100,A01,887027,Staff,26,0,50,24
1746593247205,CSE 100,A02,887028,Staff,42,0,50,8
1746593248230,CSE 101,A01,887030,Braun; Oliver,74,0,100,26
1746593248230,CSE 101,B01,887032,Jones; Miles E,0,3,50,50
1746593248230,CSE 101,B02,887033,Jones; Miles E,0,2,50,50
1746593249261,CSE 105,A01,908084,Jones; Miles E,32,0,50,18
1746593249261,CSE 105,A02,908087,Jones; Miles E,31,0,50,19
1746593250286,CSE 135,A01,887035,Powell; Thomas Allan,0,5,50,50
1746593251310,CSE 142,A01,887037,Staff,8,0,60,52
1746593252338,CSE 142L,A01,887039,Staff,34,0,60,26
1746593253364,CSE 151A,A01,887041,Solares; Edwin A,47,0,100,53
1746593254392,CSE 175,A01,887043,Kumar; Rakesh,30,0,30,0
1746593255418,CSS 1,A01,886389,Staff,1,2,40,39
1746593256443,DSC 30,A01,908097,Liao; Soohyun Nam,47,0,75,28
1746593257471,DSC 40A,A01,908099,Shannon; Kyle Michael,30,0,50,20
1746593258496,DSC 40B,A01,908112,Staff,15,0,50,35
1746593259524,DSC 80,A01,908116,Staff,19,0,60,41
1746593260551,DSC 197,001,956863,Eldridge; Justin Matthew,9999,0,9999,0
1746593261580,ECE 5,A01,886400,Morris; Karcher William,1,0,6,5
1746593261580,ECE 5,A02,886401,Morris; Karcher William,3,0,6,3
1746593262610,ECE 148,A01,886403,Silberman; Jack,0,14,14,14
1746593263636,ECON 1,A01,887265,Crane; Meredith Helen,11,0,70,59
1746593263636,ECON 1,B01,887268,Staff,42,0,50,8
1746593264664,ECON 2,A01,887273,Crane; Meredith Helen,54,0,70,16
1746593265693,ECON 3,A01,887279,Rondina; Giacomo,31,0,70,39
1746593266720,ECON 4,A01,887282,Anderson; John Charles,0,2,10,10
1746593267745,ECON 5,A01,887285,Staff,34,0,45,11
1746593267745,ECON 5,B01,887292,Staff,41,0,45,4
1746593268770,ECON 100A,A01,887337,Newhouse; Herbert S,54,0,70,16
1746593268770,ECON 100A,B01,887349,Staff,45,0,50,5
1746593269796,ECON 100B,A01,887361,Du; Songzi,29,0,70,41
1746593270822,ECON 100C,A01,887445,Newhouse; Herbert S,59,0,70,11
1746593271850,ECON 105,A00,887488,Vespa; Emanuel Ignacio,23,0,35,12
1746593272877,ECON 109,A01,887506,Shishkin; Denis,28,0,35,7
1746593273902,ECON 110A,A01,887568,Alon; Titan Michael,1,3,35,34
1746593273902,ECON 110A,B01,907601,Alon; Titan Michael,20,0,35,15
1746593274929,ECON 110B,A01,887598,Levkoff; Steven B.,0,24,70,70
1746593275954,ECON 112,A00,887599,Rondina; Giacomo,19,0,35,16
1746593276981,ECON 120A,A01,887603,Dai; Yinlin,35,0,70,35
1746593278009,ECON 120C,A01,887608,Sun; Yixiao,0,1,35,35
1746593278009,ECON 120C,B01,887614,Sun; Yixiao,0,0,35,35
1746593279035,ECON 138,A00,887621,Bharadwaj; Prashant,0,21,20,20
1746593280060,ECON 144,A00,958007,Squires; Dale E,12,0,35,23
1746593281087,ECON 171,A01,907666,Staff,18,0,35,17
1746593282113,ECON 175,A00,887626,Wu; Pak Yeung,22,0,35,13
1746593283138,ECON 190,A00,887640,Vespa; Emanuel Ignacio,22,0,35,13
1746593284167,EDS 25,A01,888197,Staff,0,0,0,0
1746593284167,EDS 25,A02,888209,Staff,0,0,0,0
1746593284167,EDS 25,A03,888210,Staff,0,0,0,0
1746593284167,EDS 25,A04,888212,Staff,0,0,0,0
1746593284167,EDS 25,A05,888213,Staff,0,0,0,0
1746593284167,EDS 25,A06,888214,Staff,0,0,0,0
1746593284167,EDS 25,A07,888235,Staff,0,2,0,0
1746593284167,EDS 25,A08,888236,Staff,0,0,0,0
1746593284167,EDS 25,A09,888240,Staff,0,0,0,0
1746593284167,EDS 25,A10,888244,Staff,0,0,0,0
1746593284167,EDS 25,B01,888273,Staff,0,0,0,0
1746593284167,EDS 25,B02,888285,Staff,0,0,0,0
1746593284167,EDS 25,B03,888423,Staff,0,0,0,1
1746593284167,EDS 25,B04,888432,Staff,0,0,0,0
1746593284167,EDS 25,B05,888433,Staff,0,0,0,0
1746593284167,EDS 25,B06,888467,Staff,0,0,0,0
1746593284167,EDS 25,B07,888468,Staff,0,0,0,0
1746593284167,EDS 25,B08,888479,Staff,0,0,0,0
1746593284167,EDS 25,B09,888484,Staff,0,0,0,0
1746593284167,EDS 25,B10,888487,Staff,0,0,0,0
1746593285195,EDS 38,A01,907700,Choi; Bailey Miyeon,30,0,30,0
1746593286220,EDS 112,A01,888601,Chapman; Thandeka K,12,0,40,28
1746593287244,EDS 115,A00,888697,Mendez; Kathrina Mendoza,10,0,30,20
1746593288268,EDS 116,A01,888893,Staff,33,0,40,7
1746593290320,EDS 124AR,A00,889133,Staff,29,0,50,21
1746593290320,EDS 124AR,B00,907471,Simon; Elizabeth A,37,0,50,13
1746593291344,EDS 124BR,A00,889134,Simon; Elizabeth A,44,0,100,56
1746593292372,EDS 125,A00,889135,Staff,25,0,30,5
1746593293398,EDS 126,A01,889138,Staff,35,0,40,5
1746593294422,EDS 164R,A01,889142,Wishard Guerra; Alison G.,32,0,50,18
1746593295452,ENG 30,A01,886396,Staff,0,0,0,0
1746593295452,ENG 30,B01,886398,Staff,0,0,0,0
1746593296480,ENVR 102,A00,906150,Montejo; Carolina,23,0,25,2
1746593297508,ETHN 103A,A00,887236,Man; Simeon S,0,2,0,0
1746593298533,ETHN 113,A00,887239,Staff,16,0,30,14
1746593299558,ETHN 116,A00,887240,Staff,16,0,25,9
1746593300589,ETHN 117,A00,887241,Choi; Esther Min,28,0,30,2
1746593301615,ETHN 118,A00,887243,Staff,24,0,30,6
1746593302643,ETHN 127,A00,887248,Cuong; Marisol,11,0,15,4
1746593303669,ETHN 139,A00,887250,Staff,7,0,10,3
1746593304697,ETHN 142,A00,887252,Staff,10,0,30,20
1746593305723,ETHN 161,A00,887253,Browne; Errol Tsekani,24,0,30,6
1746593306748,ETHN 163FR,A00,887255,Burelle; Julie Sara Veronique,0,0,5,5
1746593307773,GLBH 20,A00,889149,Elwardani; Nile Regina,8,0,42,34
1746593309832,GLBH 111,A01,889152,Burgos; Jose L.,17,0,17,0
1746593310856,GLBH 150,A00,889181,Sloane; Julia Kathryn,0,5,15,15
1746593312908,HDS 60,A01,886406,Warstadt; Melissa Fawn,72,0,80,8
1746593313936,HIAF 111,A00,889324,Gyamfi; Bright,25,0,32,7
1746593314960,HIEA 131,A00,889328,Staff,15,0,32,17
1746593315988,HIEA 144,A00,889333,Henry; Todd A.,26,0,32,6
1746593317013,HIEA 154,A00,889336,Henry; Todd A.,24,0,32,8
1746593318038,HIEU 106,A00,889339,Staff,22,0,32,10
1746593320093,HIEU 114,A00,889340,Staff,4,0,32,28
1746593321120,HIEU 135GS,A00,889342,Patterson; Patrick H.,0,0,1,24
1746593322147,HIEU 137,A00,889343,Edington; Claire Ellen,10,0,25,15
1746593323174,HIEU 148,A00,889345,Staff,14,0,32,18
1746593324199,HIEU 154,A00,889346,Biess; Frank Peter,21,0,32,11
1746593325223,HILA 102,A00,889351,Staff,12,0,32,20
1746593326252,HILD 2A,A01,889221,Lewandoski; Julia Mavis,2,10,32,30
1746593327279,HILD 7B,A01,889225,Man; Simeon S,0,12,32,32
1746593328309,HILD 7C,A01,889288,Alvarez; Luis A,0,14,32,32
1746593329334,HILD 30,A01,889323,Staff,0,5,32,32
1746593331387,HISC 119,A00,889383,Golan; Tal,20,0,32,12
1746593332425,HIUS 103,A00,889384,Man; Simeon S,0,0,32,32
1746593333451,HIUS 117,A00,919797,Kwak; Nancy,18,0,32,14
1746593334478,HIUS 142A,A00,919788,Staff,22,0,32,10
1746593336528,HIUS 149,A00,889386,Gyamfi; Bright,26,0,32,6
1746593337556,HIUS 155,A00,889387,Alvarez; Luis A,15,0,32,17
1746593338581,HUM 3,A01,886499,Caldwell; Michael Alan,19,0,50,31
1746593339607,HUM 3GS,A00,886500,Rodriguez; Bretton Sigfred,0,0,0,28
1746593340632,HUM 3R,A01,886502,Markman; Kristina,0,36,50,50
1746593341657,HUM 4,A01,886504,Crum; Matthew Stephen,23,0,50,27
1746593341657,HUM 4,B01,886506,West; Geoffrey Scott,17,0,50,33
1746593342686,HUM 4GS,A00,886507,Staff,0,0,0,19
1746593343724,HUM 5,A01,886509,Staff,31,0,50,19
1746593344753,HUM 5R,A01,886511,Zavodny; Tatiana Sophia,0,39,50,50
1746593345780,JAPN 180,A00,886407,Staff,16,0,40,24
1746593346810,LATI 50,A01,886409,Martin-Cabrera; Luis,3,0,22,19
1746593346810,LATI 50,A02,886410,Martin-Cabrera; Luis,19,0,22,3
1746593346810,LATI 50,A03,886411,Martin-Cabrera; Luis,21,0,22,1
1746593346810,LATI 50,A04,886412,Martin-Cabrera; Luis,8,0,22,14
1746593347839,LAWS 101,A00,907664,Staff,28,0,60,32
1746593348868,LIAB 1A,A00,889388,Saab; Dima,17,0,20,3
1746593349892,LIAB 1AX,A00,889389,El Cheddadi; Youniss,18,0,20,2
1746593350917,LIFR 1C,A00,889391,Van Moer; Vinciane G,8,0,20,12
1746593351946,LIFR 1CX,A00,889392,Van Moer; Vinciane G,7,0,20,13
1746593352971,LIFR 1D,A00,889393,Van Moer; Vinciane G,7,0,20,13
1746593353996,LIFR 1DX,A00,889394,Van Moer; Vinciane G,8,0,20,12
1746593355024,LIGN 7,A00,886923,Staff,25,0,50,25
1746593356049,LIGN 17,A00,886924,Kehler; Andrew Scott,126,0,150,24
1746593357075,LTAM 110,A00,889395,Staff,15,0,30,15
1746593358103,LTAM 110GS,A00,958010,Rodriguez; Bretton Sigfred,0,0,0,28
1746593359128,LTCH 101,A00,889397,Staff,23,0,25,2
1746593360158,LTCS 130,A00,889398,Staff,23,0,25,2
1746593361188,LTEA 138,A00,889399,Staff,24,0,40,16
1746593362217,LTEN 149,A00,889400,Wesling; Megan E.,0,3,25,25
1746593363241,LTEN 169,A00,889401,Staff,20,0,25,5
1746593364269,LTEN 180,A00,889402,Staff,10,0,15,5
1746593365298,LTEN 181,A00,889403,Staff,21,0,25,4
1746593366323,LTWL 100,A00,889404,Myerston Santana; Jacobo,2,0,25,23
1746593367348,LTWL 180GS,A00,889405,Staff,0,0,20,20
1746593368373,LTWL 181,A00,889406,Staff,16,0,25,9
1746593369400,LTWL 184,A00,889475,Mukherjee; Silpa,22,0,25,3
1746593370429,LTWR 102C,A00,889486,Staff,29,0,30,1
1746593371456,LTWR 115W,A00,889491,Staff,0,2,15,15
1746593372486,MAE 8,A01,886905,Staff,0,2,0,0
1746593373512,MAE 11,A00,886906,Bandaru; Prabhakar,0,7,50,50
1746593374536,MAE 20,A00,886907,Evdokimenko; Ekaterina,43,0,70,27
1746593375565,MAE 30B,A00,886909,Ghazinejad; Maziar,25,0,45,20
1746593376592,MAE 101B,A00,886910,Saintillan; David,30,0,45,15
1746593377618,MAE 105,A00,886911,Bandaru; Prabhakar,18,0,50,32
1746593378646,MAE 107,B00,958024,Staff,7,0,50,43
1746593379673,MAE 143B,A00,886913,Bewley; Thomas R,2,0,40,38
1746593380699,MAE 148,A01,886915,Silberman; Jack,0,3,14,14
1746593381725,MAE 160,A00,886916,Evdokimenko; Ekaterina,31,0,60,29
1746593382752,MATH 3C,A01,889681,Staff,0,2,30,30
1746593382752,MATH 3C,A02,960048,Staff,23,0,30,7
1746593383781,MATH 10A,A01,889760,Staff,26,0,30,4
1746593383781,MATH 10A,A02,889783,Staff,29,0,30,1
1746593384810,MATH 10B,A01,889785,Verstraete; Jacques Allan,1,0,35,34
1746593384810,MATH 10B,A02,889795,Verstraete; Jacques Allan,4,0,35,31
1746593384810,MATH 10B,B01,889797,Verstraete; Jacques Allan,3,0,35,32
1746593384810,MATH 10B,B02,889828,Verstraete; Jacques Allan,3,0,35,32
1746593385840,MATH 10C,A01,889849,Habib; Yousaf,8,0,30,22
1746593385840,MATH 10C,A02,889852,Habib; Yousaf,14,0,30,16
1746593385840,MATH 10C,A03,889853,Habib; Yousaf,22,0,30,8
1746593385840,MATH 10C,A04,889858,Habib; Yousaf,20,0,30,10
1746593385840,MATH 10C,B01,889861,Staff,1,0,30,29
1746593385840,MATH 10C,B02,889862,Staff,24,0,30,6
1746593385840,MATH 10C,B03,889863,Staff,27,0,30,3
1746593385840,MATH 10C,B04,889967,Staff,23,0,30,7
1746593386874,MATH 18,A01,889974,Staff,7,0,30,23
1746593386874,MATH 18,A02,889977,Staff,20,0,30,10
1746593386874,MATH 18,B01,889984,Hardiman; Liam,20,0,30,10
1746593386874,MATH 18,B02,889985,Hardiman; Liam,25,0,30,5
1746593387900,MATH 20A,A01,889990,Suk; Andrew Hoon,30,0,35,5
1746593388927,MATH 20B,A01,889993,Ohm; Ko Woon,21,0,30,9
1746593388927,MATH 20B,A02,889994,Ohm; Ko Woon,30,0,30,0
1746593388927,MATH 20B,B01,889996,Ohm; Ko Woon,22,0,30,8
1746593388927,MATH 20B,B02,889997,Ohm; Ko Woon,23,0,30,7
1746593389953,MATH 20C,A01,889999,Hammock; Frances H,17,0,30,13
1746593389953,MATH 20C,A02,890003,Hammock; Frances H,23,0,30,7
1746593389953,MATH 20C,B01,890006,Hammock; Frances H,3,0,30,27
1746593389953,MATH 20C,B02,890007,Hammock; Frances H,12,0,30,18
1746593390984,MATH 20D,A01,890011,Cheng; Hsiao-Bing,1,1,30,29
1746593390984,MATH 20D,A02,890012,Cheng; Hsiao-Bing,14,0,30,16
1746593390984,MATH 20D,B01,890016,Cheng; Hsiao-Bing,13,0,30,17
1746593390984,MATH 20D,B02,890017,Cheng; Hsiao-Bing,13,0,30,17
1746593392010,MATH 20E,A01,890026,Harel; Guershon,1,0,30,29
1746593392010,MATH 20E,A02,890029,Harel; Guershon,22,0,30,8
1746593392010,MATH 20E,B01,890033,Harel; Guershon,7,0,30,23
1746593392010,MATH 20E,B02,890101,Harel; Guershon,21,0,30,9
1746593393039,MATH 102,A01,890104,Staff,18,0,30,12
1746593393039,MATH 102,A02,890105,Staff,27,0,30,3
1746593394065,MATH 103B,A01,890116,Salehi Golsefidy; Alireza,3,0,30,27
1746593394065,MATH 103B,B01,890118,Staff,0,3,34,34
1746593395107,MATH 109,A01,890121,Aliabadi Sr.; Mohsen,0,0,30,30
1746593395107,MATH 109,B01,890124,Upadrashta; Pranav Kumar,18,0,30,12
1746593396131,MATH 120A,A01,890126,Eggers; John Dietrich,13,0,30,17
1746593397161,MATH 142B,A01,890128,Ioana; Adrian,19,0,30,11
1746593397161,MATH 142B,A02,890129,Ioana; Adrian,12,0,30,18
1746593398190,MATH 154,A01,890174,Staff,0,1,30,30
1746593398190,MATH 154,A02,890182,Staff,0,0,30,30
1746593399218,MATH 168A,A01,890197,Dumitriu; Ioana,21,0,35,14
1746593400242,MATH 170A,A01,890240,Nie; Jiawang,1,0,30,29
1746593400242,MATH 170A,A02,890241,Nie; Jiawang,11,0,30,19
1746593400242,MATH 170A,A03,890249,Nie; Jiawang,23,0,30,7
1746593401269,MATH 170B,A01,957891,Nag; Panchali,13,0,35,22
1746593403323,MATH 181A,A01,908025,Staff,0,3,35,35
1746593403323,MATH 181A,A02,960115,Staff,26,0,35,9
1746593404350,MATH 181B,A01,959874,Staff,24,0,30,6
1746593405376,MATH 193B,A01,890265,Staff,0,4,35,35
1746593406405,MGT 4,A01,890311,Anderson; John Charles,42,0,88,46
1746593407429,MGT 5,A00,907740,Staff,12,0,98,86
1746593408456,MGT 12,A00,890312,Lindenberger; Wade Douglas,67,0,98,31
1746593409481,MGT 16,A00,957883,Staff,78,0,98,20
1746593411531,MGT 45,A00,890314,Pecore; Joseph P.,45,0,98,53
1746593412557,MGT 71,A00,890315,Staff,0,12,98,98
1746593413585,MGT 100,A00,890316,Yavorsky; Daniel Ryan,44,0,98,54
1746593414609,MGT 103,A00,890317,Ehrich; Kristine R,73,0,98,25
1746593415636,MGT 105,A00,890356,Bates; Kenneth Walter,0,8,98,98
1746593416661,MGT 112,A00,890360,Ehrich; Kristine R,55,0,98,43
1746593417686,MGT 127R,A00,907732,Zhu; Kevin Xiaoguo,23,0,98,75
1746593418715,MGT 131B,A00,890361,Anderson; John Charles,59,0,98,39
1746593419742,MGT 137,A00,890362,Lindenberger; Wade Douglas,65,0,98,33
1746593420777,MGT 160,A00,890369,Johnson; Erik Barry,9,0,98,89
1746593422833,MGT 164,A00,890372,Zimmermann; Carsten,0,40,98,98
1746593423861,MGT 180,A00,890374,Bliss; Barbara Ann,11,0,98,87
1746593424892,MMW 15,A01,886414,Chang; Edmond Yi-Teh,0,12,28,28
1746593424892,MMW 15,A02,886415,Chang; Edmond Yi-Teh,0,8,28,28
1746593424892,MMW 15,A03,886416,Chang; Edmond Yi-Teh,0,9,28,28
1746593424892,MMW 15,A04,886417,Chang; Edmond Yi-Teh,0,8,28,28
1746593424892,MMW 15,B01,886419,Chang; Edmond Yi-Teh,0,7,28,28
1746593424892,MMW 15,B02,886420,Chang; Edmond Yi-Teh,0,8,28,28
1746593424892,MMW 15,B03,886421,Chang; Edmond Yi-Teh,0,7,28,28
1746593424892,MMW 15,B04,886422,Chang; Edmond Yi-Teh,0,8,28,28
1746593424892,MMW 15,C01,886424,Staff,0,9,28,28
1746593424892,MMW 15,C02,886425,Staff,0,8,28,28
1746593424892,MMW 15,C03,886426,Staff,0,8,28,28
1746593424892,MMW 15,C04,886427,Staff,0,8,28,28
1746593424892,MMW 15,C05,958038,Staff,0,8,28,28
1746593424892,MMW 15,C06,958039,Staff,1,8,28,27
1746593425921,MMW 15GS,A00,906910,Patterson; Patrick H.,4,0,28,24
1746593426946,MMW 122R,A01,886429,Rahimi; Babak,0,13,28,28
1746593426946,MMW 122R,A02,886430,Rahimi; Babak,0,12,28,28
1746593426946,MMW 122R,A03,958040,Rahimi; Babak,0,11,28,28
1746593427975,MUS 1A,A01,890937,Staff,2,0,25,23
1746593427975,MUS 1A,A02,891035,Staff,6,0,25,19
1746593427975,MUS 1A,C01,958912,Staff,24,0,25,1
1746593427975,MUS 1A,C02,958913,Staff,25,0,25,0
1746593430027,MUS 2AK,A00,957092,Ohnishi; Takae,15,0,15,0
1746593431057,MUS 4,A01,891044,Staff,0,0,25,25
1746593431057,MUS 4,A02,891045,Staff,22,0,25,3
1746593431057,MUS 4,B01,891048,Staff,17,0,25,8
1746593431057,MUS 4,B02,891050,Staff,25,0,25,0
1746593432082,MUS 5,A01,957506,Dubnov; Shlomo,0,0,25,25
1746593432082,MUS 5,A02,957622,Dubnov; Shlomo,13,0,25,12
1746593432082,MUS 5,A03,957623,Dubnov; Shlomo,20,0,25,5
1746593433113,MUS 6,A01,891053,Freitas Caetano; Marcelo,24,0,25,1
1746593433113,MUS 6,A02,891054,Freitas Caetano; Marcelo,23,0,25,2
1746593434140,MUS 7,A01,891081,Staff,0,0,25,25
1746593434140,MUS 7,A02,891082,Staff,3,0,25,22
1746593435169,MUS 8GS,A00,891118,Borgo; David Garcia,1,0,25,24
1746593436199,MUS 11,A01,891140,Staff,9,0,25,16
1746593436199,MUS 11,A02,891141,Staff,21,0,25,4
1746593437227,MUS 13,A01,891143,Staff,8,0,25,17
1746593437227,MUS 13,A02,891144,Staff,24,0,25,1
1746593438254,MUS 15,A01,891146,Staff,9,0,25,16
1746593438254,MUS 15,A02,891148,Staff,21,0,25,4
1746593438254,MUS 15,B01,891150,Staff,18,0,25,7
1746593438254,MUS 15,B02,891151,Staff,25,0,25,0
1746593439280,MUS 20,A01,891153,Staff,5,0,20,15
1746593439280,MUS 20,A02,891155,Staff,14,0,20,6
1746593440306,MUS 80,A00,891156,Staff,19,0,25,6
1746593440306,MUS 80,B00,891157,Staff,23,0,25,2
1746593441333,MUS 130,A00,891158,Ohnishi; Takae,35,0,35,0
1746593442360,MUS 150GS,A01,891160,Borgo; David Garcia,1,0,25,24
1746593443384,MUS 170,A01,891162,Freitas Caetano; Marcelo,20,0,25,5
1746593443384,MUS 170,A02,891164,Freitas Caetano; Marcelo,21,0,25,4
1746593444414,NANO 11,A00,886220,Vazquez Mena; Oscar,13,0,15,2
1746593445439,NANO 15,A01,886222,Drews; Aaron,4,0,7,3
1746593446466,NANO 104,A00,886224,Sirbuly; Donald,17,0,25,8
1746593447490,PH 40,A00,886528,Staff,23,0,40,17
1746593448519,PH 45,A01,886799,Staff,35,0,40,5
1746593449547,PH 110,A00,886802,Staff,0,6,40,40
1746593450574,PH 172,A00,906716,Staff,19,0,35,16
1746593451599,PH 191,A00,886803,Staff,6,0,40,34
1746593452625,PHIL 1,A00,889500,Staff,20,0,30,10
1746593453650,PHIL 10,A01,889549,Grush; Rick Scott,16,0,22,6
1746593453650,PHIL 10,A02,889551,Grush; Rick Scott,22,0,22,0
1746593454677,PHIL 28,A01,889559,Lamey; Andy M.,0,2,31,31
1746593454677,PHIL 28,A02,889561,Lamey; Andy M.,0,1,30,30
1746593454677,PHIL 28,A03,889572,Lamey; Andy M.,0,1,30,30
1746593455703,PHIL 35,A00,907839,Staff,13,0,15,2
1746593456735,PHIL 60,A00,889574,Staff,73,0,90,17
1746593457760,PHIL 101,A00,958004,Staff,12,0,15,3
1746593459813,PHIL 136,A00,889582,Fulkerson; Matthew Todd,26,0,45,19
1746593460844,PHIL 163,A01,889601,Staff,21,0,30,9
1746593460844,PHIL 163,B01,889606,Brandt; Reuven A,0,3,0,0
1746593461870,PHIL 164,A00,889610,Staff,16,0,30,14
1746593462897,PHIL 165,A00,889613,Staff,22,0,30,8
1746593463926,PHYS 1A,A00,886431,Staff,30,0,70,40
1746593464956,PHYS 1AL,001,886432,Tsai; Philbert S,1,2,30,29
1746593464956,PHYS 1AL,002,886436,Tsai; Philbert S,13,0,30,17
1746593465983,PHYS 1B,A00,886439,Staff,184,0,240,56
1746593467010,PHYS 1BL,001,886441,Tsai; Philbert S,0,4,30,30
1746593467010,PHYS 1BL,002,886444,Tsai; Philbert S,2,0,30,28
1746593468038,PHYS 1C,A00,896092,Arnold; Kam S,78,0,146,68
1746593469067,PHYS 1CL,001,886448,Tsai; Philbert S,0,0,30,30
1746593469067,PHYS 1CL,002,886449,Tsai; Philbert S,1,0,30,29
1746593469067,PHYS 1CL,003,886450,Tsai; Philbert S,16,0,30,14
1746593469067,PHYS 1CL,004,886451,Tsai; Philbert S,15,0,30,15
1746593470098,PHYS 2B,A01,886457,Staff,67,0,115,48
1746593471124,PHYS 2C,A01,886460,Shotwell; Brian,0,9,65,65
1746593472149,PHYS 2CL,A01,886467,Staff,0,4,28,28
1746593472149,PHYS 2CL,A02,886468,Staff,0,3,28,28
1746593473179,PHYS 2D,A01,886470,Staff,10,0,50,40
1746593474204,PHYS 4B,A01,886475,Grinstein; Benjamin,22,0,40,18
1746593475230,POLI 5,A00,891173,Desposato; Scott,7,0,25,18
1746593476256,POLI 5D,A01,891175,Staff,5,0,5,0
1746593476256,POLI 5D,B01,891178,Staff,5,0,5,0
1746593477283,POLI 11,A00,891179,Ferree; Karen E,1,0,35,34
1746593478310,POLI 12,A00,891180,Staff,15,0,30,15
1746593479334,POLI 27,A01,891182,Staff,12,0,75,63
1746593480360,POLI 30,A00,891183,Staff,8,0,50,42
1746593481388,POLI 100B,A00,891244,Staff,5,1,35,30
1746593482412,POLI 100I,A00,891247,Staff,7,0,30,23
1746593483439,POLI 104J,A00,891248,Nichter; Maysa,14,0,30,16
1746593484465,POLI 104U,A00,891250,Nichter; Maysa,1,0,30,29
1746593486517,POLI 110B,A00,891255,Wiens; David,19,0,25,6
1746593487546,POLI 112A,A00,891256,Wiens; David,6,0,25,19
1746593488572,POLI 114BR,A00,891261,Staff,19,0,30,11
1746593489601,POLI 117R,A00,891262,Forman; Fonna,0,6,50,50
1746593490625,POLI 118,A00,891264,Ingham; Sean,17,0,25,8
1746593491651,POLI 124A,A00,891265,Staff,18,0,20,2
1746593492677,POLI 125D,A00,891266,Nichter; Simeon C,2,0,25,23
1746593493705,POLI 126,A00,891268,Nichter; Simeon C,7,0,25,18
1746593494732,POLI 126AA,A00,891272,Staff,15,0,25,10
1746593495758,POLI 130AA,A00,891273,Staff,15,0,20,5
1746593496781,POLI 134AA,A00,891274,Staff,4,0,20,16
1746593498831,POLI 138,A00,891278,Staff,21,0,25,4
1746593499860,POLI 142K,A00,891280,Staff,10,0,25,15
1746593500885,POLI 142M,A00,891281,Gartzke; Erik,16,0,30,14
1746593501910,POLI 142P,A00,891284,Staff,20,0,30,10
1746593502936,POLI 143,A00,891285,Gartzke; Erik,12,0,30,18
1746593503963,POLI 153,A00,891286,Staff,19,0,20,1
1746593506015,POLI 175,A00,891290,Staff,15,0,20,5
1746593507043,PSYC 1,A00,890674,Steiner; Eric Tomas,0,11,45,45
1746593508108,PSYC 2,A00,890676,Albright; Thomas D,20,0,35,15
1746593509132,PSYC 3,A00,890679,Staff,17,0,20,3
1746593510157,PSYC 6,A00,959858,Staff,19,0,20,1
1746593511186,PSYC 60,A01,890684,Rickard; Timothy C.,0,6,45,45
1746593512212,PSYC 70,A01,890689,Geller; Emma Harlan,6,0,30,24
1746593513238,PSYC 71,A01,959860,Staff,21,0,25,4
1746593514266,PSYC 100,A00,890690,Lacefield; Katharine I,0,50,180,180
1746593515292,PSYC 102,A00,890695,Staff,18,0,40,22
1746593516324,PSYC 105,A00,890699,Geller; Emma Harlan,70,0,100,30
1746593517352,PSYC 106,A00,890701,Gorman; Michael R.,5,0,30,25
1746593518380,PSYC 108,A00,890704,Adrian; Julia Anna,0,29,50,50
1746593519407,PSYC 118,A01,890712,Staff,11,0,30,19
1746593520433,PSYC 124,A00,890716,Chapman; Eddie Nathaniel,25,0,60,35
1746593521458,PSYC 131,A00,890717,Anagnostaras; Stephan,0,7,80,80
1746593522489,PSYC 137,A00,890719,Winkielman; Piotr,0,11,30,30
1746593523516,PSYC 144,A00,890721,Adrian; Julia Anna,0,9,45,45
1746593524544,PSYC 162,A00,890805,Staff,0,1,75,75
1746593525570,PSYC 169,A00,890810,Staff,0,15,30,30
1746593526595,PSYC 172,A00,890814,Gorman; Michael R.,9,0,30,21
1746593527622,PSYC 181,A00,890818,Anagnostaras; Stephan,7,0,200,193
1746593528647,PSYC 184,A00,959861,Staff,163,0,175,12
1746593529676,PSYC 189,A00,890823,Staff,0,2,30,30
1746593530702,PSYC 191,A00,890884,Rickard; Timothy C.,0,12,35,35
1746593531731,PSYC 193,A00,890913,Staff,19,0,30,11
1746593531731,PSYC 193,B00,890914,Chapman; Eddie Nathaniel,24,0,30,6
1746593532763,PSYC 193L,A01,890918,Lowe; Angela Beth,20,0,30,10
1746593532763,PSYC 193L,B01,890921,Hurwitz; Ethan Scott,20,0,30,10
1746593532763,PSYC 193L,C01,890928,Staff,30,0,30,0
1746593533787,RELI 149,A00,886806,Rahimi; Babak,23,0,40,17
1746593534814,SE 9,A01,886814,Staff,7,0,20,13
1746593535839,SE 101B,A01,886816,Chadha; Mayank,3,0,35,32
1746593536867,SE 110B,A00,886818,Zhu; Qiang,4,0,75,71
1746593537896,SE 125,A01,886830,Staff,10,0,30,20
1746593538923,SE 130B,A01,886835,Staff,14,0,40,26
1746593539951,SE 131A,A01,886838,Krysl; Petr,34,0,55,21
1746593540979,SE 154,A00,886840,Staff,28,0,50,22
1746593542007,SE 164GS,A01,886849,Staff,6,0,20,14
1746593543032,SE 167GS,A01,886853,Staff,6,0,20,14
1746593544062,SIO 25,A01,890107,Staff,19,0,30,11
1746593545086,SIO 45,A00,890109,Cook; Geoffrey W,116,0,200,84
1746593546111,SIO 109R,A00,890110,Forman; Fonna,0,16,20,20
1746593547136,SIO 187,A01,890114,Kacev; David,15,0,40,25
1746593548162,SOCI 1,A01,890431,Thorpe; Charles Robert,14,0,30,16
1746593548162,SOCI 1,A02,890518,Thorpe; Charles Robert,30,0,30,0
1746593549186,SOCI 2,A01,957978,Staff,25,0,25,0
1746593549186,SOCI 2,A02,957979,Staff,23,0,25,2
1746593550212,SOCI 20,A01,890523,Calderon-Zaks; Michael Aar,21,0,30,9
1746593550212,SOCI 20,A02,890526,Calderon-Zaks; Michael Aar,29,0,30,1
1746593551242,SOCI 30,A01,890533,Pardo Guerra; Juan Pablo,37,0,40,3
1746593552271,SOCI 40,A01,890535,Staff,27,0,45,18
1746593553316,SOCI 104Q,A00,890559,Staff,18,0,30,12
1746593554345,SOCI 106,A00,890560,Arnal; Maud Marie Leonie,20,0,30,10
1746593555369,SOCI 110,A00,890567,Holkenbrink-Monk; Charlene,19,0,30,11
1746593556396,SOCI 112,A00,890568,Victoria Torres; Pablo,2,0,55,53
1746593557543,SOCI 115,A00,890597,Arnal; Maud Marie Leonie,28,0,45,17
1746593559599,SOCI 121,A00,890604,Pardo Guerra; Juan Pablo,38,0,45,7
1746593560628,SOCI 126,A01,890608,Staff,8,0,10,2
1746593561657,SOCI 127,A00,890609,Staff,18,0,30,12
1746593562687,SOCI 131,A00,890610,Thorpe; Charles Robert,37,0,45,8
1746593563713,SOCI 135,A00,890615,Payne; Christine Anna,14,0,45,31
1746593564739,SOCI 139,A00,890620,Staff,38,0,45,7
1746593565765,SOCI 148E,A00,890622,Calderon-Zaks; Michael Aar,36,0,45,9
1746593566794,SOCI 150,A00,890623,Kohler; Kristopher M.,31,0,45,14
1746593567819,SOCI 157,A00,890625,Jules-Rosette; Bennetta W.,18,0,20,2
1746593568847,SOCI 160,A00,890627,Payne; Christine Anna,21,0,45,24
1746593569875,SYN 1,A00,886855,Fish; Gwendolyn Anne,0,1,0,0
1746593569875,SYN 1,B00,906086,Fish; Gwendolyn Anne,0,2,0,2
1746593570900,SYN 2R,A00,886860,Staff,0,17,15,15
1746593570900,SYN 2R,B00,906106,Atkinson; Arthur Laird,0,16,15,15
1746593571927,SYN 100,A01,886866,Browne; Emily,0,28,20,20
1746593571927,SYN 100,B01,906128,Rock; Martin,0,4,20,20
1746593571927,SYN 100,C01,906140,Deavenport; James Cary,0,4,20,20
1746593571927,SYN 100,D01,907816,Deavenport; James Cary,0,5,20,20
1746593572952,TDAC 1,A00,890286,Walsh; Kim C.,7,0,20,13
1746593573977,TDAC 101,A00,890296,Basso; Beatrice,15,0,20,5
1746593575001,TDDE 131,A00,890297,Staff,47,0,50,3
1746593576025,TDDM 1,A00,890287,Weinberg; Sadie,25,0,30,5
1746593577090,TDGE 11,A00,890288,Fulton; Julia,138,0,200,62
1746593577090,TDGE 11,B00,890289,Castro; Robert Jess,185,0,200,15
1746593578118,TDGE 25,B00,957359,Walsh; Kim C.,5,0,20,15
1746593579153,TDGE 40,A01,890292,Power; Jade Yukana,26,0,30,4
1746593580182,TDGE 124,A00,890298,Havis; Allan,0,2,50,50
1746593581208,TDGE 131R,A00,890299,Burelle; Julie Sara Veronique,15,0,42,27
1746593582237,TDHT 101,A00,890300,Staff,10,0,20,10
1746593583265,TDHT 109,A01,890302,Anderson; Mysia Anyse,31,0,40,9
1746593584294,TDMV 1,A00,890293,Arcidiacono; Kristin,18,0,30,12
1746593585322,TDMV 2,A00,890294,Weinberg; Sadie,23,0,30,7
1746593586350,TDMV 3,A00,957878,Arcidiacono; Kristin,28,0,30,2
1746593588407,TDMV 138,A00,890304,Jun; Grace Shin Hae,25,0,40,15
1746593589435,TDMV 140,A00,890305,Corrales; Joseph Bernales,25,0,30,5
1746593590463,TDMV 142,A00,890307,Caligagan; Tony,32,0,40,8
1746593591491,TDMV 144,A00,890308,Camaya; Michelle Ann,25,0,30,5
1746593592518,TDPW 1,A00,890295,Stein; Deborah Isobel,3,0,20,17
1746593593547,USP 2,A01,890272,Lerner; Amy M,7,0,20,13
1746593594574,USP 3,A01,890274,Staff,12,0,30,18
1746593595604,USP 15,A01,890276,Sun; Feiyang,16,0,30,14
1746593596630,USP 25,A00,890277,Shenkman; Michael Thomas,18,0,25,7
1746593597654,USP 138,A00,890278,Staff,13,0,25,12
1746593598681,USP 143,A00,890279,Staff,22,0,70,48
1746593599707,USP 144,A00,890280,Chowdhury; Muhammed Zohir,16,0,30,14
1746593600732,USP 150,A00,890281,Boomhower; Matthew Charles,4,0,30,26
1746593601758,USP 151,A00,890282,Staff,16,0,20,4
1746593602787,USP 162,A00,890283,Andrews; Abigail Leslie,16,0,20,4
1746593603813,USP 168,A00,920477,Kwak; Nancy,0,0,5,5
1746593604837,USP 181,A00,890284,Staff,3,0,20,17
1746593605862,USP 191A,A00,890285,Staff,12,0,20,8
1746593606891,VIS 101,A00,886512,Staff,26,0,75,49
1746593607915,VIS 103,A00,886513,Cruz; Edwin Teddy,61,0,75,14
1746593608945,VIS 108,A00,886514,Staff,3,0,15,12
1746593609970,VIS 127P,A00,886515,Shen; Kuiyi,80,0,146,66
1746593610994,VIS 149,A00,886516,Yoldas; Pinar,0,0,15,15
1746593612021,VIS 164,A00,886526,Erdmann; Dean,19,0,22,3
1746593613047,VIS 194S,A00,886527,Staff,61,0,75,14
1746593614072,WCWP 10A,C00,886484,Martiniuk; Jill,12,0,15,3
1746593615104,WCWP 10B,A00,886490,Uriarte; Emma,0,0,15,15
1746593615104,WCWP 10B,B00,886491,Dhir; Simrita,8,0,15,7
1746593615104,WCWP 10B,C00,886492,Ornelas; Tricia,0,0,15,15
1746593616133,WCWP 100,A00,886494,Young; Mark T,0,6,15,15
1746593618217,AAS 10,A01,886199,Childs; Dennis R.,0,3,0,0
1746593619243,ANAR 104,A01,886940,Shtienberg; Gilad,27,0,30,3
1746593620267,ANAR 120,A00,886953,Staff,13,0,20,7
1746593621295,ANBI 148,A01,886955,Wilder; Linnea Lorene,30,0,40,10
1746593623346,ANSC 122,A00,886957,Staff,24,0,30,6
1746593624372,ANSC 150,A00,886958,Sloane; Julia Kathryn,2,0,15,13
1746593625400,ANSC 156,A00,886959,Jenkins; Janis A.,0,1,15,15
1746593626424,ANSC 180,A00,886960,Staff,11,0,17,6
1746593627452,ANSC 188,A00,886961,Jassal; Aftab,9,0,25,16
1746593628480,ANSC 190,A00,886962,Jassal; Aftab,14,0,25,11
1746593629506,ANSC 191,A00,886963,Staff,18,0,20,2
1746593630534,ANTH 3,A01,891689,Staff,17,0,20,3
1746593631561,ANTH 5,A00,886933,Semendeferi; Ekaterini,16,0,20,4
1746593632586,ANTH 10,A00,886934,Staff,0,12,30,30
1746593633612,ANTH 21,A01,886936,Staff,41,0,60,19
1746593634638,ANTH 23,A01,886938,Staff,92,0,100,8
1746593635662,ANTH 105,A00,886964,Stewart; Alexander B,84,0,100,16
1746593636690,ANTH 108,A00,886965,Pedersen; David,9,0,20,11
1746593637727,AWP 10,001,886147,Staff,0,0,0,0
1746593637727,AWP 10,002,886148,Staff,0,0,0,0
1746593637727,AWP 10,003,886149,Staff,0,0,0,0
1746593637727,AWP 10,004,886150,Staff,0,0,0,0
1746593637727,AWP 10,005,886151,Staff,0,0,0,0
1746593637727,AWP 10,006,886152,Staff,0,0,0,0
1746593637727,AWP 10,007,886153,Staff,0,0,0,0
1746593637727,AWP 10,008,886154,Staff,0,0,0,0
1746593637727,AWP 10,009,886155,Staff,0,0,0,0
1746593637727,AWP 10,010,886156,Staff,0,0,0,0
1746593637727,AWP 10,011,886158,Staff,0,0,0,0
1746593637727,AWP 10,012,886160,Staff,0,0,0,0
1746593637727,AWP 10,013,886161,Staff,0,0,0,0
1746593637727,AWP 10,014,886162,Staff,0,0,0,0
1746593637727,AWP 10,015,886163,Staff,0,0,0,0
1746593637727,AWP 10,016,886164,Staff,0,0,0,0
1746593637727,AWP 10,017,886165,Staff,0,0,0,0
1746593637727,AWP 10,018,886166,Staff,0,0,0,0
1746593637727,AWP 10,019,886168,Staff,0,0,0,0
1746593637727,AWP 10,020,886170,Staff,0,0,0,0
1746593637727,AWP 10,021,886172,Staff,0,0,0,0
1746593638757,AWP 10R,001,886173,Staff,0,1,0,0
1746593638757,AWP 10R,002,886174,Staff,0,1,0,0
1746593638757,AWP 10R,003,886175,Staff,0,0,0,0
1746593638757,AWP 10R,004,886176,Staff,0,0,0,0
1746593638757,AWP 10R,005,886177,Staff,0,0,0,0
1746593638757,AWP 10R,006,886178,Staff,0,0,0,0
1746593638757,AWP 10R,007,886179,Staff,0,0,0,0
1746593638757,AWP 10R,008,886181,Staff,0,0,0,0
1746593638757,AWP 10R,009,886182,Staff,0,0,0,0
1746593638757,AWP 10R,010,886183,Staff,0,0,0,0
1746593638757,AWP 10R,011,886184,Staff,0,0,0,0
1746593638757,AWP 10R,012,886185,Staff,0,0,0,0
1746593638757,AWP 10R,013,886186,Staff,0,0,0,0
1746593638757,AWP 10R,014,886187,Staff,0,0,0,0
1746593638757,AWP 10R,015,886188,Staff,0,0,0,0
1746593638757,AWP 10R,016,886189,Staff,0,0,0,0
1746593638757,AWP 10R,017,960532,Staff,0,0,0,0
1746593638757,AWP 10R,018,960533,Staff,0,0,0,0
1746593638757,AWP 10R,019,960534,Staff,0,0,0,0
1746593638757,AWP 10R,020,960538,Staff,0,0,0,0
1746593638757,AWP 10R,021,960540,Staff,0,0,0,0
1746593638757,AWP 10R,022,960541,Staff,0,0,0,0
1746593638757,AWP 10R,023,960542,Staff,0,0,0,0
1746593638757,AWP 10R,024,960544,Staff,0,0,0,0
1746593638757,AWP 10R,025,960545,Staff,0,0,0,0
1746593638757,AWP 10R,026,960548,Staff,0,0,0,0
1746593639783,AWP 102R,A00,886190,Staff,0,0,0,0
1746593639783,AWP 102R,B00,886191,Staff,0,0,0,0
1746593640808,BENG 100,A01,886193,Staff,17,0,30,13
1746593641835,BENG 122A,A01,886195,Hasty; Jeff M,13,0,30,17
1746593642863,BENG 166A,A00,886196,Sah; Robert Lie-Yuan,0,3,30,30
1746593643891,BENG 190,A00,958050,Khojah; Reem I,17,0,25,8
1746593644915,BIBC 102,A01,894320,Staff,0,0,46,46
1746593644915,BIBC 102,A02,894321,Staff,0,0,46,46
1746593644915,BIBC 102,A03,894344,Staff,6,0,46,40
1746593644915,BIBC 102,A04,894345,Staff,27,0,47,20
1746593645947,BICD 100R,A01,894365,Smith; Laurie,1,3,58,57
1746593645947,BICD 100R,A02,894366,Smith; Laurie,1,5,58,57
1746593645947,BICD 100R,A03,894367,Smith; Laurie,0,0,59,59
1746593645947,BICD 100R,A04,959869,Smith; Laurie,39,0,59,20
1746593646973,BICD 136,A01,894383,Gustafson-Brown; Cindy,14,0,50,36
1746593647999,BIEB 102,A01,894494,Butler; Shannon Rhey,51,0,130,79
1746593650056,BIEB 150,A01,894617,Wills; Christopher,3,0,20,17
1746593650056,BIEB 150,A02,894631,Wills; Christopher,3,0,20,17
1746593650056,BIEB 150,A03,894937,Wills; Christopher,3,0,20,17
1746593650056,BIEB 150,A04,894946,Wills; Christopher,5,0,20,15
1746593651080,BIEB 194,A00,906141,Kurle; Carolyn M.,5,0,20,15
1746593652109,BILD 1,A01,894154,Staff,3,0,19,16
1746593652109,BILD 1,A02,894155,Staff,14,0,19,5
1746593652109,BILD 1,A03,894160,Staff,13,0,19,6
1746593652109,BILD 1,A04,894161,Staff,15,0,18,3
1746593653136,BILD 2,A01,894168,Staff,0,0,50,50
1746593653136,BILD 2,A02,894169,Staff,0,0,50,50
1746593653136,BILD 2,A03,894179,Staff,0,0,50,50
1746593653136,BILD 2,A04,894203,Staff,23,0,50,27
1746593654164,BILD 3,A01,894213,Staff,23,0,31,8
1746593654164,BILD 3,A02,894214,Staff,26,0,31,5
1746593654164,BILD 3,A03,894235,Staff,28,0,31,3
1746593654164,BILD 3,A04,894236,Staff,28,0,32,4
1746593655189,BILD 4,A01,894253,Reuther; Keefe,5,0,24,19
1746593655189,BILD 4,A02,894258,Reuther; Keefe,16,0,24,8
1746593656214,BILD 5,A01,894276,Reuther; Keefe,34,0,50,16
1746593656214,BILD 5,A02,894277,Reuther; Keefe,45,0,50,5
1746593656214,BILD 5,A03,894290,Reuther; Keefe,44,0,50,6
1746593656214,BILD 5,A04,894291,Reuther; Keefe,48,0,50,2
1746593657240,BILD 24,A01,894297,Pirino; Giorgia,40,0,60,20
1746593658266,BIMM 100,B01,958915,Staff,71,0,100,29
1746593659291,BIMM 101,A01,895017,McDonnell; Lisa Marie,0,5,24,24
1746593659291,BIMM 101,A02,895018,McDonnell; Lisa Marie,0,5,24,24
1746593659291,BIMM 101,B01,895020,McDonnell; Lisa Marie,1,6,24,23
1746593659291,BIMM 101,B02,895021,McDonnell; Lisa Marie,0,4,24,24
1746593660316,BIMM 110,A01,895023,Staff,1,0,25,24
1746593660316,BIMM 110,A02,895024,Staff,9,0,25,16
1746593660316,BIMM 110,A03,895025,Staff,18,0,25,7
1746593660316,BIMM 110,A04,895031,Staff,20,0,25,5
1746593661341,BIMM 120,A01,895114,Gustafson-Brown; Cindy,14,0,28,14
1746593661341,BIMM 120,A02,895126,Gustafson-Brown; Cindy,21,0,27,6
1746593662365,BIPN 100,A01,895130,Yang; Mingyu,0,0,38,38
1746593662365,BIPN 100,A02,895131,Yang; Mingyu,31,0,38,7
1746593662365,BIPN 100,A03,895132,Yang; Mingyu,32,0,38,6
1746593662365,BIPN 100,A04,895133,Yang; Mingyu,27,0,36,9
1746593663392,BIPN 120,A01,895135,Cooke; James Edward,0,3,13,13
1746593663392,BIPN 120,A02,895136,Cooke; James Edward,0,1,13,13
1746593663392,BIPN 120,A03,895137,Cooke; James Edward,0,3,13,13
1746593663392,BIPN 120,A04,895156,Cooke; James Edward,0,2,11,11
1746593664418,BIPN 134,A01,895235,Cooke; James Edward,0,1,25,25
1746593664418,BIPN 134,A02,895237,Cooke; James Edward,0,0,25,25
1746593664418,BIPN 134,A03,895240,Cooke; James Edward,2,0,25,23
1746593664418,BIPN 134,A04,895270,Cooke; James Edward,20,0,25,5
1746593665442,BIPN 189,A00,892103,Staff,0,14,14,14
1746593667494,BISP 194,A00,958008,Staff,0,2,0,0
1746593668522,CAT 124,A01,922009,Staff,0,5,20,20
1746593669554,CAT 125R,A00,886390,Morales; Celeste Georgianna,0,3,20,20
1746593669554,CAT 125R,B00,886391,Irwin; Matthew Joseph,0,4,20,20
1746593669554,CAT 125R,C00,886392,Smith; Lauryn Alissa,0,2,20,20
1746593669554,CAT 125R,D00,886393,Vanderschuit; Maya Alysia,0,3,20,20
1746593669554,CAT 125R,E00,886394,Marchisotto; Jennifer Anne,0,3,20,20
1746593670579,CENG 15,A01,886218,Drews; Aaron,3,0,8,5
1746593671609,CENG 113,A00,886219,Opatkiewicz; Justin Paul,15,0,25,10
1746593672635,CGS 101,A00,887044,Staff,7,0,20,13
1746593673663,CGS 105,A01,887046,Staff,14,0,25,11
1746593674690,CGS 112,A00,887047,Cuong; Marisol,12,0,15,3
1746593675719,CGS 113,A00,887048,Staff,23,0,30,7
1746593676743,CGS 120,A00,887049,Staff,10,0,17,7
1746593677772,CHEM 6A,A01,886336,Lam; Tin Yiu,38,0,50,12
1746593677772,CHEM 6A,A02,886338,Lam; Tin Yiu,37,0,50,13
1746593678797,CHEM 6B,A01,886341,Hopkins; Patrycja Anna,16,0,50,34
1746593678797,CHEM 6B,A02,886343,Hopkins; Patrycja Anna,42,0,50,8
1746593679825,CHEM 6C,A01,886346,Albizati; Kim F.,0,2,50,50
1746593679825,CHEM 6C,A02,886348,Albizati; Kim F.,24,0,50,26
1746593680895,CHEM 40A,A01,886352,Klosterman; Jeremy K,65,0,100,35
1746593681919,CHEM 40B,A01,886356,Klosterman; Jeremy K,0,24,100,100
1746593682944,CHEM 41B,A01,886360,Theodorakis; Emmanuel,25,0,50,25
1746593682944,CHEM 41B,A02,886362,Theodorakis; Emmanuel,47,0,50,3
1746593684046,CHIN 165A,A00,886382,Xu; Li,18,0,20,2
1746593685075,CLAS 120,A00,886387,Myerston Santana; Jacobo,33,0,40,7
1746593686103,COGS 9,A01,886967,Shannon; Kyle Michael,42,0,60,18
1746593687128,COGS 11,A01,886969,Staff,9,0,30,21
1746593688157,COGS 14A,A01,886971,Staff,5,0,60,55
1746593689187,COGS 14B,A01,886973,Hoffman; Drew Ellen,4,0,60,56
1746593690215,COGS 18,A01,886975,Morgan; Eric,34,0,60,26
1746593691239,COGS 20,A01,886977,Staff,2,0,8,6
1746593691239,COGS 20,A02,886978,Staff,5,0,7,2
1746593692265,COGS 100,A01,907783,Staff,1,2,30,29
1746593693289,COGS 101B,A01,886980,Staff,0,4,48,48
1746593694317,COGS 101C,A01,886982,Delgado; Tania,0,5,44,44
1746593695344,COGS 102A,A01,886984,Johnson; Christine M.,3,0,30,27
1746593696370,COGS 118B,A01,886986,Staff,1,5,88,87
1746593697399,COGS 150,A01,886988,Bergen; Benjamin,22,0,50,28
1746593698427,COGS 153,A00,886989,Delgado; Tania,0,3,41,41
1746593699453,COGS 186,A01,886991,Staff,0,0,32,32
1746593700480,COGS 187A,A01,886993,Boyle; Mary E. T.,7,0,30,23
1746593701505,COGS 189,A00,886994,Staff,0,1,30,30
1746593702532,COMM 10,A01,886996,Staff,0,0,20,21
1746593702532,COMM 10,A02,886997,Staff,10,0,20,10
1746593702532,COMM 10,A03,959845,Staff,19,0,20,1
1746593703560,COMM 20,A01,886999,Leuning; Grant Maurstad,24,0,40,16
1746593705622,COMM 100A,A01,887002,Staff,0,0,20,25
1746593705622,COMM 100A,A02,887003,Staff,5,0,20,15
1746593706649,COMM 100B,A01,887005,Staff,0,8,20,24
1746593707677,COMM 106D,A00,887006,Staff,13,0,40,27
1746593708705,COMM 110G,A00,887007,Whitworth-Smith; Andrew C,12,0,40,28
1746593709732,COMM 111B,A00,887008,Staff,31,0,40,9
1746593710757,COMM 113T,A00,887009,Abuelhiga; Soraya Jill,28,0,40,12
1746593710757,COMM 113T,B00,906733,Staff,39,0,40,1
1746593711782,COMM 145,A00,887010,Staff,12,0,40,28
1746593712806,COMM 146,A00,887054,Staff,31,0,40,9
1746593713830,COMM 190,A00,887012,Staff,8,0,23,15
1746593714855,CSE 8A,A50,887015,Cao; Yingjun,56,0,85,29
1746593715885,CSE 11,A01,887017,Cao; Yingjun,11,0,70,59
1746593716913,CSE 20,A01,887019,Staff,30,0,50,20
1746593717940,CSE 21,A01,887021,Staff,79,0,100,21
1746593717940,CSE 21,B01,892583,Braun; Oliver,45,0,50,5
1746593718970,CSE 30,A01,887025,Eldon; John,142,0,200,58
1746593719995,CSE 100,A01,887027,Staff,26,0,50,24
1746593719995,CSE 100,A02,887028,Staff,42,0,50,8
1746593721020,CSE 101,A01,887030,Braun; Oliver,74,0,100,26
1746593721020,CSE 101,B01,887032,Jones; Miles E,0,3,50,50
1746593721020,CSE 101,B02,887033,Jones; Miles E,0,2,50,50
1746593722047,CSE 105,A01,908084,Jones; Miles E,32,0,50,18
1746593722047,CSE 105,A02,908087,Jones; Miles E,31,0,50,19
1746593723072,CSE 135,A01,887035,Powell; Thomas Allan,0,5,50,50
1746593724097,CSE 142,A01,887037,Staff,8,0,60,52
1746593725124,CSE 142L,A01,887039,Staff,34,0,60,26
1746593726154,CSE 151A,A01,887041,Solares; Edwin A,47,0,100,53
1746593727179,CSE 175,A01,887043,Kumar; Rakesh,30,0,30,0
1746593728204,CSS 1,A01,886389,Staff,1,2,40,39
1746593729231,DSC 30,A01,908097,Liao; Soohyun Nam,47,0,75,28
1746593730258,DSC 40A,A01,908099,Shannon; Kyle Michael,30,0,50,20
1746593731283,DSC 40B,A01,908112,Staff,15,0,50,35
1746593732310,DSC 80,A01,908116,Staff,19,0,60,41
1746593733337,DSC 197,001,956863,Eldridge; Justin Matthew,9999,0,9999,0
1746593734366,ECE 5,A01,886400,Morris; Karcher William,1,0,6,5
1746593734366,ECE 5,A02,886401,Morris; Karcher William,3,0,6,3
1746593735394,ECE 148,A01,886403,Silberman; Jack,0,14,14,14
1746593736424,ECON 1,A01,887265,Crane; Meredith Helen,11,0,70,59
1746593736424,ECON 1,B01,887268,Staff,42,0,50,8
1746593737452,ECON 2,A01,887273,Crane; Meredith Helen,54,0,70,16
1746593738478,ECON 3,A01,887279,Rondina; Giacomo,31,0,70,39
1746593739508,ECON 4,A01,887282,Anderson; John Charles,0,2,10,10
1746593740536,ECON 5,A01,887285,Staff,34,0,45,11
1746593740536,ECON 5,B01,887292,Staff,41,0,45,4
1746593741565,ECON 100A,A01,887337,Newhouse; Herbert S,54,0,70,16
1746593741565,ECON 100A,B01,887349,Staff,45,0,50,5
1746593742597,ECON 100B,A01,887361,Du; Songzi,29,0,70,41
1746593743622,ECON 100C,A01,887445,Newhouse; Herbert S,59,0,70,11
1746593744647,ECON 105,A00,887488,Vespa; Emanuel Ignacio,23,0,35,12
1746593745674,ECON 109,A01,887506,Shishkin; Denis,28,0,35,7
1746593746700,ECON 110A,A01,887568,Alon; Titan Michael,1,3,35,34
1746593746700,ECON 110A,B01,907601,Alon; Titan Michael,20,0,35,15
1746593747729,ECON 110B,A01,887598,Levkoff; Steven B.,0,24,70,70
1746593748756,ECON 112,A00,887599,Rondina; Giacomo,19,0,35,16
1746593749786,ECON 120A,A01,887603,Dai; Yinlin,35,0,70,35
1746593750814,ECON 120C,A01,887608,Sun; Yixiao,0,1,35,35
1746593750814,ECON 120C,B01,887614,Sun; Yixiao,0,0,35,35
1746593751850,ECON 138,A00,887621,Bharadwaj; Prashant,0,21,20,20
1746593752884,ECON 144,A00,958007,Squires; Dale E,12,0,35,23
1746593753913,ECON 171,A01,907666,Staff,18,0,35,17
1746593754937,ECON 175,A00,887626,Wu; Pak Yeung,22,0,35,13
1746593755961,ECON 190,A00,887640,Vespa; Emanuel Ignacio,22,0,35,13
1746593756990,EDS 25,A01,888197,Staff,0,0,0,0
1746593756990,EDS 25,A02,888209,Staff,0,0,0,0
1746593756990,EDS 25,A03,888210,Staff,0,0,0,0
1746593756990,EDS 25,A04,888212,Staff,0,0,0,0
1746593756990,EDS 25,A05,888213,Staff,0,0,0,0
1746593756990,EDS 25,A06,888214,Staff,0,0,0,0
1746593756990,EDS 25,A07,888235,Staff,0,2,0,0
1746593756990,EDS 25,A08,888236,Staff,0,0,0,0
1746593756990,EDS 25,A09,888240,Staff,0,0,0,0
1746593756990,EDS 25,A10,888244,Staff,0,0,0,0
1746593756990,EDS 25,B01,888273,Staff,0,0,0,0
1746593756990,EDS 25,B02,888285,Staff,0,0,0,0
1746593756990,EDS 25,B03,888423,Staff,0,0,0,1
1746593756990,EDS 25,B04,888432,Staff,0,0,0,0
1746593756990,EDS 25,B05,888433,Staff,0,0,0,0
1746593756990,EDS 25,B06,888467,Staff,0,0,0,0
1746593756990,EDS 25,B07,888468,Staff,0,0,0,0
1746593756990,EDS 25,B08,888479,Staff,0,0,0,0
1746593756990,EDS 25,B09,888484,Staff,0,0,0,0
1746593756990,EDS 25,B10,888487,Staff,0,0,0,0
1746593758017,EDS 38,A01,907700,Choi; Bailey Miyeon,30,0,30,0
1746593759044,EDS 112,A01,888601,Chapman; Thandeka K,12,0,40,28
1746593760069,EDS 115,A00,888697,Mendez; Kathrina Mendoza,10,0,30,20
1746593761097,EDS 116,A01,888893,Staff,33,0,40,7
1746593763155,EDS 124AR,A00,889133,Staff,29,0,50,21
1746593763155,EDS 124AR,B00,907471,Simon; Elizabeth A,37,0,50,13
1746593764180,EDS 124BR,A00,889134,Simon; Elizabeth A,44,0,100,56
1746593765204,EDS 125,A00,889135,Staff,25,0,30,5
1746593766233,EDS 126,A01,889138,Staff,35,0,40,5
1746593767261,EDS 164R,A01,889142,Wishard Guerra; Alison G.,32,0,50,18
1746593768290,ENG 30,A01,886396,Staff,0,0,0,0
1746593768290,ENG 30,B01,886398,Staff,0,0,0,0
1746593769318,ENVR 102,A00,906150,Montejo; Carolina,23,0,25,2
1746593770346,ETHN 103A,A00,887236,Man; Simeon S,0,2,0,0
1746593771371,ETHN 113,A00,887239,Staff,16,0,30,14
1746593772397,ETHN 116,A00,887240,Staff,16,0,25,9
1746593773423,ETHN 117,A00,887241,Choi; Esther Min,28,0,30,2
1746593774448,ETHN 118,A00,887243,Staff,24,0,30,6
1746593775477,ETHN 127,A00,887248,Cuong; Marisol,11,0,15,4
1746593776503,ETHN 139,A00,887250,Staff,7,0,10,3
1746593777530,ETHN 142,A00,887252,Staff,10,0,30,20
1746593778556,ETHN 161,A00,887253,Browne; Errol Tsekani,24,0,30,6
1746593779585,ETHN 163FR,A00,887255,Burelle; Julie Sara Veronique,0,0,5,5
1746593780613,GLBH 20,A00,889149,Elwardani; Nile Regina,8,0,42,34
1746593782665,GLBH 111,A01,889152,Burgos; Jose L.,17,0,17,0
1746593783694,GLBH 150,A00,889181,Sloane; Julia Kathryn,0,5,15,15
1746593785782,HDS 60,A01,886406,Warstadt; Melissa Fawn,72,0,80,8
1746593786808,HIAF 111,A00,889324,Gyamfi; Bright,25,0,32,7
1746593787834,HIEA 131,A00,889328,Staff,15,0,32,17
1746593788860,HIEA 144,A00,889333,Henry; Todd A.,26,0,32,6
1746593789885,HIEA 154,A00,889336,Henry; Todd A.,24,0,32,8
1746593790916,HIEU 106,A00,889339,Staff,22,0,32,10
1746593792968,HIEU 114,A00,889340,Staff,4,0,32,28
1746593793998,HIEU 135GS,A00,889342,Patterson; Patrick H.,0,0,1,24
1746593795026,HIEU 137,A00,889343,Edington; Claire Ellen,10,0,25,15
1746593796051,HIEU 148,A00,889345,Staff,14,0,32,18
1746593797077,HIEU 154,A00,889346,Biess; Frank Peter,21,0,32,11
1746593798102,HILA 102,A00,889351,Staff,12,0,32,20
1746593799129,HILD 2A,A01,889221,Lewandoski; Julia Mavis,2,10,32,30
1746593800159,HILD 7B,A01,889225,Man; Simeon S,0,12,32,32
1746593801187,HILD 7C,A01,889288,Alvarez; Luis A,0,14,32,32
1746593802212,HILD 30,A01,889323,Staff,0,5,32,32
1746593804261,HISC 119,A00,889383,Golan; Tal,20,0,32,12
1746593805290,HIUS 103,A00,889384,Man; Simeon S,0,0,32,32
1746593806320,HIUS 117,A00,919797,Kwak; Nancy,18,0,32,14
1746593807348,HIUS 142A,A00,919788,Staff,22,0,32,10
1746593809397,HIUS 149,A00,889386,Gyamfi; Bright,26,0,32,6
1746593810421,HIUS 155,A00,889387,Alvarez; Luis A,15,0,32,17
1746593811452,HUM 3,A01,886499,Caldwell; Michael Alan,19,0,50,31
1746593812480,HUM 3GS,A00,886500,Rodriguez; Bretton Sigfred,0,0,0,28
1746593813505,HUM 3R,A01,886502,Markman; Kristina,0,36,50,50
1746593814534,HUM 4,A01,886504,Crum; Matthew Stephen,23,0,50,27
1746593814534,HUM 4,B01,886506,West; Geoffrey Scott,17,0,50,33
1746593815564,HUM 4GS,A00,886507,Staff,0,0,0,19
1746593816589,HUM 5,A01,886509,Staff,31,0,50,19
1746593817615,HUM 5R,A01,886511,Zavodny; Tatiana Sophia,0,39,50,50
1746593818647,JAPN 180,A00,886407,Staff,16,0,40,24
1746593819672,LATI 50,A01,886409,Martin-Cabrera; Luis,3,0,22,19
1746593819672,LATI 50,A02,886410,Martin-Cabrera; Luis,19,0,22,3
1746593819672,LATI 50,A03,886411,Martin-Cabrera; Luis,21,0,22,1
1746593819672,LATI 50,A04,886412,Martin-Cabrera; Luis,8,0,22,14
1746593820701,LAWS 101,A00,907664,Staff,28,0,60,32
1746593821726,LIAB 1A,A00,889388,Saab; Dima,17,0,20,3
1746593822752,LIAB 1AX,A00,889389,El Cheddadi; Youniss,18,0,20,2
1746593823780,LIFR 1C,A00,889391,Van Moer; Vinciane G,8,0,20,12
1746593824809,LIFR 1CX,A00,889392,Van Moer; Vinciane G,7,0,20,13
1746593825835,LIFR 1D,A00,889393,Van Moer; Vinciane G,7,0,20,13
1746593826864,LIFR 1DX,A00,889394,Van Moer; Vinciane G,8,0,20,12
1746593827890,LIGN 7,A00,886923,Staff,25,0,50,25
1746593828918,LIGN 17,A00,886924,Kehler; Andrew Scott,126,0,150,24
1746593829942,LTAM 110,A00,889395,Staff,15,0,30,15
1746593830967,LTAM 110GS,A00,958010,Rodriguez; Bretton Sigfred,0,0,0,28
1746593831993,LTCH 101,A00,889397,Staff,23,0,25,2
1746593833021,LTCS 130,A00,889398,Staff,23,0,25,2
1746593834047,LTEA 138,A00,889399,Staff,24,0,40,16
1746593835074,LTEN 149,A00,889400,Wesling; Megan E.,0,3,25,25
1746593836100,LTEN 169,A00,889401,Staff,20,0,25,5
1746593837125,LTEN 180,A00,889402,Staff,10,0,15,5
1746593838152,LTEN 181,A00,889403,Staff,21,0,25,4
1746593839177,LTWL 100,A00,889404,Myerston Santana; Jacobo,2,0,25,23
1746593840203,LTWL 180GS,A00,889405,Staff,0,0,20,20
1746593841229,LTWL 181,A00,889406,Staff,16,0,25,9
1746593842254,LTWL 184,A00,889475,Mukherjee; Silpa,22,0,25,3
1746593843282,LTWR 102C,A00,889486,Staff,29,0,30,1
1746593844305,LTWR 115W,A00,889491,Staff,0,2,15,15
1746593845332,MAE 8,A01,886905,Staff,0,2,0,0
1746593846361,MAE 11,A00,886906,Bandaru; Prabhakar,0,7,50,50
1746593847387,MAE 20,A00,886907,Evdokimenko; Ekaterina,43,0,70,27
1746593848413,MAE 30B,A00,886909,Ghazinejad; Maziar,25,0,45,20
1746593849440,MAE 101B,A00,886910,Saintillan; David,30,0,45,15
1746593850465,MAE 105,A00,886911,Bandaru; Prabhakar,18,0,50,32
1746593851491,MAE 107,B00,958024,Staff,7,0,50,43
1746593852519,MAE 143B,A00,886913,Bewley; Thomas R,2,0,40,38
1746593853545,MAE 148,A01,886915,Silberman; Jack,0,3,14,14
1746593854575,MAE 160,A00,886916,Evdokimenko; Ekaterina,31,0,60,29
1746593855600,MATH 3C,A01,889681,Staff,0,2,30,30
1746593855600,MATH 3C,A02,960048,Staff,23,0,30,7
1746593856625,MATH 10A,A01,889760,Staff,26,0,30,4
1746593856625,MATH 10A,A02,889783,Staff,29,0,30,1
1746593857657,MATH 10B,A01,889785,Verstraete; Jacques Allan,1,0,35,34
1746593857657,MATH 10B,A02,889795,Verstraete; Jacques Allan,4,0,35,31
1746593857657,MATH 10B,B01,889797,Verstraete; Jacques Allan,3,0,35,32
1746593857657,MATH 10B,B02,889828,Verstraete; Jacques Allan,3,0,35,32
1746593858689,MATH 10C,A01,889849,Habib; Yousaf,8,0,30,22
1746593858689,MATH 10C,A02,889852,Habib; Yousaf,14,0,30,16
1746593858689,MATH 10C,A03,889853,Habib; Yousaf,22,0,30,8
1746593858689,MATH 10C,A04,889858,Habib; Yousaf,20,0,30,10
1746593858689,MATH 10C,B01,889861,Staff,1,0,30,29
1746593858689,MATH 10C,B02,889862,Staff,24,0,30,6
1746593858689,MATH 10C,B03,889863,Staff,27,0,30,3
1746593858689,MATH 10C,B04,889967,Staff,23,0,30,7
1746593859714,MATH 18,A01,889974,Staff,7,0,30,23
1746593859714,MATH 18,A02,889977,Staff,20,0,30,10
1746593859714,MATH 18,B01,889984,Hardiman; Liam,20,0,30,10
1746593859714,MATH 18,B02,889985,Hardiman; Liam,25,0,30,5
1746593860741,MATH 20A,A01,889990,Suk; Andrew Hoon,30,0,35,5
1746593861776,MATH 20B,A01,889993,Ohm; Ko Woon,21,0,30,9
1746593861776,MATH 20B,A02,889994,Ohm; Ko Woon,30,0,30,0
1746593861776,MATH 20B,B01,889996,Ohm; Ko Woon,22,0,30,8
1746593861776,MATH 20B,B02,889997,Ohm; Ko Woon,23,0,30,7
1746593862803,MATH 20C,A01,889999,Hammock; Frances H,17,0,30,13
1746593862803,MATH 20C,A02,890003,Hammock; Frances H,23,0,30,7
1746593862803,MATH 20C,B01,890006,Hammock; Frances H,3,0,30,27
1746593862803,MATH 20C,B02,890007,Hammock; Frances H,12,0,30,18
1746593863829,MATH 20D,A01,890011,Cheng; Hsiao-Bing,1,1,30,29
1746593863829,MATH 20D,A02,890012,Cheng; Hsiao-Bing,14,0,30,16
1746593863829,MATH 20D,B01,890016,Cheng; Hsiao-Bing,13,0,30,17
1746593863829,MATH 20D,B02,890017,Cheng; Hsiao-Bing,13,0,30,17
1746593864854,MATH 20E,A01,890026,Harel; Guershon,1,0,30,29
1746593864854,MATH 20E,A02,890029,Harel; Guershon,22,0,30,8
1746593864854,MATH 20E,B01,890033,Harel; Guershon,7,0,30,23
1746593864854,MATH 20E,B02,890101,Harel; Guershon,21,0,30,9
1746593865879,MATH 102,A01,890104,Staff,18,0,30,12
1746593865879,MATH 102,A02,890105,Staff,27,0,30,3
1746593866903,MATH 103B,A01,890116,Salehi Golsefidy; Alireza,3,0,30,27
1746593866903,MATH 103B,B01,890118,Staff,0,3,34,34
1746593867931,MATH 109,A01,890121,Aliabadi Sr.; Mohsen,0,0,30,30
1746593867931,MATH 109,B01,890124,Upadrashta; Pranav Kumar,18,0,30,12
1746593868960,MATH 120A,A01,890126,Eggers; John Dietrich,13,0,30,17
1746593869987,MATH 142B,A01,890128,Ioana; Adrian,19,0,30,11
1746593869987,MATH 142B,A02,890129,Ioana; Adrian,12,0,30,18
1746593871013,MATH 154,A01,890174,Staff,0,1,30,30
1746593871013,MATH 154,A02,890182,Staff,0,0,30,30
1746593872038,MATH 168A,A01,890197,Dumitriu; Ioana,21,0,35,14
1746593873065,MATH 170A,A01,890240,Nie; Jiawang,1,0,30,29
1746593873065,MATH 170A,A02,890241,Nie; Jiawang,11,0,30,19
1746593873065,MATH 170A,A03,890249,Nie; Jiawang,23,0,30,7
1746593874090,MATH 170B,A01,957891,Nag; Panchali,13,0,35,22
1746593876146,MATH 181A,A01,908025,Staff,0,3,35,35
1746593876146,MATH 181A,A02,960115,Staff,26,0,35,9
1746593877171,MATH 181B,A01,959874,Staff,24,0,30,6
1746593878196,MATH 193B,A01,890265,Staff,0,4,35,35
1746593879222,MGT 4,A01,890311,Anderson; John Charles,42,0,88,46
1746593880248,MGT 5,A00,907740,Staff,12,0,98,86
1746593881273,MGT 12,A00,890312,Lindenberger; Wade Douglas,67,0,98,31
1746593882303,MGT 16,A00,957883,Staff,78,0,98,20
1746593884352,MGT 45,A00,890314,Pecore; Joseph P.,45,0,98,53
1746593885382,MGT 71,A00,890315,Staff,0,12,98,98
1746593886407,MGT 100,A00,890316,Yavorsky; Daniel Ryan,44,0,98,54
1746593887431,MGT 103,A00,890317,Ehrich; Kristine R,73,0,98,25
1746593888499,MGT 105,A00,890356,Bates; Kenneth Walter,0,8,98,98
1746593889523,MGT 112,A00,890360,Ehrich; Kristine R,55,0,98,43
1746593890552,MGT 127R,A00,907732,Zhu; Kevin Xiaoguo,23,0,98,75
1746593891577,MGT 131B,A00,890361,Anderson; John Charles,59,0,98,39
1746593892604,MGT 137,A00,890362,Lindenberger; Wade Douglas,65,0,98,33
1746593893632,MGT 160,A00,890369,Johnson; Erik Barry,9,0,98,89
1746593895686,MGT 164,A00,890372,Zimmermann; Carsten,0,40,98,98
1746593896714,MGT 180,A00,890374,Bliss; Barbara Ann,11,0,98,87
1746593897744,MMW 15,A01,886414,Chang; Edmond Yi-Teh,0,12,28,28
1746593897744,MMW 15,A02,886415,Chang; Edmond Yi-Teh,0,8,28,28
1746593897744,MMW 15,A03,886416,Chang; Edmond Yi-Teh,0,9,28,28
1746593897744,MMW 15,A04,886417,Chang; Edmond Yi-Teh,0,8,28,28
1746593897744,MMW 15,B01,886419,Chang; Edmond Yi-Teh,0,7,28,28
1746593897744,MMW 15,B02,886420,Chang; Edmond Yi-Teh,0,7,28,28
1746593897744,MMW 15,B03,886421,Chang; Edmond Yi-Teh,0,7,28,28
1746593897744,MMW 15,B04,886422,Chang; Edmond Yi-Teh,0,8,28,28
1746593897744,MMW 15,C01,886424,Staff,0,9,28,28
1746593897744,MMW 15,C02,886425,Staff,0,8,28,28
1746593897744,MMW 15,C03,886426,Staff,0,8,28,28
1746593897744,MMW 15,C04,886427,Staff,0,8,28,28
1746593897744,MMW 15,C05,958038,Staff,0,8,28,28
1746593897744,MMW 15,C06,958039,Staff,1,8,28,27
1746593898772,MMW 15GS,A00,906910,Patterson; Patrick H.,4,0,28,24
1746593899798,MMW 122R,A01,886429,Rahimi; Babak,0,13,28,28
1746593899798,MMW 122R,A02,886430,Rahimi; Babak,0,12,28,28
1746593899798,MMW 122R,A03,958040,Rahimi; Babak,0,11,28,28
1746593900826,MUS 1A,A01,890937,Staff,2,0,25,23
1746593900826,MUS 1A,A02,891035,Staff,6,0,25,19
1746593900826,MUS 1A,C01,958912,Staff,24,0,25,1
1746593900826,MUS 1A,C02,958913,Staff,25,0,25,0
1746593902879,MUS 2AK,A00,957092,Ohnishi; Takae,15,0,15,0
1746593903904,MUS 4,A01,891044,Staff,0,0,25,25
1746593903904,MUS 4,A02,891045,Staff,22,0,25,3
1746593903904,MUS 4,B01,891048,Staff,17,0,25,8
1746593903904,MUS 4,B02,891050,Staff,25,0,25,0
1746593904934,MUS 5,A01,957506,Dubnov; Shlomo,0,0,25,25
1746593904934,MUS 5,A02,957622,Dubnov; Shlomo,13,0,25,12
1746593904934,MUS 5,A03,957623,Dubnov; Shlomo,20,0,25,5
1746593905961,MUS 6,A01,891053,Freitas Caetano; Marcelo,24,0,25,1
1746593905961,MUS 6,A02,891054,Freitas Caetano; Marcelo,23,0,25,2
1746593906986,MUS 7,A01,891081,Staff,0,0,25,25
1746593906986,MUS 7,A02,891082,Staff,3,0,25,22
1746593908012,MUS 8GS,A00,891118,Borgo; David Garcia,1,0,25,24
1746593909040,MUS 11,A01,891140,Staff,9,0,25,16
1746593909040,MUS 11,A02,891141,Staff,21,0,25,4
1746593910069,MUS 13,A01,891143,Staff,8,0,25,17
1746593910069,MUS 13,A02,891144,Staff,24,0,25,1
1746593911098,MUS 15,A01,891146,Staff,9,0,25,16
1746593911098,MUS 15,A02,891148,Staff,21,0,25,4
1746593911098,MUS 15,B01,891150,Staff,18,0,25,7
1746593911098,MUS 15,B02,891151,Staff,25,0,25,0
1746593912125,MUS 20,A01,891153,Staff,5,0,20,15
1746593912125,MUS 20,A02,891155,Staff,14,0,20,6
1746593913156,MUS 80,A00,891156,Staff,19,0,25,6
1746593913156,MUS 80,B00,891157,Staff,23,0,25,2
1746593914182,MUS 130,A00,891158,Ohnishi; Takae,35,0,35,0
1746593915208,MUS 150GS,A01,891160,Borgo; David Garcia,1,0,25,24
1746593916328,MUS 170,A01,891162,Freitas Caetano; Marcelo,20,0,25,5
1746593916328,MUS 170,A02,891164,Freitas Caetano; Marcelo,21,0,25,4
1746593917357,NANO 11,A00,886220,Vazquez Mena; Oscar,13,0,15,2
1746593918382,NANO 15,A01,886222,Drews; Aaron,4,0,7,3
1746593919409,NANO 104,A00,886224,Sirbuly; Donald,17,0,25,8
1746593920437,PH 40,A00,886528,Staff,23,0,40,17
1746593921516,PH 45,A01,886799,Staff,35,0,40,5
1746593922542,PH 110,A00,886802,Staff,0,6,40,40
1746593923570,PH 172,A00,906716,Staff,19,0,35,16
1746593924598,PH 191,A00,886803,Staff,6,0,40,34
1746593925626,PHIL 1,A00,889500,Staff,20,0,30,10
1746593926653,PHIL 10,A01,889549,Grush; Rick Scott,16,0,22,6
1746593926653,PHIL 10,A02,889551,Grush; Rick Scott,22,0,22,0
1746593927684,PHIL 28,A01,889559,Lamey; Andy M.,0,2,31,31
1746593927684,PHIL 28,A02,889561,Lamey; Andy M.,0,1,30,30
1746593927684,PHIL 28,A03,889572,Lamey; Andy M.,0,1,30,30
1746593928709,PHIL 35,A00,907839,Staff,13,0,15,2
1746593929734,PHIL 60,A00,889574,Staff,73,0,90,17
1746593930763,PHIL 101,A00,958004,Staff,12,0,15,3
1746593932813,PHIL 136,A00,889582,Fulkerson; Matthew Todd,26,0,45,19
1746593933839,PHIL 163,A01,889601,Staff,21,0,30,9
1746593933839,PHIL 163,B01,889606,Brandt; Reuven A,0,3,0,0
1746593934865,PHIL 164,A00,889610,Staff,16,0,30,14
1746593935893,PHIL 165,A00,889613,Staff,22,0,30,8
1746593936919,PHYS 1A,A00,886431,Staff,30,0,70,40
1746593937945,PHYS 1AL,001,886432,Tsai; Philbert S,1,2,30,29
1746593937945,PHYS 1AL,002,886436,Tsai; Philbert S,13,0,30,17
1746593938973,PHYS 1B,A00,886439,Staff,184,0,240,56
1746593940000,PHYS 1BL,001,886441,Tsai; Philbert S,0,4,30,30
1746593940000,PHYS 1BL,002,886444,Tsai; Philbert S,2,0,30,28
1746593941029,PHYS 1C,A00,896092,Arnold; Kam S,78,0,146,68
1746593942058,PHYS 1CL,001,886448,Tsai; Philbert S,0,0,30,30
1746593942058,PHYS 1CL,002,886449,Tsai; Philbert S,1,0,30,29
1746593942058,PHYS 1CL,003,886450,Tsai; Philbert S,16,0,30,14
1746593942058,PHYS 1CL,004,886451,Tsai; Philbert S,15,0,30,15
1746593943084,PHYS 2B,A01,886457,Staff,67,0,115,48
1746593944114,PHYS 2C,A01,886460,Shotwell; Brian,0,9,65,65
1746593945140,PHYS 2CL,A01,886467,Staff,0,4,28,28
1746593945140,PHYS 2CL,A02,886468,Staff,0,3,28,28
1746593946171,PHYS 2D,A01,886470,Staff,10,0,50,40
1746593947195,PHYS 4B,A01,886475,Grinstein; Benjamin,22,0,40,18
1746593948225,POLI 5,A00,891173,Desposato; Scott,7,0,25,18
1746593949251,POLI 5D,A01,891175,Staff,5,0,5,0
1746593949251,POLI 5D,B01,891178,Staff,5,0,5,0
1746593950280,POLI 11,A00,891179,Ferree; Karen E,1,0,35,34
1746593951310,POLI 12,A00,891180,Staff,15,0,30,15
1746593952339,POLI 27,A01,891182,Staff,12,0,75,63
1746593953365,POLI 30,A00,891183,Staff,8,0,50,42
1746593954396,POLI 100B,A00,891244,Staff,5,1,35,30
1746593955423,POLI 100I,A00,891247,Staff,7,0,30,23
1746593956450,POLI 104J,A00,891248,Nichter; Maysa,14,0,30,16
1746593957478,POLI 104U,A00,891250,Nichter; Maysa,1,0,30,29
1746593959534,POLI 110B,A00,891255,Wiens; David,19,0,25,6
1746593960566,POLI 112A,A00,891256,Wiens; David,6,0,25,19
1746593961592,POLI 114BR,A00,891261,Staff,19,0,30,11
1746593962617,POLI 117R,A00,891262,Forman; Fonna,0,6,50,50
1746593963642,POLI 118,A00,891264,Ingham; Sean,17,0,25,8
1746593964667,POLI 124A,A00,891265,Staff,18,0,20,2
1746593965696,POLI 125D,A00,891266,Nichter; Simeon C,2,0,25,23
1746593966726,POLI 126,A00,891268,Nichter; Simeon C,7,0,25,18
1746593967751,POLI 126AA,A00,891272,Staff,15,0,25,10
1746593968779,POLI 130AA,A00,891273,Staff,15,0,20,5
1746593969803,POLI 134AA,A00,891274,Staff,4,0,20,16
1746593971858,POLI 138,A00,891278,Staff,21,0,25,4
1746593972885,POLI 142K,A00,891280,Staff,10,0,25,15
1746593973916,POLI 142M,A00,891281,Gartzke; Erik,16,0,30,14
1746593974944,POLI 142P,A00,891284,Staff,20,0,30,10
1746593975972,POLI 143,A00,891285,Gartzke; Erik,12,0,30,18
1746593976999,POLI 153,A00,891286,Staff,19,0,20,1
1746593979054,POLI 175,A00,891290,Staff,15,0,20,5
1746593980079,PSYC 1,A00,890674,Steiner; Eric Tomas,0,11,45,45
1746593981107,PSYC 2,A00,890676,Albright; Thomas D,20,0,35,15
1746593982133,PSYC 3,A00,890679,Staff,17,0,20,3
1746593983160,PSYC 6,A00,959858,Staff,19,0,20,1
1746593984189,PSYC 60,A01,890684,Rickard; Timothy C.,0,6,45,45
1746593985215,PSYC 70,A01,890689,Geller; Emma Harlan,6,0,30,24
1746593986241,PSYC 71,A01,959860,Staff,21,0,25,4
1746593987267,PSYC 100,A00,890690,Lacefield; Katharine I,0,50,180,180
1746593988291,PSYC 102,A00,890695,Staff,18,0,40,22
1746593989316,PSYC 105,A00,890699,Geller; Emma Harlan,70,0,100,30
1746593990347,PSYC 106,A00,890701,Gorman; Michael R.,5,0,30,25
1746593991376,PSYC 108,A00,890704,Adrian; Julia Anna,0,29,50,50
1746593992408,PSYC 118,A01,890712,Staff,11,0,30,19
1746593993433,PSYC 124,A00,890716,Chapman; Eddie Nathaniel,25,0,60,35
1746593994460,PSYC 131,A00,890717,Anagnostaras; Stephan,0,7,80,80
1746593995485,PSYC 137,A00,890719,Winkielman; Piotr,0,11,30,30
1746593996511,PSYC 144,A00,890721,Adrian; Julia Anna,0,9,45,45
1746593997538,PSYC 162,A00,890805,Staff,0,1,75,75
1746593998567,PSYC 169,A00,890810,Staff,0,15,30,30
1746593999593,PSYC 172,A00,890814,Gorman; Michael R.,9,0,30,21
1746594000639,PSYC 181,A00,890818,Anagnostaras; Stephan,7,0,200,193
1746594001668,PSYC 184,A00,959861,Staff,163,0,175,12
1746594002694,PSYC 189,A00,890823,Staff,0,2,30,30
1746594003724,PSYC 191,A00,890884,Rickard; Timothy C.,0,12,35,35
1746594004754,PSYC 193,A00,890913,Staff,19,0,30,11
1746594004754,PSYC 193,B00,890914,Chapman; Eddie Nathaniel,24,0,30,6
1746594005786,PSYC 193L,A01,890918,Lowe; Angela Beth,20,0,30,10
1746594005786,PSYC 193L,B01,890921,Hurwitz; Ethan Scott,20,0,30,10
1746594005786,PSYC 193L,C01,890928,Staff,30,0,30,0
1746594006810,RELI 149,A00,886806,Rahimi; Babak,23,0,40,17
1746594007839,SE 9,A01,886814,Staff,7,0,20,13
1746594008864,SE 101B,A01,886816,Chadha; Mayank,3,0,35,32
1746594009894,SE 110B,A00,886818,Zhu; Qiang,4,0,75,71
1746594010920,SE 125,A01,886830,Staff,10,0,30,20
1746594011949,SE 130B,A01,886835,Staff,14,0,40,26
1746594012975,SE 131A,A01,886838,Krysl; Petr,34,0,55,21
1746594014004,SE 154,A00,886840,Staff,28,0,50,22
1746594015032,SE 164GS,A01,886849,Staff,6,0,20,14
1746594016056,SE 167GS,A01,886853,Staff,6,0,20,14
1746594017085,SIO 25,A01,890107,Staff,19,0,30,11
1746594018116,SIO 45,A00,890109,Cook; Geoffrey W,116,0,200,84
1746594019141,SIO 109R,A00,890110,Forman; Fonna,0,16,20,20
1746594020168,SIO 187,A01,890114,Kacev; David,15,0,40,25
1746594021193,SOCI 1,A01,890431,Thorpe; Charles Robert,14,0,30,16
1746594021193,SOCI 1,A02,890518,Thorpe; Charles Robert,30,0,30,0
1746594022218,SOCI 2,A01,957978,Staff,25,0,25,0
1746594022218,SOCI 2,A02,957979,Staff,23,0,25,2
1746594023244,SOCI 20,A01,890523,Calderon-Zaks; Michael Aar,21,0,30,9
1746594023244,SOCI 20,A02,890526,Calderon-Zaks; Michael Aar,29,0,30,1
1746594024269,SOCI 30,A01,890533,Pardo Guerra; Juan Pablo,37,0,40,3
1746594025297,SOCI 40,A01,890535,Staff,27,0,45,18
1746594026322,SOCI 104Q,A00,890559,Staff,18,0,30,12
1746594027385,SOCI 106,A00,890560,Arnal; Maud Marie Leonie,20,0,30,10
1746594028409,SOCI 110,A00,890567,Holkenbrink-Monk; Charlene,19,0,30,11
1746594029435,SOCI 112,A00,890568,Victoria Torres; Pablo,2,0,55,53
1746594030460,SOCI 115,A00,890597,Arnal; Maud Marie Leonie,28,0,45,17
1746594032514,SOCI 121,A00,890604,Pardo Guerra; Juan Pablo,38,0,45,7
1746594033541,SOCI 126,A01,890608,Staff,8,0,10,2
1746594034580,SOCI 127,A00,890609,Staff,18,0,30,12
1746594035610,SOCI 131,A00,890610,Thorpe; Charles Robert,37,0,45,8
1746594036634,SOCI 135,A00,890615,Payne; Christine Anna,14,0,45,31
1746594037667,SOCI 139,A00,890620,Staff,38,0,45,7
1746594038692,SOCI 148E,A00,890622,Calderon-Zaks; Michael Aar,36,0,45,9
1746594039721,SOCI 150,A00,890623,Kohler; Kristopher M.,31,0,45,14
1746594040746,SOCI 157,A00,890625,Jules-Rosette; Bennetta W.,18,0,20,2
1746594041774,SOCI 160,A00,890627,Payne; Christine Anna,21,0,45,24
1746594042803,SYN 1,A00,886855,Fish; Gwendolyn Anne,0,1,0,0
1746594042803,SYN 1,B00,906086,Fish; Gwendolyn Anne,0,2,0,2
1746594043829,SYN 2R,A00,886860,Staff,0,17,15,15
1746594043829,SYN 2R,B00,906106,Atkinson; Arthur Laird,0,16,15,15
1746594044862,SYN 100,A01,886866,Browne; Emily,0,28,20,20
1746594044862,SYN 100,B01,906128,Rock; Martin,0,4,20,20
1746594044862,SYN 100,C01,906140,Deavenport; James Cary,0,4,20,20
1746594044862,SYN 100,D01,907816,Deavenport; James Cary,0,5,20,20
1746594045891,TDAC 1,A00,890286,Walsh; Kim C.,7,0,20,13
1746594046918,TDAC 101,A00,890296,Basso; Beatrice,15,0,20,5
1746594047943,TDDE 131,A00,890297,Staff,47,0,50,3
1746594048975,TDDM 1,A00,890287,Weinberg; Sadie,25,0,30,5
1746594050002,TDGE 11,A00,890288,Fulton; Julia,138,0,200,62
1746594050002,TDGE 11,B00,890289,Castro; Robert Jess,185,0,200,15
1746594051031,TDGE 25,B00,957359,Walsh; Kim C.,5,0,20,15
1746594052060,TDGE 40,A01,890292,Power; Jade Yukana,26,0,30,4
1746594053089,TDGE 124,A00,890298,Havis; Allan,0,2,50,50
1746594054119,TDGE 131R,A00,890299,Burelle; Julie Sara Veronique,15,0,42,27
1746594055144,TDHT 101,A00,890300,Staff,10,0,20,10
1746594056175,TDHT 109,A01,890302,Anderson; Mysia Anyse,31,0,40,9
1746594057200,TDMV 1,A00,890293,Arcidiacono; Kristin,18,0,30,12
1746594058229,TDMV 2,A00,890294,Weinberg; Sadie,23,0,30,7
1746594059255,TDMV 3,A00,957878,Arcidiacono; Kristin,28,0,30,2
1746594061305,TDMV 138,A00,890304,Jun; Grace Shin Hae,25,0,40,15
1746594062332,TDMV 140,A00,890305,Corrales; Joseph Bernales,25,0,30,5
1746594063362,TDMV 142,A00,890307,Caligagan; Tony,32,0,40,8
1746594064388,TDMV 144,A00,890308,Camaya; Michelle Ann,25,0,30,5
1746594065414,TDPW 1,A00,890295,Stein; Deborah Isobel,3,0,20,17
1746594066452,USP 2,A01,890272,Lerner; Amy M,7,0,20,13
1746594067477,USP 3,A01,890274,Staff,12,0,30,18
1746594068502,USP 15,A01,890276,Sun; Feiyang,16,0,30,14
1746594069526,USP 25,A00,890277,Shenkman; Michael Thomas,18,0,25,7
1746594070555,USP 138,A00,890278,Staff,13,0,25,12
1746594071584,USP 143,A00,890279,Staff,21,0,70,49
1746594072610,USP 144,A00,890280,Chowdhury; Muhammed Zohir,16,0,30,14
1746594073638,USP 150,A00,890281,Boomhower; Matthew Charles,4,0,30,26
1746594074664,USP 151,A00,890282,Staff,16,0,20,4
1746594075692,USP 162,A00,890283,Andrews; Abigail Leslie,16,0,20,4
1746594076722,USP 168,A00,920477,Kwak; Nancy,0,0,5,5
1746594077753,USP 181,A00,890284,Staff,3,0,20,17
1746594078783,USP 191A,A00,890285,Staff,12,0,20,8
1746594079815,VIS 101,A00,886512,Staff,26,0,75,49
1746594080842,VIS 103,A00,886513,Cruz; Edwin Teddy,61,0,75,14
1746594081870,VIS 108,A00,886514,Staff,3,0,15,12
1746594082903,VIS 127P,A00,886515,Shen; Kuiyi,80,0,146,66
1746594083931,VIS 149,A00,886516,Yoldas; Pinar,0,0,15,15
1746594084961,VIS 164,A00,886526,Erdmann; Dean,19,0,22,3
1746594085988,VIS 194S,A00,886527,Staff,61,0,75,14
1746594087013,WCWP 10A,C00,886484,Martiniuk; Jill,12,0,15,3
1746594088042,WCWP 10B,A00,886490,Uriarte; Emma,0,0,15,15
1746594088042,WCWP 10B,B00,886491,Dhir; Simrita,8,0,15,7
1746594088042,WCWP 10B,C00,886492,Ornelas; Tricia,0,0,15,15
1746594089072,WCWP 100,A00,886494,Young; Mark T,0,6,15,15
1746594091165,AAS 10,A01,886199,Childs; Dennis R.,0,3,0,0
1746594092196,ANAR 104,A01,886940,Shtienberg; Gilad,27,0,30,3
1746594093228,ANAR 120,A00,886953,Staff,13,0,20,7
1746594094253,ANBI 148,A01,886955,Wilder; Linnea Lorene,30,0,40,10
1746594096305,ANSC 122,A00,886957,Staff,24,0,30,6
1746594097331,ANSC 150,A00,886958,Sloane; Julia Kathryn,2,0,15,13
1746594098360,ANSC 156,A00,886959,Jenkins; Janis A.,0,1,15,15
1746594099388,ANSC 180,A00,886960,Staff,11,0,17,6
1746594100414,ANSC 188,A00,886961,Jassal; Aftab,9,0,25,16
1746594101442,ANSC 190,A00,886962,Jassal; Aftab,14,0,25,11
1746594102469,ANSC 191,A00,886963,Staff,18,0,20,2
1746594103498,ANTH 3,A01,891689,Staff,17,0,20,3
1746594104523,ANTH 5,A00,886933,Semendeferi; Ekaterini,16,0,20,4
1746594105553,ANTH 10,A00,886934,Staff,0,12,30,30
1746594106582,ANTH 21,A01,886936,Staff,41,0,60,19
1746594107609,ANTH 23,A01,886938,Staff,92,0,100,8
1746594108638,ANTH 105,A00,886964,Stewart; Alexander B,84,0,100,16
1746594109664,ANTH 108,A00,886965,Pedersen; David,9,0,20,11
1746594110697,AWP 10,001,886147,Staff,0,0,0,0
1746594110697,AWP 10,002,886148,Staff,0,0,0,0
1746594110697,AWP 10,003,886149,Staff,0,0,0,0
1746594110697,AWP 10,004,886150,Staff,0,0,0,0
1746594110697,AWP 10,005,886151,Staff,0,0,0,0
1746594110697,AWP 10,006,886152,Staff,0,0,0,0
1746594110697,AWP 10,007,886153,Staff,0,0,0,0
1746594110697,AWP 10,008,886154,Staff,0,0,0,0
1746594110697,AWP 10,009,886155,Staff,0,0,0,0
1746594110697,AWP 10,010,886156,Staff,0,0,0,0
1746594110697,AWP 10,011,886158,Staff,0,0,0,0
1746594110697,AWP 10,012,886160,Staff,0,0,0,0
1746594110697,AWP 10,013,886161,Staff,0,0,0,0
1746594110697,AWP 10,014,886162,Staff,0,0,0,0
1746594110697,AWP 10,015,886163,Staff,0,0,0,0
1746594110697,AWP 10,016,886164,Staff,0,0,0,0
1746594110697,AWP 10,017,886165,Staff,0,0,0,0
1746594110697,AWP 10,018,886166,Staff,0,0,0,0
1746594110697,AWP 10,019,886168,Staff,0,0,0,0
1746594110697,AWP 10,020,886170,Staff,0,0,0,0
1746594110697,AWP 10,021,886172,Staff,0,0,0,0
1746594111731,AWP 10R,001,886173,Staff,0,1,0,0
1746594111731,AWP 10R,002,886174,Staff,0,1,0,0
1746594111731,AWP 10R,003,886175,Staff,0,0,0,0
1746594111731,AWP 10R,004,886176,Staff,0,0,0,0
1746594111731,AWP 10R,005,886177,Staff,0,0,0,0
1746594111731,AWP 10R,006,886178,Staff,0,0,0,0
1746594111731,AWP 10R,007,886179,Staff,0,0,0,0
1746594111731,AWP 10R,008,886181,Staff,0,0,0,0
1746594111731,AWP 10R,009,886182,Staff,0,0,0,0
1746594111731,AWP 10R,010,886183,Staff,0,0,0,0
1746594111731,AWP 10R,011,886184,Staff,0,0,0,0
1746594111731,AWP 10R,012,886185,Staff,0,0,0,0
1746594111731,AWP 10R,013,886186,Staff,0,0,0,0
1746594111731,AWP 10R,014,886187,Staff,0,0,0,0
1746594111731,AWP 10R,015,886188,Staff,0,0,0,0
1746594111731,AWP 10R,016,886189,Staff,0,0,0,0
1746594111731,AWP 10R,017,960532,Staff,0,0,0,0
1746594111731,AWP 10R,018,960533,Staff,0,0,0,0
1746594111731,AWP 10R,019,960534,Staff,0,0,0,0
1746594111731,AWP 10R,020,960538,Staff,0,0,0,0
1746594111731,AWP 10R,021,960540,Staff,0,0,0,0
1746594111731,AWP 10R,022,960541,Staff,0,0,0,0
1746594111731,AWP 10R,023,960542,Staff,0,0,0,0
1746594111731,AWP 10R,024,960544,Staff,0,0,0,0
1746594111731,AWP 10R,025,960545,Staff,0,0,0,0
1746594111731,AWP 10R,026,960548,Staff,0,0,0,0
1746594112758,AWP 102R,A00,886190,Staff,0,0,0,0
1746594112758,AWP 102R,B00,886191,Staff,0,0,0,0
1746594113784,BENG 100,A01,886193,Staff,17,0,30,13
1746594114812,BENG 122A,A01,886195,Hasty; Jeff M,13,0,30,17
1746594115838,BENG 166A,A00,886196,Sah; Robert Lie-Yuan,0,3,30,30
1746594116866,BENG 190,A00,958050,Khojah; Reem I,17,0,25,8
1746594117892,BIBC 102,A01,894320,Staff,0,0,46,46
1746594117892,BIBC 102,A02,894321,Staff,0,0,46,46
1746594117892,BIBC 102,A03,894344,Staff,6,0,46,40
1746594117892,BIBC 102,A04,894345,Staff,27,0,47,20
1746594118926,BICD 100R,A01,894365,Smith; Laurie,1,3,58,57
1746594118926,BICD 100R,A02,894366,Smith; Laurie,1,5,58,57
1746594118926,BICD 100R,A03,894367,Smith; Laurie,0,0,59,59
1746594118926,BICD 100R,A04,959869,Smith; Laurie,39,0,59,20
1746594119952,BICD 136,A01,894383,Gustafson-Brown; Cindy,14,0,50,36
1746594120979,BIEB 102,A01,894494,Butler; Shannon Rhey,51,0,130,79
1746594123034,BIEB 150,A01,894617,Wills; Christopher,3,0,20,17
1746594123034,BIEB 150,A02,894631,Wills; Christopher,3,0,20,17
1746594123034,BIEB 150,A03,894937,Wills; Christopher,3,0,20,17
1746594123034,BIEB 150,A04,894946,Wills; Christopher,5,0,20,15
1746594124062,BIEB 194,A00,906141,Kurle; Carolyn M.,5,0,20,15
1746594125093,BILD 1,A01,894154,Staff,3,0,19,16
1746594125093,BILD 1,A02,894155,Staff,14,0,19,5
1746594125093,BILD 1,A03,894160,Staff,13,0,19,6
1746594125093,BILD 1,A04,894161,Staff,15,0,18,3
1746594126119,BILD 2,A01,894168,Staff,0,0,50,50
1746594126119,BILD 2,A02,894169,Staff,0,0,50,50
1746594126119,BILD 2,A03,894179,Staff,0,0,50,50
1746594126119,BILD 2,A04,894203,Staff,23,0,50,27
1746594127145,BILD 3,A01,894213,Staff,23,0,31,8
1746594127145,BILD 3,A02,894214,Staff,26,0,31,5
1746594127145,BILD 3,A03,894235,Staff,28,0,31,3
1746594127145,BILD 3,A04,894236,Staff,28,0,32,4
1746594128173,BILD 4,A01,894253,Reuther; Keefe,5,0,24,19
1746594128173,BILD 4,A02,894258,Reuther; Keefe,16,0,24,8
1746594129205,BILD 5,A01,894276,Reuther; Keefe,34,0,50,16
1746594129205,BILD 5,A02,894277,Reuther; Keefe,45,0,50,5
1746594129205,BILD 5,A03,894290,Reuther; Keefe,44,0,50,6
1746594129205,BILD 5,A04,894291,Reuther; Keefe,48,0,50,2
1746594130232,BILD 24,A01,894297,Pirino; Giorgia,40,0,60,20
1746594131315,BIMM 100,B01,958915,Staff,71,0,100,29
1746594132347,BIMM 101,A01,895017,McDonnell; Lisa Marie,0,5,24,24
1746594132347,BIMM 101,A02,895018,McDonnell; Lisa Marie,0,5,24,24
1746594132347,BIMM 101,B01,895020,McDonnell; Lisa Marie,1,6,24,23
1746594132347,BIMM 101,B02,895021,McDonnell; Lisa Marie,0,4,24,24
1746594133377,BIMM 110,A01,895023,Staff,1,0,25,24
1746594133377,BIMM 110,A02,895024,Staff,9,0,25,16
1746594133377,BIMM 110,A03,895025,Staff,18,0,25,7
1746594133377,BIMM 110,A04,895031,Staff,20,0,25,5
1746594134403,BIMM 120,A01,895114,Gustafson-Brown; Cindy,14,0,28,14
1746594134403,BIMM 120,A02,895126,Gustafson-Brown; Cindy,21,0,27,6
1746594135430,BIPN 100,A01,895130,Yang; Mingyu,0,0,38,38
1746594135430,BIPN 100,A02,895131,Yang; Mingyu,31,0,38,7
1746594135430,BIPN 100,A03,895132,Yang; Mingyu,32,0,38,6
1746594135430,BIPN 100,A04,895133,Yang; Mingyu,27,0,36,9
1746594136461,BIPN 120,A01,895135,Cooke; James Edward,0,3,13,13
1746594136461,BIPN 120,A02,895136,Cooke; James Edward,0,1,13,13
1746594136461,BIPN 120,A03,895137,Cooke; James Edward,0,3,13,13
1746594136461,BIPN 120,A04,895156,Cooke; James Edward,0,2,11,11
1746594137493,BIPN 134,A01,895235,Cooke; James Edward,0,1,25,25
1746594137493,BIPN 134,A02,895237,Cooke; James Edward,0,0,25,25
1746594137493,BIPN 134,A03,895240,Cooke; James Edward,2,0,25,23
1746594137493,BIPN 134,A04,895270,Cooke; James Edward,20,0,25,5
1746594138519,BIPN 189,A00,892103,Staff,0,14,14,14
1746594140573,BISP 194,A00,958008,Staff,0,2,0,0
1746594141604,CAT 124,A01,922009,Staff,0,5,20,20
1746594142631,CAT 125R,A00,886390,Morales; Celeste Georgianna,0,3,20,20
1746594142631,CAT 125R,B00,886391,Irwin; Matthew Joseph,0,4,20,20
1746594142631,CAT 125R,C00,886392,Smith; Lauryn Alissa,0,2,20,20
1746594142631,CAT 125R,D00,886393,Vanderschuit; Maya Alysia,0,3,20,20
1746594142631,CAT 125R,E00,886394,Marchisotto; Jennifer Anne,0,3,20,20
1746594143660,CENG 15,A01,886218,Drews; Aaron,3,0,8,5
1746594144688,CENG 113,A00,886219,Opatkiewicz; Justin Paul,15,0,25,10
1746594145713,CGS 101,A00,887044,Staff,7,0,20,13
1746594146738,CGS 105,A01,887046,Staff,14,0,25,11
1746594147763,CGS 112,A00,887047,Cuong; Marisol,12,0,15,3
1746594148789,CGS 113,A00,887048,Staff,23,0,30,7
1746594149815,CGS 120,A00,887049,Staff,10,0,17,7
1746594150842,CHEM 6A,A01,886336,Lam; Tin Yiu,38,0,50,12
1746594150842,CHEM 6A,A02,886338,Lam; Tin Yiu,37,0,50,13
1746594151871,CHEM 6B,A01,886341,Hopkins; Patrycja Anna,16,0,50,34
1746594151871,CHEM 6B,A02,886343,Hopkins; Patrycja Anna,42,0,50,8
1746594152900,CHEM 6C,A01,886346,Albizati; Kim F.,0,2,50,50
1746594152900,CHEM 6C,A02,886348,Albizati; Kim F.,24,0,50,26
1746594153926,CHEM 40A,A01,886352,Klosterman; Jeremy K,65,0,100,35
1746594154951,CHEM 40B,A01,886356,Klosterman; Jeremy K,0,24,100,100
1746594155980,CHEM 41B,A01,886360,Theodorakis; Emmanuel,25,0,50,25
1746594155980,CHEM 41B,A02,886362,Theodorakis; Emmanuel,47,0,50,3
1746594157010,CHIN 165A,A00,886382,Xu; Li,18,0,20,2
1746594158039,CLAS 120,A00,886387,Myerston Santana; Jacobo,33,0,40,7
1746594159065,COGS 9,A01,886967,Shannon; Kyle Michael,42,0,60,18
1746594160096,COGS 11,A01,886969,Staff,9,0,30,21
1746594161123,COGS 14A,A01,886971,Staff,5,0,60,55
1746594162149,COGS 14B,A01,886973,Hoffman; Drew Ellen,4,0,60,56
1746594163176,COGS 18,A01,886975,Morgan; Eric,34,0,60,26
1746594164203,COGS 20,A01,886977,Staff,3,0,8,5
1746594164203,COGS 20,A02,886978,Staff,5,0,7,2
1746594165233,COGS 100,A01,907783,Staff,1,2,30,29
1746594166262,COGS 101B,A01,886980,Staff,0,4,48,48
1746594167290,COGS 101C,A01,886982,Delgado; Tania,0,5,44,44
1746594168317,COGS 102A,A01,886984,Johnson; Christine M.,3,0,30,27
1746594169342,COGS 118B,A01,886986,Staff,1,5,88,87
1746594170369,COGS 150,A01,886988,Bergen; Benjamin,22,0,50,28
1746594171398,COGS 153,A00,886989,Delgado; Tania,0,3,41,41
1746594172426,COGS 186,A01,886991,Staff,0,0,32,32
1746594173456,COGS 187A,A01,886993,Boyle; Mary E. T.,7,0,30,23
1746594174484,COGS 189,A00,886994,Staff,0,1,30,30
1746594175513,COMM 10,A01,886996,Staff,0,0,20,21
1746594175513,COMM 10,A02,886997,Staff,10,0,20,10
1746594175513,COMM 10,A03,959845,Staff,19,0,20,1
1746594176541,COMM 20,A01,886999,Leuning; Grant Maurstad,24,0,40,16
1746594178589,COMM 100A,A01,887002,Staff,0,0,20,25
1746594178589,COMM 100A,A02,887003,Staff,5,0,20,15
1746594179618,COMM 100B,A01,887005,Staff,0,8,20,24
1746594180644,COMM 106D,A00,887006,Staff,13,0,40,27
1746594181671,COMM 110G,A00,887007,Whitworth-Smith; Andrew C,12,0,40,28
1746594182700,COMM 111B,A00,887008,Staff,31,0,40,9
1746594183727,COMM 113T,A00,887009,Abuelhiga; Soraya Jill,28,0,40,12
1746594183727,COMM 113T,B00,906733,Staff,39,0,40,1
1746594184756,COMM 145,A00,887010,Staff,12,0,40,28
1746594185784,COMM 146,A00,887054,Staff,31,0,40,9
1746594186808,COMM 190,A00,887012,Staff,8,0,23,15
1746594187833,CSE 8A,A50,887015,Cao; Yingjun,56,0,85,29
1746594188858,CSE 11,A01,887017,Cao; Yingjun,11,0,70,59
1746594189885,CSE 20,A01,887019,Staff,30,0,50,20
1746594190914,CSE 21,A01,887021,Staff,79,0,100,21
1746594190914,CSE 21,B01,892583,Braun; Oliver,45,0,50,5
1746594191939,CSE 30,A01,887025,Eldon; John,142,0,200,58
1746594192967,CSE 100,A01,887027,Staff,26,0,50,24
1746594192967,CSE 100,A02,887028,Staff,42,0,50,8
1746594193997,CSE 101,A01,887030,Braun; Oliver,74,0,100,26
1746594193997,CSE 101,B01,887032,Jones; Miles E,0,3,50,50
1746594193997,CSE 101,B02,887033,Jones; Miles E,0,2,50,50
1746594195025,CSE 105,A01,908084,Jones; Miles E,32,0,50,18
1746594195025,CSE 105,A02,908087,Jones; Miles E,31,0,50,19
1746594196051,CSE 135,A01,887035,Powell; Thomas Allan,0,5,50,50
1746594197075,CSE 142,A01,887037,Staff,8,0,60,52
1746594198101,CSE 142L,A01,887039,Staff,34,0,60,26
1746594199126,CSE 151A,A01,887041,Solares; Edwin A,47,0,100,53
1746594200152,CSE 175,A01,887043,Kumar; Rakesh,30,0,30,0
1746594201179,CSS 1,A01,886389,Staff,1,2,40,39
1746594202203,DSC 30,A01,908097,Liao; Soohyun Nam,47,0,75,28
1746594203230,DSC 40A,A01,908099,Shannon; Kyle Michael,30,0,50,20
1746594204260,DSC 40B,A01,908112,Staff,15,0,50,35
1746594205289,DSC 80,A01,908116,Staff,19,0,60,41
1746594206316,DSC 197,001,956863,Eldridge; Justin Matthew,9999,0,9999,0
1746594207346,ECE 5,A01,886400,Morris; Karcher William,1,0,6,5
1746594207346,ECE 5,A02,886401,Morris; Karcher William,3,0,6,3
1746594208370,ECE 148,A01,886403,Silberman; Jack,0,14,14,14
1746594209397,ECON 1,A01,887265,Crane; Meredith Helen,11,0,70,59
1746594209397,ECON 1,B01,887268,Staff,42,0,50,8
1746594210426,ECON 2,A01,887273,Crane; Meredith Helen,54,0,70,16
1746594211454,ECON 3,A01,887279,Rondina; Giacomo,31,0,70,39
1746594212482,ECON 4,A01,887282,Anderson; John Charles,0,2,10,10
1746594213513,ECON 5,A01,887285,Staff,34,0,45,11
1746594213513,ECON 5,B01,887292,Staff,41,0,45,4
1746594214539,ECON 100A,A01,887337,Newhouse; Herbert S,54,0,70,16
1746594214539,ECON 100A,B01,887349,Staff,45,0,50,5
1746594215568,ECON 100B,A01,887361,Du; Songzi,29,0,70,41
1746594216598,ECON 100C,A01,887445,Newhouse; Herbert S,59,0,70,11
1746594217625,ECON 105,A00,887488,Vespa; Emanuel Ignacio,23,0,35,12
1746594218679,ECON 109,A01,887506,Shishkin; Denis,28,0,35,7
1746594219710,ECON 110A,A01,887568,Alon; Titan Michael,1,3,35,34
1746594219710,ECON 110A,B01,907601,Alon; Titan Michael,20,0,35,15
1746594220736,ECON 110B,A01,887598,Levkoff; Steven B.,0,24,70,70
1746594221761,ECON 112,A00,887599,Rondina; Giacomo,19,0,35,16
1746594222790,ECON 120A,A01,887603,Dai; Yinlin,35,0,70,35
1746594223816,ECON 120C,A01,887608,Sun; Yixiao,0,1,35,35
1746594223816,ECON 120C,B01,887614,Sun; Yixiao,0,0,35,35
1746594224839,ECON 138,A00,887621,Bharadwaj; Prashant,0,21,20,20
1746594225866,ECON 144,A00,958007,Squires; Dale E,12,0,35,23
1746594226895,ECON 171,A01,907666,Staff,18,0,35,17
1746594227924,ECON 175,A00,887626,Wu; Pak Yeung,22,0,35,13
1746594228950,ECON 190,A00,887640,Vespa; Emanuel Ignacio,22,0,35,13
1746594229986,EDS 25,A01,888197,Staff,0,0,0,0
1746594229986,EDS 25,A02,888209,Staff,0,0,0,0
1746594229986,EDS 25,A03,888210,Staff,0,0,0,0
1746594229986,EDS 25,A04,888212,Staff,0,0,0,0
1746594229986,EDS 25,A05,888213,Staff,0,0,0,0
1746594229986,EDS 25,A06,888214,Staff,0,0,0,0
1746594229986,EDS 25,A07,888235,Staff,0,2,0,0
1746594229986,EDS 25,A08,888236,Staff,0,0,0,0
1746594229986,EDS 25,A09,888240,Staff,0,0,0,0
1746594229986,EDS 25,A10,888244,Staff,0,0,0,0
1746594229986,EDS 25,B01,888273,Staff,0,0,0,0
1746594229986,EDS 25,B02,888285,Staff,0,0,0,0
1746594229986,EDS 25,B03,888423,Staff,0,0,0,1
1746594229986,EDS 25,B04,888432,Staff,0,0,0,0
1746594229986,EDS 25,B05,888433,Staff,0,0,0,0
1746594229986,EDS 25,B06,888467,Staff,0,0,0,0
1746594229986,EDS 25,B07,888468,Staff,0,0,0,0
1746594229986,EDS 25,B08,888479,Staff,0,0,0,0
1746594229986,EDS 25,B09,888484,Staff,0,0,0,0
1746594229986,EDS 25,B10,888487,Staff,0,0,0,0
1746594231014,EDS 38,A01,907700,Choi; Bailey Miyeon,30,0,30,0
1746594232038,EDS 112,A01,888601,Chapman; Thandeka K,12,0,40,28
1746594233063,EDS 115,A00,888697,Mendez; Kathrina Mendoza,10,0,30,20
1746594234092,EDS 116,A01,888893,Staff,33,0,40,7
1746594236146,EDS 124AR,A00,889133,Staff,29,0,50,21
1746594236146,EDS 124AR,B00,907471,Simon; Elizabeth A,37,0,50,13
1746594237170,EDS 124BR,A00,889134,Simon; Elizabeth A,44,0,100,56
1746594238195,EDS 125,A00,889135,Staff,25,0,30,5
1746594239223,EDS 126,A01,889138,Staff,35,0,40,5
1746594240248,EDS 164R,A01,889142,Wishard Guerra; Alison G.,32,0,50,18
1746594241274,ENG 30,A01,886396,Staff,0,0,0,0
1746594241274,ENG 30,B01,886398,Staff,0,0,0,0
1746594242299,ENVR 102,A00,906150,Montejo; Carolina,23,0,25,2
1746594243324,ETHN 103A,A00,887236,Man; Simeon S,0,2,0,0
1746594244351,ETHN 113,A00,887239,Staff,16,0,30,14
1746594245380,ETHN 116,A00,887240,Staff,16,0,25,9
1746594246406,ETHN 117,A00,887241,Choi; Esther Min,28,0,30,2
1746594247432,ETHN 118,A00,887243,Staff,24,0,30,6
1746594248461,ETHN 127,A00,887248,Cuong; Marisol,11,0,15,4
1746594249485,ETHN 139,A00,887250,Staff,7,0,10,3
1746594250511,ETHN 142,A00,887252,Staff,10,0,30,20
1746594251536,ETHN 161,A00,887253,Browne; Errol Tsekani,24,0,30,6
1746594252563,ETHN 163FR,A00,887255,Burelle; Julie Sara Veronique,0,0,5,5
1746594253594,GLBH 20,A00,889149,Elwardani; Nile Regina,8,0,42,34
1746594255654,GLBH 111,A01,889152,Burgos; Jose L.,17,0,17,0
1746594256680,GLBH 150,A00,889181,Sloane; Julia Kathryn,0,5,15,15
1746594258734,HDS 60,A01,886406,Warstadt; Melissa Fawn,72,0,80,8
1746594259759,HIAF 111,A00,889324,Gyamfi; Bright,25,0,32,7
1746594260787,HIEA 131,A00,889328,Staff,15,0,32,17
1746594261812,HIEA 144,A00,889333,Henry; Todd A.,26,0,32,6
1746594262838,HIEA 154,A00,889336,Henry; Todd A.,24,0,32,8
1746594263866,HIEU 106,A00,889339,Staff,22,0,32,10
1746594265920,HIEU 114,A00,889340,Staff,4,0,32,28
1746594266948,HIEU 135GS,A00,889342,Patterson; Patrick H.,0,0,1,24
1746594267978,HIEU 137,A00,889343,Edington; Claire Ellen,10,0,25,15
1746594269005,HIEU 148,A00,889345,Staff,14,0,32,18
1746594270032,HIEU 154,A00,889346,Biess; Frank Peter,21,0,32,11
1746594271062,HILA 102,A00,889351,Staff,12,0,32,20
1746594272087,HILD 2A,A01,889221,Lewandoski; Julia Mavis,2,10,32,30
1746594273116,HILD 7B,A01,889225,Man; Simeon S,0,12,32,32
1746594274146,HILD 7C,A01,889288,Alvarez; Luis A,0,14,32,32
1746594275176,HILD 30,A01,889323,Staff,0,5,32,32
1746594277226,HISC 119,A00,889383,Golan; Tal,20,0,32,12
1746594278253,HIUS 103,A00,889384,Man; Simeon S,0,0,32,32
1746594279278,HIUS 117,A00,919797,Kwak; Nancy,18,0,32,14
1746594280306,HIUS 142A,A00,919788,Staff,22,0,32,10
1746594282365,HIUS 149,A00,889386,Gyamfi; Bright,26,0,32,6
1746594283393,HIUS 155,A00,889387,Alvarez; Luis A,15,0,32,17
1746594284421,HUM 3,A01,886499,Caldwell; Michael Alan,19,0,50,31
1746594285451,HUM 3GS,A00,886500,Rodriguez; Bretton Sigfred,0,0,0,28
1746594286479,HUM 3R,A01,886502,Markman; Kristina,0,36,50,50
1746594287506,HUM 4,A01,886504,Crum; Matthew Stephen,23,0,50,27
1746594287506,HUM 4,B01,886506,West; Geoffrey Scott,17,0,50,33
1746594288534,HUM 4GS,A00,886507,Staff,0,0,0,19
1746594289563,HUM 5,A01,886509,Staff,31,0,50,19
1746594290591,HUM 5R,A01,886511,Zavodny; Tatiana Sophia,0,39,50,50
1746594291616,JAPN 180,A00,886407,Staff,16,0,40,24
1746594292642,LATI 50,A01,886409,Martin-Cabrera; Luis,3,0,22,19
1746594292642,LATI 50,A02,886410,Martin-Cabrera; Luis,19,0,22,3
1746594292642,LATI 50,A03,886411,Martin-Cabrera; Luis,21,0,22,1
1746594292642,LATI 50,A04,886412,Martin-Cabrera; Luis,8,0,22,14
1746594293668,LAWS 101,A00,907664,Staff,28,0,60,32
1746594294694,LIAB 1A,A00,889388,Saab; Dima,17,0,20,3
1746594295721,LIAB 1AX,A00,889389,El Cheddadi; Youniss,18,0,20,2
1746594296747,LIFR 1C,A00,889391,Van Moer; Vinciane G,8,0,20,12
1746594297776,LIFR 1CX,A00,889392,Van Moer; Vinciane G,7,0,20,13
1746594298805,LIFR 1D,A00,889393,Van Moer; Vinciane G,7,0,20,13
1746594299833,LIFR 1DX,A00,889394,Van Moer; Vinciane G,8,0,20,12
1746594300860,LIGN 7,A00,886923,Staff,25,0,50,25
1746594301887,LIGN 17,A00,886924,Kehler; Andrew Scott,126,0,150,24
1746594302923,LTAM 110,A00,889395,Staff,15,0,30,15
1746594303963,LTAM 110GS,A00,958010,Rodriguez; Bretton Sigfred,0,0,0,28
1746594304993,LTCH 101,A00,889397,Staff,23,0,25,2
1746594306021,LTCS 130,A00,889398,Staff,23,0,25,2
1746594307045,LTEA 138,A00,889399,Staff,24,0,40,16
1746594308074,LTEN 149,A00,889400,Wesling; Megan E.,0,3,25,25
1746594309100,LTEN 169,A00,889401,Staff,20,0,25,5
1746594310126,LTEN 180,A00,889402,Staff,10,0,15,5
1746594311154,LTEN 181,A00,889403,Staff,21,0,25,4
1746594312180,LTWL 100,A00,889404,Myerston Santana; Jacobo,2,0,25,23
1746594313208,LTWL 180GS,A00,889405,Staff,0,0,20,20
1746594314236,LTWL 181,A00,889406,Staff,16,0,25,9
1746594315264,LTWL 184,A00,889475,Mukherjee; Silpa,22,0,25,3
1746594316292,LTWR 102C,A00,889486,Staff,29,0,30,1
1746594317318,LTWR 115W,A00,889491,Staff,0,2,15,15
1746594318347,MAE 8,A01,886905,Staff,0,2,0,0
1746594319373,MAE 11,A00,886906,Bandaru; Prabhakar,0,7,50,50
1746594320402,MAE 20,A00,886907,Evdokimenko; Ekaterina,43,0,70,27
1746594321431,MAE 30B,A00,886909,Ghazinejad; Maziar,25,0,45,20
1746594322459,MAE 101B,A00,886910,Saintillan; David,30,0,45,15
1746594323486,MAE 105,A00,886911,Bandaru; Prabhakar,18,0,50,32
1746594324517,MAE 107,B00,958024,Staff,7,0,50,43
1746594325546,MAE 143B,A00,886913,Bewley; Thomas R,2,0,40,38
1746594326573,MAE 148,A01,886915,Silberman; Jack,0,3,14,14
1746594327599,MAE 160,A00,886916,Evdokimenko; Ekaterina,31,0,60,29
1746594328625,MATH 3C,A01,889681,Staff,0,2,30,30
1746594328625,MATH 3C,A02,960048,Staff,23,0,30,7
1746594329652,MATH 10A,A01,889760,Staff,26,0,30,4
1746594329652,MATH 10A,A02,889783,Staff,29,0,30,1
1746594330679,MATH 10B,A01,889785,Verstraete; Jacques Allan,1,0,35,34
1746594330679,MATH 10B,A02,889795,Verstraete; Jacques Allan,4,0,35,31
1746594330679,MATH 10B,B01,889797,Verstraete; Jacques Allan,3,0,35,32
1746594330679,MATH 10B,B02,889828,Verstraete; Jacques Allan,3,0,35,32
1746594331709,MATH 10C,A01,889849,Habib; Yousaf,8,0,30,22
1746594331709,MATH 10C,A02,889852,Habib; Yousaf,14,0,30,16
1746594331709,MATH 10C,A03,889853,Habib; Yousaf,22,0,30,8
1746594331709,MATH 10C,A04,889858,Habib; Yousaf,20,0,30,10
1746594331709,MATH 10C,B01,889861,Staff,1,0,30,29
1746594331709,MATH 10C,B02,889862,Staff,24,0,30,6
1746594331709,MATH 10C,B03,889863,Staff,27,0,30,3
1746594331709,MATH 10C,B04,889967,Staff,23,0,30,7
1746594332757,MATH 18,A01,889974,Staff,7,0,30,23
1746594332757,MATH 18,A02,889977,Staff,20,0,30,10
1746594332757,MATH 18,B01,889984,Hardiman; Liam,20,0,30,10
1746594332757,MATH 18,B02,889985,Hardiman; Liam,25,0,30,5
1746594333783,MATH 20A,A01,889990,Suk; Andrew Hoon,30,0,35,5
1746594334808,MATH 20B,A01,889993,Ohm; Ko Woon,21,0,30,9
1746594334808,MATH 20B,A02,889994,Ohm; Ko Woon,30,0,30,0
1746594334808,MATH 20B,B01,889996,Ohm; Ko Woon,22,0,30,8
1746594334808,MATH 20B,B02,889997,Ohm; Ko Woon,23,0,30,7
1746594335834,MATH 20C,A01,889999,Hammock; Frances H,17,0,30,13
1746594335834,MATH 20C,A02,890003,Hammock; Frances H,23,0,30,7
1746594335834,MATH 20C,B01,890006,Hammock; Frances H,3,0,30,27
1746594335834,MATH 20C,B02,890007,Hammock; Frances H,12,0,30,18
1746594336864,MATH 20D,A01,890011,Cheng; Hsiao-Bing,1,1,30,29
1746594336864,MATH 20D,A02,890012,Cheng; Hsiao-Bing,14,0,30,16
1746594336864,MATH 20D,B01,890016,Cheng; Hsiao-Bing,13,0,30,17
1746594336864,MATH 20D,B02,890017,Cheng; Hsiao-Bing,13,0,30,17
1746594337895,MATH 20E,A01,890026,Harel; Guershon,1,0,30,29
1746594337895,MATH 20E,A02,890029,Harel; Guershon,22,0,30,8
1746594337895,MATH 20E,B01,890033,Harel; Guershon,7,0,30,23
1746594337895,MATH 20E,B02,890101,Harel; Guershon,21,0,30,9
1746594338921,MATH 102,A01,890104,Staff,18,0,30,12
1746594338921,MATH 102,A02,890105,Staff,27,0,30,3
1746594339946,MATH 103B,A01,890116,Salehi Golsefidy; Alireza,3,0,30,27
1746594339946,MATH 103B,B01,890118,Staff,0,3,34,34
1746594340977,MATH 109,A01,890121,Aliabadi Sr.; Mohsen,0,0,30,30
1746594340977,MATH 109,B01,890124,Upadrashta; Pranav Kumar,18,0,30,12
1746594342009,MATH 120A,A01,890126,Eggers; John Dietrich,13,0,30,17
1746594343033,MATH 142B,A01,890128,Ioana; Adrian,19,0,30,11
1746594343033,MATH 142B,A02,890129,Ioana; Adrian,12,0,30,18
1746594344060,MATH 154,A01,890174,Staff,0,1,30,30
1746594344060,MATH 154,A02,890182,Staff,0,0,30,30
1746594345086,MATH 168A,A01,890197,Dumitriu; Ioana,21,0,35,14
1746594346111,MATH 170A,A01,890240,Nie; Jiawang,1,0,30,29
1746594346111,MATH 170A,A02,890241,Nie; Jiawang,11,0,30,19
1746594346111,MATH 170A,A03,890249,Nie; Jiawang,23,0,30,7
1746594347140,MATH 170B,A01,957891,Nag; Panchali,13,0,35,22
1746594349193,MATH 181A,A01,908025,Staff,0,3,35,35
1746594349193,MATH 181A,A02,960115,Staff,26,0,35,9
1746594350222,MATH 181B,A01,959874,Staff,24,0,30,6
1746594351246,MATH 193B,A01,890265,Staff,0,4,35,35
1746594352271,MGT 4,A01,890311,Anderson; John Charles,42,0,88,46
1746594353297,MGT 5,A00,907740,Staff,12,0,98,86
1746594354325,MGT 12,A00,890312,Lindenberger; Wade Douglas,67,0,98,31
1746594355351,MGT 16,A00,957883,Staff,78,0,98,20
1746594357403,MGT 45,A00,890314,Pecore; Joseph P.,45,0,98,53
1746594358429,MGT 71,A00,890315,Staff,0,12,98,98
1746594359457,MGT 100,A00,890316,Yavorsky; Daniel Ryan,44,0,98,54
1746594360486,MGT 103,A00,890317,Ehrich; Kristine R,73,0,98,25
1746594361517,MGT 105,A00,890356,Bates; Kenneth Walter,0,8,98,98
1746594362545,MGT 112,A00,890360,Ehrich; Kristine R,55,0,98,43
1746594363573,MGT 127R,A00,907732,Zhu; Kevin Xiaoguo,23,0,98,75
1746594364597,MGT 131B,A00,890361,Anderson; John Charles,59,0,98,39
1746594365625,MGT 137,A00,890362,Lindenberger; Wade Douglas,65,0,98,33
1746594366657,MGT 160,A00,890369,Johnson; Erik Barry,9,0,98,89
1746594368709,MGT 164,A00,890372,Zimmermann; Carsten,0,40,98,98
1746594369739,MGT 180,A00,890374,Bliss; Barbara Ann,11,0,98,87
1746594370768,MMW 15,A01,886414,Chang; Edmond Yi-Teh,0,12,28,28
1746594370768,MMW 15,A02,886415,Chang; Edmond Yi-Teh,0,8,28,28
1746594370768,MMW 15,A03,886416,Chang; Edmond Yi-Teh,0,9,28,28
1746594370768,MMW 15,A04,886417,Chang; Edmond Yi-Teh,0,8,28,28
1746594370768,MMW 15,B01,886419,Chang; Edmond Yi-Teh,0,7,28,28
1746594370768,MMW 15,B02,886420,Chang; Edmond Yi-Teh,0,7,28,28
1746594370768,MMW 15,B03,886421,Chang; Edmond Yi-Teh,0,7,28,28
1746594370768,MMW 15,B04,886422,Chang; Edmond Yi-Teh,0,8,28,28
1746594370768,MMW 15,C01,886424,Staff,0,9,28,28
1746594370768,MMW 15,C02,886425,Staff,0,8,28,28
1746594370768,MMW 15,C03,886426,Staff,0,8,28,28
1746594370768,MMW 15,C04,886427,Staff,0,8,28,28
1746594370768,MMW 15,C05,958038,Staff,0,8,28,28
1746594370768,MMW 15,C06,958039,Staff,1,8,28,27
1746594371792,MMW 15GS,A00,906910,Patterson; Patrick H.,4,0,28,24
1746594372819,MMW 122R,A01,886429,Rahimi; Babak,0,13,28,28
1746594372819,MMW 122R,A02,886430,Rahimi; Babak,0,12,28,28
1746594372819,MMW 122R,A03,958040,Rahimi; Babak,0,11,28,28
1746594373849,MUS 1A,A01,890937,Staff,2,0,25,23
1746594373849,MUS 1A,A02,891035,Staff,6,0,25,19
1746594373849,MUS 1A,C01,958912,Staff,24,0,25,1
1746594373849,MUS 1A,C02,958913,Staff,25,0,25,0
1746594375902,MUS 2AK,A00,957092,Ohnishi; Takae,15,0,15,0
1746594376936,MUS 4,A01,891044,Staff,0,0,25,25
1746594376936,MUS 4,A02,891045,Staff,22,0,25,3
1746594376936,MUS 4,B01,891048,Staff,17,0,25,8
1746594376936,MUS 4,B02,891050,Staff,25,0,25,0
1746594377963,MUS 5,A01,957506,Dubnov; Shlomo,0,0,25,25
1746594377963,MUS 5,A02,957622,Dubnov; Shlomo,13,0,25,12
1746594377963,MUS 5,A03,957623,Dubnov; Shlomo,20,0,25,5
1746594378990,MUS 6,A01,891053,Freitas Caetano; Marcelo,24,0,25,1
1746594378990,MUS 6,A02,891054,Freitas Caetano; Marcelo,23,0,25,2
1746594380021,MUS 7,A01,891081,Staff,0,0,25,25
1746594380021,MUS 7,A02,891082,Staff,3,0,25,22
1746594381047,MUS 8GS,A00,891118,Borgo; David Garcia,1,0,25,24
1746594382073,MUS 11,A01,891140,Staff,9,0,25,16
1746594382073,MUS 11,A02,891141,Staff,21,0,25,4
1746594383101,MUS 13,A01,891143,Staff,8,0,25,17
1746594383101,MUS 13,A02,891144,Staff,24,0,25,1
1746594384126,MUS 15,A01,891146,Staff,9,0,25,16
1746594384126,MUS 15,A02,891148,Staff,21,0,25,4
1746594384126,MUS 15,B01,891150,Staff,18,0,25,7
1746594384126,MUS 15,B02,891151,Staff,25,0,25,0
1746594385154,MUS 20,A01,891153,Staff,5,0,20,15
1746594385154,MUS 20,A02,891155,Staff,14,0,20,6
1746594386179,MUS 80,A00,891156,Staff,19,0,25,6
1746594386179,MUS 80,B00,891157,Staff,23,0,25,2
1746594387208,MUS 130,A00,891158,Ohnishi; Takae,35,0,35,0
1746594388234,MUS 150GS,A01,891160,Borgo; David Garcia,1,0,25,24
1746594389279,MUS 170,A01,891162,Freitas Caetano; Marcelo,20,0,25,5
1746594389279,MUS 170,A02,891164,Freitas Caetano; Marcelo,21,0,25,4
1746594390307,NANO 11,A00,886220,Vazquez Mena; Oscar,13,0,15,2
1746594391334,NANO 15,A01,886222,Drews; Aaron,4,0,7,3
1746594392362,NANO 104,A00,886224,Sirbuly; Donald,17,0,25,8
1746594393386,PH 40,A00,886528,Staff,23,0,40,17
1746594394410,PH 45,A01,886799,Staff,35,0,40,5
1746594395436,PH 110,A00,886802,Staff,0,6,40,40
1746594396461,PH 172,A00,906716,Staff,19,0,35,16
1746594397489,PH 191,A00,886803,Staff,6,0,40,34
1746594398517,PHIL 1,A00,889500,Staff,20,0,30,10
1746594399547,PHIL 10,A01,889549,Grush; Rick Scott,16,0,22,6
1746594399547,PHIL 10,A02,889551,Grush; Rick Scott,22,0,22,0
1746594400572,PHIL 28,A01,889559,Lamey; Andy M.,0,2,31,31
1746594400572,PHIL 28,A02,889561,Lamey; Andy M.,0,1,30,30
1746594400572,PHIL 28,A03,889572,Lamey; Andy M.,0,1,30,30
1746594401598,PHIL 35,A00,907839,Staff,13,0,15,2
1746594402623,PHIL 60,A00,889574,Staff,73,0,90,17
1746594403652,PHIL 101,A00,958004,Staff,12,0,15,3
1746594405704,PHIL 136,A00,889582,Fulkerson; Matthew Todd,26,0,45,19
1746594406731,PHIL 163,A01,889601,Staff,21,0,30,9
1746594406731,PHIL 163,B01,889606,Brandt; Reuven A,0,3,0,0
1746594407757,PHIL 164,A00,889610,Staff,16,0,30,14
1746594408781,PHIL 165,A00,889613,Staff,22,0,30,8
1746594409810,PHYS 1A,A00,886431,Staff,30,0,70,40
1746594410841,PHYS 1AL,001,886432,Tsai; Philbert S,1,2,30,29
1746594410841,PHYS 1AL,002,886436,Tsai; Philbert S,13,0,30,17
1746594411865,PHYS 1B,A00,886439,Staff,184,0,240,56
1746594412894,PHYS 1BL,001,886441,Tsai; Philbert S,0,4,30,30
1746594412894,PHYS 1BL,002,886444,Tsai; Philbert S,2,0,30,28
1746594413940,PHYS 1C,A00,896092,Arnold; Kam S,78,0,146,68
1746594414966,PHYS 1CL,001,886448,Tsai; Philbert S,0,0,30,30
1746594414966,PHYS 1CL,002,886449,Tsai; Philbert S,1,0,30,29
1746594414966,PHYS 1CL,003,886450,Tsai; Philbert S,16,0,30,14
1746594414966,PHYS 1CL,004,886451,Tsai; Philbert S,15,0,30,15
1746594415992,PHYS 2B,A01,886457,Staff,67,0,115,48
1746594417019,PHYS 2C,A01,886460,Shotwell; Brian,0,9,65,65
1746594418044,PHYS 2CL,A01,886467,Staff,0,4,28,28
1746594418044,PHYS 2CL,A02,886468,Staff,0,3,28,28
1746594419072,PHYS 2D,A01,886470,Staff,10,0,50,40
1746594420100,PHYS 4B,A01,886475,Grinstein; Benjamin,22,0,40,18
1746594421126,POLI 5,A00,891173,Desposato; Scott,7,0,25,18
1746594422149,POLI 5D,A01,891175,Staff,5,0,5,0
1746594422149,POLI 5D,B01,891178,Staff,5,0,5,0
1746594423177,POLI 11,A00,891179,Ferree; Karen E,1,0,35,34
1746594424204,POLI 12,A00,891180,Staff,15,0,30,15
1746594425231,POLI 27,A01,891182,Staff,12,0,75,63
1746594426286,POLI 30,A00,891183,Staff,8,0,50,42
1746594427311,POLI 100B,A00,891244,Staff,5,1,35,30
1746594428336,POLI 100I,A00,891247,Staff,7,0,30,23
1746594429363,POLI 104J,A00,891248,Nichter; Maysa,14,0,30,16
1746594430388,POLI 104U,A00,891250,Nichter; Maysa,1,0,30,29
1746594432440,POLI 110B,A00,891255,Wiens; David,19,0,25,6
1746594433465,POLI 112A,A00,891256,Wiens; David,6,0,25,19
1746594434490,POLI 114BR,A00,891261,Staff,19,0,30,11
1746594435515,POLI 117R,A00,891262,Forman; Fonna,0,6,50,50
1746594436543,POLI 118,A00,891264,Ingham; Sean,17,0,25,8
1746594437570,POLI 124A,A00,891265,Staff,18,0,20,2
1746594438594,POLI 125D,A00,891266,Nichter; Simeon C,2,0,25,23
1746594439619,POLI 126,A00,891268,Nichter; Simeon C,7,0,25,18
1746594440643,POLI 126AA,A00,891272,Staff,15,0,25,10
1746594441672,POLI 130AA,A00,891273,Staff,15,0,20,5
1746594442698,POLI 134AA,A00,891274,Staff,4,0,20,16
1746594444751,POLI 138,A00,891278,Staff,21,0,25,4
1746594445777,POLI 142K,A00,891280,Staff,10,0,25,15
1746594446803,POLI 142M,A00,891281,Gartzke; Erik,16,0,30,14
1746594447829,POLI 142P,A00,891284,Staff,20,0,30,10
1746594448854,POLI 143,A00,891285,Gartzke; Erik,12,0,30,18
1746594449879,POLI 153,A00,891286,Staff,19,0,20,1
1746594451933,POLI 175,A00,891290,Staff,15,0,20,5
1746594452959,PSYC 1,A00,890674,Steiner; Eric Tomas,0,11,45,45
1746594453983,PSYC 2,A00,890676,Albright; Thomas D,20,0,35,15
1746594455014,PSYC 3,A00,890679,Staff,17,0,20,3
1746594456043,PSYC 6,A00,959858,Staff,19,0,20,1
1746594457164,PSYC 60,A01,890684,Rickard; Timothy C.,0,6,45,45
1746594458191,PSYC 70,A01,890689,Geller; Emma Harlan,6,0,30,24
1746594459220,PSYC 71,A01,959860,Staff,21,0,25,4
1746594460248,PSYC 100,A00,890690,Lacefield; Katharine I,0,50,180,180
1746594461273,PSYC 102,A00,890695,Staff,18,0,40,22
1746594462299,PSYC 105,A00,890699,Geller; Emma Harlan,70,0,100,30
1746594463325,PSYC 106,A00,890701,Gorman; Michael R.,5,0,30,25
1746594464350,PSYC 108,A00,890704,Adrian; Julia Anna,0,29,50,50
1746594465380,PSYC 118,A01,890712,Staff,11,0,30,19
1746594466404,PSYC 124,A00,890716,Chapman; Eddie Nathaniel,25,0,60,35
1746594467428,PSYC 131,A00,890717,Anagnostaras; Stephan,0,7,80,80
1746594468454,PSYC 137,A00,890719,Winkielman; Piotr,0,11,30,30
1746594469479,PSYC 144,A00,890721,Adrian; Julia Anna,0,9,45,45
1746594470505,PSYC 162,A00,890805,Staff,0,1,75,75
1746594471529,PSYC 169,A00,890810,Staff,0,15,30,30
1746594472554,PSYC 172,A00,890814,Gorman; Michael R.,9,0,30,21
1746594473579,PSYC 181,A00,890818,Anagnostaras; Stephan,7,0,200,193
1746594474605,PSYC 184,A00,959861,Staff,163,0,175,12
1746594475629,PSYC 189,A00,890823,Staff,0,2,30,30
1746594476654,PSYC 191,A00,890884,Rickard; Timothy C.,0,12,35,35
1746594477683,PSYC 193,A00,890913,Staff,19,0,30,11
1746594477683,PSYC 193,B00,890914,Chapman; Eddie Nathaniel,24,0,30,6
1746594478712,PSYC 193L,A01,890918,Lowe; Angela Beth,20,0,30,10
1746594478712,PSYC 193L,B01,890921,Hurwitz; Ethan Scott,20,0,30,10
1746594478712,PSYC 193L,C01,890928,Staff,30,0,30,0
1746594479736,RELI 149,A00,886806,Rahimi; Babak,23,0,40,17
1746594480763,SE 9,A01,886814,Staff,7,0,20,13
1746594481788,SE 101B,A01,886816,Chadha; Mayank,3,0,35,32
1746594482816,SE 110B,A00,886818,Zhu; Qiang,4,0,75,71
1746594483843,SE 125,A01,886830,Staff,10,0,30,20
1746594484868,SE 130B,A01,886835,Staff,14,0,40,26
1746594485893,SE 131A,A01,886838,Krysl; Petr,34,0,55,21
1746594486919,SE 154,A00,886840,Staff,28,0,50,22
1746594487946,SE 164GS,A01,886849,Staff,6,0,20,14
1746594488974,SE 167GS,A01,886853,Staff,6,0,20,14
1746594490002,SIO 25,A01,890107,Staff,19,0,30,11
1746594491030,SIO 45,A00,890109,Cook; Geoffrey W,116,0,200,84
1746594492058,SIO 109R,A00,890110,Forman; Fonna,0,16,20,20
1746594493087,SIO 187,A01,890114,Kacev; David,15,0,40,25
1746594494112,SOCI 1,A01,890431,Thorpe; Charles Robert,14,0,30,16
1746594494112,SOCI 1,A02,890518,Thorpe; Charles Robert,30,0,30,0
1746594495136,SOCI 2,A01,957978,Staff,25,0,25,0
1746594495136,SOCI 2,A02,957979,Staff,23,0,25,2
1746594496161,SOCI 20,A01,890523,Calderon-Zaks; Michael Aar,21,0,30,9
1746594496161,SOCI 20,A02,890526,Calderon-Zaks; Michael Aar,29,0,30,1
1746594497186,SOCI 30,A01,890533,Pardo Guerra; Juan Pablo,37,0,40,3
1746594498212,SOCI 40,A01,890535,Staff,27,0,45,18
1746594499237,SOCI 104Q,A00,890559,Staff,18,0,30,12
1746594500265,SOCI 106,A00,890560,Arnal; Maud Marie Leonie,20,0,30,10
1746594501292,SOCI 110,A00,890567,Holkenbrink-Monk; Charlene,19,0,30,11
1746594502315,SOCI 112,A00,890568,Victoria Torres; Pablo,2,0,55,53
1746594503341,SOCI 115,A00,890597,Arnal; Maud Marie Leonie,28,0,45,17
1746594505390,SOCI 121,A00,890604,Pardo Guerra; Juan Pablo,38,0,45,7
1746594506417,SOCI 126,A01,890608,Staff,8,0,10,2
1746594507446,SOCI 127,A00,890609,Staff,18,0,30,12
1746594508473,SOCI 131,A00,890610,Thorpe; Charles Robert,37,0,45,8
1746594509500,SOCI 135,A00,890615,Payne; Christine Anna,14,0,45,31
1746594510526,SOCI 139,A00,890620,Staff,38,0,45,7
1746594511614,SOCI 148E,A00,890622,Calderon-Zaks; Michael Aar,36,0,45,9
1746594512639,SOCI 150,A00,890623,Kohler; Kristopher M.,31,0,45,14
1746594513665,SOCI 157,A00,890625,Jules-Rosette; Bennetta W.,18,0,20,2
1746594514688,SOCI 160,A00,890627,Payne; Christine Anna,21,0,45,24
1746594515713,SYN 1,A00,886855,Fish; Gwendolyn Anne,0,1,0,0
1746594515713,SYN 1,B00,906086,Fish; Gwendolyn Anne,0,2,0,2
1746594516739,SYN 2R,A00,886860,Staff,0,17,15,15
1746594516739,SYN 2R,B00,906106,Atkinson; Arthur Laird,0,16,15,15
1746594517772,SYN 100,A01,886866,Browne; Emily,0,28,20,20
1746594517772,SYN 100,B01,906128,Rock; Martin,0,4,20,20
1746594517772,SYN 100,C01,906140,Deavenport; James Cary,0,4,20,20
1746594517772,SYN 100,D01,907816,Deavenport; James Cary,0,5,20,20
1746594518800,TDAC 1,A00,890286,Walsh; Kim C.,7,0,20,13
1746594519828,TDAC 101,A00,890296,Basso; Beatrice,15,0,20,5
1746594520855,TDDE 131,A00,890297,Staff,47,0,50,3
1746594521880,TDDM 1,A00,890287,Weinberg; Sadie,25,0,30,5
1746594522905,TDGE 11,A00,890288,Fulton; Julia,138,0,200,62
1746594522905,TDGE 11,B00,890289,Castro; Robert Jess,185,0,200,15
1746594523929,TDGE 25,B00,957359,Walsh; Kim C.,5,0,20,15
1746594524956,TDGE 40,A01,890292,Power; Jade Yukana,26,0,30,4
1746594525984,TDGE 124,A00,890298,Havis; Allan,0,2,50,50
1746594527009,TDGE 131R,A00,890299,Burelle; Julie Sara Veronique,15,0,42,27
1746594528035,TDHT 101,A00,890300,Staff,10,0,20,10
1746594529063,TDHT 109,A01,890302,Anderson; Mysia Anyse,31,0,40,9
1746594530089,TDMV 1,A00,890293,Arcidiacono; Kristin,18,0,30,12
1746594531115,TDMV 2,A00,890294,Weinberg; Sadie,23,0,30,7
1746594532141,TDMV 3,A00,957878,Arcidiacono; Kristin,28,0,30,2
1746594534192,TDMV 138,A00,890304,Jun; Grace Shin Hae,25,0,40,15
1746594535221,TDMV 140,A00,890305,Corrales; Joseph Bernales,25,0,30,5
1746594536247,TDMV 142,A00,890307,Caligagan; Tony,32,0,40,8
1746594537275,TDMV 144,A00,890308,Camaya; Michelle Ann,25,0,30,5
1746594538302,TDPW 1,A00,890295,Stein; Deborah Isobel,3,0,20,17
1746594539327,USP 2,A01,890272,Lerner; Amy M,7,0,20,13
1746594540353,USP 3,A01,890274,Staff,12,0,30,18
1746594541379,USP 15,A01,890276,Sun; Feiyang,16,0,30,14
1746594542425,USP 25,A00,890277,Shenkman; Michael Thomas,18,0,25,7
1746594543450,USP 138,A00,890278,Staff,13,0,25,12
1746594544477,USP 143,A00,890279,Staff,21,0,70,49
1746594545507,USP 144,A00,890280,Chowdhury; Muhammed Zohir,16,0,30,14
1746594546540,USP 150,A00,890281,Boomhower; Matthew Charles,4,0,30,26
1746594547570,USP 151,A00,890282,Staff,16,0,20,4
1746594548595,USP 162,A00,890283,Andrews; Abigail Leslie,16,0,20,4
1746594549621,USP 168,A00,920477,Kwak; Nancy,0,0,5,5
1746594550652,USP 181,A00,890284,Staff,3,0,20,17
1746594551679,USP 191A,A00,890285,Staff,12,0,20,8
1746594552709,VIS 101,A00,886512,Staff,26,0,75,49
1746594553749,VIS 103,A00,886513,Cruz; Edwin Teddy,61,0,75,14
1746594554774,VIS 108,A00,886514,Staff,4,0,15,11
1746594555802,VIS 127P,A00,886515,Shen; Kuiyi,80,0,146,66
1746594556828,VIS 149,A00,886516,Yoldas; Pinar,0,0,15,15
1746594557853,VIS 164,A00,886526,Erdmann; Dean,19,0,22,3
1746594558879,VIS 194S,A00,886527,Staff,61,0,75,14
1746594559908,WCWP 10A,C00,886484,Martiniuk; Jill,12,0,15,3
1746594560939,WCWP 10B,A00,886490,Uriarte; Emma,0,0,15,15
1746594560939,WCWP 10B,B00,886491,Dhir; Simrita,8,0,15,7
1746594560939,WCWP 10B,C00,886492,Ornelas; Tricia,0,0,15,15
1746594561966,WCWP 100,A00,886494,Young; Mark T,0,6,15,15
1746594564035,AAS 10,A01,886199,Childs; Dennis R.,0,3,0,0
1746594565065,ANAR 104,A01,886940,Shtienberg; Gilad,27,0,30,3
1746594566094,ANAR 120,A00,886953,Staff,13,0,20,7
1746594567121,ANBI 148,A01,886955,Wilder; Linnea Lorene,30,0,40,10
1746594569170,ANSC 122,A00,886957,Staff,24,0,30,6
1746594570196,ANSC 150,A00,886958,Sloane; Julia Kathryn,2,0,15,13
1746594571220,ANSC 156,A00,886959,Jenkins; Janis A.,0,1,15,15
1746594572244,ANSC 180,A00,886960,Staff,11,0,17,6
1746594573270,ANSC 188,A00,886961,Jassal; Aftab,9,0,25,16
1746594574298,ANSC 190,A00,886962,Jassal; Aftab,14,0,25,11
1746594575325,ANSC 191,A00,886963,Staff,18,0,20,2
1746594576350,ANTH 3,A01,891689,Staff,17,0,20,3
1746594577377,ANTH 5,A00,886933,Semendeferi; Ekaterini,16,0,20,4
1746594578402,ANTH 10,A00,886934,Staff,0,12,30,30
1746594579429,ANTH 21,A01,886936,Staff,41,0,60,19
1746594580459,ANTH 23,A01,886938,Staff,92,0,100,8
1746594581487,ANTH 105,A00,886964,Stewart; Alexander B,84,0,100,16
1746594582514,ANTH 108,A00,886965,Pedersen; David,9,0,20,11
1746594583545,AWP 10,001,886147,Staff,0,0,0,0
1746594583545,AWP 10,002,886148,Staff,0,0,0,0
1746594583545,AWP 10,003,886149,Staff,0,0,0,0
1746594583545,AWP 10,004,886150,Staff,0,0,0,0
1746594583545,AWP 10,005,886151,Staff,0,0,0,0
1746594583545,AWP 10,006,886152,Staff,0,0,0,0
1746594583545,AWP 10,007,886153,Staff,0,0,0,0
1746594583545,AWP 10,008,886154,Staff,0,0,0,0
1746594583545,AWP 10,009,886155,Staff,0,0,0,0
1746594583545,AWP 10,010,886156,Staff,0,0,0,0
1746594583545,AWP 10,011,886158,Staff,0,0,0,0
1746594583545,AWP 10,012,886160,Staff,0,0,0,0
1746594583545,AWP 10,013,886161,Staff,0,0,0,0
1746594583545,AWP 10,014,886162,Staff,0,0,0,0
1746594583545,AWP 10,015,886163,Staff,0,0,0,0
1746594583545,AWP 10,016,886164,Staff,0,0,0,0
1746594583545,AWP 10,017,886165,Staff,0,0,0,0
1746594583545,AWP 10,018,886166,Staff,0,0,0,0
1746594583545,AWP 10,019,886168,Staff,0,0,0,0
1746594583545,AWP 10,020,886170,Staff,0,0,0,0
1746594583545,AWP 10,021,886172,Staff,0,0,0,0
1746594584581,AWP 10R,001,886173,Staff,0,1,0,0
1746594584581,AWP 10R,002,886174,Staff,0,1,0,0
1746594584581,AWP 10R,003,886175,Staff,0,0,0,0
1746594584581,AWP 10R,004,886176,Staff,0,0,0,0
1746594584581,AWP 10R,005,886177,Staff,0,0,0,0
1746594584581,AWP 10R,006,886178,Staff,0,0,0,0
1746594584581,AWP 10R,007,886179,Staff,0,0,0,0
1746594584581,AWP 10R,008,886181,Staff,0,0,0,0
1746594584581,AWP 10R,009,886182,Staff,0,0,0,0
1746594584581,AWP 10R,010,886183,Staff,0,0,0,0
1746594584581,AWP 10R,011,886184,Staff,0,0,0,0
1746594584581,AWP 10R,012,886185,Staff,0,0,0,0
1746594584581,AWP 10R,013,886186,Staff,0,0,0,0
1746594584581,AWP 10R,014,886187,Staff,0,0,0,0
1746594584581,AWP 10R,015,886188,Staff,0,0,0,0
1746594584581,AWP 10R,016,886189,Staff,0,0,0,0
1746594584581,AWP 10R,017,960532,Staff,0,0,0,0
1746594584581,AWP 10R,018,960533,Staff,0,0,0,0
1746594584581,AWP 10R,019,960534,Staff,0,0,0,0
1746594584581,AWP 10R,020,960538,Staff,0,0,0,0
1746594584581,AWP 10R,021,960540,Staff,0,0,0,0
1746594584581,AWP 10R,022,960541,Staff,0,0,0,0
1746594584581,AWP 10R,023,960542,Staff,0,0,0,0
1746594584581,AWP 10R,024,960544,Staff,0,0,0,0
1746594584581,AWP 10R,025,960545,Staff,0,0,0,0
1746594584581,AWP 10R,026,960548,Staff,0,0,0,0
1746594585607,AWP 102R,A00,886190,Staff,0,0,0,0
1746594585607,AWP 102R,B00,886191,Staff,0,0,0,0
1746594586637,BENG 100,A01,886193,Staff,17,0,30,13
1746594587664,BENG 122A,A01,886195,Hasty; Jeff M,13,0,30,17
1746594588689,BENG 166A,A00,886196,Sah; Robert Lie-Yuan,0,3,30,30
1746594589714,BENG 190,A00,958050,Khojah; Reem I,17,0,25,8
1746594590742,BIBC 102,A01,894320,Staff,0,0,46,46
1746594590742,BIBC 102,A02,894321,Staff,0,0,46,46
1746594590742,BIBC 102,A03,894344,Staff,6,0,46,40
1746594590742,BIBC 102,A04,894345,Staff,27,0,47,20
1746594591769,BICD 100R,A01,894365,Smith; Laurie,1,3,58,57
1746594591769,BICD 100R,A02,894366,Smith; Laurie,1,5,58,57
1746594591769,BICD 100R,A03,894367,Smith; Laurie,0,0,59,59
1746594591769,BICD 100R,A04,959869,Smith; Laurie,38,0,59,21
1746594592795,BICD 136,A01,894383,Gustafson-Brown; Cindy,14,0,50,36
1746594593820,BIEB 102,A01,894494,Butler; Shannon Rhey,51,0,130,79
1746594595879,BIEB 150,A01,894617,Wills; Christopher,3,0,20,17
1746594595879,BIEB 150,A02,894631,Wills; Christopher,3,0,20,17
1746594595879,BIEB 150,A03,894937,Wills; Christopher,3,0,20,17
1746594595879,BIEB 150,A04,894946,Wills; Christopher,5,0,20,15
1746594596906,BIEB 194,A00,906141,Kurle; Carolyn M.,5,0,20,15
1746594597936,BILD 1,A01,894154,Staff,3,0,19,16
1746594597936,BILD 1,A02,894155,Staff,14,0,19,5
1746594597936,BILD 1,A03,894160,Staff,13,0,19,6
1746594597936,BILD 1,A04,894161,Staff,15,0,18,3
1746594598963,BILD 2,A01,894168,Staff,0,0,50,50
1746594598963,BILD 2,A02,894169,Staff,0,0,50,50
1746594598963,BILD 2,A03,894179,Staff,0,0,50,50
1746594598963,BILD 2,A04,894203,Staff,23,0,50,27
1746594599994,BILD 3,A01,894213,Staff,23,0,31,8
1746594599994,BILD 3,A02,894214,Staff,26,0,31,5
1746594599994,BILD 3,A03,894235,Staff,28,0,31,3
1746594599994,BILD 3,A04,894236,Staff,28,0,32,4
1746594601023,BILD 4,A01,894253,Reuther; Keefe,5,0,24,19
1746594601023,BILD 4,A02,894258,Reuther; Keefe,16,0,24,8
1746594602051,BILD 5,A01,894276,Reuther; Keefe,34,0,50,16
1746594602051,BILD 5,A02,894277,Reuther; Keefe,45,0,50,5
1746594602051,BILD 5,A03,894290,Reuther; Keefe,44,0,50,6
1746594602051,BILD 5,A04,894291,Reuther; Keefe,48,0,50,2
1746594603081,BILD 24,A01,894297,Pirino; Giorgia,40,0,60,20
1746594604112,BIMM 100,B01,958915,Staff,71,0,100,29
1746594605142,BIMM 101,A01,895017,McDonnell; Lisa Marie,0,5,24,24
1746594605142,BIMM 101,A02,895018,McDonnell; Lisa Marie,0,5,24,24
1746594605142,BIMM 101,B01,895020,McDonnell; Lisa Marie,1,6,24,23
1746594605142,BIMM 101,B02,895021,McDonnell; Lisa Marie,0,4,24,24
1746594606171,BIMM 110,A01,895023,Staff,1,0,25,24
1746594606171,BIMM 110,A02,895024,Staff,9,0,25,16
1746594606171,BIMM 110,A03,895025,Staff,18,0,25,7
1746594606171,BIMM 110,A04,895031,Staff,20,0,25,5
1746594607199,BIMM 120,A01,895114,Gustafson-Brown; Cindy,14,0,28,14
1746594607199,BIMM 120,A02,895126,Gustafson-Brown; Cindy,21,0,27,6
1746594608225,BIPN 100,A01,895130,Yang; Mingyu,0,0,38,38
1746594608225,BIPN 100,A02,895131,Yang; Mingyu,31,0,38,7
1746594608225,BIPN 100,A03,895132,Yang; Mingyu,32,0,38,6
1746594608225,BIPN 100,A04,895133,Yang; Mingyu,27,0,36,9
1746594609251,BIPN 120,A01,895135,Cooke; James Edward,0,3,13,13
1746594609251,BIPN 120,A02,895136,Cooke; James Edward,0,1,13,13
1746594609251,BIPN 120,A03,895137,Cooke; James Edward,0,3,13,13
1746594609251,BIPN 120,A04,895156,Cooke; James Edward,0,2,11,11
1746594610276,BIPN 134,A01,895235,Cooke; James Edward,0,1,25,25
1746594610276,BIPN 134,A02,895237,Cooke; James Edward,0,0,25,25
1746594610276,BIPN 134,A03,895240,Cooke; James Edward,2,0,25,23
1746594610276,BIPN 134,A04,895270,Cooke; James Edward,20,0,25,5
1746594611300,BIPN 189,A00,892103,Staff,0,14,14,14
1746594613355,BISP 194,A00,958008,Staff,0,2,0,0
1746594614380,CAT 124,A01,922009,Staff,0,5,20,20
1746594615447,CAT 125R,A00,886390,Morales; Celeste Georgianna,0,3,20,20
1746594615447,CAT 125R,B00,886391,Irwin; Matthew Joseph,0,4,20,20
1746594615447,CAT 125R,C00,886392,Smith; Lauryn Alissa,0,2,20,20
1746594615447,CAT 125R,D00,886393,Vanderschuit; Maya Alysia,0,3,20,20
1746594615447,CAT 125R,E00,886394,Marchisotto; Jennifer Anne,0,3,20,20
1746594616476,CENG 15,A01,886218,Drews; Aaron,3,0,8,5
1746594617504,CENG 113,A00,886219,Opatkiewicz; Justin Paul,15,0,25,10
1746594618531,CGS 101,A00,887044,Staff,7,0,20,13
1746594619557,CGS 105,A01,887046,Staff,14,0,25,11
1746594620582,CGS 112,A00,887047,Cuong; Marisol,12,0,15,3
1746594621611,CGS 113,A00,887048,Staff,23,0,30,7
1746594622638,CGS 120,A00,887049,Staff,10,0,17,7
1746594623664,CHEM 6A,A01,886336,Lam; Tin Yiu,38,0,50,12
1746594623664,CHEM 6A,A02,886338,Lam; Tin Yiu,37,0,50,13
1746594624696,CHEM 6B,A01,886341,Hopkins; Patrycja Anna,16,0,50,34
1746594624696,CHEM 6B,A02,886343,Hopkins; Patrycja Anna,42,0,50,8
1746594625724,CHEM 6C,A01,886346,Albizati; Kim F.,0,2,50,50
1746594625724,CHEM 6C,A02,886348,Albizati; Kim F.,24,0,50,26
1746594626752,CHEM 40A,A01,886352,Klosterman; Jeremy K,65,0,100,35
1746594627779,CHEM 40B,A01,886356,Klosterman; Jeremy K,0,24,100,100
1746594628805,CHEM 41B,A01,886360,Theodorakis; Emmanuel,25,0,50,25
1746594628805,CHEM 41B,A02,886362,Theodorakis; Emmanuel,47,0,50,3
1746594629830,CHIN 165A,A00,886382,Xu; Li,18,0,20,2
1746594630855,CLAS 120,A00,886387,Myerston Santana; Jacobo,33,0,40,7
1746594631880,COGS 9,A01,886967,Shannon; Kyle Michael,42,0,60,18
1746594632905,COGS 11,A01,886969,Staff,9,0,30,21
1746594633931,COGS 14A,A01,886971,Staff,5,0,60,55
1746594634961,COGS 14B,A01,886973,Hoffman; Drew Ellen,4,0,60,56
1746594635986,COGS 18,A01,886975,Morgan; Eric,34,0,60,26
1746594637016,COGS 20,A01,886977,Staff,3,0,8,5
1746594637016,COGS 20,A02,886978,Staff,5,0,7,2
1746594638043,COGS 100,A01,907783,Staff,1,2,30,29
1746594639071,COGS 101B,A01,886980,Staff,0,4,48,48
1746594640099,COGS 101C,A01,886982,Delgado; Tania,0,5,44,44
1746594641128,COGS 102A,A01,886984,Johnson; Christine M.,3,0,30,27
1746594642156,COGS 118B,A01,886986,Staff,1,5,88,87
1746594643181,COGS 150,A01,886988,Bergen; Benjamin,22,0,50,28
1746594644211,COGS 153,A00,886989,Delgado; Tania,0,3,41,41
1746594645235,COGS 186,A01,886991,Staff,0,0,32,32
1746594646260,COGS 187A,A01,886993,Boyle; Mary E. T.,7,0,30,23
1746594647286,COGS 189,A00,886994,Staff,0,1,30,30
1746594648311,COMM 10,A01,886996,Staff,0,0,20,21
1746594648311,COMM 10,A02,886997,Staff,10,0,20,10
1746594648311,COMM 10,A03,959845,Staff,19,0,20,1
1746594649339,COMM 20,A01,886999,Leuning; Grant Maurstad,24,0,40,16
1746594651394,COMM 100A,A01,887002,Staff,0,0,20,25
1746594651394,COMM 100A,A02,887003,Staff,5,0,20,15
1746594652422,COMM 100B,A01,887005,Staff,0,8,20,24
1746594653447,COMM 106D,A00,887006,Staff,13,0,40,27
1746594654475,COMM 110G,A00,887007,Whitworth-Smith; Andrew C,12,0,40,28
1746594655502,COMM 111B,A00,887008,Staff,31,0,40,9
1746594656527,COMM 113T,A00,887009,Abuelhiga; Soraya Jill,28,0,40,12
1746594656527,COMM 113T,B00,906733,Staff,39,0,40,1
1746594657551,COMM 145,A00,887010,Staff,12,0,40,28
1746594658577,COMM 146,A00,887054,Staff,31,0,40,9
1746594659603,COMM 190,A00,887012,Staff,8,0,23,15
1746594660634,CSE 8A,A50,887015,Cao; Yingjun,56,0,85,29
1746594661662,CSE 11,A01,887017,Cao; Yingjun,11,0,70,59
1746594662689,CSE 20,A01,887019,Staff,30,0,50,20
1746594663714,CSE 21,A01,887021,Staff,79,0,100,21
1746594663714,CSE 21,B01,892583,Braun; Oliver,45,0,50,5
1746594664743,CSE 30,A01,887025,Eldon; John,142,0,200,58
1746594665771,CSE 100,A01,887027,Staff,26,0,50,24
1746594665771,CSE 100,A02,887028,Staff,42,0,50,8
1746594666797,CSE 101,A01,887030,Braun; Oliver,74,0,100,26
1746594666797,CSE 101,B01,887032,Jones; Miles E,0,3,50,50
1746594666797,CSE 101,B02,887033,Jones; Miles E,0,2,50,50
1746594667822,CSE 105,A01,908084,Jones; Miles E,32,0,50,18
1746594667822,CSE 105,A02,908087,Jones; Miles E,31,0,50,19
1746594668850,CSE 135,A01,887035,Powell; Thomas Allan,0,5,50,50
1746594669876,CSE 142,A01,887037,Staff,8,0,60,52
1746594670905,CSE 142L,A01,887039,Staff,34,0,60,26
1746594671933,CSE 151A,A01,887041,Solares; Edwin A,47,0,100,53
1746594672961,CSE 175,A01,887043,Kumar; Rakesh,30,0,30,0
1746594673986,CSS 1,A01,886389,Staff,1,2,40,39
1746594675014,DSC 30,A01,908097,Liao; Soohyun Nam,47,0,75,28
1746594676043,DSC 40A,A01,908099,Shannon; Kyle Michael,30,0,50,20
1746594677072,DSC 40B,A01,908112,Staff,15,0,50,35
1746594678101,DSC 80,A01,908116,Staff,19,0,60,41
1746594679127,DSC 197,001,956863,Eldridge; Justin Matthew,9999,0,9999,0
1746594680153,ECE 5,A01,886400,Morris; Karcher William,1,0,6,5
1746594680153,ECE 5,A02,886401,Morris; Karcher William,3,0,6,3
1746594681179,ECE 148,A01,886403,Silberman; Jack,0,14,14,14
1746594682205,ECON 1,A01,887265,Crane; Meredith Helen,11,0,70,59
1746594682205,ECON 1,B01,887268,Staff,42,0,50,8
1746594683232,ECON 2,A01,887273,Crane; Meredith Helen,54,0,70,16
1746594684257,ECON 3,A01,887279,Rondina; Giacomo,31,0,70,39
1746594685282,ECON 4,A01,887282,Anderson; John Charles,0,2,10,10
1746594686308,ECON 5,A01,887285,Staff,34,0,45,11
1746594686308,ECON 5,B01,887292,Staff,41,0,45,4
1746594687338,ECON 100A,A01,887337,Newhouse; Herbert S,54,0,70,16
1746594687338,ECON 100A,B01,887349,Staff,45,0,50,5
1746594688362,ECON 100B,A01,887361,Du; Songzi,29,0,70,41
1746594689390,ECON 100C,A01,887445,Newhouse; Herbert S,59,0,70,11
1746594690420,ECON 105,A00,887488,Vespa; Emanuel Ignacio,23,0,35,12
1746594691454,ECON 109,A01,887506,Shishkin; Denis,28,0,35,7
1746594692484,ECON 110A,A01,887568,Alon; Titan Michael,1,3,35,34
1746594692484,ECON 110A,B01,907601,Alon; Titan Michael,20,0,35,15
1746594693509,ECON 110B,A01,887598,Levkoff; Steven B.,0,24,70,70
1746594694534,ECON 112,A00,887599,Rondina; Giacomo,19,0,35,16
1746594695558,ECON 120A,A01,887603,Dai; Yinlin,35,0,70,35
1746594696585,ECON 120C,A01,887608,Sun; Yixiao,0,1,35,35
1746594696585,ECON 120C,B01,887614,Sun; Yixiao,0,0,35,35
1746594697613,ECON 138,A00,887621,Bharadwaj; Prashant,0,21,20,20
1746594698638,ECON 144,A00,958007,Squires; Dale E,12,0,35,23
1746594699664,ECON 171,A01,907666,Staff,18,0,35,17
1746594700692,ECON 175,A00,887626,Wu; Pak Yeung,22,0,35,13
1746594701719,ECON 190,A00,887640,Vespa; Emanuel Ignacio,22,0,35,13
1746594702752,EDS 25,A01,888197,Staff,0,0,0,0
1746594702752,EDS 25,A02,888209,Staff,0,0,0,0
1746594702752,EDS 25,A03,888210,Staff,0,0,0,0
1746594702752,EDS 25,A04,888212,Staff,0,0,0,0
1746594702752,EDS 25,A05,888213,Staff,0,0,0,0
1746594702752,EDS 25,A06,888214,Staff,0,0,0,0
1746594702752,EDS 25,A07,888235,Staff,0,2,0,0
1746594702752,EDS 25,A08,888236,Staff,0,0,0,0
1746594702752,EDS 25,A09,888240,Staff,0,0,0,0
1746594702752,EDS 25,A10,888244,Staff,0,0,0,0
1746594702752,EDS 25,B01,888273,Staff,0,0,0,0
1746594702752,EDS 25,B02,888285,Staff,0,0,0,0
1746594702752,EDS 25,B03,888423,Staff,0,0,0,1
1746594702752,EDS 25,B04,888432,Staff,0,0,0,0
1746594702752,EDS 25,B05,888433,Staff,0,0,0,0
1746594702752,EDS 25,B06,888467,Staff,0,0,0,0
1746594702752,EDS 25,B07,888468,Staff,0,0,0,0
1746594702752,EDS 25,B08,888479,Staff,0,0,0,0
1746594702752,EDS 25,B09,888484,Staff,0,0,0,0
1746594702752,EDS 25,B10,888487,Staff,0,0,0,0
1746594703777,EDS 38,A01,907700,Choi; Bailey Miyeon,30,0,30,0
1746594704803,EDS 112,A01,888601,Chapman; Thandeka K,12,0,40,28
1746594705829,EDS 115,A00,888697,Mendez; Kathrina Mendoza,10,0,30,20
1746594706856,EDS 116,A01,888893,Staff,33,0,40,7
1746594708907,EDS 124AR,A00,889133,Staff,29,0,50,21
1746594708907,EDS 124AR,B00,907471,Simon; Elizabeth A,37,0,50,13
1746594709934,EDS 124BR,A00,889134,Simon; Elizabeth A,44,0,100,56
1746594710959,EDS 125,A00,889135,Staff,25,0,30,5
1746594711984,EDS 126,A01,889138,Staff,35,0,40,5
1746594713010,EDS 164R,A01,889142,Wishard Guerra; Alison G.,32,0,50,18
1746594714039,ENG 30,A01,886396,Staff,0,0,0,0
1746594714039,ENG 30,B01,886398,Staff,0,0,0,0
1746594715062,ENVR 102,A00,906150,Montejo; Carolina,23,0,25,2
1746594716088,ETHN 103A,A00,887236,Man; Simeon S,0,2,0,0
1746594717116,ETHN 113,A00,887239,Staff,16,0,30,14
1746594718141,ETHN 116,A00,887240,Staff,16,0,25,9
1746594719221,ETHN 117,A00,887241,Choi; Esther Min,28,0,30,2
1746594720250,ETHN 118,A00,887243,Staff,24,0,30,6
1746594721275,ETHN 127,A00,887248,Cuong; Marisol,11,0,15,4
1746594722302,ETHN 139,A00,887250,Staff,7,0,10,3
1746594723330,ETHN 142,A00,887252,Staff,10,0,30,20
1746594724357,ETHN 161,A00,887253,Browne; Errol Tsekani,24,0,30,6
1746594725383,ETHN 163FR,A00,887255,Burelle; Julie Sara Veronique,0,0,5,5
1746594726409,GLBH 20,A00,889149,Elwardani; Nile Regina,8,0,42,34
1746594728465,GLBH 111,A01,889152,Burgos; Jose L.,17,0,17,0
1746594729490,GLBH 150,A00,889181,Sloane; Julia Kathryn,0,5,15,15
1746594731544,HDS 60,A01,886406,Warstadt; Melissa Fawn,72,0,80,8
1746594732572,HIAF 111,A00,889324,Gyamfi; Bright,25,0,32,7
1746594733598,HIEA 131,A00,889328,Staff,15,0,32,17
1746594734626,HIEA 144,A00,889333,Henry; Todd A.,26,0,32,6
1746594735657,HIEA 154,A00,889336,Henry; Todd A.,24,0,32,8
1746594736683,HIEU 106,A00,889339,Staff,22,0,32,10
1746594738732,HIEU 114,A00,889340,Staff,4,0,32,28
1746594739760,HIEU 135GS,A00,889342,Patterson; Patrick H.,0,0,1,24
1746594740787,HIEU 137,A00,889343,Edington; Claire Ellen,10,0,25,15
1746594741812,HIEU 148,A00,889345,Staff,14,0,32,18
1746594742840,HIEU 154,A00,889346,Biess; Frank Peter,21,0,32,11
1746594743869,HILA 102,A00,889351,Staff,12,0,32,20
1746594744894,HILD 2A,A01,889221,Lewandoski; Julia Mavis,2,10,32,30
1746594745923,HILD 7B,A01,889225,Man; Simeon S,0,12,32,32
1746594746950,HILD 7C,A01,889288,Alvarez; Luis A,0,14,32,32
1746594747977,HILD 30,A01,889323,Staff,0,5,32,32
1746594750028,HISC 119,A00,889383,Golan; Tal,20,0,32,12
1746594751056,HIUS 103,A00,889384,Man; Simeon S,0,0,32,32
1746594752081,HIUS 117,A00,919797,Kwak; Nancy,18,0,32,14
1746594753109,HIUS 142A,A00,919788,Staff,22,0,32,10
1746594755164,HIUS 149,A00,889386,Gyamfi; Bright,26,0,32,6
1746594756194,HIUS 155,A00,889387,Alvarez; Luis A,15,0,32,17
1746594757223,HUM 3,A01,886499,Caldwell; Michael Alan,19,0,50,31
1746594758251,HUM 3GS,A00,886500,Rodriguez; Bretton Sigfred,0,0,0,28
1746594759277,HUM 3R,A01,886502,Markman; Kristina,0,36,50,50
1746594760302,HUM 4,A01,886504,Crum; Matthew Stephen,23,0,50,27
1746594760302,HUM 4,B01,886506,West; Geoffrey Scott,17,0,50,33
1746594761328,HUM 4GS,A00,886507,Staff,0,0,0,19
1746594762353,HUM 5,A01,886509,Staff,31,0,50,19
1746594763379,HUM 5R,A01,886511,Zavodny; Tatiana Sophia,0,39,50,50
1746594764409,JAPN 180,A00,886407,Staff,16,0,40,24
1746594765439,LATI 50,A01,886409,Martin-Cabrera; Luis,3,0,22,19
1746594765439,LATI 50,A02,886410,Martin-Cabrera; Luis,19,0,22,3
1746594765439,LATI 50,A03,886411,Martin-Cabrera; Luis,21,0,22,1
1746594765439,LATI 50,A04,886412,Martin-Cabrera; Luis,8,0,22,14
1746594766467,LAWS 101,A00,907664,Staff,28,0,60,32
1746594767491,LIAB 1A,A00,889388,Saab; Dima,17,0,20,3
1746594768516,LIAB 1AX,A00,889389,El Cheddadi; Youniss,18,0,20,2
1746594769544,LIFR 1C,A00,889391,Van Moer; Vinciane G,8,0,20,12
1746594770584,LIFR 1CX,A00,889392,Van Moer; Vinciane G,7,0,20,13
1746594771611,LIFR 1D,A00,889393,Van Moer; Vinciane G,7,0,20,13
1746594772635,LIFR 1DX,A00,889394,Van Moer; Vinciane G,8,0,20,12
1746594773663,LIGN 7,A00,886923,Staff,25,0,50,25
1746594774690,LIGN 17,A00,886924,Kehler; Andrew Scott,126,0,150,24
1746594775717,LTAM 110,A00,889395,Staff,15,0,30,15
1746594776742,LTAM 110GS,A00,958010,Rodriguez; Bretton Sigfred,0,0,0,28
1746594777767,LTCH 101,A00,889397,Staff,23,0,25,2
1746594778793,LTCS 130,A00,889398,Staff,23,0,25,2
1746594779820,LTEA 138,A00,889399,Staff,24,0,40,16
1746594780848,LTEN 149,A00,889400,Wesling; Megan E.,0,3,25,25
1746594781876,LTEN 169,A00,889401,Staff,20,0,25,5
1746594782900,LTEN 180,A00,889402,Staff,10,0,15,5
1746594783928,LTEN 181,A00,889403,Staff,21,0,25,4
1746594784954,LTWL 100,A00,889404,Myerston Santana; Jacobo,2,0,25,23
1746594785981,LTWL 180GS,A00,889405,Staff,0,0,20,20
1746594787007,LTWL 181,A00,889406,Staff,16,0,25,9
1746594788033,LTWL 184,A00,889475,Mukherjee; Silpa,22,0,25,3
1746594789060,LTWR 102C,A00,889486,Staff,29,0,30,1
1746594790089,LTWR 115W,A00,889491,Staff,0,2,15,15
1746594791115,MAE 8,A01,886905,Staff,0,2,0,0
1746594792144,MAE 11,A00,886906,Bandaru; Prabhakar,0,7,50,50
1746594793171,MAE 20,A00,886907,Evdokimenko; Ekaterina,43,0,70,27
1746594794196,MAE 30B,A00,886909,Ghazinejad; Maziar,25,0,45,20
1746594795223,MAE 101B,A00,886910,Saintillan; David,30,0,45,15
1746594796249,MAE 105,A00,886911,Bandaru; Prabhakar,18,0,50,32
1746594797276,MAE 107,B00,958024,Staff,7,0,50,43
1746594798302,MAE 143B,A00,886913,Bewley; Thomas R,2,0,40,38
1746594799330,MAE 148,A01,886915,Silberman; Jack,0,3,14,14
1746594800357,MAE 160,A00,886916,Evdokimenko; Ekaterina,31,0,60,29
1746594801382,MATH 3C,A01,889681,Staff,0,2,30,30
1746594801382,MATH 3C,A02,960048,Staff,23,0,30,7
1746594802420,MATH 10A,A01,889760,Staff,26,0,30,4
1746594802420,MATH 10A,A02,889783,Staff,29,0,30,1
1746594803452,MATH 10B,A01,889785,Verstraete; Jacques Allan,1,0,35,34
1746594803452,MATH 10B,A02,889795,Verstraete; Jacques Allan,4,0,35,31
1746594803452,MATH 10B,B01,889797,Verstraete; Jacques Allan,3,0,35,32
1746594803452,MATH 10B,B02,889828,Verstraete; Jacques Allan,3,0,35,32
1746594804483,MATH 10C,A01,889849,Habib; Yousaf,8,0,30,22
1746594804483,MATH 10C,A02,889852,Habib; Yousaf,14,0,30,16
1746594804483,MATH 10C,A03,889853,Habib; Yousaf,22,0,30,8
1746594804483,MATH 10C,A04,889858,Habib; Yousaf,20,0,30,10
1746594804483,MATH 10C,B01,889861,Staff,1,0,30,29
1746594804483,MATH 10C,B02,889862,Staff,24,0,30,6
1746594804483,MATH 10C,B03,889863,Staff,27,0,30,3
1746594804483,MATH 10C,B04,889967,Staff,23,0,30,7
1746594805514,MATH 18,A01,889974,Staff,7,0,30,23
1746594805514,MATH 18,A02,889977,Staff,20,0,30,10
1746594805514,MATH 18,B01,889984,Hardiman; Liam,20,0,30,10
1746594805514,MATH 18,B02,889985,Hardiman; Liam,25,0,30,5
1746594806543,MATH 20A,A01,889990,Suk; Andrew Hoon,30,0,35,5
1746594807570,MATH 20B,A01,889993,Ohm; Ko Woon,21,0,30,9
1746594807570,MATH 20B,A02,889994,Ohm; Ko Woon,30,0,30,0
1746594807570,MATH 20B,B01,889996,Ohm; Ko Woon,22,0,30,8
1746594807570,MATH 20B,B02,889997,Ohm; Ko Woon,23,0,30,7
1746594808598,MATH 20C,A01,889999,Hammock; Frances H,17,0,30,13
1746594808598,MATH 20C,A02,890003,Hammock; Frances H,23,0,30,7
1746594808598,MATH 20C,B01,890006,Hammock; Frances H,3,0,30,27
1746594808598,MATH 20C,B02,890007,Hammock; Frances H,12,0,30,18
1746594809623,MATH 20D,A01,890011,Cheng; Hsiao-Bing,1,1,30,29
1746594809623,MATH 20D,A02,890012,Cheng; Hsiao-Bing,14,0,30,16
1746594809623,MATH 20D,B01,890016,Cheng; Hsiao-Bing,13,0,30,17
1746594809623,MATH 20D,B02,890017,Cheng; Hsiao-Bing,13,0,30,17
1746594810653,MATH 20E,A01,890026,Harel; Guershon,1,0,30,29
1746594810653,MATH 20E,A02,890029,Harel; Guershon,22,0,30,8
1746594810653,MATH 20E,B01,890033,Harel; Guershon,7,0,30,23
1746594810653,MATH 20E,B02,890101,Harel; Guershon,21,0,30,9
1746594811679,MATH 102,A01,890104,Staff,18,0,30,12
1746594811679,MATH 102,A02,890105,Staff,27,0,30,3
1746594812709,MATH 103B,A01,890116,Salehi Golsefidy; Alireza,3,0,30,27
1746594812709,MATH 103B,B01,890118,Staff,0,3,34,34
1746594813733,MATH 109,A01,890121,Aliabadi Sr.; Mohsen,0,0,30,30
1746594813733,MATH 109,B01,890124,Upadrashta; Pranav Kumar,18,0,30,12
1746594814759,MATH 120A,A01,890126,Eggers; John Dietrich,13,0,30,17
1746594815788,MATH 142B,A01,890128,Ioana; Adrian,19,0,30,11
1746594815788,MATH 142B,A02,890129,Ioana; Adrian,12,0,30,18
1746594816817,MATH 154,A01,890174,Staff,0,1,30,30
1746594816817,MATH 154,A02,890182,Staff,0,0,30,30
1746594817846,MATH 168A,A01,890197,Dumitriu; Ioana,21,0,35,14
1746594818874,MATH 170A,A01,890240,Nie; Jiawang,1,0,30,29
1746594818874,MATH 170A,A02,890241,Nie; Jiawang,11,0,30,19
1746594818874,MATH 170A,A03,890249,Nie; Jiawang,23,0,30,7
1746594819900,MATH 170B,A01,957891,Nag; Panchali,13,0,35,22
1746594821953,MATH 181A,A01,908025,Staff,0,3,35,35
1746594821953,MATH 181A,A02,960115,Staff,26,0,35,9
1746594823021,MATH 181B,A01,959874,Staff,24,0,30,6
1746594824047,MATH 193B,A01,890265,Staff,0,4,35,35
1746594825073,MGT 4,A01,890311,Anderson; John Charles,42,0,88,46
1746594826099,MGT 5,A00,907740,Staff,12,0,98,86
1746594827123,MGT 12,A00,890312,Lindenberger; Wade Douglas,67,0,98,31
1746594828148,MGT 16,A00,957883,Staff,78,0,98,20
1746594830202,MGT 45,A00,890314,Pecore; Joseph P.,45,0,98,53
1746594831228,MGT 71,A00,890315,Staff,0,12,98,98
1746594832253,MGT 100,A00,890316,Yavorsky; Daniel Ryan,44,0,98,54
1746594833279,MGT 103,A00,890317,Ehrich; Kristine R,73,0,98,25
1746594834305,MGT 105,A00,890356,Bates; Kenneth Walter,0,8,98,98
1746594835329,MGT 112,A00,890360,Ehrich; Kristine R,55,0,98,43
1746594836357,MGT 127R,A00,907732,Zhu; Kevin Xiaoguo,23,0,98,75
1746594837387,MGT 131B,A00,890361,Anderson; John Charles,59,0,98,39
1746594838413,MGT 137,A00,890362,Lindenberger; Wade Douglas,65,0,98,33
1746594839442,MGT 160,A00,890369,Johnson; Erik Barry,9,0,98,89
1746594841499,MGT 164,A00,890372,Zimmermann; Carsten,0,40,98,98
1746594842527,MGT 180,A00,890374,Bliss; Barbara Ann,11,0,98,87
1746594843557,MMW 15,A01,886414,Chang; Edmond Yi-Teh,0,12,28,28
1746594843557,MMW 15,A02,886415,Chang; Edmond Yi-Teh,0,8,28,28
1746594843557,MMW 15,A03,886416,Chang; Edmond Yi-Teh,0,9,28,28
1746594843557,MMW 15,A04,886417,Chang; Edmond Yi-Teh,0,8,28,28
1746594843557,MMW 15,B01,886419,Chang; Edmond Yi-Teh,0,7,28,28
1746594843557,MMW 15,B02,886420,Chang; Edmond Yi-Teh,0,7,28,28
1746594843557,MMW 15,B03,886421,Chang; Edmond Yi-Teh,0,7,28,28
1746594843557,MMW 15,B04,886422,Chang; Edmond Yi-Teh,0,8,28,28
1746594843557,MMW 15,C01,886424,Staff,0,9,28,28
1746594843557,MMW 15,C02,886425,Staff,0,8,28,28
1746594843557,MMW 15,C03,886426,Staff,0,8,28,28
1746594843557,MMW 15,C04,886427,Staff,0,8,28,28
1746594843557,MMW 15,C05,958038,Staff,0,8,28,28
1746594843557,MMW 15,C06,958039,Staff,1,8,28,27
1746594844584,MMW 15GS,A00,906910,Patterson; Patrick H.,4,0,28,24
1746594845612,MMW 122R,A01,886429,Rahimi; Babak,0,13,28,28
1746594845612,MMW 122R,A02,886430,Rahimi; Babak,0,12,28,28
1746594845612,MMW 122R,A03,958040,Rahimi; Babak,0,11,28,28
1746594846640,MUS 1A,A01,890937,Staff,2,0,25,23
1746594846640,MUS 1A,A02,891035,Staff,6,0,25,19
1746594846640,MUS 1A,C01,958912,Staff,24,0,25,1
1746594846640,MUS 1A,C02,958913,Staff,25,0,25,0
1746594848692,MUS 2AK,A00,957092,Ohnishi; Takae,15,0,15,0
1746594849721,MUS 4,A01,891044,Staff,0,0,25,25
1746594849721,MUS 4,A02,891045,Staff,22,0,25,3
1746594849721,MUS 4,B01,891048,Staff,17,0,25,8
1746594849721,MUS 4,B02,891050,Staff,25,0,25,0
1746594850747,MUS 5,A01,957506,Dubnov; Shlomo,0,0,25,25
1746594850747,MUS 5,A02,957622,Dubnov; Shlomo,13,0,25,12
1746594850747,MUS 5,A03,957623,Dubnov; Shlomo,20,0,25,5
1746594851778,MUS 6,A01,891053,Freitas Caetano; Marcelo,24,0,25,1
1746594851778,MUS 6,A02,891054,Freitas Caetano; Marcelo,23,0,25,2
1746594852802,MUS 7,A01,891081,Staff,0,0,25,25
1746594852802,MUS 7,A02,891082,Staff,3,0,25,22
1746594853827,MUS 8GS,A00,891118,Borgo; David Garcia,1,0,25,24
1746594854855,MUS 11,A01,891140,Staff,8,0,25,17
1746594854855,MUS 11,A02,891141,Staff,21,0,25,4
1746594855885,MUS 13,A01,891143,Staff,8,0,25,17
1746594855885,MUS 13,A02,891144,Staff,24,0,25,1
1746594856913,MUS 15,A01,891146,Staff,9,0,25,16
1746594856913,MUS 15,A02,891148,Staff,21,0,25,4
1746594856913,MUS 15,B01,891150,Staff,18,0,25,7
1746594856913,MUS 15,B02,891151,Staff,25,0,25,0
1746594857941,MUS 20,A01,891153,Staff,5,0,20,15
1746594857941,MUS 20,A02,891155,Staff,14,0,20,6
1746594858970,MUS 80,A00,891156,Staff,19,0,25,6
1746594858970,MUS 80,B00,891157,Staff,23,0,25,2
1746594860003,MUS 130,A00,891158,Ohnishi; Takae,35,0,35,0
1746594861026,MUS 150GS,A01,891160,Borgo; David Garcia,1,0,25,24
1746594862055,MUS 170,A01,891162,Freitas Caetano; Marcelo,20,0,25,5
1746594862055,MUS 170,A02,891164,Freitas Caetano; Marcelo,21,0,25,4
1746594863083,NANO 11,A00,886220,Vazquez Mena; Oscar,13,0,15,2
1746594864107,NANO 15,A01,886222,Drews; Aaron,4,0,7,3
1746594865132,NANO 104,A00,886224,Sirbuly; Donald,17,0,25,8
1746594866157,PH 40,A00,886528,Staff,23,0,40,17
1746594867182,PH 45,A01,886799,Staff,35,0,40,5
1746594868210,PH 110,A00,886802,Staff,0,6,40,40
1746594869238,PH 172,A00,906716,Staff,19,0,35,16
1746594870268,PH 191,A00,886803,Staff,6,0,40,34
1746594871294,PHIL 1,A00,889500,Staff,20,0,30,10
1746594872383,PHIL 10,A01,889549,Grush; Rick Scott,16,0,22,6
1746594872383,PHIL 10,A02,889551,Grush; Rick Scott,22,0,22,0
1746594873431,PHIL 28,A01,889559,Lamey; Andy M.,0,2,31,31
1746594873431,PHIL 28,A02,889561,Lamey; Andy M.,0,1,30,30
1746594873431,PHIL 28,A03,889572,Lamey; Andy M.,0,1,30,30
1746594874535,PHIL 35,A00,907839,Staff,13,0,15,2
1746594875561,PHIL 60,A00,889574,Staff,73,0,90,17
1746594876591,PHIL 101,A00,958004,Staff,12,0,15,3
1746594878643,PHIL 136,A00,889582,Fulkerson; Matthew Todd,26,0,45,19
1746594879670,PHIL 163,A01,889601,Staff,21,0,30,9
1746594879670,PHIL 163,B01,889606,Brandt; Reuven A,0,3,0,0
1746594880698,PHIL 164,A00,889610,Staff,16,0,30,14
1746594881724,PHIL 165,A00,889613,Staff,22,0,30,8
1746594882751,PHYS 1A,A00,886431,Staff,30,0,70,40
1746594883778,PHYS 1AL,001,886432,Tsai; Philbert S,1,2,30,29
1746594883778,PHYS 1AL,002,886436,Tsai; Philbert S,13,0,30,17
1746594884805,PHYS 1B,A00,886439,Staff,184,0,240,56
1746594885833,PHYS 1BL,001,886441,Tsai; Philbert S,0,4,30,30
1746594885833,PHYS 1BL,002,886444,Tsai; Philbert S,2,0,30,28
1746594886861,PHYS 1C,A00,896092,Arnold; Kam S,78,0,146,68
1746594887887,PHYS 1CL,001,886448,Tsai; Philbert S,0,0,30,30
1746594887887,PHYS 1CL,002,886449,Tsai; Philbert S,1,0,30,29
1746594887887,PHYS 1CL,003,886450,Tsai; Philbert S,16,0,30,14
1746594887887,PHYS 1CL,004,886451,Tsai; Philbert S,15,0,30,15
1746594888915,PHYS 2B,A01,886457,Staff,67,0,115,48
1746594889941,PHYS 2C,A01,886460,Shotwell; Brian,0,9,65,65
1746594890970,PHYS 2CL,A01,886467,Staff,0,4,28,28
1746594890970,PHYS 2CL,A02,886468,Staff,0,3,28,28
1746594891998,PHYS 2D,A01,886470,Staff,10,0,50,40
1746594893029,PHYS 4B,A01,886475,Grinstein; Benjamin,22,0,40,18
1746594894057,POLI 5,A00,891173,Desposato; Scott,7,0,25,18
1746594895082,POLI 5D,A01,891175,Staff,5,0,5,0
1746594895082,POLI 5D,B01,891178,Staff,5,0,5,0
1746594896108,POLI 11,A00,891179,Ferree; Karen E,1,0,35,34
1746594897135,POLI 12,A00,891180,Staff,15,0,30,15
1746594898161,POLI 27,A01,891182,Staff,12,0,75,63
1746594899188,POLI 30,A00,891183,Staff,8,0,50,42
1746594900213,POLI 100B,A00,891244,Staff,5,1,35,30
1746594901238,POLI 100I,A00,891247,Staff,7,0,30,23
1746594902264,POLI 104J,A00,891248,Nichter; Maysa,14,0,30,16
1746594903303,POLI 104U,A00,891250,Nichter; Maysa,1,0,30,29
1746594905355,POLI 110B,A00,891255,Wiens; David,19,0,25,6
1746594906383,POLI 112A,A00,891256,Wiens; David,6,0,25,19
1746594907410,POLI 114BR,A00,891261,Staff,19,0,30,11
1746594908439,POLI 117R,A00,891262,Forman; Fonna,0,6,50,50
1746594909465,POLI 118,A00,891264,Ingham; Sean,17,0,25,8
1746594910490,POLI 124A,A00,891265,Staff,18,0,20,2
1746594911520,POLI 125D,A00,891266,Nichter; Simeon C,2,0,25,23
1746594912550,POLI 126,A00,891268,Nichter; Simeon C,7,0,25,18
1746594913574,POLI 126AA,A00,891272,Staff,15,0,25,10
1746594914600,POLI 130AA,A00,891273,Staff,15,0,20,5
1746594915625,POLI 134AA,A00,891274,Staff,4,0,20,16
1746594917682,POLI 138,A00,891278,Staff,21,0,25,4
1746594918710,POLI 142K,A00,891280,Staff,10,0,25,15
1746594919738,POLI 142M,A00,891281,Gartzke; Erik,16,0,30,14
1746594920762,POLI 142P,A00,891284,Staff,20,0,30,10
1746594921788,POLI 143,A00,891285,Gartzke; Erik,12,0,30,18
1746594922815,POLI 153,A00,891286,Staff,19,0,20,1
1746594924871,POLI 175,A00,891290,Staff,15,0,20,5
1746594925967,PSYC 1,A00,890674,Steiner; Eric Tomas,0,11,45,45
1746594927035,PSYC 2,A00,890676,Albright; Thomas D,20,0,35,15
1746594928060,PSYC 3,A00,890679,Staff,17,0,20,3
1746594929086,PSYC 6,A00,959858,Staff,19,0,20,1
1746594930114,PSYC 60,A01,890684,Rickard; Timothy C.,0,6,45,45
1746594931144,PSYC 70,A01,890689,Geller; Emma Harlan,6,0,30,24
1746594932171,PSYC 71,A01,959860,Staff,21,0,25,4
1746594933202,PSYC 100,A00,890690,Lacefield; Katharine I,0,50,180,180
1746594934228,PSYC 102,A00,890695,Staff,18,0,40,22
1746594935257,PSYC 105,A00,890699,Geller; Emma Harlan,70,0,100,30
1746594936285,PSYC 106,A00,890701,Gorman; Michael R.,5,0,30,25
1746594937310,PSYC 108,A00,890704,Adrian; Julia Anna,0,29,50,50
1746594938339,PSYC 118,A01,890712,Staff,11,0,30,19
1746594939366,PSYC 124,A00,890716,Chapman; Eddie Nathaniel,25,0,60,35
1746594940393,PSYC 131,A00,890717,Anagnostaras; Stephan,0,7,80,80
1746594941419,PSYC 137,A00,890719,Winkielman; Piotr,0,11,30,30
1746594942447,PSYC 144,A00,890721,Adrian; Julia Anna,0,9,45,45
1746594943472,PSYC 162,A00,890805,Staff,0,1,75,75
1746594944498,PSYC 169,A00,890810,Staff,0,15,30,30
1746594945523,PSYC 172,A00,890814,Gorman; Michael R.,9,0,30,21
1746594946551,PSYC 181,A00,890818,Anagnostaras; Stephan,7,0,200,193
1746594947576,PSYC 184,A00,959861,Staff,163,0,175,12
1746594948604,PSYC 189,A00,890823,Staff,0,2,30,30
1746594949631,PSYC 191,A00,890884,Rickard; Timothy C.,0,12,35,35
1746594950661,PSYC 193,A00,890913,Staff,19,0,30,11
1746594950661,PSYC 193,B00,890914,Chapman; Eddie Nathaniel,24,0,30,6
1746594951689,PSYC 193L,A01,890918,Lowe; Angela Beth,20,0,30,10
1746594951689,PSYC 193L,B01,890921,Hurwitz; Ethan Scott,20,0,30,10
1746594951689,PSYC 193L,C01,890928,Staff,30,0,30,0
1746594952713,RELI 149,A00,886806,Rahimi; Babak,23,0,40,17
1746594953739,SE 9,A01,886814,Staff,7,0,20,13
1746594954770,SE 101B,A01,886816,Chadha; Mayank,3,0,35,32
1746594955801,SE 110B,A00,886818,Zhu; Qiang,4,0,75,71
1746594956826,SE 125,A01,886830,Staff,10,0,30,20
1746594957856,SE 130B,A01,886835,Staff,14,0,40,26
1746594958882,SE 131A,A01,886838,Krysl; Petr,34,0,55,21
1746594959906,SE 154,A00,886840,Staff,28,0,50,22
1746594960933,SE 164GS,A01,886849,Staff,6,0,20,14
1746594961984,SE 167GS,A01,886853,Staff,6,0,20,14
1746594963009,SIO 25,A01,890107,Staff,19,0,30,11
1746594964035,SIO 45,A00,890109,Cook; Geoffrey W,116,0,200,84
1746594965059,SIO 109R,A00,890110,Forman; Fonna,0,16,20,20
1746594966084,SIO 187,A01,890114,Kacev; David,15,0,40,25
1746594967114,SOCI 1,A01,890431,Thorpe; Charles Robert,14,0,30,16
1746594967114,SOCI 1,A02,890518,Thorpe; Charles Robert,30,0,30,0
1746594968140,SOCI 2,A01,957978,Staff,25,0,25,0
1746594968140,SOCI 2,A02,957979,Staff,23,0,25,2
1746594969168,SOCI 20,A01,890523,Calderon-Zaks; Michael Aar,21,0,30,9
1746594969168,SOCI 20,A02,890526,Calderon-Zaks; Michael Aar,29,0,30,1
1746594970193,SOCI 30,A01,890533,Pardo Guerra; Juan Pablo,37,0,40,3
1746594971219,SOCI 40,A01,890535,Staff,27,0,45,18
1746594972246,SOCI 104Q,A00,890559,Staff,18,0,30,12
1746594973272,SOCI 106,A00,890560,Arnal; Maud Marie Leonie,20,0,30,10
1746594974297,SOCI 110,A00,890567,Holkenbrink-Monk; Charlene,19,0,30,11
1746594975326,SOCI 112,A00,890568,Victoria Torres; Pablo,2,0,55,53
1746594976350,SOCI 115,A00,890597,Arnal; Maud Marie Leonie,28,0,45,17
1746594978399,SOCI 121,A00,890604,Pardo Guerra; Juan Pablo,38,0,45,7
1746594979425,SOCI 126,A01,890608,Staff,8,0,10,2
1746594980451,SOCI 127,A00,890609,Staff,18,0,30,12
1746594981481,SOCI 131,A00,890610,Thorpe; Charles Robert,37,0,45,8
1746594982552,SOCI 135,A00,890615,Payne; Christine Anna,14,0,45,31
1746594983582,SOCI 139,A00,890620,Staff,38,0,45,7
1746594984607,SOCI 148E,A00,890622,Calderon-Zaks; Michael Aar,36,0,45,9
1746594985638,SOCI 150,A00,890623,Kohler; Kristopher M.,31,0,45,14
1746594986667,SOCI 157,A00,890625,Jules-Rosette; Bennetta W.,18,0,20,2
1746594987700,SOCI 160,A00,890627,Payne; Christine Anna,21,0,45,24
1746594988729,SYN 1,A00,886855,Fish; Gwendolyn Anne,0,1,0,0
1746594988729,SYN 1,B00,906086,Fish; Gwendolyn Anne,0,2,0,2
1746594989754,SYN 2R,A00,886860,Staff,0,17,15,15
1746594989754,SYN 2R,B00,906106,Atkinson; Arthur Laird,0,16,15,15
1746594990782,SYN 100,A01,886866,Browne; Emily,0,28,20,20
1746594990782,SYN 100,B01,906128,Rock; Martin,0,4,20,20
1746594990782,SYN 100,C01,906140,Deavenport; James Cary,0,4,20,20
1746594990782,SYN 100,D01,907816,Deavenport; James Cary,0,5,20,20
1746594991808,TDAC 1,A00,890286,Walsh; Kim C.,7,0,20,13
1746594992837,TDAC 101,A00,890296,Basso; Beatrice,15,0,20,5
1746594993863,TDDE 131,A00,890297,Staff,47,0,50,3
1746594994888,TDDM 1,A00,890287,Weinberg; Sadie,25,0,30,5
1746594995916,TDGE 11,A00,890288,Fulton; Julia,138,0,200,62
1746594995916,TDGE 11,B00,890289,Castro; Robert Jess,185,0,200,15
1746594996942,TDGE 25,B00,957359,Walsh; Kim C.,5,0,20,15
1746594997968,TDGE 40,A01,890292,Power; Jade Yukana,26,0,30,4
1746594998997,TDGE 124,A00,890298,Havis; Allan,0,2,50,50
1746595000023,TDGE 131R,A00,890299,Burelle; Julie Sara Veronique,15,0,42,27
1746595001048,TDHT 101,A00,890300,Staff,10,0,20,10
1746595002077,TDHT 109,A01,890302,Anderson; Mysia Anyse,31,0,40,9
1746595003102,TDMV 1,A00,890293,Arcidiacono; Kristin,18,0,30,12
1746595004133,TDMV 2,A00,890294,Weinberg; Sadie,23,0,30,7
1746595005159,TDMV 3,A00,957878,Arcidiacono; Kristin,28,0,30,2
1746595007216,TDMV 138,A00,890304,Jun; Grace Shin Hae,25,0,40,15
1746595008244,TDMV 140,A00,890305,Corrales; Joseph Bernales,25,0,30,5
1746595009270,TDMV 142,A00,890307,Caligagan; Tony,32,0,40,8
1746595010295,TDMV 144,A00,890308,Camaya; Michelle Ann,25,0,30,5
1746595011324,TDPW 1,A00,890295,Stein; Deborah Isobel,3,0,20,17
1746595012351,USP 2,A01,890272,Lerner; Amy M,7,0,20,13
1746595013380,USP 3,A01,890274,Staff,12,0,30,18
1746595014405,USP 15,A01,890276,Sun; Feiyang,16,0,30,14
1746595015433,USP 25,A00,890277,Shenkman; Michael Thomas,18,0,25,7
1746595016462,USP 138,A00,890278,Staff,13,0,25,12
1746595017487,USP 143,A00,890279,Staff,21,0,70,49
1746595018511,USP 144,A00,890280,Chowdhury; Muhammed Zohir,16,0,30,14
1746595019540,USP 150,A00,890281,Boomhower; Matthew Charles,4,0,30,26
1746595020566,USP 151,A00,890282,Staff,16,0,20,4
1746595021591,USP 162,A00,890283,Andrews; Abigail Leslie,16,0,20,4
1746595022621,USP 168,A00,920477,Kwak; Nancy,0,0,5,5
1746595023646,USP 181,A00,890284,Staff,3,0,20,17
1746595024672,USP 191A,A00,890285,Staff,12,0,20,8
1746595025701,VIS 101,A00,886512,Staff,26,0,75,49
1746595026727,VIS 103,A00,886513,Cruz; Edwin Teddy,61,0,75,14
1746595027751,VIS 108,A00,886514,Staff,4,0,15,11
1746595028779,VIS 127P,A00,886515,Shen; Kuiyi,80,0,146,66
1746595029805,VIS 149,A00,886516,Yoldas; Pinar,0,0,15,15
1746595030893,VIS 164,A00,886526,Erdmann; Dean,19,0,22,3
1746595031921,VIS 194S,A00,886527,Staff,61,0,75,14
1746595032947,WCWP 10A,C00,886484,Martiniuk; Jill,12,0,15,3
1746595033973,WCWP 10B,A00,886490,Uriarte; Emma,0,0,15,15
1746595033973,WCWP 10B,B00,886491,Dhir; Simrita,8,0,15,7
1746595033973,WCWP 10B,C00,886492,Ornelas; Tricia,0,0,15,15
1746595034998,WCWP 100,A00,886494,Young; Mark T,0,6,15,15
1746595037101,AAS 10,A01,886199,Childs; Dennis R.,0,3,0,0
1746595038129,ANAR 104,A01,886940,Shtienberg; Gilad,27,0,30,3
1746595039155,ANAR 120,A00,886953,Staff,13,0,20,7
1746595040181,ANBI 148,A01,886955,Wilder; Linnea Lorene,30,0,40,10
1746595042235,ANSC 122,A00,886957,Staff,24,0,30,6
1746595043260,ANSC 150,A00,886958,Sloane; Julia Kathryn,2,0,15,13
1746595044284,ANSC 156,A00,886959,Jenkins; Janis A.,0,1,15,15
1746595045310,ANSC 180,A00,886960,Staff,11,0,17,6
1746595046336,ANSC 188,A00,886961,Jassal; Aftab,9,0,25,16
1746595047364,ANSC 190,A00,886962,Jassal; Aftab,14,0,25,11
1746595048388,ANSC 191,A00,886963,Staff,18,0,20,2
1746595049416,ANTH 3,A01,891689,Staff,17,0,20,3
1746595050444,ANTH 5,A00,886933,Semendeferi; Ekaterini,16,0,20,4
1746595051469,ANTH 10,A00,886934,Staff,0,12,30,30
1746595052496,ANTH 21,A01,886936,Staff,41,0,60,19
1746595053525,ANTH 23,A01,886938,Staff,92,0,100,8
1746595054553,ANTH 105,A00,886964,Stewart; Alexander B,84,0,100,16
1746595055582,ANTH 108,A00,886965,Pedersen; David,9,0,20,11
1746595056610,AWP 10,001,886147,Staff,0,0,0,0
1746595056610,AWP 10,002,886148,Staff,0,0,0,0
1746595056610,AWP 10,003,886149,Staff,0,0,0,0
1746595056610,AWP 10,004,886150,Staff,0,0,0,0
1746595056610,AWP 10,005,886151,Staff,0,0,0,0
1746595056610,AWP 10,006,886152,Staff,0,0,0,0
1746595056610,AWP 10,007,886153,Staff,0,0,0,0
1746595056610,AWP 10,008,886154,Staff,0,0,0,0
1746595056610,AWP 10,009,886155,Staff,0,0,0,0
1746595056610,AWP 10,010,886156,Staff,0,0,0,0
1746595056610,AWP 10,011,886158,Staff,0,0,0,0
1746595056610,AWP 10,012,886160,Staff,0,0,0,0
1746595056610,AWP 10,013,886161,Staff,0,0,0,0
1746595056610,AWP 10,014,886162,Staff,0,0,0,0
1746595056610,AWP 10,015,886163,Staff,0,0,0,0
1746595056610,AWP 10,016,886164,Staff,0,0,0,0
1746595056610,AWP 10,017,886165,Staff,0,0,0,0
1746595056610,AWP 10,018,886166,Staff,0,0,0,0
1746595056610,AWP 10,019,886168,Staff,0,0,0,0
1746595056610,AWP 10,020,886170,Staff,0,0,0,0
1746595056610,AWP 10,021,886172,Staff,0,0,0,0
1746595057640,AWP 10R,001,886173,Staff,0,1,0,0
1746595057640,AWP 10R,002,886174,Staff,0,1,0,0
1746595057640,AWP 10R,003,886175,Staff,0,0,0,0
1746595057640,AWP 10R,004,886176,Staff,0,0,0,0
1746595057640,AWP 10R,005,886177,Staff,0,0,0,0
1746595057640,AWP 10R,006,886178,Staff,0,0,0,0
1746595057640,AWP 10R,007,886179,Staff,0,0,0,0
1746595057640,AWP 10R,008,886181,Staff,0,0,0,0
1746595057640,AWP 10R,009,886182,Staff,0,0,0,0
1746595057640,AWP 10R,010,886183,Staff,0,0,0,0
1746595057640,AWP 10R,011,886184,Staff,0,0,0,0
1746595057640,AWP 10R,012,886185,Staff,0,0,0,0
1746595057640,AWP 10R,013,886186,Staff,0,0,0,0
1746595057640,AWP 10R,014,886187,Staff,0,0,0,0
1746595057640,AWP 10R,015,886188,Staff,0,0,0,0
1746595057640,AWP 10R,016,886189,Staff,0,0,0,0
1746595057640,AWP 10R,017,960532,Staff,0,0,0,0
1746595057640,AWP 10R,018,960533,Staff,0,0,0,0
1746595057640,AWP 10R,019,960534,Staff,0,0,0,0
1746595057640,AWP 10R,020,960538,Staff,0,0,0,0
1746595057640,AWP 10R,021,960540,Staff,0,0,0,0
1746595057640,AWP 10R,022,960541,Staff,0,0,0,0
1746595057640,AWP 10R,023,960542,Staff,0,0,0,0
1746595057640,AWP 10R,024,960544,Staff,0,0,0,0
1746595057640,AWP 10R,025,960545,Staff,0,0,0,0
1746595057640,AWP 10R,026,960548,Staff,0,0,0,0
1746595058666,AWP 102R,A00,886190,Staff,0,0,0,0
1746595058666,AWP 102R,B00,886191,Staff,0,0,0,0
1746595059694,BENG 100,A01,886193,Staff,17,0,30,13
1746595060721,BENG 122A,A01,886195,Hasty; Jeff M,13,0,30,17
1746595061750,BENG 166A,A00,886196,Sah; Robert Lie-Yuan,0,3,30,30
1746595062780,BENG 190,A00,958050,Khojah; Reem I,17,0,25,8
1746595063807,BIBC 102,A01,894320,Staff,0,1,46,46
1746595063807,BIBC 102,A02,894321,Staff,0,0,46,46
1746595063807,BIBC 102,A03,894344,Staff,6,0,46,40
1746595063807,BIBC 102,A04,894345,Staff,27,0,47,20
1746595064839,BICD 100R,A01,894365,Smith; Laurie,1,3,58,57
1746595064839,BICD 100R,A02,894366,Smith; Laurie,1,5,58,57
1746595064839,BICD 100R,A03,894367,Smith; Laurie,0,0,59,59
1746595064839,BICD 100R,A04,959869,Smith; Laurie,38,0,59,21
1746595065869,BICD 136,A01,894383,Gustafson-Brown; Cindy,14,0,50,36
1746595066898,BIEB 102,A01,894494,Butler; Shannon Rhey,51,0,130,79
1746595068951,BIEB 150,A01,894617,Wills; Christopher,3,0,20,17
1746595068951,BIEB 150,A02,894631,Wills; Christopher,3,0,20,17
1746595068951,BIEB 150,A03,894937,Wills; Christopher,3,0,20,17
1746595068951,BIEB 150,A04,894946,Wills; Christopher,5,0,20,15
1746595069977,BIEB 194,A00,906141,Kurle; Carolyn M.,5,0,20,15
1746595071007,BILD 1,A01,894154,Staff,3,0,19,16
1746595071007,BILD 1,A02,894155,Staff,14,0,19,5
1746595071007,BILD 1,A03,894160,Staff,13,0,19,6
1746595071007,BILD 1,A04,894161,Staff,15,0,18,3
1746595072035,BILD 2,A01,894168,Staff,0,0,50,50
1746595072035,BILD 2,A02,894169,Staff,0,0,50,50
1746595072035,BILD 2,A03,894179,Staff,0,0,50,50
1746595072035,BILD 2,A04,894203,Staff,23,0,50,27
1746595073061,BILD 3,A01,894213,Staff,23,0,31,8
1746595073061,BILD 3,A02,894214,Staff,26,0,31,5
1746595073061,BILD 3,A03,894235,Staff,28,0,31,3
1746595073061,BILD 3,A04,894236,Staff,28,0,32,4
1746595074090,BILD 4,A01,894253,Reuther; Keefe,5,0,24,19
1746595074090,BILD 4,A02,894258,Reuther; Keefe,16,0,24,8
1746595075120,BILD 5,A01,894276,Reuther; Keefe,34,0,50,16
1746595075120,BILD 5,A02,894277,Reuther; Keefe,45,0,50,5
1746595075120,BILD 5,A03,894290,Reuther; Keefe,44,0,50,6
1746595075120,BILD 5,A04,894291,Reuther; Keefe,48,0,50,2
1746595076151,BILD 24,A01,894297,Pirino; Giorgia,40,0,60,20
1746595077176,BIMM 100,B01,958915,Staff,71,0,100,29
1746595078201,BIMM 101,A01,895017,McDonnell; Lisa Marie,0,5,24,24
1746595078201,BIMM 101,A02,895018,McDonnell; Lisa Marie,0,5,24,24
1746595078201,BIMM 101,B01,895020,McDonnell; Lisa Marie,1,6,24,23
1746595078201,BIMM 101,B02,895021,McDonnell; Lisa Marie,0,4,24,24
1746595079227,BIMM 110,A01,895023,Staff,1,0,25,24
1746595079227,BIMM 110,A02,895024,Staff,9,0,25,16
1746595079227,BIMM 110,A03,895025,Staff,18,0,25,7
1746595079227,BIMM 110,A04,895031,Staff,20,0,25,5
1746595080254,BIMM 120,A01,895114,Gustafson-Brown; Cindy,14,0,28,14
1746595080254,BIMM 120,A02,895126,Gustafson-Brown; Cindy,21,0,27,6
1746595081279,BIPN 100,A01,895130,Yang; Mingyu,0,0,38,38
1746595081279,BIPN 100,A02,895131,Yang; Mingyu,31,0,38,7
1746595081279,BIPN 100,A03,895132,Yang; Mingyu,32,0,38,6
1746595081279,BIPN 100,A04,895133,Yang; Mingyu,27,0,36,9
1746595082310,BIPN 120,A01,895135,Cooke; James Edward,0,3,13,13
1746595082310,BIPN 120,A02,895136,Cooke; James Edward,0,1,13,13
1746595082310,BIPN 120,A03,895137,Cooke; James Edward,0,3,13,13
1746595082310,BIPN 120,A04,895156,Cooke; James Edward,0,2,11,11
1746595083336,BIPN 134,A01,895235,Cooke; James Edward,0,1,25,25
1746595083336,BIPN 134,A02,895237,Cooke; James Edward,0,0,25,25
1746595083336,BIPN 134,A03,895240,Cooke; James Edward,2,0,25,23
1746595083336,BIPN 134,A04,895270,Cooke; James Edward,20,0,25,5
1746595084361,BIPN 189,A00,892103,Staff,0,14,14,14
1746595086414,BISP 194,A00,958008,Staff,0,2,0,0
1746595087443,CAT 124,A01,922009,Staff,0,5,20,20
1746595088471,CAT 125R,A00,886390,Morales; Celeste Georgianna,0,3,20,20
1746595088471,CAT 125R,B00,886391,Irwin; Matthew Joseph,0,4,20,20
1746595088471,CAT 125R,C00,886392,Smith; Lauryn Alissa,0,2,20,20
1746595088471,CAT 125R,D00,886393,Vanderschuit; Maya Alysia,0,3,20,20
1746595088471,CAT 125R,E00,886394,Marchisotto; Jennifer Anne,0,3,20,20
1746595089496,CENG 15,A01,886218,Drews; Aaron,3,0,8,5
1746595090523,CENG 113,A00,886219,Opatkiewicz; Justin Paul,15,0,25,10
1746595091549,CGS 101,A00,887044,Staff,7,0,20,13
1746595092578,CGS 105,A01,887046,Staff,14,0,25,11
1746595093603,CGS 112,A00,887047,Cuong; Marisol,12,0,15,3
1746595094630,CGS 113,A00,887048,Staff,23,0,30,7
1746595095655,CGS 120,A00,887049,Staff,10,0,17,7
1746595096684,CHEM 6A,A01,886336,Lam; Tin Yiu,38,0,50,12
1746595096684,CHEM 6A,A02,886338,Lam; Tin Yiu,37,0,50,13
1746595097711,CHEM 6B,A01,886341,Hopkins; Patrycja Anna,16,0,50,34
1746595097711,CHEM 6B,A02,886343,Hopkins; Patrycja Anna,42,0,50,8
1746595098736,CHEM 6C,A01,886346,Albizati; Kim F.,0,2,50,50
1746595098736,CHEM 6C,A02,886348,Albizati; Kim F.,24,0,50,26
1746595099769,CHEM 40A,A01,886352,Klosterman; Jeremy K,65,0,100,35
1746595100793,CHEM 40B,A01,886356,Klosterman; Jeremy K,0,24,100,100
1746595101819,CHEM 41B,A01,886360,Theodorakis; Emmanuel,25,0,50,25
1746595101819,CHEM 41B,A02,886362,Theodorakis; Emmanuel,47,0,50,3
1746595102848,CHIN 165A,A00,886382,Xu; Li,18,0,20,2
1746595103880,CLAS 120,A00,886387,Myerston Santana; Jacobo,33,0,40,7
1746595104907,COGS 9,A01,886967,Shannon; Kyle Michael,42,0,60,18
1746595105935,COGS 11,A01,886969,Staff,9,0,30,21
1746595106963,COGS 14A,A01,886971,Staff,5,0,60,55
1746595107992,COGS 14B,A01,886973,Hoffman; Drew Ellen,4,0,60,56
1746595109018,COGS 18,A01,886975,Morgan; Eric,34,0,60,26
1746595110043,COGS 20,A01,886977,Staff,3,0,8,5
1746595110043,COGS 20,A02,886978,Staff,5,0,7,2
1746595111068,COGS 100,A01,907783,Staff,1,2,30,29
1746595112096,COGS 101B,A01,886980,Staff,0,4,48,48
1746595113127,COGS 101C,A01,886982,Delgado; Tania,0,5,44,44
1746595114155,COGS 102A,A01,886984,Johnson; Christine M.,3,0,30,27
1746595115185,COGS 118B,A01,886986,Staff,1,5,88,87
1746595116213,COGS 150,A01,886988,Bergen; Benjamin,22,0,50,28
1746595117240,COGS 153,A00,886989,Delgado; Tania,0,3,41,41
1746595118268,COGS 186,A01,886991,Staff,0,0,32,32
1746595119300,COGS 187A,A01,886993,Boyle; Mary E. T.,7,0,30,23
1746595120324,COGS 189,A00,886994,Staff,0,1,30,30
1746595121357,COMM 10,A01,886996,Staff,0,0,20,21
1746595121357,COMM 10,A02,886997,Staff,10,0,20,10
1746595121357,COMM 10,A03,959845,Staff,19,0,20,1
1746595122383,COMM 20,A01,886999,Leuning; Grant Maurstad,24,0,40,16
1746595124437,COMM 100A,A01,887002,Staff,0,0,20,25
1746595124437,COMM 100A,A02,887003,Staff,5,0,20,15
1746595125467,COMM 100B,A01,887005,Staff,0,8,20,24
1746595126492,COMM 106D,A00,887006,Staff,13,0,40,27
1746595127521,COMM 110G,A00,887007,Whitworth-Smith; Andrew C,12,0,40,28
1746595128547,COMM 111B,A00,887008,Staff,31,0,40,9
1746595129574,COMM 113T,A00,887009,Abuelhiga; Soraya Jill,28,0,40,12
1746595129574,COMM 113T,B00,906733,Staff,39,0,40,1
1746595130600,COMM 145,A00,887010,Staff,12,0,40,28
1746595131625,COMM 146,A00,887054,Staff,31,0,40,9
1746595132651,COMM 190,A00,887012,Staff,8,0,23,15
1746595133679,CSE 8A,A50,887015,Cao; Yingjun,56,0,85,29
1746595134761,CSE 11,A01,887017,Cao; Yingjun,11,0,70,59
1746595135790,CSE 20,A01,887019,Staff,30,0,50,20
1746595136821,CSE 21,A01,887021,Staff,79,0,100,21
1746595136821,CSE 21,B01,892583,Braun; Oliver,45,0,50,5
1746595137851,CSE 30,A01,887025,Eldon; John,142,0,200,58
1746595138875,CSE 100,A01,887027,Staff,26,0,50,24
1746595138875,CSE 100,A02,887028,Staff,42,0,50,8
1746595139906,CSE 101,A01,887030,Braun; Oliver,74,0,100,26
1746595139906,CSE 101,B01,887032,Jones; Miles E,0,3,50,50
1746595139906,CSE 101,B02,887033,Jones; Miles E,0,2,50,50
1746595140935,CSE 105,A01,908084,Jones; Miles E,32,0,50,18
1746595140935,CSE 105,A02,908087,Jones; Miles E,31,0,50,19
1746595141963,CSE 135,A01,887035,Powell; Thomas Allan,0,5,50,50
1746595142992,CSE 142,A01,887037,Staff,8,0,60,52
1746595144018,CSE 142L,A01,887039,Staff,34,0,60,26
1746595145043,CSE 151A,A01,887041,Solares; Edwin A,47,0,100,53
1746595146070,CSE 175,A01,887043,Kumar; Rakesh,30,0,30,0
1746595147096,CSS 1,A01,886389,Staff,1,2,40,39
1746595148121,DSC 30,A01,908097,Liao; Soohyun Nam,47,0,75,28
1746595149146,DSC 40A,A01,908099,Shannon; Kyle Michael,30,0,50,20
1746595150173,DSC 40B,A01,908112,Staff,15,0,50,35
1746595151202,DSC 80,A01,908116,Staff,19,0,60,41
1746595152226,DSC 197,001,956863,Eldridge; Justin Matthew,9999,0,9999,0
1746595153255,ECE 5,A01,886400,Morris; Karcher William,1,0,6,5
1746595153255,ECE 5,A02,886401,Morris; Karcher William,3,0,6,3
1746595154284,ECE 148,A01,886403,Silberman; Jack,0,14,14,14
1746595155311,ECON 1,A01,887265,Crane; Meredith Helen,11,0,70,59
1746595155311,ECON 1,B01,887268,Staff,42,0,50,8
1746595156339,ECON 2,A01,887273,Crane; Meredith Helen,54,0,70,16
1746595157369,ECON 3,A01,887279,Rondina; Giacomo,31,0,70,39
1746595158395,ECON 4,A01,887282,Anderson; John Charles,0,2,10,10
1746595159424,ECON 5,A01,887285,Staff,34,0,45,11
1746595159424,ECON 5,B01,887292,Staff,41,0,45,4
1746595160454,ECON 100A,A01,887337,Newhouse; Herbert S,54,0,70,16
1746595160454,ECON 100A,B01,887349,Staff,45,0,50,5
1746595161485,ECON 100B,A01,887361,Du; Songzi,29,0,70,41
1746595162510,ECON 100C,A01,887445,Newhouse; Herbert S,59,0,70,11
1746595163537,ECON 105,A00,887488,Vespa; Emanuel Ignacio,23,0,35,12
1746595164565,ECON 109,A01,887506,Shishkin; Denis,28,0,35,7
1746595165591,ECON 110A,A01,887568,Alon; Titan Michael,1,3,35,34
1746595165591,ECON 110A,B01,907601,Alon; Titan Michael,20,0,35,15
1746595166616,ECON 110B,A01,887598,Levkoff; Steven B.,0,24,70,70
1746595167641,ECON 112,A00,887599,Rondina; Giacomo,19,0,35,16
1746595168681,ECON 120A,A01,887603,Dai; Yinlin,35,0,70,35
1746595169713,ECON 120C,A01,887608,Sun; Yixiao,0,1,35,35
1746595169713,ECON 120C,B01,887614,Sun; Yixiao,0,0,35,35
1746595170738,ECON 138,A00,887621,Bharadwaj; Prashant,0,21,20,20
1746595171763,ECON 144,A00,958007,Squires; Dale E,12,0,35,23
1746595172793,ECON 171,A01,907666,Staff,18,0,35,17
1746595173817,ECON 175,A00,887626,Wu; Pak Yeung,22,0,35,13
1746595174847,ECON 190,A00,887640,Vespa; Emanuel Ignacio,22,0,35,13
1746595175876,EDS 25,A01,888197,Staff,0,0,0,0
1746595175876,EDS 25,A02,888209,Staff,0,0,0,0
1746595175876,EDS 25,A03,888210,Staff,0,0,0,0
1746595175876,EDS 25,A04,888212,Staff,0,0,0,0
1746595175876,EDS 25,A05,888213,Staff,0,0,0,0
1746595175876,EDS 25,A06,888214,Staff,0,0,0,0
1746595175876,EDS 25,A07,888235,Staff,0,2,0,0
1746595175876,EDS 25,A08,888236,Staff,0,0,0,0
1746595175876,EDS 25,A09,888240,Staff,0,0,0,0
1746595175876,EDS 25,A10,888244,Staff,0,0,0,0
1746595175876,EDS 25,B01,888273,Staff,0,0,0,0
1746595175876,EDS 25,B02,888285,Staff,0,0,0,0
1746595175876,EDS 25,B03,888423,Staff,0,0,0,1
1746595175876,EDS 25,B04,888432,Staff,0,0,0,0
1746595175876,EDS 25,B05,888433,Staff,0,0,0,0
1746595175876,EDS 25,B06,888467,Staff,0,0,0,0
1746595175876,EDS 25,B07,888468,Staff,0,0,0,0
1746595175876,EDS 25,B08,888479,Staff,0,0,0,0
1746595175876,EDS 25,B09,888484,Staff,0,0,0,0
1746595175876,EDS 25,B10,888487,Staff,0,0,0,0
1746595176902,EDS 38,A01,907700,Choi; Bailey Miyeon,30,0,30,0
1746595177930,EDS 112,A01,888601,Chapman; Thandeka K,12,0,40,28
1746595178955,EDS 115,A00,888697,Mendez; Kathrina Mendoza,10,0,30,20
1746595179982,EDS 116,A01,888893,Staff,33,0,40,7
1746595182035,EDS 124AR,A00,889133,Staff,29,0,50,21
1746595182035,EDS 124AR,B00,907471,Simon; Elizabeth A,37,0,50,13
1746595183061,EDS 124BR,A00,889134,Simon; Elizabeth A,44,0,100,56
1746595184086,EDS 125,A00,889135,Staff,25,0,30,5
1746595185116,EDS 126,A01,889138,Staff,35,0,40,5
1746595186146,EDS 164R,A01,889142,Wishard Guerra; Alison G.,32,0,50,18
1746595187173,ENG 30,A01,886396,Staff,0,0,0,0
1746595187173,ENG 30,B01,886398,Staff,0,0,0,0
1746595188198,ENVR 102,A00,906150,Montejo; Carolina,23,0,25,2
1746595189223,ETHN 103A,A00,887236,Man; Simeon S,0,2,0,0
1746595190254,ETHN 113,A00,887239,Staff,16,0,30,14
1746595191282,ETHN 116,A00,887240,Staff,16,0,25,9
1746595192313,ETHN 117,A00,887241,Choi; Esther Min,28,0,30,2
1746595193341,ETHN 118,A00,887243,Staff,24,0,30,6
1746595194368,ETHN 127,A00,887248,Cuong; Marisol,11,0,15,4
1746595195393,ETHN 139,A00,887250,Staff,7,0,10,3
1746595196418,ETHN 142,A00,887252,Staff,10,0,30,20
1746595197449,ETHN 161,A00,887253,Browne; Errol Tsekani,24,0,30,6
1746595198473,ETHN 163FR,A00,887255,Burelle; Julie Sara Veronique,0,0,5,5
1746595199503,GLBH 20,A00,889149,Elwardani; Nile Regina,8,0,42,34
1746595201558,GLBH 111,A01,889152,Burgos; Jose L.,17,0,17,0
1746595202592,GLBH 150,A00,889181,Sloane; Julia Kathryn,0,5,15,15
1746595204647,HDS 60,A01,886406,Warstadt; Melissa Fawn,72,0,80,8
1746595205685,HIAF 111,A00,889324,Gyamfi; Bright,25,0,32,7
1746595206716,HIEA 131,A00,889328,Staff,15,0,32,17
1746595207743,HIEA 144,A00,889333,Henry; Todd A.,26,0,32,6
1746595208769,HIEA 154,A00,889336,Henry; Todd A.,24,0,32,8
1746595209793,HIEU 106,A00,889339,Staff,22,0,32,10
1746595211850,HIEU 114,A00,889340,Staff,4,0,32,28
1746595212875,HIEU 135GS,A00,889342,Patterson; Patrick H.,0,0,1,24
1746595213901,HIEU 137,A00,889343,Edington; Claire Ellen,10,0,25,15
1746595214926,HIEU 148,A00,889345,Staff,14,0,32,18
1746595215952,HIEU 154,A00,889346,Biess; Frank Peter,21,0,32,11
1746595216977,HILA 102,A00,889351,Staff,12,0,32,20
1746595218006,HILD 2A,A01,889221,Lewandoski; Julia Mavis,2,10,32,30
1746595219036,HILD 7B,A01,889225,Man; Simeon S,0,12,32,32
1746595220061,HILD 7C,A01,889288,Alvarez; Luis A,0,14,32,32
1746595221087,HILD 30,A01,889323,Staff,0,5,32,32
1746595223140,HISC 119,A00,889383,Golan; Tal,20,0,32,12
1746595224169,HIUS 103,A00,889384,Man; Simeon S,0,0,32,32
1746595225195,HIUS 117,A00,919797,Kwak; Nancy,18,0,32,14
1746595226220,HIUS 142A,A00,919788,Staff,22,0,32,10
1746595228274,HIUS 149,A00,889386,Gyamfi; Bright,26,0,32,6
1746595229302,HIUS 155,A00,889387,Alvarez; Luis A,15,0,32,17
1746595230331,HUM 3,A01,886499,Caldwell; Michael Alan,19,0,50,31
1746595231358,HUM 3GS,A00,886500,Rodriguez; Bretton Sigfred,0,0,0,28
1746595232383,HUM 3R,A01,886502,Markman; Kristina,0,36,50,50
1746595233412,HUM 4,A01,886504,Crum; Matthew Stephen,23,0,50,27
1746595233412,HUM 4,B01,886506,West; Geoffrey Scott,17,0,50,33
1746595234440,HUM 4GS,A00,886507,Staff,0,0,0,19
1746595235471,HUM 5,A01,886509,Staff,31,0,50,19
1746595236496,HUM 5R,A01,886511,Zavodny; Tatiana Sophia,0,39,50,50
1746595237525,JAPN 180,A00,886407,Staff,16,0,40,24
1746595238595,LATI 50,A01,886409,Martin-Cabrera; Luis,3,0,22,19
1746595238595,LATI 50,A02,886410,Martin-Cabrera; Luis,19,0,22,3
1746595238595,LATI 50,A03,886411,Martin-Cabrera; Luis,21,0,22,1
1746595238595,LATI 50,A04,886412,Martin-Cabrera; Luis,8,0,22,14
1746595239620,LAWS 101,A00,907664,Staff,28,0,60,32
1746595240646,LIAB 1A,A00,889388,Saab; Dima,17,0,20,3
1746595241670,LIAB 1AX,A00,889389,El Cheddadi; Youniss,18,0,20,2
1746595242703,LIFR 1C,A00,889391,Van Moer; Vinciane G,8,0,20,12
1746595243728,LIFR 1CX,A00,889392,Van Moer; Vinciane G,7,0,20,13
1746595244753,LIFR 1D,A00,889393,Van Moer; Vinciane G,7,0,20,13
1746595245778,LIFR 1DX,A00,889394,Van Moer; Vinciane G,8,0,20,12
1746595246804,LIGN 7,A00,886923,Staff,25,0,50,25
1746595247830,LIGN 17,A00,886924,Kehler; Andrew Scott,126,0,150,24
1746595248857,LTAM 110,A00,889395,Staff,15,0,30,15
1746595249883,LTAM 110GS,A00,958010,Rodriguez; Bretton Sigfred,0,0,0,28
1746595250911,LTCH 101,A00,889397,Staff,23,0,25,2
1746595251937,LTCS 130,A00,889398,Staff,23,0,25,2
1746595252962,LTEA 138,A00,889399,Staff,24,0,40,16
1746595253991,LTEN 149,A00,889400,Wesling; Megan E.,0,3,25,25
1746595255017,LTEN 169,A00,889401,Staff,20,0,25,5
1746595256045,LTEN 180,A00,889402,Staff,10,0,15,5
1746595257072,LTEN 181,A00,889403,Staff,21,0,25,4
1746595258101,LTWL 100,A00,889404,Myerston Santana; Jacobo,2,0,25,23
1746595259129,LTWL 180GS,A00,889405,Staff,0,0,20,20
1746595260155,LTWL 181,A00,889406,Staff,16,0,25,9
1746595261180,LTWL 184,A00,889475,Mukherjee; Silpa,22,0,25,3
1746595262233,LTWR 102C,A00,889486,Staff,29,0,30,1
1746595263259,LTWR 115W,A00,889491,Staff,0,2,15,15
1746595264297,MAE 8,A01,886905,Staff,0,2,0,0
1746595265322,MAE 11,A00,886906,Bandaru; Prabhakar,0,7,50,50
1746595266353,MAE 20,A00,886907,Evdokimenko; Ekaterina,43,0,70,27
1746595267381,MAE 30B,A00,886909,Ghazinejad; Maziar,25,0,45,20
1746595268408,MAE 101B,A00,886910,Saintillan; David,30,0,45,15
1746595269436,MAE 105,A00,886911,Bandaru; Prabhakar,18,0,50,32
1746595270466,MAE 107,B00,958024,Staff,7,0,50,43
1746595271494,MAE 143B,A00,886913,Bewley; Thomas R,2,0,40,38
1746595272518,MAE 148,A01,886915,Silberman; Jack,0,3,14,14
1746595273548,MAE 160,A00,886916,Evdokimenko; Ekaterina,31,0,60,29
1746595274574,MATH 3C,A01,889681,Staff,0,2,30,30
1746595274574,MATH 3C,A02,960048,Staff,23,0,30,7
1746595275601,MATH 10A,A01,889760,Staff,26,0,30,4
1746595275601,MATH 10A,A02,889783,Staff,29,0,30,1
1746595276628,MATH 10B,A01,889785,Verstraete; Jacques Allan,1,0,35,34
1746595276628,MATH 10B,A02,889795,Verstraete; Jacques Allan,4,0,35,31
1746595276628,MATH 10B,B01,889797,Verstraete; Jacques Allan,3,0,35,32
1746595276628,MATH 10B,B02,889828,Verstraete; Jacques Allan,3,0,35,32
1746595277659,MATH 10C,A01,889849,Habib; Yousaf,8,0,30,22
1746595277659,MATH 10C,A02,889852,Habib; Yousaf,14,0,30,16
1746595277659,MATH 10C,A03,889853,Habib; Yousaf,22,0,30,8
1746595277659,MATH 10C,A04,889858,Habib; Yousaf,20,0,30,10
1746595277659,MATH 10C,B01,889861,Staff,1,0,30,29
1746595277659,MATH 10C,B02,889862,Staff,24,0,30,6
1746595277659,MATH 10C,B03,889863,Staff,27,0,30,3
1746595277659,MATH 10C,B04,889967,Staff,23,0,30,7
1746595278688,MATH 18,A01,889974,Staff,7,0,30,23
1746595278688,MATH 18,A02,889977,Staff,20,0,30,10
1746595278688,MATH 18,B01,889984,Hardiman; Liam,20,0,30,10
1746595278688,MATH 18,B02,889985,Hardiman; Liam,25,0,30,5
1746595279717,MATH 20A,A01,889990,Suk; Andrew Hoon,30,0,35,5
1746595280743,MATH 20B,A01,889993,Ohm; Ko Woon,21,0,30,9
1746595280743,MATH 20B,A02,889994,Ohm; Ko Woon,30,0,30,0
1746595280743,MATH 20B,B01,889996,Ohm; Ko Woon,22,0,30,8
1746595280743,MATH 20B,B02,889997,Ohm; Ko Woon,23,0,30,7
1746595281773,MATH 20C,A01,889999,Hammock; Frances H,17,0,30,13
1746595281773,MATH 20C,A02,890003,Hammock; Frances H,23,0,30,7
1746595281773,MATH 20C,B01,890006,Hammock; Frances H,3,0,30,27
1746595281773,MATH 20C,B02,890007,Hammock; Frances H,12,0,30,18
1746595282797,MATH 20D,A01,890011,Cheng; Hsiao-Bing,1,1,30,29
1746595282797,MATH 20D,A02,890012,Cheng; Hsiao-Bing,14,0,30,16
1746595282797,MATH 20D,B01,890016,Cheng; Hsiao-Bing,13,0,30,17
1746595282797,MATH 20D,B02,890017,Cheng; Hsiao-Bing,13,0,30,17
1746595283826,MATH 20E,A01,890026,Harel; Guershon,1,0,30,29
1746595283826,MATH 20E,A02,890029,Harel; Guershon,22,0,30,8
1746595283826,MATH 20E,B01,890033,Harel; Guershon,7,0,30,23
1746595283826,MATH 20E,B02,890101,Harel; Guershon,21,0,30,9
1746595284851,MATH 102,A01,890104,Staff,18,0,30,12
1746595284851,MATH 102,A02,890105,Staff,27,0,30,3
1746595285877,MATH 103B,A01,890116,Salehi Golsefidy; Alireza,3,0,30,27
1746595285877,MATH 103B,B01,890118,Staff,0,3,34,34
1746595286904,MATH 109,A01,890121,Aliabadi Sr.; Mohsen,0,0,30,30
1746595286904,MATH 109,B01,890124,Upadrashta; Pranav Kumar,18,0,30,12
1746595287930,MATH 120A,A01,890126,Eggers; John Dietrich,13,0,30,17
1746595288959,MATH 142B,A01,890128,Ioana; Adrian,19,0,30,11
1746595288959,MATH 142B,A02,890129,Ioana; Adrian,12,0,30,18
1746595289988,MATH 154,A01,890174,Staff,0,1,30,30
1746595289988,MATH 154,A02,890182,Staff,0,0,30,30
1746595291018,MATH 168A,A01,890197,Dumitriu; Ioana,21,0,35,14
1746595292048,MATH 170A,A01,890240,Nie; Jiawang,1,0,30,29
1746595292048,MATH 170A,A02,890241,Nie; Jiawang,11,0,30,19
1746595292048,MATH 170A,A03,890249,Nie; Jiawang,23,0,30,7
1746595293079,MATH 170B,A01,957891,Nag; Panchali,13,0,35,22
1746595295130,MATH 181A,A01,908025,Staff,0,3,35,35
1746595295130,MATH 181A,A02,960115,Staff,26,0,35,9
1746595296155,MATH 181B,A01,959874,Staff,24,0,30,6
1746595297183,MATH 193B,A01,890265,Staff,0,4,35,35
1746595298212,MGT 4,A01,890311,Anderson; John Charles,42,0,88,46
1746595299240,MGT 5,A00,907740,Staff,12,0,98,86
1746595300271,MGT 12,A00,890312,Lindenberger; Wade Douglas,67,0,98,31
1746595301299,MGT 16,A00,957883,Staff,78,0,98,20
1746595303358,MGT 45,A00,890314,Pecore; Joseph P.,45,0,98,53
1746595304387,MGT 71,A00,890315,Staff,0,12,98,98
1746595305412,MGT 100,A00,890316,Yavorsky; Daniel Ryan,44,0,98,54
1746595306440,MGT 103,A00,890317,Ehrich; Kristine R,73,0,98,25
1746595307466,MGT 105,A00,890356,Bates; Kenneth Walter,0,8,98,98
1746595308497,MGT 112,A00,890360,Ehrich; Kristine R,55,0,98,43
1746595309524,MGT 127R,A00,907732,Zhu; Kevin Xiaoguo,23,0,98,75
1746595310550,MGT 131B,A00,890361,Anderson; John Charles,59,0,98,39
1746595311574,MGT 137,A00,890362,Lindenberger; Wade Douglas,65,0,98,33
1746595312600,MGT 160,A00,890369,Johnson; Erik Barry,9,0,98,89
1746595314654,MGT 164,A00,890372,Zimmermann; Carsten,0,40,98,98
1746595315684,MGT 180,A00,890374,Bliss; Barbara Ann,11,0,98,87
1746595316710,MMW 15,A01,886414,Chang; Edmond Yi-Teh,0,12,28,28
1746595316710,MMW 15,A02,886415,Chang; Edmond Yi-Teh,0,8,28,28
1746595316710,MMW 15,A03,886416,Chang; Edmond Yi-Teh,0,9,28,28
1746595316710,MMW 15,A04,886417,Chang; Edmond Yi-Teh,0,8,28,28
1746595316710,MMW 15,B01,886419,Chang; Edmond Yi-Teh,0,7,28,28
1746595316710,MMW 15,B02,886420,Chang; Edmond Yi-Teh,0,7,28,28
1746595316710,MMW 15,B03,886421,Chang; Edmond Yi-Teh,0,7,28,28
1746595316710,MMW 15,B04,886422,Chang; Edmond Yi-Teh,0,8,28,28
1746595316710,MMW 15,C01,886424,Staff,0,9,28,28
1746595316710,MMW 15,C02,886425,Staff,0,8,28,28
1746595316710,MMW 15,C03,886426,Staff,0,8,28,28
1746595316710,MMW 15,C04,886427,Staff,0,8,28,28
1746595316710,MMW 15,C05,958038,Staff,0,8,28,28
1746595316710,MMW 15,C06,958039,Staff,1,8,28,27
1746595317736,MMW 15GS,A00,906910,Patterson; Patrick H.,4,0,28,24
1746595318763,MMW 122R,A01,886429,Rahimi; Babak,0,13,28,28
1746595318763,MMW 122R,A02,886430,Rahimi; Babak,0,12,28,28
1746595318763,MMW 122R,A03,958040,Rahimi; Babak,0,11,28,28
1746595319790,MUS 1A,A01,890937,Staff,2,0,25,23
1746595319790,MUS 1A,A02,891035,Staff,6,0,25,19
1746595319790,MUS 1A,C01,958912,Staff,24,0,25,1
1746595319790,MUS 1A,C02,958913,Staff,25,0,25,0
1746595321843,MUS 2AK,A00,957092,Ohnishi; Takae,15,0,15,0
1746595322869,MUS 4,A01,891044,Staff,0,0,25,25
1746595322869,MUS 4,A02,891045,Staff,22,0,25,3
1746595322869,MUS 4,B01,891048,Staff,17,0,25,8
1746595322869,MUS 4,B02,891050,Staff,25,0,25,0
1746595323900,MUS 5,A01,957506,Dubnov; Shlomo,0,0,25,25
1746595323900,MUS 5,A02,957622,Dubnov; Shlomo,13,0,25,12
1746595323900,MUS 5,A03,957623,Dubnov; Shlomo,20,0,25,5
1746595324929,MUS 6,A01,891053,Freitas Caetano; Marcelo,24,0,25,1
1746595324929,MUS 6,A02,891054,Freitas Caetano; Marcelo,23,0,25,2
1746595325954,MUS 7,A01,891081,Staff,0,0,25,25
1746595325954,MUS 7,A02,891082,Staff,3,0,25,22
1746595326983,MUS 8GS,A00,891118,Borgo; David Garcia,1,0,25,24
1746595328011,MUS 11,A01,891140,Staff,8,0,25,17
1746595328011,MUS 11,A02,891141,Staff,21,0,25,4
1746595329037,MUS 13,A01,891143,Staff,8,0,25,17
1746595329037,MUS 13,A02,891144,Staff,24,0,25,1
1746595330063,MUS 15,A01,891146,Staff,9,0,25,16
1746595330063,MUS 15,A02,891148,Staff,21,0,25,4
1746595330063,MUS 15,B01,891150,Staff,18,0,25,7
1746595330063,MUS 15,B02,891151,Staff,25,0,25,0
1746595331089,MUS 20,A01,891153,Staff,5,0,20,15
1746595331089,MUS 20,A02,891155,Staff,14,0,20,6
1746595332118,MUS 80,A00,891156,Staff,19,0,25,6
1746595332118,MUS 80,B00,891157,Staff,23,0,25,2
1746595333144,MUS 130,A00,891158,Ohnishi; Takae,35,0,35,0
1746595334170,MUS 150GS,A01,891160,Borgo; David Garcia,1,0,25,24
1746595335196,MUS 170,A01,891162,Freitas Caetano; Marcelo,20,0,25,5
1746595335196,MUS 170,A02,891164,Freitas Caetano; Marcelo,21,0,25,4
1746595336220,NANO 11,A00,886220,Vazquez Mena; Oscar,13,0,15,2
1746595337245,NANO 15,A01,886222,Drews; Aaron,4,0,7,3
1746595338271,NANO 104,A00,886224,Sirbuly; Donald,17,0,25,8
1746595339295,PH 40,A00,886528,Staff,23,0,40,17
1746595340321,PH 45,A01,886799,Staff,35,0,40,5
1746595341347,PH 110,A00,886802,Staff,0,6,40,40
1746595342430,PH 172,A00,906716,Staff,19,0,35,16
1746595343455,PH 191,A00,886803,Staff,6,0,40,34
1746595344480,PHIL 1,A00,889500,Staff,20,0,30,10
1746595345508,PHIL 10,A01,889549,Grush; Rick Scott,16,0,22,6
1746595345508,PHIL 10,A02,889551,Grush; Rick Scott,22,0,22,0
1746595346534,PHIL 28,A01,889559,Lamey; Andy M.,0,2,31,31
1746595346534,PHIL 28,A02,889561,Lamey; Andy M.,0,1,30,30
1746595346534,PHIL 28,A03,889572,Lamey; Andy M.,0,1,30,30
1746595347563,PHIL 35,A00,907839,Staff,13,0,15,2
1746595348589,PHIL 60,A00,889574,Staff,73,0,90,17
1746595349614,PHIL 101,A00,958004,Staff,12,0,15,3
1746595351669,PHIL 136,A00,889582,Fulkerson; Matthew Todd,26,0,45,19
1746595352695,PHIL 163,A01,889601,Staff,21,0,30,9
1746595352695,PHIL 163,B01,889606,Brandt; Reuven A,0,3,0,0
1746595353724,PHIL 164,A00,889610,Staff,16,0,30,14
1746595354751,PHIL 165,A00,889613,Staff,22,0,30,8
1746595355778,PHYS 1A,A00,886431,Staff,30,0,70,40
1746595356808,PHYS 1AL,001,886432,Tsai; Philbert S,1,2,30,29
1746595356808,PHYS 1AL,002,886436,Tsai; Philbert S,13,0,30,17
1746595357836,PHYS 1B,A00,886439,Staff,184,0,240,56
1746595358864,PHYS 1BL,001,886441,Tsai; Philbert S,0,4,30,30
1746595358864,PHYS 1BL,002,886444,Tsai; Philbert S,2,0,30,28
1746595359893,PHYS 1C,A00,896092,Arnold; Kam S,78,0,146,68
1746595360924,PHYS 1CL,001,886448,Tsai; Philbert S,0,0,30,30
1746595360924,PHYS 1CL,002,886449,Tsai; Philbert S,1,0,30,29
1746595360924,PHYS 1CL,003,886450,Tsai; Philbert S,16,0,30,14
1746595360924,PHYS 1CL,004,886451,Tsai; Philbert S,15,0,30,15
1746595361950,PHYS 2B,A01,886457,Staff,67,0,115,48
1746595362977,PHYS 2C,A01,886460,Shotwell; Brian,0,9,65,65
1746595364003,PHYS 2CL,A01,886467,Staff,0,4,28,28
1746595364003,PHYS 2CL,A02,886468,Staff,0,3,28,28
1746595365033,PHYS 2D,A01,886470,Staff,10,0,50,40
1746595366060,PHYS 4B,A01,886475,Grinstein; Benjamin,22,0,40,18
1746595367086,POLI 5,A00,891173,Desposato; Scott,7,0,25,18
1746595368114,POLI 5D,A01,891175,Staff,5,0,5,0
1746595368114,POLI 5D,B01,891178,Staff,5,0,5,0
1746595369142,POLI 11,A00,891179,Ferree; Karen E,1,0,35,34
1746595370167,POLI 12,A00,891180,Staff,15,0,30,15
1746595371194,POLI 27,A01,891182,Staff,12,0,75,63
1746595372221,POLI 30,A00,891183,Staff,8,0,50,42
1746595373245,POLI 100B,A00,891244,Staff,5,1,35,30
1746595374273,POLI 100I,A00,891247,Staff,7,0,30,23
1746595375297,POLI 104J,A00,891248,Nichter; Maysa,14,0,30,16
1746595376322,POLI 104U,A00,891250,Nichter; Maysa,1,0,30,29
1746595378376,POLI 110B,A00,891255,Wiens; David,19,0,25,6
1746595379404,POLI 112A,A00,891256,Wiens; David,6,0,25,19
1746595380430,POLI 114BR,A00,891261,Staff,19,0,30,11
1746595381454,POLI 117R,A00,891262,Forman; Fonna,0,6,50,50
1746595382485,POLI 118,A00,891264,Ingham; Sean,17,0,25,8
1746595383513,POLI 124A,A00,891265,Staff,18,0,20,2
1746595384538,POLI 125D,A00,891266,Nichter; Simeon C,2,0,25,23
1746595385563,POLI 126,A00,891268,Nichter; Simeon C,7,0,25,18
1746595386588,POLI 126AA,A00,891272,Staff,15,0,25,10
1746595387617,POLI 130AA,A00,891273,Staff,15,0,20,5
1746595388647,POLI 134AA,A00,891274,Staff,4,0,20,16
1746595390696,POLI 138,A00,891278,Staff,21,0,25,4
1746595391722,POLI 142K,A00,891280,Staff,10,0,25,15
1746595392749,POLI 142M,A00,891281,Gartzke; Erik,16,0,30,14
1746595393774,POLI 142P,A00,891284,Staff,20,0,30,10
1746595394803,POLI 143,A00,891285,Gartzke; Erik,12,0,30,18
1746595395829,POLI 153,A00,891286,Staff,19,0,20,1
1746595397882,POLI 175,A00,891290,Staff,15,0,20,5
1746595398910,PSYC 1,A00,890674,Steiner; Eric Tomas,0,11,45,45
1746595399937,PSYC 2,A00,890676,Albright; Thomas D,20,0,35,15
1746595400963,PSYC 3,A00,890679,Staff,17,0,20,3
1746595401991,PSYC 6,A00,959858,Staff,19,0,20,1
1746595403016,PSYC 60,A01,890684,Rickard; Timothy C.,0,6,45,45
1746595404045,PSYC 70,A01,890689,Geller; Emma Harlan,6,0,30,24
1746595405072,PSYC 71,A01,959860,Staff,21,0,25,4
1746595406103,PSYC 100,A00,890690,Lacefield; Katharine I,0,50,180,180
1746595407131,PSYC 102,A00,890695,Staff,18,0,40,22
1746595408157,PSYC 105,A00,890699,Geller; Emma Harlan,70,0,100,30
1746595409182,PSYC 106,A00,890701,Gorman; Michael R.,5,0,30,25
1746595410211,PSYC 108,A00,890704,Adrian; Julia Anna,0,29,50,50
1746595411239,PSYC 118,A01,890712,Staff,11,0,30,19
1746595412267,PSYC 124,A00,890716,Chapman; Eddie Nathaniel,25,0,60,35
1746595413291,PSYC 131,A00,890717,Anagnostaras; Stephan,0,7,80,80
1746595414321,PSYC 137,A00,890719,Winkielman; Piotr,0,11,30,30
1746595415350,PSYC 144,A00,890721,Adrian; Julia Anna,0,9,45,45
1746595416379,PSYC 162,A00,890805,Staff,0,1,75,75
1746595417406,PSYC 169,A00,890810,Staff,0,15,30,30
1746595418433,PSYC 172,A00,890814,Gorman; Michael R.,9,0,30,21
1746595419458,PSYC 181,A00,890818,Anagnostaras; Stephan,7,0,200,193
1746595420484,PSYC 184,A00,959861,Staff,163,0,175,12
1746595421512,PSYC 189,A00,890823,Staff,0,2,30,30
1746595422537,PSYC 191,A00,890884,Rickard; Timothy C.,0,12,35,35
1746595423567,PSYC 193,A00,890913,Staff,19,0,30,11
1746595423567,PSYC 193,B00,890914,Chapman; Eddie Nathaniel,24,0,30,6
1746595424594,PSYC 193L,A01,890918,Lowe; Angela Beth,20,0,30,10
1746595424594,PSYC 193L,B01,890921,Hurwitz; Ethan Scott,20,0,30,10
1746595424594,PSYC 193L,C01,890928,Staff,30,0,30,0
1746595425619,RELI 149,A00,886806,Rahimi; Babak,23,0,40,17
1746595426645,SE 9,A01,886814,Staff,7,0,20,13
1746595427673,SE 101B,A01,886816,Chadha; Mayank,3,0,35,32
1746595428700,SE 110B,A00,886818,Zhu; Qiang,4,0,75,71
1746595429729,SE 125,A01,886830,Staff,10,0,30,20
1746595430759,SE 130B,A01,886835,Staff,14,0,40,26
1746595431789,SE 131A,A01,886838,Krysl; Petr,34,0,55,21
1746595432815,SE 154,A00,886840,Staff,28,0,50,22
1746595433840,SE 164GS,A01,886849,Staff,6,0,20,14
1746595434868,SE 167GS,A01,886853,Staff,6,0,20,14
1746595435897,SIO 25,A01,890107,Staff,19,0,30,11
1746595436922,SIO 45,A00,890109,Cook; Geoffrey W,116,0,200,84
1746595437948,SIO 109R,A00,890110,Forman; Fonna,0,16,20,20
1746595438974,SIO 187,A01,890114,Kacev; David,15,0,40,25
1746595439999,SOCI 1,A01,890431,Thorpe; Charles Robert,14,0,30,16
1746595439999,SOCI 1,A02,890518,Thorpe; Charles Robert,30,0,30,0
1746595441026,SOCI 2,A01,957978,Staff,25,0,25,0
1746595441026,SOCI 2,A02,957979,Staff,23,0,25,2
1746595442055,SOCI 20,A01,890523,Calderon-Zaks; Michael Aar,21,0,30,9
1746595442055,SOCI 20,A02,890526,Calderon-Zaks; Michael Aar,29,0,30,1
1746595443084,SOCI 30,A01,890533,Pardo Guerra; Juan Pablo,37,0,40,3
1746595444111,SOCI 40,A01,890535,Staff,27,0,45,18
1746595445140,SOCI 104Q,A00,890559,Staff,18,0,30,12
1746595446204,SOCI 106,A00,890560,Arnal; Maud Marie Leonie,20,0,30,10
1746595447230,SOCI 110,A00,890567,Holkenbrink-Monk; Charlene,19,0,30,11
1746595448259,SOCI 112,A00,890568,Victoria Torres; Pablo,2,0,55,53
1746595449284,SOCI 115,A00,890597,Arnal; Maud Marie Leonie,28,0,45,17
1746595451340,SOCI 121,A00,890604,Pardo Guerra; Juan Pablo,38,0,45,7
1746595452369,SOCI 126,A01,890608,Staff,8,0,10,2
1746595453397,SOCI 127,A00,890609,Staff,18,0,30,12
1746595454422,SOCI 131,A00,890610,Thorpe; Charles Robert,37,0,45,8
1746595455448,SOCI 135,A00,890615,Payne; Christine Anna,14,0,45,31
1746595456477,SOCI 139,A00,890620,Staff,38,0,45,7
1746595457503,SOCI 148E,A00,890622,Calderon-Zaks; Michael Aar,36,0,45,9
1746595458529,SOCI 150,A00,890623,Kohler; Kristopher M.,31,0,45,14
1746595459553,SOCI 157,A00,890625,Jules-Rosette; Bennetta W.,18,0,20,2
1746595460578,SOCI 160,A00,890627,Payne; Christine Anna,21,0,45,24
1746595461607,SYN 1,A00,886855,Fish; Gwendolyn Anne,0,1,0,0
1746595461607,SYN 1,B00,906086,Fish; Gwendolyn Anne,0,2,0,2
1746595462632,SYN 2R,A00,886860,Staff,0,17,15,15
1746595462632,SYN 2R,B00,906106,Atkinson; Arthur Laird,0,16,15,15
1746595463662,SYN 100,A01,886866,Browne; Emily,0,28,20,20
1746595463662,SYN 100,B01,906128,Rock; Martin,0,4,20,20
1746595463662,SYN 100,C01,906140,Deavenport; James Cary,0,4,20,20
1746595463662,SYN 100,D01,907816,Deavenport; James Cary,0,5,20,20
1746595464687,TDAC 1,A00,890286,Walsh; Kim C.,7,0,20,13
1746595465711,TDAC 101,A00,890296,Basso; Beatrice,15,0,20,5
1746595466738,TDDE 131,A00,890297,Staff,47,0,50,3
1746595467764,TDDM 1,A00,890287,Weinberg; Sadie,25,0,30,5
1746595468791,TDGE 11,A00,890288,Fulton; Julia,138,0,200,62
1746595468791,TDGE 11,B00,890289,Castro; Robert Jess,185,0,200,15
1746595469817,TDGE 25,B00,957359,Walsh; Kim C.,5,0,20,15
1746595470846,TDGE 40,A01,890292,Power; Jade Yukana,26,0,30,4
1746595471873,TDGE 124,A00,890298,Havis; Allan,0,2,50,50
1746595472897,TDGE 131R,A00,890299,Burelle; Julie Sara Veronique,15,0,42,27
1746595473924,TDHT 101,A00,890300,Staff,10,0,20,10
1746595474951,TDHT 109,A01,890302,Anderson; Mysia Anyse,31,0,40,9
1746595475979,TDMV 1,A00,890293,Arcidiacono; Kristin,18,0,30,12
1746595477007,TDMV 2,A00,890294,Weinberg; Sadie,23,0,30,7
1746595478033,TDMV 3,A00,957878,Arcidiacono; Kristin,28,0,30,2
1746595480087,TDMV 138,A00,890304,Jun; Grace Shin Hae,25,0,40,15
1746595481116,TDMV 140,A00,890305,Corrales; Joseph Bernales,25,0,30,5
1746595482142,TDMV 142,A00,890307,Caligagan; Tony,32,0,40,8
1746595483167,TDMV 144,A00,890308,Camaya; Michelle Ann,25,0,30,5
1746595484195,TDPW 1,A00,890295,Stein; Deborah Isobel,3,0,20,17
1746595485221,USP 2,A01,890272,Lerner; Amy M,7,0,20,13
1746595486245,USP 3,A01,890274,Staff,12,0,30,18
1746595487271,USP 15,A01,890276,Sun; Feiyang,16,0,30,14
1746595488296,USP 25,A00,890277,Shenkman; Michael Thomas,18,0,25,7
1746595489322,USP 138,A00,890278,Staff,13,0,25,12
1746595490350,USP 143,A00,890279,Staff,21,0,70,49
1746595491378,USP 144,A00,890280,Chowdhury; Muhammed Zohir,16,0,30,14
1746595492417,USP 150,A00,890281,Boomhower; Matthew Charles,4,0,30,26
1746595493443,USP 151,A00,890282,Staff,16,0,20,4
1746595494470,USP 162,A00,890283,Andrews; Abigail Leslie,16,0,20,4
1746595495495,USP 168,A00,920477,Kwak; Nancy,0,0,5,5
1746595496523,USP 181,A00,890284,Staff,3,0,20,17
1746595497550,USP 191A,A00,890285,Staff,12,0,20,8
1746595498576,VIS 101,A00,886512,Staff,26,0,75,49
1746595499602,VIS 103,A00,886513,Cruz; Edwin Teddy,61,0,75,14
1746595500628,VIS 108,A00,886514,Staff,4,0,15,11
1746595501654,VIS 127P,A00,886515,Shen; Kuiyi,80,0,146,66
1746595502685,VIS 149,A00,886516,Yoldas; Pinar,0,0,15,15
1746595503714,VIS 164,A00,886526,Erdmann; Dean,19,0,22,3
1746595504742,VIS 194S,A00,886527,Staff,61,0,75,14
1746595505766,WCWP 10A,C00,886484,Martiniuk; Jill,12,0,15,3
1746595506792,WCWP 10B,A00,886490,Uriarte; Emma,0,0,15,15
1746595506792,WCWP 10B,B00,886491,Dhir; Simrita,8,0,15,7
1746595506792,WCWP 10B,C00,886492,Ornelas; Tricia,0,0,15,15
1746595507822,WCWP 100,A00,886494,Young; Mark T,0,6,15,15
1746595509938,AAS 10,A01,886199,Childs; Dennis R.,0,3,0,0
1746595510965,ANAR 104,A01,886940,Shtienberg; Gilad,27,0,30,3
1746595511990,ANAR 120,A00,886953,Staff,13,0,20,7
1746595513016,ANBI 148,A01,886955,Wilder; Linnea Lorene,30,0,40,10
1746595515075,ANSC 122,A00,886957,Staff,24,0,30,6
1746595516101,ANSC 150,A00,886958,Sloane; Julia Kathryn,2,0,15,13
1746595517126,ANSC 156,A00,886959,Jenkins; Janis A.,0,1,15,15
1746595518150,ANSC 180,A00,886960,Staff,11,0,17,6
1746595519179,ANSC 188,A00,886961,Jassal; Aftab,9,0,25,16
1746595520209,ANSC 190,A00,886962,Jassal; Aftab,14,0,25,11
1746595521236,ANSC 191,A00,886963,Staff,18,0,20,2
1746595522261,ANTH 3,A01,891689,Staff,17,0,20,3
1746595523291,ANTH 5,A00,886933,Semendeferi; Ekaterini,16,0,20,4
1746595524320,ANTH 10,A00,886934,Staff,0,12,30,30
1746595525345,ANTH 21,A01,886936,Staff,41,0,60,19
1746595526371,ANTH 23,A01,886938,Staff,92,0,100,8
1746595527395,ANTH 105,A00,886964,Stewart; Alexander B,84,0,100,16
1746595528421,ANTH 108,A00,886965,Pedersen; David,9,0,20,11
1746595529449,AWP 10,001,886147,Staff,0,0,0,0
1746595529449,AWP 10,002,886148,Staff,0,0,0,0
1746595529449,AWP 10,003,886149,Staff,0,0,0,0
1746595529449,AWP 10,004,886150,Staff,0,0,0,0
1746595529449,AWP 10,005,886151,Staff,0,0,0,0
1746595529449,AWP 10,006,886152,Staff,0,0,0,0
1746595529449,AWP 10,007,886153,Staff,0,0,0,0
1746595529449,AWP 10,008,886154,Staff,0,0,0,0
1746595529449,AWP 10,009,886155,Staff,0,0,0,0
1746595529449,AWP 10,010,886156,Staff,0,0,0,0
1746595529449,AWP 10,011,886158,Staff,0,0,0,0
1746595529449,AWP 10,012,886160,Staff,0,0,0,0
1746595529449,AWP 10,013,886161,Staff,0,0,0,0
1746595529449,AWP 10,014,886162,Staff,0,0,0,0
1746595529449,AWP 10,015,886163,Staff,0,0,0,0
1746595529449,AWP 10,016,886164,Staff,0,0,0,0
1746595529449,AWP 10,017,886165,Staff,0,0,0,0
1746595529449,AWP 10,018,886166,Staff,0,0,0,0
1746595529449,AWP 10,019,886168,Staff,0,0,0,0
1746595529449,AWP 10,020,886170,Staff,0,0,0,0
1746595529449,AWP 10,021,886172,Staff,0,0,0,0
1746595530478,AWP 10R,001,886173,Staff,0,1,0,0
1746595530478,AWP 10R,002,886174,Staff,0,1,0,0
1746595530478,AWP 10R,003,886175,Staff,0,0,0,0
1746595530478,AWP 10R,004,886176,Staff,0,0,0,0
1746595530478,AWP 10R,005,886177,Staff,0,0,0,0
1746595530478,AWP 10R,006,886178,Staff,0,0,0,0
1746595530478,AWP 10R,007,886179,Staff,0,0,0,0
1746595530478,AWP 10R,008,886181,Staff,0,0,0,0
1746595530478,AWP 10R,009,886182,Staff,0,0,0,0
1746595530478,AWP 10R,010,886183,Staff,0,0,0,0
1746595530478,AWP 10R,011,886184,Staff,0,0,0,0
1746595530478,AWP 10R,012,886185,Staff,0,0,0,0
1746595530478,AWP 10R,013,886186,Staff,0,0,0,0
1746595530478,AWP 10R,014,886187,Staff,0,0,0,0
1746595530478,AWP 10R,015,886188,Staff,0,0,0,0
1746595530478,AWP 10R,016,886189,Staff,0,0,0,0
1746595530478,AWP 10R,017,960532,Staff,0,0,0,0
1746595530478,AWP 10R,018,960533,Staff,0,0,0,0
1746595530478,AWP 10R,019,960534,Staff,0,0,0,0
1746595530478,AWP 10R,020,960538,Staff,0,0,0,0
1746595530478,AWP 10R,021,960540,Staff,0,0,0,0
1746595530478,AWP 10R,022,960541,Staff,0,0,0,0
1746595530478,AWP 10R,023,960542,Staff,0,0,0,0
1746595530478,AWP 10R,024,960544,Staff,0,0,0,0
1746595530478,AWP 10R,025,960545,Staff,0,0,0,0
1746595530478,AWP 10R,026,960548,Staff,0,0,0,0
1746595531506,AWP 102R,A00,886190,Staff,0,0,0,0
1746595531506,AWP 102R,B00,886191,Staff,0,0,0,0
1746595532531,BENG 100,A01,886193,Staff,17,0,30,13
1746595533560,BENG 122A,A01,886195,Hasty; Jeff M,13,0,30,17
1746595534589,BENG 166A,A00,886196,Sah; Robert Lie-Yuan,0,3,30,30
1746595535617,BENG 190,A00,958050,Khojah; Reem I,17,0,25,8
1746595536646,BIBC 102,A01,894320,Staff,0,1,46,46
1746595536646,BIBC 102,A02,894321,Staff,0,0,46,46
1746595536646,BIBC 102,A03,894344,Staff,6,0,46,40
1746595536646,BIBC 102,A04,894345,Staff,27,0,47,20
1746595537673,BICD 100R,A01,894365,Smith; Laurie,1,3,58,57
1746595537673,BICD 100R,A02,894366,Smith; Laurie,1,5,58,57
1746595537673,BICD 100R,A03,894367,Smith; Laurie,0,0,59,59
1746595537673,BICD 100R,A04,959869,Smith; Laurie,38,0,59,21
1746595538704,BICD 136,A01,894383,Gustafson-Brown; Cindy,14,0,50,36
1746595539731,BIEB 102,A01,894494,Butler; Shannon Rhey,51,0,130,79
1746595541790,BIEB 150,A01,894617,Wills; Christopher,3,0,20,17
1746595541790,BIEB 150,A02,894631,Wills; Christopher,3,0,20,17
1746595541790,BIEB 150,A03,894937,Wills; Christopher,3,0,20,17
1746595541790,BIEB 150,A04,894946,Wills; Christopher,5,0,20,15
1746595542819,BIEB 194,A00,906141,Kurle; Carolyn M.,5,0,20,15
1746595543845,BILD 1,A01,894154,Staff,3,0,19,16
1746595543845,BILD 1,A02,894155,Staff,14,0,19,5
1746595543845,BILD 1,A03,894160,Staff,13,0,19,6
1746595543845,BILD 1,A04,894161,Staff,15,0,18,3
1746595544871,BILD 2,A01,894168,Staff,0,0,50,50
1746595544871,BILD 2,A02,894169,Staff,0,0,50,50
1746595544871,BILD 2,A03,894179,Staff,0,0,50,50
1746595544871,BILD 2,A04,894203,Staff,23,0,50,27
1746595545899,BILD 3,A01,894213,Staff,23,0,31,8
1746595545899,BILD 3,A02,894214,Staff,26,0,31,5
1746595545899,BILD 3,A03,894235,Staff,28,0,31,3
1746595545899,BILD 3,A04,894236,Staff,28,0,32,4
1746595546928,BILD 4,A01,894253,Reuther; Keefe,5,0,24,19
1746595546928,BILD 4,A02,894258,Reuther; Keefe,16,0,24,8
1746595547958,BILD 5,A01,894276,Reuther; Keefe,34,0,50,16
1746595547958,BILD 5,A02,894277,Reuther; Keefe,45,0,50,5
1746595547958,BILD 5,A03,894290,Reuther; Keefe,44,0,50,6
1746595547958,BILD 5,A04,894291,Reuther; Keefe,48,0,50,2
1746595548988,BILD 24,A01,894297,Pirino; Giorgia,40,0,60,20
1746595550054,BIMM 100,B01,958915,Staff,71,0,100,29
1746595551085,BIMM 101,A01,895017,McDonnell; Lisa Marie,0,5,24,24
1746595551085,BIMM 101,A02,895018,McDonnell; Lisa Marie,0,5,24,24
1746595551085,BIMM 101,B01,895020,McDonnell; Lisa Marie,1,6,24,23
1746595551085,BIMM 101,B02,895021,McDonnell; Lisa Marie,0,4,24,24
1746595552113,BIMM 110,A01,895023,Staff,1,0,25,24
1746595552113,BIMM 110,A02,895024,Staff,9,0,25,16
1746595552113,BIMM 110,A03,895025,Staff,18,0,25,7
1746595552113,BIMM 110,A04,895031,Staff,20,0,25,5
1746595553145,BIMM 120,A01,895114,Gustafson-Brown; Cindy,14,0,28,14
1746595553145,BIMM 120,A02,895126,Gustafson-Brown; Cindy,21,0,27,6
1746595554173,BIPN 100,A01,895130,Yang; Mingyu,0,0,38,38
1746595554173,BIPN 100,A02,895131,Yang; Mingyu,31,0,38,7
1746595554173,BIPN 100,A03,895132,Yang; Mingyu,32,0,38,6
1746595554173,BIPN 100,A04,895133,Yang; Mingyu,27,0,36,9
1746595555198,BIPN 120,A01,895135,Cooke; James Edward,0,3,13,13
1746595555198,BIPN 120,A02,895136,Cooke; James Edward,0,1,13,13
1746595555198,BIPN 120,A03,895137,Cooke; James Edward,0,3,13,13
1746595555198,BIPN 120,A04,895156,Cooke; James Edward,0,2,11,11
1746595556222,BIPN 134,A01,895235,Cooke; James Edward,0,1,25,25
1746595556222,BIPN 134,A02,895237,Cooke; James Edward,0,0,25,25
1746595556222,BIPN 134,A03,895240,Cooke; James Edward,2,0,25,23
1746595556222,BIPN 134,A04,895270,Cooke; James Edward,20,0,25,5
1746595557250,BIPN 189,A00,892103,Staff,0,14,14,14
1746595559305,BISP 194,A00,958008,Staff,0,2,0,0
1746595560331,CAT 124,A01,922009,Staff,0,5,20,20
1746595561362,CAT 125R,A00,886390,Morales; Celeste Georgianna,0,3,20,20
1746595561362,CAT 125R,B00,886391,Irwin; Matthew Joseph,0,4,20,20
1746595561362,CAT 125R,C00,886392,Smith; Lauryn Alissa,0,2,20,20
1746595561362,CAT 125R,D00,886393,Vanderschuit; Maya Alysia,0,3,20,20
1746595561362,CAT 125R,E00,886394,Marchisotto; Jennifer Anne,0,3,20,20
1746595562394,CENG 15,A01,886218,Drews; Aaron,3,0,8,5
1746595563422,CENG 113,A00,886219,Opatkiewicz; Justin Paul,15,0,25,10
1746595564449,CGS 101,A00,887044,Staff,7,0,20,13
1746595565479,CGS 105,A01,887046,Staff,14,0,25,11
1746595566505,CGS 112,A00,887047,Cuong; Marisol,12,0,15,3
1746595567533,CGS 113,A00,887048,Staff,23,0,30,7
1746595568558,CGS 120,A00,887049,Staff,10,0,17,7
1746595569587,CHEM 6A,A01,886336,Lam; Tin Yiu,38,0,50,12
1746595569587,CHEM 6A,A02,886338,Lam; Tin Yiu,37,0,50,13
1746595570619,CHEM 6B,A01,886341,Hopkins; Patrycja Anna,16,0,50,34
1746595570619,CHEM 6B,A02,886343,Hopkins; Patrycja Anna,42,0,50,8
1746595571645,CHEM 6C,A01,886346,Albizati; Kim F.,0,2,50,50
1746595571645,CHEM 6C,A02,886348,Albizati; Kim F.,24,0,50,26
1746595572673,CHEM 40A,A01,886352,Klosterman; Jeremy K,65,0,100,35
1746595573697,CHEM 40B,A01,886356,Klosterman; Jeremy K,0,24,100,100
1746595574724,CHEM 41B,A01,886360,Theodorakis; Emmanuel,25,0,50,25
1746595574724,CHEM 41B,A02,886362,Theodorakis; Emmanuel,47,0,50,3
1746595575748,CHIN 165A,A00,886382,Xu; Li,18,0,20,2
1746595576776,CLAS 120,A00,886387,Myerston Santana; Jacobo,33,0,40,7
1746595577802,COGS 9,A01,886967,Shannon; Kyle Michael,42,0,60,18
1746595578831,COGS 11,A01,886969,Staff,9,0,30,21
1746595579859,COGS 14A,A01,886971,Staff,5,0,60,55
1746595580885,COGS 14B,A01,886973,Hoffman; Drew Ellen,4,0,60,56
1746595581911,COGS 18,A01,886975,Morgan; Eric,34,0,60,26
1746595582939,COGS 20,A01,886977,Staff,3,0,8,5
1746595582939,COGS 20,A02,886978,Staff,5,0,7,2
1746595583965,COGS 100,A01,907783,Staff,1,2,30,29
1746595584992,COGS 101B,A01,886980,Staff,0,4,48,48
1746595586018,COGS 101C,A01,886982,Delgado; Tania,0,5,44,44
1746595587048,COGS 102A,A01,886984,Johnson; Christine M.,3,0,30,27
1746595588075,COGS 118B,A01,886986,Staff,0,4,88,88
1746595589106,COGS 150,A01,886988,Bergen; Benjamin,22,0,50,28
1746595590136,COGS 153,A00,886989,Delgado; Tania,0,3,41,41
1746595591161,COGS 186,A01,886991,Staff,0,0,32,32
1746595592188,COGS 187A,A01,886993,Boyle; Mary E. T.,7,0,30,23
1746595593214,COGS 189,A00,886994,Staff,0,1,30,30
1746595594241,COMM 10,A01,886996,Staff,0,0,20,21
1746595594241,COMM 10,A02,886997,Staff,10,0,20,10
1746595594241,COMM 10,A03,959845,Staff,19,0,20,1
1746595595268,COMM 20,A01,886999,Leuning; Grant Maurstad,24,0,40,16
1746595597328,COMM 100A,A01,887002,Staff,0,0,20,25
1746595597328,COMM 100A,A02,887003,Staff,5,0,20,15
1746595598355,COMM 100B,A01,887005,Staff,0,8,20,24
1746595599381,COMM 106D,A00,887006,Staff,13,0,40,27
1746595600406,COMM 110G,A00,887007,Whitworth-Smith; Andrew C,12,0,40,28
1746595601431,COMM 111B,A00,887008,Staff,31,0,40,9
1746595602462,COMM 113T,A00,887009,Abuelhiga; Soraya Jill,28,0,40,12
1746595602462,COMM 113T,B00,906733,Staff,39,0,40,1
1746595603487,COMM 145,A00,887010,Staff,12,0,40,28
1746595604513,COMM 146,A00,887054,Staff,31,0,40,9
1746595605539,COMM 190,A00,887012,Staff,8,0,23,15
1746595606565,CSE 8A,A50,887015,Cao; Yingjun,56,0,85,29
1746595607591,CSE 11,A01,887017,Cao; Yingjun,11,0,70,59
1746595608623,CSE 20,A01,887019,Staff,30,0,50,20
1746595609650,CSE 21,A01,887021,Staff,79,0,100,21
1746595609650,CSE 21,B01,892583,Braun; Oliver,45,0,50,5
1746595610677,CSE 30,A01,887025,Eldon; John,142,0,200,58
1746595611706,CSE 100,A01,887027,Staff,26,0,50,24
1746595611706,CSE 100,A02,887028,Staff,42,0,50,8
1746595612738,CSE 101,A01,887030,Braun; Oliver,74,0,100,26
1746595612738,CSE 101,B01,887032,Jones; Miles E,0,3,50,50
1746595612738,CSE 101,B02,887033,Jones; Miles E,0,2,50,50
1746595613765,CSE 105,A01,908084,Jones; Miles E,32,0,50,18
1746595613765,CSE 105,A02,908087,Jones; Miles E,31,0,50,19
1746595614792,CSE 135,A01,887035,Powell; Thomas Allan,0,5,50,50
1746595615820,CSE 142,A01,887037,Staff,8,0,60,52
1746595616850,CSE 142L,A01,887039,Staff,34,0,60,26
1746595617875,CSE 151A,A01,887041,Solares; Edwin A,47,0,100,53
1746595618902,CSE 175,A01,887043,Kumar; Rakesh,30,0,30,0
1746595619930,CSS 1,A01,886389,Staff,0,1,40,40
1746595620961,DSC 30,A01,908097,Liao; Soohyun Nam,47,0,75,28
1746595621988,DSC 40A,A01,908099,Shannon; Kyle Michael,30,0,50,20
1746595623013,DSC 40B,A01,908112,Staff,15,0,50,35
1746595624040,DSC 80,A01,908116,Staff,19,0,60,41
1746595625068,DSC 197,001,956863,Eldridge; Justin Matthew,9999,0,9999,0
1746595626097,ECE 5,A01,886400,Morris; Karcher William,1,0,6,5
1746595626097,ECE 5,A02,886401,Morris; Karcher William,3,0,6,3
1746595627121,ECE 148,A01,886403,Silberman; Jack,0,14,14,14
1746595628150,ECON 1,A01,887265,Crane; Meredith Helen,11,0,70,59
1746595628150,ECON 1,B01,887268,Staff,42,0,50,8
1746595629178,ECON 2,A01,887273,Crane; Meredith Helen,54,0,70,16
1746595630203,ECON 3,A01,887279,Rondina; Giacomo,31,0,70,39
1746595631232,ECON 4,A01,887282,Anderson; John Charles,0,2,10,10
1746595632262,ECON 5,A01,887285,Staff,34,0,45,11
1746595632262,ECON 5,B01,887292,Staff,41,0,45,4
1746595633289,ECON 100A,A01,887337,Newhouse; Herbert S,54,0,70,16
1746595633289,ECON 100A,B01,887349,Staff,45,0,50,5
1746595634314,ECON 100B,A01,887361,Du; Songzi,29,0,70,41
1746595635342,ECON 100C,A01,887445,Newhouse; Herbert S,59,0,70,11
1746595636367,ECON 105,A00,887488,Vespa; Emanuel Ignacio,23,0,35,12
1746595637393,ECON 109,A01,887506,Shishkin; Denis,28,0,35,7
1746595638421,ECON 110A,A01,887568,Alon; Titan Michael,0,2,35,35
1746595638421,ECON 110A,B01,907601,Alon; Titan Michael,20,0,35,15
1746595639446,ECON 110B,A01,887598,Levkoff; Steven B.,0,24,70,70
1746595640472,ECON 112,A00,887599,Rondina; Giacomo,19,0,35,16
1746595641498,ECON 120A,A01,887603,Dai; Yinlin,35,0,70,35
1746595642525,ECON 120C,A01,887608,Sun; Yixiao,0,1,35,35
1746595642525,ECON 120C,B01,887614,Sun; Yixiao,0,0,35,35
1746595643553,ECON 138,A00,887621,Bharadwaj; Prashant,0,21,20,20
1746595644579,ECON 144,A00,958007,Squires; Dale E,12,0,35,23
1746595645606,ECON 171,A01,907666,Staff,18,0,35,17
1746595646631,ECON 175,A00,887626,Wu; Pak Yeung,22,0,35,13
1746595647662,ECON 190,A00,887640,Vespa; Emanuel Ignacio,22,0,35,13
1746595648690,EDS 25,A01,888197,Staff,0,0,0,0
1746595648690,EDS 25,A02,888209,Staff,0,0,0,0
1746595648690,EDS 25,A03,888210,Staff,0,0,0,0
1746595648690,EDS 25,A04,888212,Staff,0,0,0,0
1746595648690,EDS 25,A05,888213,Staff,0,0,0,0
1746595648690,EDS 25,A06,888214,Staff,0,0,0,0
1746595648690,EDS 25,A07,888235,Staff,0,2,0,0
1746595648690,EDS 25,A08,888236,Staff,0,0,0,0
1746595648690,EDS 25,A09,888240,Staff,0,0,0,0
1746595648690,EDS 25,A10,888244,Staff,0,0,0,0
1746595648690,EDS 25,B01,888273,Staff,0,0,0,0
1746595648690,EDS 25,B02,888285,Staff,0,0,0,0
1746595648690,EDS 25,B03,888423,Staff,0,0,0,1
1746595648690,EDS 25,B04,888432,Staff,0,0,0,0
1746595648690,EDS 25,B05,888433,Staff,0,0,0,0
1746595648690,EDS 25,B06,888467,Staff,0,0,0,0
1746595648690,EDS 25,B07,888468,Staff,0,0,0,0
1746595648690,EDS 25,B08,888479,Staff,0,0,0,0
1746595648690,EDS 25,B09,888484,Staff,0,0,0,0
1746595648690,EDS 25,B10,888487,Staff,0,0,0,0
1746595649720,EDS 38,A01,907700,Choi; Bailey Miyeon,30,0,30,0
1746595650744,EDS 112,A01,888601,Chapman; Thandeka K,12,0,40,28
1746595651771,EDS 115,A00,888697,Mendez; Kathrina Mendoza,10,0,30,20
1746595652796,EDS 116,A01,888893,Staff,33,0,40,7
1746595654891,EDS 124AR,A00,889133,Staff,29,0,50,21
1746595654891,EDS 124AR,B00,907471,Simon; Elizabeth A,37,0,50,13
1746595655919,EDS 124BR,A00,889134,Simon; Elizabeth A,44,0,100,56
1746595656945,EDS 125,A00,889135,Staff,25,0,30,5
1746595657971,EDS 126,A01,889138,Staff,35,0,40,5
1746595659002,EDS 164R,A01,889142,Wishard Guerra; Alison G.,32,0,50,18
1746595660033,ENG 30,A01,886396,Staff,0,0,0,0
1746595660033,ENG 30,B01,886398,Staff,0,0,0,0
1746595661061,ENVR 102,A00,906150,Montejo; Carolina,23,0,25,2
1746595662085,ETHN 103A,A00,887236,Man; Simeon S,0,2,0,0
1746595663111,ETHN 113,A00,887239,Staff,16,0,30,14
1746595664137,ETHN 116,A00,887240,Staff,16,0,25,9
1746595665165,ETHN 117,A00,887241,Choi; Esther Min,28,0,30,2
1746595666197,ETHN 118,A00,887243,Staff,24,0,30,6
1746595667225,ETHN 127,A00,887248,Cuong; Marisol,11,0,15,4
1746595668255,ETHN 139,A00,887250,Staff,7,0,10,3
1746595669283,ETHN 142,A00,887252,Staff,10,0,30,20
1746595670312,ETHN 161,A00,887253,Browne; Errol Tsekani,24,0,30,6
1746595671337,ETHN 163FR,A00,887255,Burelle; Julie Sara Veronique,0,0,5,5
1746595672362,GLBH 20,A00,889149,Elwardani; Nile Regina,8,0,42,34
1746595674415,GLBH 111,A01,889152,Burgos; Jose L.,17,0,17,0
1746595675441,GLBH 150,A00,889181,Sloane; Julia Kathryn,0,5,15,15
1746595677492,HDS 60,A01,886406,Warstadt; Melissa Fawn,72,0,80,8
1746595678519,HIAF 111,A00,889324,Gyamfi; Bright,25,0,32,7
1746595679547,HIEA 131,A00,889328,Staff,15,0,32,17
1746595680577,HIEA 144,A00,889333,Henry; Todd A.,26,0,32,6
1746595681615,HIEA 154,A00,889336,Henry; Todd A.,24,0,32,8
1746595682642,HIEU 106,A00,889339,Staff,22,0,32,10
1746595684692,HIEU 114,A00,889340,Staff,4,0,32,28
1746595685721,HIEU 135GS,A00,889342,Patterson; Patrick H.,0,0,1,24
1746595686750,HIEU 137,A00,889343,Edington; Claire Ellen,10,0,25,15
1746595687778,HIEU 148,A00,889345,Staff,14,0,32,18
1746595688809,HIEU 154,A00,889346,Biess; Frank Peter,21,0,32,11
1746595689834,HILA 102,A00,889351,Staff,12,0,32,20
1746595690861,HILD 2A,A01,889221,Lewandoski; Julia Mavis,0,8,32,32
1746595691889,HILD 7B,A01,889225,Man; Simeon S,0,12,32,32
1746595692914,HILD 7C,A01,889288,Alvarez; Luis A,0,14,32,32
1746595693941,HILD 30,A01,889323,Staff,0,5,32,32
1746595695996,HISC 119,A00,889383,Golan; Tal,20,0,32,12
1746595697023,HIUS 103,A00,889384,Man; Simeon S,0,0,32,32
1746595698056,HIUS 117,A00,919797,Kwak; Nancy,18,0,32,14
1746595699094,HIUS 142A,A00,919788,Staff,22,0,32,10
1746595701148,HIUS 149,A00,889386,Gyamfi; Bright,26,0,32,6
1746595702173,HIUS 155,A00,889387,Alvarez; Luis A,15,0,32,17
1746595703204,HUM 3,A01,886499,Caldwell; Michael Alan,19,0,50,31
1746595704232,HUM 3GS,A00,886500,Rodriguez; Bretton Sigfred,0,0,0,28
1746595705255,HUM 3R,A01,886502,Markman; Kristina,0,36,50,50
1746595706282,HUM 4,A01,886504,Crum; Matthew Stephen,23,0,50,27
1746595706282,HUM 4,B01,886506,West; Geoffrey Scott,17,0,50,33
1746595707309,HUM 4GS,A00,886507,Staff,0,0,0,19
1746595708332,HUM 5,A01,886509,Staff,31,0,50,19
1746595709358,HUM 5R,A01,886511,Zavodny; Tatiana Sophia,0,39,50,50
1746595710383,JAPN 180,A00,886407,Staff,16,0,40,24
1746595711413,LATI 50,A01,886409,Martin-Cabrera; Luis,3,0,22,19
1746595711413,LATI 50,A02,886410,Martin-Cabrera; Luis,19,0,22,3
1746595711413,LATI 50,A03,886411,Martin-Cabrera; Luis,21,0,22,1
1746595711413,LATI 50,A04,886412,Martin-Cabrera; Luis,8,0,22,14
1746595712442,LAWS 101,A00,907664,Staff,28,0,60,32
1746595713468,LIAB 1A,A00,889388,Saab; Dima,17,0,20,3
1746595714492,LIAB 1AX,A00,889389,El Cheddadi; Youniss,18,0,20,2
1746595715518,LIFR 1C,A00,889391,Van Moer; Vinciane G,8,0,20,12
1746595716547,LIFR 1CX,A00,889392,Van Moer; Vinciane G,7,0,20,13
1746595717571,LIFR 1D,A00,889393,Van Moer; Vinciane G,7,0,20,13
1746595718601,LIFR 1DX,A00,889394,Van Moer; Vinciane G,8,0,20,12
1746595719626,LIGN 7,A00,886923,Staff,25,0,50,25
1746595720656,LIGN 17,A00,886924,Kehler; Andrew Scott,126,0,150,24
1746595721681,LTAM 110,A00,889395,Staff,15,0,30,15
1746595722762,LTAM 110GS,A00,958010,Rodriguez; Bretton Sigfred,0,0,0,28
1746595723789,LTCH 101,A00,889397,Staff,23,0,25,2
1746595724817,LTCS 130,A00,889398,Staff,23,0,25,2
1746595725844,LTEA 138,A00,889399,Staff,24,0,40,16
1746595726870,LTEN 149,A00,889400,Wesling; Megan E.,0,3,25,25
1746595727897,LTEN 169,A00,889401,Staff,20,0,25,5
1746595728925,LTEN 180,A00,889402,Staff,10,0,15,5
1746595729953,LTEN 181,A00,889403,Staff,21,0,25,4
1746595730980,LTWL 100,A00,889404,Myerston Santana; Jacobo,2,0,25,23
1746595732006,LTWL 180GS,A00,889405,Staff,0,0,20,20
1746595733032,LTWL 181,A00,889406,Staff,16,0,25,9
1746595734059,LTWL 184,A00,889475,Mukherjee; Silpa,22,0,25,3
1746595735085,LTWR 102C,A00,889486,Staff,29,0,30,1
1746595736113,LTWR 115W,A00,889491,Staff,0,2,15,15
1746595737138,MAE 8,A01,886905,Staff,0,2,0,0
1746595738167,MAE 11,A00,886906,Bandaru; Prabhakar,0,7,50,50
1746595739202,MAE 20,A00,886907,Evdokimenko; Ekaterina,43,0,70,27
1746595740229,MAE 30B,A00,886909,Ghazinejad; Maziar,25,0,45,20
1746595741259,MAE 101B,A00,886910,Saintillan; David,30,0,45,15
1746595742284,MAE 105,A00,886911,Bandaru; Prabhakar,18,0,50,32
1746595743309,MAE 107,B00,958024,Staff,7,0,50,43
1746595744337,MAE 143B,A00,886913,Bewley; Thomas R,2,0,40,38
1746595745363,MAE 148,A01,886915,Silberman; Jack,0,3,14,14
1746595746394,MAE 160,A00,886916,Evdokimenko; Ekaterina,31,0,60,29
1746595747418,MATH 3C,A01,889681,Staff,0,2,30,30
1746595747418,MATH 3C,A02,960048,Staff,23,0,30,7
1746595748445,MATH 10A,A01,889760,Staff,26,0,30,4
1746595748445,MATH 10A,A02,889783,Staff,29,0,30,1
1746595749473,MATH 10B,A01,889785,Verstraete; Jacques Allan,1,0,35,34
1746595749473,MATH 10B,A02,889795,Verstraete; Jacques Allan,4,0,35,31
1746595749473,MATH 10B,B01,889797,Verstraete; Jacques Allan,3,0,35,32
1746595749473,MATH 10B,B02,889828,Verstraete; Jacques Allan,3,0,35,32
1746595750499,MATH 10C,A01,889849,Habib; Yousaf,8,0,30,22
1746595750499,MATH 10C,A02,889852,Habib; Yousaf,14,0,30,16
1746595750499,MATH 10C,A03,889853,Habib; Yousaf,22,0,30,8
1746595750499,MATH 10C,A04,889858,Habib; Yousaf,20,0,30,10
1746595750499,MATH 10C,B01,889861,Staff,1,0,30,29
1746595750499,MATH 10C,B02,889862,Staff,24,0,30,6
1746595750499,MATH 10C,B03,889863,Staff,27,0,30,3
1746595750499,MATH 10C,B04,889967,Staff,23,0,30,7
1746595751525,MATH 18,A01,889974,Staff,7,0,30,23
1746595751525,MATH 18,A02,889977,Staff,20,0,30,10
1746595751525,MATH 18,B01,889984,Hardiman; Liam,20,0,30,10
1746595751525,MATH 18,B02,889985,Hardiman; Liam,25,0,30,5
1746595752555,MATH 20A,A01,889990,Suk; Andrew Hoon,30,0,35,5
1746595753582,MATH 20B,A01,889993,Ohm; Ko Woon,21,0,30,9
1746595753582,MATH 20B,A02,889994,Ohm; Ko Woon,30,0,30,0
1746595753582,MATH 20B,B01,889996,Ohm; Ko Woon,22,0,30,8
1746595753582,MATH 20B,B02,889997,Ohm; Ko Woon,23,0,30,7
1746595754609,MATH 20C,A01,889999,Hammock; Frances H,17,0,30,13
1746595754609,MATH 20C,A02,890003,Hammock; Frances H,23,0,30,7
1746595754609,MATH 20C,B01,890006,Hammock; Frances H,3,0,30,27
1746595754609,MATH 20C,B02,890007,Hammock; Frances H,12,0,30,18
1746595755635,MATH 20D,A01,890011,Cheng; Hsiao-Bing,0,0,30,30
1746595755635,MATH 20D,A02,890012,Cheng; Hsiao-Bing,14,0,30,16
1746595755635,MATH 20D,B01,890016,Cheng; Hsiao-Bing,13,0,30,17
1746595755635,MATH 20D,B02,890017,Cheng; Hsiao-Bing,13,0,30,17
1746595756660,MATH 20E,A01,890026,Harel; Guershon,1,0,30,29
1746595756660,MATH 20E,A02,890029,Harel; Guershon,22,0,30,8
1746595756660,MATH 20E,B01,890033,Harel; Guershon,7,0,30,23
1746595756660,MATH 20E,B02,890101,Harel; Guershon,21,0,30,9
1746595757685,MATH 102,A01,890104,Staff,18,0,30,12
1746595757685,MATH 102,A02,890105,Staff,27,0,30,3
1746595758710,MATH 103B,A01,890116,Salehi Golsefidy; Alireza,3,0,30,27
1746595758710,MATH 103B,B01,890118,Staff,0,3,34,34
1746595759734,MATH 109,A01,890121,Aliabadi Sr.; Mohsen,0,0,30,30
1746595759734,MATH 109,B01,890124,Upadrashta; Pranav Kumar,18,0,30,12
1746595760761,MATH 120A,A01,890126,Eggers; John Dietrich,13,0,30,17
1746595761792,MATH 142B,A01,890128,Ioana; Adrian,19,0,30,11
1746595761792,MATH 142B,A02,890129,Ioana; Adrian,12,0,30,18
1746595762817,MATH 154,A01,890174,Staff,0,1,30,30
1746595762817,MATH 154,A02,890182,Staff,0,0,30,30
1746595763841,MATH 168A,A01,890197,Dumitriu; Ioana,21,0,35,14
1746595764870,MATH 170A,A01,890240,Nie; Jiawang,1,0,30,29
1746595764870,MATH 170A,A02,890241,Nie; Jiawang,11,0,30,19
1746595764870,MATH 170A,A03,890249,Nie; Jiawang,23,0,30,7
1746595765899,MATH 170B,A01,957891,Nag; Panchali,13,0,35,22
1746595767952,MATH 181A,A01,908025,Staff,0,3,35,35
1746595767952,MATH 181A,A02,960115,Staff,26,0,35,9
1746595768977,MATH 181B,A01,959874,Staff,24,0,30,6
1746595770007,MATH 193B,A01,890265,Staff,0,4,35,35
1746595771032,MGT 4,A01,890311,Anderson; John Charles,42,0,88,46
1746595772057,MGT 5,A00,907740,Staff,12,0,98,86
1746595773081,MGT 12,A00,890312,Lindenberger; Wade Douglas,67,0,98,31
1746595774107,MGT 16,A00,957883,Staff,78,0,98,20
1746595776160,MGT 45,A00,890314,Pecore; Joseph P.,45,0,98,53
1746595777185,MGT 71,A00,890315,Staff,0,12,98,98
1746595778213,MGT 100,A00,890316,Yavorsky; Daniel Ryan,44,0,98,54
1746595779239,MGT 103,A00,890317,Ehrich; Kristine R,73,0,98,25
1746595780264,MGT 105,A00,890356,Bates; Kenneth Walter,0,8,98,98
1746595781292,MGT 112,A00,890360,Ehrich; Kristine R,55,0,98,43
1746595782318,MGT 127R,A00,907732,Zhu; Kevin Xiaoguo,23,0,98,75
1746595783342,MGT 131B,A00,890361,Anderson; John Charles,59,0,98,39
1746595784366,MGT 137,A00,890362,Lindenberger; Wade Douglas,65,0,98,33
1746595785392,MGT 160,A00,890369,Johnson; Erik Barry,9,0,98,89
1746595787450,MGT 164,A00,890372,Zimmermann; Carsten,0,40,98,98
1746595788474,MGT 180,A00,890374,Bliss; Barbara Ann,11,0,98,87
1746595789502,MMW 15,A01,886414,Chang; Edmond Yi-Teh,0,12,28,28
1746595789502,MMW 15,A02,886415,Chang; Edmond Yi-Teh,0,8,28,28
1746595789502,MMW 15,A03,886416,Chang; Edmond Yi-Teh,0,9,28,28
1746595789502,MMW 15,A04,886417,Chang; Edmond Yi-Teh,0,8,28,28
1746595789502,MMW 15,B01,886419,Chang; Edmond Yi-Teh,0,7,28,28
1746595789502,MMW 15,B02,886420,Chang; Edmond Yi-Teh,0,7,28,28
1746595789502,MMW 15,B03,886421,Chang; Edmond Yi-Teh,0,7,28,28
1746595789502,MMW 15,B04,886422,Chang; Edmond Yi-Teh,0,8,28,28
1746595789502,MMW 15,C01,886424,Staff,0,9,28,28
1746595789502,MMW 15,C02,886425,Staff,0,8,28,28
1746595789502,MMW 15,C03,886426,Staff,0,8,28,28
1746595789502,MMW 15,C04,886427,Staff,0,8,28,28
1746595789502,MMW 15,C05,958038,Staff,0,8,28,28
1746595789502,MMW 15,C06,958039,Staff,0,7,28,28
1746595790531,MMW 15GS,A00,906910,Patterson; Patrick H.,4,0,28,24
1746595791555,MMW 122R,A01,886429,Rahimi; Babak,0,13,28,28
1746595791555,MMW 122R,A02,886430,Rahimi; Babak,0,12,28,28
1746595791555,MMW 122R,A03,958040,Rahimi; Babak,0,11,28,28
1746595792582,MUS 1A,A01,890937,Staff,2,0,25,23
1746595792582,MUS 1A,A02,891035,Staff,6,0,25,19
1746595792582,MUS 1A,C01,958912,Staff,24,0,25,1
1746595792582,MUS 1A,C02,958913,Staff,25,0,25,0
1746595794639,MUS 2AK,A00,957092,Ohnishi; Takae,15,0,15,0
1746595795667,MUS 4,A01,891044,Staff,0,0,25,25
1746595795667,MUS 4,A02,891045,Staff,22,0,25,3
1746595795667,MUS 4,B01,891048,Staff,17,0,25,8
1746595795667,MUS 4,B02,891050,Staff,25,0,25,0
1746595796692,MUS 5,A01,957506,Dubnov; Shlomo,0,0,25,25
1746595796692,MUS 5,A02,957622,Dubnov; Shlomo,13,0,25,12
1746595796692,MUS 5,A03,957623,Dubnov; Shlomo,20,0,25,5
1746595797718,MUS 6,A01,891053,Freitas Caetano; Marcelo,24,0,25,1
1746595797718,MUS 6,A02,891054,Freitas Caetano; Marcelo,23,0,25,2
1746595798746,MUS 7,A01,891081,Staff,0,0,25,25
1746595798746,MUS 7,A02,891082,Staff,3,0,25,22
1746595799775,MUS 8GS,A00,891118,Borgo; David Garcia,1,0,25,24
1746595800800,MUS 11,A01,891140,Staff,8,0,25,17
1746595800800,MUS 11,A02,891141,Staff,21,0,25,4
1746595801828,MUS 13,A01,891143,Staff,8,0,25,17
1746595801828,MUS 13,A02,891144,Staff,24,0,25,1
1746595802856,MUS 15,A01,891146,Staff,9,0,25,16
1746595802856,MUS 15,A02,891148,Staff,21,0,25,4
1746595802856,MUS 15,B01,891150,Staff,18,0,25,7
1746595802856,MUS 15,B02,891151,Staff,25,0,25,0
1746595803880,MUS 20,A01,891153,Staff,5,0,20,15
1746595803880,MUS 20,A02,891155,Staff,14,0,20,6
1746595804913,MUS 80,A00,891156,Staff,19,0,25,6
1746595804913,MUS 80,B00,891157,Staff,23,0,25,2
1746595805938,MUS 130,A00,891158,Ohnishi; Takae,35,0,35,0
1746595806964,MUS 150GS,A01,891160,Borgo; David Garcia,1,0,25,24
1746595807989,MUS 170,A01,891162,Freitas Caetano; Marcelo,20,0,25,5
1746595807989,MUS 170,A02,891164,Freitas Caetano; Marcelo,21,0,25,4
1746595809014,NANO 11,A00,886220,Vazquez Mena; Oscar,13,0,15,2
1746595810043,NANO 15,A01,886222,Drews; Aaron,4,0,7,3
1746595811068,NANO 104,A00,886224,Sirbuly; Donald,17,0,25,8
1746595812093,PH 40,A00,886528,Staff,23,0,40,17
1746595813123,PH 45,A01,886799,Staff,35,0,40,5
1746595814148,PH 110,A00,886802,Staff,0,6,40,40
1746595815179,PH 172,A00,906716,Staff,19,0,35,16
1746595816203,PH 191,A00,886803,Staff,6,0,40,34
1746595817228,PHIL 1,A00,889500,Staff,20,0,30,10
1746595818260,PHIL 10,A01,889549,Grush; Rick Scott,16,0,22,6
1746595818260,PHIL 10,A02,889551,Grush; Rick Scott,22,0,22,0
1746595819293,PHIL 28,A01,889559,Lamey; Andy M.,0,2,31,31
1746595819293,PHIL 28,A02,889561,Lamey; Andy M.,0,1,30,30
1746595819293,PHIL 28,A03,889572,Lamey; Andy M.,0,1,30,30
1746595820338,PHIL 35,A00,907839,Staff,13,0,15,2
1746595821366,PHIL 60,A00,889574,Staff,73,0,90,17
1746595822400,PHIL 101,A00,958004,Staff,12,0,15,3
1746595824450,PHIL 136,A00,889582,Fulkerson; Matthew Todd,26,0,45,19
1746595825480,PHIL 163,A01,889601,Staff,21,0,30,9
1746595825480,PHIL 163,B01,889606,Brandt; Reuven A,0,3,0,0
1746595826506,PHIL 164,A00,889610,Staff,16,0,30,14
1746595827529,PHIL 165,A00,889613,Staff,22,0,30,8
1746595828554,PHYS 1A,A00,886431,Staff,30,0,70,40
1746595829579,PHYS 1AL,001,886432,Tsai; Philbert S,0,1,30,30
1746595829579,PHYS 1AL,002,886436,Tsai; Philbert S,13,0,30,17
1746595830603,PHYS 1B,A00,886439,Staff,184,0,240,56
1746595831627,PHYS 1BL,001,886441,Tsai; Philbert S,0,4,30,30
1746595831627,PHYS 1BL,002,886444,Tsai; Philbert S,2,0,30,28
1746595832675,PHYS 1C,A00,896092,Arnold; Kam S,78,0,146,68
1746595833702,PHYS 1CL,001,886448,Tsai; Philbert S,0,0,30,30
1746595833702,PHYS 1CL,002,886449,Tsai; Philbert S,1,0,30,29
1746595833702,PHYS 1CL,003,886450,Tsai; Philbert S,16,0,30,14
1746595833702,PHYS 1CL,004,886451,Tsai; Philbert S,15,0,30,15
1746595834728,PHYS 2B,A01,886457,Staff,67,0,115,48
1746595835753,PHYS 2C,A01,886460,Shotwell; Brian,0,9,65,65
1746595836782,PHYS 2CL,A01,886467,Staff,0,4,28,28
1746595836782,PHYS 2CL,A02,886468,Staff,0,3,28,28
1746595837806,PHYS 2D,A01,886470,Staff,10,0,50,40
1746595838835,PHYS 4B,A01,886475,Grinstein; Benjamin,22,0,40,18
1746595839863,POLI 5,A00,891173,Desposato; Scott,7,0,25,18
1746595840890,POLI 5D,A01,891175,Staff,5,0,5,0
1746595840890,POLI 5D,B01,891178,Staff,5,0,5,0
1746595841915,POLI 11,A00,891179,Ferree; Karen E,1,0,35,34
1746595842938,POLI 12,A00,891180,Staff,15,0,30,15
1746595843965,POLI 27,A01,891182,Staff,12,0,75,63
1746595844989,POLI 30,A00,891183,Staff,8,0,50,42
1746595846014,POLI 100B,A00,891244,Staff,5,1,35,30
1746595847039,POLI 100I,A00,891247,Staff,7,0,30,23
1746595848062,POLI 104J,A00,891248,Nichter; Maysa,14,0,30,16
1746595849088,POLI 104U,A00,891250,Nichter; Maysa,1,0,30,29
1746595851141,POLI 110B,A00,891255,Wiens; David,19,0,25,6
1746595852169,POLI 112A,A00,891256,Wiens; David,6,0,25,19
1746595853195,POLI 114BR,A00,891261,Staff,19,0,30,11
1746595854222,POLI 117R,A00,891262,Forman; Fonna,0,6,50,50
1746595855246,POLI 118,A00,891264,Ingham; Sean,17,0,25,8
1746595856273,POLI 124A,A00,891265,Staff,18,0,20,2
1746595857306,POLI 125D,A00,891266,Nichter; Simeon C,2,0,25,23
1746595858333,POLI 126,A00,891268,Nichter; Simeon C,7,0,25,18
1746595859362,POLI 126AA,A00,891272,Staff,15,0,25,10
1746595860394,POLI 130AA,A00,891273,Staff,15,0,20,5
1746595861421,POLI 134AA,A00,891274,Staff,4,0,20,16
1746595863477,POLI 138,A00,891278,Staff,21,0,25,4
1746595864501,POLI 142K,A00,891280,Staff,10,0,25,15
1746595865526,POLI 142M,A00,891281,Gartzke; Erik,16,0,30,14
1746595866552,POLI 142P,A00,891284,Staff,20,0,30,10
1746595867580,POLI 143,A00,891285,Gartzke; Erik,12,0,30,18
1746595868611,POLI 153,A00,891286,Staff,19,0,20,1
1746595870666,POLI 175,A00,891290,Staff,15,0,20,5
1746595871691,PSYC 1,A00,890674,Steiner; Eric Tomas,0,11,45,45
1746595872718,PSYC 2,A00,890676,Albright; Thomas D,20,0,35,15
1746595873749,PSYC 3,A00,890679,Staff,17,0,20,3
1746595874776,PSYC 6,A00,959858,Staff,19,0,20,1
1746595875807,PSYC 60,A01,890684,Rickard; Timothy C.,0,6,45,45
1746595876832,PSYC 70,A01,890689,Geller; Emma Harlan,6,0,30,24
1746595877859,PSYC 71,A01,959860,Staff,21,0,25,4
1746595878889,PSYC 100,A00,890690,Lacefield; Katharine I,0,50,180,180
1746595879918,PSYC 102,A00,890695,Staff,18,0,40,22
1746595880947,PSYC 105,A00,890699,Geller; Emma Harlan,70,0,100,30
1746595881973,PSYC 106,A00,890701,Gorman; Michael R.,5,0,30,25
1746595882998,PSYC 108,A00,890704,Adrian; Julia Anna,0,29,50,50
1746595884026,PSYC 118,A01,890712,Staff,11,0,30,19
1746595885052,PSYC 124,A00,890716,Chapman; Eddie Nathaniel,25,0,60,35
1746595886083,PSYC 131,A00,890717,Anagnostaras; Stephan,0,7,80,80
1746595887111,PSYC 137,A00,890719,Winkielman; Piotr,0,11,30,30
1746595888139,PSYC 144,A00,890721,Adrian; Julia Anna,0,9,45,45
1746595889166,PSYC 162,A00,890805,Staff,0,1,75,75
1746595890195,PSYC 169,A00,890810,Staff,0,15,30,30
1746595891221,PSYC 172,A00,890814,Gorman; Michael R.,9,0,30,21
1746595892247,PSYC 181,A00,890818,Anagnostaras; Stephan,7,0,200,193
1746595893273,PSYC 184,A00,959861,Staff,163,0,175,12
1746595894302,PSYC 189,A00,890823,Staff,0,2,30,30
1746595895332,PSYC 191,A00,890884,Rickard; Timothy C.,0,12,35,35
1746595896357,PSYC 193,A00,890913,Staff,19,0,30,11
1746595896357,PSYC 193,B00,890914,Chapman; Eddie Nathaniel,24,0,30,6
1746595897384,PSYC 193L,A01,890918,Lowe; Angela Beth,20,0,30,10
1746595897384,PSYC 193L,B01,890921,Hurwitz; Ethan Scott,20,0,30,10
1746595897384,PSYC 193L,C01,890928,Staff,30,0,30,0
1746595898411,RELI 149,A00,886806,Rahimi; Babak,23,0,40,17
1746595899437,SE 9,A01,886814,Staff,7,0,20,13
1746595900463,SE 101B,A01,886816,Chadha; Mayank,3,0,35,32
1746595901492,SE 110B,A00,886818,Zhu; Qiang,4,0,75,71
1746595902517,SE 125,A01,886830,Staff,10,0,30,20
1746595903543,SE 130B,A01,886835,Staff,14,0,40,26
1746595904568,SE 131A,A01,886838,Krysl; Petr,34,0,55,21
1746595905594,SE 154,A00,886840,Staff,28,0,50,22
1746595906618,SE 164GS,A01,886849,Staff,6,0,20,14
1746595907644,SE 167GS,A01,886853,Staff,6,0,20,14
1746595908668,SIO 25,A01,890107,Staff,19,0,30,11
1746595909695,SIO 45,A00,890109,Cook; Geoffrey W,116,0,200,84
1746595910722,SIO 109R,A00,890110,Forman; Fonna,0,16,20,20
1746595911753,SIO 187,A01,890114,Kacev; David,15,0,40,25
1746595912779,SOCI 1,A01,890431,Thorpe; Charles Robert,14,0,30,16
1746595912779,SOCI 1,A02,890518,Thorpe; Charles Robert,30,0,30,0
1746595913808,SOCI 2,A01,957978,Staff,25,0,25,0
1746595913808,SOCI 2,A02,957979,Staff,23,0,25,2
1746595914837,SOCI 20,A01,890523,Calderon-Zaks; Michael Aar,21,0,30,9
1746595914837,SOCI 20,A02,890526,Calderon-Zaks; Michael Aar,29,0,30,1
1746595915867,SOCI 30,A01,890533,Pardo Guerra; Juan Pablo,37,0,40,3
1746595916891,SOCI 40,A01,890535,Staff,27,0,45,18
1746595917987,SOCI 104Q,A00,890559,Staff,18,0,30,12
1746595919016,SOCI 106,A00,890560,Arnal; Maud Marie Leonie,20,0,30,10
1746595920043,SOCI 110,A00,890567,Holkenbrink-Monk; Charlene,19,0,30,11
1746595921073,SOCI 112,A00,890568,Victoria Torres; Pablo,2,0,55,53
1746595922105,SOCI 115,A00,890597,Arnal; Maud Marie Leonie,28,0,45,17
1746595924157,SOCI 121,A00,890604,Pardo Guerra; Juan Pablo,38,0,45,7
1746595925184,SOCI 126,A01,890608,Staff,8,0,10,2
1746595926212,SOCI 127,A00,890609,Staff,18,0,30,12
1746595927240,SOCI 131,A00,890610,Thorpe; Charles Robert,37,0,45,8
1746595928268,SOCI 135,A00,890615,Payne; Christine Anna,14,0,45,31
1746595929296,SOCI 139,A00,890620,Staff,38,0,45,7
1746595930324,SOCI 148E,A00,890622,Calderon-Zaks; Michael Aar,36,0,45,9
1746595931355,SOCI 150,A00,890623,Kohler; Kristopher M.,31,0,45,14
1746595932385,SOCI 157,A00,890625,Jules-Rosette; Bennetta W.,18,0,20,2
1746595933410,SOCI 160,A00,890627,Payne; Christine Anna,21,0,45,24
1746595934437,SYN 1,A00,886855,Fish; Gwendolyn Anne,0,1,0,0
1746595934437,SYN 1,B00,906086,Fish; Gwendolyn Anne,0,2,0,2
1746595935465,SYN 2R,A00,886860,Staff,0,17,15,15
1746595935465,SYN 2R,B00,906106,Atkinson; Arthur Laird,0,16,15,15
1746595936497,SYN 100,A01,886866,Browne; Emily,0,28,20,20
1746595936497,SYN 100,B01,906128,Rock; Martin,0,4,20,20
1746595936497,SYN 100,C01,906140,Deavenport; James Cary,0,4,20,20
1746595936497,SYN 100,D01,907816,Deavenport; James Cary,0,5,20,20
1746595937525,TDAC 1,A00,890286,Walsh; Kim C.,7,0,20,13
1746595938553,TDAC 101,A00,890296,Basso; Beatrice,15,0,20,5
1746595939579,TDDE 131,A00,890297,Staff,47,0,50,3
1746595940607,TDDM 1,A00,890287,Weinberg; Sadie,25,0,30,5
1746595941633,TDGE 11,A00,890288,Fulton; Julia,138,0,200,62
1746595941633,TDGE 11,B00,890289,Castro; Robert Jess,184,0,200,16
1746595942662,TDGE 25,B00,957359,Walsh; Kim C.,5,0,20,15
1746595943688,TDGE 40,A01,890292,Power; Jade Yukana,26,0,30,4
1746595944713,TDGE 124,A00,890298,Havis; Allan,0,2,50,50
1746595945742,TDGE 131R,A00,890299,Burelle; Julie Sara Veronique,15,0,42,27
1746595946768,TDHT 101,A00,890300,Staff,10,0,20,10
1746595947794,TDHT 109,A01,890302,Anderson; Mysia Anyse,31,0,40,9
1746595948819,TDMV 1,A00,890293,Arcidiacono; Kristin,18,0,30,12
1746595949844,TDMV 2,A00,890294,Weinberg; Sadie,23,0,30,7
1746595950873,TDMV 3,A00,957878,Arcidiacono; Kristin,28,0,30,2
1746595952928,TDMV 138,A00,890304,Jun; Grace Shin Hae,25,0,40,15
1746595953955,TDMV 140,A00,890305,Corrales; Joseph Bernales,25,0,30,5
1746595955189,TDMV 142,A00,890307,Caligagan; Tony,32,0,40,8
1746595956216,TDMV 144,A00,890308,Camaya; Michelle Ann,25,0,30,5
1746595957241,TDPW 1,A00,890295,Stein; Deborah Isobel,3,0,20,17
1746595958270,USP 2,A01,890272,Lerner; Amy M,7,0,20,13
1746595959299,USP 3,A01,890274,Staff,12,0,30,18
1746595960327,USP 15,A01,890276,Sun; Feiyang,16,0,30,14
1746595961357,USP 25,A00,890277,Shenkman; Michael Thomas,18,0,25,7
1746595962382,USP 138,A00,890278,Staff,13,0,25,12
1746595963408,USP 143,A00,890279,Staff,21,0,70,49
1746595964436,USP 144,A00,890280,Chowdhury; Muhammed Zohir,16,0,30,14
1746595965461,USP 150,A00,890281,Boomhower; Matthew Charles,4,0,30,26
1746595966487,USP 151,A00,890282,Staff,16,0,20,4
1746595967513,USP 162,A00,890283,Andrews; Abigail Leslie,16,0,20,4
1746595968541,USP 168,A00,920477,Kwak; Nancy,0,0,5,5
1746595969567,USP 181,A00,890284,Staff,3,0,20,17
1746595970594,USP 191A,A00,890285,Staff,12,0,20,8
1746595971621,VIS 101,A00,886512,Staff,26,0,75,49
1746595972647,VIS 103,A00,886513,Cruz; Edwin Teddy,61,0,75,14
1746595973673,VIS 108,A00,886514,Staff,4,0,15,11
1746595974699,VIS 127P,A00,886515,Shen; Kuiyi,80,0,146,66
1746595975725,VIS 149,A00,886516,Yoldas; Pinar,0,0,15,15
1746595976750,VIS 164,A00,886526,Erdmann; Dean,19,0,22,3
1746595977775,VIS 194S,A00,886527,Staff,61,0,75,14
1746595978801,WCWP 10A,C00,886484,Martiniuk; Jill,12,0,15,3
1746595979827,WCWP 10B,A00,886490,Uriarte; Emma,0,0,15,15
1746595979827,WCWP 10B,B00,886491,Dhir; Simrita,8,0,15,7
1746595979827,WCWP 10B,C00,886492,Ornelas; Tricia,0,0,15,15
1746595980854,WCWP 100,A00,886494,Young; Mark T,0,6,15,15
1746595982978,AAS 10,A01,886199,Childs; Dennis R.,0,3,0,0
1746595984007,ANAR 104,A01,886940,Shtienberg; Gilad,27,0,30,3
1746595985036,ANAR 120,A00,886953,Staff,13,0,20,7
1746595986063,ANBI 148,A01,886955,Wilder; Linnea Lorene,30,0,40,10
1746595988115,ANSC 122,A00,886957,Staff,24,0,30,6
1746595989144,ANSC 150,A00,886958,Sloane; Julia Kathryn,2,0,15,13
1746595990169,ANSC 156,A00,886959,Jenkins; Janis A.,0,1,15,15
1746595991195,ANSC 180,A00,886960,Staff,11,0,17,6
1746595992220,ANSC 188,A00,886961,Jassal; Aftab,9,0,25,16
1746595993248,ANSC 190,A00,886962,Jassal; Aftab,14,0,25,11
1746595994275,ANSC 191,A00,886963,Staff,18,0,20,2
1746595995301,ANTH 3,A01,891689,Staff,17,0,20,3
1746595996327,ANTH 5,A00,886933,Semendeferi; Ekaterini,16,0,20,4
1746595997351,ANTH 10,A00,886934,Staff,0,12,30,30
1746595998377,ANTH 21,A01,886936,Staff,41,0,60,19
1746595999401,ANTH 23,A01,886938,Staff,92,0,100,8
1746596000430,ANTH 105,A00,886964,Stewart; Alexander B,84,0,100,16
1746596001455,ANTH 108,A00,886965,Pedersen; David,9,0,20,11
1746596002489,AWP 10,001,886147,Staff,0,0,0,0
1746596002489,AWP 10,002,886148,Staff,0,0,0,0
1746596002489,AWP 10,003,886149,Staff,0,0,0,0
1746596002489,AWP 10,004,886150,Staff,0,0,0,0
1746596002489,AWP 10,005,886151,Staff,0,0,0,0
1746596002489,AWP 10,006,886152,Staff,0,0,0,0
1746596002489,AWP 10,007,886153,Staff,0,0,0,0
1746596002489,AWP 10,008,886154,Staff,0,0,0,0
1746596002489,AWP 10,009,886155,Staff,0,0,0,0
1746596002489,AWP 10,010,886156,Staff,0,0,0,0
1746596002489,AWP 10,011,886158,Staff,0,0,0,0
1746596002489,AWP 10,012,886160,Staff,0,0,0,0
1746596002489,AWP 10,013,886161,Staff,0,0,0,0
1746596002489,AWP 10,014,886162,Staff,0,0,0,0
1746596002489,AWP 10,015,886163,Staff,0,0,0,0
1746596002489,AWP 10,016,886164,Staff,0,0,0,0
1746596002489,AWP 10,017,886165,Staff,0,0,0,0
1746596002489,AWP 10,018,886166,Staff,0,0,0,0
1746596002489,AWP 10,019,886168,Staff,0,0,0,0
1746596002489,AWP 10,020,886170,Staff,0,0,0,0
1746596002489,AWP 10,021,886172,Staff,0,0,0,0
1746596003517,AWP 10R,001,886173,Staff,0,1,0,0
1746596003517,AWP 10R,002,886174,Staff,0,1,0,0
1746596003517,AWP 10R,003,886175,Staff,0,0,0,0
1746596003517,AWP 10R,004,886176,Staff,0,0,0,0
1746596003517,AWP 10R,005,886177,Staff,0,0,0,0
1746596003517,AWP 10R,006,886178,Staff,0,0,0,0
1746596003517,AWP 10R,007,886179,Staff,0,0,0,0
1746596003517,AWP 10R,008,886181,Staff,0,0,0,0
1746596003517,AWP 10R,009,886182,Staff,0,0,0,0
1746596003517,AWP 10R,010,886183,Staff,0,0,0,0
1746596003517,AWP 10R,011,886184,Staff,0,0,0,0
1746596003517,AWP 10R,012,886185,Staff,0,0,0,0
1746596003517,AWP 10R,013,886186,Staff,0,0,0,0
1746596003517,AWP 10R,014,886187,Staff,0,0,0,0
1746596003517,AWP 10R,015,886188,Staff,0,0,0,0
1746596003517,AWP 10R,016,886189,Staff,0,0,0,0
1746596003517,AWP 10R,017,960532,Staff,0,0,0,0
1746596003517,AWP 10R,018,960533,Staff,0,0,0,0
1746596003517,AWP 10R,019,960534,Staff,0,0,0,0
1746596003517,AWP 10R,020,960538,Staff,0,0,0,0
1746596003517,AWP 10R,021,960540,Staff,0,0,0,0
1746596003517,AWP 10R,022,960541,Staff,0,0,0,0
1746596003517,AWP 10R,023,960542,Staff,0,0,0,0
1746596003517,AWP 10R,024,960544,Staff,0,0,0,0
1746596003517,AWP 10R,025,960545,Staff,0,0,0,0
1746596003517,AWP 10R,026,960548,Staff,0,0,0,0
1746596004545,AWP 102R,A00,886190,Staff,0,0,0,0
1746596004545,AWP 102R,B00,886191,Staff,0,0,0,0
1746596005572,BENG 100,A01,886193,Staff,17,0,30,13
1746596006600,BENG 122A,A01,886195,Hasty; Jeff M,13,0,30,17
1746596007629,BENG 166A,A00,886196,Sah; Robert Lie-Yuan,0,3,30,30
1746596008656,BENG 190,A00,958050,Khojah; Reem I,17,0,25,8
1746596009686,BIBC 102,A01,894320,Staff,0,1,46,46
1746596009686,BIBC 102,A02,894321,Staff,0,0,46,46
1746596009686,BIBC 102,A03,894344,Staff,6,0,46,40
1746596009686,BIBC 102,A04,894345,Staff,27,0,47,20
1746596010715,BICD 100R,A01,894365,Smith; Laurie,0,2,58,58
1746596010715,BICD 100R,A02,894366,Smith; Laurie,0,4,58,58
1746596010715,BICD 100R,A03,894367,Smith; Laurie,0,0,59,59
1746596010715,BICD 100R,A04,959869,Smith; Laurie,38,0,59,21
1746596011742,BICD 136,A01,894383,Gustafson-Brown; Cindy,14,0,50,36
1746596012772,BIEB 102,A01,894494,Butler; Shannon Rhey,51,0,130,79
1746596014823,BIEB 150,A01,894617,Wills; Christopher,3,0,20,17
1746596014823,BIEB 150,A02,894631,Wills; Christopher,3,0,20,17
1746596014823,BIEB 150,A03,894937,Wills; Christopher,3,0,20,17
1746596014823,BIEB 150,A04,894946,Wills; Christopher,5,0,20,15
1746596015852,BIEB 194,A00,906141,Kurle; Carolyn M.,5,0,20,15
1746596016880,BILD 1,A01,894154,Staff,3,0,19,16
1746596016880,BILD 1,A02,894155,Staff,14,0,19,5
1746596016880,BILD 1,A03,894160,Staff,13,0,19,6
1746596016880,BILD 1,A04,894161,Staff,15,0,18,3
1746596017908,BILD 2,A01,894168,Staff,0,0,50,50
1746596017908,BILD 2,A02,894169,Staff,0,0,50,50
1746596017908,BILD 2,A03,894179,Staff,0,0,50,50
1746596017908,BILD 2,A04,894203,Staff,23,0,50,27
1746596018938,BILD 3,A01,894213,Staff,23,0,31,8
1746596018938,BILD 3,A02,894214,Staff,26,0,31,5
1746596018938,BILD 3,A03,894235,Staff,28,0,31,3
1746596018938,BILD 3,A04,894236,Staff,28,0,32,4
1746596019969,BILD 4,A01,894253,Reuther; Keefe,5,0,24,19
1746596019969,BILD 4,A02,894258,Reuther; Keefe,16,0,24,8
1746596020999,BILD 5,A01,894276,Reuther; Keefe,34,0,50,16
1746596020999,BILD 5,A02,894277,Reuther; Keefe,45,0,50,5
1746596020999,BILD 5,A03,894290,Reuther; Keefe,44,0,50,6
1746596020999,BILD 5,A04,894291,Reuther; Keefe,48,0,50,2
1746596022028,BILD 24,A01,894297,Pirino; Giorgia,40,0,60,20
1746596023062,BIMM 100,B01,958915,Staff,71,0,100,29
1746596024087,BIMM 101,A01,895017,McDonnell; Lisa Marie,0,5,24,24
1746596024087,BIMM 101,A02,895018,McDonnell; Lisa Marie,0,5,24,24
1746596024087,BIMM 101,B01,895020,McDonnell; Lisa Marie,0,5,24,24
1746596024087,BIMM 101,B02,895021,McDonnell; Lisa Marie,0,4,24,24
1746596025117,BIMM 110,A01,895023,Staff,1,0,25,24
1746596025117,BIMM 110,A02,895024,Staff,9,0,25,16
1746596025117,BIMM 110,A03,895025,Staff,18,0,25,7
1746596025117,BIMM 110,A04,895031,Staff,20,0,25,5
1746596026147,BIMM 120,A01,895114,Gustafson-Brown; Cindy,14,0,28,14
1746596026147,BIMM 120,A02,895126,Gustafson-Brown; Cindy,21,0,27,6
1746596027173,BIPN 100,A01,895130,Yang; Mingyu,0,0,38,38
1746596027173,BIPN 100,A02,895131,Yang; Mingyu,31,0,38,7
1746596027173,BIPN 100,A03,895132,Yang; Mingyu,32,0,38,6
1746596027173,BIPN 100,A04,895133,Yang; Mingyu,27,0,36,9
1746596028202,BIPN 120,A01,895135,Cooke; James Edward,0,3,13,13
1746596028202,BIPN 120,A02,895136,Cooke; James Edward,0,1,13,13
1746596028202,BIPN 120,A03,895137,Cooke; James Edward,0,3,13,13
1746596028202,BIPN 120,A04,895156,Cooke; James Edward,0,2,11,11
1746596029231,BIPN 134,A01,895235,Cooke; James Edward,0,1,25,25
1746596029231,BIPN 134,A02,895237,Cooke; James Edward,0,0,25,25
1746596029231,BIPN 134,A03,895240,Cooke; James Edward,2,0,25,23
1746596029231,BIPN 134,A04,895270,Cooke; James Edward,20,0,25,5
1746596030259,BIPN 189,A00,892103,Staff,0,14,14,14
1746596032313,BISP 194,A00,958008,Staff,0,2,0,0
1746596033339,CAT 124,A01,922009,Staff,0,5,20,20
1746596034370,CAT 125R,A00,886390,Morales; Celeste Georgianna,0,3,20,20
1746596034370,CAT 125R,B00,886391,Irwin; Matthew Joseph,0,4,20,20
1746596034370,CAT 125R,C00,886392,Smith; Lauryn Alissa,0,2,20,20
1746596034370,CAT 125R,D00,886393,Vanderschuit; Maya Alysia,0,3,20,20
1746596034370,CAT 125R,E00,886394,Marchisotto; Jennifer Anne,0,3,20,20
1746596035400,CENG 15,A01,886218,Drews; Aaron,3,0,8,5
1746596036429,CENG 113,A00,886219,Opatkiewicz; Justin Paul,15,0,25,10
1746596037457,CGS 101,A00,887044,Staff,7,0,20,13
1746596038483,CGS 105,A01,887046,Staff,14,0,25,11
1746596039508,CGS 112,A00,887047,Cuong; Marisol,12,0,15,3
1746596040536,CGS 113,A00,887048,Staff,23,0,30,7
1746596041561,CGS 120,A00,887049,Staff,10,0,17,7
1746596042588,CHEM 6A,A01,886336,Lam; Tin Yiu,38,0,50,12
1746596042588,CHEM 6A,A02,886338,Lam; Tin Yiu,37,0,50,13
1746596043613,CHEM 6B,A01,886341,Hopkins; Patrycja Anna,16,0,50,34
1746596043613,CHEM 6B,A02,886343,Hopkins; Patrycja Anna,42,0,50,8
1746596044638,CHEM 6C,A01,886346,Albizati; Kim F.,0,2,50,50
1746596044638,CHEM 6C,A02,886348,Albizati; Kim F.,24,0,50,26
1746596045669,CHEM 40A,A01,886352,Klosterman; Jeremy K,65,0,100,35
1746596046697,CHEM 40B,A01,886356,Klosterman; Jeremy K,0,24,100,100
1746596047728,CHEM 41B,A01,886360,Theodorakis; Emmanuel,25,0,50,25
1746596047728,CHEM 41B,A02,886362,Theodorakis; Emmanuel,47,0,50,3
1746596048756,CHIN 165A,A00,886382,Xu; Li,18,0,20,2
1746596049784,CLAS 120,A00,886387,Myerston Santana; Jacobo,33,0,40,7
1746596050810,COGS 9,A01,886967,Shannon; Kyle Michael,42,0,60,18
1746596051839,COGS 11,A01,886969,Staff,9,0,30,21
1746596052868,COGS 14A,A01,886971,Staff,5,0,60,55
1746596053895,COGS 14B,A01,886973,Hoffman; Drew Ellen,4,0,60,56
1746596054920,COGS 18,A01,886975,Morgan; Eric,34,0,60,26
1746596055948,COGS 20,A01,886977,Staff,3,0,8,5
1746596055948,COGS 20,A02,886978,Staff,5,0,7,2
1746596056976,COGS 100,A01,907783,Staff,0,1,30,30
1746596058006,COGS 101B,A01,886980,Staff,0,4,48,48
1746596059036,COGS 101C,A01,886982,Delgado; Tania,0,5,44,44
1746596060063,COGS 102A,A01,886984,Johnson; Christine M.,3,0,30,27
1746596061092,COGS 118B,A01,886986,Staff,0,4,88,88
1746596062120,COGS 150,A01,886988,Bergen; Benjamin,22,0,50,28
1746596063147,COGS 153,A00,886989,Delgado; Tania,0,3,41,41
1746596064176,COGS 186,A01,886991,Staff,0,0,32,32
1746596065205,COGS 187A,A01,886993,Boyle; Mary E. T.,7,0,30,23
1746596066229,COGS 189,A00,886994,Staff,0,1,30,30
1746596067253,COMM 10,A01,886996,Staff,0,0,20,21
1746596067253,COMM 10,A02,886997,Staff,10,0,20,10
1746596067253,COMM 10,A03,959845,Staff,19,0,20,1
1746596068280,COMM 20,A01,886999,Leuning; Grant Maurstad,24,0,40,16
1746596070332,COMM 100A,A01,887002,Staff,0,0,20,25
1746596070332,COMM 100A,A02,887003,Staff,5,0,20,15
1746596071357,COMM 100B,A01,887005,Staff,0,8,20,24
1746596072385,COMM 106D,A00,887006,Staff,13,0,40,27
1746596073414,COMM 110G,A00,887007,Whitworth-Smith; Andrew C,12,0,40,28
1746596074438,COMM 111B,A00,887008,Staff,31,0,40,9
1746596075462,COMM 113T,A00,887009,Abuelhiga; Soraya Jill,28,0,40,12
1746596075462,COMM 113T,B00,906733,Staff,39,0,40,1
1746596076487,COMM 145,A00,887010,Staff,12,0,40,28
1746596077513,COMM 146,A00,887054,Staff,31,0,40,9
1746596078539,COMM 190,A00,887012,Staff,8,0,23,15
1746596079566,CSE 8A,A50,887015,Cao; Yingjun,56,0,85,29
1746596080593,CSE 11,A01,887017,Cao; Yingjun,11,0,70,59
1746596081618,CSE 20,A01,887019,Staff,30,0,50,20
1746596082647,CSE 21,A01,887021,Staff,79,0,100,21
1746596082647,CSE 21,B01,892583,Braun; Oliver,45,0,50,5
1746596083673,CSE 30,A01,887025,Eldon; John,142,0,200,58
1746596084699,CSE 100,A01,887027,Staff,26,0,50,24
1746596084699,CSE 100,A02,887028,Staff,42,0,50,8
1746596085726,CSE 101,A01,887030,Braun; Oliver,74,0,100,26
1746596085726,CSE 101,B01,887032,Jones; Miles E,0,3,50,50
1746596085726,CSE 101,B02,887033,Jones; Miles E,0,2,50,50
1746596086751,CSE 105,A01,908084,Jones; Miles E,32,0,50,18
1746596086751,CSE 105,A02,908087,Jones; Miles E,31,0,50,19
1746596087780,CSE 135,A01,887035,Powell; Thomas Allan,0,5,50,50
1746596088806,CSE 142,A01,887037,Staff,8,0,60,52
1746596089835,CSE 142L,A01,887039,Staff,34,0,60,26
1746596090864,CSE 151A,A01,887041,Solares; Edwin A,47,0,100,53
1746596091892,CSE 175,A01,887043,Kumar; Rakesh,30,0,30,0
1746596092918,CSS 1,A01,886389,Staff,0,1,40,40
1746596093947,DSC 30,A01,908097,Liao; Soohyun Nam,47,0,75,28
1746596094977,DSC 40A,A01,908099,Shannon; Kyle Michael,30,0,50,20
1746596096002,DSC 40B,A01,908112,Staff,15,0,50,35
1746596097030,DSC 80,A01,908116,Staff,19,0,60,41
1746596098056,DSC 197,001,956863,Eldridge; Justin Matthew,9999,0,9999,0
1746596099087,ECE 5,A01,886400,Morris; Karcher William,1,0,6,5
1746596099087,ECE 5,A02,886401,Morris; Karcher William,3,0,6,3
1746596100114,ECE 148,A01,886403,Silberman; Jack,0,14,14,14
1746596101141,ECON 1,A01,887265,Crane; Meredith Helen,11,0,70,59
1746596101141,ECON 1,B01,887268,Staff,42,0,50,8
1746596102167,ECON 2,A01,887273,Crane; Meredith Helen,54,0,70,16
1746596103192,ECON 3,A01,887279,Rondina; Giacomo,31,0,70,39
1746596104218,ECON 4,A01,887282,Anderson; John Charles,0,2,10,10
1746596105247,ECON 5,A01,887285,Staff,34,0,45,11
1746596105247,ECON 5,B01,887292,Staff,41,0,45,4
1746596106279,ECON 100A,A01,887337,Newhouse; Herbert S,54,0,70,16
1746596106279,ECON 100A,B01,887349,Staff,45,0,50,5
1746596107305,ECON 100B,A01,887361,Du; Songzi,29,0,70,41
1746596108331,ECON 100C,A01,887445,Newhouse; Herbert S,59,0,70,11
1746596109361,ECON 105,A00,887488,Vespa; Emanuel Ignacio,23,0,35,12
1746596110389,ECON 109,A01,887506,Shishkin; Denis,28,0,35,7
1746596111418,ECON 110A,A01,887568,Alon; Titan Michael,0,2,35,35
1746596111418,ECON 110A,B01,907601,Alon; Titan Michael,20,0,35,15
1746596112445,ECON 110B,A01,887598,Levkoff; Steven B.,0,24,70,70
1746596113472,ECON 112,A00,887599,Rondina; Giacomo,19,0,35,16
1746596114498,ECON 120A,A01,887603,Dai; Yinlin,35,0,70,35
1746596115523,ECON 120C,A01,887608,Sun; Yixiao,0,1,35,35
1746596115523,ECON 120C,B01,887614,Sun; Yixiao,0,0,35,35
1746596116549,ECON 138,A00,887621,Bharadwaj; Prashant,0,21,20,20
1746596117574,ECON 144,A00,958007,Squires; Dale E,12,0,35,23
1746596118601,ECON 171,A01,907666,Staff,18,0,35,17
1746596119625,ECON 175,A00,887626,Wu; Pak Yeung,22,0,35,13
1746596120649,ECON 190,A00,887640,Vespa; Emanuel Ignacio,22,0,35,13
1746596121675,EDS 25,A01,888197,Staff,0,0,0,0
1746596121675,EDS 25,A02,888209,Staff,0,0,0,0
1746596121675,EDS 25,A03,888210,Staff,0,0,0,0
1746596121675,EDS 25,A04,888212,Staff,0,0,0,0
1746596121675,EDS 25,A05,888213,Staff,0,0,0,0
1746596121675,EDS 25,A06,888214,Staff,0,0,0,0
1746596121675,EDS 25,A07,888235,Staff,0,2,0,0
1746596121675,EDS 25,A08,888236,Staff,0,0,0,0
1746596121675,EDS 25,A09,888240,Staff,0,0,0,0
1746596121675,EDS 25,A10,888244,Staff,0,0,0,0
1746596121675,EDS 25,B01,888273,Staff,0,0,0,0
1746596121675,EDS 25,B02,888285,Staff,0,0,0,0
1746596121675,EDS 25,B03,888423,Staff,0,0,0,1
1746596121675,EDS 25,B04,888432,Staff,0,0,0,0
1746596121675,EDS 25,B05,888433,Staff,0,0,0,0
1746596121675,EDS 25,B06,888467,Staff,0,0,0,0
1746596121675,EDS 25,B07,888468,Staff,0,0,0,0
1746596121675,EDS 25,B08,888479,Staff,0,0,0,0
1746596121675,EDS 25,B09,888484,Staff,0,0,0,0
1746596121675,EDS 25,B10,888487,Staff,0,0,0,0
1746596122703,EDS 38,A01,907700,Choi; Bailey Miyeon,30,0,30,0
1746596123728,EDS 112,A01,888601,Chapman; Thandeka K,12,0,40,28
1746596124752,EDS 115,A00,888697,Mendez; Kathrina Mendoza,10,0,30,20
1746596125777,EDS 116,A01,888893,Staff,33,0,40,7
1746596127826,EDS 124AR,A00,889133,Staff,29,0,50,21
1746596127826,EDS 124AR,B00,907471,Simon; Elizabeth A,37,0,50,13
1746596128852,EDS 124BR,A00,889134,Simon; Elizabeth A,44,0,100,56
1746596129877,EDS 125,A00,889135,Staff,25,0,30,5
1746596130903,EDS 126,A01,889138,Staff,35,0,40,5
1746596131931,EDS 164R,A01,889142,Wishard Guerra; Alison G.,32,0,50,18
1746596132957,ENG 30,A01,886396,Staff,0,0,0,0
1746596132957,ENG 30,B01,886398,Staff,0,0,0,0
1746596133984,ENVR 102,A00,906150,Montejo; Carolina,23,0,25,2
1746596135012,ETHN 103A,A00,887236,Man; Simeon S,0,2,0,0
1746596136036,ETHN 113,A00,887239,Staff,16,0,30,14
1746596137061,ETHN 116,A00,887240,Staff,16,0,25,9
1746596138087,ETHN 117,A00,887241,Choi; Esther Min,28,0,30,2
1746596139112,ETHN 118,A00,887243,Staff,24,0,30,6
1746596140138,ETHN 127,A00,887248,Cuong; Marisol,11,0,15,4
1746596141164,ETHN 139,A00,887250,Staff,7,0,10,3
1746596142188,ETHN 142,A00,887252,Staff,10,0,30,20
1746596143213,ETHN 161,A00,887253,Browne; Errol Tsekani,24,0,30,6
1746596144239,ETHN 163FR,A00,887255,Burelle; Julie Sara Veronique,0,0,5,5
1746596145268,GLBH 20,A00,889149,Elwardani; Nile Regina,8,0,42,34
1746596147322,GLBH 111,A01,889152,Burgos; Jose L.,17,0,17,0
1746596148351,GLBH 150,A00,889181,Sloane; Julia Kathryn,0,5,15,15
1746596150403,HDS 60,A01,886406,Warstadt; Melissa Fawn,72,0,80,8
1746596151440,HIAF 111,A00,889324,Gyamfi; Bright,25,0,32,7
1746596152467,HIEA 131,A00,889328,Staff,15,0,32,17
1746596153496,HIEA 144,A00,889333,Henry; Todd A.,26,0,32,6
1746596154522,HIEA 154,A00,889336,Henry; Todd A.,24,0,32,8
1746596155548,HIEU 106,A00,889339,Staff,22,0,32,10
1746596157598,HIEU 114,A00,889340,Staff,4,0,32,28
1746596158623,HIEU 135GS,A00,889342,Patterson; Patrick H.,0,0,1,24
1746596159649,HIEU 137,A00,889343,Edington; Claire Ellen,10,0,25,15
1746596160678,HIEU 148,A00,889345,Staff,14,0,32,18
1746596161705,HIEU 154,A00,889346,Biess; Frank Peter,21,0,32,11
1746596162731,HILA 102,A00,889351,Staff,12,0,32,20
1746596163760,HILD 2A,A01,889221,Lewandoski; Julia Mavis,0,8,32,32
1746596164788,HILD 7B,A01,889225,Man; Simeon S,0,12,32,32
1746596165815,HILD 7C,A01,889288,Alvarez; Luis A,0,14,32,32
1746596166841,HILD 30,A01,889323,Staff,0,5,32,32
1746596168894,HISC 119,A00,889383,Golan; Tal,20,0,32,12
1746596169918,HIUS 103,A00,889384,Man; Simeon S,0,0,32,32
1746596170945,HIUS 117,A00,919797,Kwak; Nancy,18,0,32,14
1746596171970,HIUS 142A,A00,919788,Staff,22,0,32,10
1746596174027,HIUS 149,A00,889386,Gyamfi; Bright,26,0,32,6
1746596175055,HIUS 155,A00,889387,Alvarez; Luis A,15,0,32,17
1746596176080,HUM 3,A01,886499,Caldwell; Michael Alan,19,0,50,31
1746596177108,HUM 3GS,A00,886500,Rodriguez; Bretton Sigfred,0,0,0,28
1746596178136,HUM 3R,A01,886502,Markman; Kristina,0,36,50,50
1746596179164,HUM 4,A01,886504,Crum; Matthew Stephen,23,0,50,27
1746596179164,HUM 4,B01,886506,West; Geoffrey Scott,17,0,50,33
1746596180189,HUM 4GS,A00,886507,Staff,0,0,0,19
1746596181238,HUM 5,A01,886509,Staff,31,0,50,19
1746596182266,HUM 5R,A01,886511,Zavodny; Tatiana Sophia,0,39,50,50
1746596183291,JAPN 180,A00,886407,Staff,16,0,40,24
1746596184320,LATI 50,A01,886409,Martin-Cabrera; Luis,3,0,22,19
1746596184320,LATI 50,A02,886410,Martin-Cabrera; Luis,19,0,22,3
1746596184320,LATI 50,A03,886411,Martin-Cabrera; Luis,21,0,22,1
1746596184320,LATI 50,A04,886412,Martin-Cabrera; Luis,8,0,22,14
1746596185346,LAWS 101,A00,907664,Staff,28,0,60,32
1746596186370,LIAB 1A,A00,889388,Saab; Dima,17,0,20,3
1746596187395,LIAB 1AX,A00,889389,El Cheddadi; Youniss,18,0,20,2
1746596188421,LIFR 1C,A00,889391,Van Moer; Vinciane G,8,0,20,12
1746596189450,LIFR 1CX,A00,889392,Van Moer; Vinciane G,7,0,20,13
1746596190475,LIFR 1D,A00,889393,Van Moer; Vinciane G,7,0,20,13
1746596191505,LIFR 1DX,A00,889394,Van Moer; Vinciane G,8,0,20,12
1746596192531,LIGN 7,A00,886923,Staff,25,0,50,25
1746596193559,LIGN 17,A00,886924,Kehler; Andrew Scott,126,0,150,24
1746596194584,LTAM 110,A00,889395,Staff,15,0,30,15
1746596195608,LTAM 110GS,A00,958010,Rodriguez; Bretton Sigfred,0,0,0,28
1746596196632,LTCH 101,A00,889397,Staff,23,0,25,2
1746596197657,LTCS 130,A00,889398,Staff,23,0,25,2
1746596198682,LTEA 138,A00,889399,Staff,24,0,40,16
1746596199708,LTEN 149,A00,889400,Wesling; Megan E.,0,3,25,25
1746596200735,LTEN 169,A00,889401,Staff,20,0,25,5
1746596201761,LTEN 180,A00,889402,Staff,10,0,15,5
1746596202786,LTEN 181,A00,889403,Staff,21,0,25,4
1746596203812,LTWL 100,A00,889404,Myerston Santana; Jacobo,2,0,25,23
1746596204839,LTWL 180GS,A00,889405,Staff,0,0,20,20
1746596205864,LTWL 181,A00,889406,Staff,16,0,25,9
1746596206891,LTWL 184,A00,889475,Mukherjee; Silpa,22,0,25,3
1746596207914,LTWR 102C,A00,889486,Staff,29,0,30,1
1746596208939,LTWR 115W,A00,889491,Staff,0,2,15,15
1746596209966,MAE 8,A01,886905,Staff,0,2,0,0
1746596210992,MAE 11,A00,886906,Bandaru; Prabhakar,0,7,50,50
1746596212021,MAE 20,A00,886907,Evdokimenko; Ekaterina,43,0,70,27
1746596213051,MAE 30B,A00,886909,Ghazinejad; Maziar,25,0,45,20
1746596214079,MAE 101B,A00,886910,Saintillan; David,30,0,45,15
1746596215104,MAE 105,A00,886911,Bandaru; Prabhakar,18,0,50,32
1746596216131,MAE 107,B00,958024,Staff,7,0,50,43
1746596217160,MAE 143B,A00,886913,Bewley; Thomas R,2,0,40,38
1746596218187,MAE 148,A01,886915,Silberman; Jack,0,3,14,14
1746596219213,MAE 160,A00,886916,Evdokimenko; Ekaterina,31,0,60,29
1746596220240,MATH 3C,A01,889681,Staff,0,2,30,30
1746596220240,MATH 3C,A02,960048,Staff,23,0,30,7
1746596221266,MATH 10A,A01,889760,Staff,26,0,30,4
1746596221266,MATH 10A,A02,889783,Staff,29,0,30,1
1746596222298,MATH 10B,A01,889785,Verstraete; Jacques Allan,1,0,35,34
1746596222298,MATH 10B,A02,889795,Verstraete; Jacques Allan,4,0,35,31
1746596222298,MATH 10B,B01,889797,Verstraete; Jacques Allan,3,0,35,32
1746596222298,MATH 10B,B02,889828,Verstraete; Jacques Allan,3,0,35,32
1746596223330,MATH 10C,A01,889849,Habib; Yousaf,8,0,30,22
1746596223330,MATH 10C,A02,889852,Habib; Yousaf,14,0,30,16
1746596223330,MATH 10C,A03,889853,Habib; Yousaf,22,0,30,8
1746596223330,MATH 10C,A04,889858,Habib; Yousaf,20,0,30,10
1746596223330,MATH 10C,B01,889861,Staff,1,0,30,29
1746596223330,MATH 10C,B02,889862,Staff,24,0,30,6
1746596223330,MATH 10C,B03,889863,Staff,27,0,30,3
1746596223330,MATH 10C,B04,889967,Staff,23,0,30,7
1746596224355,MATH 18,A01,889974,Staff,7,0,30,23
1746596224355,MATH 18,A02,889977,Staff,20,0,30,10
1746596224355,MATH 18,B01,889984,Hardiman; Liam,20,0,30,10
1746596224355,MATH 18,B02,889985,Hardiman; Liam,25,0,30,5
1746596225387,MATH 20A,A01,889990,Suk; Andrew Hoon,30,0,35,5
1746596226413,MATH 20B,A01,889993,Ohm; Ko Woon,21,0,30,9
1746596226413,MATH 20B,A02,889994,Ohm; Ko Woon,30,0,30,0
1746596226413,MATH 20B,B01,889996,Ohm; Ko Woon,22,0,30,8
1746596226413,MATH 20B,B02,889997,Ohm; Ko Woon,23,0,30,7
1746596227440,MATH 20C,A01,889999,Hammock; Frances H,17,0,30,13
1746596227440,MATH 20C,A02,890003,Hammock; Frances H,23,0,30,7
1746596227440,MATH 20C,B01,890006,Hammock; Frances H,3,0,30,27
1746596227440,MATH 20C,B02,890007,Hammock; Frances H,12,0,30,18
1746596228466,MATH 20D,A01,890011,Cheng; Hsiao-Bing,0,0,30,30
1746596228466,MATH 20D,A02,890012,Cheng; Hsiao-Bing,14,0,30,16
1746596228466,MATH 20D,B01,890016,Cheng; Hsiao-Bing,13,0,30,17
1746596228466,MATH 20D,B02,890017,Cheng; Hsiao-Bing,13,0,30,17
1746596229492,MATH 20E,A01,890026,Harel; Guershon,1,0,30,29
1746596229492,MATH 20E,A02,890029,Harel; Guershon,22,0,30,8
1746596229492,MATH 20E,B01,890033,Harel; Guershon,7,0,30,23
1746596229492,MATH 20E,B02,890101,Harel; Guershon,21,0,30,9
1746596230518,MATH 102,A01,890104,Staff,18,0,30,12
1746596230518,MATH 102,A02,890105,Staff,27,0,30,3
1746596231547,MATH 103B,A01,890116,Salehi Golsefidy; Alireza,3,0,30,27
1746596231547,MATH 103B,B01,890118,Staff,0,3,34,34
1746596232577,MATH 109,A01,890121,Aliabadi Sr.; Mohsen,0,0,30,30
1746596232577,MATH 109,B01,890124,Upadrashta; Pranav Kumar,18,0,30,12
1746596233606,MATH 120A,A01,890126,Eggers; John Dietrich,13,0,30,17
1746596234631,MATH 142B,A01,890128,Ioana; Adrian,19,0,30,11
1746596234631,MATH 142B,A02,890129,Ioana; Adrian,12,0,30,18
1746596235656,MATH 154,A01,890174,Staff,0,1,30,30
1746596235656,MATH 154,A02,890182,Staff,0,0,30,30
1746596236683,MATH 168A,A01,890197,Dumitriu; Ioana,21,0,35,14
1746596237708,MATH 170A,A01,890240,Nie; Jiawang,1,0,30,29
1746596237708,MATH 170A,A02,890241,Nie; Jiawang,11,0,30,19
1746596237708,MATH 170A,A03,890249,Nie; Jiawang,23,0,30,7
1746596238736,MATH 170B,A01,957891,Nag; Panchali,13,0,35,22
1746596240788,MATH 181A,A01,908025,Staff,0,3,35,35
1746596240788,MATH 181A,A02,960115,Staff,26,0,35,9
1746596241817,MATH 181B,A01,959874,Staff,24,0,30,6
1746596242860,MATH 193B,A01,890265,Staff,0,4,35,35
1746596243884,MGT 4,A01,890311,Anderson; John Charles,42,0,88,46
1746596244909,MGT 5,A00,907740,Staff,12,0,98,86
1746596245935,MGT 12,A00,890312,Lindenberger; Wade Douglas,67,0,98,31
1746596246960,MGT 16,A00,957883,Staff,78,0,98,20
1746596249015,MGT 45,A00,890314,Pecore; Joseph P.,45,0,98,53
1746596250039,MGT 71,A00,890315,Staff,0,12,98,98
1746596251067,MGT 100,A00,890316,Yavorsky; Daniel Ryan,44,0,98,54
1746596252093,MGT 103,A00,890317,Ehrich; Kristine R,73,0,98,25
1746596253120,MGT 105,A00,890356,Bates; Kenneth Walter,0,8,98,98
1746596254145,MGT 112,A00,890360,Ehrich; Kristine R,55,0,98,43
1746596255174,MGT 127R,A00,907732,Zhu; Kevin Xiaoguo,23,0,98,75
1746596256203,MGT 131B,A00,890361,Anderson; John Charles,59,0,98,39
1746596257227,MGT 137,A00,890362,Lindenberger; Wade Douglas,65,0,98,33
1746596258256,MGT 160,A00,890369,Johnson; Erik Barry,9,0,98,89
1746596260330,MGT 164,A00,890372,Zimmermann; Carsten,0,40,98,98
1746596261358,MGT 180,A00,890374,Bliss; Barbara Ann,11,0,98,87
1746596262384,MMW 15,A01,886414,Chang; Edmond Yi-Teh,0,12,28,28
1746596262384,MMW 15,A02,886415,Chang; Edmond Yi-Teh,0,8,28,28
1746596262384,MMW 15,A03,886416,Chang; Edmond Yi-Teh,0,9,28,28
1746596262384,MMW 15,A04,886417,Chang; Edmond Yi-Teh,0,8,28,28
1746596262384,MMW 15,B01,886419,Chang; Edmond Yi-Teh,0,7,28,28
1746596262384,MMW 15,B02,886420,Chang; Edmond Yi-Teh,0,7,28,28
1746596262384,MMW 15,B03,886421,Chang; Edmond Yi-Teh,0,7,28,28
1746596262384,MMW 15,B04,886422,Chang; Edmond Yi-Teh,0,8,28,28
1746596262384,MMW 15,C01,886424,Staff,0,9,28,28
1746596262384,MMW 15,C02,886425,Staff,0,8,28,28
1746596262384,MMW 15,C03,886426,Staff,0,8,28,28
1746596262384,MMW 15,C04,886427,Staff,0,8,28,28
1746596262384,MMW 15,C05,958038,Staff,0,8,28,28
1746596262384,MMW 15,C06,958039,Staff,0,7,28,28
1746596263411,MMW 15GS,A00,906910,Patterson; Patrick H.,4,0,28,24
1746596264437,MMW 122R,A01,886429,Rahimi; Babak,0,13,28,28
1746596264437,MMW 122R,A02,886430,Rahimi; Babak,0,12,28,28
1746596264437,MMW 122R,A03,958040,Rahimi; Babak,0,11,28,28
1746596265465,MUS 1A,A01,890937,Staff,2,0,25,23
1746596265465,MUS 1A,A02,891035,Staff,6,0,25,19
1746596265465,MUS 1A,C01,958912,Staff,24,0,25,1
1746596265465,MUS 1A,C02,958913,Staff,25,0,25,0
1746596267521,MUS 2AK,A00,957092,Ohnishi; Takae,15,0,15,0
1746596268545,MUS 4,A01,891044,Staff,0,0,25,25
1746596268545,MUS 4,A02,891045,Staff,22,0,25,3
1746596268545,MUS 4,B01,891048,Staff,17,0,25,8
1746596268545,MUS 4,B02,891050,Staff,25,0,25,0
1746596269575,MUS 5,A01,957506,Dubnov; Shlomo,0,0,25,25
1746596269575,MUS 5,A02,957622,Dubnov; Shlomo,13,0,25,12
1746596269575,MUS 5,A03,957623,Dubnov; Shlomo,20,0,25,5
1746596270602,MUS 6,A01,891053,Freitas Caetano; Marcelo,24,0,25,1
1746596270602,MUS 6,A02,891054,Freitas Caetano; Marcelo,23,0,25,2
1746596271627,MUS 7,A01,891081,Staff,0,0,25,25
1746596271627,MUS 7,A02,891082,Staff,3,0,25,22
1746596272652,MUS 8GS,A00,891118,Borgo; David Garcia,1,0,25,24
1746596273681,MUS 11,A01,891140,Staff,8,0,25,17
1746596273681,MUS 11,A02,891141,Staff,21,0,25,4
1746596274709,MUS 13,A01,891143,Staff,8,0,25,17
1746596274709,MUS 13,A02,891144,Staff,24,0,25,1
1746596275734,MUS 15,A01,891146,Staff,9,0,25,16
1746596275734,MUS 15,A02,891148,Staff,21,0,25,4
1746596275734,MUS 15,B01,891150,Staff,18,0,25,7
1746596275734,MUS 15,B02,891151,Staff,25,0,25,0
1746596276762,MUS 20,A01,891153,Staff,5,0,20,15
1746596276762,MUS 20,A02,891155,Staff,14,0,20,6
1746596277788,MUS 80,A00,891156,Staff,19,0,25,6
1746596277788,MUS 80,B00,891157,Staff,23,0,25,2
1746596278818,MUS 130,A00,891158,Ohnishi; Takae,35,0,35,0
1746596279846,MUS 150GS,A01,891160,Borgo; David Garcia,1,0,25,24
1746596280874,MUS 170,A01,891162,Freitas Caetano; Marcelo,20,0,25,5
1746596280874,MUS 170,A02,891164,Freitas Caetano; Marcelo,21,0,25,4
1746596281905,NANO 11,A00,886220,Vazquez Mena; Oscar,13,0,15,2
1746596282933,NANO 15,A01,886222,Drews; Aaron,4,0,7,3
1746596283958,NANO 104,A00,886224,Sirbuly; Donald,17,0,25,8
1746596284985,PH 40,A00,886528,Staff,23,0,40,17
1746596286015,PH 45,A01,886799,Staff,35,0,40,5
1746596287040,PH 110,A00,886802,Staff,0,6,40,40
1746596288063,PH 172,A00,906716,Staff,19,0,35,16
1746596289088,PH 191,A00,886803,Staff,6,0,40,34
1746596290111,PHIL 1,A00,889500,Staff,20,0,30,10
1746596291136,PHIL 10,A01,889549,Grush; Rick Scott,16,0,22,6
1746596291136,PHIL 10,A02,889551,Grush; Rick Scott,22,0,22,0
1746596292166,PHIL 28,A01,889559,Lamey; Andy M.,0,2,31,31
1746596292166,PHIL 28,A02,889561,Lamey; Andy M.,0,1,30,30
1746596292166,PHIL 28,A03,889572,Lamey; Andy M.,0,1,30,30
1746596293192,PHIL 35,A00,907839,Staff,13,0,15,2
1746596294217,PHIL 60,A00,889574,Staff,73,0,90,17
1746596295244,PHIL 101,A00,958004,Staff,12,0,15,3
1746596297297,PHIL 136,A00,889582,Fulkerson; Matthew Todd,26,0,45,19
1746596298322,PHIL 163,A01,889601,Staff,21,0,30,9
1746596298322,PHIL 163,B01,889606,Brandt; Reuven A,0,3,0,0
1746596299349,PHIL 164,A00,889610,Staff,16,0,30,14
1746596300375,PHIL 165,A00,889613,Staff,22,0,30,8
1746596301400,PHYS 1A,A00,886431,Staff,30,0,70,40
1746596302453,PHYS 1AL,001,886432,Tsai; Philbert S,0,1,30,30
1746596302453,PHYS 1AL,002,886436,Tsai; Philbert S,13,0,30,17
1746596303479,PHYS 1B,A00,886439,Staff,184,0,240,56
1746596304507,PHYS 1BL,001,886441,Tsai; Philbert S,0,4,30,30
1746596304507,PHYS 1BL,002,886444,Tsai; Philbert S,2,0,30,28
1746596305533,PHYS 1C,A00,896092,Arnold; Kam S,78,0,146,68
1746596306582,PHYS 1CL,001,886448,Tsai; Philbert S,0,0,30,30
1746596306582,PHYS 1CL,002,886449,Tsai; Philbert S,1,0,30,29
1746596306582,PHYS 1CL,003,886450,Tsai; Philbert S,16,0,30,14
1746596306582,PHYS 1CL,004,886451,Tsai; Philbert S,15,0,30,15
1746596307612,PHYS 2B,A01,886457,Staff,67,0,115,48
1746596308637,PHYS 2C,A01,886460,Shotwell; Brian,0,9,65,65
1746596309662,PHYS 2CL,A01,886467,Staff,0,4,28,28
1746596309662,PHYS 2CL,A02,886468,Staff,0,3,28,28
1746596310691,PHYS 2D,A01,886470,Staff,10,0,50,40
1746596311718,PHYS 4B,A01,886475,Grinstein; Benjamin,22,0,40,18
1746596312743,POLI 5,A00,891173,Desposato; Scott,7,0,25,18
1746596313768,POLI 5D,A01,891175,Staff,5,0,5,0
1746596313768,POLI 5D,B01,891178,Staff,5,0,5,0
1746596314797,POLI 11,A00,891179,Ferree; Karen E,1,0,35,34
1746596315826,POLI 12,A00,891180,Staff,15,0,30,15
1746596316853,POLI 27,A01,891182,Staff,12,0,75,63
1746596317878,POLI 30,A00,891183,Staff,8,0,50,42
1746596318904,POLI 100B,A00,891244,Staff,5,1,35,30
1746596319931,POLI 100I,A00,891247,Staff,7,0,30,23
1746596320989,POLI 104J,A00,891248,Nichter; Maysa,14,0,30,16
1746596322015,POLI 104U,A00,891250,Nichter; Maysa,1,0,30,29
1746596324068,POLI 110B,A00,891255,Wiens; David,19,0,25,6
1746596325095,POLI 112A,A00,891256,Wiens; David,6,0,25,19
1746596326118,POLI 114BR,A00,891261,Staff,19,0,30,11
1746596327148,POLI 117R,A00,891262,Forman; Fonna,0,6,50,50
1746596328177,POLI 118,A00,891264,Ingham; Sean,17,0,25,8
1746596329207,POLI 124A,A00,891265,Staff,18,0,20,2
1746596330234,POLI 125D,A00,891266,Nichter; Simeon C,2,0,25,23
1746596331259,POLI 126,A00,891268,Nichter; Simeon C,7,0,25,18
1746596332284,POLI 126AA,A00,891272,Staff,15,0,25,10
1746596333308,POLI 130AA,A00,891273,Staff,15,0,20,5
1746596334334,POLI 134AA,A00,891274,Staff,4,0,20,16
1746596336386,POLI 138,A00,891278,Staff,21,0,25,4
1746596337413,POLI 142K,A00,891280,Staff,10,0,25,15
1746596338438,POLI 142M,A00,891281,Gartzke; Erik,16,0,30,14
1746596339464,POLI 142P,A00,891284,Staff,20,0,30,10
1746596340488,POLI 143,A00,891285,Gartzke; Erik,12,0,30,18
1746596341514,POLI 153,A00,891286,Staff,19,0,20,1
1746596343574,POLI 175,A00,891290,Staff,15,0,20,5
1746596344603,PSYC 1,A00,890674,Steiner; Eric Tomas,0,11,45,45
1746596345632,PSYC 2,A00,890676,Albright; Thomas D,20,0,35,15
1746596346656,PSYC 3,A00,890679,Staff,17,0,20,3
1746596347685,PSYC 6,A00,959858,Staff,19,0,20,1
1746596348713,PSYC 60,A01,890684,Rickard; Timothy C.,0,6,45,45
1746596349740,PSYC 70,A01,890689,Geller; Emma Harlan,6,0,30,24
1746596350764,PSYC 71,A01,959860,Staff,21,0,25,4
1746596351794,PSYC 100,A00,890690,Lacefield; Katharine I,0,50,180,180
1746596352823,PSYC 102,A00,890695,Staff,18,0,40,22
1746596353847,PSYC 105,A00,890699,Geller; Emma Harlan,70,0,100,30
1746596354877,PSYC 106,A00,890701,Gorman; Michael R.,5,0,30,25
1746596355907,PSYC 108,A00,890704,Adrian; Julia Anna,0,29,50,50
1746596356932,PSYC 118,A01,890712,Staff,11,0,30,19
1746596357957,PSYC 124,A00,890716,Chapman; Eddie Nathaniel,25,0,60,35
1746596358981,PSYC 131,A00,890717,Anagnostaras; Stephan,0,7,80,80
1746596360010,PSYC 137,A00,890719,Winkielman; Piotr,0,11,30,30
1746596361038,PSYC 144,A00,890721,Adrian; Julia Anna,0,9,45,45
1746596362065,PSYC 162,A00,890805,Staff,0,1,75,75
1746596363093,PSYC 169,A00,890810,Staff,0,15,30,30
1746596364118,PSYC 172,A00,890814,Gorman; Michael R.,9,0,30,21
1746596365142,PSYC 181,A00,890818,Anagnostaras; Stephan,7,0,200,193
1746596366169,PSYC 184,A00,959861,Staff,163,0,175,12
1746596367193,PSYC 189,A00,890823,Staff,0,2,30,30
1746596368224,PSYC 191,A00,890884,Rickard; Timothy C.,0,12,35,35
1746596369251,PSYC 193,A00,890913,Staff,19,0,30,11
1746596369251,PSYC 193,B00,890914,Chapman; Eddie Nathaniel,24,0,30,6
1746596370278,PSYC 193L,A01,890918,Lowe; Angela Beth,20,0,30,10
1746596370278,PSYC 193L,B01,890921,Hurwitz; Ethan Scott,20,0,30,10
1746596370278,PSYC 193L,C01,890928,Staff,30,0,30,0
1746596371305,RELI 149,A00,886806,Rahimi; Babak,23,0,40,17
1746596372330,SE 9,A01,886814,Staff,7,0,20,13
1746596373355,SE 101B,A01,886816,Chadha; Mayank,3,0,35,32
1746596374379,SE 110B,A00,886818,Zhu; Qiang,4,0,75,71
1746596375403,SE 125,A01,886830,Staff,10,0,30,20
1746596376431,SE 130B,A01,886835,Staff,14,0,40,26
1746596377456,SE 131A,A01,886838,Krysl; Petr,34,0,55,21
1746596378483,SE 154,A00,886840,Staff,28,0,50,22
1746596379519,SE 164GS,A01,886849,Staff,6,0,20,14
1746596380543,SE 167GS,A01,886853,Staff,6,0,20,14
1746596381571,SIO 25,A01,890107,Staff,19,0,30,11
1746596382597,SIO 45,A00,890109,Cook; Geoffrey W,116,0,200,84
1746596383621,SIO 109R,A00,890110,Forman; Fonna,0,16,20,20
1746596384647,SIO 187,A01,890114,Kacev; David,15,0,40,25
1746596385675,SOCI 1,A01,890431,Thorpe; Charles Robert,14,0,30,16
1746596385675,SOCI 1,A02,890518,Thorpe; Charles Robert,30,0,30,0
1746596386701,SOCI 2,A01,957978,Staff,25,0,25,0
1746596386701,SOCI 2,A02,957979,Staff,23,0,25,2
1746596387728,SOCI 20,A01,890523,Calderon-Zaks; Michael Aar,21,0,30,9
1746596387728,SOCI 20,A02,890526,Calderon-Zaks; Michael Aar,29,0,30,1
1746596388754,SOCI 30,A01,890533,Pardo Guerra; Juan Pablo,37,0,40,3
1746596389778,SOCI 40,A01,890535,Staff,27,0,45,18
1746596390806,SOCI 104Q,A00,890559,Staff,18,0,30,12
1746596391830,SOCI 106,A00,890560,Arnal; Maud Marie Leonie,20,0,30,10
1746596392855,SOCI 110,A00,890567,Holkenbrink-Monk; Charlene,19,0,30,11
1746596393884,SOCI 112,A00,890568,Victoria Torres; Pablo,2,0,55,53
1746596394910,SOCI 115,A00,890597,Arnal; Maud Marie Leonie,28,0,45,17
1746596396961,SOCI 121,A00,890604,Pardo Guerra; Juan Pablo,38,0,45,7
1746596397986,SOCI 126,A01,890608,Staff,8,0,10,2
1746596399012,SOCI 127,A00,890609,Staff,18,0,30,12
1746596400037,SOCI 131,A00,890610,Thorpe; Charles Robert,37,0,45,8
1746596401066,SOCI 135,A00,890615,Payne; Christine Anna,14,0,45,31
1746596402093,SOCI 139,A00,890620,Staff,38,0,45,7
1746596403134,SOCI 148E,A00,890622,Calderon-Zaks; Michael Aar,36,0,45,9
1746596404159,SOCI 150,A00,890623,Kohler; Kristopher M.,31,0,45,14
1746596405187,SOCI 157,A00,890625,Jules-Rosette; Bennetta W.,18,0,20,2
1746596406215,SOCI 160,A00,890627,Payne; Christine Anna,21,0,45,24
1746596407244,SYN 1,A00,886855,Fish; Gwendolyn Anne,0,1,0,0
1746596407244,SYN 1,B00,906086,Fish; Gwendolyn Anne,0,2,0,2
1746596408268,SYN 2R,A00,886860,Staff,0,17,15,15
1746596408268,SYN 2R,B00,906106,Atkinson; Arthur Laird,0,16,15,15
1746596409300,SYN 100,A01,886866,Browne; Emily,0,28,20,20
1746596409300,SYN 100,B01,906128,Rock; Martin,0,4,20,20
1746596409300,SYN 100,C01,906140,Deavenport; James Cary,0,4,20,20
1746596409300,SYN 100,D01,907816,Deavenport; James Cary,0,5,20,20
1746596410324,TDAC 1,A00,890286,Walsh; Kim C.,7,0,20,13
1746596411351,TDAC 101,A00,890296,Basso; Beatrice,15,0,20,5
1746596412375,TDDE 131,A00,890297,Staff,47,0,50,3
1746596413403,TDDM 1,A00,890287,Weinberg; Sadie,25,0,30,5
1746596414428,TDGE 11,A00,890288,Fulton; Julia,138,0,200,62
1746596414428,TDGE 11,B00,890289,Castro; Robert Jess,184,0,200,16
1746596415451,TDGE 25,B00,957359,Walsh; Kim C.,5,0,20,15
1746596416475,TDGE 40,A01,890292,Power; Jade Yukana,26,0,30,4
1746596417501,TDGE 124,A00,890298,Havis; Allan,0,2,50,50
1746596418527,TDGE 131R,A00,890299,Burelle; Julie Sara Veronique,15,0,42,27
1746596419553,TDHT 101,A00,890300,Staff,10,0,20,10
1746596420579,TDHT 109,A01,890302,Anderson; Mysia Anyse,31,0,40,9
1746596421605,TDMV 1,A00,890293,Arcidiacono; Kristin,18,0,30,12
1746596422631,TDMV 2,A00,890294,Weinberg; Sadie,23,0,30,7
1746596423655,TDMV 3,A00,957878,Arcidiacono; Kristin,28,0,30,2
1746596425705,TDMV 138,A00,890304,Jun; Grace Shin Hae,25,0,40,15
1746596426729,TDMV 140,A00,890305,Corrales; Joseph Bernales,25,0,30,5
1746596427754,TDMV 142,A00,890307,Caligagan; Tony,32,0,40,8
1746596428779,TDMV 144,A00,890308,Camaya; Michelle Ann,25,0,30,5
1746596429803,TDPW 1,A00,890295,Stein; Deborah Isobel,3,0,20,17
1746596430832,USP 2,A01,890272,Lerner; Amy M,7,0,20,13
1746596431858,USP 3,A01,890274,Staff,12,0,30,18
1746596432886,USP 15,A01,890276,Sun; Feiyang,16,0,30,14
1746596433916,USP 25,A00,890277,Shenkman; Michael Thomas,18,0,25,7
1746596434942,USP 138,A00,890278,Staff,13,0,25,12
1746596435969,USP 143,A00,890279,Staff,21,0,70,49
1746596436993,USP 144,A00,890280,Chowdhury; Muhammed Zohir,16,0,30,14
1746596438022,USP 150,A00,890281,Boomhower; Matthew Charles,4,0,30,26
1746596439046,USP 151,A00,890282,Staff,16,0,20,4
1746596440093,USP 162,A00,890283,Andrews; Abigail Leslie,16,0,20,4
1746596441121,USP 168,A00,920477,Kwak; Nancy,0,0,5,5
1746596442149,USP 181,A00,890284,Staff,3,0,20,17
1746596443194,USP 191A,A00,890285,Staff,12,0,20,8
1746596444221,VIS 101,A00,886512,Staff,26,0,75,49
1746596445250,VIS 103,A00,886513,Cruz; Edwin Teddy,61,0,75,14
1746596446277,VIS 108,A00,886514,Staff,4,0,15,11
1746596447305,VIS 127P,A00,886515,Shen; Kuiyi,80,0,146,66
1746596448332,VIS 149,A00,886516,Yoldas; Pinar,0,0,15,15
1746596449376,VIS 164,A00,886526,Erdmann; Dean,19,0,22,3
1746596450404,VIS 194S,A00,886527,Staff,61,0,75,14
1746596451433,WCWP 10A,C00,886484,Martiniuk; Jill,12,0,15,3
1746596452458,WCWP 10B,A00,886490,Uriarte; Emma,0,0,15,15
1746596452458,WCWP 10B,B00,886491,Dhir; Simrita,8,0,15,7
1746596452458,WCWP 10B,C00,886492,Ornelas; Tricia,0,0,15,15
1746596453484,WCWP 100,A00,886494,Young; Mark T,0,6,15,15
1746596455582,AAS 10,A01,886199,Childs; Dennis R.,0,3,0,0
1746596456606,ANAR 104,A01,886940,Shtienberg; Gilad,27,0,30,3
1746596457634,ANAR 120,A00,886953,Staff,13,0,20,7
1746596458662,ANBI 148,A01,886955,Wilder; Linnea Lorene,30,0,40,10
1746596460714,ANSC 122,A00,886957,Staff,24,0,30,6
1746596461741,ANSC 150,A00,886958,Sloane; Julia Kathryn,2,0,15,13
1746596462770,ANSC 156,A00,886959,Jenkins; Janis A.,0,1,15,15
1746596463796,ANSC 180,A00,886960,Staff,11,0,17,6
1746596464822,ANSC 188,A00,886961,Jassal; Aftab,9,0,25,16
1746596465847,ANSC 190,A00,886962,Jassal; Aftab,14,0,25,11
1746596466873,ANSC 191,A00,886963,Staff,18,0,20,2
1746596467902,ANTH 3,A01,891689,Staff,17,0,20,3
1746596468927,ANTH 5,A00,886933,Semendeferi; Ekaterini,16,0,20,4
1746596469955,ANTH 10,A00,886934,Staff,0,12,30,30
1746596470981,ANTH 21,A01,886936,Staff,41,0,60,19
1746596472008,ANTH 23,A01,886938,Staff,92,0,100,8
1746596473036,ANTH 105,A00,886964,Stewart; Alexander B,84,0,100,16
1746596474059,ANTH 108,A00,886965,Pedersen; David,9,0,20,11
1746596475086,AWP 10,001,886147,Staff,0,0,0,0
1746596475086,AWP 10,002,886148,Staff,0,0,0,0
1746596475086,AWP 10,003,886149,Staff,0,0,0,0
1746596475086,AWP 10,004,886150,Staff,0,0,0,0
1746596475086,AWP 10,005,886151,Staff,0,0,0,0
1746596475086,AWP 10,006,886152,Staff,0,0,0,0
1746596475086,AWP 10,007,886153,Staff,0,0,0,0
1746596475086,AWP 10,008,886154,Staff,0,0,0,0
1746596475086,AWP 10,009,886155,Staff,0,0,0,0
1746596475086,AWP 10,010,886156,Staff,0,0,0,0
1746596475086,AWP 10,011,886158,Staff,0,0,0,0
1746596475086,AWP 10,012,886160,Staff,0,0,0,0
1746596475086,AWP 10,013,886161,Staff,0,0,0,0
1746596475086,AWP 10,014,886162,Staff,0,0,0,0
1746596475086,AWP 10,015,886163,Staff,0,0,0,0
1746596475086,AWP 10,016,886164,Staff,0,0,0,0
1746596475086,AWP 10,017,886165,Staff,0,0,0,0
1746596475086,AWP 10,018,886166,Staff,0,0,0,0
1746596475086,AWP 10,019,886168,Staff,0,0,0,0
1746596475086,AWP 10,020,886170,Staff,0,0,0,0
1746596475086,AWP 10,021,886172,Staff,0,0,0,0
1746596476114,AWP 10R,001,886173,Staff,0,1,0,0
1746596476114,AWP 10R,002,886174,Staff,0,1,0,0
1746596476114,AWP 10R,003,886175,Staff,0,0,0,0
1746596476114,AWP 10R,004,886176,Staff,0,0,0,0
1746596476114,AWP 10R,005,886177,Staff,0,0,0,0
1746596476114,AWP 10R,006,886178,Staff,0,0,0,0
1746596476114,AWP 10R,007,886179,Staff,0,0,0,0
1746596476114,AWP 10R,008,886181,Staff,0,0,0,0
1746596476114,AWP 10R,009,886182,Staff,0,0,0,0
1746596476114,AWP 10R,010,886183,Staff,0,0,0,0
1746596476114,AWP 10R,011,886184,Staff,0,0,0,0
1746596476114,AWP 10R,012,886185,Staff,0,0,0,0
1746596476114,AWP 10R,013,886186,Staff,0,0,0,0
1746596476114,AWP 10R,014,886187,Staff,0,0,0,0
1746596476114,AWP 10R,015,886188,Staff,0,0,0,0
1746596476114,AWP 10R,016,886189,Staff,0,0,0,0
1746596476114,AWP 10R,017,960532,Staff,0,0,0,0
1746596476114,AWP 10R,018,960533,Staff,0,0,0,0
1746596476114,AWP 10R,019,960534,Staff,0,0,0,0
1746596476114,AWP 10R,020,960538,Staff,0,0,0,0
1746596476114,AWP 10R,021,960540,Staff,0,0,0,0
1746596476114,AWP 10R,022,960541,Staff,0,0,0,0
1746596476114,AWP 10R,023,960542,Staff,0,0,0,0
1746596476114,AWP 10R,024,960544,Staff,0,0,0,0
1746596476114,AWP 10R,025,960545,Staff,0,0,0,0
1746596476114,AWP 10R,026,960548,Staff,0,0,0,0
1746596477140,AWP 102R,A00,886190,Staff,0,0,0,0
1746596477140,AWP 102R,B00,886191,Staff,0,0,0,0
1746596478166,BENG 100,A01,886193,Staff,17,0,30,13
1746596479230,BENG 122A,A01,886195,Hasty; Jeff M,13,0,30,17
1746596480258,BENG 166A,A00,886196,Sah; Robert Lie-Yuan,0,3,30,30
1746596481285,BENG 190,A00,958050,Khojah; Reem I,17,0,25,8
1746596482310,BIBC 102,A01,894320,Staff,0,1,46,46
1746596482310,BIBC 102,A02,894321,Staff,0,0,46,46
1746596482310,BIBC 102,A03,894344,Staff,6,0,46,40
1746596482310,BIBC 102,A04,894345,Staff,27,0,47,20
1746596483340,BICD 100R,A01,894365,Smith; Laurie,0,2,58,58
1746596483340,BICD 100R,A02,894366,Smith; Laurie,0,4,58,58
1746596483340,BICD 100R,A03,894367,Smith; Laurie,0,0,59,59
1746596483340,BICD 100R,A04,959869,Smith; Laurie,38,0,59,21
1746596484366,BICD 136,A01,894383,Gustafson-Brown; Cindy,14,0,50,36
1746596485395,BIEB 102,A01,894494,Butler; Shannon Rhey,51,0,130,79
1746596487450,BIEB 150,A01,894617,Wills; Christopher,3,0,20,17
1746596487450,BIEB 150,A02,894631,Wills; Christopher,3,0,20,17
1746596487450,BIEB 150,A03,894937,Wills; Christopher,3,0,20,17
1746596487450,BIEB 150,A04,894946,Wills; Christopher,5,0,20,15
1746596488476,BIEB 194,A00,906141,Kurle; Carolyn M.,5,0,20,15
1746596489505,BILD 1,A01,894154,Staff,3,0,19,16
1746596489505,BILD 1,A02,894155,Staff,14,0,19,5
1746596489505,BILD 1,A03,894160,Staff,13,0,19,6
1746596489505,BILD 1,A04,894161,Staff,15,0,18,3
1746596490531,BILD 2,A01,894168,Staff,0,0,50,50
1746596490531,BILD 2,A02,894169,Staff,0,0,50,50
1746596490531,BILD 2,A03,894179,Staff,0,0,50,50
1746596490531,BILD 2,A04,894203,Staff,23,0,50,27
1746596491560,BILD 3,A01,894213,Staff,23,0,31,8
1746596491560,BILD 3,A02,894214,Staff,26,0,31,5
1746596491560,BILD 3,A03,894235,Staff,28,0,31,3
1746596491560,BILD 3,A04,894236,Staff,28,0,32,4
1746596492585,BILD 4,A01,894253,Reuther; Keefe,5,0,24,19
1746596492585,BILD 4,A02,894258,Reuther; Keefe,16,0,24,8
1746596493614,BILD 5,A01,894276,Reuther; Keefe,34,0,50,16
1746596493614,BILD 5,A02,894277,Reuther; Keefe,45,0,50,5
1746596493614,BILD 5,A03,894290,Reuther; Keefe,44,0,50,6
1746596493614,BILD 5,A04,894291,Reuther; Keefe,48,0,50,2
1746596494640,BILD 24,A01,894297,Pirino; Giorgia,40,0,60,20
1746596495664,BIMM 100,B01,958915,Staff,71,0,100,29
1746596496692,BIMM 101,A01,895017,McDonnell; Lisa Marie,0,5,24,24
1746596496692,BIMM 101,A02,895018,McDonnell; Lisa Marie,0,5,24,24
1746596496692,BIMM 101,B01,895020,McDonnell; Lisa Marie,0,5,24,24
1746596496692,BIMM 101,B02,895021,McDonnell; Lisa Marie,0,4,24,24
1746596497720,BIMM 110,A01,895023,Staff,1,0,25,24
1746596497720,BIMM 110,A02,895024,Staff,9,0,25,16
1746596497720,BIMM 110,A03,895025,Staff,18,0,25,7
1746596497720,BIMM 110,A04,895031,Staff,20,0,25,5
1746596498746,BIMM 120,A01,895114,Gustafson-Brown; Cindy,14,0,28,14
1746596498746,BIMM 120,A02,895126,Gustafson-Brown; Cindy,21,0,27,6
1746596499772,BIPN 100,A01,895130,Yang; Mingyu,0,0,38,38
1746596499772,BIPN 100,A02,895131,Yang; Mingyu,31,0,38,7
1746596499772,BIPN 100,A03,895132,Yang; Mingyu,32,0,38,6
1746596499772,BIPN 100,A04,895133,Yang; Mingyu,27,0,36,9
1746596500797,BIPN 120,A01,895135,Cooke; James Edward,0,3,13,13
1746596500797,BIPN 120,A02,895136,Cooke; James Edward,0,1,13,13
1746596500797,BIPN 120,A03,895137,Cooke; James Edward,0,3,13,13
1746596500797,BIPN 120,A04,895156,Cooke; James Edward,0,2,11,11
1746596501823,BIPN 134,A01,895235,Cooke; James Edward,0,1,25,25
1746596501823,BIPN 134,A02,895237,Cooke; James Edward,0,0,25,25
1746596501823,BIPN 134,A03,895240,Cooke; James Edward,2,0,25,23
1746596501823,BIPN 134,A04,895270,Cooke; James Edward,20,0,25,5
1746596502850,BIPN 189,A00,892103,Staff,0,14,14,14
1746596504902,BISP 194,A00,958008,Staff,0,2,0,0
1746596505925,CAT 124,A01,922009,Staff,0,5,20,20
1746596506952,CAT 125R,A00,886390,Morales; Celeste Georgianna,0,3,20,20
1746596506952,CAT 125R,B00,886391,Irwin; Matthew Joseph,0,4,20,20
1746596506952,CAT 125R,C00,886392,Smith; Lauryn Alissa,0,2,20,20
1746596506952,CAT 125R,D00,886393,Vanderschuit; Maya Alysia,0,3,20,20
1746596506952,CAT 125R,E00,886394,Marchisotto; Jennifer Anne,0,3,20,20
1746596507977,CENG 15,A01,886218,Drews; Aaron,3,0,8,5
1746596509003,CENG 113,A00,886219,Opatkiewicz; Justin Paul,15,0,25,10
1746596510027,CGS 101,A00,887044,Staff,7,0,20,13
1746596511055,CGS 105,A01,887046,Staff,14,0,25,11
1746596512081,CGS 112,A00,887047,Cuong; Marisol,12,0,15,3
1746596513109,CGS 113,A00,887048,Staff,23,0,30,7
1746596514133,CGS 120,A00,887049,Staff,10,0,17,7
1746596515162,CHEM 6A,A01,886336,Lam; Tin Yiu,38,0,50,12
1746596515162,CHEM 6A,A02,886338,Lam; Tin Yiu,37,0,50,13
1746596516189,CHEM 6B,A01,886341,Hopkins; Patrycja Anna,16,0,50,34
1746596516189,CHEM 6B,A02,886343,Hopkins; Patrycja Anna,42,0,50,8
1746596517214,CHEM 6C,A01,886346,Albizati; Kim F.,0,2,50,50
1746596517214,CHEM 6C,A02,886348,Albizati; Kim F.,24,0,50,26
1746596518240,CHEM 40A,A01,886352,Klosterman; Jeremy K,65,0,100,35
1746596519266,CHEM 40B,A01,886356,Klosterman; Jeremy K,0,24,100,100
1746596520292,CHEM 41B,A01,886360,Theodorakis; Emmanuel,25,0,50,25
1746596520292,CHEM 41B,A02,886362,Theodorakis; Emmanuel,47,0,50,3
1746596521318,CHIN 165A,A00,886382,Xu; Li,18,0,20,2
1746596522343,CLAS 120,A00,886387,Myerston Santana; Jacobo,33,0,40,7
1746596523370,COGS 9,A01,886967,Shannon; Kyle Michael,42,0,60,18
1746596524393,COGS 11,A01,886969,Staff,9,0,30,21
1746596525418,COGS 14A,A01,886971,Staff,5,0,60,55
1746596526447,COGS 14B,A01,886973,Hoffman; Drew Ellen,4,0,60,56
1746596527472,COGS 18,A01,886975,Morgan; Eric,34,0,60,26
1746596528498,COGS 20,A01,886977,Staff,3,0,8,5
1746596528498,COGS 20,A02,886978,Staff,5,0,7,2
1746596529526,COGS 100,A01,907783,Staff,0,1,30,30
1746596530552,COGS 101B,A01,886980,Staff,0,4,48,48
1746596531578,COGS 101C,A01,886982,Delgado; Tania,0,5,44,44
1746596532605,COGS 102A,A01,886984,Johnson; Christine M.,3,0,30,27
1746596533629,COGS 118B,A01,886986,Staff,0,4,88,88
1746596534656,COGS 150,A01,886988,Bergen; Benjamin,22,0,50,28
1746596535681,COGS 153,A00,886989,Delgado; Tania,0,3,41,41
1746596536709,COGS 186,A01,886991,Staff,0,0,32,32
1746596537735,COGS 187A,A01,886993,Boyle; Mary E. T.,7,0,30,23
1746596538759,COGS 189,A00,886994,Staff,0,1,30,30
1746596539786,COMM 10,A01,886996,Staff,0,0,20,21
1746596539786,COMM 10,A02,886997,Staff,10,0,20,10
1746596539786,COMM 10,A03,959845,Staff,19,0,20,1
1746596540814,COMM 20,A01,886999,Leuning; Grant Maurstad,24,0,40,16
1746596542864,COMM 100A,A01,887002,Staff,0,0,20,25
1746596542864,COMM 100A,A02,887003,Staff,5,0,20,15
1746596543891,COMM 100B,A01,887005,Staff,0,8,20,24
1746596544917,COMM 106D,A00,887006,Staff,13,0,40,27
1746596545942,COMM 110G,A00,887007,Whitworth-Smith; Andrew C,12,0,40,28
1746596546969,COMM 111B,A00,887008,Staff,31,0,40,9
1746596547997,COMM 113T,A00,887009,Abuelhiga; Soraya Jill,28,0,40,12
1746596547997,COMM 113T,B00,906733,Staff,39,0,40,1
1746596549022,COMM 145,A00,887010,Staff,12,0,40,28
1746596550048,COMM 146,A00,887054,Staff,31,0,40,9
1746596551075,COMM 190,A00,887012,Staff,8,0,23,15
1746596552103,CSE 8A,A50,887015,Cao; Yingjun,56,0,85,29
1746596553127,CSE 11,A01,887017,Cao; Yingjun,11,0,70,59
1746596554153,CSE 20,A01,887019,Staff,30,0,50,20
1746596555179,CSE 21,A01,887021,Staff,79,0,100,21
1746596555179,CSE 21,B01,892583,Braun; Oliver,45,0,50,5
1746596556207,CSE 30,A01,887025,Eldon; John,142,0,200,58
1746596557232,CSE 100,A01,887027,Staff,26,0,50,24
1746596557232,CSE 100,A02,887028,Staff,42,0,50,8
1746596558257,CSE 101,A01,887030,Braun; Oliver,74,0,100,26
1746596558257,CSE 101,B01,887032,Jones; Miles E,0,3,50,50
1746596558257,CSE 101,B02,887033,Jones; Miles E,0,2,50,50
1746596559284,CSE 105,A01,908084,Jones; Miles E,32,0,50,18
1746596559284,CSE 105,A02,908087,Jones; Miles E,31,0,50,19
1746596560310,CSE 135,A01,887035,Powell; Thomas Allan,0,5,50,50
1746596561335,CSE 142,A01,887037,Staff,8,0,60,52
1746596562364,CSE 142L,A01,887039,Staff,34,0,60,26
1746596563388,CSE 151A,A01,887041,Solares; Edwin A,47,0,100,53
1746596564415,CSE 175,A01,887043,Kumar; Rakesh,30,0,30,0
1746596565442,CSS 1,A01,886389,Staff,0,1,40,40
1746596566469,DSC 30,A01,908097,Liao; Soohyun Nam,47,0,75,28
1746596567493,DSC 40A,A01,908099,Shannon; Kyle Michael,30,0,50,20
1746596568521,DSC 40B,A01,908112,Staff,15,0,50,35
1746596569551,DSC 80,A01,908116,Staff,19,0,60,41
1746596570579,DSC 197,001,956863,Eldridge; Justin Matthew,9999,0,9999,0
1746596571607,ECE 5,A01,886400,Morris; Karcher William,1,0,6,5
1746596571607,ECE 5,A02,886401,Morris; Karcher William,3,0,6,3
1746596572640,ECE 148,A01,886403,Silberman; Jack,0,14,14,14
1746596573664,ECON 1,A01,887265,Crane; Meredith Helen,11,0,70,59
1746596573664,ECON 1,B01,887268,Staff,42,0,50,8
1746596574690,ECON 2,A01,887273,Crane; Meredith Helen,54,0,70,16
1746596575719,ECON 3,A01,887279,Rondina; Giacomo,31,0,70,39
1746596576746,ECON 4,A01,887282,Anderson; John Charles,0,2,10,10
1746596577775,ECON 5,A01,887285,Staff,34,0,45,11
1746596577775,ECON 5,B01,887292,Staff,41,0,45,4
1746596578804,ECON 100A,A01,887337,Newhouse; Herbert S,54,0,70,16
1746596578804,ECON 100A,B01,887349,Staff,45,0,50,5
1746596579830,ECON 100B,A01,887361,Du; Songzi,29,0,70,41
1746596580854,ECON 100C,A01,887445,Newhouse; Herbert S,59,0,70,11
1746596581880,ECON 105,A00,887488,Vespa; Emanuel Ignacio,23,0,35,12
1746596582949,ECON 109,A01,887506,Shishkin; Denis,28,0,35,7
1746596583979,ECON 110A,A01,887568,Alon; Titan Michael,0,2,35,35
1746596583979,ECON 110A,B01,907601,Alon; Titan Michael,20,0,35,15
1746596585003,ECON 110B,A01,887598,Levkoff; Steven B.,0,24,70,70
1746596586032,ECON 112,A00,887599,Rondina; Giacomo,19,0,35,16
1746596587061,ECON 120A,A01,887603,Dai; Yinlin,35,0,70,35
1746596588092,ECON 120C,A01,887608,Sun; Yixiao,0,1,35,35
1746596588092,ECON 120C,B01,887614,Sun; Yixiao,0,0,35,35
1746596589118,ECON 138,A00,887621,Bharadwaj; Prashant,0,21,20,20
1746596590144,ECON 144,A00,958007,Squires; Dale E,12,0,35,23
1746596591170,ECON 171,A01,907666,Staff,18,0,35,17
1746596592198,ECON 175,A00,887626,Wu; Pak Yeung,22,0,35,13
1746596593223,ECON 190,A00,887640,Vespa; Emanuel Ignacio,22,0,35,13
1746596594257,EDS 25,A01,888197,Staff,0,0,0,0
1746596594257,EDS 25,A02,888209,Staff,0,0,0,0
1746596594257,EDS 25,A03,888210,Staff,0,0,0,0
1746596594257,EDS 25,A04,888212,Staff,0,0,0,0
1746596594257,EDS 25,A05,888213,Staff,0,0,0,0
1746596594257,EDS 25,A06,888214,Staff,0,0,0,0
1746596594257,EDS 25,A07,888235,Staff,0,2,0,0
1746596594257,EDS 25,A08,888236,Staff,0,0,0,0
1746596594257,EDS 25,A09,888240,Staff,0,0,0,0
1746596594257,EDS 25,A10,888244,Staff,0,0,0,0
1746596594257,EDS 25,B01,888273,Staff,0,0,0,0
1746596594257,EDS 25,B02,888285,Staff,0,0,0,0
1746596594257,EDS 25,B03,888423,Staff,0,0,0,1
1746596594257,EDS 25,B04,888432,Staff,0,0,0,0
1746596594257,EDS 25,B05,888433,Staff,0,0,0,0
1746596594257,EDS 25,B06,888467,Staff,0,0,0,0
1746596594257,EDS 25,B07,888468,Staff,0,0,0,0
1746596594257,EDS 25,B08,888479,Staff,0,0,0,0
1746596594257,EDS 25,B09,888484,Staff,0,0,0,0
1746596594257,EDS 25,B10,888487,Staff,0,0,0,0
1746596595284,EDS 38,A01,907700,Choi; Bailey Miyeon,30,0,30,0
1746596596310,EDS 112,A01,888601,Chapman; Thandeka K,12,0,40,28
1746596597338,EDS 115,A00,888697,Mendez; Kathrina Mendoza,10,0,30,20
1746596598365,EDS 116,A01,888893,Staff,33,0,40,7
1746596600415,EDS 124AR,A00,889133,Staff,29,0,50,21
1746596600415,EDS 124AR,B00,907471,Simon; Elizabeth A,37,0,50,13
1746596601439,EDS 124BR,A00,889134,Simon; Elizabeth A,44,0,100,56
1746596602465,EDS 125,A00,889135,Staff,25,0,30,5
1746596603493,EDS 126,A01,889138,Staff,35,0,40,5
1746596604519,EDS 164R,A01,889142,Wishard Guerra; Alison G.,32,0,50,18
1746596605544,ENG 30,A01,886396,Staff,0,0,0,0
1746596605544,ENG 30,B01,886398,Staff,0,0,0,0
1746596606571,ENVR 102,A00,906150,Montejo; Carolina,23,0,25,2
1746596607596,ETHN 103A,A00,887236,Man; Simeon S,0,2,0,0
1746596608622,ETHN 113,A00,887239,Staff,16,0,30,14
1746596609711,ETHN 116,A00,887240,Staff,16,0,25,9
1746596610735,ETHN 117,A00,887241,Choi; Esther Min,28,0,30,2
1746596611760,ETHN 118,A00,887243,Staff,24,0,30,6
1746596612788,ETHN 127,A00,887248,Cuong; Marisol,11,0,15,4
1746596613813,ETHN 139,A00,887250,Staff,7,0,10,3
1746596614839,ETHN 142,A00,887252,Staff,10,0,30,20
1746596615868,ETHN 161,A00,887253,Browne; Errol Tsekani,24,0,30,6
1746596616894,ETHN 163FR,A00,887255,Burelle; Julie Sara Veronique,0,0,5,5
1746596617920,GLBH 20,A00,889149,Elwardani; Nile Regina,8,0,42,34
1746596619971,GLBH 111,A01,889152,Burgos; Jose L.,17,0,17,0
1746596620996,GLBH 150,A00,889181,Sloane; Julia Kathryn,0,5,15,15
1746596623048,HDS 60,A01,886406,Warstadt; Melissa Fawn,72,0,80,8
1746596624076,HIAF 111,A00,889324,Gyamfi; Bright,25,0,32,7
1746596625102,HIEA 131,A00,889328,Staff,15,0,32,17
1746596626129,HIEA 144,A00,889333,Henry; Todd A.,26,0,32,6
1746596627157,HIEA 154,A00,889336,Henry; Todd A.,24,0,32,8
1746596628186,HIEU 106,A00,889339,Staff,22,0,32,10
1746596630237,HIEU 114,A00,889340,Staff,4,0,32,28
1746596631265,HIEU 135GS,A00,889342,Patterson; Patrick H.,0,0,1,24
1746596632289,HIEU 137,A00,889343,Edington; Claire Ellen,10,0,25,15
1746596633315,HIEU 148,A00,889345,Staff,14,0,32,18
1746596634342,HIEU 154,A00,889346,Biess; Frank Peter,21,0,32,11
1746596635370,HILA 102,A00,889351,Staff,12,0,32,20
1746596636398,HILD 2A,A01,889221,Lewandoski; Julia Mavis,0,8,32,32
1746596637429,HILD 7B,A01,889225,Man; Simeon S,0,12,32,32
1746596638454,HILD 7C,A01,889288,Alvarez; Luis A,0,14,32,32
1746596639479,HILD 30,A01,889323,Staff,0,5,32,32
1746596641531,HISC 119,A00,889383,Golan; Tal,20,0,32,12
1746596642560,HIUS 103,A00,889384,Man; Simeon S,0,0,32,32
1746596643586,HIUS 117,A00,919797,Kwak; Nancy,18,0,32,14
1746596644612,HIUS 142A,A00,919788,Staff,22,0,32,10
1746596646661,HIUS 149,A00,889386,Gyamfi; Bright,26,0,32,6
1746596647688,HIUS 155,A00,889387,Alvarez; Luis A,15,0,32,17
1746596648715,HUM 3,A01,886499,Caldwell; Michael Alan,19,0,50,31
1746596649741,HUM 3GS,A00,886500,Rodriguez; Bretton Sigfred,0,0,0,28
1746596650766,HUM 3R,A01,886502,Markman; Kristina,0,36,50,50
1746596651791,HUM 4,A01,886504,Crum; Matthew Stephen,23,0,50,27
1746596651791,HUM 4,B01,886506,West; Geoffrey Scott,17,0,50,33
1746596652815,HUM 4GS,A00,886507,Staff,0,0,0,19
1746596653840,HUM 5,A01,886509,Staff,31,0,50,19
1746596654866,HUM 5R,A01,886511,Zavodny; Tatiana Sophia,0,39,50,50
1746596655893,JAPN 180,A00,886407,Staff,16,0,40,24
1746596656919,LATI 50,A01,886409,Martin-Cabrera; Luis,3,0,22,19
1746596656919,LATI 50,A02,886410,Martin-Cabrera; Luis,19,0,22,3
1746596656919,LATI 50,A03,886411,Martin-Cabrera; Luis,21,0,22,1
1746596656919,LATI 50,A04,886412,Martin-Cabrera; Luis,8,0,22,14
1746596657945,LAWS 101,A00,907664,Staff,28,0,60,32
1746596658973,LIAB 1A,A00,889388,Saab; Dima,17,0,20,3
1746596659999,LIAB 1AX,A00,889389,El Cheddadi; Youniss,18,0,20,2
1746596661024,LIFR 1C,A00,889391,Van Moer; Vinciane G,8,0,20,12
1746596662051,LIFR 1CX,A00,889392,Van Moer; Vinciane G,7,0,20,13
1746596663079,LIFR 1D,A00,889393,Van Moer; Vinciane G,7,0,20,13
1746596664105,LIFR 1DX,A00,889394,Van Moer; Vinciane G,8,0,20,12
1746596665130,LIGN 7,A00,886923,Staff,25,0,50,25
1746596666156,LIGN 17,A00,886924,Kehler; Andrew Scott,126,0,150,24
1746596667181,LTAM 110,A00,889395,Staff,15,0,30,15
1746596668206,LTAM 110GS,A00,958010,Rodriguez; Bretton Sigfred,0,0,0,28
1746596669233,LTCH 101,A00,889397,Staff,23,0,25,2
1746596670258,LTCS 130,A00,889398,Staff,23,0,25,2
1746596671282,LTEA 138,A00,889399,Staff,24,0,40,16
1746596672309,LTEN 149,A00,889400,Wesling; Megan E.,0,3,25,25
1746596673344,LTEN 169,A00,889401,Staff,20,0,25,5
1746596674370,LTEN 180,A00,889402,Staff,10,0,15,5
1746596675393,LTEN 181,A00,889403,Staff,21,0,25,4
1746596676418,LTWL 100,A00,889404,Myerston Santana; Jacobo,2,0,25,23
1746596677444,LTWL 180GS,A00,889405,Staff,0,0,20,20
1746596678470,LTWL 181,A00,889406,Staff,16,0,25,9
1746596679495,LTWL 184,A00,889475,Mukherjee; Silpa,22,0,25,3
1746596680521,LTWR 102C,A00,889486,Staff,29,0,30,1
1746596681545,LTWR 115W,A00,889491,Staff,0,2,15,15
1746596682573,MAE 8,A01,886905,Staff,0,2,0,0
1746596683597,MAE 11,A00,886906,Bandaru; Prabhakar,0,7,50,50
1746596684626,MAE 20,A00,886907,Evdokimenko; Ekaterina,43,0,70,27
1746596685654,MAE 30B,A00,886909,Ghazinejad; Maziar,25,0,45,20
1746596686678,MAE 101B,A00,886910,Saintillan; David,30,0,45,15
1746596687703,MAE 105,A00,886911,Bandaru; Prabhakar,18,0,50,32
1746596688730,MAE 107,B00,958024,Staff,7,0,50,43
1746596689755,MAE 143B,A00,886913,Bewley; Thomas R,2,0,40,38
1746596690781,MAE 148,A01,886915,Silberman; Jack,0,3,14,14
1746596691807,MAE 160,A00,886916,Evdokimenko; Ekaterina,31,0,60,29
1746596692834,MATH 3C,A01,889681,Staff,0,2,30,30
1746596692834,MATH 3C,A02,960048,Staff,23,0,30,7
1746596693862,MATH 10A,A01,889760,Staff,26,0,30,4
1746596693862,MATH 10A,A02,889783,Staff,29,0,30,1
1746596694891,MATH 10B,A01,889785,Verstraete; Jacques Allan,1,0,35,34
1746596694891,MATH 10B,A02,889795,Verstraete; Jacques Allan,4,0,35,31
1746596694891,MATH 10B,B01,889797,Verstraete; Jacques Allan,3,0,35,32
1746596694891,MATH 10B,B02,889828,Verstraete; Jacques Allan,3,0,35,32
1746596695918,MATH 10C,A01,889849,Habib; Yousaf,8,0,30,22
1746596695918,MATH 10C,A02,889852,Habib; Yousaf,14,0,30,16
1746596695918,MATH 10C,A03,889853,Habib; Yousaf,22,0,30,8
1746596695918,MATH 10C,A04,889858,Habib; Yousaf,20,0,30,10
1746596695918,MATH 10C,B01,889861,Staff,1,0,30,29
1746596695918,MATH 10C,B02,889862,Staff,24,0,30,6
1746596695918,MATH 10C,B03,889863,Staff,27,0,30,3
1746596695918,MATH 10C,B04,889967,Staff,23,0,30,7
1746596696944,MATH 18,A01,889974,Staff,7,0,30,23
1746596696944,MATH 18,A02,889977,Staff,20,0,30,10
1746596696944,MATH 18,B01,889984,Hardiman; Liam,20,0,30,10
1746596696944,MATH 18,B02,889985,Hardiman; Liam,25,0,30,5
1746596697969,MATH 20A,A01,889990,Suk; Andrew Hoon,30,0,35,5
1746596698997,MATH 20B,A01,889993,Ohm; Ko Woon,21,0,30,9
1746596698997,MATH 20B,A02,889994,Ohm; Ko Woon,30,0,30,0
1746596698997,MATH 20B,B01,889996,Ohm; Ko Woon,22,0,30,8
1746596698997,MATH 20B,B02,889997,Ohm; Ko Woon,23,0,30,7
1746596700030,MATH 20C,A01,889999,Hammock; Frances H,17,0,30,13
1746596700030,MATH 20C,A02,890003,Hammock; Frances H,23,0,30,7
1746596700030,MATH 20C,B01,890006,Hammock; Frances H,3,0,30,27
1746596700030,MATH 20C,B02,890007,Hammock; Frances H,12,0,30,18
1746596701077,MATH 20D,A01,890011,Cheng; Hsiao-Bing,0,0,30,30
1746596701077,MATH 20D,A02,890012,Cheng; Hsiao-Bing,14,0,30,16
1746596701077,MATH 20D,B01,890016,Cheng; Hsiao-Bing,13,0,30,17
1746596701077,MATH 20D,B02,890017,Cheng; Hsiao-Bing,13,0,30,17
1746596702108,MATH 20E,A01,890026,Harel; Guershon,1,0,30,29
1746596702108,MATH 20E,A02,890029,Harel; Guershon,22,0,30,8
1746596702108,MATH 20E,B01,890033,Harel; Guershon,7,0,30,23
1746596702108,MATH 20E,B02,890101,Harel; Guershon,21,0,30,9
1746596703134,MATH 102,A01,890104,Staff,18,0,30,12
1746596703134,MATH 102,A02,890105,Staff,27,0,30,3
1746596704163,MATH 103B,A01,890116,Salehi Golsefidy; Alireza,3,0,30,27
1746596704163,MATH 103B,B01,890118,Staff,0,3,34,34
1746596716262,MATH 109,A01,890121,Aliabadi Sr.; Mohsen,0,0,30,30
1746596716262,MATH 109,B01,890124,Upadrashta; Pranav Kumar,18,0,30,12
1746596717287,MATH 120A,A01,890126,Eggers; John Dietrich,13,0,30,17
1746596718312,MATH 142B,A01,890128,Ioana; Adrian,19,0,30,11
1746596718312,MATH 142B,A02,890129,Ioana; Adrian,12,0,30,18
1746596719341,MATH 154,A01,890174,Staff,0,1,30,30
1746596719341,MATH 154,A02,890182,Staff,0,0,30,30
1746596720369,MATH 168A,A01,890197,Dumitriu; Ioana,21,0,35,14
1746596721394,MATH 170A,A01,890240,Nie; Jiawang,1,0,30,29
1746596721394,MATH 170A,A02,890241,Nie; Jiawang,11,0,30,19
1746596721394,MATH 170A,A03,890249,Nie; Jiawang,23,0,30,7
1746596722420,MATH 170B,A01,957891,Nag; Panchali,13,0,35,22
1746596724476,MATH 181A,A01,908025,Staff,0,3,35,35
1746596724476,MATH 181A,A02,960115,Staff,26,0,35,9
1746596725505,MATH 181B,A01,959874,Staff,24,0,30,6
1746596726536,MATH 193B,A01,890265,Staff,0,4,35,35
1746596727563,MGT 4,A01,890311,Anderson; John Charles,42,0,88,46
1746596728592,MGT 5,A00,907740,Staff,12,0,98,86
1746596729617,MGT 12,A00,890312,Lindenberger; Wade Douglas,67,0,98,31
1746596730646,MGT 16,A00,957883,Staff,78,0,98,20
1746596732702,MGT 45,A00,890314,Pecore; Joseph P.,45,0,98,53
1746596733728,MGT 71,A00,890315,Staff,0,12,98,98
1746596734753,MGT 100,A00,890316,Yavorsky; Daniel Ryan,44,0,98,54
1746596735780,MGT 103,A00,890317,Ehrich; Kristine R,73,0,98,25
1746596736809,MGT 105,A00,890356,Bates; Kenneth Walter,0,8,98,98
1746596737837,MGT 112,A00,890360,Ehrich; Kristine R,55,0,98,43
1746596738864,MGT 127R,A00,907732,Zhu; Kevin Xiaoguo,23,0,98,75
1746596739889,MGT 131B,A00,890361,Anderson; John Charles,59,0,98,39
1746596740913,MGT 137,A00,890362,Lindenberger; Wade Douglas,65,0,98,33
1746596741938,MGT 160,A00,890369,Johnson; Erik Barry,9,0,98,89
1746596743994,MGT 164,A00,890372,Zimmermann; Carsten,0,40,98,98
1746596745023,MGT 180,A00,890374,Bliss; Barbara Ann,11,0,98,87
1746596746053,MMW 15,A01,886414,Chang; Edmond Yi-Teh,0,12,28,28
1746596746053,MMW 15,A02,886415,Chang; Edmond Yi-Teh,0,8,28,28
1746596746053,MMW 15,A03,886416,Chang; Edmond Yi-Teh,0,9,28,28
1746596746053,MMW 15,A04,886417,Chang; Edmond Yi-Teh,0,8,28,28
1746596746053,MMW 15,B01,886419,Chang; Edmond Yi-Teh,0,7,28,28
1746596746053,MMW 15,B02,886420,Chang; Edmond Yi-Teh,0,7,28,28
1746596746053,MMW 15,B03,886421,Chang; Edmond Yi-Teh,0,7,28,28
1746596746053,MMW 15,B04,886422,Chang; Edmond Yi-Teh,0,8,28,28
1746596746053,MMW 15,C01,886424,Staff,0,9,28,28
1746596746053,MMW 15,C02,886425,Staff,0,8,28,28
1746596746053,MMW 15,C03,886426,Staff,0,8,28,28
1746596746053,MMW 15,C04,886427,Staff,0,8,28,28
1746596746053,MMW 15,C05,958038,Staff,0,8,28,28
1746596746053,MMW 15,C06,958039,Staff,0,7,28,28
1746596747078,MMW 15GS,A00,906910,Patterson; Patrick H.,4,0,28,24
1746596748105,MMW 122R,A01,886429,Rahimi; Babak,0,13,28,28
1746596748105,MMW 122R,A02,886430,Rahimi; Babak,0,12,28,28
1746596748105,MMW 122R,A03,958040,Rahimi; Babak,0,11,28,28
1746596749137,MUS 1A,A01,890937,Staff,2,0,25,23
1746596749137,MUS 1A,A02,891035,Staff,6,0,25,19
1746596749137,MUS 1A,C01,958912,Staff,24,0,25,1
1746596749137,MUS 1A,C02,958913,Staff,25,0,25,0
1746596751191,MUS 2AK,A00,957092,Ohnishi; Takae,15,0,15,0
1746596752222,MUS 4,A01,891044,Staff,0,0,25,25
1746596752222,MUS 4,A02,891045,Staff,22,0,25,3
1746596752222,MUS 4,B01,891048,Staff,17,0,25,8
1746596752222,MUS 4,B02,891050,Staff,25,0,25,0
1746596753252,MUS 5,A01,957506,Dubnov; Shlomo,0,0,25,25
1746596753252,MUS 5,A02,957622,Dubnov; Shlomo,13,0,25,12
1746596753252,MUS 5,A03,957623,Dubnov; Shlomo,20,0,25,5
1746596754282,MUS 6,A01,891053,Freitas Caetano; Marcelo,24,0,25,1
1746596754282,MUS 6,A02,891054,Freitas Caetano; Marcelo,23,0,25,2
1746596755308,MUS 7,A01,891081,Staff,0,0,25,25
1746596755308,MUS 7,A02,891082,Staff,3,0,25,22
1746596756334,MUS 8GS,A00,891118,Borgo; David Garcia,1,0,25,24
1746596757358,MUS 11,A01,891140,Staff,8,0,25,17
1746596757358,MUS 11,A02,891141,Staff,21,0,25,4
1746596758384,MUS 13,A01,891143,Staff,8,0,25,17
1746596758384,MUS 13,A02,891144,Staff,24,0,25,1
1746596759411,MUS 15,A01,891146,Staff,9,0,25,16
1746596759411,MUS 15,A02,891148,Staff,21,0,25,4
1746596759411,MUS 15,B01,891150,Staff,18,0,25,7
1746596759411,MUS 15,B02,891151,Staff,25,0,25,0
1746596760440,MUS 20,A01,891153,Staff,5,0,20,15
1746596760440,MUS 20,A02,891155,Staff,14,0,20,6
1746596761465,MUS 80,A00,891156,Staff,19,0,25,6
1746596761465,MUS 80,B00,891157,Staff,23,0,25,2
1746596762493,MUS 130,A00,891158,Ohnishi; Takae,35,0,35,0
1746596763542,MUS 150GS,A01,891160,Borgo; David Garcia,1,0,25,24
1746596764567,MUS 170,A01,891162,Freitas Caetano; Marcelo,20,0,25,5
1746596764567,MUS 170,A02,891164,Freitas Caetano; Marcelo,21,0,25,4
1746596765596,NANO 11,A00,886220,Vazquez Mena; Oscar,13,0,15,2
1746596766623,NANO 15,A01,886222,Drews; Aaron,4,0,7,3
1746596767649,NANO 104,A00,886224,Sirbuly; Donald,17,0,25,8
1746596768675,PH 40,A00,886528,Staff,23,0,40,17
1746596769705,PH 45,A01,886799,Staff,35,0,40,5
1746596770731,PH 110,A00,886802,Staff,0,6,40,40
1746596771760,PH 172,A00,906716,Staff,19,0,35,16
1746596772786,PH 191,A00,886803,Staff,6,0,40,34
1746596773815,PHIL 1,A00,889500,Staff,20,0,30,10
1746596774841,PHIL 10,A01,889549,Grush; Rick Scott,16,0,22,6
1746596774841,PHIL 10,A02,889551,Grush; Rick Scott,22,0,22,0
1746596775870,PHIL 28,A01,889559,Lamey; Andy M.,0,2,31,31
1746596775870,PHIL 28,A02,889561,Lamey; Andy M.,0,1,30,30
1746596775870,PHIL 28,A03,889572,Lamey; Andy M.,0,1,30,30
1746596776896,PHIL 35,A00,907839,Staff,13,0,15,2
1746596777924,PHIL 60,A00,889574,Staff,73,0,90,17
1746596778951,PHIL 101,A00,958004,Staff,12,0,15,3
1746596781011,PHIL 136,A00,889582,Fulkerson; Matthew Todd,26,0,45,19
1746596782040,PHIL 163,A01,889601,Staff,21,0,30,9
1746596782040,PHIL 163,B01,889606,Brandt; Reuven A,0,3,0,0
1746596783068,PHIL 164,A00,889610,Staff,16,0,30,14
1746596784095,PHIL 165,A00,889613,Staff,22,0,30,8
1746596785123,PHYS 1A,A00,886431,Staff,30,0,70,40
1746596786148,PHYS 1AL,001,886432,Tsai; Philbert S,0,1,30,30
1746596786148,PHYS 1AL,002,886436,Tsai; Philbert S,13,0,30,17
1746596787173,PHYS 1B,A00,886439,Staff,184,0,240,56
1746596788198,PHYS 1BL,001,886441,Tsai; Philbert S,0,4,30,30
1746596788198,PHYS 1BL,002,886444,Tsai; Philbert S,2,0,30,28
1746596789226,PHYS 1C,A00,896092,Arnold; Kam S,78,0,146,68
1746596790251,PHYS 1CL,001,886448,Tsai; Philbert S,0,0,30,30
1746596790251,PHYS 1CL,002,886449,Tsai; Philbert S,1,0,30,29
1746596790251,PHYS 1CL,003,886450,Tsai; Philbert S,16,0,30,14
1746596790251,PHYS 1CL,004,886451,Tsai; Philbert S,15,0,30,15
1746596791279,PHYS 2B,A01,886457,Staff,67,0,115,48
1746596792307,PHYS 2C,A01,886460,Shotwell; Brian,0,9,65,65
1746596793332,PHYS 2CL,A01,886467,Staff,0,4,28,28
1746596793332,PHYS 2CL,A02,886468,Staff,0,3,28,28
1746596794361,PHYS 2D,A01,886470,Staff,10,0,50,40
1746596795385,PHYS 4B,A01,886475,Grinstein; Benjamin,22,0,40,18
1746596796410,POLI 5,A00,891173,Desposato; Scott,7,0,25,18
1746596797435,POLI 5D,A01,891175,Staff,5,0,5,0
1746596797435,POLI 5D,B01,891178,Staff,5,0,5,0
1746596798463,POLI 11,A00,891179,Ferree; Karen E,1,0,35,34
1746596799490,POLI 12,A00,891180,Staff,15,0,30,15
1746596800515,POLI 27,A01,891182,Staff,12,0,75,63
1746596802089,POLI 30,A00,891183,Staff,8,0,50,42
1746596803116,POLI 100B,A00,891244,Staff,5,1,35,30
1746596804143,POLI 100I,A00,891247,Staff,7,0,30,23
1746596805172,POLI 104J,A00,891248,Nichter; Maysa,14,0,30,16
1746596806201,POLI 104U,A00,891250,Nichter; Maysa,1,0,30,29
1746596808251,POLI 110B,A00,891255,Wiens; David,19,0,25,6
1746596809275,POLI 112A,A00,891256,Wiens; David,6,0,25,19
1746596810302,POLI 114BR,A00,891261,Staff,19,0,30,11
1746596811330,POLI 117R,A00,891262,Forman; Fonna,0,6,50,50
1746596812353,POLI 118,A00,891264,Ingham; Sean,17,0,25,8
1746596813380,POLI 124A,A00,891265,Staff,18,0,20,2
1746596814404,POLI 125D,A00,891266,Nichter; Simeon C,2,0,25,23
1746596815428,POLI 126,A00,891268,Nichter; Simeon C,7,0,25,18
1746596816453,POLI 126AA,A00,891272,Staff,15,0,25,10
1746596817480,POLI 130AA,A00,891273,Staff,15,0,20,5
1746596818504,POLI 134AA,A00,891274,Staff,4,0,20,16
1746596820560,POLI 138,A00,891278,Staff,21,0,25,4
1746596821586,POLI 142K,A00,891280,Staff,10,0,25,15
1746596822614,POLI 142M,A00,891281,Gartzke; Erik,16,0,30,14
1746596823640,POLI 142P,A00,891284,Staff,20,0,30,10
1746596824665,POLI 143,A00,891285,Gartzke; Erik,12,0,30,18
1746596825690,POLI 153,A00,891286,Staff,19,0,20,1
1746596827741,POLI 175,A00,891290,Staff,15,0,20,5
1746596828769,PSYC 1,A00,890674,Steiner; Eric Tomas,0,11,45,45
1746596829794,PSYC 2,A00,890676,Albright; Thomas D,20,0,35,15
1746596830821,PSYC 3,A00,890679,Staff,17,0,20,3
1746596831846,PSYC 6,A00,959858,Staff,19,0,20,1
1746596832871,PSYC 60,A01,890684,Rickard; Timothy C.,0,6,45,45
1746596833899,PSYC 70,A01,890689,Geller; Emma Harlan,6,0,30,24
1746596834925,PSYC 71,A01,959860,Staff,21,0,25,4
1746596835953,PSYC 100,A00,890690,Lacefield; Katharine I,0,50,180,180
1746596836979,PSYC 102,A00,890695,Staff,18,0,40,22
1746596838004,PSYC 105,A00,890699,Geller; Emma Harlan,70,0,100,30
1746596839032,PSYC 106,A00,890701,Gorman; Michael R.,5,0,30,25
1746596840062,PSYC 108,A00,890704,Adrian; Julia Anna,0,29,50,50
1746596841089,PSYC 118,A01,890712,Staff,11,0,30,19
1746596842119,PSYC 124,A00,890716,Chapman; Eddie Nathaniel,25,0,60,35
1746596843145,PSYC 131,A00,890717,Anagnostaras; Stephan,0,7,80,80
1746596844170,PSYC 137,A00,890719,Winkielman; Piotr,0,11,30,30
1746596845198,PSYC 144,A00,890721,Adrian; Julia Anna,0,9,45,45
1746596846224,PSYC 162,A00,890805,Staff,0,1,75,75
1746596847252,PSYC 169,A00,890810,Staff,0,15,30,30
1746596848280,PSYC 172,A00,890814,Gorman; Michael R.,9,0,30,21
1746596849303,PSYC 181,A00,890818,Anagnostaras; Stephan,7,0,200,193
1746596850331,PSYC 184,A00,959861,Staff,163,0,175,12
1746596851354,PSYC 189,A00,890823,Staff,0,2,30,30
1746596852380,PSYC 191,A00,890884,Rickard; Timothy C.,0,12,35,35
1746596853404,PSYC 193,A00,890913,Staff,19,0,30,11
1746596853404,PSYC 193,B00,890914,Chapman; Eddie Nathaniel,24,0,30,6
1746596854433,PSYC 193L,A01,890918,Lowe; Angela Beth,20,0,30,10
1746596854433,PSYC 193L,B01,890921,Hurwitz; Ethan Scott,20,0,30,10
1746596854433,PSYC 193L,C01,890928,Staff,30,0,30,0
1746596855459,RELI 149,A00,886806,Rahimi; Babak,23,0,40,17
1746596856485,SE 9,A01,886814,Staff,7,0,20,13
1746596857549,SE 101B,A01,886816,Chadha; Mayank,3,0,35,32
1746596858576,SE 110B,A00,886818,Zhu; Qiang,4,0,75,71
1746596859603,SE 125,A01,886830,Staff,10,0,30,20
1746596860630,SE 130B,A01,886835,Staff,14,0,40,26
1746596861657,SE 131A,A01,886838,Krysl; Petr,34,0,55,21
1746596862683,SE 154,A00,886840,Staff,28,0,50,22
1746596863710,SE 164GS,A01,886849,Staff,6,0,20,14
1746596864734,SE 167GS,A01,886853,Staff,6,0,20,14
1746596865762,SIO 25,A01,890107,Staff,19,0,30,11
1746596866790,SIO 45,A00,890109,Cook; Geoffrey W,116,0,200,84
1746596867817,SIO 109R,A00,890110,Forman; Fonna,0,16,20,20
1746596868844,SIO 187,A01,890114,Kacev; David,15,0,40,25
1746596869873,SOCI 1,A01,890431,Thorpe; Charles Robert,14,0,30,16
1746596869873,SOCI 1,A02,890518,Thorpe; Charles Robert,30,0,30,0
1746596870899,SOCI 2,A01,957978,Staff,25,0,25,0
1746596870899,SOCI 2,A02,957979,Staff,23,0,25,2
1746596871927,SOCI 20,A01,890523,Calderon-Zaks; Michael Aar,21,0,30,9
1746596871927,SOCI 20,A02,890526,Calderon-Zaks; Michael Aar,29,0,30,1
1746596872951,SOCI 30,A01,890533,Pardo Guerra; Juan Pablo,37,0,40,3
1746596873979,SOCI 40,A01,890535,Staff,27,0,45,18
1746596875007,SOCI 104Q,A00,890559,Staff,18,0,30,12
1746596876033,SOCI 106,A00,890560,Arnal; Maud Marie Leonie,20,0,30,10
1746596877059,SOCI 110,A00,890567,Holkenbrink-Monk; Charlene,19,0,30,11
1746596878088,SOCI 112,A00,890568,Victoria Torres; Pablo,2,0,55,53
1746596879114,SOCI 115,A00,890597,Arnal; Maud Marie Leonie,28,0,45,17
1746596881169,SOCI 121,A00,890604,Pardo Guerra; Juan Pablo,38,0,45,7
1746596882193,SOCI 126,A01,890608,Staff,8,0,10,2
1746596883220,SOCI 127,A00,890609,Staff,18,0,30,12
1746596884245,SOCI 131,A00,890610,Thorpe; Charles Robert,37,0,45,8
1746596885270,SOCI 135,A00,890615,Payne; Christine Anna,14,0,45,31
1746596886295,SOCI 139,A00,890620,Staff,38,0,45,7
1746596887320,SOCI 148E,A00,890622,Calderon-Zaks; Michael Aar,36,0,45,9
1746596888347,SOCI 150,A00,890623,Kohler; Kristopher M.,31,0,45,14
1746596889372,SOCI 157,A00,890625,Jules-Rosette; Bennetta W.,18,0,20,2
1746596890400,SOCI 160,A00,890627,Payne; Christine Anna,21,0,45,24
1746596891428,SYN 1,A00,886855,Fish; Gwendolyn Anne,0,1,0,0
1746596891428,SYN 1,B00,906086,Fish; Gwendolyn Anne,0,2,0,2
1746596892457,SYN 2R,A00,886860,Staff,0,17,15,15
1746596892457,SYN 2R,B00,906106,Atkinson; Arthur Laird,0,16,15,15
1746596893501,SYN 100,A01,886866,Browne; Emily,0,28,20,20
1746596893501,SYN 100,B01,906128,Rock; Martin,0,4,20,20
1746596893501,SYN 100,C01,906140,Deavenport; James Cary,0,4,20,20
1746596893501,SYN 100,D01,907816,Deavenport; James Cary,0,5,20,20
1746596894528,TDAC 1,A00,890286,Walsh; Kim C.,7,0,20,13
1746596895554,TDAC 101,A00,890296,Basso; Beatrice,15,0,20,5
1746596896578,TDDE 131,A00,890297,Staff,47,0,50,3
1746596897603,TDDM 1,A00,890287,Weinberg; Sadie,25,0,30,5
1746596898631,TDGE 11,A00,890288,Fulton; Julia,138,0,200,62
1746596898631,TDGE 11,B00,890289,Castro; Robert Jess,184,0,200,16
1746596899655,TDGE 25,B00,957359,Walsh; Kim C.,5,0,20,15
1746596900680,TDGE 40,A01,890292,Power; Jade Yukana,26,0,30,4
1746596901706,TDGE 124,A00,890298,Havis; Allan,0,2,50,50
1746596902731,TDGE 131R,A00,890299,Burelle; Julie Sara Veronique,15,0,42,27
1746596903757,TDHT 101,A00,890300,Staff,10,0,20,10
1746596904787,TDHT 109,A01,890302,Anderson; Mysia Anyse,31,0,40,9
1746596905816,TDMV 1,A00,890293,Arcidiacono; Kristin,18,0,30,12
1746596906839,TDMV 2,A00,890294,Weinberg; Sadie,23,0,30,7
1746596907866,TDMV 3,A00,957878,Arcidiacono; Kristin,28,0,30,2
1746596910173,TDMV 138,A00,890304,Jun; Grace Shin Hae,25,0,40,15
1746596911199,TDMV 140,A00,890305,Corrales; Joseph Bernales,25,0,30,5
1746596912224,TDMV 142,A00,890307,Caligagan; Tony,32,0,40,8
1746596913251,TDMV 144,A00,890308,Camaya; Michelle Ann,25,0,30,5
1746596914275,TDPW 1,A00,890295,Stein; Deborah Isobel,3,0,20,17
1746596915304,USP 2,A01,890272,Lerner; Amy M,7,0,20,13
1746596916331,USP 3,A01,890274,Staff,12,0,30,18
1746596917357,USP 15,A01,890276,Sun; Feiyang,16,0,30,14
1746596918382,USP 25,A00,890277,Shenkman; Michael Thomas,18,0,25,7
1746596919406,USP 138,A00,890278,Staff,13,0,25,12
1746596920435,USP 143,A00,890279,Staff,21,0,70,49
1746596921460,USP 144,A00,890280,Chowdhury; Muhammed Zohir,16,0,30,14
1746596922485,USP 150,A00,890281,Boomhower; Matthew Charles,4,0,30,26
1746596923553,USP 151,A00,890282,Staff,16,0,20,4
1746596924581,USP 162,A00,890283,Andrews; Abigail Leslie,16,0,20,4
1746596925607,USP 168,A00,920477,Kwak; Nancy,0,0,5,5
1746596926631,USP 181,A00,890284,Staff,3,0,20,17
1746596927660,USP 191A,A00,890285,Staff,12,0,20,8
1746596928685,VIS 101,A00,886512,Staff,26,0,75,49
1746596929715,VIS 103,A00,886513,Cruz; Edwin Teddy,61,0,75,14
1746596930743,VIS 108,A00,886514,Staff,4,0,15,11
1746596931772,VIS 127P,A00,886515,Shen; Kuiyi,80,0,146,66
1746596932800,VIS 149,A00,886516,Yoldas; Pinar,0,0,15,15
1746596933825,VIS 164,A00,886526,Erdmann; Dean,19,0,22,3
1746596934851,VIS 194S,A00,886527,Staff,61,0,75,14
1746596935877,WCWP 10A,C00,886484,Martiniuk; Jill,12,0,15,3
1746596936908,WCWP 10B,A00,886490,Uriarte; Emma,0,0,15,15
1746596936908,WCWP 10B,B00,886491,Dhir; Simrita,8,0,15,7
1746596936908,WCWP 10B,C00,886492,Ornelas; Tricia,0,0,15,15
1746596937933,WCWP 100,A00,886494,Young; Mark T,0,6,15,15
1746596940041,AAS 10,A01,886199,Childs; Dennis R.,0,3,0,0
1746596941067,ANAR 104,A01,886940,Shtienberg; Gilad,27,0,30,3
1746596942096,ANAR 120,A00,886953,Staff,13,0,20,7
1746596943122,ANBI 148,A01,886955,Wilder; Linnea Lorene,30,0,40,10
1746596945170,ANSC 122,A00,886957,Staff,24,0,30,6
1746596946198,ANSC 150,A00,886958,Sloane; Julia Kathryn,2,0,15,13
1746596947430,ANSC 156,A00,886959,Jenkins; Janis A.,0,1,15,15
1746596948455,ANSC 180,A00,886960,Staff,11,0,17,6
1746596949479,ANSC 188,A00,886961,Jassal; Aftab,9,0,25,16
1746596950508,ANSC 190,A00,886962,Jassal; Aftab,14,0,25,11
1746596951533,ANSC 191,A00,886963,Staff,18,0,20,2
1746596952558,ANTH 3,A01,891689,Staff,17,0,20,3
1746596953583,ANTH 5,A00,886933,Semendeferi; Ekaterini,16,0,20,4
1746596954608,ANTH 10,A00,886934,Staff,0,12,30,30
1746596955639,ANTH 21,A01,886936,Staff,41,0,60,19
1746596956665,ANTH 23,A01,886938,Staff,92,0,100,8
1746596957693,ANTH 105,A00,886964,Stewart; Alexander B,84,0,100,16
1746596958720,ANTH 108,A00,886965,Pedersen; David,9,0,20,11
1746596959754,AWP 10,001,886147,Staff,0,0,0,0
1746596959754,AWP 10,002,886148,Staff,0,0,0,0
1746596959754,AWP 10,003,886149,Staff,0,0,0,0
1746596959754,AWP 10,004,886150,Staff,0,0,0,0
1746596959754,AWP 10,005,886151,Staff,0,0,0,0
1746596959754,AWP 10,006,886152,Staff,0,0,0,0
1746596959754,AWP 10,007,886153,Staff,0,0,0,0
1746596959754,AWP 10,008,886154,Staff,0,0,0,0
1746596959754,AWP 10,009,886155,Staff,0,0,0,0
1746596959754,AWP 10,010,886156,Staff,0,0,0,0
1746596959754,AWP 10,011,886158,Staff,0,0,0,0
1746596959754,AWP 10,012,886160,Staff,0,0,0,0
1746596959754,AWP 10,013,886161,Staff,0,0,0,0
1746596959754,AWP 10,014,886162,Staff,0,0,0,0
1746596959754,AWP 10,015,886163,Staff,0,0,0,0
1746596959754,AWP 10,016,886164,Staff,0,0,0,0
1746596959754,AWP 10,017,886165,Staff,0,0,0,0
1746596959754,AWP 10,018,886166,Staff,0,0,0,0
1746596959754,AWP 10,019,886168,Staff,0,0,0,0
1746596959754,AWP 10,020,886170,Staff,0,0,0,0
1746596959754,AWP 10,021,886172,Staff,0,0,0,0
1746596960791,AWP 10R,001,886173,Staff,0,1,0,0
1746596960791,AWP 10R,002,886174,Staff,0,1,0,0
1746596960791,AWP 10R,003,886175,Staff,0,0,0,0
1746596960791,AWP 10R,004,886176,Staff,0,0,0,0
1746596960791,AWP 10R,005,886177,Staff,0,0,0,0
1746596960791,AWP 10R,006,886178,Staff,0,0,0,0
1746596960791,AWP 10R,007,886179,Staff,0,0,0,0
1746596960791,AWP 10R,008,886181,Staff,0,0,0,0
1746596960791,AWP 10R,009,886182,Staff,0,0,0,0
1746596960791,AWP 10R,010,886183,Staff,0,0,0,0
1746596960791,AWP 10R,011,886184,Staff,0,0,0,0
1746596960791,AWP 10R,012,886185,Staff,0,0,0,0
1746596960791,AWP 10R,013,886186,Staff,0,0,0,0
1746596960791,AWP 10R,014,886187,Staff,0,0,0,0
1746596960791,AWP 10R,015,886188,Staff,0,0,0,0
1746596960791,AWP 10R,016,886189,Staff,0,0,0,0
1746596960791,AWP 10R,017,960532,Staff,0,0,0,0
1746596960791,AWP 10R,018,960533,Staff,0,0,0,0
1746596960791,AWP 10R,019,960534,Staff,0,0,0,0
1746596960791,AWP 10R,020,960538,Staff,0,0,0,0
1746596960791,AWP 10R,021,960540,Staff,0,0,0,0
1746596960791,AWP 10R,022,960541,Staff,0,0,0,0
1746596960791,AWP 10R,023,960542,Staff,0,0,0,0
1746596960791,AWP 10R,024,960544,Staff,0,0,0,0
1746596960791,AWP 10R,025,960545,Staff,0,0,0,0
1746596960791,AWP 10R,026,960548,Staff,0,0,0,0
1746596961816,AWP 102R,A00,886190,Staff,0,0,0,0
1746596961816,AWP 102R,B00,886191,Staff,0,0,0,0
1746596962840,BENG 100,A01,886193,Staff,17,0,30,13
1746596963868,BENG 122A,A01,886195,Hasty; Jeff M,13,0,30,17
1746596964896,BENG 166A,A00,886196,Sah; Robert Lie-Yuan,0,3,30,30
1746596965925,BENG 190,A00,958050,Khojah; Reem I,17,0,25,8
1746596966951,BIBC 102,A01,894320,Staff,0,1,46,46
1746596966951,BIBC 102,A02,894321,Staff,0,0,46,46
1746596966951,BIBC 102,A03,894344,Staff,6,0,46,40
1746596966951,BIBC 102,A04,894345,Staff,27,0,47,20
1746596967978,BICD 100R,A01,894365,Smith; Laurie,0,2,58,58
1746596967978,BICD 100R,A02,894366,Smith; Laurie,0,4,58,58
1746596967978,BICD 100R,A03,894367,Smith; Laurie,0,0,59,59
1746596967978,BICD 100R,A04,959869,Smith; Laurie,38,0,59,21
1746596969004,BICD 136,A01,894383,Gustafson-Brown; Cindy,14,0,50,36
1746596970029,BIEB 102,A01,894494,Butler; Shannon Rhey,51,0,130,79
1746596972081,BIEB 150,A01,894617,Wills; Christopher,3,0,20,17
1746596972081,BIEB 150,A02,894631,Wills; Christopher,3,0,20,17
1746596972081,BIEB 150,A03,894937,Wills; Christopher,3,0,20,17
1746596972081,BIEB 150,A04,894946,Wills; Christopher,5,0,20,15
1746596973105,BIEB 194,A00,906141,Kurle; Carolyn M.,5,0,20,15
1746596974135,BILD 1,A01,894154,Staff,3,0,19,16
1746596974135,BILD 1,A02,894155,Staff,14,0,19,5
1746596974135,BILD 1,A03,894160,Staff,13,0,19,6
1746596974135,BILD 1,A04,894161,Staff,15,0,18,3
1746596975160,BILD 2,A01,894168,Staff,0,0,50,50
1746596975160,BILD 2,A02,894169,Staff,0,0,50,50
1746596975160,BILD 2,A03,894179,Staff,0,0,50,50
1746596975160,BILD 2,A04,894203,Staff,23,0,50,27
1746596976185,BILD 3,A01,894213,Staff,23,0,31,8
1746596976185,BILD 3,A02,894214,Staff,26,0,31,5
1746596976185,BILD 3,A03,894235,Staff,28,0,31,3
1746596976185,BILD 3,A04,894236,Staff,28,0,32,4
1746596977211,BILD 4,A01,894253,Reuther; Keefe,5,0,24,19
1746596977211,BILD 4,A02,894258,Reuther; Keefe,16,0,24,8
1746596978237,BILD 5,A01,894276,Reuther; Keefe,34,0,50,16
1746596978237,BILD 5,A02,894277,Reuther; Keefe,45,0,50,5
1746596978237,BILD 5,A03,894290,Reuther; Keefe,44,0,50,6
1746596978237,BILD 5,A04,894291,Reuther; Keefe,48,0,50,2
1746596979269,BILD 24,A01,894297,Pirino; Giorgia,40,0,60,20
1746596980294,BIMM 100,B01,958915,Staff,71,0,100,29
1746596981322,BIMM 101,A01,895017,McDonnell; Lisa Marie,0,5,24,24
1746596981322,BIMM 101,A02,895018,McDonnell; Lisa Marie,0,5,24,24
1746596981322,BIMM 101,B01,895020,McDonnell; Lisa Marie,0,5,24,24
1746596981322,BIMM 101,B02,895021,McDonnell; Lisa Marie,0,4,24,24
1746596982347,BIMM 110,A01,895023,Staff,1,0,25,24
1746596982347,BIMM 110,A02,895024,Staff,9,0,25,16
1746596982347,BIMM 110,A03,895025,Staff,18,0,25,7
1746596982347,BIMM 110,A04,895031,Staff,20,0,25,5
1746596983376,BIMM 120,A01,895114,Gustafson-Brown; Cindy,14,0,28,14
1746596983376,BIMM 120,A02,895126,Gustafson-Brown; Cindy,21,0,27,6
1746596984401,BIPN 100,A01,895130,Yang; Mingyu,0,0,38,38
1746596984401,BIPN 100,A02,895131,Yang; Mingyu,31,0,38,7
1746596984401,BIPN 100,A03,895132,Yang; Mingyu,32,0,38,6
1746596984401,BIPN 100,A04,895133,Yang; Mingyu,27,0,36,9
1746596985425,BIPN 120,A01,895135,Cooke; James Edward,0,3,13,13
1746596985425,BIPN 120,A02,895136,Cooke; James Edward,0,1,13,13
1746596985425,BIPN 120,A03,895137,Cooke; James Edward,0,3,13,13
1746596985425,BIPN 120,A04,895156,Cooke; James Edward,0,2,11,11
1746596986451,BIPN 134,A01,895235,Cooke; James Edward,0,1,25,25
1746596986451,BIPN 134,A02,895237,Cooke; James Edward,0,0,25,25
1746596986451,BIPN 134,A03,895240,Cooke; James Edward,2,0,25,23
1746596986451,BIPN 134,A04,895270,Cooke; James Edward,20,0,25,5
1746596987478,BIPN 189,A00,892103,Staff,0,14,14,14
1746596989533,BISP 194,A00,958008,Staff,0,2,0,0
1746596990559,CAT 124,A01,922009,Staff,0,5,20,20
1746596991584,CAT 125R,A00,886390,Morales; Celeste Georgianna,0,3,20,20
1746596991584,CAT 125R,B00,886391,Irwin; Matthew Joseph,0,4,20,20
1746596991584,CAT 125R,C00,886392,Smith; Lauryn Alissa,0,2,20,20
1746596991584,CAT 125R,D00,886393,Vanderschuit; Maya Alysia,0,3,20,20
1746596991584,CAT 125R,E00,886394,Marchisotto; Jennifer Anne,0,3,20,20
1746596992609,CENG 15,A01,886218,Drews; Aaron,3,0,8,5
1746596993635,CENG 113,A00,886219,Opatkiewicz; Justin Paul,15,0,25,10
1746596994661,CGS 101,A00,887044,Staff,7,0,20,13
1746596995687,CGS 105,A01,887046,Staff,14,0,25,11
1746596996716,CGS 112,A00,887047,Cuong; Marisol,12,0,15,3
1746596997744,CGS 113,A00,887048,Staff,23,0,30,7
1746596998772,CGS 120,A00,887049,Staff,10,0,17,7
1746596999798,CHEM 6A,A01,886336,Lam; Tin Yiu,38,0,50,12
1746596999798,CHEM 6A,A02,886338,Lam; Tin Yiu,37,0,50,13
1746597000823,CHEM 6B,A01,886341,Hopkins; Patrycja Anna,16,0,50,34
1746597000823,CHEM 6B,A02,886343,Hopkins; Patrycja Anna,42,0,50,8
1746597001862,CHEM 6C,A01,886346,Albizati; Kim F.,0,2,50,50
1746597001862,CHEM 6C,A02,886348,Albizati; Kim F.,24,0,50,26
1746597002888,CHEM 40A,A01,886352,Klosterman; Jeremy K,65,0,100,35
1746597003917,CHEM 40B,A01,886356,Klosterman; Jeremy K,0,24,100,100
1746597004948,CHEM 41B,A01,886360,Theodorakis; Emmanuel,25,0,50,25
1746597004948,CHEM 41B,A02,886362,Theodorakis; Emmanuel,47,0,50,3
1746597005980,CHIN 165A,A00,886382,Xu; Li,18,0,20,2
1746597007006,CLAS 120,A00,886387,Myerston Santana; Jacobo,33,0,40,7
1746597008033,COGS 9,A01,886967,Shannon; Kyle Michael,42,0,60,18
1746597009061,COGS 11,A01,886969,Staff,9,0,30,21
1746597010087,COGS 14A,A01,886971,Staff,5,0,60,55
1746597011113,COGS 14B,A01,886973,Hoffman; Drew Ellen,4,0,60,56
1746597012138,COGS 18,A01,886975,Morgan; Eric,34,0,60,26
1746597013167,COGS 20,A01,886977,Staff,3,0,8,5
1746597013167,COGS 20,A02,886978,Staff,5,0,7,2
1746597014194,COGS 100,A01,907783,Staff,0,1,30,30
1746597015221,COGS 101B,A01,886980,Staff,0,4,48,48
1746597016249,COGS 101C,A01,886982,Delgado; Tania,0,5,44,44
1746597017279,COGS 102A,A01,886984,Johnson; Christine M.,3,0,30,27
1746597018308,COGS 118B,A01,886986,Staff,0,4,88,88
1746597019334,COGS 150,A01,886988,Bergen; Benjamin,22,0,50,28
1746597020359,COGS 153,A00,886989,Delgado; Tania,0,3,41,41
1746597021384,COGS 186,A01,886991,Staff,0,0,32,32
1746597022409,COGS 187A,A01,886993,Boyle; Mary E. T.,7,0,30,23
1746597023489,COGS 189,A00,886994,Staff,0,1,30,30
1746597024514,COMM 10,A01,886996,Staff,0,0,20,21
1746597024514,COMM 10,A02,886997,Staff,10,0,20,10
1746597024514,COMM 10,A03,959845,Staff,19,0,20,1
1746597025541,COMM 20,A01,886999,Leuning; Grant Maurstad,24,0,40,16
1746597027594,COMM 100A,A01,887002,Staff,0,0,20,25
1746597027594,COMM 100A,A02,887003,Staff,5,0,20,15
1746597028622,COMM 100B,A01,887005,Staff,0,8,20,24
1746597029646,COMM 106D,A00,887006,Staff,13,0,40,27
1746597030671,COMM 110G,A00,887007,Whitworth-Smith; Andrew C,12,0,40,28
1746597031700,COMM 111B,A00,887008,Staff,31,0,40,9
1746597032725,COMM 113T,A00,887009,Abuelhiga; Soraya Jill,28,0,40,12
1746597032725,COMM 113T,B00,906733,Staff,39,0,40,1
1746597033754,COMM 145,A00,887010,Staff,12,0,40,28
1746597034779,COMM 146,A00,887054,Staff,31,0,40,9
1746597035806,COMM 190,A00,887012,Staff,8,0,23,15
1746597036833,CSE 8A,A50,887015,Cao; Yingjun,56,0,85,29
1746597037858,CSE 11,A01,887017,Cao; Yingjun,11,0,70,59
1746597038888,CSE 20,A01,887019,Staff,30,0,50,20
1746597039916,CSE 21,A01,887021,Staff,79,0,100,21
1746597039916,CSE 21,B01,892583,Braun; Oliver,45,0,50,5
1746597040942,CSE 30,A01,887025,Eldon; John,142,0,200,58
1746597041968,CSE 100,A01,887027,Staff,26,0,50,24
1746597041968,CSE 100,A02,887028,Staff,42,0,50,8
1746597043000,CSE 101,A01,887030,Braun; Oliver,74,0,100,26
1746597043000,CSE 101,B01,887032,Jones; Miles E,0,3,50,50
1746597043000,CSE 101,B02,887033,Jones; Miles E,0,2,50,50
1746597044026,CSE 105,A01,908084,Jones; Miles E,32,0,50,18
1746597044026,CSE 105,A02,908087,Jones; Miles E,31,0,50,19
1746597045055,CSE 135,A01,887035,Powell; Thomas Allan,0,5,50,50
1746597046084,CSE 142,A01,887037,Staff,8,0,60,52
1746597047110,CSE 142L,A01,887039,Staff,34,0,60,26
1746597048138,CSE 151A,A01,887041,Solares; Edwin A,47,0,100,53
1746597049167,CSE 175,A01,887043,Kumar; Rakesh,30,0,30,0
1746597050194,CSS 1,A01,886389,Staff,0,1,40,40
1746597051223,DSC 30,A01,908097,Liao; Soohyun Nam,47,0,75,28
1746597052250,DSC 40A,A01,908099,Shannon; Kyle Michael,30,0,50,20
1746597053276,DSC 40B,A01,908112,Staff,15,0,50,35
1746597054303,DSC 80,A01,908116,Staff,19,0,60,41
1746597055331,DSC 197,001,956863,Eldridge; Justin Matthew,9999,0,9999,0
1746597056357,ECE 5,A01,886400,Morris; Karcher William,1,0,6,5
1746597056357,ECE 5,A02,886401,Morris; Karcher William,3,0,6,3
1746597057383,ECE 148,A01,886403,Silberman; Jack,0,14,14,14
1746597058409,ECON 1,A01,887265,Crane; Meredith Helen,11,0,70,59
1746597058409,ECON 1,B01,887268,Staff,42,0,50,8
1746597059434,ECON 2,A01,887273,Crane; Meredith Helen,54,0,70,16
1746597060463,ECON 3,A01,887279,Rondina; Giacomo,31,0,70,39
1746597061492,ECON 4,A01,887282,Anderson; John Charles,0,2,10,10
1746597062517,ECON 5,A01,887285,Staff,34,0,45,11
1746597062517,ECON 5,B01,887292,Staff,41,0,45,4
1746597063545,ECON 100A,A01,887337,Newhouse; Herbert S,54,0,70,16
1746597063545,ECON 100A,B01,887349,Staff,45,0,50,5
1746597064568,ECON 100B,A01,887361,Du; Songzi,29,0,70,41
1746597065595,ECON 100C,A01,887445,Newhouse; Herbert S,59,0,70,11
1746597066624,ECON 105,A00,887488,Vespa; Emanuel Ignacio,23,0,35,12
1746597067649,ECON 109,A01,887506,Shishkin; Denis,28,0,35,7
1746597068680,ECON 110A,A01,887568,Alon; Titan Michael,0,2,35,35
1746597068680,ECON 110A,B01,907601,Alon; Titan Michael,20,0,35,15
1746597069703,ECON 110B,A01,887598,Levkoff; Steven B.,0,24,70,70
1746597070733,ECON 112,A00,887599,Rondina; Giacomo,19,0,35,16
1746597071761,ECON 120A,A01,887603,Dai; Yinlin,35,0,70,35
1746597072791,ECON 120C,A01,887608,Sun; Yixiao,0,1,35,35
1746597072791,ECON 120C,B01,887614,Sun; Yixiao,0,0,35,35
1746597073819,ECON 138,A00,887621,Bharadwaj; Prashant,0,21,20,20
1746597074845,ECON 144,A00,958007,Squires; Dale E,12,0,35,23
1746597075872,ECON 171,A01,907666,Staff,18,0,35,17
1746597076897,ECON 175,A00,887626,Wu; Pak Yeung,22,0,35,13
1746597077927,ECON 190,A00,887640,Vespa; Emanuel Ignacio,22,0,35,13
1746597078982,EDS 25,A01,888197,Staff,0,0,0,0
1746597078982,EDS 25,A02,888209,Staff,0,0,0,0
1746597078982,EDS 25,A03,888210,Staff,0,0,0,0
1746597078982,EDS 25,A04,888212,Staff,0,0,0,0
1746597078982,EDS 25,A05,888213,Staff,0,0,0,0
1746597078982,EDS 25,A06,888214,Staff,0,0,0,0
1746597078982,EDS 25,A07,888235,Staff,0,2,0,0
1746597078982,EDS 25,A08,888236,Staff,0,0,0,0
1746597078982,EDS 25,A09,888240,Staff,0,0,0,0
1746597078982,EDS 25,A10,888244,Staff,0,0,0,0
1746597078982,EDS 25,B01,888273,Staff,0,0,0,0
1746597078982,EDS 25,B02,888285,Staff,0,0,0,0
1746597078982,EDS 25,B03,888423,Staff,0,0,0,1
1746597078982,EDS 25,B04,888432,Staff,0,0,0,0
1746597078982,EDS 25,B05,888433,Staff,0,0,0,0
1746597078982,EDS 25,B06,888467,Staff,0,0,0,0
1746597078982,EDS 25,B07,888468,Staff,0,0,0,0
1746597078982,EDS 25,B08,888479,Staff,0,0,0,0
1746597078982,EDS 25,B09,888484,Staff,0,0,0,0
1746597078982,EDS 25,B10,888487,Staff,0,0,0,0
1746597080012,EDS 38,A01,907700,Choi; Bailey Miyeon,30,0,30,0
1746597081038,EDS 112,A01,888601,Chapman; Thandeka K,12,0,40,28
1746597082062,EDS 115,A00,888697,Mendez; Kathrina Mendoza,10,0,30,20
1746597083092,EDS 116,A01,888893,Staff,33,0,40,7
1746597085145,EDS 124AR,A00,889133,Staff,29,0,50,21
1746597085145,EDS 124AR,B00,907471,Simon; Elizabeth A,37,0,50,13
1746597086170,EDS 124BR,A00,889134,Simon; Elizabeth A,44,0,100,56
1746597087196,EDS 125,A00,889135,Staff,25,0,30,5
1746597088224,EDS 126,A01,889138,Staff,35,0,40,5
1746597089251,EDS 164R,A01,889142,Wishard Guerra; Alison G.,32,0,50,18
1746597090276,ENG 30,A01,886396,Staff,0,0,0,0
1746597090276,ENG 30,B01,886398,Staff,0,0,0,0
1746597091301,ENVR 102,A00,906150,Montejo; Carolina,23,0,25,2
1746597092326,ETHN 103A,A00,887236,Man; Simeon S,0,2,0,0
1746597093352,ETHN 113,A00,887239,Staff,16,0,30,14
1746597094379,ETHN 116,A00,887240,Staff,16,0,25,9
1746597095406,ETHN 117,A00,887241,Choi; Esther Min,28,0,30,2
1746597096432,ETHN 118,A00,887243,Staff,24,0,30,6
1746597097457,ETHN 127,A00,887248,Cuong; Marisol,11,0,15,4
1746597098481,ETHN 139,A00,887250,Staff,7,0,10,3
1746597099507,ETHN 142,A00,887252,Staff,10,0,30,20
1746597100534,ETHN 161,A00,887253,Browne; Errol Tsekani,24,0,30,6
1746597101588,ETHN 163FR,A00,887255,Burelle; Julie Sara Veronique,0,0,5,5
1746597102613,GLBH 20,A00,889149,Elwardani; Nile Regina,8,0,42,34
1746597104666,GLBH 111,A01,889152,Burgos; Jose L.,17,0,17,0
1746597105692,GLBH 150,A00,889181,Sloane; Julia Kathryn,0,5,15,15
1746597107743,HDS 60,A01,886406,Warstadt; Melissa Fawn,72,0,80,8
1746597108767,HIAF 111,A00,889324,Gyamfi; Bright,25,0,32,7
1746597109793,HIEA 131,A00,889328,Staff,15,0,32,17
1746597110823,HIEA 144,A00,889333,Henry; Todd A.,26,0,32,6
1746597111850,HIEA 154,A00,889336,Henry; Todd A.,24,0,32,8
1746597112876,HIEU 106,A00,889339,Staff,22,0,32,10
1746597114928,HIEU 114,A00,889340,Staff,4,0,32,28
1746597115953,HIEU 135GS,A00,889342,Patterson; Patrick H.,0,0,1,24
1746597116978,HIEU 137,A00,889343,Edington; Claire Ellen,10,0,25,15
1746597118004,HIEU 148,A00,889345,Staff,14,0,32,18
1746597119029,HIEU 154,A00,889346,Biess; Frank Peter,21,0,32,11
1746597120058,HILA 102,A00,889351,Staff,12,0,32,20
1746597121085,HILD 2A,A01,889221,Lewandoski; Julia Mavis,0,8,32,32
1746597122111,HILD 7B,A01,889225,Man; Simeon S,0,12,32,32
1746597123136,HILD 7C,A01,889288,Alvarez; Luis A,0,14,32,32
1746597124161,HILD 30,A01,889323,Staff,0,5,32,32
1746597126209,HISC 119,A00,889383,Golan; Tal,20,0,32,12
1746597127234,HIUS 103,A00,889384,Man; Simeon S,0,0,32,32
1746597128258,HIUS 117,A00,919797,Kwak; Nancy,18,0,32,14
1746597129284,HIUS 142A,A00,919788,Staff,22,0,32,10
1746597131338,HIUS 149,A00,889386,Gyamfi; Bright,26,0,32,6
1746597132363,HIUS 155,A00,889387,Alvarez; Luis A,15,0,32,17
1746597133390,HUM 3,A01,886499,Caldwell; Michael Alan,19,0,50,31
1746597134419,HUM 3GS,A00,886500,Rodriguez; Bretton Sigfred,0,0,0,28
1746597135442,HUM 3R,A01,886502,Markman; Kristina,0,36,50,50
1746597136472,HUM 4,A01,886504,Crum; Matthew Stephen,23,0,50,27
1746597136472,HUM 4,B01,886506,West; Geoffrey Scott,17,0,50,33
1746597137496,HUM 4GS,A00,886507,Staff,0,0,0,19
1746597138521,HUM 5,A01,886509,Staff,31,0,50,19
1746597139545,HUM 5R,A01,886511,Zavodny; Tatiana Sophia,0,39,50,50
1746597140570,JAPN 180,A00,886407,Staff,16,0,40,24
1746597141595,LATI 50,A01,886409,Martin-Cabrera; Luis,3,0,22,19
1746597141595,LATI 50,A02,886410,Martin-Cabrera; Luis,19,0,22,3
1746597141595,LATI 50,A03,886411,Martin-Cabrera; Luis,21,0,22,1
1746597141595,LATI 50,A04,886412,Martin-Cabrera; Luis,8,0,22,14
1746597142620,LAWS 101,A00,907664,Staff,28,0,60,32
1746597143647,LIAB 1A,A00,889388,Saab; Dima,17,0,20,3
1746597144671,LIAB 1AX,A00,889389,El Cheddadi; Youniss,18,0,20,2
1746597145694,LIFR 1C,A00,889391,Van Moer; Vinciane G,8,0,20,12
1746597146719,LIFR 1CX,A00,889392,Van Moer; Vinciane G,7,0,20,13
1746597147748,LIFR 1D,A00,889393,Van Moer; Vinciane G,7,0,20,13
1746597148786,LIFR 1DX,A00,889394,Van Moer; Vinciane G,8,0,20,12
1746597149811,LIGN 7,A00,886923,Staff,25,0,50,25
1746597150838,LIGN 17,A00,886924,Kehler; Andrew Scott,126,0,150,24
1746597151861,LTAM 110,A00,889395,Staff,15,0,30,15
1746597152885,LTAM 110GS,A00,958010,Rodriguez; Bretton Sigfred,0,0,0,28
1746597153908,LTCH 101,A00,889397,Staff,23,0,25,2
1746597154932,LTCS 130,A00,889398,Staff,23,0,25,2
1746597155957,LTEA 138,A00,889399,Staff,24,0,40,16
1746597156982,LTEN 149,A00,889400,Wesling; Megan E.,0,3,25,25
1746597158006,LTEN 169,A00,889401,Staff,20,0,25,5
1746597159031,LTEN 180,A00,889402,Staff,10,0,15,5
1746597160057,LTEN 181,A00,889403,Staff,21,0,25,4
1746597161084,LTWL 100,A00,889404,Myerston Santana; Jacobo,2,0,25,23
1746597162113,LTWL 180GS,A00,889405,Staff,0,0,20,20
1746597163140,LTWL 181,A00,889406,Staff,16,0,25,9
1746597164166,LTWL 184,A00,889475,Mukherjee; Silpa,22,0,25,3
1746597165193,LTWR 102C,A00,889486,Staff,29,0,30,1
1746597166219,LTWR 115W,A00,889491,Staff,0,2,15,15
1746597167244,MAE 8,A01,886905,Staff,0,2,0,0
1746597168271,MAE 11,A00,886906,Bandaru; Prabhakar,0,7,50,50
1746597169299,MAE 20,A00,886907,Evdokimenko; Ekaterina,43,0,70,27
1746597170328,MAE 30B,A00,886909,Ghazinejad; Maziar,25,0,45,20
1746597171358,MAE 101B,A00,886910,Saintillan; David,30,0,45,15
1746597172383,MAE 105,A00,886911,Bandaru; Prabhakar,18,0,50,32
1746597173412,MAE 107,B00,958024,Staff,7,0,50,43
1746597174439,MAE 143B,A00,886913,Bewley; Thomas R,2,0,40,38
1746597175468,MAE 148,A01,886915,Silberman; Jack,0,3,14,14
1746597176492,MAE 160,A00,886916,Evdokimenko; Ekaterina,31,0,60,29
1746597177518,MATH 3C,A01,889681,Staff,0,2,30,30
1746597177518,MATH 3C,A02,960048,Staff,23,0,30,7
1746597178544,MATH 10A,A01,889760,Staff,26,0,30,4
1746597178544,MATH 10A,A02,889783,Staff,29,0,30,1
1746597179569,MATH 10B,A01,889785,Verstraete; Jacques Allan,1,0,35,34
1746597179569,MATH 10B,A02,889795,Verstraete; Jacques Allan,4,0,35,31
1746597179569,MATH 10B,B01,889797,Verstraete; Jacques Allan,3,0,35,32
1746597179569,MATH 10B,B02,889828,Verstraete; Jacques Allan,3,0,35,32
1746597180602,MATH 10C,A01,889849,Habib; Yousaf,8,0,30,22
1746597180602,MATH 10C,A02,889852,Habib; Yousaf,14,0,30,16
1746597180602,MATH 10C,A03,889853,Habib; Yousaf,22,0,30,8
1746597180602,MATH 10C,A04,889858,Habib; Yousaf,20,0,30,10
1746597180602,MATH 10C,B01,889861,Staff,1,0,30,29
1746597180602,MATH 10C,B02,889862,Staff,24,0,30,6
1746597180602,MATH 10C,B03,889863,Staff,27,0,30,3
1746597180602,MATH 10C,B04,889967,Staff,23,0,30,7
1746597181634,MATH 18,A01,889974,Staff,7,0,30,23
1746597181634,MATH 18,A02,889977,Staff,20,0,30,10
1746597181634,MATH 18,B01,889984,Hardiman; Liam,20,0,30,10
1746597181634,MATH 18,B02,889985,Hardiman; Liam,25,0,30,5
1746597182661,MATH 20A,A01,889990,Suk; Andrew Hoon,30,0,35,5
1746597183691,MATH 20B,A01,889993,Ohm; Ko Woon,21,0,30,9
1746597183691,MATH 20B,A02,889994,Ohm; Ko Woon,30,0,30,0
1746597183691,MATH 20B,B01,889996,Ohm; Ko Woon,22,0,30,8
1746597183691,MATH 20B,B02,889997,Ohm; Ko Woon,23,0,30,7
1746597184716,MATH 20C,A01,889999,Hammock; Frances H,17,0,30,13
1746597184716,MATH 20C,A02,890003,Hammock; Frances H,23,0,30,7
1746597184716,MATH 20C,B01,890006,Hammock; Frances H,2,0,30,28
1746597184716,MATH 20C,B02,890007,Hammock; Frances H,12,0,30,18
1746597185746,MATH 20D,A01,890011,Cheng; Hsiao-Bing,0,0,30,30
1746597185746,MATH 20D,A02,890012,Cheng; Hsiao-Bing,14,0,30,16
1746597185746,MATH 20D,B01,890016,Cheng; Hsiao-Bing,13,0,30,17
1746597185746,MATH 20D,B02,890017,Cheng; Hsiao-Bing,13,0,30,17
1746597186772,MATH 20E,A01,890026,Harel; Guershon,1,0,30,29
1746597186772,MATH 20E,A02,890029,Harel; Guershon,22,0,30,8
1746597186772,MATH 20E,B01,890033,Harel; Guershon,7,0,30,23
1746597186772,MATH 20E,B02,890101,Harel; Guershon,21,0,30,9
1746597187798,MATH 102,A01,890104,Staff,18,0,30,12
1746597187798,MATH 102,A02,890105,Staff,27,0,30,3
1746597188823,MATH 103B,A01,890116,Salehi Golsefidy; Alireza,3,0,30,27
1746597188823,MATH 103B,B01,890118,Staff,0,3,34,34
1746597189849,MATH 109,A01,890121,Aliabadi Sr.; Mohsen,0,0,30,30
1746597189849,MATH 109,B01,890124,Upadrashta; Pranav Kumar,18,0,30,12
1746597190877,MATH 120A,A01,890126,Eggers; John Dietrich,13,0,30,17
1746597191908,MATH 142B,A01,890128,Ioana; Adrian,19,0,30,11
1746597191908,MATH 142B,A02,890129,Ioana; Adrian,12,0,30,18
1746597192935,MATH 154,A01,890174,Staff,0,1,30,30
1746597192935,MATH 154,A02,890182,Staff,0,0,30,30
1746597193960,MATH 168A,A01,890197,Dumitriu; Ioana,21,0,35,14
1746597194987,MATH 170A,A01,890240,Nie; Jiawang,1,0,30,29
1746597194987,MATH 170A,A02,890241,Nie; Jiawang,11,0,30,19
1746597194987,MATH 170A,A03,890249,Nie; Jiawang,23,0,30,7
1746597196015,MATH 170B,A01,957891,Nag; Panchali,13,0,35,22
1746597198067,MATH 181A,A01,908025,Staff,0,3,35,35
1746597198067,MATH 181A,A02,960115,Staff,26,0,35,9
1746597199092,MATH 181B,A01,959874,Staff,24,0,30,6
1746597200121,MATH 193B,A01,890265,Staff,0,4,35,35
1746597201147,MGT 4,A01,890311,Anderson; John Charles,42,0,88,46
1746597202175,MGT 5,A00,907740,Staff,12,0,98,86
1746597203201,MGT 12,A00,890312,Lindenberger; Wade Douglas,67,0,98,31
1746597204226,MGT 16,A00,957883,Staff,78,0,98,20
1746597206279,MGT 45,A00,890314,Pecore; Joseph P.,45,0,98,53
1746597207304,MGT 71,A00,890315,Staff,0,12,98,98
1746597208331,MGT 100,A00,890316,Yavorsky; Daniel Ryan,44,0,98,54
1746597209360,MGT 103,A00,890317,Ehrich; Kristine R,73,0,98,25
1746597210388,MGT 105,A00,890356,Bates; Kenneth Walter,0,8,98,98
1746597211415,MGT 112,A00,890360,Ehrich; Kristine R,55,0,98,43
1746597212444,MGT 127R,A00,907732,Zhu; Kevin Xiaoguo,23,0,98,75
1746597213469,MGT 131B,A00,890361,Anderson; John Charles,59,0,98,39
1746597214493,MGT 137,A00,890362,Lindenberger; Wade Douglas,65,0,98,33
1746597215520,MGT 160,A00,890369,Johnson; Erik Barry,9,0,98,89
1746597217570,MGT 164,A00,890372,Zimmermann; Carsten,0,40,98,98
1746597218594,MGT 180,A00,890374,Bliss; Barbara Ann,11,0,98,87
1746597219620,MMW 15,A01,886414,Chang; Edmond Yi-Teh,0,12,28,28
1746597219620,MMW 15,A02,886415,Chang; Edmond Yi-Teh,0,8,28,28
1746597219620,MMW 15,A03,886416,Chang; Edmond Yi-Teh,0,9,28,28
1746597219620,MMW 15,A04,886417,Chang; Edmond Yi-Teh,0,8,28,28
1746597219620,MMW 15,B01,886419,Chang; Edmond Yi-Teh,0,7,28,28
1746597219620,MMW 15,B02,886420,Chang; Edmond Yi-Teh,0,7,28,28
1746597219620,MMW 15,B03,886421,Chang; Edmond Yi-Teh,0,7,28,28
1746597219620,MMW 15,B04,886422,Chang; Edmond Yi-Teh,0,8,28,28
1746597219620,MMW 15,C01,886424,Staff,0,9,28,28
1746597219620,MMW 15,C02,886425,Staff,0,8,28,28
1746597219620,MMW 15,C03,886426,Staff,0,8,28,28
1746597219620,MMW 15,C04,886427,Staff,0,8,28,28
1746597219620,MMW 15,C05,958038,Staff,0,8,28,28
1746597219620,MMW 15,C06,958039,Staff,0,7,28,28
1746597220645,MMW 15GS,A00,906910,Patterson; Patrick H.,4,0,28,24
1746597221673,MMW 122R,A01,886429,Rahimi; Babak,0,13,28,28
1746597221673,MMW 122R,A02,886430,Rahimi; Babak,0,12,28,28
1746597221673,MMW 122R,A03,958040,Rahimi; Babak,0,11,28,28
1746597222699,MUS 1A,A01,890937,Staff,2,0,25,23
1746597222699,MUS 1A,A02,891035,Staff,6,0,25,19
1746597222699,MUS 1A,C01,958912,Staff,24,0,25,1
1746597222699,MUS 1A,C02,958913,Staff,25,0,25,0
1746597224757,MUS 2AK,A00,957092,Ohnishi; Takae,15,0,15,0
1746597225785,MUS 4,A01,891044,Staff,0,0,25,25
1746597225785,MUS 4,A02,891045,Staff,22,0,25,3
1746597225785,MUS 4,B01,891048,Staff,17,0,25,8
1746597225785,MUS 4,B02,891050,Staff,25,0,25,0
1746597226815,MUS 5,A01,957506,Dubnov; Shlomo,0,0,25,25
1746597226815,MUS 5,A02,957622,Dubnov; Shlomo,13,0,25,12
1746597226815,MUS 5,A03,957623,Dubnov; Shlomo,20,0,25,5
1746597227839,MUS 6,A01,891053,Freitas Caetano; Marcelo,24,0,25,1
1746597227839,MUS 6,A02,891054,Freitas Caetano; Marcelo,23,0,25,2
1746597228863,MUS 7,A01,891081,Staff,0,0,25,25
1746597228863,MUS 7,A02,891082,Staff,3,0,25,22
1746597229890,MUS 8GS,A00,891118,Borgo; David Garcia,1,0,25,24
1746597230915,MUS 11,A01,891140,Staff,8,0,25,17
1746597230915,MUS 11,A02,891141,Staff,21,0,25,4
1746597231944,MUS 13,A01,891143,Staff,8,0,25,17
1746597231944,MUS 13,A02,891144,Staff,24,0,25,1
1746597232970,MUS 15,A01,891146,Staff,9,0,25,16
1746597232970,MUS 15,A02,891148,Staff,21,0,25,4
1746597232970,MUS 15,B01,891150,Staff,18,0,25,7
1746597232970,MUS 15,B02,891151,Staff,25,0,25,0
1746597233996,MUS 20,A01,891153,Staff,5,0,20,15
1746597233996,MUS 20,A02,891155,Staff,14,0,20,6
1746597235023,MUS 80,A00,891156,Staff,19,0,25,6
1746597235023,MUS 80,B00,891157,Staff,23,0,25,2
1746597236050,MUS 130,A00,891158,Ohnishi; Takae,35,0,35,0
1746597237075,MUS 150GS,A01,891160,Borgo; David Garcia,1,0,25,24
1746597238100,MUS 170,A01,891162,Freitas Caetano; Marcelo,20,0,25,5
1746597238100,MUS 170,A02,891164,Freitas Caetano; Marcelo,21,0,25,4
1746597239125,NANO 11,A00,886220,Vazquez Mena; Oscar,13,0,15,2
1746597240150,NANO 15,A01,886222,Drews; Aaron,4,0,7,3
1746597241176,NANO 104,A00,886224,Sirbuly; Donald,17,0,25,8
1746597242204,PH 40,A00,886528,Staff,23,0,40,17
1746597243235,PH 45,A01,886799,Staff,35,0,40,5
1746597244259,PH 110,A00,886802,Staff,0,6,40,40
1746597245288,PH 172,A00,906716,Staff,19,0,35,16
1746597246315,PH 191,A00,886803,Staff,6,0,40,34
1746597247345,PHIL 1,A00,889500,Staff,20,0,30,10
1746597248376,PHIL 10,A01,889549,Grush; Rick Scott,16,0,22,6
1746597248376,PHIL 10,A02,889551,Grush; Rick Scott,22,0,22,0
1746597249406,PHIL 28,A01,889559,Lamey; Andy M.,0,2,31,31
1746597249406,PHIL 28,A02,889561,Lamey; Andy M.,0,1,30,30
1746597249406,PHIL 28,A03,889572,Lamey; Andy M.,0,1,30,30
1746597250430,PHIL 35,A00,907839,Staff,13,0,15,2
1746597251454,PHIL 60,A00,889574,Staff,73,0,90,17
1746597252484,PHIL 101,A00,958004,Staff,12,0,15,3
1746597254538,PHIL 136,A00,889582,Fulkerson; Matthew Todd,26,0,45,19
1746597255568,PHIL 163,A01,889601,Staff,21,0,30,9
1746597255568,PHIL 163,B01,889606,Brandt; Reuven A,0,3,0,0
1746597256595,PHIL 164,A00,889610,Staff,16,0,30,14
1746597257619,PHIL 165,A00,889613,Staff,22,0,30,8
1746597258643,PHYS 1A,A00,886431,Staff,30,0,70,40
1746597259668,PHYS 1AL,001,886432,Tsai; Philbert S,0,1,30,30
1746597259668,PHYS 1AL,002,886436,Tsai; Philbert S,13,0,30,17
1746597260692,PHYS 1B,A00,886439,Staff,184,0,240,56
1746597261717,PHYS 1BL,001,886441,Tsai; Philbert S,0,4,30,30
1746597261717,PHYS 1BL,002,886444,Tsai; Philbert S,2,0,30,28
1746597262745,PHYS 1C,A00,896092,Arnold; Kam S,78,0,146,68
1746597263772,PHYS 1CL,001,886448,Tsai; Philbert S,0,0,30,30
1746597263772,PHYS 1CL,002,886449,Tsai; Philbert S,1,0,30,29
1746597263772,PHYS 1CL,003,886450,Tsai; Philbert S,16,0,30,14
1746597263772,PHYS 1CL,004,886451,Tsai; Philbert S,15,0,30,15
1746597264802,PHYS 2B,A01,886457,Staff,67,0,115,48
1746597265827,PHYS 2C,A01,886460,Shotwell; Brian,0,9,65,65
1746597266857,PHYS 2CL,A01,886467,Staff,0,4,28,28
1746597266857,PHYS 2CL,A02,886468,Staff,0,3,28,28
1746597267883,PHYS 2D,A01,886470,Staff,10,0,50,40
1746597268910,PHYS 4B,A01,886475,Grinstein; Benjamin,22,0,40,18
1746597269940,POLI 5,A00,891173,Desposato; Scott,7,0,25,18
1746597270969,POLI 5D,A01,891175,Staff,5,0,5,0
1746597270969,POLI 5D,B01,891178,Staff,5,0,5,0
1746597271999,POLI 11,A00,891179,Ferree; Karen E,1,0,35,34
1746597273024,POLI 12,A00,891180,Staff,15,0,30,15
1746597274053,POLI 27,A01,891182,Staff,12,0,75,63
1746597275080,POLI 30,A00,891183,Staff,8,0,50,42
1746597276106,POLI 100B,A00,891244,Staff,5,1,35,30
1746597277135,POLI 100I,A00,891247,Staff,7,0,30,23
1746597278160,POLI 104J,A00,891248,Nichter; Maysa,14,0,30,16
1746597279185,POLI 104U,A00,891250,Nichter; Maysa,1,0,30,29
1746597281257,POLI 110B,A00,891255,Wiens; David,19,0,25,6
1746597282285,POLI 112A,A00,891256,Wiens; David,6,0,25,19
1746597283311,POLI 114BR,A00,891261,Staff,19,0,30,11
1746597284337,POLI 117R,A00,891262,Forman; Fonna,0,6,50,50
1746597285363,POLI 118,A00,891264,Ingham; Sean,17,0,25,8
1746597286391,POLI 124A,A00,891265,Staff,18,0,20,2
1746597287415,POLI 125D,A00,891266,Nichter; Simeon C,2,0,25,23
1746597288444,POLI 126,A00,891268,Nichter; Simeon C,7,0,25,18
1746597289469,POLI 126AA,A00,891272,Staff,15,0,25,10
1746597290493,POLI 130AA,A00,891273,Staff,15,0,20,5
1746597291518,POLI 134AA,A00,891274,Staff,4,0,20,16
1746597293571,POLI 138,A00,891278,Staff,21,0,25,4
1746597294597,POLI 142K,A00,891280,Staff,10,0,25,15
1746597295625,POLI 142M,A00,891281,Gartzke; Erik,16,0,30,14
1746597296649,POLI 142P,A00,891284,Staff,20,0,30,10
1746597297671,POLI 143,A00,891285,Gartzke; Erik,12,0,30,18
1746597298698,POLI 153,A00,891286,Staff,19,0,20,1
1746597300750,POLI 175,A00,891290,Staff,15,0,20,5
1746597301785,PSYC 1,A00,890674,Steiner; Eric Tomas,0,11,45,45
1746597302815,PSYC 2,A00,890676,Albright; Thomas D,20,0,35,15
1746597303844,PSYC 3,A00,890679,Staff,17,0,20,3
1746597304869,PSYC 6,A00,959858,Staff,19,0,20,1
1746597305896,PSYC 60,A01,890684,Rickard; Timothy C.,0,6,45,45
1746597306921,PSYC 70,A01,890689,Geller; Emma Harlan,6,0,30,24
1746597307948,PSYC 71,A01,959860,Staff,21,0,25,4
1746597308975,PSYC 100,A00,890690,Lacefield; Katharine I,0,50,180,180
1746597310005,PSYC 102,A00,890695,Staff,18,0,40,22
1746597311034,PSYC 105,A00,890699,Geller; Emma Harlan,70,0,100,30
1746597312061,PSYC 106,A00,890701,Gorman; Michael R.,5,0,30,25
1746597313088,PSYC 108,A00,890704,Adrian; Julia Anna,0,29,50,50
1746597314114,PSYC 118,A01,890712,Staff,11,0,30,19
1746597315141,PSYC 124,A00,890716,Chapman; Eddie Nathaniel,25,0,60,35
1746597316169,PSYC 131,A00,890717,Anagnostaras; Stephan,0,7,80,80
1746597317198,PSYC 137,A00,890719,Winkielman; Piotr,0,11,30,30
1746597318229,PSYC 144,A00,890721,Adrian; Julia Anna,0,9,45,45
1746597319255,PSYC 162,A00,890805,Staff,0,1,75,75
1746597320285,PSYC 169,A00,890810,Staff,0,15,30,30
1746597321310,PSYC 172,A00,890814,Gorman; Michael R.,9,0,30,21
1746597322338,PSYC 181,A00,890818,Anagnostaras; Stephan,7,0,200,193
1746597323363,PSYC 184,A00,959861,Staff,162,0,175,13
1746597324388,PSYC 189,A00,890823,Staff,0,2,30,30
1746597325413,PSYC 191,A00,890884,Rickard; Timothy C.,0,11,35,35
1746597326442,PSYC 193,A00,890913,Staff,19,0,30,11
1746597326442,PSYC 193,B00,890914,Chapman; Eddie Nathaniel,24,0,30,6
1746597327472,PSYC 193L,A01,890918,Lowe; Angela Beth,20,0,30,10
1746597327472,PSYC 193L,B01,890921,Hurwitz; Ethan Scott,20,0,30,10
1746597327472,PSYC 193L,C01,890928,Staff,30,0,30,0
1746597328501,RELI 149,A00,886806,Rahimi; Babak,23,0,40,17
1746597329528,SE 9,A01,886814,Staff,7,0,20,13
1746597330552,SE 101B,A01,886816,Chadha; Mayank,3,0,35,32
1746597331583,SE 110B,A00,886818,Zhu; Qiang,4,0,75,71
1746597332609,SE 125,A01,886830,Staff,10,0,30,20
1746597333634,SE 130B,A01,886835,Staff,14,0,40,26
1746597334662,SE 131A,A01,886838,Krysl; Petr,34,0,55,21
1746597335689,SE 154,A00,886840,Staff,28,0,50,22
1746597336714,SE 164GS,A01,886849,Staff,6,0,20,14
1746597337950,SE 167GS,A01,886853,Staff,6,0,20,14
1746597338974,SIO 25,A01,890107,Staff,19,0,30,11
1746597340002,SIO 45,A00,890109,Cook; Geoffrey W,116,0,200,84
1746597341025,SIO 109R,A00,890110,Forman; Fonna,0,16,20,20
1746597342050,SIO 187,A01,890114,Kacev; David,15,0,40,25
1746597343074,SOCI 1,A01,890431,Thorpe; Charles Robert,14,0,30,16
1746597343074,SOCI 1,A02,890518,Thorpe; Charles Robert,30,0,30,0
1746597344102,SOCI 2,A01,957978,Staff,25,0,25,0
1746597344102,SOCI 2,A02,957979,Staff,23,0,25,2
1746597345130,SOCI 20,A01,890523,Calderon-Zaks; Michael Aar,21,0,30,9
1746597345130,SOCI 20,A02,890526,Calderon-Zaks; Michael Aar,29,0,30,1
1746597346157,SOCI 30,A01,890533,Pardo Guerra; Juan Pablo,37,0,40,3
1746597347186,SOCI 40,A01,890535,Staff,27,0,45,18
1746597348214,SOCI 104Q,A00,890559,Staff,18,0,30,12
1746597349238,SOCI 106,A00,890560,Arnal; Maud Marie Leonie,20,0,30,10
1746597350263,SOCI 110,A00,890567,Holkenbrink-Monk; Charlene,19,0,30,11
1746597351288,SOCI 112,A00,890568,Victoria Torres; Pablo,2,0,55,53
1746597352312,SOCI 115,A00,890597,Arnal; Maud Marie Leonie,28,0,45,17
1746597354366,SOCI 121,A00,890604,Pardo Guerra; Juan Pablo,38,0,45,7
1746597355393,SOCI 126,A01,890608,Staff,8,0,10,2
1746597356416,SOCI 127,A00,890609,Staff,18,0,30,12
1746597357450,SOCI 131,A00,890610,Thorpe; Charles Robert,37,0,45,8
1746597358489,SOCI 135,A00,890615,Payne; Christine Anna,14,0,45,31
1746597359516,SOCI 139,A00,890620,Staff,38,0,45,7
1746597360541,SOCI 148E,A00,890622,Calderon-Zaks; Michael Aar,36,0,45,9
1746597361568,SOCI 150,A00,890623,Kohler; Kristopher M.,31,0,45,14
1746597362592,SOCI 157,A00,890625,Jules-Rosette; Bennetta W.,18,0,20,2
1746597363617,SOCI 160,A00,890627,Payne; Christine Anna,21,0,45,24
1746597364642,SYN 1,A00,886855,Fish; Gwendolyn Anne,0,1,0,0
1746597364642,SYN 1,B00,906086,Fish; Gwendolyn Anne,0,2,0,2
1746597365670,SYN 2R,A00,886860,Staff,0,17,15,15
1746597365670,SYN 2R,B00,906106,Atkinson; Arthur Laird,0,16,15,15
1746597366698,SYN 100,A01,886866,Browne; Emily,0,28,20,20
1746597366698,SYN 100,B01,906128,Rock; Martin,0,4,20,20
1746597366698,SYN 100,C01,906140,Deavenport; James Cary,0,4,20,20
1746597366698,SYN 100,D01,907816,Deavenport; James Cary,0,5,20,20
1746597367724,TDAC 1,A00,890286,Walsh; Kim C.,7,0,20,13
1746597368754,TDAC 101,A00,890296,Basso; Beatrice,15,0,20,5
1746597369782,TDDE 131,A00,890297,Staff,47,0,50,3
1746597370808,TDDM 1,A00,890287,Weinberg; Sadie,25,0,30,5
1746597371838,TDGE 11,A00,890288,Fulton; Julia,138,0,200,62
1746597371838,TDGE 11,B00,890289,Castro; Robert Jess,184,0,200,16
1746597372865,TDGE 25,B00,957359,Walsh; Kim C.,5,0,20,15
1746597373904,TDGE 40,A01,890292,Power; Jade Yukana,26,0,30,4
1746597374928,TDGE 124,A00,890298,Havis; Allan,0,2,50,50
1746597375954,TDGE 131R,A00,890299,Burelle; Julie Sara Veronique,15,0,42,27
1746597376979,TDHT 101,A00,890300,Staff,10,0,20,10
1746597378008,TDHT 109,A01,890302,Anderson; Mysia Anyse,31,0,40,9
1746597379036,TDMV 1,A00,890293,Arcidiacono; Kristin,18,0,30,12
1746597380064,TDMV 2,A00,890294,Weinberg; Sadie,23,0,30,7
1746597381091,TDMV 3,A00,957878,Arcidiacono; Kristin,28,0,30,2
1746597383144,TDMV 138,A00,890304,Jun; Grace Shin Hae,25,0,40,15
1746597384170,TDMV 140,A00,890305,Corrales; Joseph Bernales,25,0,30,5
1746597385198,TDMV 142,A00,890307,Caligagan; Tony,32,0,40,8
1746597386226,TDMV 144,A00,890308,Camaya; Michelle Ann,25,0,30,5
1746597387253,TDPW 1,A00,890295,Stein; Deborah Isobel,3,0,20,17
1746597388282,USP 2,A01,890272,Lerner; Amy M,7,0,20,13
1746597389310,USP 3,A01,890274,Staff,12,0,30,18
1746597390337,USP 15,A01,890276,Sun; Feiyang,16,0,30,14
1746597391361,USP 25,A00,890277,Shenkman; Michael Thomas,18,0,25,7
1746597392398,USP 138,A00,890278,Staff,13,0,25,12
1746597393424,USP 143,A00,890279,Staff,21,0,70,49
1746597394449,USP 144,A00,890280,Chowdhury; Muhammed Zohir,16,0,30,14
1746597395477,USP 150,A00,890281,Boomhower; Matthew Charles,4,0,30,26
1746597396507,USP 151,A00,890282,Staff,16,0,20,4
1746597397532,USP 162,A00,890283,Andrews; Abigail Leslie,16,0,20,4
1746597398557,USP 168,A00,920477,Kwak; Nancy,0,0,5,5
1746597399584,USP 181,A00,890284,Staff,3,0,20,17
1746597400610,USP 191A,A00,890285,Staff,12,0,20,8
1746597401634,VIS 101,A00,886512,Staff,26,0,75,49
1746597402661,VIS 103,A00,886513,Cruz; Edwin Teddy,61,0,75,14
1746597403685,VIS 108,A00,886514,Staff,4,0,15,11
1746597404713,VIS 127P,A00,886515,Shen; Kuiyi,80,0,146,66
1746597405739,VIS 149,A00,886516,Yoldas; Pinar,0,0,15,15
1746597406764,VIS 164,A00,886526,Erdmann; Dean,19,0,22,3
1746597407789,VIS 194S,A00,886527,Staff,61,0,75,14
1746597408814,WCWP 10A,C00,886484,Martiniuk; Jill,12,0,15,3
1746597409843,WCWP 10B,A00,886490,Uriarte; Emma,0,0,15,15
1746597409843,WCWP 10B,B00,886491,Dhir; Simrita,8,0,15,7
1746597409843,WCWP 10B,C00,886492,Ornelas; Tricia,0,0,15,15
1746597410869,WCWP 100,A00,886494,Young; Mark T,0,6,15,15
1746597413218,AAS 10,A01,886199,Childs; Dennis R.,0,3,0,0
1746597414241,ANAR 104,A01,886940,Shtienberg; Gilad,27,0,30,3
1746597415268,ANAR 120,A00,886953,Staff,13,0,20,7
1746597416294,ANBI 148,A01,886955,Wilder; Linnea Lorene,30,0,40,10
1746597418343,ANSC 122,A00,886957,Staff,24,0,30,6
1746597419369,ANSC 150,A00,886958,Sloane; Julia Kathryn,2,0,15,13
1746597420398,ANSC 156,A00,886959,Jenkins; Janis A.,0,1,15,15
1746597421424,ANSC 180,A00,886960,Staff,11,0,17,6
1746597422450,ANSC 188,A00,886961,Jassal; Aftab,9,0,25,16
1746597423476,ANSC 190,A00,886962,Jassal; Aftab,14,0,25,11
1746597424502,ANSC 191,A00,886963,Staff,18,0,20,2
1746597425529,ANTH 3,A01,891689,Staff,17,0,20,3
1746597426554,ANTH 5,A00,886933,Semendeferi; Ekaterini,16,0,20,4
1746597427581,ANTH 10,A00,886934,Staff,0,12,30,30
1746597428607,ANTH 21,A01,886936,Staff,41,0,60,19
1746597429636,ANTH 23,A01,886938,Staff,92,0,100,8
1746597430661,ANTH 105,A00,886964,Stewart; Alexander B,84,0,100,16
1746597431687,ANTH 108,A00,886965,Pedersen; David,9,0,20,11
1746597432715,AWP 10,001,886147,Staff,0,0,0,0
1746597432715,AWP 10,002,886148,Staff,0,0,0,0
1746597432715,AWP 10,003,886149,Staff,0,0,0,0
1746597432715,AWP 10,004,886150,Staff,0,0,0,0
1746597432715,AWP 10,005,886151,Staff,0,0,0,0
1746597432715,AWP 10,006,886152,Staff,0,0,0,0
1746597432715,AWP 10,007,886153,Staff,0,0,0,0
1746597432715,AWP 10,008,886154,Staff,0,0,0,0
1746597432715,AWP 10,009,886155,Staff,0,0,0,0
1746597432715,AWP 10,010,886156,Staff,0,0,0,0
1746597432715,AWP 10,011,886158,Staff,0,0,0,0
1746597432715,AWP 10,012,886160,Staff,0,0,0,0
1746597432715,AWP 10,013,886161,Staff,0,0,0,0
1746597432715,AWP 10,014,886162,Staff,0,0,0,0
1746597432715,AWP 10,015,886163,Staff,0,0,0,0
1746597432715,AWP 10,016,886164,Staff,0,0,0,0
1746597432715,AWP 10,017,886165,Staff,0,0,0,0
1746597432715,AWP 10,018,886166,Staff,0,0,0,0
1746597432715,AWP 10,019,886168,Staff,0,0,0,0
1746597432715,AWP 10,020,886170,Staff,0,0,0,0
1746597432715,AWP 10,021,886172,Staff,0,0,0,0
1746597433745,AWP 10R,001,886173,Staff,0,1,0,0
1746597433745,AWP 10R,002,886174,Staff,0,1,0,0
1746597433745,AWP 10R,003,886175,Staff,0,0,0,0
1746597433745,AWP 10R,004,886176,Staff,0,0,0,0
1746597433745,AWP 10R,005,886177,Staff,0,0,0,0
1746597433745,AWP 10R,006,886178,Staff,0,0,0,0
1746597433745,AWP 10R,007,886179,Staff,0,0,0,0
1746597433745,AWP 10R,008,886181,Staff,0,0,0,0
1746597433745,AWP 10R,009,886182,Staff,0,0,0,0
1746597433745,AWP 10R,010,886183,Staff,0,0,0,0
1746597433745,AWP 10R,011,886184,Staff,0,0,0,0
1746597433745,AWP 10R,012,886185,Staff,0,0,0,0
1746597433745,AWP 10R,013,886186,Staff,0,0,0,0
1746597433745,AWP 10R,014,886187,Staff,0,0,0,0
1746597433745,AWP 10R,015,886188,Staff,0,0,0,0
1746597433745,AWP 10R,016,886189,Staff,0,0,0,0
1746597433745,AWP 10R,017,960532,Staff,0,0,0,0
1746597433745,AWP 10R,018,960533,Staff,0,0,0,0
1746597433745,AWP 10R,019,960534,Staff,0,0,0,0
1746597433745,AWP 10R,020,960538,Staff,0,0,0,0
1746597433745,AWP 10R,021,960540,Staff,0,0,0,0
1746597433745,AWP 10R,022,960541,Staff,0,0,0,0
1746597433745,AWP 10R,023,960542,Staff,0,0,0,0
1746597433745,AWP 10R,024,960544,Staff,0,0,0,0
1746597433745,AWP 10R,025,960545,Staff,0,0,0,0
1746597433745,AWP 10R,026,960548,Staff,0,0,0,0
1746597434774,AWP 102R,A00,886190,Staff,0,0,0,0
1746597434774,AWP 102R,B00,886191,Staff,0,0,0,0
1746597435798,BENG 100,A01,886193,Staff,17,0,30,13
1746597436827,BENG 122A,A01,886195,Hasty; Jeff M,13,0,30,17
1746597437854,BENG 166A,A00,886196,Sah; Robert Lie-Yuan,0,3,30,30
1746597438880,BENG 190,A00,958050,Khojah; Reem I,17,0,25,8
1746597439908,BIBC 102,A01,894320,Staff,0,1,46,46
1746597439908,BIBC 102,A02,894321,Staff,0,0,46,46
1746597439908,BIBC 102,A03,894344,Staff,6,0,46,40
1746597439908,BIBC 102,A04,894345,Staff,27,0,47,20
1746597440936,BICD 100R,A01,894365,Smith; Laurie,0,2,58,58
1746597440936,BICD 100R,A02,894366,Smith; Laurie,0,4,58,58
1746597440936,BICD 100R,A03,894367,Smith; Laurie,0,0,59,59
1746597440936,BICD 100R,A04,959869,Smith; Laurie,38,0,59,21
1746597441962,BICD 136,A01,894383,Gustafson-Brown; Cindy,14,0,50,36
1746597442988,BIEB 102,A01,894494,Butler; Shannon Rhey,51,0,130,79
1746597445044,BIEB 150,A01,894617,Wills; Christopher,3,0,20,17
1746597445044,BIEB 150,A02,894631,Wills; Christopher,3,0,20,17
1746597445044,BIEB 150,A03,894937,Wills; Christopher,3,0,20,17
1746597445044,BIEB 150,A04,894946,Wills; Christopher,5,0,20,15
1746597446069,BIEB 194,A00,906141,Kurle; Carolyn M.,5,0,20,15
1746597447097,BILD 1,A01,894154,Staff,3,0,19,16
1746597447097,BILD 1,A02,894155,Staff,14,0,19,5
1746597447097,BILD 1,A03,894160,Staff,13,0,19,6
1746597447097,BILD 1,A04,894161,Staff,15,0,18,3
1746597448122,BILD 2,A01,894168,Staff,0,0,50,50
1746597448122,BILD 2,A02,894169,Staff,0,0,50,50
1746597448122,BILD 2,A03,894179,Staff,0,0,50,50
1746597448122,BILD 2,A04,894203,Staff,22,0,50,28
1746597449147,BILD 3,A01,894213,Staff,23,0,31,8
1746597449147,BILD 3,A02,894214,Staff,26,0,31,5
1746597449147,BILD 3,A03,894235,Staff,28,0,31,3
1746597449147,BILD 3,A04,894236,Staff,28,0,32,4
1746597450176,BILD 4,A01,894253,Reuther; Keefe,5,0,24,19
1746597450176,BILD 4,A02,894258,Reuther; Keefe,16,0,24,8
1746597451199,BILD 5,A01,894276,Reuther; Keefe,34,0,50,16
1746597451199,BILD 5,A02,894277,Reuther; Keefe,45,0,50,5
1746597451199,BILD 5,A03,894290,Reuther; Keefe,44,0,50,6
1746597451199,BILD 5,A04,894291,Reuther; Keefe,48,0,50,2
1746597452228,BILD 24,A01,894297,Pirino; Giorgia,40,0,60,20
1746597453255,BIMM 100,B01,958915,Staff,71,0,100,29
1746597454282,BIMM 101,A01,895017,McDonnell; Lisa Marie,0,5,24,24
1746597454282,BIMM 101,A02,895018,McDonnell; Lisa Marie,0,5,24,24
1746597454282,BIMM 101,B01,895020,McDonnell; Lisa Marie,0,5,24,24
1746597454282,BIMM 101,B02,895021,McDonnell; Lisa Marie,0,4,24,24
1746597455309,BIMM 110,A01,895023,Staff,1,0,25,24
1746597455309,BIMM 110,A02,895024,Staff,9,0,25,16
1746597455309,BIMM 110,A03,895025,Staff,18,0,25,7
1746597455309,BIMM 110,A04,895031,Staff,20,0,25,5
1746597456337,BIMM 120,A01,895114,Gustafson-Brown; Cindy,14,0,28,14
1746597456337,BIMM 120,A02,895126,Gustafson-Brown; Cindy,21,0,27,6
1746597457363,BIPN 100,A01,895130,Yang; Mingyu,0,0,38,38
1746597457363,BIPN 100,A02,895131,Yang; Mingyu,31,0,38,7
1746597457363,BIPN 100,A03,895132,Yang; Mingyu,32,0,38,6
1746597457363,BIPN 100,A04,895133,Yang; Mingyu,27,0,36,9
1746597458387,BIPN 120,A01,895135,Cooke; James Edward,0,3,13,13
1746597458387,BIPN 120,A02,895136,Cooke; James Edward,0,1,13,13
1746597458387,BIPN 120,A03,895137,Cooke; James Edward,0,3,13,13
1746597458387,BIPN 120,A04,895156,Cooke; James Edward,0,2,11,11
1746597459412,BIPN 134,A01,895235,Cooke; James Edward,0,1,25,25
1746597459412,BIPN 134,A02,895237,Cooke; James Edward,0,0,25,25
1746597459412,BIPN 134,A03,895240,Cooke; James Edward,1,0,25,24
1746597459412,BIPN 134,A04,895270,Cooke; James Edward,20,0,25,5
1746597460437,BIPN 189,A00,892103,Staff,0,14,14,14
1746597462489,BISP 194,A00,958008,Staff,0,2,0,0
1746597463515,CAT 124,A01,922009,Staff,0,5,20,20
1746597464547,CAT 125R,A00,886390,Morales; Celeste Georgianna,0,3,20,20
1746597464547,CAT 125R,B00,886391,Irwin; Matthew Joseph,0,4,20,20
1746597464547,CAT 125R,C00,886392,Smith; Lauryn Alissa,0,2,20,20
1746597464547,CAT 125R,D00,886393,Vanderschuit; Maya Alysia,0,3,20,20
1746597464547,CAT 125R,E00,886394,Marchisotto; Jennifer Anne,0,3,20,20
1746597465576,CENG 15,A01,886218,Drews; Aaron,3,0,8,5
1746597466605,CENG 113,A00,886219,Opatkiewicz; Justin Paul,15,0,25,10
1746597467669,CGS 101,A00,887044,Staff,7,0,20,13
1746597468696,CGS 105,A01,887046,Staff,14,0,25,11
1746597469725,CGS 112,A00,887047,Cuong; Marisol,12,0,15,3
1746597470749,CGS 113,A00,887048,Staff,23,0,30,7
1746597471775,CGS 120,A00,887049,Staff,10,0,17,7
1746597472807,CHEM 6A,A01,886336,Lam; Tin Yiu,38,0,50,12
1746597472807,CHEM 6A,A02,886338,Lam; Tin Yiu,37,0,50,13
1746597473832,CHEM 6B,A01,886341,Hopkins; Patrycja Anna,16,0,50,34
1746597473832,CHEM 6B,A02,886343,Hopkins; Patrycja Anna,42,0,50,8
1746597474857,CHEM 6C,A01,886346,Albizati; Kim F.,0,2,50,50
1746597474857,CHEM 6C,A02,886348,Albizati; Kim F.,24,0,50,26
1746597475882,CHEM 40A,A01,886352,Klosterman; Jeremy K,65,0,100,35
1746597476909,CHEM 40B,A01,886356,Klosterman; Jeremy K,0,24,100,100
1746597477934,CHEM 41B,A01,886360,Theodorakis; Emmanuel,25,0,50,25
1746597477934,CHEM 41B,A02,886362,Theodorakis; Emmanuel,47,0,50,3
1746597478961,CHIN 165A,A00,886382,Xu; Li,18,0,20,2
1746597479989,CLAS 120,A00,886387,Myerston Santana; Jacobo,33,0,40,7
1746597481015,COGS 9,A01,886967,Shannon; Kyle Michael,42,0,60,18
1746597482042,COGS 11,A01,886969,Staff,9,0,30,21
1746597483067,COGS 14A,A01,886971,Staff,5,0,60,55
1746597484097,COGS 14B,A01,886973,Hoffman; Drew Ellen,4,0,60,56
1746597485122,COGS 18,A01,886975,Morgan; Eric,34,0,60,26
1746597486150,COGS 20,A01,886977,Staff,3,0,8,5
1746597486150,COGS 20,A02,886978,Staff,5,0,7,2
1746597487177,COGS 100,A01,907783,Staff,0,1,30,30
1746597488205,COGS 101B,A01,886980,Staff,0,4,48,48
1746597489230,COGS 101C,A01,886982,Delgado; Tania,0,5,44,44
1746597490258,COGS 102A,A01,886984,Johnson; Christine M.,3,0,30,27
1746597491281,COGS 118B,A01,886986,Staff,0,4,88,88
1746597492310,COGS 150,A01,886988,Bergen; Benjamin,22,0,50,28
1746597493337,COGS 153,A00,886989,Delgado; Tania,0,3,41,41
1746597494366,COGS 186,A01,886991,Staff,0,0,32,32
1746597495390,COGS 187A,A01,886993,Boyle; Mary E. T.,7,0,30,23
1746597496417,COGS 189,A00,886994,Staff,0,1,30,30
1746597497442,COMM 10,A01,886996,Staff,0,0,20,21
1746597497442,COMM 10,A02,886997,Staff,10,0,20,10
1746597497442,COMM 10,A03,959845,Staff,19,0,20,1
1746597498471,COMM 20,A01,886999,Leuning; Grant Maurstad,24,0,40,16
1746597500521,COMM 100A,A01,887002,Staff,0,0,20,25
1746597500521,COMM 100A,A02,887003,Staff,5,0,20,15
1746597501547,COMM 100B,A01,887005,Staff,0,8,20,24
1746597502572,COMM 106D,A00,887006,Staff,14,0,40,26
1746597503597,COMM 110G,A00,887007,Whitworth-Smith; Andrew C,12,0,40,28
1746597504623,COMM 111B,A00,887008,Staff,31,0,40,9
1746597505648,COMM 113T,A00,887009,Abuelhiga; Soraya Jill,28,0,40,12
1746597505648,COMM 113T,B00,906733,Staff,39,0,40,1
1746597506676,COMM 145,A00,887010,Staff,13,0,40,27
1746597507701,COMM 146,A00,887054,Staff,32,0,40,8
1746597508729,COMM 190,A00,887012,Staff,8,0,23,15
1746597509753,CSE 8A,A50,887015,Cao; Yingjun,56,0,85,29
1746597510778,CSE 11,A01,887017,Cao; Yingjun,11,0,70,59
1746597511803,CSE 20,A01,887019,Staff,30,0,50,20
1746597512829,CSE 21,A01,887021,Staff,79,0,100,21
1746597512829,CSE 21,B01,892583,Braun; Oliver,45,0,50,5
1746597513856,CSE 30,A01,887025,Eldon; John,142,0,200,58
1746597514885,CSE 100,A01,887027,Staff,26,0,50,24
1746597514885,CSE 100,A02,887028,Staff,42,0,50,8
1746597515909,CSE 101,A01,887030,Braun; Oliver,74,0,100,26
1746597515909,CSE 101,B01,887032,Jones; Miles E,0,3,50,50
1746597515909,CSE 101,B02,887033,Jones; Miles E,0,2,50,50
1746597516936,CSE 105,A01,908084,Jones; Miles E,32,0,50,18
1746597516936,CSE 105,A02,908087,Jones; Miles E,31,0,50,19
1746597517964,CSE 135,A01,887035,Powell; Thomas Allan,0,5,50,50
1746597518991,CSE 142,A01,887037,Staff,8,0,60,52
1746597520015,CSE 142L,A01,887039,Staff,34,0,60,26
1746597521041,CSE 151A,A01,887041,Solares; Edwin A,47,0,100,53
1746597522066,CSE 175,A01,887043,Kumar; Rakesh,30,0,30,0
1746597523091,CSS 1,A01,886389,Staff,0,1,40,40
1746597524117,DSC 30,A01,908097,Liao; Soohyun Nam,47,0,75,28
1746597525144,DSC 40A,A01,908099,Shannon; Kyle Michael,30,0,50,20
1746597526172,DSC 40B,A01,908112,Staff,15,0,50,35
1746597527200,DSC 80,A01,908116,Staff,19,0,60,41
1746597528226,DSC 197,001,956863,Eldridge; Justin Matthew,9999,0,9999,0
1746597529252,ECE 5,A01,886400,Morris; Karcher William,1,0,6,5
1746597529252,ECE 5,A02,886401,Morris; Karcher William,3,0,6,3
1746597530277,ECE 148,A01,886403,Silberman; Jack,0,14,14,14
1746597531306,ECON 1,A01,887265,Crane; Meredith Helen,11,0,70,59
1746597531306,ECON 1,B01,887268,Staff,42,0,50,8
1746597532333,ECON 2,A01,887273,Crane; Meredith Helen,54,0,70,16
1746597533362,ECON 3,A01,887279,Rondina; Giacomo,31,0,70,39
1746597534386,ECON 4,A01,887282,Anderson; John Charles,0,2,10,10
1746597535410,ECON 5,A01,887285,Staff,34,0,45,11
1746597535410,ECON 5,B01,887292,Staff,41,0,45,4
1746597536434,ECON 100A,A01,887337,Newhouse; Herbert S,54,0,70,16
1746597536434,ECON 100A,B01,887349,Staff,45,0,50,5
1746597537462,ECON 100B,A01,887361,Du; Songzi,29,0,70,41
1746597538486,ECON 100C,A01,887445,Newhouse; Herbert S,59,0,70,11
1746597539514,ECON 105,A00,887488,Vespa; Emanuel Ignacio,23,0,35,12
1746597540543,ECON 109,A01,887506,Shishkin; Denis,28,0,35,7
1746597541569,ECON 110A,A01,887568,Alon; Titan Michael,0,2,35,35
1746597541569,ECON 110A,B01,907601,Alon; Titan Michael,20,0,35,15
1746597542595,ECON 110B,A01,887598,Levkoff; Steven B.,0,24,70,70
1746597543623,ECON 112,A00,887599,Rondina; Giacomo,19,0,35,16
1746597544647,ECON 120A,A01,887603,Dai; Yinlin,35,0,70,35
1746597545681,ECON 120C,A01,887608,Sun; Yixiao,0,1,35,35
1746597545681,ECON 120C,B01,887614,Sun; Yixiao,0,0,35,35
1746597546709,ECON 138,A00,887621,Bharadwaj; Prashant,0,21,20,20
1746597547736,ECON 144,A00,958007,Squires; Dale E,12,0,35,23
1746597548762,ECON 171,A01,907666,Staff,18,0,35,17
1746597549787,ECON 175,A00,887626,Wu; Pak Yeung,22,0,35,13
1746597550815,ECON 190,A00,887640,Vespa; Emanuel Ignacio,22,0,35,13
1746597551843,EDS 25,A01,888197,Staff,0,0,0,0
1746597551843,EDS 25,A02,888209,Staff,0,0,0,0
1746597551843,EDS 25,A03,888210,Staff,0,0,0,0
1746597551843,EDS 25,A04,888212,Staff,0,0,0,0
1746597551843,EDS 25,A05,888213,Staff,0,0,0,0
1746597551843,EDS 25,A06,888214,Staff,0,0,0,0
1746597551843,EDS 25,A07,888235,Staff,0,2,0,0
1746597551843,EDS 25,A08,888236,Staff,0,0,0,0
1746597551843,EDS 25,A09,888240,Staff,0,0,0,0
1746597551843,EDS 25,A10,888244,Staff,0,0,0,0
1746597551843,EDS 25,B01,888273,Staff,0,0,0,0
1746597551843,EDS 25,B02,888285,Staff,0,0,0,0
1746597551843,EDS 25,B03,888423,Staff,0,0,0,1
1746597551843,EDS 25,B04,888432,Staff,0,0,0,0
1746597551843,EDS 25,B05,888433,Staff,0,0,0,0
1746597551843,EDS 25,B06,888467,Staff,0,0,0,0
1746597551843,EDS 25,B07,888468,Staff,0,0,0,0
1746597551843,EDS 25,B08,888479,Staff,0,0,0,0
1746597551843,EDS 25,B09,888484,Staff,0,0,0,0
1746597551843,EDS 25,B10,888487,Staff,0,0,0,0
1746597552871,EDS 38,A01,907700,Choi; Bailey Miyeon,30,0,30,0
1746597553898,EDS 112,A01,888601,Chapman; Thandeka K,12,0,40,28
1746597554922,EDS 115,A00,888697,Mendez; Kathrina Mendoza,10,0,30,20
1746597555950,EDS 116,A01,888893,Staff,33,0,40,7
1746597558003,EDS 124AR,A00,889133,Staff,29,0,50,21
1746597558003,EDS 124AR,B00,907471,Simon; Elizabeth A,37,0,50,13
1746597559030,EDS 124BR,A00,889134,Simon; Elizabeth A,44,0,100,56
1746597560054,EDS 125,A00,889135,Staff,25,0,30,5
1746597561083,EDS 126,A01,889138,Staff,35,0,40,5
1746597562110,EDS 164R,A01,889142,Wishard Guerra; Alison G.,32,0,50,18
1746597563136,ENG 30,A01,886396,Staff,0,0,0,0
1746597563136,ENG 30,B01,886398,Staff,0,0,0,0
1746597564163,ENVR 102,A00,906150,Montejo; Carolina,23,0,25,2
1746597565187,ETHN 103A,A00,887236,Man; Simeon S,0,2,0,0
1746597566214,ETHN 113,A00,887239,Staff,16,0,30,14
1746597567240,ETHN 116,A00,887240,Staff,16,0,25,9
1746597568263,ETHN 117,A00,887241,Choi; Esther Min,28,0,30,2
1746597569289,ETHN 118,A00,887243,Staff,24,0,30,6
1746597570318,ETHN 127,A00,887248,Cuong; Marisol,11,0,15,4
1746597571342,ETHN 139,A00,887250,Staff,7,0,10,3
1746597572366,ETHN 142,A00,887252,Staff,10,0,30,20
1746597573393,ETHN 161,A00,887253,Browne; Errol Tsekani,24,0,30,6
1746597574417,ETHN 163FR,A00,887255,Burelle; Julie Sara Veronique,0,0,5,5
1746597575444,GLBH 20,A00,889149,Elwardani; Nile Regina,8,0,42,34
1746597577498,GLBH 111,A01,889152,Burgos; Jose L.,17,0,17,0
1746597578524,GLBH 150,A00,889181,Sloane; Julia Kathryn,0,5,15,15
1746597580575,HDS 60,A01,886406,Warstadt; Melissa Fawn,72,0,80,8
1746597581602,HIAF 111,A00,889324,Gyamfi; Bright,25,0,32,7
1746597582628,HIEA 131,A00,889328,Staff,15,0,32,17
1746597583656,HIEA 144,A00,889333,Henry; Todd A.,26,0,32,6
1746597584682,HIEA 154,A00,889336,Henry; Todd A.,24,0,32,8
1746597585706,HIEU 106,A00,889339,Staff,22,0,32,10
1746597587761,HIEU 114,A00,889340,Staff,4,0,32,28
1746597588785,HIEU 135GS,A00,889342,Patterson; Patrick H.,0,0,1,24
1746597589814,HIEU 137,A00,889343,Edington; Claire Ellen,10,0,25,15
1746597590839,HIEU 148,A00,889345,Staff,14,0,32,18
1746597591862,HIEU 154,A00,889346,Biess; Frank Peter,21,0,32,11
1746597592890,HILA 102,A00,889351,Staff,12,0,32,20
1746597593916,HILD 2A,A01,889221,Lewandoski; Julia Mavis,0,8,32,32
1746597594944,HILD 7B,A01,889225,Man; Simeon S,0,12,32,32
1746597595971,HILD 7C,A01,889288,Alvarez; Luis A,0,14,32,32
1746597596999,HILD 30,A01,889323,Staff,0,5,32,32
1746597599055,HISC 119,A00,889383,Golan; Tal,20,0,32,12
1746597600080,HIUS 103,A00,889384,Man; Simeon S,0,0,32,32
1746597601107,HIUS 117,A00,919797,Kwak; Nancy,18,0,32,14
1746597602139,HIUS 142A,A00,919788,Staff,22,0,32,10
1746597604197,HIUS 149,A00,889386,Gyamfi; Bright,26,0,32,6
1746597605227,HIUS 155,A00,889387,Alvarez; Luis A,15,0,32,17
1746597606251,HUM 3,A01,886499,Caldwell; Michael Alan,19,0,50,31
1746597607276,HUM 3GS,A00,886500,Rodriguez; Bretton Sigfred,0,0,0,28
1746597608304,HUM 3R,A01,886502,Markman; Kristina,0,36,50,50
1746597609330,HUM 4,A01,886504,Crum; Matthew Stephen,23,0,50,27
1746597609330,HUM 4,B01,886506,West; Geoffrey Scott,17,0,50,33
1746597610357,HUM 4GS,A00,886507,Staff,0,0,0,19
1746597611383,HUM 5,A01,886509,Staff,31,0,50,19
1746597612439,HUM 5R,A01,886511,Zavodny; Tatiana Sophia,0,39,50,50
1746597613466,JAPN 180,A00,886407,Staff,16,0,40,24
1746597614521,LATI 50,A01,886409,Martin-Cabrera; Luis,3,0,22,19
1746597614521,LATI 50,A02,886410,Martin-Cabrera; Luis,19,0,22,3
1746597614521,LATI 50,A03,886411,Martin-Cabrera; Luis,21,0,22,1
1746597614521,LATI 50,A04,886412,Martin-Cabrera; Luis,8,0,22,14
1746597615557,LAWS 101,A00,907664,Staff,28,0,60,32
1746597616586,LIAB 1A,A00,889388,Saab; Dima,17,0,20,3
1746597617613,LIAB 1AX,A00,889389,El Cheddadi; Youniss,18,0,20,2
1746597618650,LIFR 1C,A00,889391,Van Moer; Vinciane G,8,0,20,12
1746597619681,LIFR 1CX,A00,889392,Van Moer; Vinciane G,7,0,20,13
1746597620707,LIFR 1D,A00,889393,Van Moer; Vinciane G,7,0,20,13
1746597621732,LIFR 1DX,A00,889394,Van Moer; Vinciane G,8,0,20,12
1746597622760,LIGN 7,A00,886923,Staff,25,0,50,25
1746597623789,LIGN 17,A00,886924,Kehler; Andrew Scott,126,0,150,24
1746597624815,LTAM 110,A00,889395,Staff,15,0,30,15
1746597625843,LTAM 110GS,A00,958010,Rodriguez; Bretton Sigfred,0,0,0,28
1746597626873,LTCH 101,A00,889397,Staff,23,0,25,2
1746597627904,LTCS 130,A00,889398,Staff,23,0,25,2
1746597628930,LTEA 138,A00,889399,Staff,24,0,40,16
1746597629969,LTEN 149,A00,889400,Wesling; Megan E.,0,3,25,25
1746597630994,LTEN 169,A00,889401,Staff,20,0,25,5
1746597632029,LTEN 180,A00,889402,Staff,10,0,15,5
1746597633056,LTEN 181,A00,889403,Staff,21,0,25,4
1746597634082,LTWL 100,A00,889404,Myerston Santana; Jacobo,2,0,25,23
1746597635114,LTWL 180GS,A00,889405,Staff,0,0,20,20
1746597636148,LTWL 181,A00,889406,Staff,16,0,25,9
1746597637185,LTWL 184,A00,889475,Mukherjee; Silpa,22,0,25,3
1746597638214,LTWR 102C,A00,889486,Staff,29,0,30,1
1746597639245,LTWR 115W,A00,889491,Staff,0,2,15,15
1746597640275,MAE 8,A01,886905,Staff,0,2,0,0
1746597641315,MAE 11,A00,886906,Bandaru; Prabhakar,0,7,50,50
1746597642341,MAE 20,A00,886907,Evdokimenko; Ekaterina,43,0,70,27
1746597643375,MAE 30B,A00,886909,Ghazinejad; Maziar,25,0,45,20
1746597644403,MAE 101B,A00,886910,Saintillan; David,30,0,45,15
1746597645432,MAE 105,A00,886911,Bandaru; Prabhakar,18,0,50,32
1746597646460,MAE 107,B00,958024,Staff,7,0,50,43
1746597647492,MAE 143B,A00,886913,Bewley; Thomas R,2,0,40,38
1746597648518,MAE 148,A01,886915,Silberman; Jack,0,3,14,14
1746597649545,MAE 160,A00,886916,Evdokimenko; Ekaterina,31,0,60,29
1746597650574,MATH 3C,A01,889681,Staff,0,2,30,30
1746597650574,MATH 3C,A02,960048,Staff,23,0,30,7
1746597651605,MATH 10A,A01,889760,Staff,26,0,30,4
1746597651605,MATH 10A,A02,889783,Staff,29,0,30,1
1746597652643,MATH 10B,A01,889785,Verstraete; Jacques Allan,1,0,35,34
1746597652643,MATH 10B,A02,889795,Verstraete; Jacques Allan,4,0,35,31
1746597652643,MATH 10B,B01,889797,Verstraete; Jacques Allan,3,0,35,32
1746597652643,MATH 10B,B02,889828,Verstraete; Jacques Allan,3,0,35,32
1746597653675,MATH 10C,A01,889849,Habib; Yousaf,8,0,30,22
1746597653675,MATH 10C,A02,889852,Habib; Yousaf,14,0,30,16
1746597653675,MATH 10C,A03,889853,Habib; Yousaf,22,0,30,8
1746597653675,MATH 10C,A04,889858,Habib; Yousaf,20,0,30,10
1746597653675,MATH 10C,B01,889861,Staff,1,0,30,29
1746597653675,MATH 10C,B02,889862,Staff,24,0,30,6
1746597653675,MATH 10C,B03,889863,Staff,27,0,30,3
1746597653675,MATH 10C,B04,889967,Staff,23,0,30,7
1746597654707,MATH 18,A01,889974,Staff,7,0,30,23
1746597654707,MATH 18,A02,889977,Staff,20,0,30,10
1746597654707,MATH 18,B01,889984,Hardiman; Liam,20,0,30,10
1746597654707,MATH 18,B02,889985,Hardiman; Liam,25,0,30,5
1746597655734,MATH 20A,A01,889990,Suk; Andrew Hoon,30,0,35,5
1746597656759,MATH 20B,A01,889993,Ohm; Ko Woon,21,0,30,9
1746597656759,MATH 20B,A02,889994,Ohm; Ko Woon,30,0,30,0
1746597656759,MATH 20B,B01,889996,Ohm; Ko Woon,22,0,30,8
1746597656759,MATH 20B,B02,889997,Ohm; Ko Woon,23,0,30,7
1746597657791,MATH 20C,A01,889999,Hammock; Frances H,17,0,30,13
1746597657791,MATH 20C,A02,890003,Hammock; Frances H,23,0,30,7
1746597657791,MATH 20C,B01,890006,Hammock; Frances H,2,0,30,28
1746597657791,MATH 20C,B02,890007,Hammock; Frances H,12,0,30,18
1746597658823,MATH 20D,A01,890011,Cheng; Hsiao-Bing,0,0,30,30
1746597658823,MATH 20D,A02,890012,Cheng; Hsiao-Bing,14,0,30,16
1746597658823,MATH 20D,B01,890016,Cheng; Hsiao-Bing,13,0,30,17
1746597658823,MATH 20D,B02,890017,Cheng; Hsiao-Bing,13,0,30,17
1746597659857,MATH 20E,A01,890026,Harel; Guershon,1,0,30,29
1746597659857,MATH 20E,A02,890029,Harel; Guershon,22,0,30,8
1746597659857,MATH 20E,B01,890033,Harel; Guershon,7,0,30,23
1746597659857,MATH 20E,B02,890101,Harel; Guershon,21,0,30,9
1746597660885,MATH 102,A01,890104,Staff,18,0,30,12
1746597660885,MATH 102,A02,890105,Staff,27,0,30,3
1746597661913,MATH 103B,A01,890116,Salehi Golsefidy; Alireza,3,0,30,27
1746597661913,MATH 103B,B01,890118,Staff,0,3,34,34
1746597662939,MATH 109,A01,890121,Aliabadi Sr.; Mohsen,0,0,30,30
1746597662939,MATH 109,B01,890124,Upadrashta; Pranav Kumar,18,0,30,12
1746597663967,MATH 120A,A01,890126,Eggers; John Dietrich,13,0,30,17
1746597664999,MATH 142B,A01,890128,Ioana; Adrian,19,0,30,11
1746597664999,MATH 142B,A02,890129,Ioana; Adrian,12,0,30,18
1746597666027,MATH 154,A01,890174,Staff,0,1,30,30
1746597666027,MATH 154,A02,890182,Staff,0,0,30,30
1746597667058,MATH 168A,A01,890197,Dumitriu; Ioana,21,0,35,14
1746597668084,MATH 170A,A01,890240,Nie; Jiawang,1,0,30,29
1746597668084,MATH 170A,A02,890241,Nie; Jiawang,11,0,30,19
1746597668084,MATH 170A,A03,890249,Nie; Jiawang,23,0,30,7
1746597669133,MATH 170B,A01,957891,Nag; Panchali,13,0,35,22
1746597671194,MATH 181A,A01,908025,Staff,0,3,35,35
1746597671194,MATH 181A,A02,960115,Staff,26,0,35,9
1746597672225,MATH 181B,A01,959874,Staff,24,0,30,6
1746597673251,MATH 193B,A01,890265,Staff,0,4,35,35
1746597674279,MGT 4,A01,890311,Anderson; John Charles,42,0,88,46
1746597675308,MGT 5,A00,907740,Staff,12,0,98,86
1746597676336,MGT 12,A00,890312,Lindenberger; Wade Douglas,67,0,98,31
1746597677365,MGT 16,A00,957883,Staff,78,0,98,20
1746597679418,MGT 45,A00,890314,Pecore; Joseph P.,45,0,98,53
1746597680447,MGT 71,A00,890315,Staff,0,12,98,98
1746597681474,MGT 100,A00,890316,Yavorsky; Daniel Ryan,44,0,98,54
1746597682500,MGT 103,A00,890317,Ehrich; Kristine R,73,0,98,25
1746597683527,MGT 105,A00,890356,Bates; Kenneth Walter,0,8,98,98
1746597684553,MGT 112,A00,890360,Ehrich; Kristine R,55,0,98,43
1746597685581,MGT 127R,A00,907732,Zhu; Kevin Xiaoguo,23,0,98,75
1746597686625,MGT 131B,A00,890361,Anderson; John Charles,59,0,98,39
1746597687651,MGT 137,A00,890362,Lindenberger; Wade Douglas,65,0,98,33
1746597688681,MGT 160,A00,890369,Johnson; Erik Barry,9,0,98,89
1746597690732,MGT 164,A00,890372,Zimmermann; Carsten,0,40,98,98
1746597691758,MGT 180,A00,890374,Bliss; Barbara Ann,11,0,98,87
1746597692783,MMW 15,A01,886414,Chang; Edmond Yi-Teh,0,12,28,28
1746597692783,MMW 15,A02,886415,Chang; Edmond Yi-Teh,0,8,28,28
1746597692783,MMW 15,A03,886416,Chang; Edmond Yi-Teh,0,9,28,28
1746597692783,MMW 15,A04,886417,Chang; Edmond Yi-Teh,0,8,28,28
1746597692783,MMW 15,B01,886419,Chang; Edmond Yi-Teh,0,7,28,28
1746597692783,MMW 15,B02,886420,Chang; Edmond Yi-Teh,0,7,28,28
1746597692783,MMW 15,B03,886421,Chang; Edmond Yi-Teh,0,7,28,28
1746597692783,MMW 15,B04,886422,Chang; Edmond Yi-Teh,0,8,28,28
1746597692783,MMW 15,C01,886424,Staff,0,9,28,28
1746597692783,MMW 15,C02,886425,Staff,0,8,28,28
1746597692783,MMW 15,C03,886426,Staff,0,8,28,28
1746597692783,MMW 15,C04,886427,Staff,0,8,28,28
1746597692783,MMW 15,C05,958038,Staff,0,8,28,28
1746597692783,MMW 15,C06,958039,Staff,0,7,28,28
1746597693809,MMW 15GS,A00,906910,Patterson; Patrick H.,4,0,28,24
1746597694836,MMW 122R,A01,886429,Rahimi; Babak,0,13,28,28
1746597694836,MMW 122R,A02,886430,Rahimi; Babak,0,12,28,28
1746597694836,MMW 122R,A03,958040,Rahimi; Babak,0,11,28,28
1746597695862,MUS 1A,A01,890937,Staff,2,0,25,23
1746597695862,MUS 1A,A02,891035,Staff,6,0,25,19
1746597695862,MUS 1A,C01,958912,Staff,24,0,25,1
1746597695862,MUS 1A,C02,958913,Staff,25,0,25,0
1746597697918,MUS 2AK,A00,957092,Ohnishi; Takae,15,0,15,0
1746597698945,MUS 4,A01,891044,Staff,0,0,25,25
1746597698945,MUS 4,A02,891045,Staff,22,0,25,3
1746597698945,MUS 4,B01,891048,Staff,17,0,25,8
1746597698945,MUS 4,B02,891050,Staff,25,0,25,0
1746597699974,MUS 5,A01,957506,Dubnov; Shlomo,0,0,25,25
1746597699974,MUS 5,A02,957622,Dubnov; Shlomo,13,0,25,12
1746597699974,MUS 5,A03,957623,Dubnov; Shlomo,20,0,25,5
1746597701003,MUS 6,A01,891053,Freitas Caetano; Marcelo,24,0,25,1
1746597701003,MUS 6,A02,891054,Freitas Caetano; Marcelo,23,0,25,2
1746597702030,MUS 7,A01,891081,Staff,0,0,25,25
1746597702030,MUS 7,A02,891082,Staff,3,0,25,22
1746597703055,MUS 8GS,A00,891118,Borgo; David Garcia,1,0,25,24
1746597704122,MUS 11,A01,891140,Staff,8,0,25,17
1746597704122,MUS 11,A02,891141,Staff,21,0,25,4
1746597705147,MUS 13,A01,891143,Staff,8,0,25,17
1746597705147,MUS 13,A02,891144,Staff,24,0,25,1
1746597706173,MUS 15,A01,891146,Staff,9,0,25,16
1746597706173,MUS 15,A02,891148,Staff,21,0,25,4
1746597706173,MUS 15,B01,891150,Staff,18,0,25,7
1746597706173,MUS 15,B02,891151,Staff,25,0,25,0
1746597707200,MUS 20,A01,891153,Staff,5,0,20,15
1746597707200,MUS 20,A02,891155,Staff,14,0,20,6
1746597708225,MUS 80,A00,891156,Staff,19,0,25,6
1746597708225,MUS 80,B00,891157,Staff,23,0,25,2
1746597709250,MUS 130,A00,891158,Ohnishi; Takae,35,0,35,0
1746597710276,MUS 150GS,A01,891160,Borgo; David Garcia,1,0,25,24
1746597711305,MUS 170,A01,891162,Freitas Caetano; Marcelo,20,0,25,5
1746597711305,MUS 170,A02,891164,Freitas Caetano; Marcelo,21,0,25,4
1746597712331,NANO 11,A00,886220,Vazquez Mena; Oscar,13,0,15,2
1746597713358,NANO 15,A01,886222,Drews; Aaron,4,0,7,3
1746597714387,NANO 104,A00,886224,Sirbuly; Donald,17,0,25,8
1746597715412,PH 40,A00,886528,Staff,23,0,40,17
1746597716438,PH 45,A01,886799,Staff,35,0,40,5
1746597717463,PH 110,A00,886802,Staff,0,6,40,40
1746597718492,PH 172,A00,906716,Staff,19,0,35,16
1746597719516,PH 191,A00,886803,Staff,6,0,40,34
1746597720546,PHIL 1,A00,889500,Staff,20,0,30,10
1746597721572,PHIL 10,A01,889549,Grush; Rick Scott,16,0,22,6
1746597721572,PHIL 10,A02,889551,Grush; Rick Scott,22,0,22,0
1746597722598,PHIL 28,A01,889559,Lamey; Andy M.,0,2,31,31
1746597722598,PHIL 28,A02,889561,Lamey; Andy M.,0,1,30,30
1746597722598,PHIL 28,A03,889572,Lamey; Andy M.,0,1,30,30
1746597723625,PHIL 35,A00,907839,Staff,13,0,15,2
1746597724653,PHIL 60,A00,889574,Staff,73,0,90,17
1746597725684,PHIL 101,A00,958004,Staff,12,0,15,3
1746597727739,PHIL 136,A00,889582,Fulkerson; Matthew Todd,26,0,45,19
1746597728765,PHIL 163,A01,889601,Staff,21,0,30,9
1746597728765,PHIL 163,B01,889606,Brandt; Reuven A,0,3,0,0
1746597729790,PHIL 164,A00,889610,Staff,16,0,30,14
1746597730815,PHIL 165,A00,889613,Staff,22,0,30,8
1746597731847,PHYS 1A,A00,886431,Staff,30,0,70,40
1746597732872,PHYS 1AL,001,886432,Tsai; Philbert S,0,1,30,30
1746597732872,PHYS 1AL,002,886436,Tsai; Philbert S,13,0,30,17
1746597733898,PHYS 1B,A00,886439,Staff,184,0,240,56
1746597734924,PHYS 1BL,001,886441,Tsai; Philbert S,0,4,30,30
1746597734924,PHYS 1BL,002,886444,Tsai; Philbert S,2,0,30,28
1746597735954,PHYS 1C,A00,896092,Arnold; Kam S,78,0,146,68
1746597736985,PHYS 1CL,001,886448,Tsai; Philbert S,0,0,30,30
1746597736985,PHYS 1CL,002,886449,Tsai; Philbert S,1,0,30,29
1746597736985,PHYS 1CL,003,886450,Tsai; Philbert S,16,0,30,14
1746597736985,PHYS 1CL,004,886451,Tsai; Philbert S,15,0,30,15
1746597738011,PHYS 2B,A01,886457,Staff,67,0,115,48
1746597739078,PHYS 2C,A01,886460,Shotwell; Brian,0,9,65,65
1746597740103,PHYS 2CL,A01,886467,Staff,0,4,28,28
1746597740103,PHYS 2CL,A02,886468,Staff,0,3,28,28
1746597741129,PHYS 2D,A01,886470,Staff,10,0,50,40
1746597742155,PHYS 4B,A01,886475,Grinstein; Benjamin,22,0,40,18
1746597743184,POLI 5,A00,891173,Desposato; Scott,7,0,25,18
1746597744214,POLI 5D,A01,891175,Staff,5,0,5,0
1746597744214,POLI 5D,B01,891178,Staff,5,0,5,0
1746597745241,POLI 11,A00,891179,Ferree; Karen E,1,0,35,34
1746597746272,POLI 12,A00,891180,Staff,15,0,30,15
1746597747299,POLI 27,A01,891182,Staff,11,0,75,64
1746597748325,POLI 30,A00,891183,Staff,8,0,50,42
1746597749348,POLI 100B,A00,891244,Staff,5,1,35,30
1746597750374,POLI 100I,A00,891247,Staff,7,0,30,23
1746597751400,POLI 104J,A00,891248,Nichter; Maysa,14,0,30,16
1746597752433,POLI 104U,A00,891250,Nichter; Maysa,1,0,30,29
1746597754486,POLI 110B,A00,891255,Wiens; David,19,0,25,6
1746597755519,POLI 112A,A00,891256,Wiens; David,6,0,25,19
1746597756546,POLI 114BR,A00,891261,Staff,19,0,30,11
1746597757571,POLI 117R,A00,891262,Forman; Fonna,0,6,50,50
1746597758598,POLI 118,A00,891264,Ingham; Sean,17,0,25,8
1746597759626,POLI 124A,A00,891265,Staff,18,0,20,2
1746597760655,POLI 125D,A00,891266,Nichter; Simeon C,2,0,25,23
1746597761681,POLI 126,A00,891268,Nichter; Simeon C,7,0,25,18
1746597762706,POLI 126AA,A00,891272,Staff,15,0,25,10
1746597763731,POLI 130AA,A00,891273,Staff,15,0,20,5
1746597764759,POLI 134AA,A00,891274,Staff,4,0,20,16
1746597766812,POLI 138,A00,891278,Staff,21,0,25,4
1746597767838,POLI 142K,A00,891280,Staff,10,0,25,15
1746597768870,POLI 142M,A00,891281,Gartzke; Erik,16,0,30,14
1746597769895,POLI 142P,A00,891284,Staff,20,0,30,10
1746597770925,POLI 143,A00,891285,Gartzke; Erik,12,0,30,18
1746597771951,POLI 153,A00,891286,Staff,19,0,20,1
1746597774009,POLI 175,A00,891290,Staff,15,0,20,5
1746597775036,PSYC 1,A00,890674,Steiner; Eric Tomas,0,11,45,45
1746597776064,PSYC 2,A00,890676,Albright; Thomas D,20,0,35,15
1746597777093,PSYC 3,A00,890679,Staff,17,0,20,3
1746597778120,PSYC 6,A00,959858,Staff,19,0,20,1
1746597779154,PSYC 60,A01,890684,Rickard; Timothy C.,0,6,45,45
1746597780182,PSYC 70,A01,890689,Geller; Emma Harlan,6,0,30,24
1746597781208,PSYC 71,A01,959860,Staff,21,0,25,4
1746597782239,PSYC 100,A00,890690,Lacefield; Katharine I,0,50,180,180
1746597783265,PSYC 102,A00,890695,Staff,18,0,40,22
1746597784291,PSYC 105,A00,890699,Geller; Emma Harlan,70,0,100,30
1746597785318,PSYC 106,A00,890701,Gorman; Michael R.,5,0,30,25
1746597786342,PSYC 108,A00,890704,Adrian; Julia Anna,0,29,50,50
1746597787368,PSYC 118,A01,890712,Staff,11,0,30,19
1746597788393,PSYC 124,A00,890716,Chapman; Eddie Nathaniel,25,0,60,35
1746597789422,PSYC 131,A00,890717,Anagnostaras; Stephan,0,7,80,80
1746597790456,PSYC 137,A00,890719,Winkielman; Piotr,0,11,30,30
1746597791482,PSYC 144,A00,890721,Adrian; Julia Anna,0,9,45,45
1746597792509,PSYC 162,A00,890805,Staff,0,1,75,75
1746597793534,PSYC 169,A00,890810,Staff,0,15,30,30
1746597794560,PSYC 172,A00,890814,Gorman; Michael R.,9,0,30,21
1746597795584,PSYC 181,A00,890818,Anagnostaras; Stephan,7,0,200,193
1746597796613,PSYC 184,A00,959861,Staff,162,0,175,13
1746597797637,PSYC 189,A00,890823,Staff,0,2,30,30
1746597798665,PSYC 191,A00,890884,Rickard; Timothy C.,0,11,35,35
1746597799693,PSYC 193,A00,890913,Staff,19,0,30,11
1746597799693,PSYC 193,B00,890914,Chapman; Eddie Nathaniel,24,0,30,6
1746597800718,PSYC 193L,A01,890918,Lowe; Angela Beth,20,0,30,10
1746597800718,PSYC 193L,B01,890921,Hurwitz; Ethan Scott,20,0,30,10
1746597800718,PSYC 193L,C01,890928,Staff,30,0,30,0
1746597801743,RELI 149,A00,886806,Rahimi; Babak,23,0,40,17
1746597802771,SE 9,A01,886814,Staff,7,0,20,13
1746597803797,SE 101B,A01,886816,Chadha; Mayank,3,0,35,32
1746597804824,SE 110B,A00,886818,Zhu; Qiang,4,0,75,71
1746597805852,SE 125,A01,886830,Staff,10,0,30,20
1746597806877,SE 130B,A01,886835,Staff,14,0,40,26
1746597807940,SE 131A,A01,886838,Krysl; Petr,34,0,55,21
1746597808967,SE 154,A00,886840,Staff,28,0,50,22
1746597809995,SE 164GS,A01,886849,Staff,6,0,20,14
1746597811019,SE 167GS,A01,886853,Staff,6,0,20,14
1746597812047,SIO 25,A01,890107,Staff,19,0,30,11
1746597813074,SIO 45,A00,890109,Cook; Geoffrey W,116,0,200,84
1746597814101,SIO 109R,A00,890110,Forman; Fonna,0,16,20,20
1746597815125,SIO 187,A01,890114,Kacev; David,15,0,40,25
1746597816150,SOCI 1,A01,890431,Thorpe; Charles Robert,14,0,30,16
1746597816150,SOCI 1,A02,890518,Thorpe; Charles Robert,30,0,30,0
1746597817180,SOCI 2,A01,957978,Staff,25,0,25,0
1746597817180,SOCI 2,A02,957979,Staff,23,0,25,2
1746597818206,SOCI 20,A01,890523,Calderon-Zaks; Michael Aar,21,0,30,9
1746597818206,SOCI 20,A02,890526,Calderon-Zaks; Michael Aar,29,0,30,1
1746597819233,SOCI 30,A01,890533,Pardo Guerra; Juan Pablo,37,0,40,3
1746597820260,SOCI 40,A01,890535,Staff,27,0,45,18
1746597821287,SOCI 104Q,A00,890559,Staff,18,0,30,12
1746597822313,SOCI 106,A00,890560,Arnal; Maud Marie Leonie,20,0,30,10
1746597823341,SOCI 110,A00,890567,Holkenbrink-Monk; Charlene,19,0,30,11
1746597824367,SOCI 112,A00,890568,Victoria Torres; Pablo,2,0,55,53
1746597825392,SOCI 115,A00,890597,Arnal; Maud Marie Leonie,28,0,45,17
1746597827442,SOCI 121,A00,890604,Pardo Guerra; Juan Pablo,38,0,45,7
1746597828471,SOCI 126,A01,890608,Staff,8,0,10,2
1746597829498,SOCI 127,A00,890609,Staff,18,0,30,12
1746597830526,SOCI 131,A00,890610,Thorpe; Charles Robert,37,0,45,8
1746597831551,SOCI 135,A00,890615,Payne; Christine Anna,14,0,45,31
1746597832577,SOCI 139,A00,890620,Staff,38,0,45,7
1746597833605,SOCI 148E,A00,890622,Calderon-Zaks; Michael Aar,36,0,45,9
1746597834633,SOCI 150,A00,890623,Kohler; Kristopher M.,31,0,45,14
1746597835664,SOCI 157,A00,890625,Jules-Rosette; Bennetta W.,18,0,20,2
1746597836690,SOCI 160,A00,890627,Payne; Christine Anna,21,0,45,24
1746597837716,SYN 1,A00,886855,Fish; Gwendolyn Anne,0,1,0,0
1746597837716,SYN 1,B00,906086,Fish; Gwendolyn Anne,0,2,0,2
1746597838745,SYN 2R,A00,886860,Staff,0,17,15,15
1746597838745,SYN 2R,B00,906106,Atkinson; Arthur Laird,0,16,15,15
1746597839781,SYN 100,A01,886866,Browne; Emily,0,28,20,20
1746597839781,SYN 100,B01,906128,Rock; Martin,0,4,20,20
1746597839781,SYN 100,C01,906140,Deavenport; James Cary,0,4,20,20
1746597839781,SYN 100,D01,907816,Deavenport; James Cary,0,5,20,20
1746597840824,TDAC 1,A00,890286,Walsh; Kim C.,7,0,20,13
1746597841849,TDAC 101,A00,890296,Basso; Beatrice,15,0,20,5
1746597842873,TDDE 131,A00,890297,Staff,47,0,50,3
1746597843898,TDDM 1,A00,890287,Weinberg; Sadie,25,0,30,5
1746597844924,TDGE 11,A00,890288,Fulton; Julia,138,0,200,62
1746597844924,TDGE 11,B00,890289,Castro; Robert Jess,184,0,200,16
1746597845949,TDGE 25,B00,957359,Walsh; Kim C.,5,0,20,15
1746597846974,TDGE 40,A01,890292,Power; Jade Yukana,26,0,30,4
1746597848003,TDGE 124,A00,890298,Havis; Allan,0,2,50,50
1746597849032,TDGE 131R,A00,890299,Burelle; Julie Sara Veronique,15,0,42,27
1746597850058,TDHT 101,A00,890300,Staff,10,0,20,10
1746597851087,TDHT 109,A01,890302,Anderson; Mysia Anyse,31,0,40,9
1746597852117,TDMV 1,A00,890293,Arcidiacono; Kristin,18,0,30,12
1746597853147,TDMV 2,A00,890294,Weinberg; Sadie,23,0,30,7
1746597854172,TDMV 3,A00,957878,Arcidiacono; Kristin,28,0,30,2
1746597856223,TDMV 138,A00,890304,Jun; Grace Shin Hae,25,0,40,15
1746597857251,TDMV 140,A00,890305,Corrales; Joseph Bernales,25,0,30,5
1746597858278,TDMV 142,A00,890307,Caligagan; Tony,32,0,40,8
1746597859307,TDMV 144,A00,890308,Camaya; Michelle Ann,25,0,30,5
1746597860332,TDPW 1,A00,890295,Stein; Deborah Isobel,3,0,20,17
1746597861357,USP 2,A01,890272,Lerner; Amy M,7,0,20,13
1746597862382,USP 3,A01,890274,Staff,12,0,30,18
1746597863410,USP 15,A01,890276,Sun; Feiyang,16,0,30,14
1746597864434,USP 25,A00,890277,Shenkman; Michael Thomas,18,0,25,7
1746597865458,USP 138,A00,890278,Staff,13,0,25,12
1746597866484,USP 143,A00,890279,Staff,21,0,70,49
1746597867510,USP 144,A00,890280,Chowdhury; Muhammed Zohir,16,0,30,14
1746597868535,USP 150,A00,890281,Boomhower; Matthew Charles,4,0,30,26
1746597869559,USP 151,A00,890282,Staff,16,0,20,4
1746597870588,USP 162,A00,890283,Andrews; Abigail Leslie,16,0,20,4
1746597871612,USP 168,A00,920477,Kwak; Nancy,0,0,5,5
1746597872640,USP 181,A00,890284,Staff,3,0,20,17
1746597873667,USP 191A,A00,890285,Staff,12,0,20,8
1746597874692,VIS 101,A00,886512,Staff,26,0,75,49
1746597875719,VIS 103,A00,886513,Cruz; Edwin Teddy,61,0,75,14
1746597876744,VIS 108,A00,886514,Staff,4,0,15,11
1746597877788,VIS 127P,A00,886515,Shen; Kuiyi,80,0,146,66
1746597878813,VIS 149,A00,886516,Yoldas; Pinar,0,0,15,15
1746597879842,VIS 164,A00,886526,Erdmann; Dean,19,0,22,3
1746597880867,VIS 194S,A00,886527,Staff,61,0,75,14
1746597881897,WCWP 10A,C00,886484,Martiniuk; Jill,12,0,15,3
1746597882923,WCWP 10B,A00,886490,Uriarte; Emma,0,0,15,15
1746597882923,WCWP 10B,B00,886491,Dhir; Simrita,8,0,15,7
1746597882923,WCWP 10B,C00,886492,Ornelas; Tricia,0,0,15,15
1746597883948,WCWP 100,A00,886494,Young; Mark T,0,6,15,15
1746597886122,AAS 10,A01,886199,Childs; Dennis R.,0,3,0,0
1746597887148,ANAR 104,A01,886940,Shtienberg; Gilad,27,0,30,3
1746597888175,ANAR 120,A00,886953,Staff,13,0,20,7
1746597889202,ANBI 148,A01,886955,Wilder; Linnea Lorene,30,0,40,10
1746597891256,ANSC 122,A00,886957,Staff,24,0,30,6
1746597892282,ANSC 150,A00,886958,Sloane; Julia Kathryn,2,0,15,13
1746597893307,ANSC 156,A00,886959,Jenkins; Janis A.,0,1,15,15
1746597894340,ANSC 180,A00,886960,Staff,11,0,17,6
1746597895367,ANSC 188,A00,886961,Jassal; Aftab,9,0,25,16
1746597896392,ANSC 190,A00,886962,Jassal; Aftab,14,0,25,11
1746597897418,ANSC 191,A00,886963,Staff,18,0,20,2
1746597898441,ANTH 3,A01,891689,Staff,17,0,20,3
1746597899469,ANTH 5,A00,886933,Semendeferi; Ekaterini,16,0,20,4
1746597900498,ANTH 10,A00,886934,Staff,0,12,30,30
1746597901526,ANTH 21,A01,886936,Staff,41,0,60,19
1746597902552,ANTH 23,A01,886938,Staff,92,0,100,8
1746597903582,ANTH 105,A00,886964,Stewart; Alexander B,84,0,100,16
1746597904607,ANTH 108,A00,886965,Pedersen; David,9,0,20,11
1746597905644,AWP 10,001,886147,Staff,0,0,0,0
1746597905644,AWP 10,002,886148,Staff,0,0,0,0
1746597905644,AWP 10,003,886149,Staff,0,0,0,0
1746597905644,AWP 10,004,886150,Staff,0,0,0,0
1746597905644,AWP 10,005,886151,Staff,0,0,0,0
1746597905644,AWP 10,006,886152,Staff,0,0,0,0
1746597905644,AWP 10,007,886153,Staff,0,0,0,0
1746597905644,AWP 10,008,886154,Staff,0,0,0,0
1746597905644,AWP 10,009,886155,Staff,0,0,0,0
1746597905644,AWP 10,010,886156,Staff,0,0,0,0
1746597905644,AWP 10,011,886158,Staff,0,0,0,0
1746597905644,AWP 10,012,886160,Staff,0,0,0,0
1746597905644,AWP 10,013,886161,Staff,0,0,0,0
1746597905644,AWP 10,014,886162,Staff,0,0,0,0
1746597905644,AWP 10,015,886163,Staff,0,0,0,0
1746597905644,AWP 10,016,886164,Staff,0,0,0,0
1746597905644,AWP 10,017,886165,Staff,0,0,0,0
1746597905644,AWP 10,018,886166,Staff,0,0,0,0
1746597905644,AWP 10,019,886168,Staff,0,0,0,0
1746597905644,AWP 10,020,886170,Staff,0,0,0,0
1746597905644,AWP 10,021,886172,Staff,0,0,0,0
1746597906674,AWP 10R,001,886173,Staff,0,1,0,0
1746597906674,AWP 10R,002,886174,Staff,0,1,0,0
1746597906674,AWP 10R,003,886175,Staff,0,0,0,0
1746597906674,AWP 10R,004,886176,Staff,0,0,0,0
1746597906674,AWP 10R,005,886177,Staff,0,0,0,0
1746597906674,AWP 10R,006,886178,Staff,0,0,0,0
1746597906674,AWP 10R,007,886179,Staff,0,0,0,0
1746597906674,AWP 10R,008,886181,Staff,0,0,0,0
1746597906674,AWP 10R,009,886182,Staff,0,0,0,0
1746597906674,AWP 10R,010,886183,Staff,0,0,0,0
1746597906674,AWP 10R,011,886184,Staff,0,0,0,0
1746597906674,AWP 10R,012,886185,Staff,0,0,0,0
1746597906674,AWP 10R,013,886186,Staff,0,0,0,0
1746597906674,AWP 10R,014,886187,Staff,0,0,0,0
1746597906674,AWP 10R,015,886188,Staff,0,0,0,0
1746597906674,AWP 10R,016,886189,Staff,0,0,0,0
1746597906674,AWP 10R,017,960532,Staff,0,0,0,0
1746597906674,AWP 10R,018,960533,Staff,0,0,0,0
1746597906674,AWP 10R,019,960534,Staff,0,0,0,0
1746597906674,AWP 10R,020,960538,Staff,0,0,0,0
1746597906674,AWP 10R,021,960540,Staff,0,0,0,0
1746597906674,AWP 10R,022,960541,Staff,0,0,0,0
1746597906674,AWP 10R,023,960542,Staff,0,0,0,0
1746597906674,AWP 10R,024,960544,Staff,0,0,0,0
1746597906674,AWP 10R,025,960545,Staff,0,0,0,0
1746597906674,AWP 10R,026,960548,Staff,0,0,0,0
1746597907700,AWP 102R,A00,886190,Staff,0,0,0,0
1746597907700,AWP 102R,B00,886191,Staff,0,0,0,0
1746597908730,BENG 100,A01,886193,Staff,17,0,30,13
1746597909756,BENG 122A,A01,886195,Hasty; Jeff M,13,0,30,17
1746597910782,BENG 166A,A00,886196,Sah; Robert Lie-Yuan,0,3,30,30
1746597911811,BENG 190,A00,958050,Khojah; Reem I,17,0,25,8
1746597912841,BIBC 102,A01,894320,Staff,0,1,46,46
1746597912841,BIBC 102,A02,894321,Staff,0,0,46,46
1746597912841,BIBC 102,A03,894344,Staff,6,0,46,40
1746597912841,BIBC 102,A04,894345,Staff,27,0,47,20
1746597913874,BICD 100R,A01,894365,Smith; Laurie,0,2,58,58
1746597913874,BICD 100R,A02,894366,Smith; Laurie,0,4,58,58
1746597913874,BICD 100R,A03,894367,Smith; Laurie,0,0,59,59
1746597913874,BICD 100R,A04,959869,Smith; Laurie,38,0,59,21
1746597914944,BICD 136,A01,894383,Gustafson-Brown; Cindy,14,0,50,36
1746597915970,BIEB 102,A01,894494,Butler; Shannon Rhey,51,0,130,79
1746597918029,BIEB 150,A01,894617,Wills; Christopher,3,0,20,17
1746597918029,BIEB 150,A02,894631,Wills; Christopher,3,0,20,17
1746597918029,BIEB 150,A03,894937,Wills; Christopher,3,0,20,17
1746597918029,BIEB 150,A04,894946,Wills; Christopher,5,0,20,15
1746597919057,BIEB 194,A00,906141,Kurle; Carolyn M.,5,0,20,15
1746597920089,BILD 1,A01,894154,Staff,3,0,19,16
1746597920089,BILD 1,A02,894155,Staff,14,0,19,5
1746597920089,BILD 1,A03,894160,Staff,13,0,19,6
1746597920089,BILD 1,A04,894161,Staff,15,0,18,3
1746597921118,BILD 2,A01,894168,Staff,0,0,50,50
1746597921118,BILD 2,A02,894169,Staff,0,0,50,50
1746597921118,BILD 2,A03,894179,Staff,0,0,50,50
1746597921118,BILD 2,A04,894203,Staff,22,0,50,28
1746597922143,BILD 3,A01,894213,Staff,23,0,31,8
1746597922143,BILD 3,A02,894214,Staff,26,0,31,5
1746597922143,BILD 3,A03,894235,Staff,28,0,31,3
1746597922143,BILD 3,A04,894236,Staff,28,0,32,4
1746597923173,BILD 4,A01,894253,Reuther; Keefe,5,0,24,19
1746597923173,BILD 4,A02,894258,Reuther; Keefe,16,0,24,8
1746597924199,BILD 5,A01,894276,Reuther; Keefe,34,0,50,16
1746597924199,BILD 5,A02,894277,Reuther; Keefe,45,0,50,5
1746597924199,BILD 5,A03,894290,Reuther; Keefe,44,0,50,6
1746597924199,BILD 5,A04,894291,Reuther; Keefe,48,0,50,2
1746597925224,BILD 24,A01,894297,Pirino; Giorgia,40,0,60,20
1746597926255,BIMM 100,B01,958915,Staff,71,0,100,29
1746597927287,BIMM 101,A01,895017,McDonnell; Lisa Marie,0,5,24,24
1746597927287,BIMM 101,A02,895018,McDonnell; Lisa Marie,0,5,24,24
1746597927287,BIMM 101,B01,895020,McDonnell; Lisa Marie,0,5,24,24
1746597927287,BIMM 101,B02,895021,McDonnell; Lisa Marie,0,4,24,24
1746597928311,BIMM 110,A01,895023,Staff,1,0,25,24
1746597928311,BIMM 110,A02,895024,Staff,9,0,25,16
1746597928311,BIMM 110,A03,895025,Staff,18,0,25,7
1746597928311,BIMM 110,A04,895031,Staff,20,0,25,5
1746597929338,BIMM 120,A01,895114,Gustafson-Brown; Cindy,14,0,28,14
1746597929338,BIMM 120,A02,895126,Gustafson-Brown; Cindy,21,0,27,6
1746597930364,BIPN 100,A01,895130,Yang; Mingyu,0,0,38,38
1746597930364,BIPN 100,A02,895131,Yang; Mingyu,31,0,38,7
1746597930364,BIPN 100,A03,895132,Yang; Mingyu,32,0,38,6
1746597930364,BIPN 100,A04,895133,Yang; Mingyu,27,0,36,9
1746597931388,BIPN 120,A01,895135,Cooke; James Edward,0,3,13,13
1746597931388,BIPN 120,A02,895136,Cooke; James Edward,0,1,13,13
1746597931388,BIPN 120,A03,895137,Cooke; James Edward,0,3,13,13
1746597931388,BIPN 120,A04,895156,Cooke; James Edward,0,2,11,11
1746597932422,BIPN 134,A01,895235,Cooke; James Edward,0,1,25,25
1746597932422,BIPN 134,A02,895237,Cooke; James Edward,0,0,25,25
1746597932422,BIPN 134,A03,895240,Cooke; James Edward,1,0,25,24
1746597932422,BIPN 134,A04,895270,Cooke; James Edward,20,0,25,5
1746597933446,BIPN 189,A00,892103,Staff,0,14,14,14
1746597935499,BISP 194,A00,958008,Staff,0,2,0,0
1746597936531,CAT 124,A01,922009,Staff,0,5,20,20
1746597937558,CAT 125R,A00,886390,Morales; Celeste Georgianna,0,3,20,20
1746597937558,CAT 125R,B00,886391,Irwin; Matthew Joseph,0,4,20,20
1746597937558,CAT 125R,C00,886392,Smith; Lauryn Alissa,0,2,20,20
1746597937558,CAT 125R,D00,886393,Vanderschuit; Maya Alysia,0,3,20,20
1746597937558,CAT 125R,E00,886394,Marchisotto; Jennifer Anne,0,3,20,20
1746597938590,CENG 15,A01,886218,Drews; Aaron,3,0,8,5
1746597939615,CENG 113,A00,886219,Opatkiewicz; Justin Paul,15,0,25,10
1746597940643,CGS 101,A00,887044,Staff,7,0,20,13
1746597941667,CGS 105,A01,887046,Staff,14,0,25,11
1746597942694,CGS 112,A00,887047,Cuong; Marisol,12,0,15,3
1746597943720,CGS 113,A00,887048,Staff,23,0,30,7
1746597944748,CGS 120,A00,887049,Staff,10,0,17,7
1746597945775,CHEM 6A,A01,886336,Lam; Tin Yiu,38,0,50,12
1746597945775,CHEM 6A,A02,886338,Lam; Tin Yiu,37,0,50,13
1746597946805,CHEM 6B,A01,886341,Hopkins; Patrycja Anna,16,0,50,34
1746597946805,CHEM 6B,A02,886343,Hopkins; Patrycja Anna,42,0,50,8
1746597947830,CHEM 6C,A01,886346,Albizati; Kim F.,0,2,50,50
1746597947830,CHEM 6C,A02,886348,Albizati; Kim F.,24,0,50,26
1746597948916,CHEM 40A,A01,886352,Klosterman; Jeremy K,65,0,100,35
1746597949943,CHEM 40B,A01,886356,Klosterman; Jeremy K,0,24,100,100
1746597950973,CHEM 41B,A01,886360,Theodorakis; Emmanuel,25,0,50,25
1746597950973,CHEM 41B,A02,886362,Theodorakis; Emmanuel,47,0,50,3
1746597951999,CHIN 165A,A00,886382,Xu; Li,18,0,20,2
1746597953026,CLAS 120,A00,886387,Myerston Santana; Jacobo,33,0,40,7
1746597954052,COGS 9,A01,886967,Shannon; Kyle Michael,42,0,60,18
1746597955079,COGS 11,A01,886969,Staff,9,0,30,21
1746597956104,COGS 14A,A01,886971,Staff,5,0,60,55
1746597957135,COGS 14B,A01,886973,Hoffman; Drew Ellen,4,0,60,56
1746597958166,COGS 18,A01,886975,Morgan; Eric,34,0,60,26
1746597959193,COGS 20,A01,886977,Staff,3,0,8,5
1746597959193,COGS 20,A02,886978,Staff,5,0,7,2
1746597960226,COGS 100,A01,907783,Staff,0,1,30,30
1746597961251,COGS 101B,A01,886980,Staff,0,4,48,48
1746597962277,COGS 101C,A01,886982,Delgado; Tania,0,5,44,44
1746597963308,COGS 102A,A01,886984,Johnson; Christine M.,3,0,30,27
1746597964332,COGS 118B,A01,886986,Staff,0,4,88,88
1746597965361,COGS 150,A01,886988,Bergen; Benjamin,22,0,50,28
1746597966391,COGS 153,A00,886989,Delgado; Tania,0,3,41,41
1746597967416,COGS 186,A01,886991,Staff,0,0,32,32
1746597968448,COGS 187A,A01,886993,Boyle; Mary E. T.,7,0,30,23
1746597969474,COGS 189,A00,886994,Staff,0,1,30,30
1746597970505,COMM 10,A01,886996,Staff,0,0,20,21
1746597970505,COMM 10,A02,886997,Staff,10,0,20,10
1746597970505,COMM 10,A03,959845,Staff,19,0,20,1
1746597971531,COMM 20,A01,886999,Leuning; Grant Maurstad,24,0,40,16
1746597973580,COMM 100A,A01,887002,Staff,0,0,20,25
1746597973580,COMM 100A,A02,887003,Staff,5,0,20,15
1746597974621,COMM 100B,A01,887005,Staff,0,8,20,24
1746597975648,COMM 106D,A00,887006,Staff,14,0,40,26
1746597976675,COMM 110G,A00,887007,Whitworth-Smith; Andrew C,12,0,40,28
1746597977704,COMM 111B,A00,887008,Staff,31,0,40,9
1746597978729,COMM 113T,A00,887009,Abuelhiga; Soraya Jill,28,0,40,12
1746597978729,COMM 113T,B00,906733,Staff,39,0,40,1
1746597979756,COMM 145,A00,887010,Staff,13,0,40,27
1746597980781,COMM 146,A00,887054,Staff,32,0,40,8
1746597981807,COMM 190,A00,887012,Staff,8,0,23,15
1746597982838,CSE 8A,A50,887015,Cao; Yingjun,56,0,85,29
1746597983866,CSE 11,A01,887017,Cao; Yingjun,11,0,70,59
1746597984895,CSE 20,A01,887019,Staff,30,0,50,20
1746597985931,CSE 21,A01,887021,Staff,79,0,100,21
1746597985931,CSE 21,B01,892583,Braun; Oliver,45,0,50,5
1746597986962,CSE 30,A01,887025,Eldon; John,142,0,200,58
1746597987992,CSE 100,A01,887027,Staff,26,0,50,24
1746597987992,CSE 100,A02,887028,Staff,42,0,50,8
1746597989016,CSE 101,A01,887030,Braun; Oliver,74,0,100,26
1746597989016,CSE 101,B01,887032,Jones; Miles E,0,3,50,50
1746597989016,CSE 101,B02,887033,Jones; Miles E,0,2,50,50
1746597990042,CSE 105,A01,908084,Jones; Miles E,32,0,50,18
1746597990042,CSE 105,A02,908087,Jones; Miles E,31,0,50,19
1746597991072,CSE 135,A01,887035,Powell; Thomas Allan,0,5,50,50
1746597992100,CSE 142,A01,887037,Staff,8,0,60,52
1746597993131,CSE 142L,A01,887039,Staff,34,0,60,26
1746597994160,CSE 151A,A01,887041,Solares; Edwin A,47,0,100,53
1746597995187,CSE 175,A01,887043,Kumar; Rakesh,30,0,30,0
1746597996212,CSS 1,A01,886389,Staff,0,1,40,40
1746597997238,DSC 30,A01,908097,Liao; Soohyun Nam,47,0,75,28
1746597998265,DSC 40A,A01,908099,Shannon; Kyle Michael,30,0,50,20
1746597999290,DSC 40B,A01,908112,Staff,15,0,50,35
1746598000318,DSC 80,A01,908116,Staff,19,0,60,41
1746598001350,DSC 197,001,956863,Eldridge; Justin Matthew,9999,0,9999,0
1746598002375,ECE 5,A01,886400,Morris; Karcher William,1,0,6,5
1746598002375,ECE 5,A02,886401,Morris; Karcher William,3,0,6,3
1746598003405,ECE 148,A01,886403,Silberman; Jack,0,14,14,14
1746598004432,ECON 1,A01,887265,Crane; Meredith Helen,11,0,70,59
1746598004432,ECON 1,B01,887268,Staff,42,0,50,8
1746598005460,ECON 2,A01,887273,Crane; Meredith Helen,54,0,70,16
1746598006490,ECON 3,A01,887279,Rondina; Giacomo,31,0,70,39
1746598007518,ECON 4,A01,887282,Anderson; John Charles,0,2,10,10
1746598008545,ECON 5,A01,887285,Staff,34,0,45,11
1746598008545,ECON 5,B01,887292,Staff,41,0,45,4
1746598009577,ECON 100A,A01,887337,Newhouse; Herbert S,54,0,70,16
1746598009577,ECON 100A,B01,887349,Staff,45,0,50,5
1746598010604,ECON 100B,A01,887361,Du; Songzi,29,0,70,41
1746598011629,ECON 100C,A01,887445,Newhouse; Herbert S,59,0,70,11
1746598012657,ECON 105,A00,887488,Vespa; Emanuel Ignacio,23,0,35,12
1746598013684,ECON 109,A01,887506,Shishkin; Denis,28,0,35,7
1746598014712,ECON 110A,A01,887568,Alon; Titan Michael,0,2,35,35
1746598014712,ECON 110A,B01,907601,Alon; Titan Michael,20,0,35,15
1746598015743,ECON 110B,A01,887598,Levkoff; Steven B.,0,24,70,70
1746598016770,ECON 112,A00,887599,Rondina; Giacomo,19,0,35,16
1746598017796,ECON 120A,A01,887603,Dai; Yinlin,35,0,70,35
1746598018870,ECON 120C,A01,887608,Sun; Yixiao,0,1,35,35
1746598018870,ECON 120C,B01,887614,Sun; Yixiao,0,0,35,35
1746598019896,ECON 138,A00,887621,Bharadwaj; Prashant,0,21,20,20
1746598020921,ECON 144,A00,958007,Squires; Dale E,12,0,35,23
1746598021950,ECON 171,A01,907666,Staff,18,0,35,17
1746598022976,ECON 175,A00,887626,Wu; Pak Yeung,22,0,35,13
1746598024003,ECON 190,A00,887640,Vespa; Emanuel Ignacio,22,0,35,13
1746598025039,EDS 25,A01,888197,Staff,0,0,0,0
1746598025039,EDS 25,A02,888209,Staff,0,0,0,0
1746598025039,EDS 25,A03,888210,Staff,0,0,0,0
1746598025039,EDS 25,A04,888212,Staff,0,0,0,0
1746598025039,EDS 25,A05,888213,Staff,0,0,0,0
1746598025039,EDS 25,A06,888214,Staff,0,0,0,0
1746598025039,EDS 25,A07,888235,Staff,0,2,0,0
1746598025039,EDS 25,A08,888236,Staff,0,0,0,0
1746598025039,EDS 25,A09,888240,Staff,0,0,0,0
1746598025039,EDS 25,A10,888244,Staff,0,0,0,0
1746598025039,EDS 25,B01,888273,Staff,0,0,0,0
1746598025039,EDS 25,B02,888285,Staff,0,0,0,0
1746598025039,EDS 25,B03,888423,Staff,0,0,0,1
1746598025039,EDS 25,B04,888432,Staff,0,0,0,0
1746598025039,EDS 25,B05,888433,Staff,0,0,0,0
1746598025039,EDS 25,B06,888467,Staff,0,0,0,0
1746598025039,EDS 25,B07,888468,Staff,0,0,0,0
1746598025039,EDS 25,B08,888479,Staff,0,0,0,0
1746598025039,EDS 25,B09,888484,Staff,0,0,0,0
1746598025039,EDS 25,B10,888487,Staff,0,0,0,0
1746598026066,EDS 38,A01,907700,Choi; Bailey Miyeon,30,0,30,0
1746598027091,EDS 112,A01,888601,Chapman; Thandeka K,12,0,40,28
1746598028119,EDS 115,A00,888697,Mendez; Kathrina Mendoza,10,0,30,20
1746598029147,EDS 116,A01,888893,Staff,33,0,40,7
1746598031199,EDS 124AR,A00,889133,Staff,29,0,50,21
1746598031199,EDS 124AR,B00,907471,Simon; Elizabeth A,37,0,50,13
1746598032223,EDS 124BR,A00,889134,Simon; Elizabeth A,44,0,100,56
1746598033251,EDS 125,A00,889135,Staff,25,0,30,5
1746598034277,EDS 126,A01,889138,Staff,35,0,40,5
1746598035303,EDS 164R,A01,889142,Wishard Guerra; Alison G.,32,0,50,18
1746598036330,ENG 30,A01,886396,Staff,0,0,0,0
1746598036330,ENG 30,B01,886398,Staff,0,0,0,0
1746598037360,ENVR 102,A00,906150,Montejo; Carolina,23,0,25,2
1746598038387,ETHN 103A,A00,887236,Man; Simeon S,0,2,0,0
1746598039412,ETHN 113,A00,887239,Staff,16,0,30,14
1746598040443,ETHN 116,A00,887240,Staff,16,0,25,9
1746598041470,ETHN 117,A00,887241,Choi; Esther Min,28,0,30,2
1746598042498,ETHN 118,A00,887243,Staff,24,0,30,6
1746598043525,ETHN 127,A00,887248,Cuong; Marisol,11,0,15,4
1746598044552,ETHN 139,A00,887250,Staff,7,0,10,3
1746598045579,ETHN 142,A00,887252,Staff,10,0,30,20
1746598046604,ETHN 161,A00,887253,Browne; Errol Tsekani,24,0,30,6
1746598047629,ETHN 163FR,A00,887255,Burelle; Julie Sara Veronique,0,0,5,5
1746598048657,GLBH 20,A00,889149,Elwardani; Nile Regina,8,0,42,34
1746598050709,GLBH 111,A01,889152,Burgos; Jose L.,17,0,17,0
1746598051739,GLBH 150,A00,889181,Sloane; Julia Kathryn,0,5,15,15
1746598053796,HDS 60,A01,886406,Warstadt; Melissa Fawn,72,0,80,8
1746598054821,HIAF 111,A00,889324,Gyamfi; Bright,25,0,32,7
1746598055849,HIEA 131,A00,889328,Staff,15,0,32,17
1746598056888,HIEA 144,A00,889333,Henry; Todd A.,26,0,32,6
1746598057919,HIEA 154,A00,889336,Henry; Todd A.,24,0,32,8
1746598058946,HIEU 106,A00,889339,Staff,22,0,32,10
1746598061005,HIEU 114,A00,889340,Staff,4,0,32,28
1746598062038,HIEU 135GS,A00,889342,Patterson; Patrick H.,0,0,1,24
1746598063063,HIEU 137,A00,889343,Edington; Claire Ellen,10,0,25,15
1746598064089,HIEU 148,A00,889345,Staff,14,0,32,18
1746598065117,HIEU 154,A00,889346,Biess; Frank Peter,21,0,32,11
1746598066151,HILA 102,A00,889351,Staff,12,0,32,20
1746598067184,HILD 2A,A01,889221,Lewandoski; Julia Mavis,0,8,32,32
1746598068211,HILD 7B,A01,889225,Man; Simeon S,0,12,32,32
1746598069238,HILD 7C,A01,889288,Alvarez; Luis A,0,14,32,32
1746598070263,HILD 30,A01,889323,Staff,0,5,32,32
1746598072314,HISC 119,A00,889383,Golan; Tal,20,0,32,12
1746598073342,HIUS 103,A00,889384,Man; Simeon S,0,0,32,32
1746598074366,HIUS 117,A00,919797,Kwak; Nancy,18,0,32,14
1746598075393,HIUS 142A,A00,919788,Staff,22,0,32,10
1746598077450,HIUS 149,A00,889386,Gyamfi; Bright,26,0,32,6
1746598078480,HIUS 155,A00,889387,Alvarez; Luis A,15,0,32,17
1746598079515,HUM 3,A01,886499,Caldwell; Michael Alan,19,0,50,31
1746598080545,HUM 3GS,A00,886500,Rodriguez; Bretton Sigfred,0,0,0,28
1746598081570,HUM 3R,A01,886502,Markman; Kristina,0,36,50,50
1746598082598,HUM 4,A01,886504,Crum; Matthew Stephen,23,0,50,27
1746598082598,HUM 4,B01,886506,West; Geoffrey Scott,17,0,50,33
1746598083630,HUM 4GS,A00,886507,Staff,0,0,0,19
1746598084657,HUM 5,A01,886509,Staff,31,0,50,19
1746598085682,HUM 5R,A01,886511,Zavodny; Tatiana Sophia,0,39,50,50
1746598086708,JAPN 180,A00,886407,Staff,16,0,40,24
1746598087739,LATI 50,A01,886409,Martin-Cabrera; Luis,3,0,22,19
1746598087739,LATI 50,A02,886410,Martin-Cabrera; Luis,19,0,22,3
1746598087739,LATI 50,A03,886411,Martin-Cabrera; Luis,21,0,22,1
1746598087739,LATI 50,A04,886412,Martin-Cabrera; Luis,8,0,22,14
1746598088771,LAWS 101,A00,907664,Staff,28,0,60,32
1746598089796,LIAB 1A,A00,889388,Saab; Dima,17,0,20,3
1746598090832,LIAB 1AX,A00,889389,El Cheddadi; Youniss,18,0,20,2
1746598091860,LIFR 1C,A00,889391,Van Moer; Vinciane G,8,0,20,12
1746598092889,LIFR 1CX,A00,889392,Van Moer; Vinciane G,7,0,20,13
1746598093915,LIFR 1D,A00,889393,Van Moer; Vinciane G,7,0,20,13
1746598094944,LIFR 1DX,A00,889394,Van Moer; Vinciane G,8,0,20,12
1746598095973,LIGN 7,A00,886923,Staff,25,0,50,25
1746598097005,LIGN 17,A00,886924,Kehler; Andrew Scott,126,0,150,24
1746598098034,LTAM 110,A00,889395,Staff,15,0,30,15
1746598099060,LTAM 110GS,A00,958010,Rodriguez; Bretton Sigfred,0,0,0,28
1746598100091,LTCH 101,A00,889397,Staff,23,0,25,2
1746598101116,LTCS 130,A00,889398,Staff,23,0,25,2
1746598102196,LTEA 138,A00,889399,Staff,24,0,40,16
1746598103223,LTEN 149,A00,889400,Wesling; Megan E.,0,3,25,25
1746598104253,LTEN 169,A00,889401,Staff,20,0,25,5
1746598105279,LTEN 180,A00,889402,Staff,10,0,15,5
1746598106304,LTEN 181,A00,889403,Staff,21,0,25,4
1746598107329,LTWL 100,A00,889404,Myerston Santana; Jacobo,2,0,25,23
1746598108356,LTWL 180GS,A00,889405,Staff,0,0,20,20
1746598109381,LTWL 181,A00,889406,Staff,16,0,25,9
1746598110407,LTWL 184,A00,889475,Mukherjee; Silpa,22,0,25,3
1746598111434,LTWR 102C,A00,889486,Staff,29,0,30,1
1746598112461,LTWR 115W,A00,889491,Staff,0,2,15,15
1746598113486,MAE 8,A01,886905,Staff,0,2,0,0
1746598114511,MAE 11,A00,886906,Bandaru; Prabhakar,0,7,50,50
1746598115538,MAE 20,A00,886907,Evdokimenko; Ekaterina,43,0,70,27
1746598116563,MAE 30B,A00,886909,Ghazinejad; Maziar,25,0,45,20
1746598117591,MAE 101B,A00,886910,Saintillan; David,30,0,45,15
1746598118619,MAE 105,A00,886911,Bandaru; Prabhakar,18,0,50,32
1746598119650,MAE 107,B00,958024,Staff,7,0,50,43
1746598120680,MAE 143B,A00,886913,Bewley; Thomas R,2,0,40,38
1746598121706,MAE 148,A01,886915,Silberman; Jack,0,3,14,14
1746598122732,MAE 160,A00,886916,Evdokimenko; Ekaterina,30,0,60,30
1746598123801,MATH 3C,A01,889681,Staff,0,2,30,30
1746598123801,MATH 3C,A02,960048,Staff,23,0,30,7
1746598124830,MATH 10A,A01,889760,Staff,26,0,30,4
1746598124830,MATH 10A,A02,889783,Staff,29,0,30,1
1746598125862,MATH 10B,A01,889785,Verstraete; Jacques Allan,1,0,35,34
1746598125862,MATH 10B,A02,889795,Verstraete; Jacques Allan,4,0,35,31
1746598125862,MATH 10B,B01,889797,Verstraete; Jacques Allan,3,0,35,32
1746598125862,MATH 10B,B02,889828,Verstraete; Jacques Allan,3,0,35,32
1746598126896,MATH 10C,A01,889849,Habib; Yousaf,8,0,30,22
1746598126896,MATH 10C,A02,889852,Habib; Yousaf,14,0,30,16
1746598126896,MATH 10C,A03,889853,Habib; Yousaf,22,0,30,8
1746598126896,MATH 10C,A04,889858,Habib; Yousaf,20,0,30,10
1746598126896,MATH 10C,B01,889861,Staff,1,0,30,29
1746598126896,MATH 10C,B02,889862,Staff,24,0,30,6
1746598126896,MATH 10C,B03,889863,Staff,27,0,30,3
1746598126896,MATH 10C,B04,889967,Staff,23,0,30,7
1746598127927,MATH 18,A01,889974,Staff,7,0,30,23
1746598127927,MATH 18,A02,889977,Staff,20,0,30,10
1746598127927,MATH 18,B01,889984,Hardiman; Liam,20,0,30,10
1746598127927,MATH 18,B02,889985,Hardiman; Liam,25,0,30,5
1746598128953,MATH 20A,A01,889990,Suk; Andrew Hoon,30,0,35,5
1746598129985,MATH 20B,A01,889993,Ohm; Ko Woon,21,0,30,9
1746598129985,MATH 20B,A02,889994,Ohm; Ko Woon,30,0,30,0
1746598129985,MATH 20B,B01,889996,Ohm; Ko Woon,22,0,30,8
1746598129985,MATH 20B,B02,889997,Ohm; Ko Woon,23,0,30,7
1746598131011,MATH 20C,A01,889999,Hammock; Frances H,17,0,30,13
1746598131011,MATH 20C,A02,890003,Hammock; Frances H,23,0,30,7
1746598131011,MATH 20C,B01,890006,Hammock; Frances H,2,0,30,28
1746598131011,MATH 20C,B02,890007,Hammock; Frances H,12,0,30,18
1746598132037,MATH 20D,A01,890011,Cheng; Hsiao-Bing,0,0,30,30
1746598132037,MATH 20D,A02,890012,Cheng; Hsiao-Bing,14,0,30,16
1746598132037,MATH 20D,B01,890016,Cheng; Hsiao-Bing,13,0,30,17
1746598132037,MATH 20D,B02,890017,Cheng; Hsiao-Bing,13,0,30,17
1746598133063,MATH 20E,A01,890026,Harel; Guershon,1,0,30,29
1746598133063,MATH 20E,A02,890029,Harel; Guershon,22,0,30,8
1746598133063,MATH 20E,B01,890033,Harel; Guershon,7,0,30,23
1746598133063,MATH 20E,B02,890101,Harel; Guershon,21,0,30,9
1746598134089,MATH 102,A01,890104,Staff,18,0,30,12
1746598134089,MATH 102,A02,890105,Staff,27,0,30,3
1746598135115,MATH 103B,A01,890116,Salehi Golsefidy; Alireza,3,0,30,27
1746598135115,MATH 103B,B01,890118,Staff,0,3,34,34
1746598136142,MATH 109,A01,890121,Aliabadi Sr.; Mohsen,0,0,30,30
1746598136142,MATH 109,B01,890124,Upadrashta; Pranav Kumar,18,0,30,12
1746598137168,MATH 120A,A01,890126,Eggers; John Dietrich,13,0,30,17
1746598138197,MATH 142B,A01,890128,Ioana; Adrian,19,0,30,11
1746598138197,MATH 142B,A02,890129,Ioana; Adrian,12,0,30,18
1746598139225,MATH 154,A01,890174,Staff,0,1,30,30
1746598139225,MATH 154,A02,890182,Staff,0,0,30,30
1746598140250,MATH 168A,A01,890197,Dumitriu; Ioana,21,0,35,14
1746598141276,MATH 170A,A01,890240,Nie; Jiawang,1,0,30,29
1746598141276,MATH 170A,A02,890241,Nie; Jiawang,11,0,30,19
1746598141276,MATH 170A,A03,890249,Nie; Jiawang,23,0,30,7
1746598142305,MATH 170B,A01,957891,Nag; Panchali,13,0,35,22
1746598144355,MATH 181A,A01,908025,Staff,0,3,35,35
1746598144355,MATH 181A,A02,960115,Staff,26,0,35,9
1746598145381,MATH 181B,A01,959874,Staff,24,0,30,6
1746598146411,MATH 193B,A01,890265,Staff,0,4,35,35
1746598147437,MGT 4,A01,890311,Anderson; John Charles,42,0,88,46
1746598148465,MGT 5,A00,907740,Staff,12,0,98,86
1746598149492,MGT 12,A00,890312,Lindenberger; Wade Douglas,67,0,98,31
1746598150516,MGT 16,A00,957883,Staff,78,0,98,20
1746598152568,MGT 45,A00,890314,Pecore; Joseph P.,45,0,98,53
1746598153596,MGT 71,A00,890315,Staff,0,12,98,98
1746598154625,MGT 100,A00,890316,Yavorsky; Daniel Ryan,44,0,98,54
1746598155653,MGT 103,A00,890317,Ehrich; Kristine R,73,0,98,25
1746598156679,MGT 105,A00,890356,Bates; Kenneth Walter,0,8,98,98
1746598157707,MGT 112,A00,890360,Ehrich; Kristine R,55,0,98,43
1746598158733,MGT 127R,A00,907732,Zhu; Kevin Xiaoguo,23,0,98,75
1746598159764,MGT 131B,A00,890361,Anderson; John Charles,59,0,98,39
1746598160793,MGT 137,A00,890362,Lindenberger; Wade Douglas,65,0,98,33
1746598161819,MGT 160,A00,890369,Johnson; Erik Barry,9,0,98,89
1746598163871,MGT 164,A00,890372,Zimmermann; Carsten,0,40,98,98
1746598164896,MGT 180,A00,890374,Bliss; Barbara Ann,11,0,98,87
1746598165934,MMW 15,A01,886414,Chang; Edmond Yi-Teh,0,12,28,28
1746598165934,MMW 15,A02,886415,Chang; Edmond Yi-Teh,0,8,28,28
1746598165934,MMW 15,A03,886416,Chang; Edmond Yi-Teh,0,9,28,28
1746598165934,MMW 15,A04,886417,Chang; Edmond Yi-Teh,0,8,28,28
1746598165934,MMW 15,B01,886419,Chang; Edmond Yi-Teh,0,7,28,28
1746598165934,MMW 15,B02,886420,Chang; Edmond Yi-Teh,0,7,28,28
1746598165934,MMW 15,B03,886421,Chang; Edmond Yi-Teh,0,7,28,28
1746598165934,MMW 15,B04,886422,Chang; Edmond Yi-Teh,0,8,28,28
1746598165934,MMW 15,C01,886424,Staff,0,9,28,28
1746598165934,MMW 15,C02,886425,Staff,0,8,28,28
1746598165934,MMW 15,C03,886426,Staff,0,8,28,28
1746598165934,MMW 15,C04,886427,Staff,0,8,28,28
1746598165934,MMW 15,C05,958038,Staff,0,8,28,28
1746598165934,MMW 15,C06,958039,Staff,0,7,28,28
1746598166959,MMW 15GS,A00,906910,Patterson; Patrick H.,4,0,28,24
1746598167984,MMW 122R,A01,886429,Rahimi; Babak,0,13,28,28
1746598167984,MMW 122R,A02,886430,Rahimi; Babak,0,12,28,28
1746598167984,MMW 122R,A03,958040,Rahimi; Babak,0,11,28,28
1746598169011,MUS 1A,A01,890937,Staff,2,0,25,23
1746598169011,MUS 1A,A02,891035,Staff,6,0,25,19
1746598169011,MUS 1A,C01,958912,Staff,24,0,25,1
1746598169011,MUS 1A,C02,958913,Staff,25,0,25,0
1746598171066,MUS 2AK,A00,957092,Ohnishi; Takae,15,0,15,0
1746598172099,MUS 4,A01,891044,Staff,0,0,25,25
1746598172099,MUS 4,A02,891045,Staff,22,0,25,3
1746598172099,MUS 4,B01,891048,Staff,17,0,25,8
1746598172099,MUS 4,B02,891050,Staff,25,0,25,0
1746598173127,MUS 5,A01,957506,Dubnov; Shlomo,0,0,25,25
1746598173127,MUS 5,A02,957622,Dubnov; Shlomo,13,0,25,12
1746598173127,MUS 5,A03,957623,Dubnov; Shlomo,20,0,25,5
1746598174154,MUS 6,A01,891053,Freitas Caetano; Marcelo,24,0,25,1
1746598174154,MUS 6,A02,891054,Freitas Caetano; Marcelo,23,0,25,2
1746598175181,MUS 7,A01,891081,Staff,0,0,25,25
1746598175181,MUS 7,A02,891082,Staff,3,0,25,22
1746598176208,MUS 8GS,A00,891118,Borgo; David Garcia,1,0,25,24
1746598177234,MUS 11,A01,891140,Staff,8,0,25,17
1746598177234,MUS 11,A02,891141,Staff,21,0,25,4
1746598178262,MUS 13,A01,891143,Staff,8,0,25,17
1746598178262,MUS 13,A02,891144,Staff,24,0,25,1
1746598179290,MUS 15,A01,891146,Staff,9,0,25,16
1746598179290,MUS 15,A02,891148,Staff,21,0,25,4
1746598179290,MUS 15,B01,891150,Staff,18,0,25,7
1746598179290,MUS 15,B02,891151,Staff,25,0,25,0
1746598180318,MUS 20,A01,891153,Staff,5,0,20,15
1746598180318,MUS 20,A02,891155,Staff,14,0,20,6
1746598181344,MUS 80,A00,891156,Staff,19,0,25,6
1746598181344,MUS 80,B00,891157,Staff,23,0,25,2
1746598182369,MUS 130,A00,891158,Ohnishi; Takae,35,0,35,0
1746598183397,MUS 150GS,A01,891160,Borgo; David Garcia,1,0,25,24
1746598184428,MUS 170,A01,891162,Freitas Caetano; Marcelo,20,0,25,5
1746598184428,MUS 170,A02,891164,Freitas Caetano; Marcelo,21,0,25,4
1746598185455,NANO 11,A00,886220,Vazquez Mena; Oscar,13,0,15,2
1746598186484,NANO 15,A01,886222,Drews; Aaron,4,0,7,3
1746598187513,NANO 104,A00,886224,Sirbuly; Donald,17,0,25,8
1746598188539,PH 40,A00,886528,Staff,23,0,40,17
1746598189564,PH 45,A01,886799,Staff,35,0,40,5
1746598190594,PH 110,A00,886802,Staff,0,6,40,40
1746598191619,PH 172,A00,906716,Staff,19,0,35,16
1746598192646,PH 191,A00,886803,Staff,6,0,40,34
1746598193671,PHIL 1,A00,889500,Staff,20,0,30,10
1746598194698,PHIL 10,A01,889549,Grush; Rick Scott,16,0,22,6
1746598194698,PHIL 10,A02,889551,Grush; Rick Scott,22,0,22,0
1746598195732,PHIL 28,A01,889559,Lamey; Andy M.,0,2,31,31
1746598195732,PHIL 28,A02,889561,Lamey; Andy M.,0,1,30,30
1746598195732,PHIL 28,A03,889572,Lamey; Andy M.,0,1,30,30
1746598196761,PHIL 35,A00,907839,Staff,13,0,15,2
1746598197809,PHIL 60,A00,889574,Staff,73,0,90,17
1746598198835,PHIL 101,A00,958004,Staff,12,0,15,3
1746598200893,PHIL 136,A00,889582,Fulkerson; Matthew Todd,26,0,45,19
1746598201919,PHIL 163,A01,889601,Staff,21,0,30,9
1746598201919,PHIL 163,B01,889606,Brandt; Reuven A,0,3,0,0
1746598202943,PHIL 164,A00,889610,Staff,16,0,30,14
1746598203970,PHIL 165,A00,889613,Staff,22,0,30,8
1746598204996,PHYS 1A,A00,886431,Staff,30,0,70,40
1746598206026,PHYS 1AL,001,886432,Tsai; Philbert S,0,1,30,30
1746598206026,PHYS 1AL,002,886436,Tsai; Philbert S,13,0,30,17
1746598207051,PHYS 1B,A00,886439,Staff,184,0,240,56
1746598208076,PHYS 1BL,001,886441,Tsai; Philbert S,0,4,30,30
1746598208076,PHYS 1BL,002,886444,Tsai; Philbert S,2,0,30,28
1746598209105,PHYS 1C,A00,896092,Arnold; Kam S,78,0,146,68
1746598210133,PHYS 1CL,001,886448,Tsai; Philbert S,0,0,30,30
1746598210133,PHYS 1CL,002,886449,Tsai; Philbert S,1,0,30,29
1746598210133,PHYS 1CL,003,886450,Tsai; Philbert S,16,0,30,14
1746598210133,PHYS 1CL,004,886451,Tsai; Philbert S,15,0,30,15
1746598211158,PHYS 2B,A01,886457,Staff,67,0,115,48
1746598212188,PHYS 2C,A01,886460,Shotwell; Brian,0,9,65,65
1746598213212,PHYS 2CL,A01,886467,Staff,0,4,28,28
1746598213212,PHYS 2CL,A02,886468,Staff,0,3,28,28
1746598214238,PHYS 2D,A01,886470,Staff,10,0,50,40
1746598215266,PHYS 4B,A01,886475,Grinstein; Benjamin,22,0,40,18
1746598216295,POLI 5,A00,891173,Desposato; Scott,7,0,25,18
1746598217322,POLI 5D,A01,891175,Staff,5,0,5,0
1746598217322,POLI 5D,B01,891178,Staff,5,0,5,0
1746598218346,POLI 11,A00,891179,Ferree; Karen E,0,0,35,35
1746598219373,POLI 12,A00,891180,Staff,15,0,30,15
1746598220399,POLI 27,A01,891182,Staff,11,0,75,64
1746598221428,POLI 30,A00,891183,Staff,8,0,50,42
1746598222454,POLI 100B,A00,891244,Staff,5,1,35,30
1746598223480,POLI 100I,A00,891247,Staff,7,0,30,23
1746598224508,POLI 104J,A00,891248,Nichter; Maysa,14,0,30,16
1746598225532,POLI 104U,A00,891250,Nichter; Maysa,1,0,30,29
1746598227582,POLI 110B,A00,891255,Wiens; David,19,0,25,6
1746598228610,POLI 112A,A00,891256,Wiens; David,6,0,25,19
1746598229638,POLI 114BR,A00,891261,Staff,19,0,30,11
1746598230664,POLI 117R,A00,891262,Forman; Fonna,0,6,50,50
1746598231690,POLI 118,A00,891264,Ingham; Sean,17,0,25,8
1746598232720,POLI 124A,A00,891265,Staff,18,0,20,2
1746598233746,POLI 125D,A00,891266,Nichter; Simeon C,2,0,25,23
1746598234773,POLI 126,A00,891268,Nichter; Simeon C,7,0,25,18
1746598235801,POLI 126AA,A00,891272,Staff,15,0,25,10
1746598236830,POLI 130AA,A00,891273,Staff,15,0,20,5
1746598237859,POLI 134AA,A00,891274,Staff,4,0,20,16
1746598239912,POLI 138,A00,891278,Staff,21,0,25,4
1746598240940,POLI 142K,A00,891280,Staff,10,0,25,15
1746598241970,POLI 142M,A00,891281,Gartzke; Erik,16,0,30,14
1746598242994,POLI 142P,A00,891284,Staff,20,0,30,10
1746598244021,POLI 143,A00,891285,Gartzke; Erik,12,0,30,18
1746598245045,POLI 153,A00,891286,Staff,19,0,20,1
1746598247097,POLI 175,A00,891290,Staff,15,0,20,5
1746598248123,PSYC 1,A00,890674,Steiner; Eric Tomas,0,11,45,45
1746598249148,PSYC 2,A00,890676,Albright; Thomas D,20,0,35,15
1746598250176,PSYC 3,A00,890679,Staff,17,0,20,3
1746598251204,PSYC 6,A00,959858,Staff,19,0,20,1
1746598252228,PSYC 60,A01,890684,Rickard; Timothy C.,0,6,45,45
1746598253254,PSYC 70,A01,890689,Geller; Emma Harlan,6,0,30,24
1746598254278,PSYC 71,A01,959860,Staff,21,0,25,4
1746598255306,PSYC 100,A00,890690,Lacefield; Katharine I,0,50,180,180
1746598256331,PSYC 102,A00,890695,Staff,18,0,40,22
1746598257359,PSYC 105,A00,890699,Geller; Emma Harlan,70,0,100,30
1746598258383,PSYC 106,A00,890701,Gorman; Michael R.,5,0,30,25
1746598259412,PSYC 108,A00,890704,Adrian; Julia Anna,0,29,50,50
1746598260436,PSYC 118,A01,890712,Staff,11,0,30,19
1746598261460,PSYC 124,A00,890716,Chapman; Eddie Nathaniel,25,0,60,35
1746598262542,PSYC 131,A00,890717,Anagnostaras; Stephan,0,7,80,80
1746598263567,PSYC 137,A00,890719,Winkielman; Piotr,0,11,30,30
1746598264591,PSYC 144,A00,890721,Adrian; Julia Anna,0,9,45,45
1746598265620,PSYC 162,A00,890805,Staff,0,1,75,75
1746598266646,PSYC 169,A00,890810,Staff,0,15,30,30
1746598267671,PSYC 172,A00,890814,Gorman; Michael R.,9,0,30,21
1746598268700,PSYC 181,A00,890818,Anagnostaras; Stephan,7,0,200,193
1746598269727,PSYC 184,A00,959861,Staff,162,0,175,13
1746598270753,PSYC 189,A00,890823,Staff,0,2,30,30
1746598271779,PSYC 191,A00,890884,Rickard; Timothy C.,0,11,35,35
1746598272807,PSYC 193,A00,890913,Staff,19,0,30,11
1746598272807,PSYC 193,B00,890914,Chapman; Eddie Nathaniel,24,0,30,6
1746598273834,PSYC 193L,A01,890918,Lowe; Angela Beth,20,0,30,10
1746598273834,PSYC 193L,B01,890921,Hurwitz; Ethan Scott,20,0,30,10
1746598273834,PSYC 193L,C01,890928,Staff,30,0,30,0
1746598274860,RELI 149,A00,886806,Rahimi; Babak,23,0,40,17
1746598275886,SE 9,A01,886814,Staff,7,0,20,13
1746598276913,SE 101B,A01,886816,Chadha; Mayank,3,0,35,32
1746598277942,SE 110B,A00,886818,Zhu; Qiang,4,0,75,71
1746598278970,SE 125,A01,886830,Staff,10,0,30,20
1746598279999,SE 130B,A01,886835,Staff,14,0,40,26
1746598281024,SE 131A,A01,886838,Krysl; Petr,34,0,55,21
1746598282049,SE 154,A00,886840,Staff,28,0,50,22
1746598283075,SE 164GS,A01,886849,Staff,6,0,20,14
1746598284100,SE 167GS,A01,886853,Staff,6,0,20,14
1746598285126,SIO 25,A01,890107,Staff,19,0,30,11
1746598286152,SIO 45,A00,890109,Cook; Geoffrey W,115,0,200,85
1746598287178,SIO 109R,A00,890110,Forman; Fonna,0,16,20,20
1746598288205,SIO 187,A01,890114,Kacev; David,15,0,40,25
1746598289230,SOCI 1,A01,890431,Thorpe; Charles Robert,14,0,30,16
1746598289230,SOCI 1,A02,890518,Thorpe; Charles Robert,30,0,30,0
1746598290257,SOCI 2,A01,957978,Staff,25,0,25,0
1746598290257,SOCI 2,A02,957979,Staff,23,0,25,2
1746598291282,SOCI 20,A01,890523,Calderon-Zaks; Michael Aar,21,0,30,9
1746598291282,SOCI 20,A02,890526,Calderon-Zaks; Michael Aar,29,0,30,1
1746598292309,SOCI 30,A01,890533,Pardo Guerra; Juan Pablo,37,0,40,3
1746598293337,SOCI 40,A01,890535,Staff,27,0,45,18
1746598294363,SOCI 104Q,A00,890559,Staff,18,0,30,12
1746598295389,SOCI 106,A00,890560,Arnal; Maud Marie Leonie,20,0,30,10
1746598296419,SOCI 110,A00,890567,Holkenbrink-Monk; Charlene,19,0,30,11
1746598297444,SOCI 112,A00,890568,Victoria Torres; Pablo,2,0,55,53
1746598298470,SOCI 115,A00,890597,Arnal; Maud Marie Leonie,28,0,45,17
1746598300525,SOCI 121,A00,890604,Pardo Guerra; Juan Pablo,38,0,45,7
1746598301552,SOCI 126,A01,890608,Staff,8,0,10,2
1746598302577,SOCI 127,A00,890609,Staff,18,0,30,12
1746598303605,SOCI 131,A00,890610,Thorpe; Charles Robert,37,0,45,8
1746598304631,SOCI 135,A00,890615,Payne; Christine Anna,14,0,45,31
1746598305658,SOCI 139,A00,890620,Staff,38,0,45,7
1746598306687,SOCI 148E,A00,890622,Calderon-Zaks; Michael Aar,36,0,45,9
1746598307713,SOCI 150,A00,890623,Kohler; Kristopher M.,31,0,45,14
1746598308758,SOCI 157,A00,890625,Jules-Rosette; Bennetta W.,18,0,20,2
1746598309788,SOCI 160,A00,890627,Payne; Christine Anna,21,0,45,24
1746598310813,SYN 1,A00,886855,Fish; Gwendolyn Anne,0,1,0,0
1746598310813,SYN 1,B00,906086,Fish; Gwendolyn Anne,0,2,0,2
1746598311837,SYN 2R,A00,886860,Staff,0,17,15,15
1746598311837,SYN 2R,B00,906106,Atkinson; Arthur Laird,0,16,15,15
1746598312870,SYN 100,A01,886866,Browne; Emily,0,28,20,20
1746598312870,SYN 100,B01,906128,Rock; Martin,0,4,20,20
1746598312870,SYN 100,C01,906140,Deavenport; James Cary,0,4,20,20
1746598312870,SYN 100,D01,907816,Deavenport; James Cary,0,5,20,20
1746598313897,TDAC 1,A00,890286,Walsh; Kim C.,7,0,20,13
1746598314923,TDAC 101,A00,890296,Basso; Beatrice,15,0,20,5
1746598315949,TDDE 131,A00,890297,Staff,47,0,50,3
1746598316975,TDDM 1,A00,890287,Weinberg; Sadie,25,0,30,5
1746598318000,TDGE 11,A00,890288,Fulton; Julia,138,0,200,62
1746598318000,TDGE 11,B00,890289,Castro; Robert Jess,184,0,200,16
1746598319026,TDGE 25,B00,957359,Walsh; Kim C.,5,0,20,15
1746598320055,TDGE 40,A01,890292,Power; Jade Yukana,26,0,30,4
1746598321084,TDGE 124,A00,890298,Havis; Allan,0,2,50,50
1746598322110,TDGE 131R,A00,890299,Burelle; Julie Sara Veronique,15,0,42,27
1746598323139,TDHT 101,A00,890300,Staff,10,0,20,10
1746598324165,TDHT 109,A01,890302,Anderson; Mysia Anyse,31,0,40,9
1746598325196,TDMV 1,A00,890293,Arcidiacono; Kristin,18,0,30,12
1746598326220,TDMV 2,A00,890294,Weinberg; Sadie,23,0,30,7
1746598327250,TDMV 3,A00,957878,Arcidiacono; Kristin,28,0,30,2
1746598329303,TDMV 138,A00,890304,Jun; Grace Shin Hae,25,0,40,15
1746598330332,TDMV 140,A00,890305,Corrales; Joseph Bernales,25,0,30,5
1746598331360,TDMV 142,A00,890307,Caligagan; Tony,32,0,40,8
1746598332398,TDMV 144,A00,890308,Camaya; Michelle Ann,25,0,30,5
1746598333424,TDPW 1,A00,890295,Stein; Deborah Isobel,3,0,20,17
1746598334451,USP 2,A01,890272,Lerner; Amy M,7,0,20,13
1746598335476,USP 3,A01,890274,Staff,12,0,30,18
1746598336507,USP 15,A01,890276,Sun; Feiyang,16,0,30,14
1746598337530,USP 25,A00,890277,Shenkman; Michael Thomas,18,0,25,7
1746598338558,USP 138,A00,890278,Staff,13,0,25,12
1746598339583,USP 143,A00,890279,Staff,21,0,70,49
1746598340612,USP 144,A00,890280,Chowdhury; Muhammed Zohir,16,0,30,14
1746598341642,USP 150,A00,890281,Boomhower; Matthew Charles,4,0,30,26
1746598342672,USP 151,A00,890282,Staff,16,0,20,4
1746598343696,USP 162,A00,890283,Andrews; Abigail Leslie,16,0,20,4
1746598344724,USP 168,A00,920477,Kwak; Nancy,0,0,5,5
1746598345750,USP 181,A00,890284,Staff,3,0,20,17
1746598346775,USP 191A,A00,890285,Staff,12,0,20,8
1746598347800,VIS 101,A00,886512,Staff,26,0,75,49
1746598348828,VIS 103,A00,886513,Cruz; Edwin Teddy,61,0,75,14
1746598349864,VIS 108,A00,886514,Staff,4,0,15,11
1746598350889,VIS 127P,A00,886515,Shen; Kuiyi,80,0,146,66
1746598351914,VIS 149,A00,886516,Yoldas; Pinar,0,0,15,15
1746598352940,VIS 164,A00,886526,Erdmann; Dean,19,0,22,3
1746598353966,VIS 194S,A00,886527,Staff,61,0,75,14
1746598354992,WCWP 10A,C00,886484,Martiniuk; Jill,12,0,15,3
1746598356017,WCWP 10B,A00,886490,Uriarte; Emma,0,0,15,15
1746598356017,WCWP 10B,B00,886491,Dhir; Simrita,8,0,15,7
1746598356017,WCWP 10B,C00,886492,Ornelas; Tricia,0,0,15,15
1746598357046,WCWP 100,A00,886494,Young; Mark T,0,6,15,15
1746598359142,AAS 10,A01,886199,Childs; Dennis R.,0,3,0,0
1746598360166,ANAR 104,A01,886940,Shtienberg; Gilad,27,0,30,3
1746598361194,ANAR 120,A00,886953,Staff,13,0,20,7
1746598362219,ANBI 148,A01,886955,Wilder; Linnea Lorene,30,0,40,10
1746598364271,ANSC 122,A00,886957,Staff,24,0,30,6
1746598365298,ANSC 150,A00,886958,Sloane; Julia Kathryn,2,0,15,13
1746598366364,ANSC 156,A00,886959,Jenkins; Janis A.,0,1,15,15
1746598367390,ANSC 180,A00,886960,Staff,11,0,17,6
1746598368417,ANSC 188,A00,886961,Jassal; Aftab,9,0,25,16
1746598369443,ANSC 190,A00,886962,Jassal; Aftab,14,0,25,11
1746598370469,ANSC 191,A00,886963,Staff,18,0,20,2
1746598371498,ANTH 3,A01,891689,Staff,17,0,20,3
1746598372527,ANTH 5,A00,886933,Semendeferi; Ekaterini,16,0,20,4
1746598373555,ANTH 10,A00,886934,Staff,0,12,30,30
1746598374584,ANTH 21,A01,886936,Staff,41,0,60,19
1746598375615,ANTH 23,A01,886938,Staff,92,0,100,8
1746598376643,ANTH 105,A00,886964,Stewart; Alexander B,84,0,100,16
1746598377668,ANTH 108,A00,886965,Pedersen; David,9,0,20,11
1746598378695,AWP 10,001,886147,Staff,0,0,0,0
1746598378695,AWP 10,002,886148,Staff,0,0,0,0
1746598378695,AWP 10,003,886149,Staff,0,0,0,0
1746598378695,AWP 10,004,886150,Staff,0,0,0,0
1746598378695,AWP 10,005,886151,Staff,0,0,0,0
1746598378695,AWP 10,006,886152,Staff,0,0,0,0
1746598378695,AWP 10,007,886153,Staff,0,0,0,0
1746598378695,AWP 10,008,886154,Staff,0,0,0,0
1746598378695,AWP 10,009,886155,Staff,0,0,0,0
1746598378695,AWP 10,010,886156,Staff,0,0,0,0
1746598378695,AWP 10,011,886158,Staff,0,0,0,0
1746598378695,AWP 10,012,886160,Staff,0,0,0,0
1746598378695,AWP 10,013,886161,Staff,0,0,0,0
1746598378695,AWP 10,014,886162,Staff,0,0,0,0
1746598378695,AWP 10,015,886163,Staff,0,0,0,0
1746598378695,AWP 10,016,886164,Staff,0,0,0,0
1746598378695,AWP 10,017,886165,Staff,0,0,0,0
1746598378695,AWP 10,018,886166,Staff,0,0,0,0
1746598378695,AWP 10,019,886168,Staff,0,0,0,0
1746598378695,AWP 10,020,886170,Staff,0,0,0,0
1746598378695,AWP 10,021,886172,Staff,0,0,0,0
1746598379723,AWP 10R,001,886173,Staff,0,1,0,0
1746598379723,AWP 10R,002,886174,Staff,0,1,0,0
1746598379723,AWP 10R,003,886175,Staff,0,0,0,0
1746598379723,AWP 10R,004,886176,Staff,0,0,0,0
1746598379723,AWP 10R,005,886177,Staff,0,0,0,0
1746598379723,AWP 10R,006,886178,Staff,0,0,0,0
1746598379723,AWP 10R,007,886179,Staff,0,0,0,0
1746598379723,AWP 10R,008,886181,Staff,0,0,0,0
1746598379723,AWP 10R,009,886182,Staff,0,0,0,0
1746598379723,AWP 10R,010,886183,Staff,0,0,0,0
1746598379723,AWP 10R,011,886184,Staff,0,0,0,0
1746598379723,AWP 10R,012,886185,Staff,0,0,0,0
1746598379723,AWP 10R,013,886186,Staff,0,0,0,0
1746598379723,AWP 10R,014,886187,Staff,0,0,0,0
1746598379723,AWP 10R,015,886188,Staff,0,0,0,0
1746598379723,AWP 10R,016,886189,Staff,0,0,0,0
1746598379723,AWP 10R,017,960532,Staff,0,0,0,0
1746598379723,AWP 10R,018,960533,Staff,0,0,0,0
1746598379723,AWP 10R,019,960534,Staff,0,0,0,0
1746598379723,AWP 10R,020,960538,Staff,0,0,0,0
1746598379723,AWP 10R,021,960540,Staff,0,0,0,0
1746598379723,AWP 10R,022,960541,Staff,0,0,0,0
1746598379723,AWP 10R,023,960542,Staff,0,0,0,0
1746598379723,AWP 10R,024,960544,Staff,0,0,0,0
1746598379723,AWP 10R,025,960545,Staff,0,0,0,0
1746598379723,AWP 10R,026,960548,Staff,0,0,0,0
1746598380749,AWP 102R,A00,886190,Staff,0,0,0,0
1746598380749,AWP 102R,B00,886191,Staff,0,0,0,0
1746598381775,BENG 100,A01,886193,Staff,17,0,30,13
1746598382800,BENG 122A,A01,886195,Hasty; Jeff M,13,0,30,17
1746598383828,BENG 166A,A00,886196,Sah; Robert Lie-Yuan,0,3,30,30
1746598384853,BENG 190,A00,958050,Khojah; Reem I,17,0,25,8
1746598385880,BIBC 102,A01,894320,Staff,0,1,46,46
1746598385880,BIBC 102,A02,894321,Staff,0,0,46,46
1746598385880,BIBC 102,A03,894344,Staff,6,0,46,40
1746598385880,BIBC 102,A04,894345,Staff,27,0,47,20
1746598386908,BICD 100R,A01,894365,Smith; Laurie,0,2,58,58
1746598386908,BICD 100R,A02,894366,Smith; Laurie,0,4,58,58
1746598386908,BICD 100R,A03,894367,Smith; Laurie,0,0,59,59
1746598386908,BICD 100R,A04,959869,Smith; Laurie,38,0,59,21
1746598387940,BICD 136,A01,894383,Gustafson-Brown; Cindy,14,0,50,36
1746598388966,BIEB 102,A01,894494,Butler; Shannon Rhey,51,0,130,79
1746598391024,BIEB 150,A01,894617,Wills; Christopher,3,0,20,17
1746598391024,BIEB 150,A02,894631,Wills; Christopher,3,0,20,17
1746598391024,BIEB 150,A03,894937,Wills; Christopher,3,0,20,17
1746598391024,BIEB 150,A04,894946,Wills; Christopher,5,0,20,15
1746598392050,BIEB 194,A00,906141,Kurle; Carolyn M.,5,0,20,15
1746598393078,BILD 1,A01,894154,Staff,3,0,19,16
1746598393078,BILD 1,A02,894155,Staff,14,0,19,5
1746598393078,BILD 1,A03,894160,Staff,13,0,19,6
1746598393078,BILD 1,A04,894161,Staff,15,0,18,3
1746598394109,BILD 2,A01,894168,Staff,0,0,50,50
1746598394109,BILD 2,A02,894169,Staff,0,0,50,50
1746598394109,BILD 2,A03,894179,Staff,0,0,50,50
1746598394109,BILD 2,A04,894203,Staff,22,0,50,28
1746598395134,BILD 3,A01,894213,Staff,23,0,31,8
1746598395134,BILD 3,A02,894214,Staff,26,0,31,5
1746598395134,BILD 3,A03,894235,Staff,28,0,31,3
1746598395134,BILD 3,A04,894236,Staff,28,0,32,4
1746598396163,BILD 4,A01,894253,Reuther; Keefe,5,0,24,19
1746598396163,BILD 4,A02,894258,Reuther; Keefe,16,0,24,8
1746598397189,BILD 5,A01,894276,Reuther; Keefe,34,0,50,16
1746598397189,BILD 5,A02,894277,Reuther; Keefe,45,0,50,5
1746598397189,BILD 5,A03,894290,Reuther; Keefe,44,0,50,6
1746598397189,BILD 5,A04,894291,Reuther; Keefe,48,0,50,2
1746598398215,BILD 24,A01,894297,Pirino; Giorgia,40,0,60,20
1746598399241,BIMM 100,B01,958915,Staff,71,0,100,29
1746598400267,BIMM 101,A01,895017,McDonnell; Lisa Marie,0,5,24,24
1746598400267,BIMM 101,A02,895018,McDonnell; Lisa Marie,0,5,24,24
1746598400267,BIMM 101,B01,895020,McDonnell; Lisa Marie,0,5,24,24
1746598400267,BIMM 101,B02,895021,McDonnell; Lisa Marie,0,4,24,24
1746598401293,BIMM 110,A01,895023,Staff,1,0,25,24
1746598401293,BIMM 110,A02,895024,Staff,9,0,25,16
1746598401293,BIMM 110,A03,895025,Staff,18,0,25,7
1746598401293,BIMM 110,A04,895031,Staff,20,0,25,5
1746598402323,BIMM 120,A01,895114,Gustafson-Brown; Cindy,14,0,28,14
1746598402323,BIMM 120,A02,895126,Gustafson-Brown; Cindy,21,0,27,6
1746598403353,BIPN 100,A01,895130,Yang; Mingyu,0,0,38,38
1746598403353,BIPN 100,A02,895131,Yang; Mingyu,31,0,38,7
1746598403353,BIPN 100,A03,895132,Yang; Mingyu,32,0,38,6
1746598403353,BIPN 100,A04,895133,Yang; Mingyu,27,0,36,9
1746598404383,BIPN 120,A01,895135,Cooke; James Edward,0,3,13,13
1746598404383,BIPN 120,A02,895136,Cooke; James Edward,0,1,13,13
1746598404383,BIPN 120,A03,895137,Cooke; James Edward,0,3,13,13
1746598404383,BIPN 120,A04,895156,Cooke; James Edward,0,2,11,11
1746598405412,BIPN 134,A01,895235,Cooke; James Edward,0,1,25,25
1746598405412,BIPN 134,A02,895237,Cooke; James Edward,0,0,25,25
1746598405412,BIPN 134,A03,895240,Cooke; James Edward,1,0,25,24
1746598405412,BIPN 134,A04,895270,Cooke; James Edward,20,0,25,5
1746598406440,BIPN 189,A00,892103,Staff,0,14,14,14
1746598408494,BISP 194,A00,958008,Staff,0,2,0,0
1746598409518,CAT 124,A01,922009,Staff,0,5,20,20
1746598410556,CAT 125R,A00,886390,Morales; Celeste Georgianna,0,3,20,20
1746598410556,CAT 125R,B00,886391,Irwin; Matthew Joseph,0,4,20,20
1746598410556,CAT 125R,C00,886392,Smith; Lauryn Alissa,0,2,20,20
1746598410556,CAT 125R,D00,886393,Vanderschuit; Maya Alysia,0,3,20,20
1746598410556,CAT 125R,E00,886394,Marchisotto; Jennifer Anne,0,3,20,20
1746598411584,CENG 15,A01,886218,Drews; Aaron,3,0,8,5
1746598412611,CENG 113,A00,886219,Opatkiewicz; Justin Paul,15,0,25,10
1746598413638,CGS 101,A00,887044,Staff,7,0,20,13
1746598414665,CGS 105,A01,887046,Staff,14,0,25,11
1746598415689,CGS 112,A00,887047,Cuong; Marisol,12,0,15,3
1746598416717,CGS 113,A00,887048,Staff,23,0,30,7
1746598417743,CGS 120,A00,887049,Staff,10,0,17,7
1746598418769,CHEM 6A,A01,886336,Lam; Tin Yiu,38,0,50,12
1746598418769,CHEM 6A,A02,886338,Lam; Tin Yiu,37,0,50,13
1746598419800,CHEM 6B,A01,886341,Hopkins; Patrycja Anna,16,0,50,34
1746598419800,CHEM 6B,A02,886343,Hopkins; Patrycja Anna,42,0,50,8
1746598420832,CHEM 6C,A01,886346,Albizati; Kim F.,0,2,50,50
1746598420832,CHEM 6C,A02,886348,Albizati; Kim F.,24,0,50,26
1746598421862,CHEM 40A,A01,886352,Klosterman; Jeremy K,65,0,100,35
1746598422891,CHEM 40B,A01,886356,Klosterman; Jeremy K,0,24,100,100
1746598423921,CHEM 41B,A01,886360,Theodorakis; Emmanuel,25,0,50,25
1746598423921,CHEM 41B,A02,886362,Theodorakis; Emmanuel,47,0,50,3
1746598424947,CHIN 165A,A00,886382,Xu; Li,18,0,20,2
1746598425976,CLAS 120,A00,886387,Myerston Santana; Jacobo,33,0,40,7
1746598427002,COGS 9,A01,886967,Shannon; Kyle Michael,42,0,60,18
1746598428031,COGS 11,A01,886969,Staff,9,0,30,21
1746598429060,COGS 14A,A01,886971,Staff,5,0,60,55
1746598430087,COGS 14B,A01,886973,Hoffman; Drew Ellen,4,0,60,56
1746598431116,COGS 18,A01,886975,Morgan; Eric,34,0,60,26
1746598432143,COGS 20,A01,886977,Staff,3,0,8,5
1746598432143,COGS 20,A02,886978,Staff,5,0,7,2
1746598433173,COGS 100,A01,907783,Staff,0,1,30,30
1746598434198,COGS 101B,A01,886980,Staff,0,4,48,48
1746598435224,COGS 101C,A01,886982,Delgado; Tania,0,5,44,44
1746598436252,COGS 102A,A01,886984,Johnson; Christine M.,3,0,30,27
1746598437277,COGS 118B,A01,886986,Staff,0,4,88,88
1746598438304,COGS 150,A01,886988,Bergen; Benjamin,22,0,50,28
1746598439331,COGS 153,A00,886989,Delgado; Tania,0,3,41,41
1746598440360,COGS 186,A01,886991,Staff,0,0,32,32
1746598441390,COGS 187A,A01,886993,Boyle; Mary E. T.,7,0,30,23
1746598442425,COGS 189,A00,886994,Staff,0,1,30,30
1746598443453,COMM 10,A01,886996,Staff,0,0,20,21
1746598443453,COMM 10,A02,886997,Staff,10,0,20,10
1746598443453,COMM 10,A03,959845,Staff,19,0,20,1
1746598444481,COMM 20,A01,886999,Leuning; Grant Maurstad,24,0,40,16
1746598446533,COMM 100A,A01,887002,Staff,0,0,20,25
1746598446533,COMM 100A,A02,887003,Staff,5,0,20,15
1746598447560,COMM 100B,A01,887005,Staff,0,8,20,24
1746598448587,COMM 106D,A00,887006,Staff,14,0,40,26
1746598449615,COMM 110G,A00,887007,Whitworth-Smith; Andrew C,12,0,40,28
1746598450639,COMM 111B,A00,887008,Staff,31,0,40,9
1746598451667,COMM 113T,A00,887009,Abuelhiga; Soraya Jill,28,0,40,12
1746598451667,COMM 113T,B00,906733,Staff,39,0,40,1
1746598452693,COMM 145,A00,887010,Staff,13,0,40,27
1746598453722,COMM 146,A00,887054,Staff,32,0,40,8
1746598454749,COMM 190,A00,887012,Staff,8,0,23,15
1746598455774,CSE 8A,A50,887015,Cao; Yingjun,56,0,85,29
1746598456800,CSE 11,A01,887017,Cao; Yingjun,11,0,70,59
1746598457828,CSE 20,A01,887019,Staff,30,0,50,20
1746598458852,CSE 21,A01,887021,Staff,79,0,100,21
1746598458852,CSE 21,B01,892583,Braun; Oliver,45,0,50,5
1746598459879,CSE 30,A01,887025,Eldon; John,142,0,200,58
1746598460907,CSE 100,A01,887027,Staff,26,0,50,24
1746598460907,CSE 100,A02,887028,Staff,42,0,50,8
1746598461934,CSE 101,A01,887030,Braun; Oliver,74,0,100,26
1746598461934,CSE 101,B01,887032,Jones; Miles E,0,3,50,50
1746598461934,CSE 101,B02,887033,Jones; Miles E,0,2,50,50
1746598462964,CSE 105,A01,908084,Jones; Miles E,32,0,50,18
1746598462964,CSE 105,A02,908087,Jones; Miles E,31,0,50,19
1746598463990,CSE 135,A01,887035,Powell; Thomas Allan,0,5,50,50
1746598465018,CSE 142,A01,887037,Staff,8,0,60,52
1746598466047,CSE 142L,A01,887039,Staff,34,0,60,26
1746598467075,CSE 151A,A01,887041,Solares; Edwin A,47,0,100,53
1746598468099,CSE 175,A01,887043,Kumar; Rakesh,30,0,30,0
1746598469126,CSS 1,A01,886389,Staff,0,1,40,40
1746598470155,DSC 30,A01,908097,Liao; Soohyun Nam,47,0,75,28
1746598471180,DSC 40A,A01,908099,Shannon; Kyle Michael,30,0,50,20
1746598472207,DSC 40B,A01,908112,Staff,15,0,50,35
1746598473235,DSC 80,A01,908116,Staff,19,0,60,41
1746598474260,DSC 197,001,956863,Eldridge; Justin Matthew,9999,0,9999,0
1746598475286,ECE 5,A01,886400,Morris; Karcher William,1,0,6,5
1746598475286,ECE 5,A02,886401,Morris; Karcher William,3,0,6,3
1746598476314,ECE 148,A01,886403,Silberman; Jack,0,14,14,14
1746598477339,ECON 1,A01,887265,Crane; Meredith Helen,11,0,70,59
1746598477339,ECON 1,B01,887268,Staff,42,0,50,8
1746598478365,ECON 2,A01,887273,Crane; Meredith Helen,54,0,70,16
1746598479392,ECON 3,A01,887279,Rondina; Giacomo,31,0,70,39
1746598480418,ECON 4,A01,887282,Anderson; John Charles,0,2,10,10
1746598481446,ECON 5,A01,887285,Staff,34,0,45,11
1746598481446,ECON 5,B01,887292,Staff,41,0,45,4
1746598482472,ECON 100A,A01,887337,Newhouse; Herbert S,54,0,70,16
1746598482472,ECON 100A,B01,887349,Staff,45,0,50,5
1746598483499,ECON 100B,A01,887361,Du; Songzi,29,0,70,41
1746598484527,ECON 100C,A01,887445,Newhouse; Herbert S,59,0,70,11
1746598485553,ECON 105,A00,887488,Vespa; Emanuel Ignacio,23,0,35,12
1746598486579,ECON 109,A01,887506,Shishkin; Denis,28,0,35,7
1746598487610,ECON 110A,A01,887568,Alon; Titan Michael,0,2,35,35
1746598487610,ECON 110A,B01,907601,Alon; Titan Michael,20,0,35,15
1746598488634,ECON 110B,A01,887598,Levkoff; Steven B.,0,24,70,70
1746598489663,ECON 112,A00,887599,Rondina; Giacomo,19,0,35,16
1746598490691,ECON 120A,A01,887603,Dai; Yinlin,35,0,70,35
1746598491718,ECON 120C,A01,887608,Sun; Yixiao,0,1,35,35
1746598491718,ECON 120C,B01,887614,Sun; Yixiao,0,0,35,35
1746598492743,ECON 138,A00,887621,Bharadwaj; Prashant,0,21,20,20
1746598493772,ECON 144,A00,958007,Squires; Dale E,12,0,35,23
1746598494800,ECON 171,A01,907666,Staff,18,0,35,17
1746598495827,ECON 175,A00,887626,Wu; Pak Yeung,22,0,35,13
1746598496852,ECON 190,A00,887640,Vespa; Emanuel Ignacio,22,0,35,13
1746598497887,EDS 25,A01,888197,Staff,0,0,0,0
1746598497887,EDS 25,A02,888209,Staff,0,0,0,0
1746598497887,EDS 25,A03,888210,Staff,0,0,0,0
1746598497887,EDS 25,A04,888212,Staff,0,0,0,0
1746598497887,EDS 25,A05,888213,Staff,0,0,0,0
1746598497887,EDS 25,A06,888214,Staff,0,0,0,0
1746598497887,EDS 25,A07,888235,Staff,0,2,0,0
1746598497887,EDS 25,A08,888236,Staff,0,0,0,0
1746598497887,EDS 25,A09,888240,Staff,0,0,0,0
1746598497887,EDS 25,A10,888244,Staff,0,0,0,0
1746598497887,EDS 25,B01,888273,Staff,0,0,0,0
1746598497887,EDS 25,B02,888285,Staff,0,0,0,0
1746598497887,EDS 25,B03,888423,Staff,0,0,0,1
1746598497887,EDS 25,B04,888432,Staff,0,0,0,0
1746598497887,EDS 25,B05,888433,Staff,0,0,0,0
1746598497887,EDS 25,B06,888467,Staff,0,0,0,0
1746598497887,EDS 25,B07,888468,Staff,0,0,0,0
1746598497887,EDS 25,B08,888479,Staff,0,0,0,0
1746598497887,EDS 25,B09,888484,Staff,0,0,0,0
1746598497887,EDS 25,B10,888487,Staff,0,0,0,0
1746598498916,EDS 38,A01,907700,Choi; Bailey Miyeon,30,0,30,0
1746598499945,EDS 112,A01,888601,Chapman; Thandeka K,12,0,40,28
1746598500971,EDS 115,A00,888697,Mendez; Kathrina Mendoza,10,0,30,20
1746598501998,EDS 116,A01,888893,Staff,33,0,40,7
1746598504057,EDS 124AR,A00,889133,Staff,29,0,50,21
1746598504057,EDS 124AR,B00,907471,Simon; Elizabeth A,37,0,50,13
1746598505087,EDS 124BR,A00,889134,Simon; Elizabeth A,44,0,100,56
1746598506111,EDS 125,A00,889135,Staff,25,0,30,5
1746598507138,EDS 126,A01,889138,Staff,35,0,40,5
1746598508166,EDS 164R,A01,889142,Wishard Guerra; Alison G.,32,0,50,18
1746598509193,ENG 30,A01,886396,Staff,0,0,0,0
1746598509193,ENG 30,B01,886398,Staff,0,0,0,0
1746598510218,ENVR 102,A00,906150,Montejo; Carolina,23,0,25,2
1746598511243,ETHN 103A,A00,887236,Man; Simeon S,0,2,0,0
1746598512271,ETHN 113,A00,887239,Staff,16,0,30,14
1746598513298,ETHN 116,A00,887240,Staff,16,0,25,9
1746598514323,ETHN 117,A00,887241,Choi; Esther Min,28,0,30,2
1746598515348,ETHN 118,A00,887243,Staff,24,0,30,6
1746598516375,ETHN 127,A00,887248,Cuong; Marisol,11,0,15,4
1746598517402,ETHN 139,A00,887250,Staff,7,0,10,3
1746598518432,ETHN 142,A00,887252,Staff,10,0,30,20
1746598519456,ETHN 161,A00,887253,Browne; Errol Tsekani,24,0,30,6
1746598520481,ETHN 163FR,A00,887255,Burelle; Julie Sara Veronique,0,0,5,5
1746598521505,GLBH 20,A00,889149,Elwardani; Nile Regina,8,0,42,34
1746598523556,GLBH 111,A01,889152,Burgos; Jose L.,17,0,17,0
1746598524585,GLBH 150,A00,889181,Sloane; Julia Kathryn,0,5,15,15
1746598526642,HDS 60,A01,886406,Warstadt; Melissa Fawn,72,0,80,8
1746598527667,HIAF 111,A00,889324,Gyamfi; Bright,25,0,32,7
1746598528694,HIEA 131,A00,889328,Staff,15,0,32,17
1746598529724,HIEA 144,A00,889333,Henry; Todd A.,26,0,32,6
1746598530749,HIEA 154,A00,889336,Henry; Todd A.,24,0,32,8
1746598531776,HIEU 106,A00,889339,Staff,22,0,32,10
1746598533827,HIEU 114,A00,889340,Staff,4,0,32,28
1746598534855,HIEU 135GS,A00,889342,Patterson; Patrick H.,0,0,1,24
1746598535880,HIEU 137,A00,889343,Edington; Claire Ellen,10,0,25,15
1746598536905,HIEU 148,A00,889345,Staff,14,0,32,18
1746598537930,HIEU 154,A00,889346,Biess; Frank Peter,21,0,32,11
1746598538954,HILA 102,A00,889351,Staff,12,0,32,20
1746598539980,HILD 2A,A01,889221,Lewandoski; Julia Mavis,0,8,32,32
1746598541005,HILD 7B,A01,889225,Man; Simeon S,0,12,32,32
1746598542033,HILD 7C,A01,889288,Alvarez; Luis A,0,14,32,32
1746598543062,HILD 30,A01,889323,Staff,0,5,32,32
1746598545121,HISC 119,A00,889383,Golan; Tal,20,0,32,12
1746598546145,HIUS 103,A00,889384,Man; Simeon S,0,0,32,32
1746598547172,HIUS 117,A00,919797,Kwak; Nancy,18,0,32,14
1746598548198,HIUS 142A,A00,919788,Staff,22,0,32,10
1746598550253,HIUS 149,A00,889386,Gyamfi; Bright,26,0,32,6
1746598551283,HIUS 155,A00,889387,Alvarez; Luis A,15,0,32,17
1746598552311,HUM 3,A01,886499,Caldwell; Michael Alan,19,0,50,31
1746598553391,HUM 3GS,A00,886500,Rodriguez; Bretton Sigfred,0,0,0,28
1746598554417,HUM 3R,A01,886502,Markman; Kristina,0,36,50,50
1746598555447,HUM 4,A01,886504,Crum; Matthew Stephen,23,0,50,27
1746598555447,HUM 4,B01,886506,West; Geoffrey Scott,17,0,50,33
1746598556472,HUM 4GS,A00,886507,Staff,0,0,0,19
1746598557497,HUM 5,A01,886509,Staff,31,0,50,19
1746598558522,HUM 5R,A01,886511,Zavodny; Tatiana Sophia,0,39,50,50
1746598559547,JAPN 180,A00,886407,Staff,16,0,40,24
1746598560574,LATI 50,A01,886409,Martin-Cabrera; Luis,3,0,22,19
1746598560574,LATI 50,A02,886410,Martin-Cabrera; Luis,19,0,22,3
1746598560574,LATI 50,A03,886411,Martin-Cabrera; Luis,21,0,22,1
1746598560574,LATI 50,A04,886412,Martin-Cabrera; Luis,8,0,22,14
1746598561600,LAWS 101,A00,907664,Staff,28,0,60,32
1746598562632,LIAB 1A,A00,889388,Saab; Dima,17,0,20,3
1746598563658,LIAB 1AX,A00,889389,El Cheddadi; Youniss,18,0,20,2
1746598564683,LIFR 1C,A00,889391,Van Moer; Vinciane G,8,0,20,12
1746598565710,LIFR 1CX,A00,889392,Van Moer; Vinciane G,7,0,20,13
1746598566736,LIFR 1D,A00,889393,Van Moer; Vinciane G,7,0,20,13
1746598567764,LIFR 1DX,A00,889394,Van Moer; Vinciane G,8,0,20,12
1746598568789,LIGN 7,A00,886923,Staff,25,0,50,25
1746598569814,LIGN 17,A00,886924,Kehler; Andrew Scott,126,0,150,24
1746598570839,LTAM 110,A00,889395,Staff,15,0,30,15
1746598571865,LTAM 110GS,A00,958010,Rodriguez; Bretton Sigfred,0,0,0,28
1746598572893,LTCH 101,A00,889397,Staff,23,0,25,2
1746598573919,LTCS 130,A00,889398,Staff,23,0,25,2
1746598574946,LTEA 138,A00,889399,Staff,24,0,40,16
1746598575975,LTEN 149,A00,889400,Wesling; Megan E.,0,3,25,25
1746598577001,LTEN 169,A00,889401,Staff,20,0,25,5
1746598578026,LTEN 180,A00,889402,Staff,10,0,15,5
1746598579051,LTEN 181,A00,889403,Staff,21,0,25,4
1746598580079,LTWL 100,A00,889404,Myerston Santana; Jacobo,2,0,25,23
1746598581105,LTWL 180GS,A00,889405,Staff,0,0,20,20
1746598582131,LTWL 181,A00,889406,Staff,16,0,25,9
1746598583155,LTWL 184,A00,889475,Mukherjee; Silpa,22,0,25,3
1746598584182,LTWR 102C,A00,889486,Staff,29,0,30,1
1746598585212,LTWR 115W,A00,889491,Staff,0,2,15,15
1746598586237,MAE 8,A01,886905,Staff,0,2,0,0
1746598587266,MAE 11,A00,886906,Bandaru; Prabhakar,0,7,50,50
1746598588296,MAE 20,A00,886907,Evdokimenko; Ekaterina,43,0,70,27
1746598589322,MAE 30B,A00,886909,Ghazinejad; Maziar,25,0,45,20
1746598590347,MAE 101B,A00,886910,Saintillan; David,30,0,45,15
1746598591375,MAE 105,A00,886911,Bandaru; Prabhakar,18,0,50,32
1746598592408,MAE 107,B00,958024,Staff,7,0,50,43
1746598593437,MAE 143B,A00,886913,Bewley; Thomas R,2,0,40,38
1746598594466,MAE 148,A01,886915,Silberman; Jack,0,3,14,14
1746598595495,MAE 160,A00,886916,Evdokimenko; Ekaterina,30,0,60,30
1746598596521,MATH 3C,A01,889681,Staff,0,2,30,30
1746598596521,MATH 3C,A02,960048,Staff,23,0,30,7
1746598597547,MATH 10A,A01,889760,Staff,26,0,30,4
1746598597547,MATH 10A,A02,889783,Staff,29,0,30,1
1746598598572,MATH 10B,A01,889785,Verstraete; Jacques Allan,1,0,35,34
1746598598572,MATH 10B,A02,889795,Verstraete; Jacques Allan,4,0,35,31
1746598598572,MATH 10B,B01,889797,Verstraete; Jacques Allan,3,0,35,32
1746598598572,MATH 10B,B02,889828,Verstraete; Jacques Allan,3,0,35,32
1746598599604,MATH 10C,A01,889849,Habib; Yousaf,8,0,30,22
1746598599604,MATH 10C,A02,889852,Habib; Yousaf,14,0,30,16
1746598599604,MATH 10C,A03,889853,Habib; Yousaf,22,0,30,8
1746598599604,MATH 10C,A04,889858,Habib; Yousaf,20,0,30,10
1746598599604,MATH 10C,B01,889861,Staff,1,0,30,29
1746598599604,MATH 10C,B02,889862,Staff,24,0,30,6
1746598599604,MATH 10C,B03,889863,Staff,27,0,30,3
1746598599604,MATH 10C,B04,889967,Staff,23,0,30,7
1746598600631,MATH 18,A01,889974,Staff,7,0,30,23
1746598600631,MATH 18,A02,889977,Staff,20,0,30,10
1746598600631,MATH 18,B01,889984,Hardiman; Liam,20,0,30,10
1746598600631,MATH 18,B02,889985,Hardiman; Liam,25,0,30,5
1746598601657,MATH 20A,A01,889990,Suk; Andrew Hoon,30,0,35,5
1746598602682,MATH 20B,A01,889993,Ohm; Ko Woon,21,0,30,9
1746598602682,MATH 20B,A02,889994,Ohm; Ko Woon,30,0,30,0
1746598602682,MATH 20B,B01,889996,Ohm; Ko Woon,22,0,30,8
1746598602682,MATH 20B,B02,889997,Ohm; Ko Woon,23,0,30,7
1746598603710,MATH 20C,A01,889999,Hammock; Frances H,17,0,30,13
1746598603710,MATH 20C,A02,890003,Hammock; Frances H,23,0,30,7
1746598603710,MATH 20C,B01,890006,Hammock; Frances H,2,0,30,28
1746598603710,MATH 20C,B02,890007,Hammock; Frances H,12,0,30,18
1746598604737,MATH 20D,A01,890011,Cheng; Hsiao-Bing,0,0,30,30
1746598604737,MATH 20D,A02,890012,Cheng; Hsiao-Bing,14,0,30,16
1746598604737,MATH 20D,B01,890016,Cheng; Hsiao-Bing,13,0,30,17
1746598604737,MATH 20D,B02,890017,Cheng; Hsiao-Bing,13,0,30,17
1746598605768,MATH 20E,A01,890026,Harel; Guershon,1,0,30,29
1746598605768,MATH 20E,A02,890029,Harel; Guershon,22,0,30,8
1746598605768,MATH 20E,B01,890033,Harel; Guershon,7,0,30,23
1746598605768,MATH 20E,B02,890101,Harel; Guershon,21,0,30,9
1746598606793,MATH 102,A01,890104,Staff,18,0,30,12
1746598606793,MATH 102,A02,890105,Staff,27,0,30,3
1746598607821,MATH 103B,A01,890116,Salehi Golsefidy; Alireza,3,0,30,27
1746598607821,MATH 103B,B01,890118,Staff,0,3,34,34
1746598608847,MATH 109,A01,890121,Aliabadi Sr.; Mohsen,0,0,30,30
1746598608847,MATH 109,B01,890124,Upadrashta; Pranav Kumar,18,0,30,12
1746598609872,MATH 120A,A01,890126,Eggers; John Dietrich,13,0,30,17
1746598610897,MATH 142B,A01,890128,Ioana; Adrian,19,0,30,11
1746598610897,MATH 142B,A02,890129,Ioana; Adrian,12,0,30,18
1746598611924,MATH 154,A01,890174,Staff,0,1,30,30
1746598611924,MATH 154,A02,890182,Staff,0,0,30,30
1746598612954,MATH 168A,A01,890197,Dumitriu; Ioana,21,0,35,14
1746598613981,MATH 170A,A01,890240,Nie; Jiawang,1,0,30,29
1746598613981,MATH 170A,A02,890241,Nie; Jiawang,11,0,30,19
1746598613981,MATH 170A,A03,890249,Nie; Jiawang,23,0,30,7
1746598615008,MATH 170B,A01,957891,Nag; Panchali,13,0,35,22
1746598617060,MATH 181A,A01,908025,Staff,0,3,35,35
1746598617060,MATH 181A,A02,960115,Staff,26,0,35,9
1746598618087,MATH 181B,A01,959874,Staff,24,0,30,6
1746598619112,MATH 193B,A01,890265,Staff,0,4,35,35
1746598620193,MGT 4,A01,890311,Anderson; John Charles,42,0,88,46
1746598621219,MGT 5,A00,907740,Staff,12,0,98,86
1746598622244,MGT 12,A00,890312,Lindenberger; Wade Douglas,67,0,98,31
1746598623269,MGT 16,A00,957883,Staff,78,0,98,20
1746598625318,MGT 45,A00,890314,Pecore; Joseph P.,45,0,98,53
1746598626349,MGT 71,A00,890315,Staff,0,12,98,98
1746598627374,MGT 100,A00,890316,Yavorsky; Daniel Ryan,44,0,98,54
1746598628400,MGT 103,A00,890317,Ehrich; Kristine R,73,0,98,25
1746598629427,MGT 105,A00,890356,Bates; Kenneth Walter,0,8,98,98
1746598630454,MGT 112,A00,890360,Ehrich; Kristine R,55,0,98,43
1746598631481,MGT 127R,A00,907732,Zhu; Kevin Xiaoguo,23,0,98,75
1746598632510,MGT 131B,A00,890361,Anderson; John Charles,59,0,98,39
1746598633540,MGT 137,A00,890362,Lindenberger; Wade Douglas,65,0,98,33
1746598634566,MGT 160,A00,890369,Johnson; Erik Barry,9,0,98,89
1746598636614,MGT 164,A00,890372,Zimmermann; Carsten,0,40,98,98
1746598637641,MGT 180,A00,890374,Bliss; Barbara Ann,11,0,98,87
1746598638667,MMW 15,A01,886414,Chang; Edmond Yi-Teh,0,12,28,28
1746598638667,MMW 15,A02,886415,Chang; Edmond Yi-Teh,0,8,28,28
1746598638667,MMW 15,A03,886416,Chang; Edmond Yi-Teh,0,9,28,28
1746598638667,MMW 15,A04,886417,Chang; Edmond Yi-Teh,0,8,28,28
1746598638667,MMW 15,B01,886419,Chang; Edmond Yi-Teh,0,7,28,28
1746598638667,MMW 15,B02,886420,Chang; Edmond Yi-Teh,0,7,28,28
1746598638667,MMW 15,B03,886421,Chang; Edmond Yi-Teh,0,7,28,28
1746598638667,MMW 15,B04,886422,Chang; Edmond Yi-Teh,0,8,28,28
1746598638667,MMW 15,C01,886424,Staff,0,9,28,28
1746598638667,MMW 15,C02,886425,Staff,0,8,28,28
1746598638667,MMW 15,C03,886426,Staff,0,8,28,28
1746598638667,MMW 15,C04,886427,Staff,0,8,28,28
1746598638667,MMW 15,C05,958038,Staff,0,8,28,28
1746598638667,MMW 15,C06,958039,Staff,0,7,28,28
1746598639693,MMW 15GS,A00,906910,Patterson; Patrick H.,4,0,28,24
1746598640718,MMW 122R,A01,886429,Rahimi; Babak,0,13,28,28
1746598640718,MMW 122R,A02,886430,Rahimi; Babak,0,12,28,28
1746598640718,MMW 122R,A03,958040,Rahimi; Babak,0,11,28,28
1746598641747,MUS 1A,A01,890937,Staff,2,0,25,23
1746598641747,MUS 1A,A02,891035,Staff,6,0,25,19
1746598641747,MUS 1A,C01,958912,Staff,24,0,25,1
1746598641747,MUS 1A,C02,958913,Staff,25,0,25,0
1746598643804,MUS 2AK,A00,957092,Ohnishi; Takae,15,0,15,0
1746598644865,MUS 4,A01,891044,Staff,0,0,25,25
1746598644865,MUS 4,A02,891045,Staff,22,0,25,3
1746598644865,MUS 4,B01,891048,Staff,17,0,25,8
1746598644865,MUS 4,B02,891050,Staff,25,0,25,0
1746598645891,MUS 5,A01,957506,Dubnov; Shlomo,0,0,25,25
1746598645891,MUS 5,A02,957622,Dubnov; Shlomo,13,0,25,12
1746598645891,MUS 5,A03,957623,Dubnov; Shlomo,20,0,25,5
1746598646921,MUS 6,A01,891053,Freitas Caetano; Marcelo,24,0,25,1
1746598646921,MUS 6,A02,891054,Freitas Caetano; Marcelo,23,0,25,2
1746598647950,MUS 7,A01,891081,Staff,0,0,25,25
1746598647950,MUS 7,A02,891082,Staff,3,0,25,22
1746598648975,MUS 8GS,A00,891118,Borgo; David Garcia,1,0,25,24
1746598650005,MUS 11,A01,891140,Staff,8,0,25,17
1746598650005,MUS 11,A02,891141,Staff,21,0,25,4
1746598651035,MUS 13,A01,891143,Staff,8,0,25,17
1746598651035,MUS 13,A02,891144,Staff,24,0,25,1
1746598652063,MUS 15,A01,891146,Staff,9,0,25,16
1746598652063,MUS 15,A02,891148,Staff,21,0,25,4
1746598652063,MUS 15,B01,891150,Staff,18,0,25,7
1746598652063,MUS 15,B02,891151,Staff,25,0,25,0
1746598653089,MUS 20,A01,891153,Staff,5,0,20,15
1746598653089,MUS 20,A02,891155,Staff,14,0,20,6
1746598654117,MUS 80,A00,891156,Staff,19,0,25,6
1746598654117,MUS 80,B00,891157,Staff,23,0,25,2
1746598655146,MUS 130,A00,891158,Ohnishi; Takae,35,0,35,0
1746598656175,MUS 150GS,A01,891160,Borgo; David Garcia,1,0,25,24
1746598657200,MUS 170,A01,891162,Freitas Caetano; Marcelo,20,0,25,5
1746598657200,MUS 170,A02,891164,Freitas Caetano; Marcelo,21,0,25,4
1746598658226,NANO 11,A00,886220,Vazquez Mena; Oscar,13,0,15,2
1746598659252,NANO 15,A01,886222,Drews; Aaron,4,0,7,3
1746598660278,NANO 104,A00,886224,Sirbuly; Donald,17,0,25,8
1746598661305,PH 40,A00,886528,Staff,23,0,40,17
1746598662336,PH 45,A01,886799,Staff,35,0,40,5
1746598663360,PH 110,A00,886802,Staff,0,6,40,40
1746598664388,PH 172,A00,906716,Staff,19,0,35,16
1746598665417,PH 191,A00,886803,Staff,6,0,40,34
1746598666444,PHIL 1,A00,889500,Staff,20,0,30,10
1746598667470,PHIL 10,A01,889549,Grush; Rick Scott,16,0,22,6
1746598667470,PHIL 10,A02,889551,Grush; Rick Scott,22,0,22,0
1746598668496,PHIL 28,A01,889559,Lamey; Andy M.,0,2,31,31
1746598668496,PHIL 28,A02,889561,Lamey; Andy M.,0,1,30,30
1746598668496,PHIL 28,A03,889572,Lamey; Andy M.,0,1,30,30
1746598669525,PHIL 35,A00,907839,Staff,13,0,15,2
1746598670549,PHIL 60,A00,889574,Staff,73,0,90,17
1746598671579,PHIL 101,A00,958004,Staff,12,0,15,3
1746598673632,PHIL 136,A00,889582,Fulkerson; Matthew Todd,26,0,45,19
1746598674662,PHIL 163,A01,889601,Staff,21,0,30,9
1746598674662,PHIL 163,B01,889606,Brandt; Reuven A,0,3,0,0
1746598675691,PHIL 164,A00,889610,Staff,16,0,30,14
1746598676719,PHIL 165,A00,889613,Staff,22,0,30,8
1746598677751,PHYS 1A,A00,886431,Staff,30,0,70,40
1746598678777,PHYS 1AL,001,886432,Tsai; Philbert S,0,1,30,30
1746598678777,PHYS 1AL,002,886436,Tsai; Philbert S,13,0,30,17
1746598679801,PHYS 1B,A00,886439,Staff,184,0,240,56
1746598680831,PHYS 1BL,001,886441,Tsai; Philbert S,0,4,30,30
1746598680831,PHYS 1BL,002,886444,Tsai; Philbert S,2,0,30,28
1746598681861,PHYS 1C,A00,896092,Arnold; Kam S,78,0,146,68
1746598682887,PHYS 1CL,001,886448,Tsai; Philbert S,0,0,30,30
1746598682887,PHYS 1CL,002,886449,Tsai; Philbert S,1,0,30,29
1746598682887,PHYS 1CL,003,886450,Tsai; Philbert S,16,0,30,14
1746598682887,PHYS 1CL,004,886451,Tsai; Philbert S,15,0,30,15
1746598683916,PHYS 2B,A01,886457,Staff,67,0,115,48
1746598684945,PHYS 2C,A01,886460,Shotwell; Brian,0,9,65,65
1746598685971,PHYS 2CL,A01,886467,Staff,0,4,28,28
1746598685971,PHYS 2CL,A02,886468,Staff,0,3,28,28
1746598687001,PHYS 2D,A01,886470,Staff,10,0,50,40
1746598688030,PHYS 4B,A01,886475,Grinstein; Benjamin,22,0,40,18
1746598689060,POLI 5,A00,891173,Desposato; Scott,7,0,25,18
1746598690087,POLI 5D,A01,891175,Staff,5,0,5,0
1746598690087,POLI 5D,B01,891178,Staff,5,0,5,0
1746598691113,POLI 11,A00,891179,Ferree; Karen E,0,0,35,35
1746598692142,POLI 12,A00,891180,Staff,15,0,30,15
1746598693168,POLI 27,A01,891182,Staff,11,0,75,64
1746598694194,POLI 30,A00,891183,Staff,8,0,50,42
1746598695223,POLI 100B,A00,891244,Staff,5,1,35,30
1746598696247,POLI 100I,A00,891247,Staff,7,0,30,23
1746598697273,POLI 104J,A00,891248,Nichter; Maysa,14,0,30,16
1746598698300,POLI 104U,A00,891250,Nichter; Maysa,1,0,30,29
1746598700353,POLI 110B,A00,891255,Wiens; David,19,0,25,6
1746598701379,POLI 112A,A00,891256,Wiens; David,6,0,25,19
1746598702416,POLI 114BR,A00,891261,Staff,19,0,30,11
1746598703441,POLI 117R,A00,891262,Forman; Fonna,0,6,50,50
1746598704469,POLI 118,A00,891264,Ingham; Sean,17,0,25,8
1746598705496,POLI 124A,A00,891265,Staff,18,0,20,2
1746598706525,POLI 125D,A00,891266,Nichter; Simeon C,2,0,25,23
1746598707549,POLI 126,A00,891268,Nichter; Simeon C,7,0,25,18
1746598708579,POLI 126AA,A00,891272,Staff,15,0,25,10
1746598709605,POLI 130AA,A00,891273,Staff,15,0,20,5
1746598710631,POLI 134AA,A00,891274,Staff,4,0,20,16
1746598712683,POLI 138,A00,891278,Staff,21,0,25,4
1746598713707,POLI 142K,A00,891280,Staff,10,0,25,15
1746598714733,POLI 142M,A00,891281,Gartzke; Erik,16,0,30,14
1746598715762,POLI 142P,A00,891284,Staff,20,0,30,10
1746598716791,POLI 143,A00,891285,Gartzke; Erik,12,0,30,18
1746598717817,POLI 153,A00,891286,Staff,19,0,20,1
1746598719870,POLI 175,A00,891290,Staff,15,0,20,5
1746598720899,PSYC 1,A00,890674,Steiner; Eric Tomas,0,11,45,45
1746598721927,PSYC 2,A00,890676,Albright; Thomas D,20,0,35,15
1746598722954,PSYC 3,A00,890679,Staff,17,0,20,3
1746598723982,PSYC 6,A00,959858,Staff,19,0,20,1
1746598725009,PSYC 60,A01,890684,Rickard; Timothy C.,0,6,45,45
1746598726037,PSYC 70,A01,890689,Geller; Emma Harlan,6,0,30,24
1746598727063,PSYC 71,A01,959860,Staff,21,0,25,4
1746598728089,PSYC 100,A00,890690,Lacefield; Katharine I,0,50,180,180
1746598729114,PSYC 102,A00,890695,Staff,18,0,40,22
1746598730140,PSYC 105,A00,890699,Geller; Emma Harlan,70,0,100,30
1746598731168,PSYC 106,A00,890701,Gorman; Michael R.,5,0,30,25
1746598732195,PSYC 108,A00,890704,Adrian; Julia Anna,0,29,50,50
1746598733249,PSYC 118,A01,890712,Staff,11,0,30,19
1746598734272,PSYC 124,A00,890716,Chapman; Eddie Nathaniel,25,0,60,35
1746598735300,PSYC 131,A00,890717,Anagnostaras; Stephan,0,7,80,80
1746598736340,PSYC 137,A00,890719,Winkielman; Piotr,0,11,30,30
1746598737365,PSYC 144,A00,890721,Adrian; Julia Anna,0,9,45,45
1746598738390,PSYC 162,A00,890805,Staff,0,1,75,75
1746598739415,PSYC 169,A00,890810,Staff,0,15,30,30
1746598740441,PSYC 172,A00,890814,Gorman; Michael R.,9,0,30,21
1746598741466,PSYC 181,A00,890818,Anagnostaras; Stephan,7,0,200,193
1746598742495,PSYC 184,A00,959861,Staff,162,0,175,13
1746598743520,PSYC 189,A00,890823,Staff,0,2,30,30
1746598744545,PSYC 191,A00,890884,Rickard; Timothy C.,0,11,35,35
1746598745570,PSYC 193,A00,890913,Staff,19,0,30,11
1746598745570,PSYC 193,B00,890914,Chapman; Eddie Nathaniel,24,0,30,6
1746598746601,PSYC 193L,A01,890918,Lowe; Angela Beth,20,0,30,10
1746598746601,PSYC 193L,B01,890921,Hurwitz; Ethan Scott,20,0,30,10
1746598746601,PSYC 193L,C01,890928,Staff,30,0,30,0
1746598747626,RELI 149,A00,886806,Rahimi; Babak,23,0,40,17
1746598748654,SE 9,A01,886814,Staff,7,0,20,13
1746598749687,SE 101B,A01,886816,Chadha; Mayank,3,0,35,32
1746598750711,SE 110B,A00,886818,Zhu; Qiang,4,0,75,71
1746598751736,SE 125,A01,886830,Staff,10,0,30,20
1746598752760,SE 130B,A01,886835,Staff,14,0,40,26
1746598753793,SE 131A,A01,886838,Krysl; Petr,34,0,55,21
1746598754821,SE 154,A00,886840,Staff,28,0,50,22
1746598755849,SE 164GS,A01,886849,Staff,6,0,20,14
1746598756873,SE 167GS,A01,886853,Staff,6,0,20,14
1746598757898,SIO 25,A01,890107,Staff,19,0,30,11
1746598758929,SIO 45,A00,890109,Cook; Geoffrey W,115,0,200,85
1746598759953,SIO 109R,A00,890110,Forman; Fonna,0,16,20,20
1746598760982,SIO 187,A01,890114,Kacev; David,15,0,40,25
1746598762007,SOCI 1,A01,890431,Thorpe; Charles Robert,14,0,30,16
1746598762007,SOCI 1,A02,890518,Thorpe; Charles Robert,30,0,30,0
1746598763032,SOCI 2,A01,957978,Staff,25,0,25,0
1746598763032,SOCI 2,A02,957979,Staff,23,0,25,2
1746598764062,SOCI 20,A01,890523,Calderon-Zaks; Michael Aar,21,0,30,9
1746598764062,SOCI 20,A02,890526,Calderon-Zaks; Michael Aar,29,0,30,1
1746598765087,SOCI 30,A01,890533,Pardo Guerra; Juan Pablo,37,0,40,3
1746598766113,SOCI 40,A01,890535,Staff,27,0,45,18
1746598767141,SOCI 104Q,A00,890559,Staff,18,0,30,12
1746598768167,SOCI 106,A00,890560,Arnal; Maud Marie Leonie,20,0,30,10
1746598769192,SOCI 110,A00,890567,Holkenbrink-Monk; Charlene,19,0,30,11
1746598770221,SOCI 112,A00,890568,Victoria Torres; Pablo,2,0,55,53
1746598771248,SOCI 115,A00,890597,Arnal; Maud Marie Leonie,28,0,45,17
1746598773301,SOCI 121,A00,890604,Pardo Guerra; Juan Pablo,38,0,45,7
1746598774326,SOCI 126,A01,890608,Staff,8,0,10,2
1746598775354,SOCI 127,A00,890609,Staff,18,0,30,12
1746598776379,SOCI 131,A00,890610,Thorpe; Charles Robert,37,0,45,8
1746598777407,SOCI 135,A00,890615,Payne; Christine Anna,14,0,45,31
1746598778431,SOCI 139,A00,890620,Staff,38,0,45,7
1746598779456,SOCI 148E,A00,890622,Calderon-Zaks; Michael Aar,36,0,45,9
1746598780480,SOCI 150,A00,890623,Kohler; Kristopher M.,31,0,45,14
1746598781505,SOCI 157,A00,890625,Jules-Rosette; Bennetta W.,18,0,20,2
1746598782530,SOCI 160,A00,890627,Payne; Christine Anna,21,0,45,24
1746598783554,SYN 1,A00,886855,Fish; Gwendolyn Anne,0,1,0,0
1746598783554,SYN 1,B00,906086,Fish; Gwendolyn Anne,0,2,0,2
1746598784580,SYN 2R,A00,886860,Staff,0,17,15,15
1746598784580,SYN 2R,B00,906106,Atkinson; Arthur Laird,0,16,15,15
1746598785606,SYN 100,A01,886866,Browne; Emily,0,28,20,20
1746598785606,SYN 100,B01,906128,Rock; Martin,0,4,20,20
1746598785606,SYN 100,C01,906140,Deavenport; James Cary,0,4,20,20
1746598785606,SYN 100,D01,907816,Deavenport; James Cary,0,5,20,20
1746598786632,TDAC 1,A00,890286,Walsh; Kim C.,7,0,20,13
1746598787657,TDAC 101,A00,890296,Basso; Beatrice,15,0,20,5
1746598788684,TDDE 131,A00,890297,Staff,47,0,50,3
1746598789710,TDDM 1,A00,890287,Weinberg; Sadie,25,0,30,5
1746598790739,TDGE 11,A00,890288,Fulton; Julia,138,0,200,62
1746598790739,TDGE 11,B00,890289,Castro; Robert Jess,184,0,200,16
1746598791763,TDGE 25,B00,957359,Walsh; Kim C.,5,0,20,15
1746598792789,TDGE 40,A01,890292,Power; Jade Yukana,26,0,30,4
1746598793814,TDGE 124,A00,890298,Havis; Allan,0,2,50,50
1746598794840,TDGE 131R,A00,890299,Burelle; Julie Sara Veronique,15,0,42,27
1746598795865,TDHT 101,A00,890300,Staff,10,0,20,10
1746598796914,TDHT 109,A01,890302,Anderson; Mysia Anyse,31,0,40,9
1746598797939,TDMV 1,A00,890293,Arcidiacono; Kristin,18,0,30,12
1746598798964,TDMV 2,A00,890294,Weinberg; Sadie,23,0,30,7
1746598799994,TDMV 3,A00,957878,Arcidiacono; Kristin,28,0,30,2
1746598802045,TDMV 138,A00,890304,Jun; Grace Shin Hae,25,0,40,15
1746598803071,TDMV 140,A00,890305,Corrales; Joseph Bernales,25,0,30,5
1746598804097,TDMV 142,A00,890307,Caligagan; Tony,32,0,40,8
1746598805127,TDMV 144,A00,890308,Camaya; Michelle Ann,25,0,30,5
1746598806153,TDPW 1,A00,890295,Stein; Deborah Isobel,3,0,20,17
1746598807182,USP 2,A01,890272,Lerner; Amy M,7,0,20,13
1746598808210,USP 3,A01,890274,Staff,12,0,30,18
1746598809239,USP 15,A01,890276,Sun; Feiyang,16,0,30,14
1746598810268,USP 25,A00,890277,Shenkman; Michael Thomas,18,0,25,7
1746598811292,USP 138,A00,890278,Staff,13,0,25,12
1746598812318,USP 143,A00,890279,Staff,21,0,70,49
1746598813341,USP 144,A00,890280,Chowdhury; Muhammed Zohir,16,0,30,14
1746598814366,USP 150,A00,890281,Boomhower; Matthew Charles,4,0,30,26
1746598815395,USP 151,A00,890282,Staff,16,0,20,4
1746598816419,USP 162,A00,890283,Andrews; Abigail Leslie,16,0,20,4
1746598817446,USP 168,A00,920477,Kwak; Nancy,0,0,5,5
1746598818475,USP 181,A00,890284,Staff,3,0,20,17
1746598819502,USP 191A,A00,890285,Staff,12,0,20,8
1746598820528,VIS 101,A00,886512,Staff,26,0,75,49
1746598821557,VIS 103,A00,886513,Cruz; Edwin Teddy,61,0,75,14
1746598822582,VIS 108,A00,886514,Staff,4,0,15,11
1746598823609,VIS 127P,A00,886515,Shen; Kuiyi,80,0,146,66
1746598824639,VIS 149,A00,886516,Yoldas; Pinar,0,0,15,15
1746598825664,VIS 164,A00,886526,Erdmann; Dean,19,0,22,3
1746598826692,VIS 194S,A00,886527,Staff,61,0,75,14
1746598827723,WCWP 10A,C00,886484,Martiniuk; Jill,12,0,15,3
1746598828748,WCWP 10B,A00,886490,Uriarte; Emma,0,0,15,15
1746598828748,WCWP 10B,B00,886491,Dhir; Simrita,8,0,15,7
1746598828748,WCWP 10B,C00,886492,Ornelas; Tricia,0,0,15,15
1746598829778,WCWP 100,A00,886494,Young; Mark T,0,6,15,15
1746598831910,AAS 10,A01,886199,Childs; Dennis R.,0,3,0,0
1746598832937,ANAR 104,A01,886940,Shtienberg; Gilad,27,0,30,3
1746598833964,ANAR 120,A00,886953,Staff,13,0,20,7
1746598834988,ANBI 148,A01,886955,Wilder; Linnea Lorene,30,0,40,10
1746598837040,ANSC 122,A00,886957,Staff,24,0,30,6
1746598838066,ANSC 150,A00,886958,Sloane; Julia Kathryn,2,0,15,13
1746598839091,ANSC 156,A00,886959,Jenkins; Janis A.,0,1,15,15
1746598840116,ANSC 180,A00,886960,Staff,11,0,17,6
1746598841142,ANSC 188,A00,886961,Jassal; Aftab,9,0,25,16
1746598842168,ANSC 190,A00,886962,Jassal; Aftab,14,0,25,11
1746598843198,ANSC 191,A00,886963,Staff,18,0,20,2
1746598844227,ANTH 3,A01,891689,Staff,17,0,20,3
1746598845260,ANTH 5,A00,886933,Semendeferi; Ekaterini,16,0,20,4
1746598846284,ANTH 10,A00,886934,Staff,0,12,30,30
1746598847313,ANTH 21,A01,886936,Staff,41,0,60,19
1746598848338,ANTH 23,A01,886938,Staff,92,0,100,8
1746598849363,ANTH 105,A00,886964,Stewart; Alexander B,84,0,100,16
1746598850389,ANTH 108,A00,886965,Pedersen; David,9,0,20,11
1746598851424,AWP 10,001,886147,Staff,0,0,0,0
1746598851424,AWP 10,002,886148,Staff,0,0,0,0
1746598851424,AWP 10,003,886149,Staff,0,0,0,0
1746598851424,AWP 10,004,886150,Staff,0,0,0,0
1746598851424,AWP 10,005,886151,Staff,0,0,0,0
1746598851424,AWP 10,006,886152,Staff,0,0,0,0
1746598851424,AWP 10,007,886153,Staff,0,0,0,0
1746598851424,AWP 10,008,886154,Staff,0,0,0,0
1746598851424,AWP 10,009,886155,Staff,0,0,0,0
1746598851424,AWP 10,010,886156,Staff,0,0,0,0
1746598851424,AWP 10,011,886158,Staff,0,0,0,0
1746598851424,AWP 10,012,886160,Staff,0,0,0,0
1746598851424,AWP 10,013,886161,Staff,0,0,0,0
1746598851424,AWP 10,014,886162,Staff,0,0,0,0
1746598851424,AWP 10,015,886163,Staff,0,0,0,0
1746598851424,AWP 10,016,886164,Staff,0,0,0,0
1746598851424,AWP 10,017,886165,Staff,0,0,0,0
1746598851424,AWP 10,018,886166,Staff,0,0,0,0
1746598851424,AWP 10,019,886168,Staff,0,0,0,0
1746598851424,AWP 10,020,886170,Staff,0,0,0,0
1746598851424,AWP 10,021,886172,Staff,0,0,0,0
1746598852450,AWP 10R,001,886173,Staff,0,1,0,0
1746598852450,AWP 10R,002,886174,Staff,0,1,0,0
1746598852450,AWP 10R,003,886175,Staff,0,0,0,0
1746598852450,AWP 10R,004,886176,Staff,0,0,0,0
1746598852450,AWP 10R,005,886177,Staff,0,0,0,0
1746598852450,AWP 10R,006,886178,Staff,0,0,0,0
1746598852450,AWP 10R,007,886179,Staff,0,0,0,0
1746598852450,AWP 10R,008,886181,Staff,0,0,0,0
1746598852450,AWP 10R,009,886182,Staff,0,0,0,0
1746598852450,AWP 10R,010,886183,Staff,0,0,0,0
1746598852450,AWP 10R,011,886184,Staff,0,0,0,0
1746598852450,AWP 10R,012,886185,Staff,0,0,0,0
1746598852450,AWP 10R,013,886186,Staff,0,0,0,0
1746598852450,AWP 10R,014,886187,Staff,0,0,0,0
1746598852450,AWP 10R,015,886188,Staff,0,0,0,0
1746598852450,AWP 10R,016,886189,Staff,0,0,0,0
1746598852450,AWP 10R,017,960532,Staff,0,0,0,0
1746598852450,AWP 10R,018,960533,Staff,0,0,0,0
1746598852450,AWP 10R,019,960534,Staff,0,0,0,0
1746598852450,AWP 10R,020,960538,Staff,0,0,0,0
1746598852450,AWP 10R,021,960540,Staff,0,0,0,0
1746598852450,AWP 10R,022,960541,Staff,0,0,0,0
1746598852450,AWP 10R,023,960542,Staff,0,0,0,0
1746598852450,AWP 10R,024,960544,Staff,0,0,0,0
1746598852450,AWP 10R,025,960545,Staff,0,0,0,0
1746598852450,AWP 10R,026,960548,Staff,0,0,0,0
1746598853477,AWP 102R,A00,886190,Staff,0,0,0,0
1746598853477,AWP 102R,B00,886191,Staff,0,0,0,0
1746598854506,BENG 100,A01,886193,Staff,17,0,30,13
1746598855532,BENG 122A,A01,886195,Hasty; Jeff M,13,0,30,17
1746598856556,BENG 166A,A00,886196,Sah; Robert Lie-Yuan,0,3,30,30
1746598857582,BENG 190,A00,958050,Khojah; Reem I,17,0,25,8
1746598858608,BIBC 102,A01,894320,Staff,0,1,46,46
1746598858608,BIBC 102,A02,894321,Staff,0,0,46,46
1746598858608,BIBC 102,A03,894344,Staff,6,0,46,40
1746598858608,BIBC 102,A04,894345,Staff,27,0,47,20
1746598859637,BICD 100R,A01,894365,Smith; Laurie,0,2,58,58
1746598859637,BICD 100R,A02,894366,Smith; Laurie,0,4,58,58
1746598859637,BICD 100R,A03,894367,Smith; Laurie,0,0,59,59
1746598859637,BICD 100R,A04,959869,Smith; Laurie,38,0,59,21
1746598860669,BICD 136,A01,894383,Gustafson-Brown; Cindy,14,0,50,36
1746598861698,BIEB 102,A01,894494,Butler; Shannon Rhey,51,0,130,79
1746598863750,BIEB 150,A01,894617,Wills; Christopher,3,0,20,17
1746598863750,BIEB 150,A02,894631,Wills; Christopher,3,0,20,17
1746598863750,BIEB 150,A03,894937,Wills; Christopher,3,0,20,17
1746598863750,BIEB 150,A04,894946,Wills; Christopher,5,0,20,15
1746598864777,BIEB 194,A00,906141,Kurle; Carolyn M.,5,0,20,15
1746598865804,BILD 1,A01,894154,Staff,3,0,19,16
1746598865804,BILD 1,A02,894155,Staff,14,0,19,5
1746598865804,BILD 1,A03,894160,Staff,13,0,19,6
1746598865804,BILD 1,A04,894161,Staff,15,0,18,3
1746598866834,BILD 2,A01,894168,Staff,0,0,50,50
1746598866834,BILD 2,A02,894169,Staff,0,0,50,50
1746598866834,BILD 2,A03,894179,Staff,0,0,50,50
1746598866834,BILD 2,A04,894203,Staff,22,0,50,28
1746598867863,BILD 3,A01,894213,Staff,23,0,31,8
1746598867863,BILD 3,A02,894214,Staff,26,0,31,5
1746598867863,BILD 3,A03,894235,Staff,28,0,31,3
1746598867863,BILD 3,A04,894236,Staff,28,0,32,4
1746598868889,BILD 4,A01,894253,Reuther; Keefe,5,0,24,19
1746598868889,BILD 4,A02,894258,Reuther; Keefe,16,0,24,8
1746598869915,BILD 5,A01,894276,Reuther; Keefe,34,0,50,16
1746598869915,BILD 5,A02,894277,Reuther; Keefe,45,0,50,5
1746598869915,BILD 5,A03,894290,Reuther; Keefe,44,0,50,6
1746598869915,BILD 5,A04,894291,Reuther; Keefe,48,0,50,2
1746598870940,BILD 24,A01,894297,Pirino; Giorgia,40,0,60,20
1746598871977,BIMM 100,B01,958915,Staff,71,0,100,29
1746598873006,BIMM 101,A01,895017,McDonnell; Lisa Marie,0,5,24,24
1746598873006,BIMM 101,A02,895018,McDonnell; Lisa Marie,0,5,24,24
1746598873006,BIMM 101,B01,895020,McDonnell; Lisa Marie,0,5,24,24
1746598873006,BIMM 101,B02,895021,McDonnell; Lisa Marie,0,4,24,24
1746598874034,BIMM 110,A01,895023,Staff,1,0,25,24
1746598874034,BIMM 110,A02,895024,Staff,9,0,25,16
1746598874034,BIMM 110,A03,895025,Staff,18,0,25,7
1746598874034,BIMM 110,A04,895031,Staff,20,0,25,5
1746598875059,BIMM 120,A01,895114,Gustafson-Brown; Cindy,14,0,28,14
1746598875059,BIMM 120,A02,895126,Gustafson-Brown; Cindy,21,0,27,6
1746598876086,BIPN 100,A01,895130,Yang; Mingyu,0,0,38,38
1746598876086,BIPN 100,A02,895131,Yang; Mingyu,31,0,38,7
1746598876086,BIPN 100,A03,895132,Yang; Mingyu,32,0,38,6
1746598876086,BIPN 100,A04,895133,Yang; Mingyu,27,0,36,9
1746598877117,BIPN 120,A01,895135,Cooke; James Edward,0,3,13,13
1746598877117,BIPN 120,A02,895136,Cooke; James Edward,0,1,13,13
1746598877117,BIPN 120,A03,895137,Cooke; James Edward,0,3,13,13
1746598877117,BIPN 120,A04,895156,Cooke; James Edward,0,2,11,11
1746598878147,BIPN 134,A01,895235,Cooke; James Edward,0,1,25,25
1746598878147,BIPN 134,A02,895237,Cooke; James Edward,0,0,25,25
1746598878147,BIPN 134,A03,895240,Cooke; James Edward,1,0,25,24
1746598878147,BIPN 134,A04,895270,Cooke; James Edward,20,0,25,5
1746598879173,BIPN 189,A00,892103,Staff,0,14,14,14
1746598881227,BISP 194,A00,958008,Staff,0,2,0,0
1746598882252,CAT 124,A01,922009,Staff,0,5,20,20
1746598883280,CAT 125R,A00,886390,Morales; Celeste Georgianna,0,3,20,20
1746598883280,CAT 125R,B00,886391,Irwin; Matthew Joseph,0,4,20,20
1746598883280,CAT 125R,C00,886392,Smith; Lauryn Alissa,0,2,20,20
1746598883280,CAT 125R,D00,886393,Vanderschuit; Maya Alysia,0,3,20,20
1746598883280,CAT 125R,E00,886394,Marchisotto; Jennifer Anne,0,3,20,20
1746598884310,CENG 15,A01,886218,Drews; Aaron,3,0,8,5
1746598885333,CENG 113,A00,886219,Opatkiewicz; Justin Paul,15,0,25,10
1746598886360,CGS 101,A00,887044,Staff,7,0,20,13
1746598887389,CGS 105,A01,887046,Staff,14,0,25,11
1746598888468,CGS 112,A00,887047,Cuong; Marisol,12,0,15,3
1746598889499,CGS 113,A00,887048,Staff,23,0,30,7
1746598890524,CGS 120,A00,887049,Staff,10,0,17,7
1746598891549,CHEM 6A,A01,886336,Lam; Tin Yiu,38,0,50,12
1746598891549,CHEM 6A,A02,886338,Lam; Tin Yiu,37,0,50,13
1746598892579,CHEM 6B,A01,886341,Hopkins; Patrycja Anna,16,0,50,34
1746598892579,CHEM 6B,A02,886343,Hopkins; Patrycja Anna,42,0,50,8
1746598893605,CHEM 6C,A01,886346,Albizati; Kim F.,0,2,50,50
1746598893605,CHEM 6C,A02,886348,Albizati; Kim F.,24,0,50,26
1746598894636,CHEM 40A,A01,886352,Klosterman; Jeremy K,65,0,100,35
1746598895660,CHEM 40B,A01,886356,Klosterman; Jeremy K,0,24,100,100
1746598896686,CHEM 41B,A01,886360,Theodorakis; Emmanuel,25,0,50,25
1746598896686,CHEM 41B,A02,886362,Theodorakis; Emmanuel,47,0,50,3
1746598897711,CHIN 165A,A00,886382,Xu; Li,18,0,20,2
1746598898738,CLAS 120,A00,886387,Myerston Santana; Jacobo,33,0,40,7
1746598899767,COGS 9,A01,886967,Shannon; Kyle Michael,42,0,60,18
1746598900792,COGS 11,A01,886969,Staff,9,0,30,21
1746598901817,COGS 14A,A01,886971,Staff,5,0,60,55
1746598902842,COGS 14B,A01,886973,Hoffman; Drew Ellen,4,0,60,56
1746598903872,COGS 18,A01,886975,Morgan; Eric,34,0,60,26
1746598904900,COGS 20,A01,886977,Staff,3,0,8,5
1746598904900,COGS 20,A02,886978,Staff,5,0,7,2
1746598905926,COGS 100,A01,907783,Staff,0,1,30,30
1746598906951,COGS 101B,A01,886980,Staff,0,4,48,48
1746598907978,COGS 101C,A01,886982,Delgado; Tania,0,5,44,44
1746598909004,COGS 102A,A01,886984,Johnson; Christine M.,3,0,30,27
1746598910030,COGS 118B,A01,886986,Staff,0,4,88,88
1746598911054,COGS 150,A01,886988,Bergen; Benjamin,22,0,50,28
1746598912079,COGS 153,A00,886989,Delgado; Tania,0,3,41,41
1746598913109,COGS 186,A01,886991,Staff,0,0,32,32
1746598914135,COGS 187A,A01,886993,Boyle; Mary E. T.,7,0,30,23
1746598915160,COGS 189,A00,886994,Staff,0,1,30,30
1746598916186,COMM 10,A01,886996,Staff,0,0,20,21
1746598916186,COMM 10,A02,886997,Staff,10,0,20,10
1746598916186,COMM 10,A03,959845,Staff,19,0,20,1
1746598917211,COMM 20,A01,886999,Leuning; Grant Maurstad,24,0,40,16
1746598919270,COMM 100A,A01,887002,Staff,0,0,20,25
1746598919270,COMM 100A,A02,887003,Staff,5,0,20,15
1746598920295,COMM 100B,A01,887005,Staff,0,8,20,24
1746598921319,COMM 106D,A00,887006,Staff,14,0,40,26
1746598922347,COMM 110G,A00,887007,Whitworth-Smith; Andrew C,12,0,40,28
1746598923374,COMM 111B,A00,887008,Staff,31,0,40,9
1746598924398,COMM 113T,A00,887009,Abuelhiga; Soraya Jill,28,0,40,12
1746598924398,COMM 113T,B00,906733,Staff,39,0,40,1
1746598925427,COMM 145,A00,887010,Staff,13,0,40,27
1746598926452,COMM 146,A00,887054,Staff,32,0,40,8
1746598927476,COMM 190,A00,887012,Staff,8,0,23,15
1746598928503,CSE 8A,A50,887015,Cao; Yingjun,56,0,85,29
1746598929528,CSE 11,A01,887017,Cao; Yingjun,11,0,70,59
1746598930553,CSE 20,A01,887019,Staff,30,0,50,20
1746598931585,CSE 21,A01,887021,Staff,79,0,100,21
1746598931585,CSE 21,B01,892583,Braun; Oliver,45,0,50,5
1746598932612,CSE 30,A01,887025,Eldon; John,142,0,200,58
1746598933643,CSE 100,A01,887027,Staff,26,0,50,24
1746598933643,CSE 100,A02,887028,Staff,42,0,50,8
1746598934674,CSE 101,A01,887030,Braun; Oliver,74,0,100,26
1746598934674,CSE 101,B01,887032,Jones; Miles E,0,3,50,50
1746598934674,CSE 101,B02,887033,Jones; Miles E,0,2,50,50
1746598935698,CSE 105,A01,908084,Jones; Miles E,32,0,50,18
1746598935698,CSE 105,A02,908087,Jones; Miles E,31,0,50,19
1746598936731,CSE 135,A01,887035,Powell; Thomas Allan,0,5,50,50
1746598937758,CSE 142,A01,887037,Staff,8,0,60,52
1746598938783,CSE 142L,A01,887039,Staff,34,0,60,26
1746598939809,CSE 151A,A01,887041,Solares; Edwin A,47,0,100,53
1746598940835,CSE 175,A01,887043,Kumar; Rakesh,30,0,30,0
1746598941863,CSS 1,A01,886389,Staff,0,1,40,40
1746598942889,DSC 30,A01,908097,Liao; Soohyun Nam,47,0,75,28
1746598943915,DSC 40A,A01,908099,Shannon; Kyle Michael,30,0,50,20
1746598944940,DSC 40B,A01,908112,Staff,15,0,50,35
1746598945971,DSC 80,A01,908116,Staff,19,0,60,41
1746598946999,DSC 197,001,956863,Eldridge; Justin Matthew,9999,0,9999,0
1746598948024,ECE 5,A01,886400,Morris; Karcher William,1,0,6,5
1746598948024,ECE 5,A02,886401,Morris; Karcher William,3,0,6,3
1746598949050,ECE 148,A01,886403,Silberman; Jack,0,14,14,14
1746598950077,ECON 1,A01,887265,Crane; Meredith Helen,11,0,70,59
1746598950077,ECON 1,B01,887268,Staff,42,0,50,8
1746598951103,ECON 2,A01,887273,Crane; Meredith Helen,54,0,70,16
1746598952135,ECON 3,A01,887279,Rondina; Giacomo,31,0,70,39
1746598953158,ECON 4,A01,887282,Anderson; John Charles,0,2,10,10
1746598954184,ECON 5,A01,887285,Staff,34,0,45,11
1746598954184,ECON 5,B01,887292,Staff,41,0,45,4
1746598955210,ECON 100A,A01,887337,Newhouse; Herbert S,54,0,70,16
1746598955210,ECON 100A,B01,887349,Staff,45,0,50,5
1746598956236,ECON 100B,A01,887361,Du; Songzi,29,0,70,41
1746598957261,ECON 100C,A01,887445,Newhouse; Herbert S,59,0,70,11
1746598958290,ECON 105,A00,887488,Vespa; Emanuel Ignacio,23,0,35,12
1746598959315,ECON 109,A01,887506,Shishkin; Denis,28,0,35,7
1746598960342,ECON 110A,A01,887568,Alon; Titan Michael,0,2,35,35
1746598960342,ECON 110A,B01,907601,Alon; Titan Michael,20,0,35,15
1746598961367,ECON 110B,A01,887598,Levkoff; Steven B.,0,24,70,70
1746598962392,ECON 112,A00,887599,Rondina; Giacomo,19,0,35,16
1746598963431,ECON 120A,A01,887603,Dai; Yinlin,35,0,70,35
1746598964460,ECON 120C,A01,887608,Sun; Yixiao,0,1,35,35
1746598964460,ECON 120C,B01,887614,Sun; Yixiao,0,0,35,35
1746598965487,ECON 138,A00,887621,Bharadwaj; Prashant,0,21,20,20
1746598966512,ECON 144,A00,958007,Squires; Dale E,12,0,35,23
1746598967541,ECON 171,A01,907666,Staff,18,0,35,17
1746598968568,ECON 175,A00,887626,Wu; Pak Yeung,22,0,35,13
1746598969601,ECON 190,A00,887640,Vespa; Emanuel Ignacio,22,0,35,13
1746598970637,EDS 25,A01,888197,Staff,0,0,0,0
1746598970637,EDS 25,A02,888209,Staff,0,0,0,0
1746598970637,EDS 25,A03,888210,Staff,0,0,0,0
1746598970637,EDS 25,A04,888212,Staff,0,0,0,0
1746598970637,EDS 25,A05,888213,Staff,0,0,0,0
1746598970637,EDS 25,A06,888214,Staff,0,0,0,0
1746598970637,EDS 25,A07,888235,Staff,0,2,0,0
1746598970637,EDS 25,A08,888236,Staff,0,0,0,0
1746598970637,EDS 25,A09,888240,Staff,0,0,0,0
1746598970637,EDS 25,A10,888244,Staff,0,0,0,0
1746598970637,EDS 25,B01,888273,Staff,0,0,0,0
1746598970637,EDS 25,B02,888285,Staff,0,0,0,0
1746598970637,EDS 25,B03,888423,Staff,0,0,0,1
1746598970637,EDS 25,B04,888432,Staff,0,0,0,0
1746598970637,EDS 25,B05,888433,Staff,0,0,0,0
1746598970637,EDS 25,B06,888467,Staff,0,0,0,0
1746598970637,EDS 25,B07,888468,Staff,0,0,0,0
1746598970637,EDS 25,B08,888479,Staff,0,0,0,0
1746598970637,EDS 25,B09,888484,Staff,0,0,0,0
1746598970637,EDS 25,B10,888487,Staff,0,0,0,0
1746598971662,EDS 38,A01,907700,Choi; Bailey Miyeon,30,0,30,0
1746598972689,EDS 112,A01,888601,Chapman; Thandeka K,12,0,40,28
1746598973714,EDS 115,A00,888697,Mendez; Kathrina Mendoza,10,0,30,20
1746598974740,EDS 116,A01,888893,Staff,33,0,40,7
1746598976793,EDS 124AR,A00,889133,Staff,29,0,50,21
1746598976793,EDS 124AR,B00,907471,Simon; Elizabeth A,37,0,50,13
1746598977822,EDS 124BR,A00,889134,Simon; Elizabeth A,44,0,100,56
1746598978846,EDS 125,A00,889135,Staff,25,0,30,5
1746598979874,EDS 126,A01,889138,Staff,35,0,40,5
1746598980899,EDS 164R,A01,889142,Wishard Guerra; Alison G.,32,0,50,18
1746598981929,ENG 30,A01,886396,Staff,0,0,0,0
1746598981929,ENG 30,B01,886398,Staff,0,0,0,0
1746598982954,ENVR 102,A00,906150,Montejo; Carolina,23,0,25,2
1746598983982,ETHN 103A,A00,887236,Man; Simeon S,0,2,0,0
1746598985008,ETHN 113,A00,887239,Staff,16,0,30,14
1746598986033,ETHN 116,A00,887240,Staff,16,0,25,9
1746598987061,ETHN 117,A00,887241,Choi; Esther Min,28,0,30,2
1746598988084,ETHN 118,A00,887243,Staff,24,0,30,6
1746598989113,ETHN 127,A00,887248,Cuong; Marisol,11,0,15,4
1746598990138,ETHN 139,A00,887250,Staff,7,0,10,3
1746598991164,ETHN 142,A00,887252,Staff,10,0,30,20
1746598992192,ETHN 161,A00,887253,Browne; Errol Tsekani,24,0,30,6
1746598993219,ETHN 163FR,A00,887255,Burelle; Julie Sara Veronique,0,0,5,5
1746598994244,GLBH 20,A00,889149,Elwardani; Nile Regina,8,0,42,34
1746598996299,GLBH 111,A01,889152,Burgos; Jose L.,17,0,17,0
1746598997324,GLBH 150,A00,889181,Sloane; Julia Kathryn,0,5,15,15
1746598999378,HDS 60,A01,886406,Warstadt; Melissa Fawn,72,0,80,8
1746599000406,HIAF 111,A00,889324,Gyamfi; Bright,25,0,32,7
1746599001431,HIEA 131,A00,889328,Staff,15,0,32,17
1746599002461,HIEA 144,A00,889333,Henry; Todd A.,26,0,32,6
1746599003490,HIEA 154,A00,889336,Henry; Todd A.,24,0,32,8
1746599004513,HIEU 106,A00,889339,Staff,22,0,32,10
1746599006628,HIEU 114,A00,889340,Staff,4,0,32,28
1746599007654,HIEU 135GS,A00,889342,Patterson; Patrick H.,0,0,1,24
1746599008681,HIEU 137,A00,889343,Edington; Claire Ellen,10,0,25,15
1746599009708,HIEU 148,A00,889345,Staff,14,0,32,18
1746599010738,HIEU 154,A00,889346,Biess; Frank Peter,21,0,32,11
1746599011770,HILA 102,A00,889351,Staff,12,0,32,20
1746599012798,HILD 2A,A01,889221,Lewandoski; Julia Mavis,0,8,32,32
1746599013822,HILD 7B,A01,889225,Man; Simeon S,0,12,32,32
1746599014854,HILD 7C,A01,889288,Alvarez; Luis A,0,14,32,32
1746599015883,HILD 30,A01,889323,Staff,0,5,32,32
1746599017942,HISC 119,A00,889383,Golan; Tal,20,0,32,12
1746599018970,HIUS 103,A00,889384,Man; Simeon S,0,0,32,32
1746599020002,HIUS 117,A00,919797,Kwak; Nancy,18,0,32,14
1746599021031,HIUS 142A,A00,919788,Staff,22,0,32,10
1746599023107,HIUS 149,A00,889386,Gyamfi; Bright,26,0,32,6
1746599024132,HIUS 155,A00,889387,Alvarez; Luis A,15,0,32,17
1746599025158,HUM 3,A01,886499,Caldwell; Michael Alan,19,0,50,31
1746599026182,HUM 3GS,A00,886500,Rodriguez; Bretton Sigfred,0,0,0,28
1746599027209,HUM 3R,A01,886502,Markman; Kristina,0,36,50,50
1746599028235,HUM 4,A01,886504,Crum; Matthew Stephen,23,0,50,27
1746599028235,HUM 4,B01,886506,West; Geoffrey Scott,17,0,50,33
1746599029257,HUM 4GS,A00,886507,Staff,0,0,0,19
1746599030284,HUM 5,A01,886509,Staff,31,0,50,19
1746599031312,HUM 5R,A01,886511,Zavodny; Tatiana Sophia,0,39,50,50
1746599032337,JAPN 180,A00,886407,Staff,16,0,40,24
1746599033368,LATI 50,A01,886409,Martin-Cabrera; Luis,3,0,22,19
1746599033368,LATI 50,A02,886410,Martin-Cabrera; Luis,19,0,22,3
1746599033368,LATI 50,A03,886411,Martin-Cabrera; Luis,21,0,22,1
1746599033368,LATI 50,A04,886412,Martin-Cabrera; Luis,8,0,22,14
1746599034398,LAWS 101,A00,907664,Staff,28,0,60,32
1746599035427,LIAB 1A,A00,889388,Saab; Dima,17,0,20,3
1746599036455,LIAB 1AX,A00,889389,El Cheddadi; Youniss,18,0,20,2
1746599037484,LIFR 1C,A00,889391,Van Moer; Vinciane G,8,0,20,12
1746599038510,LIFR 1CX,A00,889392,Van Moer; Vinciane G,7,0,20,13
1746599039539,LIFR 1D,A00,889393,Van Moer; Vinciane G,7,0,20,13
1746599040572,LIFR 1DX,A00,889394,Van Moer; Vinciane G,8,0,20,12
1746599041597,LIGN 7,A00,886923,Staff,25,0,50,25
1746599042627,LIGN 17,A00,886924,Kehler; Andrew Scott,126,0,150,24
1746599043656,LTAM 110,A00,889395,Staff,15,0,30,15
1746599044681,LTAM 110GS,A00,958010,Rodriguez; Bretton Sigfred,0,0,0,28
1746599045708,LTCH 101,A00,889397,Staff,23,0,25,2
1746599046735,LTCS 130,A00,889398,Staff,23,0,25,2
1746599047764,LTEA 138,A00,889399,Staff,24,0,40,16
1746599048788,LTEN 149,A00,889400,Wesling; Megan E.,0,3,25,25
1746599049813,LTEN 169,A00,889401,Staff,20,0,25,5
1746599050841,LTEN 180,A00,889402,Staff,10,0,15,5
1746599051867,LTEN 181,A00,889403,Staff,21,0,25,4
1746599052895,LTWL 100,A00,889404,Myerston Santana; Jacobo,2,0,25,23
1746599053924,LTWL 180GS,A00,889405,Staff,0,0,20,20
1746599054949,LTWL 181,A00,889406,Staff,16,0,25,9
1746599055975,LTWL 184,A00,889475,Mukherjee; Silpa,22,0,25,3
1746599056999,LTWR 102C,A00,889486,Staff,29,0,30,1
1746599058026,LTWR 115W,A00,889491,Staff,0,2,15,15
1746599059051,MAE 8,A01,886905,Staff,0,2,0,0
1746599060077,MAE 11,A00,886906,Bandaru; Prabhakar,0,7,50,50
1746599061104,MAE 20,A00,886907,Evdokimenko; Ekaterina,43,0,70,27
1746599062133,MAE 30B,A00,886909,Ghazinejad; Maziar,25,0,45,20
1746599063162,MAE 101B,A00,886910,Saintillan; David,30,0,45,15
1746599064192,MAE 105,A00,886911,Bandaru; Prabhakar,18,0,50,32
1746599065216,MAE 107,B00,958024,Staff,7,0,50,43
1746599066246,MAE 143B,A00,886913,Bewley; Thomas R,2,0,40,38
1746599067272,MAE 148,A01,886915,Silberman; Jack,0,3,14,14
1746599068300,MAE 160,A00,886916,Evdokimenko; Ekaterina,30,0,60,30
1746599069324,MATH 3C,A01,889681,Staff,0,2,30,30
1746599069324,MATH 3C,A02,960048,Staff,23,0,30,7
1746599070351,MATH 10A,A01,889760,Staff,26,0,30,4
1746599070351,MATH 10A,A02,889783,Staff,29,0,30,1
1746599071379,MATH 10B,A01,889785,Verstraete; Jacques Allan,1,0,35,34
1746599071379,MATH 10B,A02,889795,Verstraete; Jacques Allan,4,0,35,31
1746599071379,MATH 10B,B01,889797,Verstraete; Jacques Allan,3,0,35,32
1746599071379,MATH 10B,B02,889828,Verstraete; Jacques Allan,3,0,35,32
1746599072407,MATH 10C,A01,889849,Habib; Yousaf,8,0,30,22
1746599072407,MATH 10C,A02,889852,Habib; Yousaf,14,0,30,16
1746599072407,MATH 10C,A03,889853,Habib; Yousaf,22,0,30,8
1746599072407,MATH 10C,A04,889858,Habib; Yousaf,20,0,30,10
1746599072407,MATH 10C,B01,889861,Staff,1,0,30,29
1746599072407,MATH 10C,B02,889862,Staff,24,0,30,6
1746599072407,MATH 10C,B03,889863,Staff,27,0,30,3
1746599072407,MATH 10C,B04,889967,Staff,23,0,30,7
1746599073436,MATH 18,A01,889974,Staff,7,0,30,23
1746599073436,MATH 18,A02,889977,Staff,20,0,30,10
1746599073436,MATH 18,B01,889984,Hardiman; Liam,20,0,30,10
1746599073436,MATH 18,B02,889985,Hardiman; Liam,25,0,30,5
1746599074461,MATH 20A,A01,889990,Suk; Andrew Hoon,30,0,35,5
1746599075488,MATH 20B,A01,889993,Ohm; Ko Woon,21,0,30,9
1746599075488,MATH 20B,A02,889994,Ohm; Ko Woon,30,0,30,0
1746599075488,MATH 20B,B01,889996,Ohm; Ko Woon,22,0,30,8
1746599075488,MATH 20B,B02,889997,Ohm; Ko Woon,23,0,30,7
1746599076516,MATH 20C,A01,889999,Hammock; Frances H,17,0,30,13
1746599076516,MATH 20C,A02,890003,Hammock; Frances H,23,0,30,7
1746599076516,MATH 20C,B01,890006,Hammock; Frances H,2,0,30,28
1746599076516,MATH 20C,B02,890007,Hammock; Frances H,12,0,30,18
1746599077546,MATH 20D,A01,890011,Cheng; Hsiao-Bing,0,0,30,30
1746599077546,MATH 20D,A02,890012,Cheng; Hsiao-Bing,14,0,30,16
1746599077546,MATH 20D,B01,890016,Cheng; Hsiao-Bing,13,0,30,17
1746599077546,MATH 20D,B02,890017,Cheng; Hsiao-Bing,13,0,30,17
1746599078575,MATH 20E,A01,890026,Harel; Guershon,1,0,30,29
1746599078575,MATH 20E,A02,890029,Harel; Guershon,22,0,30,8
1746599078575,MATH 20E,B01,890033,Harel; Guershon,7,0,30,23
1746599078575,MATH 20E,B02,890101,Harel; Guershon,21,0,30,9
1746599079604,MATH 102,A01,890104,Staff,18,0,30,12
1746599079604,MATH 102,A02,890105,Staff,27,0,30,3
1746599080631,MATH 103B,A01,890116,Salehi Golsefidy; Alireza,3,0,30,27
1746599080631,MATH 103B,B01,890118,Staff,0,3,34,34
1746599081663,MATH 109,A01,890121,Aliabadi Sr.; Mohsen,0,0,30,30
1746599081663,MATH 109,B01,890124,Upadrashta; Pranav Kumar,18,0,30,12
1746599082687,MATH 120A,A01,890126,Eggers; John Dietrich,13,0,30,17
1746599083712,MATH 142B,A01,890128,Ioana; Adrian,19,0,30,11
1746599083712,MATH 142B,A02,890129,Ioana; Adrian,12,0,30,18
1746599084739,MATH 154,A01,890174,Staff,0,1,30,30
1746599084739,MATH 154,A02,890182,Staff,0,0,30,30
1746599085766,MATH 168A,A01,890197,Dumitriu; Ioana,21,0,35,14
1746599086795,MATH 170A,A01,890240,Nie; Jiawang,1,0,30,29
1746599086795,MATH 170A,A02,890241,Nie; Jiawang,11,0,30,19
1746599086795,MATH 170A,A03,890249,Nie; Jiawang,23,0,30,7
1746599087820,MATH 170B,A01,957891,Nag; Panchali,13,0,35,22
1746599089877,MATH 181A,A01,908025,Staff,0,3,35,35
1746599089877,MATH 181A,A02,960115,Staff,26,0,35,9
1746599090911,MATH 181B,A01,959874,Staff,24,0,30,6
1746599091937,MATH 193B,A01,890265,Staff,0,4,35,35
1746599092966,MGT 4,A01,890311,Anderson; John Charles,42,0,88,46
1746599093993,MGT 5,A00,907740,Staff,12,0,98,86
1746599095023,MGT 12,A00,890312,Lindenberger; Wade Douglas,67,0,98,31
1746599096050,MGT 16,A00,957883,Staff,78,0,98,20
1746599098108,MGT 45,A00,890314,Pecore; Joseph P.,45,0,98,53
1746599099138,MGT 71,A00,890315,Staff,0,12,98,98
1746599100164,MGT 100,A00,890316,Yavorsky; Daniel Ryan,44,0,98,54
1746599101192,MGT 103,A00,890317,Ehrich; Kristine R,73,0,98,25
1746599102218,MGT 105,A00,890356,Bates; Kenneth Walter,0,8,98,98
1746599103254,MGT 112,A00,890360,Ehrich; Kristine R,55,0,98,43
1746599104283,MGT 127R,A00,907732,Zhu; Kevin Xiaoguo,23,0,98,75
1746599105312,MGT 131B,A00,890361,Anderson; John Charles,59,0,98,39
1746599106341,MGT 137,A00,890362,Lindenberger; Wade Douglas,65,0,98,33
1746599107368,MGT 160,A00,890369,Johnson; Erik Barry,9,0,98,89
1746599109424,MGT 164,A00,890372,Zimmermann; Carsten,0,40,98,98
1746599110451,MGT 180,A00,890374,Bliss; Barbara Ann,11,0,98,87
1746599111485,MMW 15,A01,886414,Chang; Edmond Yi-Teh,0,12,28,28
1746599111485,MMW 15,A02,886415,Chang; Edmond Yi-Teh,0,8,28,28
1746599111485,MMW 15,A03,886416,Chang; Edmond Yi-Teh,0,9,28,28
1746599111485,MMW 15,A04,886417,Chang; Edmond Yi-Teh,0,8,28,28
1746599111485,MMW 15,B01,886419,Chang; Edmond Yi-Teh,0,7,28,28
1746599111485,MMW 15,B02,886420,Chang; Edmond Yi-Teh,0,7,28,28
1746599111485,MMW 15,B03,886421,Chang; Edmond Yi-Teh,0,7,28,28
1746599111485,MMW 15,B04,886422,Chang; Edmond Yi-Teh,0,8,28,28
1746599111485,MMW 15,C01,886424,Staff,0,9,28,28
1746599111485,MMW 15,C02,886425,Staff,0,8,28,28
1746599111485,MMW 15,C03,886426,Staff,0,8,28,28
1746599111485,MMW 15,C04,886427,Staff,0,8,28,28
1746599111485,MMW 15,C05,958038,Staff,0,8,28,28
1746599111485,MMW 15,C06,958039,Staff,0,7,28,28
1746599112510,MMW 15GS,A00,906910,Patterson; Patrick H.,4,0,28,24
1746599113537,MMW 122R,A01,886429,Rahimi; Babak,0,13,28,28
1746599113537,MMW 122R,A02,886430,Rahimi; Babak,0,12,28,28
1746599113537,MMW 122R,A03,958040,Rahimi; Babak,0,11,28,28
1746599114569,MUS 1A,A01,890937,Staff,2,0,25,23
1746599114569,MUS 1A,A02,891035,Staff,6,0,25,19
1746599114569,MUS 1A,C01,958912,Staff,24,0,25,1
1746599114569,MUS 1A,C02,958913,Staff,25,0,25,0
1746599116628,MUS 2AK,A00,957092,Ohnishi; Takae,15,0,15,0
1746599117663,MUS 4,A01,891044,Staff,0,0,25,25
1746599117663,MUS 4,A02,891045,Staff,22,0,25,3
1746599117663,MUS 4,B01,891048,Staff,17,0,25,8
1746599117663,MUS 4,B02,891050,Staff,25,0,25,0
1746599118689,MUS 5,A01,957506,Dubnov; Shlomo,0,0,25,25
1746599118689,MUS 5,A02,957622,Dubnov; Shlomo,13,0,25,12
1746599118689,MUS 5,A03,957623,Dubnov; Shlomo,20,0,25,5
1746599119718,MUS 6,A01,891053,Freitas Caetano; Marcelo,24,0,25,1
1746599119718,MUS 6,A02,891054,Freitas Caetano; Marcelo,23,0,25,2
1746599120747,MUS 7,A01,891081,Staff,0,0,25,25
1746599120747,MUS 7,A02,891082,Staff,3,0,25,22
1746599121776,MUS 8GS,A00,891118,Borgo; David Garcia,1,0,25,24
1746599122805,MUS 11,A01,891140,Staff,8,0,25,17
1746599122805,MUS 11,A02,891141,Staff,21,0,25,4
1746599123829,MUS 13,A01,891143,Staff,8,0,25,17
1746599123829,MUS 13,A02,891144,Staff,24,0,25,1
1746599124855,MUS 15,A01,891146,Staff,9,0,25,16
1746599124855,MUS 15,A02,891148,Staff,21,0,25,4
1746599124855,MUS 15,B01,891150,Staff,18,0,25,7
1746599124855,MUS 15,B02,891151,Staff,25,0,25,0
1746599125881,MUS 20,A01,891153,Staff,5,0,20,15
1746599125881,MUS 20,A02,891155,Staff,14,0,20,6
1746599126907,MUS 80,A00,891156,Staff,19,0,25,6
1746599126907,MUS 80,B00,891157,Staff,23,0,25,2
1746599127936,MUS 130,A00,891158,Ohnishi; Takae,35,0,35,0
1746599128962,MUS 150GS,A01,891160,Borgo; David Garcia,1,0,25,24
1746599129990,MUS 170,A01,891162,Freitas Caetano; Marcelo,20,0,25,5
1746599129990,MUS 170,A02,891164,Freitas Caetano; Marcelo,21,0,25,4
1746599131074,NANO 11,A00,886220,Vazquez Mena; Oscar,13,0,15,2
1746599132102,NANO 15,A01,886222,Drews; Aaron,4,0,7,3
1746599133141,NANO 104,A00,886224,Sirbuly; Donald,17,0,25,8
1746599134169,PH 40,A00,886528,Staff,23,0,40,17
1746599135195,PH 45,A01,886799,Staff,35,0,40,5
1746599136223,PH 110,A00,886802,Staff,0,6,40,40
1746599137249,PH 172,A00,906716,Staff,19,0,35,16
1746599138277,PH 191,A00,886803,Staff,6,0,40,34
1746599139304,PHIL 1,A00,889500,Staff,20,0,30,10
1746599140331,PHIL 10,A01,889549,Grush; Rick Scott,16,0,22,6
1746599140331,PHIL 10,A02,889551,Grush; Rick Scott,22,0,22,0
1746599141358,PHIL 28,A01,889559,Lamey; Andy M.,0,2,31,31
1746599141358,PHIL 28,A02,889561,Lamey; Andy M.,0,1,30,30
1746599141358,PHIL 28,A03,889572,Lamey; Andy M.,0,1,30,30
1746599142399,PHIL 35,A00,907839,Staff,13,0,15,2
1746599143424,PHIL 60,A00,889574,Staff,73,0,90,17
1746599144450,PHIL 101,A00,958004,Staff,12,0,15,3
1746599146500,PHIL 136,A00,889582,Fulkerson; Matthew Todd,26,0,45,19
1746599147531,PHIL 163,A01,889601,Staff,21,0,30,9
1746599147531,PHIL 163,B01,889606,Brandt; Reuven A,0,3,0,0
1746599148559,PHIL 164,A00,889610,Staff,16,0,30,14
1746599149585,PHIL 165,A00,889613,Staff,22,0,30,8
1746599150612,PHYS 1A,A00,886431,Staff,30,0,70,40
1746599151641,PHYS 1AL,001,886432,Tsai; Philbert S,0,1,30,30
1746599151641,PHYS 1AL,002,886436,Tsai; Philbert S,13,0,30,17
1746599152669,PHYS 1B,A00,886439,Staff,184,0,240,56
1746599153697,PHYS 1BL,001,886441,Tsai; Philbert S,0,4,30,30
1746599153697,PHYS 1BL,002,886444,Tsai; Philbert S,2,0,30,28
1746599154727,PHYS 1C,A00,896092,Arnold; Kam S,78,0,146,68
1746599155756,PHYS 1CL,001,886448,Tsai; Philbert S,0,0,30,30
1746599155756,PHYS 1CL,002,886449,Tsai; Philbert S,1,0,30,29
1746599155756,PHYS 1CL,003,886450,Tsai; Philbert S,16,0,30,14
1746599155756,PHYS 1CL,004,886451,Tsai; Philbert S,15,0,30,15
1746599156784,PHYS 2B,A01,886457,Staff,67,0,115,48
1746599157814,PHYS 2C,A01,886460,Shotwell; Brian,0,9,65,65
1746599158841,PHYS 2CL,A01,886467,Staff,0,4,28,28
1746599158841,PHYS 2CL,A02,886468,Staff,0,3,28,28
1746599159866,PHYS 2D,A01,886470,Staff,10,0,50,40
1746599160895,PHYS 4B,A01,886475,Grinstein; Benjamin,22,0,40,18
1746599161923,POLI 5,A00,891173,Desposato; Scott,7,0,25,18
1746599162948,POLI 5D,A01,891175,Staff,5,0,5,0
1746599162948,POLI 5D,B01,891178,Staff,5,0,5,0
1746599163976,POLI 11,A00,891179,Ferree; Karen E,0,0,35,35
1746599165001,POLI 12,A00,891180,Staff,15,0,30,15
1746599166027,POLI 27,A01,891182,Staff,11,0,75,64
1746599167052,POLI 30,A00,891183,Staff,8,0,50,42
1746599168077,POLI 100B,A00,891244,Staff,5,1,35,30
1746599169104,POLI 100I,A00,891247,Staff,7,0,30,23
1746599170133,POLI 104J,A00,891248,Nichter; Maysa,14,0,30,16
1746599171158,POLI 104U,A00,891250,Nichter; Maysa,1,0,30,29
1746599173218,POLI 110B,A00,891255,Wiens; David,19,0,25,6
1746599174243,POLI 112A,A00,891256,Wiens; David,6,0,25,19
1746599175272,POLI 114BR,A00,891261,Staff,19,0,30,11
1746599176296,POLI 117R,A00,891262,Forman; Fonna,0,6,50,50
1746599177322,POLI 118,A00,891264,Ingham; Sean,17,0,25,8
1746599178352,POLI 124A,A00,891265,Staff,18,0,20,2
1746599179376,POLI 125D,A00,891266,Nichter; Simeon C,2,0,25,23
1746599180401,POLI 126,A00,891268,Nichter; Simeon C,7,0,25,18
1746599181428,POLI 126AA,A00,891272,Staff,15,0,25,10
1746599182453,POLI 130AA,A00,891273,Staff,15,0,20,5
1746599183479,POLI 134AA,A00,891274,Staff,4,0,20,16
1746599185535,POLI 138,A00,891278,Staff,21,0,25,4
1746599186565,POLI 142K,A00,891280,Staff,10,0,25,15
1746599187593,POLI 142M,A00,891281,Gartzke; Erik,16,0,30,14
1746599188621,POLI 142P,A00,891284,Staff,20,0,30,10
1746599189649,POLI 143,A00,891285,Gartzke; Erik,12,0,30,18
1746599190673,POLI 153,A00,891286,Staff,19,0,20,1
1746599192725,POLI 175,A00,891290,Staff,15,0,20,5
1746599193750,PSYC 1,A00,890674,Steiner; Eric Tomas,0,11,45,45
1746599194780,PSYC 2,A00,890676,Albright; Thomas D,20,0,35,15
1746599195805,PSYC 3,A00,890679,Staff,17,0,20,3
1746599196835,PSYC 6,A00,959858,Staff,19,0,20,1
1746599197863,PSYC 60,A01,890684,Rickard; Timothy C.,0,6,45,45
1746599198889,PSYC 70,A01,890689,Geller; Emma Harlan,6,0,30,24
1746599199914,PSYC 71,A01,959860,Staff,21,0,25,4
1746599200941,PSYC 100,A00,890690,Lacefield; Katharine I,0,50,180,180
1746599201968,PSYC 102,A00,890695,Staff,18,0,40,22
1746599202994,PSYC 105,A00,890699,Geller; Emma Harlan,70,0,100,30
1746599204020,PSYC 106,A00,890701,Gorman; Michael R.,5,0,30,25
1746599205044,PSYC 108,A00,890704,Adrian; Julia Anna,0,29,50,50
1746599206072,PSYC 118,A01,890712,Staff,11,0,30,19
1746599207098,PSYC 124,A00,890716,Chapman; Eddie Nathaniel,25,0,60,35
1746599208128,PSYC 131,A00,890717,Anagnostaras; Stephan,0,7,80,80
1746599209152,PSYC 137,A00,890719,Winkielman; Piotr,0,11,30,30
1746599210178,PSYC 144,A00,890721,Adrian; Julia Anna,0,9,45,45
1746599211206,PSYC 162,A00,890805,Staff,0,1,75,75
1746599212231,PSYC 169,A00,890810,Staff,0,15,30,30
1746599213257,PSYC 172,A00,890814,Gorman; Michael R.,9,0,30,21
1746599214286,PSYC 181,A00,890818,Anagnostaras; Stephan,7,0,200,193
1746599215314,PSYC 184,A00,959861,Staff,162,0,175,13
1746599216342,PSYC 189,A00,890823,Staff,0,2,30,30
1746599217373,PSYC 191,A00,890884,Rickard; Timothy C.,0,11,35,35
1746599218398,PSYC 193,A00,890913,Staff,19,0,30,11
1746599218398,PSYC 193,B00,890914,Chapman; Eddie Nathaniel,24,0,30,6
1746599219436,PSYC 193L,A01,890918,Lowe; Angela Beth,20,0,30,10
1746599219436,PSYC 193L,B01,890921,Hurwitz; Ethan Scott,20,0,30,10
1746599219436,PSYC 193L,C01,890928,Staff,30,0,30,0
1746599220466,RELI 149,A00,886806,Rahimi; Babak,23,0,40,17
1746599221492,SE 9,A01,886814,Staff,7,0,20,13
1746599222519,SE 101B,A01,886816,Chadha; Mayank,3,0,35,32
1746599223545,SE 110B,A00,886818,Zhu; Qiang,4,0,75,71
1746599224573,SE 125,A01,886830,Staff,10,0,30,20
1746599225605,SE 130B,A01,886835,Staff,14,0,40,26
1746599226636,SE 131A,A01,886838,Krysl; Petr,34,0,55,21
1746599227662,SE 154,A00,886840,Staff,28,0,50,22
1746599228688,SE 164GS,A01,886849,Staff,6,0,20,14
1746599229713,SE 167GS,A01,886853,Staff,6,0,20,14
1746599230738,SIO 25,A01,890107,Staff,19,0,30,11
1746599231769,SIO 45,A00,890109,Cook; Geoffrey W,115,0,200,85
1746599232797,SIO 109R,A00,890110,Forman; Fonna,0,16,20,20
1746599233824,SIO 187,A01,890114,Kacev; David,15,0,40,25
1746599234889,SOCI 1,A01,890431,Thorpe; Charles Robert,14,0,30,16
1746599234889,SOCI 1,A02,890518,Thorpe; Charles Robert,30,0,30,0
1746599235917,SOCI 2,A01,957978,Staff,25,0,25,0
1746599235917,SOCI 2,A02,957979,Staff,23,0,25,2
1746599236943,SOCI 20,A01,890523,Calderon-Zaks; Michael Aar,21,0,30,9
1746599236943,SOCI 20,A02,890526,Calderon-Zaks; Michael Aar,29,0,30,1
1746599237969,SOCI 30,A01,890533,Pardo Guerra; Juan Pablo,37,0,40,3
1746599238995,SOCI 40,A01,890535,Staff,27,0,45,18
1746599240024,SOCI 104Q,A00,890559,Staff,18,0,30,12
1746599241054,SOCI 106,A00,890560,Arnal; Maud Marie Leonie,20,0,30,10
1746599242083,SOCI 110,A00,890567,Holkenbrink-Monk; Charlene,19,0,30,11
1746599243108,SOCI 112,A00,890568,Victoria Torres; Pablo,2,0,55,53
1746599244136,SOCI 115,A00,890597,Arnal; Maud Marie Leonie,28,0,45,17
1746599246195,SOCI 121,A00,890604,Pardo Guerra; Juan Pablo,38,0,45,7
1746599247219,SOCI 126,A01,890608,Staff,8,0,10,2
1746599248245,SOCI 127,A00,890609,Staff,18,0,30,12
1746599249268,SOCI 131,A00,890610,Thorpe; Charles Robert,37,0,45,8
1746599250299,SOCI 135,A00,890615,Payne; Christine Anna,14,0,45,31
1746599251327,SOCI 139,A00,890620,Staff,38,0,45,7
1746599252351,SOCI 148E,A00,890622,Calderon-Zaks; Michael Aar,36,0,45,9
1746599253378,SOCI 150,A00,890623,Kohler; Kristopher M.,31,0,45,14
1746599254405,SOCI 157,A00,890625,Jules-Rosette; Bennetta W.,18,0,20,2
1746599255430,SOCI 160,A00,890627,Payne; Christine Anna,21,0,45,24
1746599256462,SYN 1,A00,886855,Fish; Gwendolyn Anne,0,1,0,0
1746599256462,SYN 1,B00,906086,Fish; Gwendolyn Anne,0,2,0,2
1746599257486,SYN 2R,A00,886860,Staff,0,17,15,15
1746599257486,SYN 2R,B00,906106,Atkinson; Arthur Laird,0,16,15,15
1746599258512,SYN 100,A01,886866,Browne; Emily,0,28,20,20
1746599258512,SYN 100,B01,906128,Rock; Martin,0,4,20,20
1746599258512,SYN 100,C01,906140,Deavenport; James Cary,0,4,20,20
1746599258512,SYN 100,D01,907816,Deavenport; James Cary,0,5,20,20
1746599259536,TDAC 1,A00,890286,Walsh; Kim C.,7,0,20,13
1746599260561,TDAC 101,A00,890296,Basso; Beatrice,15,0,20,5
1746599261586,TDDE 131,A00,890297,Staff,47,0,50,3
1746599262616,TDDM 1,A00,890287,Weinberg; Sadie,25,0,30,5
1746599263642,TDGE 11,A00,890288,Fulton; Julia,138,0,200,62
1746599263642,TDGE 11,B00,890289,Castro; Robert Jess,184,0,200,16
1746599264668,TDGE 25,B00,957359,Walsh; Kim C.,5,0,20,15
1746599265695,TDGE 40,A01,890292,Power; Jade Yukana,26,0,30,4
1746599266722,TDGE 124,A00,890298,Havis; Allan,0,2,50,50
1746599267747,TDGE 131R,A00,890299,Burelle; Julie Sara Veronique,15,0,42,27
1746599268773,TDHT 101,A00,890300,Staff,10,0,20,10
1746599269803,TDHT 109,A01,890302,Anderson; Mysia Anyse,31,0,40,9
1746599270831,TDMV 1,A00,890293,Arcidiacono; Kristin,18,0,30,12
1746599271857,TDMV 2,A00,890294,Weinberg; Sadie,23,0,30,7
1746599272881,TDMV 3,A00,957878,Arcidiacono; Kristin,28,0,30,2
1746599274940,TDMV 138,A00,890304,Jun; Grace Shin Hae,25,0,40,15
1746599275966,TDMV 140,A00,890305,Corrales; Joseph Bernales,25,0,30,5
1746599276996,TDMV 142,A00,890307,Caligagan; Tony,32,0,40,8
1746599278023,TDMV 144,A00,890308,Camaya; Michelle Ann,25,0,30,5
1746599279049,TDPW 1,A00,890295,Stein; Deborah Isobel,3,0,20,17
1746599280075,USP 2,A01,890272,Lerner; Amy M,7,0,20,13
1746599281101,USP 3,A01,890274,Staff,12,0,30,18
1746599282127,USP 15,A01,890276,Sun; Feiyang,16,0,30,14
1746599283155,USP 25,A00,890277,Shenkman; Michael Thomas,18,0,25,7
1746599284182,USP 138,A00,890278,Staff,13,0,25,12
1746599285212,USP 143,A00,890279,Staff,21,0,70,49
1746599286241,USP 144,A00,890280,Chowdhury; Muhammed Zohir,16,0,30,14
1746599287269,USP 150,A00,890281,Boomhower; Matthew Charles,4,0,30,26
1746599288295,USP 151,A00,890282,Staff,16,0,20,4
1746599289320,USP 162,A00,890283,Andrews; Abigail Leslie,16,0,20,4
1746599290345,USP 168,A00,920477,Kwak; Nancy,0,0,5,5
1746599291371,USP 181,A00,890284,Staff,3,0,20,17
1746599292396,USP 191A,A00,890285,Staff,12,0,20,8
1746599293420,VIS 101,A00,886512,Staff,26,0,75,49
1746599294446,VIS 103,A00,886513,Cruz; Edwin Teddy,61,0,75,14
1746599295471,VIS 108,A00,886514,Staff,4,0,15,11
1746599296496,VIS 127P,A00,886515,Shen; Kuiyi,80,0,146,66
1746599297522,VIS 149,A00,886516,Yoldas; Pinar,0,0,15,15
1746599298548,VIS 164,A00,886526,Erdmann; Dean,19,0,22,3
1746599299573,VIS 194S,A00,886527,Staff,61,0,75,14
1746599300602,WCWP 10A,C00,886484,Martiniuk; Jill,12,0,15,3
1746599301632,WCWP 10B,A00,886490,Uriarte; Emma,0,0,15,15
1746599301632,WCWP 10B,B00,886491,Dhir; Simrita,8,0,15,7
1746599301632,WCWP 10B,C00,886492,Ornelas; Tricia,0,0,15,15
1746599302658,WCWP 100,A00,886494,Young; Mark T,0,6,15,15
1746599304780,AAS 10,A01,886199,Childs; Dennis R.,0,3,0,0
1746599305805,ANAR 104,A01,886940,Shtienberg; Gilad,27,0,30,3
1746599306831,ANAR 120,A00,886953,Staff,13,0,20,7
1746599307860,ANBI 148,A01,886955,Wilder; Linnea Lorene,30,0,40,10
1746599309912,ANSC 122,A00,886957,Staff,24,0,30,6
1746599310937,ANSC 150,A00,886958,Sloane; Julia Kathryn,2,0,15,13
1746599311962,ANSC 156,A00,886959,Jenkins; Janis A.,0,1,15,15
1746599312988,ANSC 180,A00,886960,Staff,11,0,17,6
1746599314013,ANSC 188,A00,886961,Jassal; Aftab,9,0,25,16
1746599315038,ANSC 190,A00,886962,Jassal; Aftab,14,0,25,11
1746599316064,ANSC 191,A00,886963,Staff,18,0,20,2
1746599317089,ANTH 3,A01,891689,Staff,17,0,20,3
1746599318118,ANTH 5,A00,886933,Semendeferi; Ekaterini,16,0,20,4
1746599319143,ANTH 10,A00,886934,Staff,0,12,30,30
1746599320172,ANTH 21,A01,886936,Staff,41,0,60,19
1746599321198,ANTH 23,A01,886938,Staff,92,0,100,8
1746599322229,ANTH 105,A00,886964,Stewart; Alexander B,84,0,100,16
1746599323256,ANTH 108,A00,886965,Pedersen; David,9,0,20,11
1746599324281,AWP 10,001,886147,Staff,0,0,0,0
1746599324281,AWP 10,002,886148,Staff,0,0,0,0
1746599324281,AWP 10,003,886149,Staff,0,0,0,0
1746599324281,AWP 10,004,886150,Staff,0,0,0,0
1746599324281,AWP 10,005,886151,Staff,0,0,0,0
1746599324281,AWP 10,006,886152,Staff,0,0,0,0
1746599324281,AWP 10,007,886153,Staff,0,0,0,0
1746599324281,AWP 10,008,886154,Staff,0,0,0,0
1746599324281,AWP 10,009,886155,Staff,0,0,0,0
1746599324281,AWP 10,010,886156,Staff,0,0,0,0
1746599324281,AWP 10,011,886158,Staff,0,0,0,0
1746599324281,AWP 10,012,886160,Staff,0,0,0,0
1746599324281,AWP 10,013,886161,Staff,0,0,0,0
1746599324281,AWP 10,014,886162,Staff,0,0,0,0
1746599324281,AWP 10,015,886163,Staff,0,0,0,0
1746599324281,AWP 10,016,886164,Staff,0,0,0,0
1746599324281,AWP 10,017,886165,Staff,0,0,0,0
1746599324281,AWP 10,018,886166,Staff,0,0,0,0
1746599324281,AWP 10,019,886168,Staff,0,0,0,0
1746599324281,AWP 10,020,886170,Staff,0,0,0,0
1746599324281,AWP 10,021,886172,Staff,0,0,0,0
1746599325311,AWP 10R,001,886173,Staff,0,1,0,0
1746599325311,AWP 10R,002,886174,Staff,0,1,0,0
1746599325311,AWP 10R,003,886175,Staff,0,0,0,0
1746599325311,AWP 10R,004,886176,Staff,0,0,0,0
1746599325311,AWP 10R,005,886177,Staff,0,0,0,0
1746599325311,AWP 10R,006,886178,Staff,0,0,0,0
1746599325311,AWP 10R,007,886179,Staff,0,0,0,0
1746599325311,AWP 10R,008,886181,Staff,0,0,0,0
1746599325311,AWP 10R,009,886182,Staff,0,0,0,0
1746599325311,AWP 10R,010,886183,Staff,0,0,0,0
1746599325311,AWP 10R,011,886184,Staff,0,0,0,0
1746599325311,AWP 10R,012,886185,Staff,0,0,0,0
1746599325311,AWP 10R,013,886186,Staff,0,0,0,0
1746599325311,AWP 10R,014,886187,Staff,0,0,0,0
1746599325311,AWP 10R,015,886188,Staff,0,0,0,0
1746599325311,AWP 10R,016,886189,Staff,0,0,0,0
1746599325311,AWP 10R,017,960532,Staff,0,0,0,0
1746599325311,AWP 10R,018,960533,Staff,0,0,0,0
1746599325311,AWP 10R,019,960534,Staff,0,0,0,0
1746599325311,AWP 10R,020,960538,Staff,0,0,0,0
1746599325311,AWP 10R,021,960540,Staff,0,0,0,0
1746599325311,AWP 10R,022,960541,Staff,0,0,0,0
1746599325311,AWP 10R,023,960542,Staff,0,0,0,0
1746599325311,AWP 10R,024,960544,Staff,0,0,0,0
1746599325311,AWP 10R,025,960545,Staff,0,0,0,0
1746599325311,AWP 10R,026,960548,Staff,0,0,0,0
1746599326340,AWP 102R,A00,886190,Staff,0,0,0,0
1746599326340,AWP 102R,B00,886191,Staff,0,0,0,0
1746599327366,BENG 100,A01,886193,Staff,17,0,30,13
1746599328393,BENG 122A,A01,886195,Hasty; Jeff M,13,0,30,17
1746599329422,BENG 166A,A00,886196,Sah; Robert Lie-Yuan,0,3,30,30
1746599330446,BENG 190,A00,958050,Khojah; Reem I,17,0,25,8
1746599331474,BIBC 102,A01,894320,Staff,0,1,46,46
1746599331474,BIBC 102,A02,894321,Staff,0,0,46,46
1746599331474,BIBC 102,A03,894344,Staff,6,0,46,40
1746599331474,BIBC 102,A04,894345,Staff,27,0,47,20
1746599332503,BICD 100R,A01,894365,Smith; Laurie,0,2,58,58
1746599332503,BICD 100R,A02,894366,Smith; Laurie,0,4,58,58
1746599332503,BICD 100R,A03,894367,Smith; Laurie,0,0,59,59
1746599332503,BICD 100R,A04,959869,Smith; Laurie,38,0,59,21
1746599333529,BICD 136,A01,894383,Gustafson-Brown; Cindy,14,0,50,36
1746599334558,BIEB 102,A01,894494,Butler; Shannon Rhey,51,0,130,79
1746599336612,BIEB 150,A01,894617,Wills; Christopher,3,0,20,17
1746599336612,BIEB 150,A02,894631,Wills; Christopher,3,0,20,17
1746599336612,BIEB 150,A03,894937,Wills; Christopher,3,0,20,17
1746599336612,BIEB 150,A04,894946,Wills; Christopher,5,0,20,15
1746599337640,BIEB 194,A00,906141,Kurle; Carolyn M.,5,0,20,15
1746599338720,BILD 1,A01,894154,Staff,3,0,19,16
1746599338720,BILD 1,A02,894155,Staff,14,0,19,5
1746599338720,BILD 1,A03,894160,Staff,13,0,19,6
1746599338720,BILD 1,A04,894161,Staff,15,0,18,3
1746599339745,BILD 2,A01,894168,Staff,0,0,50,50
1746599339745,BILD 2,A02,894169,Staff,0,0,50,50
1746599339745,BILD 2,A03,894179,Staff,0,0,50,50
1746599339745,BILD 2,A04,894203,Staff,22,0,50,28
1746599340771,BILD 3,A01,894213,Staff,23,0,31,8
1746599340771,BILD 3,A02,894214,Staff,26,0,31,5
1746599340771,BILD 3,A03,894235,Staff,28,0,31,3
1746599340771,BILD 3,A04,894236,Staff,28,0,32,4
1746599341800,BILD 4,A01,894253,Reuther; Keefe,5,0,24,19
1746599341800,BILD 4,A02,894258,Reuther; Keefe,16,0,24,8
1746599342826,BILD 5,A01,894276,Reuther; Keefe,34,0,50,16
1746599342826,BILD 5,A02,894277,Reuther; Keefe,45,0,50,5
1746599342826,BILD 5,A03,894290,Reuther; Keefe,44,0,50,6
1746599342826,BILD 5,A04,894291,Reuther; Keefe,48,0,50,2
1746599343855,BILD 24,A01,894297,Pirino; Giorgia,40,0,60,20
1746599344884,BIMM 100,B01,958915,Staff,71,0,100,29
1746599345908,BIMM 101,A01,895017,McDonnell; Lisa Marie,0,5,24,24
1746599345908,BIMM 101,A02,895018,McDonnell; Lisa Marie,0,5,24,24
1746599345908,BIMM 101,B01,895020,McDonnell; Lisa Marie,0,5,24,24
1746599345908,BIMM 101,B02,895021,McDonnell; Lisa Marie,0,4,24,24
1746599346937,BIMM 110,A01,895023,Staff,1,0,25,24
1746599346937,BIMM 110,A02,895024,Staff,9,0,25,16
1746599346937,BIMM 110,A03,895025,Staff,18,0,25,7
1746599346937,BIMM 110,A04,895031,Staff,20,0,25,5
1746599347965,BIMM 120,A01,895114,Gustafson-Brown; Cindy,14,0,28,14
1746599347965,BIMM 120,A02,895126,Gustafson-Brown; Cindy,21,0,27,6
1746599348992,BIPN 100,A01,895130,Yang; Mingyu,0,0,38,38
1746599348992,BIPN 100,A02,895131,Yang; Mingyu,31,0,38,7
1746599348992,BIPN 100,A03,895132,Yang; Mingyu,32,0,38,6
1746599348992,BIPN 100,A04,895133,Yang; Mingyu,27,0,36,9
1746599350023,BIPN 120,A01,895135,Cooke; James Edward,0,3,13,13
1746599350023,BIPN 120,A02,895136,Cooke; James Edward,0,1,13,13
1746599350023,BIPN 120,A03,895137,Cooke; James Edward,0,3,13,13
1746599350023,BIPN 120,A04,895156,Cooke; James Edward,0,2,11,11
1746599351050,BIPN 134,A01,895235,Cooke; James Edward,0,1,25,25
1746599351050,BIPN 134,A02,895237,Cooke; James Edward,0,0,25,25
1746599351050,BIPN 134,A03,895240,Cooke; James Edward,1,0,25,24
1746599351050,BIPN 134,A04,895270,Cooke; James Edward,20,0,25,5
1746599352077,BIPN 189,A00,892103,Staff,0,14,14,14
1746599354128,BISP 194,A00,958008,Staff,0,2,0,0
1746599355154,CAT 124,A01,922009,Staff,0,5,20,20
1746599356181,CAT 125R,A00,886390,Morales; Celeste Georgianna,0,3,20,20
1746599356181,CAT 125R,B00,886391,Irwin; Matthew Joseph,0,4,20,20
1746599356181,CAT 125R,C00,886392,Smith; Lauryn Alissa,0,2,20,20
1746599356181,CAT 125R,D00,886393,Vanderschuit; Maya Alysia,0,3,20,20
1746599356181,CAT 125R,E00,886394,Marchisotto; Jennifer Anne,0,3,20,20
1746599357206,CENG 15,A01,886218,Drews; Aaron,3,0,8,5
1746599358236,CENG 113,A00,886219,Opatkiewicz; Justin Paul,15,0,25,10
1746599359260,CGS 101,A00,887044,Staff,7,0,20,13
1746599360289,CGS 105,A01,887046,Staff,14,0,25,11
1746599361314,CGS 112,A00,887047,Cuong; Marisol,12,0,15,3
1746599362340,CGS 113,A00,887048,Staff,23,0,30,7
1746599363368,CGS 120,A00,887049,Staff,9,0,17,8
1746599364397,CHEM 6A,A01,886336,Lam; Tin Yiu,38,0,50,12
1746599364397,CHEM 6A,A02,886338,Lam; Tin Yiu,37,0,50,13
1746599365422,CHEM 6B,A01,886341,Hopkins; Patrycja Anna,16,0,50,34
1746599365422,CHEM 6B,A02,886343,Hopkins; Patrycja Anna,42,0,50,8
1746599366446,CHEM 6C,A01,886346,Albizati; Kim F.,0,2,50,50
1746599366446,CHEM 6C,A02,886348,Albizati; Kim F.,24,0,50,26
1746599367476,CHEM 40A,A01,886352,Klosterman; Jeremy K,65,0,100,35
1746599368503,CHEM 40B,A01,886356,Klosterman; Jeremy K,0,24,100,100
1746599369532,CHEM 41B,A01,886360,Theodorakis; Emmanuel,25,0,50,25
1746599369532,CHEM 41B,A02,886362,Theodorakis; Emmanuel,47,0,50,3
1746599370559,CHIN 165A,A00,886382,Xu; Li,18,0,20,2
1746599371588,CLAS 120,A00,886387,Myerston Santana; Jacobo,33,0,40,7
1746599372613,COGS 9,A01,886967,Shannon; Kyle Michael,42,0,60,18
1746599373641,COGS 11,A01,886969,Staff,9,0,30,21
1746599374669,COGS 14A,A01,886971,Staff,5,0,60,55
1746599375697,COGS 14B,A01,886973,Hoffman; Drew Ellen,4,0,60,56
1746599376723,COGS 18,A01,886975,Morgan; Eric,34,0,60,26
1746599377753,COGS 20,A01,886977,Staff,3,0,8,5
1746599377753,COGS 20,A02,886978,Staff,5,0,7,2
1746599378779,COGS 100,A01,907783,Staff,0,1,30,30
1746599379808,COGS 101B,A01,886980,Staff,0,4,48,48
1746599380840,COGS 101C,A01,886982,Delgado; Tania,0,5,44,44
1746599381868,COGS 102A,A01,886984,Johnson; Christine M.,3,0,30,27
1746599382897,COGS 118B,A01,886986,Staff,0,4,88,88
1746599383924,COGS 150,A01,886988,Bergen; Benjamin,22,0,50,28
1746599384950,COGS 153,A00,886989,Delgado; Tania,0,3,41,41
1746599385978,COGS 186,A01,886991,Staff,0,0,32,32
1746599387005,COGS 187A,A01,886993,Boyle; Mary E. T.,7,0,30,23
1746599388034,COGS 189,A00,886994,Staff,0,1,30,30
1746599389062,COMM 10,A01,886996,Staff,0,0,20,21
1746599389062,COMM 10,A02,886997,Staff,10,0,20,10
1746599389062,COMM 10,A03,959845,Staff,19,0,20,1
1746599390092,COMM 20,A01,886999,Leuning; Grant Maurstad,24,0,40,16
1746599392143,COMM 100A,A01,887002,Staff,0,0,20,25
1746599392143,COMM 100A,A02,887003,Staff,5,0,20,15
1746599393168,COMM 100B,A01,887005,Staff,0,8,20,24
1746599394197,COMM 106D,A00,887006,Staff,14,0,40,26
1746599395226,COMM 110G,A00,887007,Whitworth-Smith; Andrew C,12,0,40,28
1746599396251,COMM 111B,A00,887008,Staff,31,0,40,9
1746599397277,COMM 113T,A00,887009,Abuelhiga; Soraya Jill,28,0,40,12
1746599397277,COMM 113T,B00,906733,Staff,39,0,40,1
1746599398302,COMM 145,A00,887010,Staff,13,0,40,27
1746599399331,COMM 146,A00,887054,Staff,32,0,40,8
1746599400358,COMM 190,A00,887012,Staff,8,0,23,15
1746599401387,CSE 8A,A50,887015,Cao; Yingjun,56,0,85,29
1746599402425,CSE 11,A01,887017,Cao; Yingjun,11,0,70,59
1746599403454,CSE 20,A01,887019,Staff,30,0,50,20
1746599404488,CSE 21,A01,887021,Staff,79,0,100,21
1746599404488,CSE 21,B01,892583,Braun; Oliver,45,0,50,5
1746599405515,CSE 30,A01,887025,Eldon; John,142,0,200,58
1746599406539,CSE 100,A01,887027,Staff,26,0,50,24
1746599406539,CSE 100,A02,887028,Staff,42,0,50,8
1746599407565,CSE 101,A01,887030,Braun; Oliver,74,0,100,26
1746599407565,CSE 101,B01,887032,Jones; Miles E,0,3,50,50
1746599407565,CSE 101,B02,887033,Jones; Miles E,0,2,50,50
1746599408594,CSE 105,A01,908084,Jones; Miles E,32,0,50,18
1746599408594,CSE 105,A02,908087,Jones; Miles E,31,0,50,19
1746599409621,CSE 135,A01,887035,Powell; Thomas Allan,0,5,50,50
1746599410648,CSE 142,A01,887037,Staff,8,0,60,52
1746599411676,CSE 142L,A01,887039,Staff,34,0,60,26
1746599412702,CSE 151A,A01,887041,Solares; Edwin A,47,0,100,53
1746599413732,CSE 175,A01,887043,Kumar; Rakesh,30,0,30,0
1746599414759,CSS 1,A01,886389,Staff,0,1,40,40
1746599415785,DSC 30,A01,908097,Liao; Soohyun Nam,47,0,75,28
1746599416816,DSC 40A,A01,908099,Shannon; Kyle Michael,30,0,50,20
1746599417842,DSC 40B,A01,908112,Staff,15,0,50,35
1746599418869,DSC 80,A01,908116,Staff,19,0,60,41
1746599419896,DSC 197,001,956863,Eldridge; Justin Matthew,9999,0,9999,0
1746599420926,ECE 5,A01,886400,Morris; Karcher William,1,0,6,5
1746599420926,ECE 5,A02,886401,Morris; Karcher William,3,0,6,3
1746599421953,ECE 148,A01,886403,Silberman; Jack,0,14,14,14
1746599422981,ECON 1,A01,887265,Crane; Meredith Helen,11,0,70,59
1746599422981,ECON 1,B01,887268,Staff,42,0,50,8
1746599424009,ECON 2,A01,887273,Crane; Meredith Helen,54,0,70,16
1746599425038,ECON 3,A01,887279,Rondina; Giacomo,31,0,70,39
1746599426066,ECON 4,A01,887282,Anderson; John Charles,0,2,10,10
1746599427093,ECON 5,A01,887285,Staff,34,0,45,11
1746599427093,ECON 5,B01,887292,Staff,41,0,45,4
1746599428120,ECON 100A,A01,887337,Newhouse; Herbert S,54,0,70,16
1746599428120,ECON 100A,B01,887349,Staff,45,0,50,5
1746599429147,ECON 100B,A01,887361,Du; Songzi,29,0,70,41
1746599430173,ECON 100C,A01,887445,Newhouse; Herbert S,59,0,70,11
1746599431198,ECON 105,A00,887488,Vespa; Emanuel Ignacio,23,0,35,12
1746599432227,ECON 109,A01,887506,Shishkin; Denis,28,0,35,7
1746599433257,ECON 110A,A01,887568,Alon; Titan Michael,0,2,35,35
1746599433257,ECON 110A,B01,907601,Alon; Titan Michael,20,0,35,15
1746599434282,ECON 110B,A01,887598,Levkoff; Steven B.,0,24,70,70
1746599435308,ECON 112,A00,887599,Rondina; Giacomo,19,0,35,16
1746599436332,ECON 120A,A01,887603,Dai; Yinlin,35,0,70,35
1746599437357,ECON 120C,A01,887608,Sun; Yixiao,0,1,35,35
1746599437357,ECON 120C,B01,887614,Sun; Yixiao,0,0,35,35
1746599438386,ECON 138,A00,887621,Bharadwaj; Prashant,0,21,20,20
1746599439411,ECON 144,A00,958007,Squires; Dale E,12,0,35,23
1746599440437,ECON 171,A01,907666,Staff,18,0,35,17
1746599441462,ECON 175,A00,887626,Wu; Pak Yeung,22,0,35,13
1746599442546,ECON 190,A00,887640,Vespa; Emanuel Ignacio,22,0,35,13
1746599443576,EDS 25,A01,888197,Staff,0,0,0,0
1746599443576,EDS 25,A02,888209,Staff,0,0,0,0
1746599443576,EDS 25,A03,888210,Staff,0,0,0,0
1746599443576,EDS 25,A04,888212,Staff,0,0,0,0
1746599443576,EDS 25,A05,888213,Staff,0,0,0,0
1746599443576,EDS 25,A06,888214,Staff,0,0,0,0
1746599443576,EDS 25,A07,888235,Staff,0,2,0,0
1746599443576,EDS 25,A08,888236,Staff,0,0,0,0
1746599443576,EDS 25,A09,888240,Staff,0,0,0,0
1746599443576,EDS 25,A10,888244,Staff,0,0,0,0
1746599443576,EDS 25,B01,888273,Staff,0,0,0,0
1746599443576,EDS 25,B02,888285,Staff,0,0,0,0
1746599443576,EDS 25,B03,888423,Staff,0,0,0,1
1746599443576,EDS 25,B04,888432,Staff,0,0,0,0
1746599443576,EDS 25,B05,888433,Staff,0,0,0,0
1746599443576,EDS 25,B06,888467,Staff,0,0,0,0
1746599443576,EDS 25,B07,888468,Staff,0,0,0,0
1746599443576,EDS 25,B08,888479,Staff,0,0,0,0
1746599443576,EDS 25,B09,888484,Staff,0,0,0,0
1746599443576,EDS 25,B10,888487,Staff,0,0,0,0
1746599444601,EDS 38,A01,907700,Choi; Bailey Miyeon,30,0,30,0
1746599445628,EDS 112,A01,888601,Chapman; Thandeka K,12,0,40,28
1746599446652,EDS 115,A00,888697,Mendez; Kathrina Mendoza,10,0,30,20
1746599447680,EDS 116,A01,888893,Staff,33,0,40,7
1746599449735,EDS 124AR,A00,889133,Staff,29,0,50,21
1746599449735,EDS 124AR,B00,907471,Simon; Elizabeth A,37,0,50,13
1746599450759,EDS 124BR,A00,889134,Simon; Elizabeth A,44,0,100,56
1746599451784,EDS 125,A00,889135,Staff,25,0,30,5
1746599452811,EDS 126,A01,889138,Staff,35,0,40,5
1746599453844,EDS 164R,A01,889142,Wishard Guerra; Alison G.,32,0,50,18
1746599454876,ENG 30,A01,886396,Staff,0,0,0,0
1746599454876,ENG 30,B01,886398,Staff,0,0,0,0
1746599455912,ENVR 102,A00,906150,Montejo; Carolina,23,0,25,2
1746599456938,ETHN 103A,A00,887236,Man; Simeon S,0,2,0,0
1746599457964,ETHN 113,A00,887239,Staff,16,0,30,14
1746599458989,ETHN 116,A00,887240,Staff,16,0,25,9
1746599460016,ETHN 117,A00,887241,Choi; Esther Min,28,0,30,2
1746599461048,ETHN 118,A00,887243,Staff,24,0,30,6
1746599462075,ETHN 127,A00,887248,Cuong; Marisol,11,0,15,4
1746599463101,ETHN 139,A00,887250,Staff,7,0,10,3
1746599464132,ETHN 142,A00,887252,Staff,10,0,30,20
1746599465157,ETHN 161,A00,887253,Browne; Errol Tsekani,24,0,30,6
1746599466182,ETHN 163FR,A00,887255,Burelle; Julie Sara Veronique,0,0,5,5
1746599467207,GLBH 20,A00,889149,Elwardani; Nile Regina,8,0,42,34
1746599469266,GLBH 111,A01,889152,Burgos; Jose L.,17,0,17,0
1746599470293,GLBH 150,A00,889181,Sloane; Julia Kathryn,0,5,15,15
1746599472345,HDS 60,A01,886406,Warstadt; Melissa Fawn,72,0,80,8
1746599473370,HIAF 111,A00,889324,Gyamfi; Bright,25,0,32,7
1746599474396,HIEA 131,A00,889328,Staff,15,0,32,17
1746599475422,HIEA 144,A00,889333,Henry; Todd A.,26,0,32,6
1746599476449,HIEA 154,A00,889336,Henry; Todd A.,24,0,32,8
1746599477478,HIEU 106,A00,889339,Staff,22,0,32,10
1746599479529,HIEU 114,A00,889340,Staff,4,0,32,28
1746599480556,HIEU 135GS,A00,889342,Patterson; Patrick H.,0,0,1,24
1746599481582,HIEU 137,A00,889343,Edington; Claire Ellen,10,0,25,15
1746599482608,HIEU 148,A00,889345,Staff,14,0,32,18
1746599483633,HIEU 154,A00,889346,Biess; Frank Peter,21,0,32,11
1746599484658,HILA 102,A00,889351,Staff,12,0,32,20
1746599485682,HILD 2A,A01,889221,Lewandoski; Julia Mavis,0,8,32,32
1746599486710,HILD 7B,A01,889225,Man; Simeon S,0,12,32,32
1746599487736,HILD 7C,A01,889288,Alvarez; Luis A,0,14,32,32
1746599488761,HILD 30,A01,889323,Staff,0,5,32,32
1746599490817,HISC 119,A00,889383,Golan; Tal,20,0,32,12
1746599491844,HIUS 103,A00,889384,Man; Simeon S,0,0,32,32
1746599492871,HIUS 117,A00,919797,Kwak; Nancy,18,0,32,14
1746599493898,HIUS 142A,A00,919788,Staff,22,0,32,10
1746599495947,HIUS 149,A00,889386,Gyamfi; Bright,26,0,32,6
1746599496974,HIUS 155,A00,889387,Alvarez; Luis A,15,0,32,17
1746599498000,HUM 3,A01,886499,Caldwell; Michael Alan,19,0,50,31
1746599499025,HUM 3GS,A00,886500,Rodriguez; Bretton Sigfred,0,0,0,28
1746599500050,HUM 3R,A01,886502,Markman; Kristina,0,36,50,50
1746599501080,HUM 4,A01,886504,Crum; Matthew Stephen,23,0,50,27
1746599501080,HUM 4,B01,886506,West; Geoffrey Scott,17,0,50,33
1746599502108,HUM 4GS,A00,886507,Staff,0,0,0,19
1746599503134,HUM 5,A01,886509,Staff,31,0,50,19
1746599504161,HUM 5R,A01,886511,Zavodny; Tatiana Sophia,0,39,50,50
1746599505184,JAPN 180,A00,886407,Staff,16,0,40,24
1746599506209,LATI 50,A01,886409,Martin-Cabrera; Luis,3,0,22,19
1746599506209,LATI 50,A02,886410,Martin-Cabrera; Luis,19,0,22,3
1746599506209,LATI 50,A03,886411,Martin-Cabrera; Luis,21,0,22,1
1746599506209,LATI 50,A04,886412,Martin-Cabrera; Luis,8,0,22,14
1746599507238,LAWS 101,A00,907664,Staff,28,0,60,32
1746599508264,LIAB 1A,A00,889388,Saab; Dima,17,0,20,3
1746599509291,LIAB 1AX,A00,889389,El Cheddadi; Youniss,18,0,20,2
1746599510317,LIFR 1C,A00,889391,Van Moer; Vinciane G,8,0,20,12
1746599511342,LIFR 1CX,A00,889392,Van Moer; Vinciane G,7,0,20,13
1746599512367,LIFR 1D,A00,889393,Van Moer; Vinciane G,7,0,20,13
1746599513392,LIFR 1DX,A00,889394,Van Moer; Vinciane G,8,0,20,12
1746599514418,LIGN 7,A00,886923,Staff,25,0,50,25
1746599515443,LIGN 17,A00,886924,Kehler; Andrew Scott,126,0,150,24
1746599516469,LTAM 110,A00,889395,Staff,15,0,30,15
1746599517493,LTAM 110GS,A00,958010,Rodriguez; Bretton Sigfred,0,0,0,28
1746599518522,LTCH 101,A00,889397,Staff,23,0,25,2
1746599519549,LTCS 130,A00,889398,Staff,23,0,25,2
1746599520574,LTEA 138,A00,889399,Staff,24,0,40,16
1746599521598,LTEN 149,A00,889400,Wesling; Megan E.,0,3,25,25
1746599522623,LTEN 169,A00,889401,Staff,20,0,25,5
1746599523649,LTEN 180,A00,889402,Staff,10,0,15,5
1746599524675,LTEN 181,A00,889403,Staff,21,0,25,4
1746599525702,LTWL 100,A00,889404,Myerston Santana; Jacobo,2,0,25,23
1746599526727,LTWL 180GS,A00,889405,Staff,0,0,20,20
1746599527752,LTWL 181,A00,889406,Staff,16,0,25,9
1746599528779,LTWL 184,A00,889475,Mukherjee; Silpa,22,0,25,3
1746599529806,LTWR 102C,A00,889486,Staff,29,0,30,1
1746599530830,LTWR 115W,A00,889491,Staff,0,2,15,15
1746599531858,MAE 8,A01,886905,Staff,0,2,0,0
1746599532886,MAE 11,A00,886906,Bandaru; Prabhakar,0,7,50,50
1746599533910,MAE 20,A00,886907,Evdokimenko; Ekaterina,43,0,70,27
1746599534937,MAE 30B,A00,886909,Ghazinejad; Maziar,25,0,45,20
1746599535963,MAE 101B,A00,886910,Saintillan; David,30,0,45,15
1746599536989,MAE 105,A00,886911,Bandaru; Prabhakar,18,0,50,32
1746599538014,MAE 107,B00,958024,Staff,7,0,50,43
1746599539044,MAE 143B,A00,886913,Bewley; Thomas R,2,0,40,38
1746599540073,MAE 148,A01,886915,Silberman; Jack,0,3,14,14
1746599541097,MAE 160,A00,886916,Evdokimenko; Ekaterina,30,0,60,30
1746599542121,MATH 3C,A01,889681,Staff,0,2,30,30
1746599542121,MATH 3C,A02,960048,Staff,23,0,30,7
1746599543146,MATH 10A,A01,889760,Staff,26,0,30,4
1746599543146,MATH 10A,A02,889783,Staff,29,0,30,1
1746599544172,MATH 10B,A01,889785,Verstraete; Jacques Allan,1,0,35,34
1746599544172,MATH 10B,A02,889795,Verstraete; Jacques Allan,4,0,35,31
1746599544172,MATH 10B,B01,889797,Verstraete; Jacques Allan,3,0,35,32
1746599544172,MATH 10B,B02,889828,Verstraete; Jacques Allan,3,0,35,32
1746599545197,MATH 10C,A01,889849,Habib; Yousaf,8,0,30,22
1746599545197,MATH 10C,A02,889852,Habib; Yousaf,14,0,30,16
1746599545197,MATH 10C,A03,889853,Habib; Yousaf,22,0,30,8
1746599545197,MATH 10C,A04,889858,Habib; Yousaf,20,0,30,10
1746599545197,MATH 10C,B01,889861,Staff,1,0,30,29
1746599545197,MATH 10C,B02,889862,Staff,24,0,30,6
1746599545197,MATH 10C,B03,889863,Staff,27,0,30,3
1746599545197,MATH 10C,B04,889967,Staff,23,0,30,7
1746599546222,MATH 18,A01,889974,Staff,7,0,30,23
1746599546222,MATH 18,A02,889977,Staff,20,0,30,10
1746599546222,MATH 18,B01,889984,Hardiman; Liam,20,0,30,10
1746599546222,MATH 18,B02,889985,Hardiman; Liam,25,0,30,5
1746599547251,MATH 20A,A01,889990,Suk; Andrew Hoon,30,0,35,5
1746599548278,MATH 20B,A01,889993,Ohm; Ko Woon,21,0,30,9
1746599548278,MATH 20B,A02,889994,Ohm; Ko Woon,30,0,30,0
1746599548278,MATH 20B,B01,889996,Ohm; Ko Woon,22,0,30,8
1746599548278,MATH 20B,B02,889997,Ohm; Ko Woon,23,0,30,7
1746599549304,MATH 20C,A01,889999,Hammock; Frances H,17,0,30,13
1746599549304,MATH 20C,A02,890003,Hammock; Frances H,23,0,30,7
1746599549304,MATH 20C,B01,890006,Hammock; Frances H,2,0,30,28
1746599549304,MATH 20C,B02,890007,Hammock; Frances H,12,0,30,18
1746599550330,MATH 20D,A01,890011,Cheng; Hsiao-Bing,1,0,30,29
1746599550330,MATH 20D,A02,890012,Cheng; Hsiao-Bing,14,0,30,16
1746599550330,MATH 20D,B01,890016,Cheng; Hsiao-Bing,13,0,30,17
1746599550330,MATH 20D,B02,890017,Cheng; Hsiao-Bing,13,0,30,17
1746599551355,MATH 20E,A01,890026,Harel; Guershon,1,0,30,29
1746599551355,MATH 20E,A02,890029,Harel; Guershon,22,0,30,8
1746599551355,MATH 20E,B01,890033,Harel; Guershon,7,0,30,23
1746599551355,MATH 20E,B02,890101,Harel; Guershon,21,0,30,9
1746599552379,MATH 102,A01,890104,Staff,18,0,30,12
1746599552379,MATH 102,A02,890105,Staff,27,0,30,3
1746599553406,MATH 103B,A01,890116,Salehi Golsefidy; Alireza,3,0,30,27
1746599553406,MATH 103B,B01,890118,Staff,0,3,34,34
1746599554431,MATH 109,A01,890121,Aliabadi Sr.; Mohsen,0,0,30,30
1746599554431,MATH 109,B01,890124,Upadrashta; Pranav Kumar,18,0,30,12
1746599555460,MATH 120A,A01,890126,Eggers; John Dietrich,13,0,30,17
1746599556489,MATH 142B,A01,890128,Ioana; Adrian,19,0,30,11
1746599556489,MATH 142B,A02,890129,Ioana; Adrian,12,0,30,18
1746599557515,MATH 154,A01,890174,Staff,0,1,30,30
1746599557515,MATH 154,A02,890182,Staff,0,0,30,30
1746599558540,MATH 168A,A01,890197,Dumitriu; Ioana,21,0,35,14
1746599559566,MATH 170A,A01,890240,Nie; Jiawang,1,0,30,29
1746599559566,MATH 170A,A02,890241,Nie; Jiawang,11,0,30,19
1746599559566,MATH 170A,A03,890249,Nie; Jiawang,23,0,30,7
1746599560595,MATH 170B,A01,957891,Nag; Panchali,13,0,35,22
1746599562644,MATH 181A,A01,908025,Staff,0,3,35,35
1746599562644,MATH 181A,A02,960115,Staff,26,0,35,9
1746599563670,MATH 181B,A01,959874,Staff,24,0,30,6
1746599564696,MATH 193B,A01,890265,Staff,0,4,35,35
1746599565725,MGT 4,A01,890311,Anderson; John Charles,42,0,88,46
1746599566751,MGT 5,A00,907740,Staff,12,0,98,86
1746599567777,MGT 12,A00,890312,Lindenberger; Wade Douglas,67,0,98,31
1746599568805,MGT 16,A00,957883,Staff,78,0,98,20
1746599570857,MGT 45,A00,890314,Pecore; Joseph P.,45,0,98,53
1746599571885,MGT 71,A00,890315,Staff,0,12,98,98
1746599572914,MGT 100,A00,890316,Yavorsky; Daniel Ryan,44,0,98,54
1746599573938,MGT 103,A00,890317,Ehrich; Kristine R,73,0,98,25
1746599574985,MGT 105,A00,890356,Bates; Kenneth Walter,0,8,98,98
1746599576011,MGT 112,A00,890360,Ehrich; Kristine R,55,0,98,43
1746599577036,MGT 127R,A00,907732,Zhu; Kevin Xiaoguo,23,0,98,75
1746599578060,MGT 131B,A00,890361,Anderson; John Charles,59,0,98,39
1746599579087,MGT 137,A00,890362,Lindenberger; Wade Douglas,65,0,98,33
1746599580113,MGT 160,A00,890369,Johnson; Erik Barry,9,0,98,89
1746599582170,MGT 164,A00,890372,Zimmermann; Carsten,0,40,98,98
1746599583196,MGT 180,A00,890374,Bliss; Barbara Ann,11,0,98,87
1746599584220,MMW 15,A01,886414,Chang; Edmond Yi-Teh,0,12,28,28
1746599584220,MMW 15,A02,886415,Chang; Edmond Yi-Teh,0,8,28,28
1746599584220,MMW 15,A03,886416,Chang; Edmond Yi-Teh,0,9,28,28
1746599584220,MMW 15,A04,886417,Chang; Edmond Yi-Teh,0,8,28,28
1746599584220,MMW 15,B01,886419,Chang; Edmond Yi-Teh,0,7,28,28
1746599584220,MMW 15,B02,886420,Chang; Edmond Yi-Teh,0,7,28,28
1746599584220,MMW 15,B03,886421,Chang; Edmond Yi-Teh,0,7,28,28
1746599584220,MMW 15,B04,886422,Chang; Edmond Yi-Teh,0,8,28,28
1746599584220,MMW 15,C01,886424,Staff,0,9,28,28
1746599584220,MMW 15,C02,886425,Staff,0,8,28,28
1746599584220,MMW 15,C03,886426,Staff,0,8,28,28
1746599584220,MMW 15,C04,886427,Staff,0,8,28,28
1746599584220,MMW 15,C05,958038,Staff,0,8,28,28
1746599584220,MMW 15,C06,958039,Staff,0,7,28,28
1746599585245,MMW 15GS,A00,906910,Patterson; Patrick H.,4,0,28,24
1746599586274,MMW 122R,A01,886429,Rahimi; Babak,0,13,28,28
1746599586274,MMW 122R,A02,886430,Rahimi; Babak,0,12,28,28
1746599586274,MMW 122R,A03,958040,Rahimi; Babak,0,11,28,28
1746599587306,MUS 1A,A01,890937,Staff,2,0,25,23
1746599587306,MUS 1A,A02,891035,Staff,6,0,25,19
1746599587306,MUS 1A,C01,958912,Staff,24,0,25,1
1746599587306,MUS 1A,C02,958913,Staff,25,0,25,0
1746599589362,MUS 2AK,A00,957092,Ohnishi; Takae,15,0,15,0
1746599590389,MUS 4,A01,891044,Staff,0,0,25,25
1746599590389,MUS 4,A02,891045,Staff,22,0,25,3
1746599590389,MUS 4,B01,891048,Staff,17,0,25,8
1746599590389,MUS 4,B02,891050,Staff,25,0,25,0
1746599591415,MUS 5,A01,957506,Dubnov; Shlomo,0,0,25,25
1746599591415,MUS 5,A02,957622,Dubnov; Shlomo,13,0,25,12
1746599591415,MUS 5,A03,957623,Dubnov; Shlomo,20,0,25,5
1746599592441,MUS 6,A01,891053,Freitas Caetano; Marcelo,24,0,25,1
1746599592441,MUS 6,A02,891054,Freitas Caetano; Marcelo,23,0,25,2
1746599593470,MUS 7,A01,891081,Staff,0,0,25,25
1746599593470,MUS 7,A02,891082,Staff,3,0,25,22
1746599594498,MUS 8GS,A00,891118,Borgo; David Garcia,1,0,25,24
1746599595524,MUS 11,A01,891140,Staff,8,0,25,17
1746599595524,MUS 11,A02,891141,Staff,21,0,25,4
1746599596551,MUS 13,A01,891143,Staff,8,0,25,17
1746599596551,MUS 13,A02,891144,Staff,24,0,25,1
1746599597578,MUS 15,A01,891146,Staff,9,0,25,16
1746599597578,MUS 15,A02,891148,Staff,21,0,25,4
1746599597578,MUS 15,B01,891150,Staff,18,0,25,7
1746599597578,MUS 15,B02,891151,Staff,25,0,25,0
1746599598604,MUS 20,A01,891153,Staff,5,0,20,15
1746599598604,MUS 20,A02,891155,Staff,14,0,20,6
1746599599633,MUS 80,A00,891156,Staff,19,0,25,6
1746599599633,MUS 80,B00,891157,Staff,23,0,25,2
1746599600661,MUS 130,A00,891158,Ohnishi; Takae,35,0,35,0
1746599601687,MUS 150GS,A01,891160,Borgo; David Garcia,1,0,25,24
1746599602717,MUS 170,A01,891162,Freitas Caetano; Marcelo,20,0,25,5
1746599602717,MUS 170,A02,891164,Freitas Caetano; Marcelo,21,0,25,4
1746599603742,NANO 11,A00,886220,Vazquez Mena; Oscar,13,0,15,2
1746599604769,NANO 15,A01,886222,Drews; Aaron,4,0,7,3
1746599605800,NANO 104,A00,886224,Sirbuly; Donald,17,0,25,8
1746599606829,PH 40,A00,886528,Staff,23,0,40,17
1746599607862,PH 45,A01,886799,Staff,35,0,40,5
1746599608888,PH 110,A00,886802,Staff,0,6,40,40
1746599609914,PH 172,A00,906716,Staff,19,0,35,16
1746599610942,PH 191,A00,886803,Staff,6,0,40,34
1746599611969,PHIL 1,A00,889500,Staff,20,0,30,10
1746599612995,PHIL 10,A01,889549,Grush; Rick Scott,16,0,22,6
1746599612995,PHIL 10,A02,889551,Grush; Rick Scott,22,0,22,0
1746599614025,PHIL 28,A01,889559,Lamey; Andy M.,0,2,31,31
1746599614025,PHIL 28,A02,889561,Lamey; Andy M.,0,1,30,30
1746599614025,PHIL 28,A03,889572,Lamey; Andy M.,0,1,30,30
1746599615051,PHIL 35,A00,907839,Staff,13,0,15,2
1746599616077,PHIL 60,A00,889574,Staff,73,0,90,17
1746599617104,PHIL 101,A00,958004,Staff,12,0,15,3
1746599619158,PHIL 136,A00,889582,Fulkerson; Matthew Todd,26,0,45,19
1746599620185,PHIL 163,A01,889601,Staff,21,0,30,9
1746599620185,PHIL 163,B01,889606,Brandt; Reuven A,0,3,0,0
1746599621212,PHIL 164,A00,889610,Staff,16,0,30,14
1746599622238,PHIL 165,A00,889613,Staff,22,0,30,8
1746599623261,PHYS 1A,A00,886431,Staff,30,0,70,40
1746599624289,PHYS 1AL,001,886432,Tsai; Philbert S,0,1,30,30
1746599624289,PHYS 1AL,002,886436,Tsai; Philbert S,13,0,30,17
1746599625313,PHYS 1B,A00,886439,Staff,184,0,240,56
1746599626338,PHYS 1BL,001,886441,Tsai; Philbert S,0,4,30,30
1746599626338,PHYS 1BL,002,886444,Tsai; Philbert S,2,0,30,28
1746599627368,PHYS 1C,A00,896092,Arnold; Kam S,78,0,146,68
1746599628393,PHYS 1CL,001,886448,Tsai; Philbert S,0,0,30,30
1746599628393,PHYS 1CL,002,886449,Tsai; Philbert S,1,0,30,29
1746599628393,PHYS 1CL,003,886450,Tsai; Philbert S,16,0,30,14
1746599628393,PHYS 1CL,004,886451,Tsai; Philbert S,15,0,30,15
1746599629422,PHYS 2B,A01,886457,Staff,67,0,115,48
1746599630448,PHYS 2C,A01,886460,Shotwell; Brian,0,9,65,65
1746599631476,PHYS 2CL,A01,886467,Staff,0,4,28,28
1746599631476,PHYS 2CL,A02,886468,Staff,0,3,28,28
1746599632507,PHYS 2D,A01,886470,Staff,10,0,50,40
1746599633534,PHYS 4B,A01,886475,Grinstein; Benjamin,22,0,40,18
1746599634584,POLI 5,A00,891173,Desposato; Scott,7,0,25,18
1746599635612,POLI 5D,A01,891175,Staff,5,0,5,0
1746599635612,POLI 5D,B01,891178,Staff,5,0,5,0
1746599636640,POLI 11,A00,891179,Ferree; Karen E,0,0,35,35
1746599637665,POLI 12,A00,891180,Staff,15,0,30,15
1746599638694,POLI 27,A01,891182,Staff,11,0,75,64
1746599639718,POLI 30,A00,891183,Staff,8,0,50,42
1746599640745,POLI 100B,A00,891244,Staff,5,1,35,30
1746599641772,POLI 100I,A00,891247,Staff,7,0,30,23
1746599642800,POLI 104J,A00,891248,Nichter; Maysa,14,0,30,16
1746599643826,POLI 104U,A00,891250,Nichter; Maysa,1,0,30,29
1746599645879,POLI 110B,A00,891255,Wiens; David,19,0,25,6
1746599646907,POLI 112A,A00,891256,Wiens; David,6,0,25,19
1746599647934,POLI 114BR,A00,891261,Staff,19,0,30,11
1746599648962,POLI 117R,A00,891262,Forman; Fonna,0,6,50,50
1746599649988,POLI 118,A00,891264,Ingham; Sean,17,0,25,8
1746599651013,POLI 124A,A00,891265,Staff,18,0,20,2
1746599652040,POLI 125D,A00,891266,Nichter; Simeon C,2,0,25,23
1746599653065,POLI 126,A00,891268,Nichter; Simeon C,7,0,25,18
1746599654092,POLI 126AA,A00,891272,Staff,15,0,25,10
1746599655122,POLI 130AA,A00,891273,Staff,15,0,20,5
1746599656150,POLI 134AA,A00,891274,Staff,4,0,20,16
1746599658200,POLI 138,A00,891278,Staff,21,0,25,4
1746599659227,POLI 142K,A00,891280,Staff,10,0,25,15
1746599660252,POLI 142M,A00,891281,Gartzke; Erik,16,0,30,14
1746599661279,POLI 142P,A00,891284,Staff,20,0,30,10
1746599662305,POLI 143,A00,891285,Gartzke; Erik,12,0,30,18
1746599663332,POLI 153,A00,891286,Staff,19,0,20,1
1746599665388,POLI 175,A00,891290,Staff,15,0,20,5
1746599666415,PSYC 1,A00,890674,Steiner; Eric Tomas,0,11,45,45
1746599667443,PSYC 2,A00,890676,Albright; Thomas D,20,0,35,15
1746599668469,PSYC 3,A00,890679,Staff,17,0,20,3
1746599669497,PSYC 6,A00,959858,Staff,19,0,20,1
1746599670523,PSYC 60,A01,890684,Rickard; Timothy C.,0,6,45,45
1746599671550,PSYC 70,A01,890689,Geller; Emma Harlan,6,0,30,24
1746599672578,PSYC 71,A01,959860,Staff,21,0,25,4
1746599673604,PSYC 100,A00,890690,Lacefield; Katharine I,0,50,180,180
1746599674629,PSYC 102,A00,890695,Staff,18,0,40,22
1746599675662,PSYC 105,A00,890699,Geller; Emma Harlan,70,0,100,30
1746599676690,PSYC 106,A00,890701,Gorman; Michael R.,5,0,30,25
1746599677714,PSYC 108,A00,890704,Adrian; Julia Anna,0,29,50,50
1746599678739,PSYC 118,A01,890712,Staff,11,0,30,19
1746599679768,PSYC 124,A00,890716,Chapman; Eddie Nathaniel,25,0,60,35
1746599680794,PSYC 131,A00,890717,Anagnostaras; Stephan,0,7,80,80
1746599681820,PSYC 137,A00,890719,Winkielman; Piotr,0,11,30,30
1746599682848,PSYC 144,A00,890721,Adrian; Julia Anna,0,9,45,45
1746599683874,PSYC 162,A00,890805,Staff,0,2,75,75
1746599684900,PSYC 169,A00,890810,Staff,0,15,30,30
1746599685927,PSYC 172,A00,890814,Gorman; Michael R.,9,0,30,21
1746599686954,PSYC 181,A00,890818,Anagnostaras; Stephan,7,0,200,193
1746599687983,PSYC 184,A00,959861,Staff,162,0,175,13
1746599689009,PSYC 189,A00,890823,Staff,0,2,30,30
1746599690038,PSYC 191,A00,890884,Rickard; Timothy C.,0,11,35,35
1746599691063,PSYC 193,A00,890913,Staff,19,0,30,11
1746599691063,PSYC 193,B00,890914,Chapman; Eddie Nathaniel,24,0,30,6
1746599692092,PSYC 193L,A01,890918,Lowe; Angela Beth,20,0,30,10
1746599692092,PSYC 193L,B01,890921,Hurwitz; Ethan Scott,20,0,30,10
1746599692092,PSYC 193L,C01,890928,Staff,30,0,30,0
1746599693119,RELI 149,A00,886806,Rahimi; Babak,23,0,40,17
1746599694145,SE 9,A01,886814,Staff,7,0,20,13
1746599695175,SE 101B,A01,886816,Chadha; Mayank,3,0,35,32
1746599696202,SE 110B,A00,886818,Zhu; Qiang,4,0,75,71
1746599697229,SE 125,A01,886830,Staff,10,0,30,20
1746599698256,SE 130B,A01,886835,Staff,14,0,40,26
1746599699282,SE 131A,A01,886838,Krysl; Petr,34,0,55,21
1746599700311,SE 154,A00,886840,Staff,28,0,50,22
1746599701335,SE 164GS,A01,886849,Staff,6,0,20,14
1746599702361,SE 167GS,A01,886853,Staff,6,0,20,14
1746599703390,SIO 25,A01,890107,Staff,19,0,30,11
1746599704417,SIO 45,A00,890109,Cook; Geoffrey W,115,0,200,85
1746599705443,SIO 109R,A00,890110,Forman; Fonna,0,16,20,20
1746599706469,SIO 187,A01,890114,Kacev; David,15,0,40,25
1746599707499,SOCI 1,A01,890431,Thorpe; Charles Robert,14,0,30,16
1746599707499,SOCI 1,A02,890518,Thorpe; Charles Robert,30,0,30,0
1746599708553,SOCI 2,A01,957978,Staff,25,0,25,0
1746599708553,SOCI 2,A02,957979,Staff,23,0,25,2
1746599709581,SOCI 20,A01,890523,Calderon-Zaks; Michael Aar,21,0,30,9
1746599709581,SOCI 20,A02,890526,Calderon-Zaks; Michael Aar,29,0,30,1
1746599710605,SOCI 30,A01,890533,Pardo Guerra; Juan Pablo,37,0,40,3
1746599711631,SOCI 40,A01,890535,Staff,27,0,45,18
1746599712664,SOCI 104Q,A00,890559,Staff,18,0,30,12
1746599713693,SOCI 106,A00,890560,Arnal; Maud Marie Leonie,20,0,30,10
1746599714720,SOCI 110,A00,890567,Holkenbrink-Monk; Charlene,19,0,30,11
1746599715746,SOCI 112,A00,890568,Victoria Torres; Pablo,2,0,55,53
1746599716773,SOCI 115,A00,890597,Arnal; Maud Marie Leonie,28,0,45,17
1746599718823,SOCI 121,A00,890604,Pardo Guerra; Juan Pablo,38,0,45,7
1746599719848,SOCI 126,A01,890608,Staff,8,0,10,2
1746599720873,SOCI 127,A00,890609,Staff,18,0,30,12
1746599721902,SOCI 131,A00,890610,Thorpe; Charles Robert,37,0,45,8
1746599722927,SOCI 135,A00,890615,Payne; Christine Anna,14,0,45,31
1746599723955,SOCI 139,A00,890620,Staff,38,0,45,7
1746599724982,SOCI 148E,A00,890622,Calderon-Zaks; Michael Aar,36,0,45,9
1746599726007,SOCI 150,A00,890623,Kohler; Kristopher M.,31,0,45,14
1746599727036,SOCI 157,A00,890625,Jules-Rosette; Bennetta W.,18,0,20,2
1746599728065,SOCI 160,A00,890627,Payne; Christine Anna,21,0,45,24
1746599729094,SYN 1,A00,886855,Fish; Gwendolyn Anne,0,1,0,0
1746599729094,SYN 1,B00,906086,Fish; Gwendolyn Anne,0,2,0,2
1746599730120,SYN 2R,A00,886860,Staff,0,17,15,15
1746599730120,SYN 2R,B00,906106,Atkinson; Arthur Laird,0,16,15,15
1746599731148,SYN 100,A01,886866,Browne; Emily,0,28,20,20
1746599731148,SYN 100,B01,906128,Rock; Martin,0,4,20,20
1746599731148,SYN 100,C01,906140,Deavenport; James Cary,0,4,20,20
1746599731148,SYN 100,D01,907816,Deavenport; James Cary,0,5,20,20
1746599732175,TDAC 1,A00,890286,Walsh; Kim C.,7,0,20,13
1746599733201,TDAC 101,A00,890296,Basso; Beatrice,15,0,20,5
1746599734228,TDDE 131,A00,890297,Staff,47,0,50,3
1746599735259,TDDM 1,A00,890287,Weinberg; Sadie,25,0,30,5
1746599736286,TDGE 11,A00,890288,Fulton; Julia,138,0,200,62
1746599736286,TDGE 11,B00,890289,Castro; Robert Jess,184,0,200,16
1746599737313,TDGE 25,B00,957359,Walsh; Kim C.,5,0,20,15
1746599738344,TDGE 40,A01,890292,Power; Jade Yukana,26,0,30,4
1746599739374,TDGE 124,A00,890298,Havis; Allan,0,2,50,50
1746599740401,TDGE 131R,A00,890299,Burelle; Julie Sara Veronique,15,0,42,27
1746599741427,TDHT 101,A00,890300,Staff,10,0,20,10
1746599742457,TDHT 109,A01,890302,Anderson; Mysia Anyse,31,0,40,9
1746599743485,TDMV 1,A00,890293,Arcidiacono; Kristin,18,0,30,12
1746599744512,TDMV 2,A00,890294,Weinberg; Sadie,23,0,30,7
1746599745539,TDMV 3,A00,957878,Arcidiacono; Kristin,28,0,30,2
1746599747602,TDMV 138,A00,890304,Jun; Grace Shin Hae,25,0,40,15
1746599748625,TDMV 140,A00,890305,Corrales; Joseph Bernales,25,0,30,5
1746599749652,TDMV 142,A00,890307,Caligagan; Tony,32,0,40,8
1746599750679,TDMV 144,A00,890308,Camaya; Michelle Ann,25,0,30,5
1746599751704,TDPW 1,A00,890295,Stein; Deborah Isobel,3,0,20,17
1746599752731,USP 2,A01,890272,Lerner; Amy M,7,0,20,13
1746599753761,USP 3,A01,890274,Staff,12,0,30,18
1746599754788,USP 15,A01,890276,Sun; Feiyang,16,0,30,14
1746599755813,USP 25,A00,890277,Shenkman; Michael Thomas,18,0,25,7
1746599756840,USP 138,A00,890278,Staff,13,0,25,12
1746599757865,USP 143,A00,890279,Staff,21,0,70,49
1746599758896,USP 144,A00,890280,Chowdhury; Muhammed Zohir,16,0,30,14
1746599759927,USP 150,A00,890281,Boomhower; Matthew Charles,4,0,30,26
1746599760956,USP 151,A00,890282,Staff,16,0,20,4
1746599761981,USP 162,A00,890283,Andrews; Abigail Leslie,16,0,20,4
1746599763012,USP 168,A00,920477,Kwak; Nancy,0,0,5,5
1746599764042,USP 181,A00,890284,Staff,3,0,20,17
1746599765069,USP 191A,A00,890285,Staff,12,0,20,8
1746599766098,VIS 101,A00,886512,Staff,26,0,75,49
1746599767127,VIS 103,A00,886513,Cruz; Edwin Teddy,61,0,75,14
1746599768154,VIS 108,A00,886514,Staff,4,0,15,11
1746599769181,VIS 127P,A00,886515,Shen; Kuiyi,80,0,146,66
1746599770207,VIS 149,A00,886516,Yoldas; Pinar,0,0,15,15
1746599771234,VIS 164,A00,886526,Erdmann; Dean,19,0,22,3
1746599772262,VIS 194S,A00,886527,Staff,61,0,75,14
1746599773291,WCWP 10A,C00,886484,Martiniuk; Jill,12,0,15,3
1746599774318,WCWP 10B,A00,886490,Uriarte; Emma,0,0,15,15
1746599774318,WCWP 10B,B00,886491,Dhir; Simrita,8,0,15,7
1746599774318,WCWP 10B,C00,886492,Ornelas; Tricia,0,0,15,15
1746599775344,WCWP 100,A00,886494,Young; Mark T,0,6,15,15
1746599777484,AAS 10,A01,886199,Childs; Dennis R.,0,3,0,0
1746599778509,ANAR 104,A01,886940,Shtienberg; Gilad,27,0,30,3
1746599779535,ANAR 120,A00,886953,Staff,13,0,20,7
1746599780558,ANBI 148,A01,886955,Wilder; Linnea Lorene,30,0,40,10
1746599782614,ANSC 122,A00,886957,Staff,24,0,30,6
1746599783642,ANSC 150,A00,886958,Sloane; Julia Kathryn,2,0,15,13
1746599784669,ANSC 156,A00,886959,Jenkins; Janis A.,0,1,15,15
1746599785695,ANSC 180,A00,886960,Staff,11,0,17,6
1746599786723,ANSC 188,A00,886961,Jassal; Aftab,9,0,25,16
1746599787748,ANSC 190,A00,886962,Jassal; Aftab,14,0,25,11
1746599788774,ANSC 191,A00,886963,Staff,18,0,20,2
1746599789800,ANTH 3,A01,891689,Staff,17,0,20,3
1746599790831,ANTH 5,A00,886933,Semendeferi; Ekaterini,16,0,20,4
1746599791865,ANTH 10,A00,886934,Staff,0,12,30,30
1746599792892,ANTH 21,A01,886936,Staff,41,0,60,19
1746599793921,ANTH 23,A01,886938,Staff,92,0,100,8
1746599794951,ANTH 105,A00,886964,Stewart; Alexander B,84,0,100,16
1746599795978,ANTH 108,A00,886965,Pedersen; David,9,0,20,11
1746599797010,AWP 10,001,886147,Staff,0,0,0,0
1746599797010,AWP 10,002,886148,Staff,0,0,0,0
1746599797010,AWP 10,003,886149,Staff,0,0,0,0
1746599797010,AWP 10,004,886150,Staff,0,0,0,0
1746599797010,AWP 10,005,886151,Staff,0,0,0,0
1746599797010,AWP 10,006,886152,Staff,0,0,0,0
1746599797010,AWP 10,007,886153,Staff,0,0,0,0
1746599797010,AWP 10,008,886154,Staff,0,0,0,0
1746599797010,AWP 10,009,886155,Staff,0,0,0,0
1746599797010,AWP 10,010,886156,Staff,0,0,0,0
1746599797010,AWP 10,011,886158,Staff,0,0,0,0
1746599797010,AWP 10,012,886160,Staff,0,0,0,0
1746599797010,AWP 10,013,886161,Staff,0,0,0,0
1746599797010,AWP 10,014,886162,Staff,0,0,0,0
1746599797010,AWP 10,015,886163,Staff,0,0,0,0
1746599797010,AWP 10,016,886164,Staff,0,0,0,0
1746599797010,AWP 10,017,886165,Staff,0,0,0,0
1746599797010,AWP 10,018,886166,Staff,0,0,0,0
1746599797010,AWP 10,019,886168,Staff,0,0,0,0
1746599797010,AWP 10,020,886170,Staff,0,0,0,0
1746599797010,AWP 10,021,886172,Staff,0,0,0,0
1746599798039,AWP 10R,001,886173,Staff,0,1,0,0
1746599798039,AWP 10R,002,886174,Staff,0,1,0,0
1746599798039,AWP 10R,003,886175,Staff,0,0,0,0
1746599798039,AWP 10R,004,886176,Staff,0,0,0,0
1746599798039,AWP 10R,005,886177,Staff,0,0,0,0
1746599798039,AWP 10R,006,886178,Staff,0,0,0,0
1746599798039,AWP 10R,007,886179,Staff,0,0,0,0
1746599798039,AWP 10R,008,886181,Staff,0,0,0,0
1746599798039,AWP 10R,009,886182,Staff,0,0,0,0
1746599798039,AWP 10R,010,886183,Staff,0,0,0,0
1746599798039,AWP 10R,011,886184,Staff,0,0,0,0
1746599798039,AWP 10R,012,886185,Staff,0,0,0,0
1746599798039,AWP 10R,013,886186,Staff,0,0,0,0
1746599798039,AWP 10R,014,886187,Staff,0,0,0,0
1746599798039,AWP 10R,015,886188,Staff,0,0,0,0
1746599798039,AWP 10R,016,886189,Staff,0,0,0,0
1746599798039,AWP 10R,017,960532,Staff,0,0,0,0
1746599798039,AWP 10R,018,960533,Staff,0,0,0,0
1746599798039,AWP 10R,019,960534,Staff,0,0,0,0
1746599798039,AWP 10R,020,960538,Staff,0,0,0,0
1746599798039,AWP 10R,021,960540,Staff,0,0,0,0
1746599798039,AWP 10R,022,960541,Staff,0,0,0,0
1746599798039,AWP 10R,023,960542,Staff,0,0,0,0
1746599798039,AWP 10R,024,960544,Staff,0,0,0,0
1746599798039,AWP 10R,025,960545,Staff,0,0,0,0
1746599798039,AWP 10R,026,960548,Staff,0,0,0,0
1746599799066,AWP 102R,A00,886190,Staff,0,0,0,0
1746599799066,AWP 102R,B00,886191,Staff,0,0,0,0
1746599800094,BENG 100,A01,886193,Staff,17,0,30,13
1746599801124,BENG 122A,A01,886195,Hasty; Jeff M,13,0,30,17
1746599802155,BENG 166A,A00,886196,Sah; Robert Lie-Yuan,0,3,30,30
1746599803184,BENG 190,A00,958050,Khojah; Reem I,17,0,25,8
1746599804213,BIBC 102,A01,894320,Staff,0,1,46,46
1746599804213,BIBC 102,A02,894321,Staff,0,0,46,46
1746599804213,BIBC 102,A03,894344,Staff,6,0,46,40
1746599804213,BIBC 102,A04,894345,Staff,27,0,47,20
1746599805240,BICD 100R,A01,894365,Smith; Laurie,0,2,58,58
1746599805240,BICD 100R,A02,894366,Smith; Laurie,0,4,58,58
1746599805240,BICD 100R,A03,894367,Smith; Laurie,0,0,59,59
1746599805240,BICD 100R,A04,959869,Smith; Laurie,38,0,59,21
1746599806269,BICD 136,A01,894383,Gustafson-Brown; Cindy,14,0,50,36
1746599807300,BIEB 102,A01,894494,Butler; Shannon Rhey,51,0,130,79
1746599809352,BIEB 150,A01,894617,Wills; Christopher,3,0,20,17
1746599809352,BIEB 150,A02,894631,Wills; Christopher,3,0,20,17
1746599809352,BIEB 150,A03,894937,Wills; Christopher,3,0,20,17
1746599809352,BIEB 150,A04,894946,Wills; Christopher,5,0,20,15
1746599810378,BIEB 194,A00,906141,Kurle; Carolyn M.,5,0,20,15
1746599811405,BILD 1,A01,894154,Staff,3,0,19,16
1746599811405,BILD 1,A02,894155,Staff,14,0,19,5
1746599811405,BILD 1,A03,894160,Staff,13,0,19,6
1746599811405,BILD 1,A04,894161,Staff,15,0,18,3
1746599812433,BILD 2,A01,894168,Staff,0,0,50,50
1746599812433,BILD 2,A02,894169,Staff,0,0,50,50
1746599812433,BILD 2,A03,894179,Staff,0,0,50,50
1746599812433,BILD 2,A04,894203,Staff,22,0,50,28
1746599813460,BILD 3,A01,894213,Staff,23,0,31,8
1746599813460,BILD 3,A02,894214,Staff,26,0,31,5
1746599813460,BILD 3,A03,894235,Staff,28,0,31,3
1746599813460,BILD 3,A04,894236,Staff,28,0,32,4
1746599814484,BILD 4,A01,894253,Reuther; Keefe,5,0,24,19
1746599814484,BILD 4,A02,894258,Reuther; Keefe,16,0,24,8
1746599815516,BILD 5,A01,894276,Reuther; Keefe,34,0,50,16
1746599815516,BILD 5,A02,894277,Reuther; Keefe,45,0,50,5
1746599815516,BILD 5,A03,894290,Reuther; Keefe,44,0,50,6
1746599815516,BILD 5,A04,894291,Reuther; Keefe,48,0,50,2
1746599816548,BILD 24,A01,894297,Pirino; Giorgia,40,0,60,20
1746599817577,BIMM 100,B01,958915,Staff,71,0,100,29
1746599818602,BIMM 101,A01,895017,McDonnell; Lisa Marie,0,5,24,24
1746599818602,BIMM 101,A02,895018,McDonnell; Lisa Marie,0,5,24,24
1746599818602,BIMM 101,B01,895020,McDonnell; Lisa Marie,0,5,24,24
1746599818602,BIMM 101,B02,895021,McDonnell; Lisa Marie,0,4,24,24
1746599819626,BIMM 110,A01,895023,Staff,1,0,25,24
1746599819626,BIMM 110,A02,895024,Staff,9,0,25,16
1746599819626,BIMM 110,A03,895025,Staff,18,0,25,7
1746599819626,BIMM 110,A04,895031,Staff,20,0,25,5
1746599820654,BIMM 120,A01,895114,Gustafson-Brown; Cindy,14,0,28,14
1746599820654,BIMM 120,A02,895126,Gustafson-Brown; Cindy,21,0,27,6
1746599821681,BIPN 100,A01,895130,Yang; Mingyu,0,0,38,38
1746599821681,BIPN 100,A02,895131,Yang; Mingyu,31,0,38,7
1746599821681,BIPN 100,A03,895132,Yang; Mingyu,32,0,38,6
1746599821681,BIPN 100,A04,895133,Yang; Mingyu,27,0,36,9
1746599822707,BIPN 120,A01,895135,Cooke; James Edward,0,3,13,13
1746599822707,BIPN 120,A02,895136,Cooke; James Edward,0,1,13,13
1746599822707,BIPN 120,A03,895137,Cooke; James Edward,0,3,13,13
1746599822707,BIPN 120,A04,895156,Cooke; James Edward,0,2,11,11
1746599823737,BIPN 134,A01,895235,Cooke; James Edward,0,1,25,25
1746599823737,BIPN 134,A02,895237,Cooke; James Edward,0,0,25,25
1746599823737,BIPN 134,A03,895240,Cooke; James Edward,1,0,25,24
1746599823737,BIPN 134,A04,895270,Cooke; James Edward,20,0,25,5
1746599824766,BIPN 189,A00,892103,Staff,0,14,14,14
1746599826814,BISP 194,A00,958008,Staff,0,2,0,0
1746599827843,CAT 124,A01,922009,Staff,0,5,20,20
1746599828869,CAT 125R,A00,886390,Morales; Celeste Georgianna,0,3,20,20
1746599828869,CAT 125R,B00,886391,Irwin; Matthew Joseph,0,4,20,20
1746599828869,CAT 125R,C00,886392,Smith; Lauryn Alissa,0,2,20,20
1746599828869,CAT 125R,D00,886393,Vanderschuit; Maya Alysia,0,3,20,20
1746599828869,CAT 125R,E00,886394,Marchisotto; Jennifer Anne,0,3,20,20
1746599829895,CENG 15,A01,886218,Drews; Aaron,3,0,8,5
1746599830921,CENG 113,A00,886219,Opatkiewicz; Justin Paul,15,0,25,10
1746599831951,CGS 101,A00,887044,Staff,7,0,20,13
1746599832976,CGS 105,A01,887046,Staff,14,0,25,11
1746599834003,CGS 112,A00,887047,Cuong; Marisol,12,0,15,3
1746599835033,CGS 113,A00,887048,Staff,23,0,30,7
1746599836061,CGS 120,A00,887049,Staff,9,0,17,8
1746599837086,CHEM 6A,A01,886336,Lam; Tin Yiu,38,0,50,12
1746599837086,CHEM 6A,A02,886338,Lam; Tin Yiu,37,0,50,13
1746599838117,CHEM 6B,A01,886341,Hopkins; Patrycja Anna,16,0,50,34
1746599838117,CHEM 6B,A02,886343,Hopkins; Patrycja Anna,42,0,50,8
1746599839146,CHEM 6C,A01,886346,Albizati; Kim F.,0,2,50,50
1746599839146,CHEM 6C,A02,886348,Albizati; Kim F.,24,0,50,26
1746599840171,CHEM 40A,A01,886352,Klosterman; Jeremy K,65,0,100,35
1746599841199,CHEM 40B,A01,886356,Klosterman; Jeremy K,0,24,100,100
1746599842232,CHEM 41B,A01,886360,Theodorakis; Emmanuel,25,0,50,25
1746599842232,CHEM 41B,A02,886362,Theodorakis; Emmanuel,47,0,50,3
1746599843257,CHIN 165A,A00,886382,Xu; Li,18,0,20,2
1746599844281,CLAS 120,A00,886387,Myerston Santana; Jacobo,33,0,40,7
1746599845328,COGS 9,A01,886967,Shannon; Kyle Michael,42,0,60,18
1746599846353,COGS 11,A01,886969,Staff,9,0,30,21
1746599847377,COGS 14A,A01,886971,Staff,5,0,60,55
1746599848405,COGS 14B,A01,886973,Hoffman; Drew Ellen,4,0,60,56
1746599849429,COGS 18,A01,886975,Morgan; Eric,34,0,60,26
1746599850453,COGS 20,A01,886977,Staff,3,0,8,5
1746599850453,COGS 20,A02,886978,Staff,5,0,7,2
1746599851492,COGS 100,A01,907783,Staff,0,1,30,30
1746599852517,COGS 101B,A01,886980,Staff,0,4,48,48
1746599853548,COGS 101C,A01,886982,Delgado; Tania,0,5,44,44
1746599854573,COGS 102A,A01,886984,Johnson; Christine M.,3,0,30,27
1746599855603,COGS 118B,A01,886986,Staff,0,4,88,88
1746599856628,COGS 150,A01,886988,Bergen; Benjamin,22,0,50,28
1746599857653,COGS 153,A00,886989,Delgado; Tania,0,3,41,41
1746599858683,COGS 186,A01,886991,Staff,0,0,32,32
1746599859712,COGS 187A,A01,886993,Boyle; Mary E. T.,7,0,30,23
1746599860738,COGS 189,A00,886994,Staff,0,1,30,30
1746599861766,COMM 10,A01,886996,Staff,0,0,20,21
1746599861766,COMM 10,A02,886997,Staff,10,0,20,10
1746599861766,COMM 10,A03,959845,Staff,19,0,20,1
1746599862795,COMM 20,A01,886999,Leuning; Grant Maurstad,24,0,40,16
1746599864845,COMM 100A,A01,887002,Staff,0,0,20,25
1746599864845,COMM 100A,A02,887003,Staff,5,0,20,15
1746599865871,COMM 100B,A01,887005,Staff,0,8,20,24
1746599866896,COMM 106D,A00,887006,Staff,14,0,40,26
1746599867921,COMM 110G,A00,887007,Whitworth-Smith; Andrew C,12,0,40,28
1746599868946,COMM 111B,A00,887008,Staff,31,0,40,9
1746599869975,COMM 113T,A00,887009,Abuelhiga; Soraya Jill,28,0,40,12
1746599869975,COMM 113T,B00,906733,Staff,39,0,40,1
1746599871001,COMM 145,A00,887010,Staff,13,0,40,27
1746599872026,COMM 146,A00,887054,Staff,32,0,40,8
1746599873052,COMM 190,A00,887012,Staff,8,0,23,15
1746599874076,CSE 8A,A50,887015,Cao; Yingjun,56,0,85,29
1746599875102,CSE 11,A01,887017,Cao; Yingjun,11,0,70,59
1746599876131,CSE 20,A01,887019,Staff,30,0,50,20
1746599877162,CSE 21,A01,887021,Staff,79,0,100,21
1746599877162,CSE 21,B01,892583,Braun; Oliver,45,0,50,5
1746599878188,CSE 30,A01,887025,Eldon; John,142,0,200,58
1746599879217,CSE 100,A01,887027,Staff,26,0,50,24
1746599879217,CSE 100,A02,887028,Staff,42,0,50,8
1746599880241,CSE 101,A01,887030,Braun; Oliver,74,0,100,26
1746599880241,CSE 101,B01,887032,Jones; Miles E,0,3,50,50
1746599880241,CSE 101,B02,887033,Jones; Miles E,0,2,50,50
1746599881266,CSE 105,A01,908084,Jones; Miles E,32,0,50,18
1746599881266,CSE 105,A02,908087,Jones; Miles E,31,0,50,19
1746599882291,CSE 135,A01,887035,Powell; Thomas Allan,0,5,50,50
1746599883318,CSE 142,A01,887037,Staff,8,0,60,52
1746599884342,CSE 142L,A01,887039,Staff,34,0,60,26
1746599885371,CSE 151A,A01,887041,Solares; Edwin A,47,0,100,53
1746599886397,CSE 175,A01,887043,Kumar; Rakesh,30,0,30,0
1746599887424,CSS 1,A01,886389,Staff,0,1,40,40
1746599888454,DSC 30,A01,908097,Liao; Soohyun Nam,47,0,75,28
1746599889480,DSC 40A,A01,908099,Shannon; Kyle Michael,30,0,50,20
1746599890508,DSC 40B,A01,908112,Staff,15,0,50,35
1746599891533,DSC 80,A01,908116,Staff,19,0,60,41
1746599892558,DSC 197,001,956863,Eldridge; Justin Matthew,9999,0,9999,0
1746599893590,ECE 5,A01,886400,Morris; Karcher William,1,0,6,5
1746599893590,ECE 5,A02,886401,Morris; Karcher William,3,0,6,3
1746599894619,ECE 148,A01,886403,Silberman; Jack,0,14,14,14
1746599895642,ECON 1,A01,887265,Crane; Meredith Helen,11,0,70,59
1746599895642,ECON 1,B01,887268,Staff,42,0,50,8
1746599896692,ECON 2,A01,887273,Crane; Meredith Helen,54,0,70,16
1746599897734,ECON 3,A01,887279,Rondina; Giacomo,31,0,70,39
1746599898762,ECON 4,A01,887282,Anderson; John Charles,0,2,10,10
1746599899792,ECON 5,A01,887285,Staff,34,0,45,11
1746599899792,ECON 5,B01,887292,Staff,41,0,45,4
1746599900819,ECON 100A,A01,887337,Newhouse; Herbert S,54,0,70,16
1746599900819,ECON 100A,B01,887349,Staff,45,0,50,5
1746599901845,ECON 100B,A01,887361,Du; Songzi,29,0,70,41
1746599902875,ECON 100C,A01,887445,Newhouse; Herbert S,59,0,70,11
1746599903902,ECON 105,A00,887488,Vespa; Emanuel Ignacio,23,0,35,12
1746599904932,ECON 109,A01,887506,Shishkin; Denis,28,0,35,7
1746599905958,ECON 110A,A01,887568,Alon; Titan Michael,0,2,35,35
1746599905958,ECON 110A,B01,907601,Alon; Titan Michael,20,0,35,15
1746599906984,ECON 110B,A01,887598,Levkoff; Steven B.,0,24,70,70
1746599908010,ECON 112,A00,887599,Rondina; Giacomo,19,0,35,16
1746599909035,ECON 120A,A01,887603,Dai; Yinlin,35,0,70,35
1746599910064,ECON 120C,A01,887608,Sun; Yixiao,0,1,35,35
1746599910064,ECON 120C,B01,887614,Sun; Yixiao,0,0,35,35
1746599911093,ECON 138,A00,887621,Bharadwaj; Prashant,0,21,20,20
1746599912121,ECON 144,A00,958007,Squires; Dale E,12,0,35,23
1746599913150,ECON 171,A01,907666,Staff,18,0,35,17
1746599914175,ECON 175,A00,887626,Wu; Pak Yeung,22,0,35,13
1746599915200,ECON 190,A00,887640,Vespa; Emanuel Ignacio,22,0,35,13
1746599916232,EDS 25,A01,888197,Staff,0,0,0,0
1746599916232,EDS 25,A02,888209,Staff,0,0,0,0
1746599916232,EDS 25,A03,888210,Staff,0,0,0,0
1746599916232,EDS 25,A04,888212,Staff,0,0,0,0
1746599916232,EDS 25,A05,888213,Staff,0,0,0,0
1746599916232,EDS 25,A06,888214,Staff,0,0,0,0
1746599916232,EDS 25,A07,888235,Staff,0,2,0,0
1746599916232,EDS 25,A08,888236,Staff,0,0,0,0
1746599916232,EDS 25,A09,888240,Staff,0,0,0,0
1746599916232,EDS 25,A10,888244,Staff,0,0,0,0
1746599916232,EDS 25,B01,888273,Staff,0,0,0,0
1746599916232,EDS 25,B02,888285,Staff,0,0,0,0
1746599916232,EDS 25,B03,888423,Staff,0,0,0,1
1746599916232,EDS 25,B04,888432,Staff,0,0,0,0
1746599916232,EDS 25,B05,888433,Staff,0,0,0,0
1746599916232,EDS 25,B06,888467,Staff,0,0,0,0
1746599916232,EDS 25,B07,888468,Staff,0,0,0,0
1746599916232,EDS 25,B08,888479,Staff,0,0,0,0
1746599916232,EDS 25,B09,888484,Staff,0,0,0,0
1746599916232,EDS 25,B10,888487,Staff,0,0,0,0
1746599917260,EDS 38,A01,907700,Choi; Bailey Miyeon,30,0,30,0
1746599918286,EDS 112,A01,888601,Chapman; Thandeka K,12,0,40,28
1746599919313,EDS 115,A00,888697,Mendez; Kathrina Mendoza,10,0,30,20
1746599920341,EDS 116,A01,888893,Staff,33,0,40,7
1746599922406,EDS 124AR,A00,889133,Staff,29,0,50,21
1746599922406,EDS 124AR,B00,907471,Simon; Elizabeth A,37,0,50,13
1746599923432,EDS 124BR,A00,889134,Simon; Elizabeth A,44,0,100,56
1746599924460,EDS 125,A00,889135,Staff,25,0,30,5
1746599925487,EDS 126,A01,889138,Staff,35,0,40,5
1746599926510,EDS 164R,A01,889142,Wishard Guerra; Alison G.,32,0,50,18
1746599927539,ENG 30,A01,886396,Staff,0,0,0,0
1746599927539,ENG 30,B01,886398,Staff,0,0,0,0
1746599928569,ENVR 102,A00,906150,Montejo; Carolina,23,0,25,2
1746599929594,ETHN 103A,A00,887236,Man; Simeon S,0,2,0,0
1746599930624,ETHN 113,A00,887239,Staff,16,0,30,14
1746599931651,ETHN 116,A00,887240,Staff,16,0,25,9
1746599932676,ETHN 117,A00,887241,Choi; Esther Min,28,0,30,2
1746599933703,ETHN 118,A00,887243,Staff,24,0,30,6
1746599934729,ETHN 127,A00,887248,Cuong; Marisol,11,0,15,4
1746599935757,ETHN 139,A00,887250,Staff,7,0,10,3
1746599936782,ETHN 142,A00,887252,Staff,9,0,30,21
1746599937807,ETHN 161,A00,887253,Browne; Errol Tsekani,24,0,30,6
1746599938834,ETHN 163FR,A00,887255,Burelle; Julie Sara Veronique,0,0,5,5
1746599939863,GLBH 20,A00,889149,Elwardani; Nile Regina,8,0,42,34
1746599941923,GLBH 111,A01,889152,Burgos; Jose L.,17,0,17,0
1746599942950,GLBH 150,A00,889181,Sloane; Julia Kathryn,0,5,15,15
1746599945005,HDS 60,A01,886406,Warstadt; Melissa Fawn,72,0,80,8
1746599946033,HIAF 111,A00,889324,Gyamfi; Bright,25,0,32,7
1746599947058,HIEA 131,A00,889328,Staff,15,0,32,17
1746599948085,HIEA 144,A00,889333,Henry; Todd A.,26,0,32,6
1746599949110,HIEA 154,A00,889336,Henry; Todd A.,24,0,32,8
1746599950136,HIEU 106,A00,889339,Staff,22,0,32,10
1746599952185,HIEU 114,A00,889340,Staff,4,0,32,28
1746599953212,HIEU 135GS,A00,889342,Patterson; Patrick H.,0,0,1,24
1746599954236,HIEU 137,A00,889343,Edington; Claire Ellen,10,0,25,15
1746599955259,HIEU 148,A00,889345,Staff,14,0,32,18
1746599956287,HIEU 154,A00,889346,Biess; Frank Peter,21,0,32,11
1746599957315,HILA 102,A00,889351,Staff,12,0,32,20
1746599958339,HILD 2A,A01,889221,Lewandoski; Julia Mavis,0,8,32,32
1746599959368,HILD 7B,A01,889225,Man; Simeon S,0,12,32,32
1746599960396,HILD 7C,A01,889288,Alvarez; Luis A,0,14,32,32
1746599961421,HILD 30,A01,889323,Staff,0,5,32,32
1746599963518,HISC 119,A00,889383,Golan; Tal,20,0,32,12
1746599964548,HIUS 103,A00,889384,Man; Simeon S,0,0,32,32
1746599965574,HIUS 117,A00,919797,Kwak; Nancy,18,0,32,14
1746599966601,HIUS 142A,A00,919788,Staff,22,0,32,10
1746599968653,HIUS 149,A00,889386,Gyamfi; Bright,26,0,32,6
1746599969680,HIUS 155,A00,889387,Alvarez; Luis A,15,0,32,17
1746599970708,HUM 3,A01,886499,Caldwell; Michael Alan,19,0,50,31
1746599971733,HUM 3GS,A00,886500,Rodriguez; Bretton Sigfred,0,0,0,28
1746599972759,HUM 3R,A01,886502,Markman; Kristina,0,36,50,50
1746599973787,HUM 4,A01,886504,Crum; Matthew Stephen,23,0,50,27
1746599973787,HUM 4,B01,886506,West; Geoffrey Scott,17,0,50,33
1746599974812,HUM 4GS,A00,886507,Staff,0,0,0,19
1746599975840,HUM 5,A01,886509,Staff,31,0,50,19
1746599976867,HUM 5R,A01,886511,Zavodny; Tatiana Sophia,0,39,50,50
1746599977894,JAPN 180,A00,886407,Staff,16,0,40,24
1746599978923,LATI 50,A01,886409,Martin-Cabrera; Luis,3,0,22,19
1746599978923,LATI 50,A02,886410,Martin-Cabrera; Luis,19,0,22,3
1746599978923,LATI 50,A03,886411,Martin-Cabrera; Luis,21,0,22,1
1746599978923,LATI 50,A04,886412,Martin-Cabrera; Luis,8,0,22,14
1746599979952,LAWS 101,A00,907664,Staff,28,0,60,32
1746599980979,LIAB 1A,A00,889388,Saab; Dima,17,0,20,3
1746599982005,LIAB 1AX,A00,889389,El Cheddadi; Youniss,18,0,20,2
1746599983037,LIFR 1C,A00,889391,Van Moer; Vinciane G,8,0,20,12
1746599984064,LIFR 1CX,A00,889392,Van Moer; Vinciane G,7,0,20,13
1746599985094,LIFR 1D,A00,889393,Van Moer; Vinciane G,7,0,20,13
1746599986123,LIFR 1DX,A00,889394,Van Moer; Vinciane G,8,0,20,12
1746599987149,LIGN 7,A00,886923,Staff,25,0,50,25
1746599988176,LIGN 17,A00,886924,Kehler; Andrew Scott,126,0,150,24
1746599989204,LTAM 110,A00,889395,Staff,15,0,30,15
1746599990227,LTAM 110GS,A00,958010,Rodriguez; Bretton Sigfred,0,0,0,28
1746599991253,LTCH 101,A00,889397,Staff,23,0,25,2
1746599992283,LTCS 130,A00,889398,Staff,23,0,25,2
1746599993307,LTEA 138,A00,889399,Staff,24,0,40,16
1746599994355,LTEN 149,A00,889400,Wesling; Megan E.,0,3,25,25
1746599995385,LTEN 169,A00,889401,Staff,20,0,25,5
1746599996410,LTEN 180,A00,889402,Staff,10,0,15,5
1746599997436,LTEN 181,A00,889403,Staff,21,0,25,4
1746599998460,LTWL 100,A00,889404,Myerston Santana; Jacobo,2,0,25,23
1746599999486,LTWL 180GS,A00,889405,Staff,0,0,20,20
1746600000514,LTWL 181,A00,889406,Staff,16,0,25,9
1746600001542,LTWL 184,A00,889475,Mukherjee; Silpa,22,0,25,3
1746600002579,LTWR 102C,A00,889486,Staff,29,0,30,1
1746600003609,LTWR 115W,A00,889491,Staff,0,2,15,15
1746600004639,MAE 8,A01,886905,Staff,0,2,0,0
1746600005667,MAE 11,A00,886906,Bandaru; Prabhakar,0,7,50,50
1746600006695,MAE 20,A00,886907,Evdokimenko; Ekaterina,43,0,70,27
1746600007724,MAE 30B,A00,886909,Ghazinejad; Maziar,25,0,45,20
1746600008753,MAE 101B,A00,886910,Saintillan; David,30,0,45,15
1746600009778,MAE 105,A00,886911,Bandaru; Prabhakar,18,0,50,32
1746600010807,MAE 107,B00,958024,Staff,7,0,50,43
1746600011836,MAE 143B,A00,886913,Bewley; Thomas R,2,0,40,38
1746600012862,MAE 148,A01,886915,Silberman; Jack,0,3,14,14
1746600013888,MAE 160,A00,886916,Evdokimenko; Ekaterina,30,0,60,30
1746600014915,MATH 3C,A01,889681,Staff,0,2,30,30
1746600014915,MATH 3C,A02,960048,Staff,23,0,30,7
1746600015942,MATH 10A,A01,889760,Staff,26,0,30,4
1746600015942,MATH 10A,A02,889783,Staff,29,0,30,1
1746600016967,MATH 10B,A01,889785,Verstraete; Jacques Allan,1,0,35,34
1746600016967,MATH 10B,A02,889795,Verstraete; Jacques Allan,4,0,35,31
1746600016967,MATH 10B,B01,889797,Verstraete; Jacques Allan,3,0,35,32
1746600016967,MATH 10B,B02,889828,Verstraete; Jacques Allan,3,0,35,32
1746600017995,MATH 10C,A01,889849,Habib; Yousaf,8,0,30,22
1746600017995,MATH 10C,A02,889852,Habib; Yousaf,14,0,30,16
1746600017995,MATH 10C,A03,889853,Habib; Yousaf,22,0,30,8
1746600017995,MATH 10C,A04,889858,Habib; Yousaf,20,0,30,10
1746600017995,MATH 10C,B01,889861,Staff,1,0,30,29
1746600017995,MATH 10C,B02,889862,Staff,24,0,30,6
1746600017995,MATH 10C,B03,889863,Staff,27,0,30,3
1746600017995,MATH 10C,B04,889967,Staff,23,0,30,7
1746600019021,MATH 18,A01,889974,Staff,7,0,30,23
1746600019021,MATH 18,A02,889977,Staff,20,0,30,10
1746600019021,MATH 18,B01,889984,Hardiman; Liam,20,0,30,10
1746600019021,MATH 18,B02,889985,Hardiman; Liam,25,0,30,5
1746600020048,MATH 20A,A01,889990,Suk; Andrew Hoon,30,0,35,5
1746600021078,MATH 20B,A01,889993,Ohm; Ko Woon,21,0,30,9
1746600021078,MATH 20B,A02,889994,Ohm; Ko Woon,30,0,30,0
1746600021078,MATH 20B,B01,889996,Ohm; Ko Woon,22,0,30,8
1746600021078,MATH 20B,B02,889997,Ohm; Ko Woon,23,0,30,7
1746600022110,MATH 20C,A01,889999,Hammock; Frances H,17,0,30,13
1746600022110,MATH 20C,A02,890003,Hammock; Frances H,23,0,30,7
1746600022110,MATH 20C,B01,890006,Hammock; Frances H,2,0,30,28
1746600022110,MATH 20C,B02,890007,Hammock; Frances H,12,0,30,18
1746600023139,MATH 20D,A01,890011,Cheng; Hsiao-Bing,1,0,30,29
1746600023139,MATH 20D,A02,890012,Cheng; Hsiao-Bing,14,0,30,16
1746600023139,MATH 20D,B01,890016,Cheng; Hsiao-Bing,13,0,30,17
1746600023139,MATH 20D,B02,890017,Cheng; Hsiao-Bing,13,0,30,17
1746600024164,MATH 20E,A01,890026,Harel; Guershon,1,0,30,29
1746600024164,MATH 20E,A02,890029,Harel; Guershon,22,0,30,8
1746600024164,MATH 20E,B01,890033,Harel; Guershon,7,0,30,23
1746600024164,MATH 20E,B02,890101,Harel; Guershon,21,0,30,9
1746600025189,MATH 102,A01,890104,Staff,18,0,30,12
1746600025189,MATH 102,A02,890105,Staff,27,0,30,3
1746600026215,MATH 103B,A01,890116,Salehi Golsefidy; Alireza,3,0,30,27
1746600026215,MATH 103B,B01,890118,Staff,0,3,34,34
1746600027244,MATH 109,A01,890121,Aliabadi Sr.; Mohsen,0,0,30,30
1746600027244,MATH 109,B01,890124,Upadrashta; Pranav Kumar,18,0,30,12
1746600028272,MATH 120A,A01,890126,Eggers; John Dietrich,13,0,30,17
1746600029299,MATH 142B,A01,890128,Ioana; Adrian,19,0,30,11
1746600029299,MATH 142B,A02,890129,Ioana; Adrian,12,0,30,18
1746600030328,MATH 154,A01,890174,Staff,0,1,30,30
1746600030328,MATH 154,A02,890182,Staff,0,0,30,30
1746600031355,MATH 168A,A01,890197,Dumitriu; Ioana,21,0,35,14
1746600032382,MATH 170A,A01,890240,Nie; Jiawang,1,0,30,29
1746600032382,MATH 170A,A02,890241,Nie; Jiawang,11,0,30,19
1746600032382,MATH 170A,A03,890249,Nie; Jiawang,23,0,30,7
1746600033410,MATH 170B,A01,957891,Nag; Panchali,13,0,35,22
1746600035464,MATH 181A,A01,908025,Staff,0,3,35,35
1746600035464,MATH 181A,A02,960115,Staff,26,0,35,9
1746600036491,MATH 181B,A01,959874,Staff,24,0,30,6
1746600037517,MATH 193B,A01,890265,Staff,0,4,35,35
1746600038547,MGT 4,A01,890311,Anderson; John Charles,42,0,88,46
1746600039573,MGT 5,A00,907740,Staff,12,0,98,86
1746600040604,MGT 12,A00,890312,Lindenberger; Wade Douglas,67,0,98,31
1746600041634,MGT 16,A00,957883,Staff,78,0,98,20
1746600043687,MGT 45,A00,890314,Pecore; Joseph P.,45,0,98,53
1746600044713,MGT 71,A00,890315,Staff,0,12,98,98
1746600045742,MGT 100,A00,890316,Yavorsky; Daniel Ryan,44,0,98,54
1746600046769,MGT 103,A00,890317,Ehrich; Kristine R,73,0,98,25
1746600047796,MGT 105,A00,890356,Bates; Kenneth Walter,0,8,98,98
1746600048821,MGT 112,A00,890360,Ehrich; Kristine R,55,0,98,43
1746600049850,MGT 127R,A00,907732,Zhu; Kevin Xiaoguo,23,0,98,75
1746600050879,MGT 131B,A00,890361,Anderson; John Charles,59,0,98,39
1746600051906,MGT 137,A00,890362,Lindenberger; Wade Douglas,65,0,98,33
1746600052935,MGT 160,A00,890369,Johnson; Erik Barry,9,0,98,89
1746600054991,MGT 164,A00,890372,Zimmermann; Carsten,0,40,98,98
1746600056019,MGT 180,A00,890374,Bliss; Barbara Ann,11,0,98,87
1746600057045,MMW 15,A01,886414,Chang; Edmond Yi-Teh,0,12,28,28
1746600057045,MMW 15,A02,886415,Chang; Edmond Yi-Teh,0,8,28,28
1746600057045,MMW 15,A03,886416,Chang; Edmond Yi-Teh,0,9,28,28
1746600057045,MMW 15,A04,886417,Chang; Edmond Yi-Teh,0,8,28,28
1746600057045,MMW 15,B01,886419,Chang; Edmond Yi-Teh,0,7,28,28
1746600057045,MMW 15,B02,886420,Chang; Edmond Yi-Teh,0,7,28,28
1746600057045,MMW 15,B03,886421,Chang; Edmond Yi-Teh,0,7,28,28
1746600057045,MMW 15,B04,886422,Chang; Edmond Yi-Teh,0,8,28,28
1746600057045,MMW 15,C01,886424,Staff,0,9,28,28
1746600057045,MMW 15,C02,886425,Staff,0,8,28,28
1746600057045,MMW 15,C03,886426,Staff,0,8,28,28
1746600057045,MMW 15,C04,886427,Staff,0,8,28,28
1746600057045,MMW 15,C05,958038,Staff,0,8,28,28
1746600057045,MMW 15,C06,958039,Staff,0,7,28,28
1746600058073,MMW 15GS,A00,906910,Patterson; Patrick H.,4,0,28,24
1746600059105,MMW 122R,A01,886429,Rahimi; Babak,0,13,28,28
1746600059105,MMW 122R,A02,886430,Rahimi; Babak,0,12,28,28
1746600059105,MMW 122R,A03,958040,Rahimi; Babak,0,11,28,28
1746600060130,MUS 1A,A01,890937,Staff,2,0,25,23
1746600060130,MUS 1A,A02,891035,Staff,6,0,25,19
1746600060130,MUS 1A,C01,958912,Staff,24,0,25,1
1746600060130,MUS 1A,C02,958913,Staff,25,0,25,0
1746600062197,MUS 2AK,A00,957092,Ohnishi; Takae,15,0,15,0
1746600063223,MUS 4,A01,891044,Staff,0,0,25,25
1746600063223,MUS 4,A02,891045,Staff,22,0,25,3
1746600063223,MUS 4,B01,891048,Staff,17,0,25,8
1746600063223,MUS 4,B02,891050,Staff,25,0,25,0
1746600064250,MUS 5,A01,957506,Dubnov; Shlomo,0,0,25,25
1746600064250,MUS 5,A02,957622,Dubnov; Shlomo,13,0,25,12
1746600064250,MUS 5,A03,957623,Dubnov; Shlomo,20,0,25,5
1746600065281,MUS 6,A01,891053,Freitas Caetano; Marcelo,24,0,25,1
1746600065281,MUS 6,A02,891054,Freitas Caetano; Marcelo,23,0,25,2
1746600066310,MUS 7,A01,891081,Staff,0,0,25,25
1746600066310,MUS 7,A02,891082,Staff,3,0,25,22
1746600067335,MUS 8GS,A00,891118,Borgo; David Garcia,1,0,25,24
1746600068363,MUS 11,A01,891140,Staff,8,0,25,17
1746600068363,MUS 11,A02,891141,Staff,21,0,25,4
1746600069394,MUS 13,A01,891143,Staff,8,0,25,17
1746600069394,MUS 13,A02,891144,Staff,24,0,25,1
1746600070418,MUS 15,A01,891146,Staff,9,0,25,16
1746600070418,MUS 15,A02,891148,Staff,21,0,25,4
1746600070418,MUS 15,B01,891150,Staff,18,0,25,7
1746600070418,MUS 15,B02,891151,Staff,25,0,25,0
1746600071448,MUS 20,A01,891153,Staff,5,0,20,15
1746600071448,MUS 20,A02,891155,Staff,14,0,20,6
1746600072475,MUS 80,A00,891156,Staff,19,0,25,6
1746600072475,MUS 80,B00,891157,Staff,23,0,25,2
1746600073501,MUS 130,A00,891158,Ohnishi; Takae,35,0,35,0
1746600074526,MUS 150GS,A01,891160,Borgo; David Garcia,1,0,25,24
1746600075552,MUS 170,A01,891162,Freitas Caetano; Marcelo,20,0,25,5
1746600075552,MUS 170,A02,891164,Freitas Caetano; Marcelo,21,0,25,4
1746600076578,NANO 11,A00,886220,Vazquez Mena; Oscar,13,0,15,2
1746600077603,NANO 15,A01,886222,Drews; Aaron,4,0,7,3
1746600078629,NANO 104,A00,886224,Sirbuly; Donald,17,0,25,8
1746600079658,PH 40,A00,886528,Staff,23,0,40,17
1746600080684,PH 45,A01,886799,Staff,35,0,40,5
1746600081712,PH 110,A00,886802,Staff,0,6,40,40
1746600082740,PH 172,A00,906716,Staff,19,0,35,16
1746600083764,PH 191,A00,886803,Staff,6,0,40,34
1746600084793,PHIL 1,A00,889500,Staff,20,0,30,10
1746600085818,PHIL 10,A01,889549,Grush; Rick Scott,16,0,22,6
1746600085818,PHIL 10,A02,889551,Grush; Rick Scott,22,0,22,0
1746600086850,PHIL 28,A01,889559,Lamey; Andy M.,0,2,31,31
1746600086850,PHIL 28,A02,889561,Lamey; Andy M.,0,1,30,30
1746600086850,PHIL 28,A03,889572,Lamey; Andy M.,0,1,30,30
1746600087878,PHIL 35,A00,907839,Staff,13,0,15,2
1746600088902,PHIL 60,A00,889574,Staff,73,0,90,17
1746600089929,PHIL 101,A00,958004,Staff,12,0,15,3
1746600091982,PHIL 136,A00,889582,Fulkerson; Matthew Todd,26,0,45,19
1746600093009,PHIL 163,A01,889601,Staff,21,0,30,9
1746600093009,PHIL 163,B01,889606,Brandt; Reuven A,0,3,0,0
1746600094033,PHIL 164,A00,889610,Staff,16,0,30,14
1746600095060,PHIL 165,A00,889613,Staff,22,0,30,8
1746600096087,PHYS 1A,A00,886431,Staff,30,0,70,40
1746600097113,PHYS 1AL,001,886432,Tsai; Philbert S,0,1,30,30
1746600097113,PHYS 1AL,002,886436,Tsai; Philbert S,13,0,30,17
1746600098143,PHYS 1B,A00,886439,Staff,184,0,240,56
1746600099169,PHYS 1BL,001,886441,Tsai; Philbert S,0,4,30,30
1746600099169,PHYS 1BL,002,886444,Tsai; Philbert S,2,0,30,28
1746600100198,PHYS 1C,A00,896092,Arnold; Kam S,78,0,146,68
1746600101231,PHYS 1CL,001,886448,Tsai; Philbert S,0,0,30,30
1746600101231,PHYS 1CL,002,886449,Tsai; Philbert S,1,0,30,29
1746600101231,PHYS 1CL,003,886450,Tsai; Philbert S,16,0,30,14
1746600101231,PHYS 1CL,004,886451,Tsai; Philbert S,15,0,30,15
1746600102261,PHYS 2B,A01,886457,Staff,67,0,115,48
1746600103287,PHYS 2C,A01,886460,Shotwell; Brian,0,9,65,65
1746600104314,PHYS 2CL,A01,886467,Staff,0,4,28,28
1746600104314,PHYS 2CL,A02,886468,Staff,0,3,28,28
1746600105341,PHYS 2D,A01,886470,Staff,10,0,50,40
1746600106371,PHYS 4B,A01,886475,Grinstein; Benjamin,22,0,40,18
1746600107398,POLI 5,A00,891173,Desposato; Scott,7,0,25,18
1746600108428,POLI 5D,A01,891175,Staff,5,0,5,0
1746600108428,POLI 5D,B01,891178,Staff,5,0,5,0
1746600109453,POLI 11,A00,891179,Ferree; Karen E,0,0,35,35
1746600110484,POLI 12,A00,891180,Staff,15,0,30,15
1746600111511,POLI 27,A01,891182,Staff,11,0,75,64
1746600112537,POLI 30,A00,891183,Staff,8,0,50,42
1746600113564,POLI 100B,A00,891244,Staff,5,1,35,30
1746600114594,POLI 100I,A00,891247,Staff,7,0,30,23
1746600115618,POLI 104J,A00,891248,Nichter; Maysa,14,0,30,16
1746600116642,POLI 104U,A00,891250,Nichter; Maysa,1,0,30,29
1746600118693,POLI 110B,A00,891255,Wiens; David,19,0,25,6
1746600119719,POLI 112A,A00,891256,Wiens; David,6,0,25,19
1746600120744,POLI 114BR,A00,891261,Staff,19,0,30,11
1746600121771,POLI 117R,A00,891262,Forman; Fonna,0,6,50,50
1746600122802,POLI 118,A00,891264,Ingham; Sean,17,0,25,8
1746600123830,POLI 124A,A00,891265,Staff,18,0,20,2
1746600124858,POLI 125D,A00,891266,Nichter; Simeon C,2,0,25,23
1746600125885,POLI 126,A00,891268,Nichter; Simeon C,7,0,25,18
1746600126914,POLI 126AA,A00,891272,Staff,15,0,25,10
1746600127939,POLI 130AA,A00,891273,Staff,15,0,20,5
1746600128966,POLI 134AA,A00,891274,Staff,4,0,20,16
1746600131017,POLI 138,A00,891278,Staff,21,0,25,4
1746600132044,POLI 142K,A00,891280,Staff,10,0,25,15
1746600133074,POLI 142M,A00,891281,Gartzke; Erik,16,0,30,14
1746600134099,POLI 142P,A00,891284,Staff,20,0,30,10
1746600135126,POLI 143,A00,891285,Gartzke; Erik,12,0,30,18
1746600136154,POLI 153,A00,891286,Staff,19,0,20,1
1746600138206,POLI 175,A00,891290,Staff,15,0,20,5
1746600139232,PSYC 1,A00,890674,Steiner; Eric Tomas,0,11,45,45
1746600140257,PSYC 2,A00,890676,Albright; Thomas D,20,0,35,15
1746600141288,PSYC 3,A00,890679,Staff,17,0,20,3
1746600142316,PSYC 6,A00,959858,Staff,19,0,20,1
1746600143344,PSYC 60,A01,890684,Rickard; Timothy C.,0,6,45,45
1746600144374,PSYC 70,A01,890689,Geller; Emma Harlan,6,0,30,24
1746600145402,PSYC 71,A01,959860,Staff,21,0,25,4
1746600146427,PSYC 100,A00,890690,Lacefield; Katharine I,0,50,180,180
1746600147453,PSYC 102,A00,890695,Staff,18,0,40,22
1746600148480,PSYC 105,A00,890699,Geller; Emma Harlan,70,0,100,30
1746600149506,PSYC 106,A00,890701,Gorman; Michael R.,5,0,30,25
1746600150533,PSYC 108,A00,890704,Adrian; Julia Anna,0,29,50,50
1746600151560,PSYC 118,A01,890712,Staff,11,0,30,19
1746600152589,PSYC 124,A00,890716,Chapman; Eddie Nathaniel,25,0,60,35
1746600153619,PSYC 131,A00,890717,Anagnostaras; Stephan,0,7,80,80
1746600154645,PSYC 137,A00,890719,Winkielman; Piotr,0,11,30,30
1746600155671,PSYC 144,A00,890721,Adrian; Julia Anna,0,9,45,45
1746600156697,PSYC 162,A00,890805,Staff,0,2,75,75
1746600157723,PSYC 169,A00,890810,Staff,0,15,30,30
1746600158751,PSYC 172,A00,890814,Gorman; Michael R.,9,0,30,21
1746600159774,PSYC 181,A00,890818,Anagnostaras; Stephan,7,0,200,193
1746600160800,PSYC 184,A00,959861,Staff,162,0,175,13
1746600161827,PSYC 189,A00,890823,Staff,0,2,30,30
1746600162857,PSYC 191,A00,890884,Rickard; Timothy C.,0,11,35,35
1746600163884,PSYC 193,A00,890913,Staff,19,0,30,11
1746600163884,PSYC 193,B00,890914,Chapman; Eddie Nathaniel,24,0,30,6
1746600164910,PSYC 193L,A01,890918,Lowe; Angela Beth,20,0,30,10
1746600164910,PSYC 193L,B01,890921,Hurwitz; Ethan Scott,20,0,30,10
1746600164910,PSYC 193L,C01,890928,Staff,30,0,30,0
1746600165938,RELI 149,A00,886806,Rahimi; Babak,23,0,40,17
1746600166965,SE 9,A01,886814,Staff,7,0,20,13
1746600167990,SE 101B,A01,886816,Chadha; Mayank,3,0,35,32
1746600169016,SE 110B,A00,886818,Zhu; Qiang,4,0,75,71
1746600170047,SE 125,A01,886830,Staff,10,0,30,20
1746600171075,SE 130B,A01,886835,Staff,14,0,40,26
1746600172103,SE 131A,A01,886838,Krysl; Petr,34,0,55,21
1746600173133,SE 154,A00,886840,Staff,28,0,50,22
1746600174161,SE 164GS,A01,886849,Staff,6,0,20,14
1746600175188,SE 167GS,A01,886853,Staff,6,0,20,14
1746600176216,SIO 25,A01,890107,Staff,19,0,30,11
1746600177244,SIO 45,A00,890109,Cook; Geoffrey W,115,0,200,85
1746600178269,SIO 109R,A00,890110,Forman; Fonna,0,16,20,20
1746600179297,SIO 187,A01,890114,Kacev; David,15,0,40,25
1746600180326,SOCI 1,A01,890431,Thorpe; Charles Robert,14,0,30,16
1746600180326,SOCI 1,A02,890518,Thorpe; Charles Robert,30,0,30,0
1746600181353,SOCI 2,A01,957978,Staff,25,0,25,0
1746600181353,SOCI 2,A02,957979,Staff,23,0,25,2
1746600182384,SOCI 20,A01,890523,Calderon-Zaks; Michael Aar,21,0,30,9
1746600182384,SOCI 20,A02,890526,Calderon-Zaks; Michael Aar,29,0,30,1
1746600183414,SOCI 30,A01,890533,Pardo Guerra; Juan Pablo,37,0,40,3
1746600184441,SOCI 40,A01,890535,Staff,27,0,45,18
1746600185471,SOCI 104Q,A00,890559,Staff,18,0,30,12
1746600186498,SOCI 106,A00,890560,Arnal; Maud Marie Leonie,20,0,30,10
1746600187525,SOCI 110,A00,890567,Holkenbrink-Monk; Charlene,19,0,30,11
1746600188556,SOCI 112,A00,890568,Victoria Torres; Pablo,2,0,55,53
1746600189585,SOCI 115,A00,890597,Arnal; Maud Marie Leonie,28,0,45,17
1746600191637,SOCI 121,A00,890604,Pardo Guerra; Juan Pablo,38,0,45,7
1746600192666,SOCI 126,A01,890608,Staff,8,0,10,2
1746600193691,SOCI 127,A00,890609,Staff,18,0,30,12
1746600194718,SOCI 131,A00,890610,Thorpe; Charles Robert,37,0,45,8
1746600195749,SOCI 135,A00,890615,Payne; Christine Anna,14,0,45,31
1746600196776,SOCI 139,A00,890620,Staff,38,0,45,7
1746600197800,SOCI 148E,A00,890622,Calderon-Zaks; Michael Aar,36,0,45,9
1746600198829,SOCI 150,A00,890623,Kohler; Kristopher M.,31,0,45,14
1746600199860,SOCI 157,A00,890625,Jules-Rosette; Bennetta W.,18,0,20,2
1746600200885,SOCI 160,A00,890627,Payne; Christine Anna,21,0,45,24
1746600201913,SYN 1,A00,886855,Fish; Gwendolyn Anne,0,1,0,0
1746600201913,SYN 1,B00,906086,Fish; Gwendolyn Anne,0,2,0,2
1746600202939,SYN 2R,A00,886860,Staff,0,17,15,15
1746600202939,SYN 2R,B00,906106,Atkinson; Arthur Laird,0,16,15,15
1746600203973,SYN 100,A01,886866,Browne; Emily,0,28,20,20
1746600203973,SYN 100,B01,906128,Rock; Martin,0,4,20,20
1746600203973,SYN 100,C01,906140,Deavenport; James Cary,0,4,20,20
1746600203973,SYN 100,D01,907816,Deavenport; James Cary,0,5,20,20
1746600205004,TDAC 1,A00,890286,Walsh; Kim C.,7,0,20,13
1746600206029,TDAC 101,A00,890296,Basso; Beatrice,15,0,20,5
1746600207082,TDDE 131,A00,890297,Staff,47,0,50,3
1746600208107,TDDM 1,A00,890287,Weinberg; Sadie,25,0,30,5
1746600209133,TDGE 11,A00,890288,Fulton; Julia,138,0,200,62
1746600209133,TDGE 11,B00,890289,Castro; Robert Jess,184,0,200,16
1746600210160,TDGE 25,B00,957359,Walsh; Kim C.,5,0,20,15
1746600211190,TDGE 40,A01,890292,Power; Jade Yukana,26,0,30,4
1746600212214,TDGE 124,A00,890298,Havis; Allan,0,2,50,50
1746600213241,TDGE 131R,A00,890299,Burelle; Julie Sara Veronique,15,0,42,27
1746600214267,TDHT 101,A00,890300,Staff,10,0,20,10
1746600215293,TDHT 109,A01,890302,Anderson; Mysia Anyse,31,0,40,9
1746600216316,TDMV 1,A00,890293,Arcidiacono; Kristin,18,0,30,12
1746600217348,TDMV 2,A00,890294,Weinberg; Sadie,23,0,30,7
1746600218374,TDMV 3,A00,957878,Arcidiacono; Kristin,28,0,30,2
1746600220427,TDMV 138,A00,890304,Jun; Grace Shin Hae,25,0,40,15
1746600221454,TDMV 140,A00,890305,Corrales; Joseph Bernales,25,0,30,5
1746600222477,TDMV 142,A00,890307,Caligagan; Tony,32,0,40,8
1746600223503,TDMV 144,A00,890308,Camaya; Michelle Ann,25,0,30,5
1746600224529,TDPW 1,A00,890295,Stein; Deborah Isobel,3,0,20,17
1746600225556,USP 2,A01,890272,Lerner; Amy M,7,0,20,13
1746600226582,USP 3,A01,890274,Staff,12,0,30,18
1746600227607,USP 15,A01,890276,Sun; Feiyang,16,0,30,14
1746600228634,USP 25,A00,890277,Shenkman; Michael Thomas,18,0,25,7
1746600229661,USP 138,A00,890278,Staff,13,0,25,12
1746600230692,USP 143,A00,890279,Staff,21,0,70,49
1746600231719,USP 144,A00,890280,Chowdhury; Muhammed Zohir,16,0,30,14
1746600232743,USP 150,A00,890281,Boomhower; Matthew Charles,4,0,30,26
1746600233771,USP 151,A00,890282,Staff,16,0,20,4
1746600234796,USP 162,A00,890283,Andrews; Abigail Leslie,16,0,20,4
1746600235822,USP 168,A00,920477,Kwak; Nancy,0,0,5,5
1746600236848,USP 181,A00,890284,Staff,3,0,20,17
1746600237879,USP 191A,A00,890285,Staff,12,0,20,8
1746600238907,VIS 101,A00,886512,Staff,26,0,75,49
1746600239935,VIS 103,A00,886513,Cruz; Edwin Teddy,61,0,75,14
1746600240964,VIS 108,A00,886514,Staff,4,0,15,11
1746600241991,VIS 127P,A00,886515,Shen; Kuiyi,80,0,146,66
1746600243021,VIS 149,A00,886516,Yoldas; Pinar,0,0,15,15
1746600244044,VIS 164,A00,886526,Erdmann; Dean,19,0,22,3
1746600245068,VIS 194S,A00,886527,Staff,61,0,75,14
1746600246096,WCWP 10A,C00,886484,Martiniuk; Jill,12,0,15,3
1746600247123,WCWP 10B,A00,886490,Uriarte; Emma,0,0,15,15
1746600247123,WCWP 10B,B00,886491,Dhir; Simrita,8,0,15,7
1746600247123,WCWP 10B,C00,886492,Ornelas; Tricia,0,0,15,15
1746600248151,WCWP 100,A00,886494,Young; Mark T,0,6,15,15
1746600250226,AAS 10,A01,886199,Childs; Dennis R.,0,3,0,0
1746600251250,ANAR 104,A01,886940,Shtienberg; Gilad,27,0,30,3
1746600252274,ANAR 120,A00,886953,Staff,13,0,20,7
1746600253300,ANBI 148,A01,886955,Wilder; Linnea Lorene,30,0,40,10
1746600255349,ANSC 122,A00,886957,Staff,24,0,30,6
1746600256376,ANSC 150,A00,886958,Sloane; Julia Kathryn,2,0,15,13
1746600257401,ANSC 156,A00,886959,Jenkins; Janis A.,0,1,15,15
1746600258428,ANSC 180,A00,886960,Staff,11,0,17,6
1746600259452,ANSC 188,A00,886961,Jassal; Aftab,9,0,25,16
1746600260481,ANSC 190,A00,886962,Jassal; Aftab,14,0,25,11
1746600261505,ANSC 191,A00,886963,Staff,18,0,20,2
1746600262531,ANTH 3,A01,891689,Staff,17,0,20,3
1746600263558,ANTH 5,A00,886933,Semendeferi; Ekaterini,16,0,20,4
1746600264582,ANTH 10,A00,886934,Staff,0,12,30,30
1746600265608,ANTH 21,A01,886936,Staff,41,0,60,19
1746600266633,ANTH 23,A01,886938,Staff,92,0,100,8
1746600267663,ANTH 105,A00,886964,Stewart; Alexander B,84,0,100,16
1746600268692,ANTH 108,A00,886965,Pedersen; David,9,0,20,11
1746600269719,AWP 10,001,886147,Staff,0,0,0,0
1746600269719,AWP 10,002,886148,Staff,0,0,0,0
1746600269719,AWP 10,003,886149,Staff,0,0,0,0
1746600269719,AWP 10,004,886150,Staff,0,0,0,0
1746600269719,AWP 10,005,886151,Staff,0,0,0,0
1746600269719,AWP 10,006,886152,Staff,0,0,0,0
1746600269719,AWP 10,007,886153,Staff,0,0,0,0
1746600269719,AWP 10,008,886154,Staff,0,0,0,0
1746600269719,AWP 10,009,886155,Staff,0,0,0,0
1746600269719,AWP 10,010,886156,Staff,0,0,0,0
1746600269719,AWP 10,011,886158,Staff,0,0,0,0
1746600269719,AWP 10,012,886160,Staff,0,0,0,0
1746600269719,AWP 10,013,886161,Staff,0,0,0,0
1746600269719,AWP 10,014,886162,Staff,0,0,0,0
1746600269719,AWP 10,015,886163,Staff,0,0,0,0
1746600269719,AWP 10,016,886164,Staff,0,0,0,0
1746600269719,AWP 10,017,886165,Staff,0,0,0,0
1746600269719,AWP 10,018,886166,Staff,0,0,0,0
1746600269719,AWP 10,019,886168,Staff,0,0,0,0
1746600269719,AWP 10,020,886170,Staff,0,0,0,0
1746600269719,AWP 10,021,886172,Staff,0,0,0,0
1746600270747,AWP 10R,001,886173,Staff,0,1,0,0
1746600270747,AWP 10R,002,886174,Staff,0,1,0,0
1746600270747,AWP 10R,003,886175,Staff,0,0,0,0
1746600270747,AWP 10R,004,886176,Staff,0,0,0,0
1746600270747,AWP 10R,005,886177,Staff,0,0,0,0
1746600270747,AWP 10R,006,886178,Staff,0,0,0,0
1746600270747,AWP 10R,007,886179,Staff,0,0,0,0
1746600270747,AWP 10R,008,886181,Staff,0,0,0,0
1746600270747,AWP 10R,009,886182,Staff,0,0,0,0
1746600270747,AWP 10R,010,886183,Staff,0,0,0,0
1746600270747,AWP 10R,011,886184,Staff,0,0,0,0
1746600270747,AWP 10R,012,886185,Staff,0,0,0,0
1746600270747,AWP 10R,013,886186,Staff,0,0,0,0
1746600270747,AWP 10R,014,886187,Staff,0,0,0,0
1746600270747,AWP 10R,015,886188,Staff,0,0,0,0
1746600270747,AWP 10R,016,886189,Staff,0,0,0,0
1746600270747,AWP 10R,017,960532,Staff,0,0,0,0
1746600270747,AWP 10R,018,960533,Staff,0,0,0,0
1746600270747,AWP 10R,019,960534,Staff,0,0,0,0
1746600270747,AWP 10R,020,960538,Staff,0,0,0,0
1746600270747,AWP 10R,021,960540,Staff,0,0,0,0
1746600270747,AWP 10R,022,960541,Staff,0,0,0,0
1746600270747,AWP 10R,023,960542,Staff,0,0,0,0
1746600270747,AWP 10R,024,960544,Staff,0,0,0,0
1746600270747,AWP 10R,025,960545,Staff,0,0,0,0
1746600270747,AWP 10R,026,960548,Staff,0,0,0,0
1746600271771,AWP 102R,A00,886190,Staff,0,0,0,0
1746600271771,AWP 102R,B00,886191,Staff,0,0,0,0
1746600272797,BENG 100,A01,886193,Staff,17,0,30,13
1746600273822,BENG 122A,A01,886195,Hasty; Jeff M,13,0,30,17
1746600274852,BENG 166A,A00,886196,Sah; Robert Lie-Yuan,0,3,30,30
1746600275877,BENG 190,A00,958050,Khojah; Reem I,17,0,25,8
1746600276908,BIBC 102,A01,894320,Staff,0,1,46,46
1746600276908,BIBC 102,A02,894321,Staff,0,0,46,46
1746600276908,BIBC 102,A03,894344,Staff,6,0,46,40
1746600276908,BIBC 102,A04,894345,Staff,27,0,47,20
1746600277933,BICD 100R,A01,894365,Smith; Laurie,0,2,58,58
1746600277933,BICD 100R,A02,894366,Smith; Laurie,0,4,58,58
1746600277933,BICD 100R,A03,894367,Smith; Laurie,0,0,59,59
1746600277933,BICD 100R,A04,959869,Smith; Laurie,38,0,59,21
1746600278958,BICD 136,A01,894383,Gustafson-Brown; Cindy,14,0,50,36
1746600279984,BIEB 102,A01,894494,Butler; Shannon Rhey,51,0,130,79
1746600282045,BIEB 150,A01,894617,Wills; Christopher,3,0,20,17
1746600282045,BIEB 150,A02,894631,Wills; Christopher,3,0,20,17
1746600282045,BIEB 150,A03,894937,Wills; Christopher,3,0,20,17
1746600282045,BIEB 150,A04,894946,Wills; Christopher,5,0,20,15
1746600283071,BIEB 194,A00,906141,Kurle; Carolyn M.,5,0,20,15
1746600284103,BILD 1,A01,894154,Staff,3,0,19,16
1746600284103,BILD 1,A02,894155,Staff,14,0,19,5
1746600284103,BILD 1,A03,894160,Staff,13,0,19,6
1746600284103,BILD 1,A04,894161,Staff,15,0,18,3
1746600285127,BILD 2,A01,894168,Staff,0,0,50,50
1746600285127,BILD 2,A02,894169,Staff,0,0,50,50
1746600285127,BILD 2,A03,894179,Staff,0,0,50,50
1746600285127,BILD 2,A04,894203,Staff,22,0,50,28
1746600286155,BILD 3,A01,894213,Staff,23,0,31,8
1746600286155,BILD 3,A02,894214,Staff,26,0,31,5
1746600286155,BILD 3,A03,894235,Staff,28,0,31,3
1746600286155,BILD 3,A04,894236,Staff,28,0,32,4
1746600287181,BILD 4,A01,894253,Reuther; Keefe,5,0,24,19
1746600287181,BILD 4,A02,894258,Reuther; Keefe,16,0,24,8
1746600288210,BILD 5,A01,894276,Reuther; Keefe,34,0,50,16
1746600288210,BILD 5,A02,894277,Reuther; Keefe,45,0,50,5
1746600288210,BILD 5,A03,894290,Reuther; Keefe,44,0,50,6
1746600288210,BILD 5,A04,894291,Reuther; Keefe,48,0,50,2
1746600289237,BILD 24,A01,894297,Pirino; Giorgia,40,0,60,20
1746600290264,BIMM 100,B01,958915,Staff,71,0,100,29
1746600291291,BIMM 101,A01,895017,McDonnell; Lisa Marie,0,5,24,24
1746600291291,BIMM 101,A02,895018,McDonnell; Lisa Marie,0,5,24,24
1746600291291,BIMM 101,B01,895020,McDonnell; Lisa Marie,0,5,24,24
1746600291291,BIMM 101,B02,895021,McDonnell; Lisa Marie,0,4,24,24
1746600292318,BIMM 110,A01,895023,Staff,1,0,25,24
1746600292318,BIMM 110,A02,895024,Staff,9,0,25,16
1746600292318,BIMM 110,A03,895025,Staff,18,0,25,7
1746600292318,BIMM 110,A04,895031,Staff,20,0,25,5
1746600293352,BIMM 120,A01,895114,Gustafson-Brown; Cindy,14,0,28,14
1746600293352,BIMM 120,A02,895126,Gustafson-Brown; Cindy,21,0,27,6
1746600294380,BIPN 100,A01,895130,Yang; Mingyu,0,0,38,38
1746600294380,BIPN 100,A02,895131,Yang; Mingyu,31,0,38,7
1746600294380,BIPN 100,A03,895132,Yang; Mingyu,32,0,38,6
1746600294380,BIPN 100,A04,895133,Yang; Mingyu,27,0,36,9
1746600295408,BIPN 120,A01,895135,Cooke; James Edward,0,3,13,13
1746600295408,BIPN 120,A02,895136,Cooke; James Edward,0,1,13,13
1746600295408,BIPN 120,A03,895137,Cooke; James Edward,0,3,13,13
1746600295408,BIPN 120,A04,895156,Cooke; James Edward,0,2,11,11
1746600296434,BIPN 134,A01,895235,Cooke; James Edward,0,1,25,25
1746600296434,BIPN 134,A02,895237,Cooke; James Edward,0,0,25,25
1746600296434,BIPN 134,A03,895240,Cooke; James Edward,1,0,25,24
1746600296434,BIPN 134,A04,895270,Cooke; James Edward,20,0,25,5
1746600297462,BIPN 189,A00,892103,Staff,0,14,14,14
1746600299517,BISP 194,A00,958008,Staff,0,2,0,0
1746600300543,CAT 124,A01,922009,Staff,0,5,20,20
1746600301579,CAT 125R,A00,886390,Morales; Celeste Georgianna,0,3,20,20
1746600301579,CAT 125R,B00,886391,Irwin; Matthew Joseph,0,4,20,20
1746600301579,CAT 125R,C00,886392,Smith; Lauryn Alissa,0,2,20,20
1746600301579,CAT 125R,D00,886393,Vanderschuit; Maya Alysia,0,3,20,20
1746600301579,CAT 125R,E00,886394,Marchisotto; Jennifer Anne,0,3,20,20
1746600302606,CENG 15,A01,886218,Drews; Aaron,3,0,8,5
1746600303635,CENG 113,A00,886219,Opatkiewicz; Justin Paul,15,0,25,10
1746600304663,CGS 101,A00,887044,Staff,7,0,20,13
1746600305692,CGS 105,A01,887046,Staff,14,0,25,11
1746600306717,CGS 112,A00,887047,Cuong; Marisol,12,0,15,3
1746600307744,CGS 113,A00,887048,Staff,23,0,30,7
1746600308772,CGS 120,A00,887049,Staff,9,0,17,8
1746600309797,CHEM 6A,A01,886336,Lam; Tin Yiu,38,0,50,12
1746600309797,CHEM 6A,A02,886338,Lam; Tin Yiu,37,0,50,13
1746600310823,CHEM 6B,A01,886341,Hopkins; Patrycja Anna,16,0,50,34
1746600310823,CHEM 6B,A02,886343,Hopkins; Patrycja Anna,42,0,50,8
1746600311849,CHEM 6C,A01,886346,Albizati; Kim F.,0,2,50,50
1746600311849,CHEM 6C,A02,886348,Albizati; Kim F.,24,0,50,26
1746600312876,CHEM 40A,A01,886352,Klosterman; Jeremy K,65,0,100,35
1746600313908,CHEM 40B,A01,886356,Klosterman; Jeremy K,0,24,100,100
1746600314934,CHEM 41B,A01,886360,Theodorakis; Emmanuel,25,0,50,25
1746600314934,CHEM 41B,A02,886362,Theodorakis; Emmanuel,47,0,50,3
1746600315963,CHIN 165A,A00,886382,Xu; Li,18,0,20,2
1746600316991,CLAS 120,A00,886387,Myerston Santana; Jacobo,33,0,40,7
1746600318015,COGS 9,A01,886967,Shannon; Kyle Michael,42,0,60,18
1746600319041,COGS 11,A01,886969,Staff,9,0,30,21
1746600320067,COGS 14A,A01,886971,Staff,5,0,60,55
1746600321091,COGS 14B,A01,886973,Hoffman; Drew Ellen,4,0,60,56
1746600322121,COGS 18,A01,886975,Morgan; Eric,34,0,60,26
1746600323147,COGS 20,A01,886977,Staff,3,0,8,5
1746600323147,COGS 20,A02,886978,Staff,5,0,7,2
1746600324174,COGS 100,A01,907783,Staff,0,1,30,30
1746600325204,COGS 101B,A01,886980,Staff,0,4,48,48
1746600326233,COGS 101C,A01,886982,Delgado; Tania,0,5,44,44
1746600327265,COGS 102A,A01,886984,Johnson; Christine M.,3,0,30,27
1746600328293,COGS 118B,A01,886986,Staff,0,4,88,88
1746600329321,COGS 150,A01,886988,Bergen; Benjamin,22,0,50,28
1746600330348,COGS 153,A00,886989,Delgado; Tania,0,3,41,41
1746600331374,COGS 186,A01,886991,Staff,0,0,32,32
1746600332403,COGS 187A,A01,886993,Boyle; Mary E. T.,7,0,30,23
1746600333429,COGS 189,A00,886994,Staff,0,1,30,30
1746600334452,COMM 10,A01,886996,Staff,0,0,20,21
1746600334452,COMM 10,A02,886997,Staff,10,0,20,10
1746600334452,COMM 10,A03,959845,Staff,19,0,20,1
1746600335479,COMM 20,A01,886999,Leuning; Grant Maurstad,24,0,40,16
1746600337532,COMM 100A,A01,887002,Staff,0,0,20,25
1746600337532,COMM 100A,A02,887003,Staff,5,0,20,15
1746600338559,COMM 100B,A01,887005,Staff,0,8,20,24
1746600339587,COMM 106D,A00,887006,Staff,14,0,40,26
1746600340617,COMM 110G,A00,887007,Whitworth-Smith; Andrew C,12,0,40,28
1746600341645,COMM 111B,A00,887008,Staff,31,0,40,9
1746600342675,COMM 113T,A00,887009,Abuelhiga; Soraya Jill,28,0,40,12
1746600342675,COMM 113T,B00,906733,Staff,39,0,40,1
1746600343701,COMM 145,A00,887010,Staff,13,0,40,27
1746600344728,COMM 146,A00,887054,Staff,32,0,40,8
1746600345754,COMM 190,A00,887012,Staff,8,0,23,15
1746600346783,CSE 8A,A50,887015,Cao; Yingjun,56,0,85,29
1746600347808,CSE 11,A01,887017,Cao; Yingjun,11,0,70,59
1746600348838,CSE 20,A01,887019,Staff,30,0,50,20
1746600349862,CSE 21,A01,887021,Staff,79,0,100,21
1746600349862,CSE 21,B01,892583,Braun; Oliver,45,0,50,5
1746600350888,CSE 30,A01,887025,Eldon; John,142,0,200,58
1746600351913,CSE 100,A01,887027,Staff,26,0,50,24
1746600351913,CSE 100,A02,887028,Staff,42,0,50,8
1746600352945,CSE 101,A01,887030,Braun; Oliver,74,0,100,26
1746600352945,CSE 101,B01,887032,Jones; Miles E,0,3,50,50
1746600352945,CSE 101,B02,887033,Jones; Miles E,0,2,50,50
1746600353974,CSE 105,A01,908084,Jones; Miles E,32,0,50,18
1746600353974,CSE 105,A02,908087,Jones; Miles E,31,0,50,19
1746600355002,CSE 135,A01,887035,Powell; Thomas Allan,0,5,50,50
1746600356029,CSE 142,A01,887037,Staff,8,0,60,52
1746600357054,CSE 142L,A01,887039,Staff,34,0,60,26
1746600358079,CSE 151A,A01,887041,Solares; Edwin A,47,0,100,53
1746600359182,CSE 175,A01,887043,Kumar; Rakesh,30,0,30,0
1746600360209,CSS 1,A01,886389,Staff,0,1,40,40
1746600361238,DSC 30,A01,908097,Liao; Soohyun Nam,47,0,75,28
1746600362267,DSC 40A,A01,908099,Shannon; Kyle Michael,30,0,50,20
1746600363291,DSC 40B,A01,908112,Staff,15,0,50,35
1746600364318,DSC 80,A01,908116,Staff,19,0,60,41
1746600365348,DSC 197,001,956863,Eldridge; Justin Matthew,9999,0,9999,0
1746600366377,ECE 5,A01,886400,Morris; Karcher William,1,0,6,5
1746600366377,ECE 5,A02,886401,Morris; Karcher William,3,0,6,3
1746600367407,ECE 148,A01,886403,Silberman; Jack,0,14,14,14
1746600368436,ECON 1,A01,887265,Crane; Meredith Helen,11,0,70,59
1746600368436,ECON 1,B01,887268,Staff,42,0,50,8
1746600369461,ECON 2,A01,887273,Crane; Meredith Helen,54,0,70,16
1746600370485,ECON 3,A01,887279,Rondina; Giacomo,31,0,70,39
1746600371514,ECON 4,A01,887282,Anderson; John Charles,0,2,10,10
1746600372541,ECON 5,A01,887285,Staff,34,0,45,11
1746600372541,ECON 5,B01,887292,Staff,41,0,45,4
1746600373570,ECON 100A,A01,887337,Newhouse; Herbert S,54,0,70,16
1746600373570,ECON 100A,B01,887349,Staff,45,0,50,5
1746600374595,ECON 100B,A01,887361,Du; Songzi,29,0,70,41
1746600375621,ECON 100C,A01,887445,Newhouse; Herbert S,59,0,70,11
1746600376649,ECON 105,A00,887488,Vespa; Emanuel Ignacio,23,0,35,12
1746600377675,ECON 109,A01,887506,Shishkin; Denis,28,0,35,7
1746600378701,ECON 110A,A01,887568,Alon; Titan Michael,0,2,35,35
1746600378701,ECON 110A,B01,907601,Alon; Titan Michael,20,0,35,15
1746600379726,ECON 110B,A01,887598,Levkoff; Steven B.,0,24,70,70
1746600380753,ECON 112,A00,887599,Rondina; Giacomo,19,0,35,16
1746600381781,ECON 120A,A01,887603,Dai; Yinlin,35,0,70,35
1746600382808,ECON 120C,A01,887608,Sun; Yixiao,0,1,35,35
1746600382808,ECON 120C,B01,887614,Sun; Yixiao,0,0,35,35
1746600383837,ECON 138,A00,887621,Bharadwaj; Prashant,0,21,20,20
1746600384864,ECON 144,A00,958007,Squires; Dale E,12,0,35,23
1746600385895,ECON 171,A01,907666,Staff,18,0,35,17
1746600386920,ECON 175,A00,887626,Wu; Pak Yeung,22,0,35,13
1746600387946,ECON 190,A00,887640,Vespa; Emanuel Ignacio,22,0,35,13
1746600388979,EDS 25,A01,888197,Staff,0,0,0,0
1746600388979,EDS 25,A02,888209,Staff,0,0,0,0
1746600388979,EDS 25,A03,888210,Staff,0,0,0,0
1746600388979,EDS 25,A04,888212,Staff,0,0,0,0
1746600388979,EDS 25,A05,888213,Staff,0,0,0,0
1746600388979,EDS 25,A06,888214,Staff,0,0,0,0
1746600388979,EDS 25,A07,888235,Staff,0,2,0,0
1746600388979,EDS 25,A08,888236,Staff,0,0,0,0
1746600388979,EDS 25,A09,888240,Staff,0,0,0,0
1746600388979,EDS 25,A10,888244,Staff,0,0,0,0
1746600388979,EDS 25,B01,888273,Staff,0,0,0,0
1746600388979,EDS 25,B02,888285,Staff,0,0,0,0
1746600388979,EDS 25,B03,888423,Staff,0,0,0,1
1746600388979,EDS 25,B04,888432,Staff,0,0,0,0
1746600388979,EDS 25,B05,888433,Staff,0,0,0,0
1746600388979,EDS 25,B06,888467,Staff,0,0,0,0
1746600388979,EDS 25,B07,888468,Staff,0,0,0,0
1746600388979,EDS 25,B08,888479,Staff,0,0,0,0
1746600388979,EDS 25,B09,888484,Staff,0,0,0,0
1746600388979,EDS 25,B10,888487,Staff,0,0,0,0
1746600390011,EDS 38,A01,907700,Choi; Bailey Miyeon,30,0,30,0
1746600391038,EDS 112,A01,888601,Chapman; Thandeka K,12,0,40,28
1746600392062,EDS 115,A00,888697,Mendez; Kathrina Mendoza,10,0,30,20
1746600393087,EDS 116,A01,888893,Staff,33,0,40,7
1746600395137,EDS 124AR,A00,889133,Staff,29,0,50,21
1746600395137,EDS 124AR,B00,907471,Simon; Elizabeth A,37,0,50,13
1746600396164,EDS 124BR,A00,889134,Simon; Elizabeth A,44,0,100,56
1746600397190,EDS 125,A00,889135,Staff,25,0,30,5
1746600398215,EDS 126,A01,889138,Staff,35,0,40,5
1746600399242,EDS 164R,A01,889142,Wishard Guerra; Alison G.,32,0,50,18
1746600400269,ENG 30,A01,886396,Staff,0,0,0,0
1746600400269,ENG 30,B01,886398,Staff,0,0,0,0
1746600401298,ENVR 102,A00,906150,Montejo; Carolina,23,0,25,2
1746600402324,ETHN 103A,A00,887236,Man; Simeon S,0,2,0,0
1746600403349,ETHN 113,A00,887239,Staff,16,0,30,14
1746600404379,ETHN 116,A00,887240,Staff,16,0,25,9
1746600405406,ETHN 117,A00,887241,Choi; Esther Min,28,0,30,2
1746600406434,ETHN 118,A00,887243,Staff,24,0,30,6
1746600407464,ETHN 127,A00,887248,Cuong; Marisol,11,0,15,4
1746600408491,ETHN 139,A00,887250,Staff,7,0,10,3
1746600409519,ETHN 142,A00,887252,Staff,9,0,30,21
1746600410542,ETHN 161,A00,887253,Browne; Errol Tsekani,24,0,30,6
1746600411566,ETHN 163FR,A00,887255,Burelle; Julie Sara Veronique,0,0,5,5
1746600412591,GLBH 20,A00,889149,Elwardani; Nile Regina,8,0,42,34
1746600414639,GLBH 111,A01,889152,Burgos; Jose L.,17,0,17,0
1746600415666,GLBH 150,A00,889181,Sloane; Julia Kathryn,0,5,15,15
1746600417718,HDS 60,A01,886406,Warstadt; Melissa Fawn,72,0,80,8
1746600418743,HIAF 111,A00,889324,Gyamfi; Bright,25,0,32,7
1746600419770,HIEA 131,A00,889328,Staff,15,0,32,17
1746600420798,HIEA 144,A00,889333,Henry; Todd A.,26,0,32,6
1746600421827,HIEA 154,A00,889336,Henry; Todd A.,24,0,32,8
1746600422851,HIEU 106,A00,889339,Staff,22,0,32,10
1746600424907,HIEU 114,A00,889340,Staff,4,0,32,28
1746600425935,HIEU 135GS,A00,889342,Patterson; Patrick H.,0,0,1,24
1746600426961,HIEU 137,A00,889343,Edington; Claire Ellen,10,0,25,15
1746600427986,HIEU 148,A00,889345,Staff,14,0,32,18
1746600429011,HIEU 154,A00,889346,Biess; Frank Peter,21,0,32,11
1746600430036,HILA 102,A00,889351,Staff,12,0,32,20
1746600431063,HILD 2A,A01,889221,Lewandoski; Julia Mavis,0,8,32,32
1746600432089,HILD 7B,A01,889225,Man; Simeon S,0,12,32,32
1746600433117,HILD 7C,A01,889288,Alvarez; Luis A,0,14,32,32
1746600434146,HILD 30,A01,889323,Staff,0,5,32,32
1746600436203,HISC 119,A00,889383,Golan; Tal,20,0,32,12
1746600437233,HIUS 103,A00,889384,Man; Simeon S,0,0,32,32
1746600438257,HIUS 117,A00,919797,Kwak; Nancy,18,0,32,14
1746600439282,HIUS 142A,A00,919788,Staff,22,0,32,10
1746600441341,HIUS 149,A00,889386,Gyamfi; Bright,26,0,32,6
1746600442369,HIUS 155,A00,889387,Alvarez; Luis A,15,0,32,17
1746600443393,HUM 3,A01,886499,Caldwell; Michael Alan,19,0,50,31
1746600444420,HUM 3GS,A00,886500,Rodriguez; Bretton Sigfred,0,0,0,28
1746600445445,HUM 3R,A01,886502,Markman; Kristina,0,36,50,50
1746600446472,HUM 4,A01,886504,Crum; Matthew Stephen,23,0,50,27
1746600446472,HUM 4,B01,886506,West; Geoffrey Scott,17,0,50,33
1746600447500,HUM 4GS,A00,886507,Staff,0,0,0,19
1746600448530,HUM 5,A01,886509,Staff,31,0,50,19
1746600449556,HUM 5R,A01,886511,Zavodny; Tatiana Sophia,0,39,50,50
1746600450581,JAPN 180,A00,886407,Staff,16,0,40,24
1746600451609,LATI 50,A01,886409,Martin-Cabrera; Luis,3,0,22,19
1746600451609,LATI 50,A02,886410,Martin-Cabrera; Luis,19,0,22,3
1746600451609,LATI 50,A03,886411,Martin-Cabrera; Luis,21,0,22,1
1746600451609,LATI 50,A04,886412,Martin-Cabrera; Luis,8,0,22,14
1746600452637,LAWS 101,A00,907664,Staff,28,0,60,32
1746600453663,LIAB 1A,A00,889388,Saab; Dima,17,0,20,3
1746600454687,LIAB 1AX,A00,889389,El Cheddadi; Youniss,18,0,20,2
1746600455713,LIFR 1C,A00,889391,Van Moer; Vinciane G,8,0,20,12
1746600456740,LIFR 1CX,A00,889392,Van Moer; Vinciane G,7,0,20,13
1746600457770,LIFR 1D,A00,889393,Van Moer; Vinciane G,7,0,20,13
1746600458797,LIFR 1DX,A00,889394,Van Moer; Vinciane G,8,0,20,12
1746600459822,LIGN 7,A00,886923,Staff,25,0,50,25
1746600460848,LIGN 17,A00,886924,Kehler; Andrew Scott,126,0,150,24
1746600461877,LTAM 110,A00,889395,Staff,15,0,30,15
1746600462905,LTAM 110GS,A00,958010,Rodriguez; Bretton Sigfred,0,0,0,28
1746600463935,LTCH 101,A00,889397,Staff,23,0,25,2
1746600464963,LTCS 130,A00,889398,Staff,23,0,25,2
1746600465990,LTEA 138,A00,889399,Staff,24,0,40,16
1746600467016,LTEN 149,A00,889400,Wesling; Megan E.,0,3,25,25
1746600468044,LTEN 169,A00,889401,Staff,20,0,25,5
1746600469072,LTEN 180,A00,889402,Staff,10,0,15,5
1746600470098,LTEN 181,A00,889403,Staff,21,0,25,4
1746600471125,LTWL 100,A00,889404,Myerston Santana; Jacobo,2,0,25,23
1746600472151,LTWL 180GS,A00,889405,Staff,0,0,20,20
1746600473181,LTWL 181,A00,889406,Staff,16,0,25,9
1746600474207,LTWL 184,A00,889475,Mukherjee; Silpa,22,0,25,3
1746600475235,LTWR 102C,A00,889486,Staff,29,0,30,1
1746600476263,LTWR 115W,A00,889491,Staff,0,2,15,15
1746600477289,MAE 8,A01,886905,Staff,0,2,0,0
1746600478314,MAE 11,A00,886906,Bandaru; Prabhakar,0,7,50,50
1746600479346,MAE 20,A00,886907,Evdokimenko; Ekaterina,43,0,70,27
1746600480372,MAE 30B,A00,886909,Ghazinejad; Maziar,25,0,45,20
1746600481396,MAE 101B,A00,886910,Saintillan; David,30,0,45,15
1746600482422,MAE 105,A00,886911,Bandaru; Prabhakar,18,0,50,32
1746600483454,MAE 107,B00,958024,Staff,7,0,50,43
1746600484478,MAE 143B,A00,886913,Bewley; Thomas R,2,0,40,38
1746600485507,MAE 148,A01,886915,Silberman; Jack,0,3,14,14
1746600486533,MAE 160,A00,886916,Evdokimenko; Ekaterina,30,0,60,30
1746600487561,MATH 3C,A01,889681,Staff,0,2,30,30
1746600487561,MATH 3C,A02,960048,Staff,23,0,30,7
1746600488592,MATH 10A,A01,889760,Staff,26,0,30,4
1746600488592,MATH 10A,A02,889783,Staff,29,0,30,1
1746600489617,MATH 10B,A01,889785,Verstraete; Jacques Allan,1,0,35,34
1746600489617,MATH 10B,A02,889795,Verstraete; Jacques Allan,4,0,35,31
1746600489617,MATH 10B,B01,889797,Verstraete; Jacques Allan,3,0,35,32
1746600489617,MATH 10B,B02,889828,Verstraete; Jacques Allan,3,0,35,32
1746600490644,MATH 10C,A01,889849,Habib; Yousaf,8,0,30,22
1746600490644,MATH 10C,A02,889852,Habib; Yousaf,14,0,30,16
1746600490644,MATH 10C,A03,889853,Habib; Yousaf,22,0,30,8
1746600490644,MATH 10C,A04,889858,Habib; Yousaf,20,0,30,10
1746600490644,MATH 10C,B01,889861,Staff,1,0,30,29
1746600490644,MATH 10C,B02,889862,Staff,24,0,30,6
1746600490644,MATH 10C,B03,889863,Staff,27,0,30,3
1746600490644,MATH 10C,B04,889967,Staff,23,0,30,7
1746600491669,MATH 18,A01,889974,Staff,7,0,30,23
1746600491669,MATH 18,A02,889977,Staff,20,0,30,10
1746600491669,MATH 18,B01,889984,Hardiman; Liam,20,0,30,10
1746600491669,MATH 18,B02,889985,Hardiman; Liam,25,0,30,5
1746600492697,MATH 20A,A01,889990,Suk; Andrew Hoon,30,0,35,5
1746600493721,MATH 20B,A01,889993,Ohm; Ko Woon,21,0,30,9
1746600493721,MATH 20B,A02,889994,Ohm; Ko Woon,30,0,30,0
1746600493721,MATH 20B,B01,889996,Ohm; Ko Woon,22,0,30,8
1746600493721,MATH 20B,B02,889997,Ohm; Ko Woon,23,0,30,7
1746600494747,MATH 20C,A01,889999,Hammock; Frances H,17,0,30,13
1746600494747,MATH 20C,A02,890003,Hammock; Frances H,23,0,30,7
1746600494747,MATH 20C,B01,890006,Hammock; Frances H,2,0,30,28
1746600494747,MATH 20C,B02,890007,Hammock; Frances H,12,0,30,18
1746600495774,MATH 20D,A01,890011,Cheng; Hsiao-Bing,1,0,30,29
1746600495774,MATH 20D,A02,890012,Cheng; Hsiao-Bing,14,0,30,16
1746600495774,MATH 20D,B01,890016,Cheng; Hsiao-Bing,13,0,30,17
1746600495774,MATH 20D,B02,890017,Cheng; Hsiao-Bing,13,0,30,17
1746600496805,MATH 20E,A01,890026,Harel; Guershon,1,0,30,29
1746600496805,MATH 20E,A02,890029,Harel; Guershon,22,0,30,8
1746600496805,MATH 20E,B01,890033,Harel; Guershon,7,0,30,23
1746600496805,MATH 20E,B02,890101,Harel; Guershon,21,0,30,9
1746600497831,MATH 102,A01,890104,Staff,18,0,30,12
1746600497831,MATH 102,A02,890105,Staff,27,0,30,3
1746600498855,MATH 103B,A01,890116,Salehi Golsefidy; Alireza,3,0,30,27
1746600498855,MATH 103B,B01,890118,Staff,0,3,34,34
1746600499883,MATH 109,A01,890121,Aliabadi Sr.; Mohsen,0,0,30,30
1746600499883,MATH 109,B01,890124,Upadrashta; Pranav Kumar,18,0,30,12
1746600500914,MATH 120A,A01,890126,Eggers; John Dietrich,13,0,30,17
1746600501938,MATH 142B,A01,890128,Ioana; Adrian,19,0,30,11
1746600501938,MATH 142B,A02,890129,Ioana; Adrian,12,0,30,18
1746600502969,MATH 154,A01,890174,Staff,0,1,30,30
1746600502969,MATH 154,A02,890182,Staff,0,0,30,30
1746600503998,MATH 168A,A01,890197,Dumitriu; Ioana,21,0,35,14
1746600505029,MATH 170A,A01,890240,Nie; Jiawang,1,0,30,29
1746600505029,MATH 170A,A02,890241,Nie; Jiawang,11,0,30,19
1746600505029,MATH 170A,A03,890249,Nie; Jiawang,23,0,30,7
1746600506054,MATH 170B,A01,957891,Nag; Panchali,13,0,35,22
1746600508111,MATH 181A,A01,908025,Staff,0,3,35,35
1746600508111,MATH 181A,A02,960115,Staff,26,0,35,9
1746600509137,MATH 181B,A01,959874,Staff,24,0,30,6
1746600510166,MATH 193B,A01,890265,Staff,0,4,35,35
1746600511197,MGT 4,A01,890311,Anderson; John Charles,42,0,88,46
1746600512222,MGT 5,A00,907740,Staff,12,0,98,86
1746600513251,MGT 12,A00,890312,Lindenberger; Wade Douglas,67,0,98,31
1746600514275,MGT 16,A00,957883,Staff,78,0,98,20
1746600516334,MGT 45,A00,890314,Pecore; Joseph P.,45,0,98,53
1746600517359,MGT 71,A00,890315,Staff,0,12,98,98
1746600518388,MGT 100,A00,890316,Yavorsky; Daniel Ryan,44,0,98,54
1746600519418,MGT 103,A00,890317,Ehrich; Kristine R,73,0,98,25
1746600520445,MGT 105,A00,890356,Bates; Kenneth Walter,0,8,98,98
1746600521472,MGT 112,A00,890360,Ehrich; Kristine R,55,0,98,43
1746600522499,MGT 127R,A00,907732,Zhu; Kevin Xiaoguo,23,0,98,75
1746600523526,MGT 131B,A00,890361,Anderson; John Charles,59,0,98,39
1746600524552,MGT 137,A00,890362,Lindenberger; Wade Douglas,65,0,98,33
1746600525579,MGT 160,A00,890369,Johnson; Erik Barry,9,0,98,89
1746600527640,MGT 164,A00,890372,Zimmermann; Carsten,0,40,98,98
1746600528669,MGT 180,A00,890374,Bliss; Barbara Ann,11,0,98,87
1746600529696,MMW 15,A01,886414,Chang; Edmond Yi-Teh,0,12,28,28
1746600529696,MMW 15,A02,886415,Chang; Edmond Yi-Teh,0,8,28,28
1746600529696,MMW 15,A03,886416,Chang; Edmond Yi-Teh,0,9,28,28
1746600529696,MMW 15,A04,886417,Chang; Edmond Yi-Teh,0,8,28,28
1746600529696,MMW 15,B01,886419,Chang; Edmond Yi-Teh,0,7,28,28
1746600529696,MMW 15,B02,886420,Chang; Edmond Yi-Teh,0,7,28,28
1746600529696,MMW 15,B03,886421,Chang; Edmond Yi-Teh,0,7,28,28
1746600529696,MMW 15,B04,886422,Chang; Edmond Yi-Teh,0,8,28,28
1746600529696,MMW 15,C01,886424,Staff,0,9,28,28
1746600529696,MMW 15,C02,886425,Staff,0,8,28,28
1746600529696,MMW 15,C03,886426,Staff,0,8,28,28
1746600529696,MMW 15,C04,886427,Staff,0,8,28,28
1746600529696,MMW 15,C05,958038,Staff,0,8,28,28
1746600529696,MMW 15,C06,958039,Staff,0,7,28,28
1746600530721,MMW 15GS,A00,906910,Patterson; Patrick H.,4,0,28,24
1746600531751,MMW 122R,A01,886429,Rahimi; Babak,0,13,28,28
1746600531751,MMW 122R,A02,886430,Rahimi; Babak,0,12,28,28
1746600531751,MMW 122R,A03,958040,Rahimi; Babak,0,11,28,28
1746600532783,MUS 1A,A01,890937,Staff,2,0,25,23
1746600532783,MUS 1A,A02,891035,Staff,6,0,25,19
1746600532783,MUS 1A,C01,958912,Staff,24,0,25,1
1746600532783,MUS 1A,C02,958913,Staff,25,0,25,0
1746600534836,MUS 2AK,A00,957092,Ohnishi; Takae,15,0,15,0
1746600535868,MUS 4,A01,891044,Staff,0,0,25,25
1746600535868,MUS 4,A02,891045,Staff,22,0,25,3
1746600535868,MUS 4,B01,891048,Staff,17,0,25,8
1746600535868,MUS 4,B02,891050,Staff,25,0,25,0
1746600536898,MUS 5,A01,957506,Dubnov; Shlomo,0,0,25,25
1746600536898,MUS 5,A02,957622,Dubnov; Shlomo,13,0,25,12
1746600536898,MUS 5,A03,957623,Dubnov; Shlomo,20,0,25,5
1746600537929,MUS 6,A01,891053,Freitas Caetano; Marcelo,24,0,25,1
1746600537929,MUS 6,A02,891054,Freitas Caetano; Marcelo,23,0,25,2
1746600538960,MUS 7,A01,891081,Staff,0,0,25,25
1746600538960,MUS 7,A02,891082,Staff,3,0,25,22
1746600539999,MUS 8GS,A00,891118,Borgo; David Garcia,1,0,25,24
1746600541025,MUS 11,A01,891140,Staff,8,0,25,17
1746600541025,MUS 11,A02,891141,Staff,21,0,25,4
1746600542052,MUS 13,A01,891143,Staff,8,0,25,17
1746600542052,MUS 13,A02,891144,Staff,24,0,25,1
1746600543077,MUS 15,A01,891146,Staff,9,0,25,16
1746600543077,MUS 15,A02,891148,Staff,21,0,25,4
1746600543077,MUS 15,B01,891150,Staff,18,0,25,7
1746600543077,MUS 15,B02,891151,Staff,25,0,25,0
1746600544103,MUS 20,A01,891153,Staff,5,0,20,15
1746600544103,MUS 20,A02,891155,Staff,14,0,20,6
1746600545131,MUS 80,A00,891156,Staff,19,0,25,6
1746600545131,MUS 80,B00,891157,Staff,23,0,25,2
1746600546159,MUS 130,A00,891158,Ohnishi; Takae,35,0,35,0
1746600547187,MUS 150GS,A01,891160,Borgo; David Garcia,1,0,25,24
1746600548212,MUS 170,A01,891162,Freitas Caetano; Marcelo,20,0,25,5
1746600548212,MUS 170,A02,891164,Freitas Caetano; Marcelo,21,0,25,4
1746600549238,NANO 11,A00,886220,Vazquez Mena; Oscar,13,0,15,2
1746600550263,NANO 15,A01,886222,Drews; Aaron,4,0,7,3
1746600551289,NANO 104,A00,886224,Sirbuly; Donald,17,0,25,8
1746600552315,PH 40,A00,886528,Staff,23,0,40,17
1746600553339,PH 45,A01,886799,Staff,35,0,40,5
1746600554366,PH 110,A00,886802,Staff,0,6,40,40
1746600555395,PH 172,A00,906716,Staff,19,0,35,16
1746600556420,PH 191,A00,886803,Staff,6,0,40,34
1746600557444,PHIL 1,A00,889500,Staff,20,0,30,10
1746600558473,PHIL 10,A01,889549,Grush; Rick Scott,16,0,22,6
1746600558473,PHIL 10,A02,889551,Grush; Rick Scott,22,0,22,0
1746600559499,PHIL 28,A01,889559,Lamey; Andy M.,0,2,31,31
1746600559499,PHIL 28,A02,889561,Lamey; Andy M.,0,1,30,30
1746600559499,PHIL 28,A03,889572,Lamey; Andy M.,0,1,30,30
1746600560524,PHIL 35,A00,907839,Staff,13,0,15,2
1746600561551,PHIL 60,A00,889574,Staff,73,0,90,17
1746600562578,PHIL 101,A00,958004,Staff,12,0,15,3
1746600564633,PHIL 136,A00,889582,Fulkerson; Matthew Todd,26,0,45,19
1746600565662,PHIL 163,A01,889601,Staff,21,0,30,9
1746600565662,PHIL 163,B01,889606,Brandt; Reuven A,0,3,0,0
1746600566690,PHIL 164,A00,889610,Staff,16,0,30,14
1746600567714,PHIL 165,A00,889613,Staff,22,0,30,8
1746600568743,PHYS 1A,A00,886431,Staff,30,0,70,40
1746600569769,PHYS 1AL,001,886432,Tsai; Philbert S,0,1,30,30
1746600569769,PHYS 1AL,002,886436,Tsai; Philbert S,13,0,30,17
1746600570795,PHYS 1B,A00,886439,Staff,184,0,240,56
1746600571822,PHYS 1BL,001,886441,Tsai; Philbert S,0,4,30,30
1746600571822,PHYS 1BL,002,886444,Tsai; Philbert S,2,0,30,28
1746600572849,PHYS 1C,A00,896092,Arnold; Kam S,78,0,146,68
1746600573874,PHYS 1CL,001,886448,Tsai; Philbert S,0,0,30,30
1746600573874,PHYS 1CL,002,886449,Tsai; Philbert S,1,0,30,29
1746600573874,PHYS 1CL,003,886450,Tsai; Philbert S,16,0,30,14
1746600573874,PHYS 1CL,004,886451,Tsai; Philbert S,15,0,30,15
1746600574899,PHYS 2B,A01,886457,Staff,67,0,115,48
1746600575925,PHYS 2C,A01,886460,Shotwell; Brian,0,9,65,65
1746600576959,PHYS 2CL,A01,886467,Staff,0,4,28,28
1746600576959,PHYS 2CL,A02,886468,Staff,0,3,28,28
1746600577986,PHYS 2D,A01,886470,Staff,10,0,50,40
1746600579021,PHYS 4B,A01,886475,Grinstein; Benjamin,22,0,40,18
1746600580050,POLI 5,A00,891173,Desposato; Scott,7,0,25,18
1746600581078,POLI 5D,A01,891175,Staff,5,0,5,0
1746600581078,POLI 5D,B01,891178,Staff,5,0,5,0
1746600582106,POLI 11,A00,891179,Ferree; Karen E,0,0,35,35
1746600583135,POLI 12,A00,891180,Staff,15,0,30,15
1746600584160,POLI 27,A01,891182,Staff,11,0,75,64
1746600585189,POLI 30,A00,891183,Staff,8,0,50,42
1746600586215,POLI 100B,A00,891244,Staff,5,1,35,30
1746600587243,POLI 100I,A00,891247,Staff,7,0,30,23
1746600588269,POLI 104J,A00,891248,Nichter; Maysa,14,0,30,16
1746600589296,POLI 104U,A00,891250,Nichter; Maysa,1,0,30,29
1746600591349,POLI 110B,A00,891255,Wiens; David,19,0,25,6
1746600592375,POLI 112A,A00,891256,Wiens; David,6,0,25,19
1746600593402,POLI 114BR,A00,891261,Staff,19,0,30,11
1746600594429,POLI 117R,A00,891262,Forman; Fonna,0,6,50,50
1746600595457,POLI 118,A00,891264,Ingham; Sean,17,0,25,8
1746600596488,POLI 124A,A00,891265,Staff,18,0,20,2
1746600597517,POLI 125D,A00,891266,Nichter; Simeon C,2,0,25,23
1746600598544,POLI 126,A00,891268,Nichter; Simeon C,7,0,25,18
1746600599574,POLI 126AA,A00,891272,Staff,15,0,25,10
1746600600601,POLI 130AA,A00,891273,Staff,15,0,20,5
1746600601628,POLI 134AA,A00,891274,Staff,4,0,20,16
1746600603687,POLI 138,A00,891278,Staff,21,0,25,4
1746600604717,POLI 142K,A00,891280,Staff,10,0,25,15
1746600605742,POLI 142M,A00,891281,Gartzke; Erik,16,0,30,14
1746600606768,POLI 142P,A00,891284,Staff,20,0,30,10
1746600607793,POLI 143,A00,891285,Gartzke; Erik,12,0,30,18
1746600608822,POLI 153,A00,891286,Staff,19,0,20,1
1746600610879,POLI 175,A00,891290,Staff,15,0,20,5
1746600611909,PSYC 1,A00,890674,Steiner; Eric Tomas,0,11,45,45
1746600612941,PSYC 2,A00,890676,Albright; Thomas D,20,0,35,15
1746600613969,PSYC 3,A00,890679,Staff,17,0,20,3
1746600615000,PSYC 6,A00,959858,Staff,19,0,20,1
1746600616026,PSYC 60,A01,890684,Rickard; Timothy C.,0,6,45,45
1746600617052,PSYC 70,A01,890689,Geller; Emma Harlan,6,0,30,24
1746600618077,PSYC 71,A01,959860,Staff,21,0,25,4
1746600619103,PSYC 100,A00,890690,Lacefield; Katharine I,0,50,180,180
1746600620130,PSYC 102,A00,890695,Staff,18,0,40,22
1746600621155,PSYC 105,A00,890699,Geller; Emma Harlan,70,0,100,30
1746600622184,PSYC 106,A00,890701,Gorman; Michael R.,5,0,30,25
1746600623210,PSYC 108,A00,890704,Adrian; Julia Anna,0,29,50,50
1746600624237,PSYC 118,A01,890712,Staff,11,0,30,19
1746600625267,PSYC 124,A00,890716,Chapman; Eddie Nathaniel,25,0,60,35
1746600626295,PSYC 131,A00,890717,Anagnostaras; Stephan,0,7,80,80
1746600627321,PSYC 137,A00,890719,Winkielman; Piotr,0,11,30,30
1746600628348,PSYC 144,A00,890721,Adrian; Julia Anna,0,9,45,45
1746600629372,PSYC 162,A00,890805,Staff,0,1,75,75
1746600630398,PSYC 169,A00,890810,Staff,0,15,30,30
1746600631426,PSYC 172,A00,890814,Gorman; Michael R.,9,0,30,21
1746600632451,PSYC 181,A00,890818,Anagnostaras; Stephan,7,0,200,193
1746600633477,PSYC 184,A00,959861,Staff,162,0,175,13
1746600634502,PSYC 189,A00,890823,Staff,0,2,30,30
1746600635531,PSYC 191,A00,890884,Rickard; Timothy C.,0,11,35,35
1746600636559,PSYC 193,A00,890913,Staff,19,0,30,11
1746600636559,PSYC 193,B00,890914,Chapman; Eddie Nathaniel,24,0,30,6
1746600637586,PSYC 193L,A01,890918,Lowe; Angela Beth,20,0,30,10
1746600637586,PSYC 193L,B01,890921,Hurwitz; Ethan Scott,20,0,30,10
1746600637586,PSYC 193L,C01,890928,Staff,30,0,30,0
1746600638611,RELI 149,A00,886806,Rahimi; Babak,23,0,40,17
1746600639640,SE 9,A01,886814,Staff,7,0,20,13
1746600640669,SE 101B,A01,886816,Chadha; Mayank,3,0,35,32
1746600641694,SE 110B,A00,886818,Zhu; Qiang,4,0,75,71
1746600642722,SE 125,A01,886830,Staff,10,0,30,20
1746600643750,SE 130B,A01,886835,Staff,14,0,40,26
1746600644776,SE 131A,A01,886838,Krysl; Petr,34,0,55,21
1746600645806,SE 154,A00,886840,Staff,28,0,50,22
1746600646834,SE 164GS,A01,886849,Staff,6,0,20,14
1746600647860,SE 167GS,A01,886853,Staff,6,0,20,14
1746600648887,SIO 25,A01,890107,Staff,19,0,30,11
1746600649916,SIO 45,A00,890109,Cook; Geoffrey W,115,0,200,85
1746600650943,SIO 109R,A00,890110,Forman; Fonna,0,16,20,20
1746600651972,SIO 187,A01,890114,Kacev; David,15,0,40,25
1746600652998,SOCI 1,A01,890431,Thorpe; Charles Robert,14,0,30,16
1746600652998,SOCI 1,A02,890518,Thorpe; Charles Robert,30,0,30,0
1746600654026,SOCI 2,A01,957978,Staff,25,0,25,0
1746600654026,SOCI 2,A02,957979,Staff,23,0,25,2
1746600655053,SOCI 20,A01,890523,Calderon-Zaks; Michael Aar,21,0,30,9
1746600655053,SOCI 20,A02,890526,Calderon-Zaks; Michael Aar,29,0,30,1
1746600656078,SOCI 30,A01,890533,Pardo Guerra; Juan Pablo,37,0,40,3
1746600657108,SOCI 40,A01,890535,Staff,27,0,45,18
1746600658134,SOCI 104Q,A00,890559,Staff,18,0,30,12
1746600659165,SOCI 106,A00,890560,Arnal; Maud Marie Leonie,20,0,30,10
1746600660199,SOCI 110,A00,890567,Holkenbrink-Monk; Charlene,19,0,30,11
1746600661227,SOCI 112,A00,890568,Victoria Torres; Pablo,2,0,55,53
1746600662251,SOCI 115,A00,890597,Arnal; Maud Marie Leonie,28,0,45,17
1746600664302,SOCI 121,A00,890604,Pardo Guerra; Juan Pablo,38,0,45,7
1746600665329,SOCI 126,A01,890608,Staff,8,0,10,2
1746600666355,SOCI 127,A00,890609,Staff,18,0,30,12
1746600667380,SOCI 131,A00,890610,Thorpe; Charles Robert,37,0,45,8
1746600668407,SOCI 135,A00,890615,Payne; Christine Anna,14,0,45,31
1746600669435,SOCI 139,A00,890620,Staff,38,0,45,7
1746600670460,SOCI 148E,A00,890622,Calderon-Zaks; Michael Aar,36,0,45,9
1746600671513,SOCI 150,A00,890623,Kohler; Kristopher M.,31,0,45,14
1746600672539,SOCI 157,A00,890625,Jules-Rosette; Bennetta W.,18,0,20,2
1746600673565,SOCI 160,A00,890627,Payne; Christine Anna,21,0,45,24
1746600674593,SYN 1,A00,886855,Fish; Gwendolyn Anne,0,1,0,0
1746600674593,SYN 1,B00,906086,Fish; Gwendolyn Anne,0,2,0,2
1746600675617,SYN 2R,A00,886860,Staff,0,17,15,15
1746600675617,SYN 2R,B00,906106,Atkinson; Arthur Laird,0,16,15,15
1746600676646,SYN 100,A01,886866,Browne; Emily,0,28,20,20
1746600676646,SYN 100,B01,906128,Rock; Martin,0,4,20,20
1746600676646,SYN 100,C01,906140,Deavenport; James Cary,0,4,20,20
1746600676646,SYN 100,D01,907816,Deavenport; James Cary,0,5,20,20
1746600677670,TDAC 1,A00,890286,Walsh; Kim C.,7,0,20,13
1746600678695,TDAC 101,A00,890296,Basso; Beatrice,15,0,20,5
1746600679718,TDDE 131,A00,890297,Staff,47,0,50,3
1746600680746,TDDM 1,A00,890287,Weinberg; Sadie,25,0,30,5
1746600681771,TDGE 11,A00,890288,Fulton; Julia,138,0,200,62
1746600681771,TDGE 11,B00,890289,Castro; Robert Jess,184,0,200,16
1746600682800,TDGE 25,B00,957359,Walsh; Kim C.,5,0,20,15
1746600683826,TDGE 40,A01,890292,Power; Jade Yukana,26,0,30,4
1746600684853,TDGE 124,A00,890298,Havis; Allan,0,2,50,50
1746600685878,TDGE 131R,A00,890299,Burelle; Julie Sara Veronique,15,0,42,27
1746600686906,TDHT 101,A00,890300,Staff,10,0,20,10
1746600687933,TDHT 109,A01,890302,Anderson; Mysia Anyse,31,0,40,9
1746600688958,TDMV 1,A00,890293,Arcidiacono; Kristin,18,0,30,12
1746600689987,TDMV 2,A00,890294,Weinberg; Sadie,23,0,30,7
1746600691014,TDMV 3,A00,957878,Arcidiacono; Kristin,28,0,30,2
1746600693072,TDMV 138,A00,890304,Jun; Grace Shin Hae,25,0,40,15
1746600694099,TDMV 140,A00,890305,Corrales; Joseph Bernales,25,0,30,5
1746600695129,TDMV 142,A00,890307,Caligagan; Tony,32,0,40,8
1746600696157,TDMV 144,A00,890308,Camaya; Michelle Ann,25,0,30,5
1746600697185,TDPW 1,A00,890295,Stein; Deborah Isobel,3,0,20,17
1746600698213,USP 2,A01,890272,Lerner; Amy M,7,0,20,13
1746600699244,USP 3,A01,890274,Staff,12,0,30,18
1746600700270,USP 15,A01,890276,Sun; Feiyang,16,0,30,14
1746600701296,USP 25,A00,890277,Shenkman; Michael Thomas,18,0,25,7
1746600702320,USP 138,A00,890278,Staff,13,0,25,12
1746600703344,USP 143,A00,890279,Staff,21,0,70,49
1746600704372,USP 144,A00,890280,Chowdhury; Muhammed Zohir,16,0,30,14
1746600705402,USP 150,A00,890281,Boomhower; Matthew Charles,4,0,30,26
1746600706428,USP 151,A00,890282,Staff,16,0,20,4
1746600707456,USP 162,A00,890283,Andrews; Abigail Leslie,16,0,20,4
1746600708484,USP 168,A00,920477,Kwak; Nancy,0,0,5,5
1746600709516,USP 181,A00,890284,Staff,3,0,20,17
1746600710541,USP 191A,A00,890285,Staff,12,0,20,8
1746600711568,VIS 101,A00,886512,Staff,26,0,75,49
1746600712594,VIS 103,A00,886513,Cruz; Edwin Teddy,61,0,75,14
1746600713618,VIS 108,A00,886514,Staff,4,0,15,11
1746600714643,VIS 127P,A00,886515,Shen; Kuiyi,80,0,146,66
1746600715669,VIS 149,A00,886516,Yoldas; Pinar,0,0,15,15
1746600716693,VIS 164,A00,886526,Erdmann; Dean,19,0,22,3
1746600717722,VIS 194S,A00,886527,Staff,61,0,75,14
1746600718751,WCWP 10A,C00,886484,Martiniuk; Jill,12,0,15,3
1746600719782,WCWP 10B,A00,886490,Uriarte; Emma,0,0,15,15
1746600719782,WCWP 10B,B00,886491,Dhir; Simrita,8,0,15,7
1746600719782,WCWP 10B,C00,886492,Ornelas; Tricia,0,0,15,15
1746600720811,WCWP 100,A00,886494,Young; Mark T,0,6,15,15
1746600722931,AAS 10,A01,886199,Childs; Dennis R.,0,3,0,0
1746600723956,ANAR 104,A01,886940,Shtienberg; Gilad,27,0,30,3
1746600724982,ANAR 120,A00,886953,Staff,13,0,20,7
1746600726008,ANBI 148,A01,886955,Wilder; Linnea Lorene,30,0,40,10
1746600728061,ANSC 122,A00,886957,Staff,24,0,30,6
1746600729090,ANSC 150,A00,886958,Sloane; Julia Kathryn,2,0,15,13
1746600730116,ANSC 156,A00,886959,Jenkins; Janis A.,0,1,15,15
1746600731144,ANSC 180,A00,886960,Staff,11,0,17,6
1746600732169,ANSC 188,A00,886961,Jassal; Aftab,9,0,25,16
1746600733197,ANSC 190,A00,886962,Jassal; Aftab,14,0,25,11
1746600734221,ANSC 191,A00,886963,Staff,18,0,20,2
1746600735248,ANTH 3,A01,891689,Staff,17,0,20,3
1746600736275,ANTH 5,A00,886933,Semendeferi; Ekaterini,16,0,20,4
1746600737301,ANTH 10,A00,886934,Staff,0,12,30,30
1746600738326,ANTH 21,A01,886936,Staff,41,0,60,19
1746600739354,ANTH 23,A01,886938,Staff,92,0,100,8
1746600740378,ANTH 105,A00,886964,Stewart; Alexander B,84,0,100,16
1746600741403,ANTH 108,A00,886965,Pedersen; David,9,0,20,11
1746600742435,AWP 10,001,886147,Staff,0,0,0,0
1746600742435,AWP 10,002,886148,Staff,0,0,0,0
1746600742435,AWP 10,003,886149,Staff,0,0,0,0
1746600742435,AWP 10,004,886150,Staff,0,0,0,0
1746600742435,AWP 10,005,886151,Staff,0,0,0,0
1746600742435,AWP 10,006,886152,Staff,0,0,0,0
1746600742435,AWP 10,007,886153,Staff,0,0,0,0
1746600742435,AWP 10,008,886154,Staff,0,0,0,0
1746600742435,AWP 10,009,886155,Staff,0,0,0,0
1746600742435,AWP 10,010,886156,Staff,0,0,0,0
1746600742435,AWP 10,011,886158,Staff,0,0,0,0
1746600742435,AWP 10,012,886160,Staff,0,0,0,0
1746600742435,AWP 10,013,886161,Staff,0,0,0,0
1746600742435,AWP 10,014,886162,Staff,0,0,0,0
1746600742435,AWP 10,015,886163,Staff,0,0,0,0
1746600742435,AWP 10,016,886164,Staff,0,0,0,0
1746600742435,AWP 10,017,886165,Staff,0,0,0,0
1746600742435,AWP 10,018,886166,Staff,0,0,0,0
1746600742435,AWP 10,019,886168,Staff,0,0,0,0
1746600742435,AWP 10,020,886170,Staff,0,0,0,0
1746600742435,AWP 10,021,886172,Staff,0,0,0,0
1746600743462,AWP 10R,001,886173,Staff,0,1,0,0
1746600743462,AWP 10R,002,886174,Staff,0,1,0,0
1746600743462,AWP 10R,003,886175,Staff,0,0,0,0
1746600743462,AWP 10R,004,886176,Staff,0,0,0,0
1746600743462,AWP 10R,005,886177,Staff,0,0,0,0
1746600743462,AWP 10R,006,886178,Staff,0,0,0,0
1746600743462,AWP 10R,007,886179,Staff,0,0,0,0
1746600743462,AWP 10R,008,886181,Staff,0,0,0,0
1746600743462,AWP 10R,009,886182,Staff,0,0,0,0
1746600743462,AWP 10R,010,886183,Staff,0,0,0,0
1746600743462,AWP 10R,011,886184,Staff,0,0,0,0
1746600743462,AWP 10R,012,886185,Staff,0,0,0,0
1746600743462,AWP 10R,013,886186,Staff,0,0,0,0
1746600743462,AWP 10R,014,886187,Staff,0,0,0,0
1746600743462,AWP 10R,015,886188,Staff,0,0,0,0
1746600743462,AWP 10R,016,886189,Staff,0,0,0,0
1746600743462,AWP 10R,017,960532,Staff,0,0,0,0
1746600743462,AWP 10R,018,960533,Staff,0,0,0,0
1746600743462,AWP 10R,019,960534,Staff,0,0,0,0
1746600743462,AWP 10R,020,960538,Staff,0,0,0,0
1746600743462,AWP 10R,021,960540,Staff,0,0,0,0
1746600743462,AWP 10R,022,960541,Staff,0,0,0,0
1746600743462,AWP 10R,023,960542,Staff,0,0,0,0
1746600743462,AWP 10R,024,960544,Staff,0,0,0,0
1746600743462,AWP 10R,025,960545,Staff,0,0,0,0
1746600743462,AWP 10R,026,960548,Staff,0,0,0,0
1746600744489,AWP 102R,A00,886190,Staff,0,0,0,0
1746600744489,AWP 102R,B00,886191,Staff,0,0,0,0
1746600745520,BENG 100,A01,886193,Staff,17,0,30,13
1746600746550,BENG 122A,A01,886195,Hasty; Jeff M,13,0,30,17
1746600747574,BENG 166A,A00,886196,Sah; Robert Lie-Yuan,0,3,30,30
1746600748600,BENG 190,A00,958050,Khojah; Reem I,17,0,25,8
1746600749627,BIBC 102,A01,894320,Staff,0,1,46,46
1746600749627,BIBC 102,A02,894321,Staff,0,0,46,46
1746600749627,BIBC 102,A03,894344,Staff,6,0,46,40
1746600749627,BIBC 102,A04,894345,Staff,27,0,47,20
1746600750657,BICD 100R,A01,894365,Smith; Laurie,0,2,58,58
1746600750657,BICD 100R,A02,894366,Smith; Laurie,0,4,58,58
1746600750657,BICD 100R,A03,894367,Smith; Laurie,0,0,59,59
1746600750657,BICD 100R,A04,959869,Smith; Laurie,38,0,59,21
1746600751684,BICD 136,A01,894383,Gustafson-Brown; Cindy,14,0,50,36
1746600752710,BIEB 102,A01,894494,Butler; Shannon Rhey,51,0,130,79
1746600754761,BIEB 150,A01,894617,Wills; Christopher,3,0,20,17
1746600754761,BIEB 150,A02,894631,Wills; Christopher,3,0,20,17
1746600754761,BIEB 150,A03,894937,Wills; Christopher,3,0,20,17
1746600754761,BIEB 150,A04,894946,Wills; Christopher,5,0,20,15
1746600755790,BIEB 194,A00,906141,Kurle; Carolyn M.,5,0,20,15
1746600756877,BILD 1,A01,894154,Staff,3,0,19,16
1746600756877,BILD 1,A02,894155,Staff,14,0,19,5
1746600756877,BILD 1,A03,894160,Staff,13,0,19,6
1746600756877,BILD 1,A04,894161,Staff,15,0,18,3
1746600757907,BILD 2,A01,894168,Staff,0,0,50,50
1746600757907,BILD 2,A02,894169,Staff,0,0,50,50
1746600757907,BILD 2,A03,894179,Staff,0,0,50,50
1746600757907,BILD 2,A04,894203,Staff,22,0,50,28
1746600758935,BILD 3,A01,894213,Staff,23,0,31,8
1746600758935,BILD 3,A02,894214,Staff,26,0,31,5
1746600758935,BILD 3,A03,894235,Staff,28,0,31,3
1746600758935,BILD 3,A04,894236,Staff,28,0,32,4
1746600759962,BILD 4,A01,894253,Reuther; Keefe,5,0,24,19
1746600759962,BILD 4,A02,894258,Reuther; Keefe,16,0,24,8
1746600760989,BILD 5,A01,894276,Reuther; Keefe,34,0,50,16
1746600760989,BILD 5,A02,894277,Reuther; Keefe,45,0,50,5
1746600760989,BILD 5,A03,894290,Reuther; Keefe,44,0,50,6
1746600760989,BILD 5,A04,894291,Reuther; Keefe,48,0,50,2
1746600762016,BILD 24,A01,894297,Pirino; Giorgia,40,0,60,20
1746600763041,BIMM 100,B01,958915,Staff,71,0,100,29
1746600764068,BIMM 101,A01,895017,McDonnell; Lisa Marie,0,5,24,24
1746600764068,BIMM 101,A02,895018,McDonnell; Lisa Marie,0,5,24,24
1746600764068,BIMM 101,B01,895020,McDonnell; Lisa Marie,0,5,24,24
1746600764068,BIMM 101,B02,895021,McDonnell; Lisa Marie,0,4,24,24
1746600765097,BIMM 110,A01,895023,Staff,1,0,25,24
1746600765097,BIMM 110,A02,895024,Staff,9,0,25,16
1746600765097,BIMM 110,A03,895025,Staff,18,0,25,7
1746600765097,BIMM 110,A04,895031,Staff,20,0,25,5
1746600766126,BIMM 120,A01,895114,Gustafson-Brown; Cindy,14,0,28,14
1746600766126,BIMM 120,A02,895126,Gustafson-Brown; Cindy,21,0,27,6
1746600767156,BIPN 100,A01,895130,Yang; Mingyu,0,0,38,38
1746600767156,BIPN 100,A02,895131,Yang; Mingyu,31,0,38,7
1746600767156,BIPN 100,A03,895132,Yang; Mingyu,32,0,38,6
1746600767156,BIPN 100,A04,895133,Yang; Mingyu,27,0,36,9
1746600768186,BIPN 120,A01,895135,Cooke; James Edward,0,3,13,13
1746600768186,BIPN 120,A02,895136,Cooke; James Edward,0,1,13,13
1746600768186,BIPN 120,A03,895137,Cooke; James Edward,0,3,13,13
1746600768186,BIPN 120,A04,895156,Cooke; James Edward,0,2,11,11
1746600769213,BIPN 134,A01,895235,Cooke; James Edward,0,1,25,25
1746600769213,BIPN 134,A02,895237,Cooke; James Edward,0,0,25,25
1746600769213,BIPN 134,A03,895240,Cooke; James Edward,1,0,25,24
1746600769213,BIPN 134,A04,895270,Cooke; James Edward,20,0,25,5
1746600770241,BIPN 189,A00,892103,Staff,0,14,14,14
1746600772291,BISP 194,A00,958008,Staff,0,2,0,0
1746600773323,CAT 124,A01,922009,Staff,0,5,20,20
1746600774357,CAT 125R,A00,886390,Morales; Celeste Georgianna,0,3,20,20
1746600774357,CAT 125R,B00,886391,Irwin; Matthew Joseph,0,4,20,20
1746600774357,CAT 125R,C00,886392,Smith; Lauryn Alissa,0,2,20,20
1746600774357,CAT 125R,D00,886393,Vanderschuit; Maya Alysia,0,3,20,20
1746600774357,CAT 125R,E00,886394,Marchisotto; Jennifer Anne,0,3,20,20
1746600775385,CENG 15,A01,886218,Drews; Aaron,3,0,8,5
1746600776411,CENG 113,A00,886219,Opatkiewicz; Justin Paul,15,0,25,10
1746600777437,CGS 101,A00,887044,Staff,7,0,20,13
1746600778467,CGS 105,A01,887046,Staff,14,0,25,11
1746600779495,CGS 112,A00,887047,Cuong; Marisol,12,0,15,3
1746600780524,CGS 113,A00,887048,Staff,23,0,30,7
1746600781548,CGS 120,A00,887049,Staff,9,0,17,8
1746600782576,CHEM 6A,A01,886336,Lam; Tin Yiu,38,0,50,12
1746600782576,CHEM 6A,A02,886338,Lam; Tin Yiu,37,0,50,13
1746600783606,CHEM 6B,A01,886341,Hopkins; Patrycja Anna,16,0,50,34
1746600783606,CHEM 6B,A02,886343,Hopkins; Patrycja Anna,42,0,50,8
1746600784634,CHEM 6C,A01,886346,Albizati; Kim F.,0,2,50,50
1746600784634,CHEM 6C,A02,886348,Albizati; Kim F.,24,0,50,26
1746600785661,CHEM 40A,A01,886352,Klosterman; Jeremy K,65,0,100,35
1746600786691,CHEM 40B,A01,886356,Klosterman; Jeremy K,0,24,100,100
1746600787715,CHEM 41B,A01,886360,Theodorakis; Emmanuel,25,0,50,25
1746600787715,CHEM 41B,A02,886362,Theodorakis; Emmanuel,47,0,50,3
1746600788744,CHIN 165A,A00,886382,Xu; Li,18,0,20,2
1746600789775,CLAS 120,A00,886387,Myerston Santana; Jacobo,33,0,40,7
1746600790800,COGS 9,A01,886967,Shannon; Kyle Michael,42,0,60,18
1746600791827,COGS 11,A01,886969,Staff,9,0,30,21
1746600792853,COGS 14A,A01,886971,Staff,5,0,60,55
1746600793879,COGS 14B,A01,886973,Hoffman; Drew Ellen,4,0,60,56
1746600794906,COGS 18,A01,886975,Morgan; Eric,34,0,60,26
1746600795936,COGS 20,A01,886977,Staff,3,0,8,5
1746600795936,COGS 20,A02,886978,Staff,5,0,7,2
1746600796963,COGS 100,A01,907783,Staff,0,1,30,30
1746600797991,COGS 101B,A01,886980,Staff,0,4,48,48
1746600799022,COGS 101C,A01,886982,Delgado; Tania,0,5,44,44
1746600800050,COGS 102A,A01,886984,Johnson; Christine M.,3,0,30,27
1746600801079,COGS 118B,A01,886986,Staff,0,4,88,88
1746600802103,COGS 150,A01,886988,Bergen; Benjamin,22,0,50,28
1746600803131,COGS 153,A00,886989,Delgado; Tania,0,3,41,41
1746600804157,COGS 186,A01,886991,Staff,0,0,32,32
1746600805181,COGS 187A,A01,886993,Boyle; Mary E. T.,7,0,30,23
1746600806208,COGS 189,A00,886994,Staff,0,1,30,30
1746600807233,COMM 10,A01,886996,Staff,0,0,20,21
1746600807233,COMM 10,A02,886997,Staff,10,0,20,10
1746600807233,COMM 10,A03,959845,Staff,19,0,20,1
1746600808259,COMM 20,A01,886999,Leuning; Grant Maurstad,24,0,40,16
1746600810313,COMM 100A,A01,887002,Staff,0,0,20,25
1746600810313,COMM 100A,A02,887003,Staff,5,0,20,15
1746600811339,COMM 100B,A01,887005,Staff,0,8,20,24
1746600812365,COMM 106D,A00,887006,Staff,14,0,40,26
1746600813392,COMM 110G,A00,887007,Whitworth-Smith; Andrew C,12,0,40,28
1746600814417,COMM 111B,A00,887008,Staff,31,0,40,9
1746600815445,COMM 113T,A00,887009,Abuelhiga; Soraya Jill,28,0,40,12
1746600815445,COMM 113T,B00,906733,Staff,39,0,40,1
1746600816471,COMM 145,A00,887010,Staff,13,0,40,27
1746600817494,COMM 146,A00,887054,Staff,32,0,40,8
1746600818520,COMM 190,A00,887012,Staff,8,0,23,15
1746600819570,CSE 8A,A50,887015,Cao; Yingjun,56,0,85,29
1746600820595,CSE 11,A01,887017,Cao; Yingjun,11,0,70,59
1746600821619,CSE 20,A01,887019,Staff,30,0,50,20
1746600822644,CSE 21,A01,887021,Staff,79,0,100,21
1746600822644,CSE 21,B01,892583,Braun; Oliver,45,0,50,5
1746600823669,CSE 30,A01,887025,Eldon; John,142,0,200,58
1746600824694,CSE 100,A01,887027,Staff,26,0,50,24
1746600824694,CSE 100,A02,887028,Staff,42,0,50,8
1746600825722,CSE 101,A01,887030,Braun; Oliver,74,0,100,26
1746600825722,CSE 101,B01,887032,Jones; Miles E,0,3,50,50
1746600825722,CSE 101,B02,887033,Jones; Miles E,0,2,50,50
1746600826749,CSE 105,A01,908084,Jones; Miles E,32,0,50,18
1746600826749,CSE 105,A02,908087,Jones; Miles E,31,0,50,19
1746600827790,CSE 135,A01,887035,Powell; Thomas Allan,0,5,50,50
1746600828816,CSE 142,A01,887037,Staff,8,0,60,52
1746600829840,CSE 142L,A01,887039,Staff,34,0,60,26
1746600830869,CSE 151A,A01,887041,Solares; Edwin A,47,0,100,53
1746600831895,CSE 175,A01,887043,Kumar; Rakesh,30,0,30,0
1746600832920,CSS 1,A01,886389,Staff,0,1,40,40
1746600833950,DSC 30,A01,908097,Liao; Soohyun Nam,47,0,75,28
1746600834980,DSC 40A,A01,908099,Shannon; Kyle Michael,30,0,50,20
1746600836007,DSC 40B,A01,908112,Staff,15,0,50,35
1746600837035,DSC 80,A01,908116,Staff,19,0,60,41
1746600838064,DSC 197,001,956863,Eldridge; Justin Matthew,9999,0,9999,0
1746600839088,ECE 5,A01,886400,Morris; Karcher William,1,0,6,5
1746600839088,ECE 5,A02,886401,Morris; Karcher William,3,0,6,3
1746600840114,ECE 148,A01,886403,Silberman; Jack,0,14,14,14
1746600841142,ECON 1,A01,887265,Crane; Meredith Helen,11,0,70,59
1746600841142,ECON 1,B01,887268,Staff,42,0,50,8
1746600842168,ECON 2,A01,887273,Crane; Meredith Helen,54,0,70,16
1746600843194,ECON 3,A01,887279,Rondina; Giacomo,31,0,70,39
1746600844220,ECON 4,A01,887282,Anderson; John Charles,0,2,10,10
1746600845246,ECON 5,A01,887285,Staff,34,0,45,11
1746600845246,ECON 5,B01,887292,Staff,41,0,45,4
1746600846272,ECON 100A,A01,887337,Newhouse; Herbert S,54,0,70,16
1746600846272,ECON 100A,B01,887349,Staff,45,0,50,5
1746600847299,ECON 100B,A01,887361,Du; Songzi,29,0,70,41
1746600848323,ECON 100C,A01,887445,Newhouse; Herbert S,59,0,70,11
1746600849353,ECON 105,A00,887488,Vespa; Emanuel Ignacio,23,0,35,12
1746600850379,ECON 109,A01,887506,Shishkin; Denis,28,0,35,7
1746600851405,ECON 110A,A01,887568,Alon; Titan Michael,0,2,35,35
1746600851405,ECON 110A,B01,907601,Alon; Titan Michael,20,0,35,15
1746600852433,ECON 110B,A01,887598,Levkoff; Steven B.,0,24,70,70
1746600853468,ECON 112,A00,887599,Rondina; Giacomo,19,0,35,16
1746600854492,ECON 120A,A01,887603,Dai; Yinlin,35,0,70,35
1746600855518,ECON 120C,A01,887608,Sun; Yixiao,0,1,35,35
1746600855518,ECON 120C,B01,887614,Sun; Yixiao,0,0,35,35
1746600856544,ECON 138,A00,887621,Bharadwaj; Prashant,0,21,20,20
1746600857569,ECON 144,A00,958007,Squires; Dale E,12,0,35,23
1746600858594,ECON 171,A01,907666,Staff,18,0,35,17
1746600859620,ECON 175,A00,887626,Wu; Pak Yeung,22,0,35,13
1746600860644,ECON 190,A00,887640,Vespa; Emanuel Ignacio,22,0,35,13
1746600861673,EDS 25,A01,888197,Staff,0,0,0,0
1746600861673,EDS 25,A02,888209,Staff,0,0,0,0
1746600861673,EDS 25,A03,888210,Staff,0,0,0,0
1746600861673,EDS 25,A04,888212,Staff,0,0,0,0
1746600861673,EDS 25,A05,888213,Staff,0,0,0,0
1746600861673,EDS 25,A06,888214,Staff,0,0,0,0
1746600861673,EDS 25,A07,888235,Staff,0,2,0,0
1746600861673,EDS 25,A08,888236,Staff,0,0,0,0
1746600861673,EDS 25,A09,888240,Staff,0,0,0,0
1746600861673,EDS 25,A10,888244,Staff,0,0,0,0
1746600861673,EDS 25,B01,888273,Staff,0,0,0,0
1746600861673,EDS 25,B02,888285,Staff,0,0,0,0
1746600861673,EDS 25,B03,888423,Staff,0,0,0,1
1746600861673,EDS 25,B04,888432,Staff,0,0,0,0
1746600861673,EDS 25,B05,888433,Staff,0,0,0,0
1746600861673,EDS 25,B06,888467,Staff,0,0,0,0
1746600861673,EDS 25,B07,888468,Staff,0,0,0,0
1746600861673,EDS 25,B08,888479,Staff,0,0,0,0
1746600861673,EDS 25,B09,888484,Staff,0,0,0,0
1746600861673,EDS 25,B10,888487,Staff,0,0,0,0
1746600862705,EDS 38,A01,907700,Choi; Bailey Miyeon,30,0,30,0
1746600863729,EDS 112,A01,888601,Chapman; Thandeka K,12,0,40,28
1746600864761,EDS 115,A00,888697,Mendez; Kathrina Mendoza,10,0,30,20
1746600865789,EDS 116,A01,888893,Staff,33,0,40,7
1746600867842,EDS 124AR,A00,889133,Staff,29,0,50,21
1746600867842,EDS 124AR,B00,907471,Simon; Elizabeth A,37,0,50,13
1746600868869,EDS 124BR,A00,889134,Simon; Elizabeth A,44,0,100,56
1746600869897,EDS 125,A00,889135,Staff,25,0,30,5
1746600870921,EDS 126,A01,889138,Staff,35,0,40,5
1746600871948,EDS 164R,A01,889142,Wishard Guerra; Alison G.,32,0,50,18
1746600872979,ENG 30,A01,886396,Staff,0,0,0,0
1746600872979,ENG 30,B01,886398,Staff,0,0,0,0
1746600874005,ENVR 102,A00,906150,Montejo; Carolina,23,0,25,2
1746600875031,ETHN 103A,A00,887236,Man; Simeon S,0,2,0,0
1746600876060,ETHN 113,A00,887239,Staff,16,0,30,14
1746600877085,ETHN 116,A00,887240,Staff,16,0,25,9
1746600878111,ETHN 117,A00,887241,Choi; Esther Min,28,0,30,2
1746600879140,ETHN 118,A00,887243,Staff,24,0,30,6
1746600880171,ETHN 127,A00,887248,Cuong; Marisol,11,0,15,4
1746600881196,ETHN 139,A00,887250,Staff,7,0,10,3
1746600882221,ETHN 142,A00,887252,Staff,9,0,30,21
1746600883251,ETHN 161,A00,887253,Browne; Errol Tsekani,24,0,30,6
1746600884276,ETHN 163FR,A00,887255,Burelle; Julie Sara Veronique,0,0,5,5
1746600885312,GLBH 20,A00,889149,Elwardani; Nile Regina,8,0,42,34
1746600887361,GLBH 111,A01,889152,Burgos; Jose L.,17,0,17,0
1746600888387,GLBH 150,A00,889181,Sloane; Julia Kathryn,0,5,15,15
1746600890437,HDS 60,A01,886406,Warstadt; Melissa Fawn,72,0,80,8
1746600891461,HIAF 111,A00,889324,Gyamfi; Bright,25,0,32,7
1746600892491,HIEA 131,A00,889328,Staff,15,0,32,17
1746600893517,HIEA 144,A00,889333,Henry; Todd A.,26,0,32,6
1746600894541,HIEA 154,A00,889336,Henry; Todd A.,24,0,32,8
1746600895571,HIEU 106,A00,889339,Staff,22,0,32,10
1746600897624,HIEU 114,A00,889340,Staff,4,0,32,28
1746600898651,HIEU 135GS,A00,889342,Patterson; Patrick H.,0,0,1,24
1746600899680,HIEU 137,A00,889343,Edington; Claire Ellen,10,0,25,15
1746600900707,HIEU 148,A00,889345,Staff,14,0,32,18
1746600901734,HIEU 154,A00,889346,Biess; Frank Peter,21,0,32,11
1746600902759,HILA 102,A00,889351,Staff,12,0,32,20
1746600903787,HILD 2A,A01,889221,Lewandoski; Julia Mavis,0,8,32,32
1746600904817,HILD 7B,A01,889225,Man; Simeon S,0,12,32,32
1746600905847,HILD 7C,A01,889288,Alvarez; Luis A,0,14,32,32
1746600906873,HILD 30,A01,889323,Staff,0,5,32,32
1746600908936,HISC 119,A00,889383,Golan; Tal,20,0,32,12
1746600909963,HIUS 103,A00,889384,Man; Simeon S,0,0,32,32
1746600910988,HIUS 117,A00,919797,Kwak; Nancy,18,0,32,14
1746600912015,HIUS 142A,A00,919788,Staff,22,0,32,10
1746600914070,HIUS 149,A00,889386,Gyamfi; Bright,26,0,32,6
1746600915096,HIUS 155,A00,889387,Alvarez; Luis A,15,0,32,17
1746600916123,HUM 3,A01,886499,Caldwell; Michael Alan,19,0,50,31
1746600917152,HUM 3GS,A00,886500,Rodriguez; Bretton Sigfred,0,0,0,28
1746600918179,HUM 3R,A01,886502,Markman; Kristina,0,36,50,50
1746600919206,HUM 4,A01,886504,Crum; Matthew Stephen,23,0,50,27
1746600919206,HUM 4,B01,886506,West; Geoffrey Scott,17,0,50,33
1746600920232,HUM 4GS,A00,886507,Staff,0,0,0,19
1746600921260,HUM 5,A01,886509,Staff,31,0,50,19
1746600922286,HUM 5R,A01,886511,Zavodny; Tatiana Sophia,0,39,50,50
1746600923314,JAPN 180,A00,886407,Staff,16,0,40,24
1746600924345,LATI 50,A01,886409,Martin-Cabrera; Luis,3,0,22,19
1746600924345,LATI 50,A02,886410,Martin-Cabrera; Luis,19,0,22,3
1746600924345,LATI 50,A03,886411,Martin-Cabrera; Luis,21,0,22,1
1746600924345,LATI 50,A04,886412,Martin-Cabrera; Luis,8,0,22,14
1746600925376,LAWS 101,A00,907664,Staff,28,0,60,32
1746600926403,LIAB 1A,A00,889388,Saab; Dima,17,0,20,3
1746600927429,LIAB 1AX,A00,889389,El Cheddadi; Youniss,18,0,20,2
1746600928456,LIFR 1C,A00,889391,Van Moer; Vinciane G,8,0,20,12
1746600929482,LIFR 1CX,A00,889392,Van Moer; Vinciane G,7,0,20,13
1746600930507,LIFR 1D,A00,889393,Van Moer; Vinciane G,7,0,20,13
1746600931535,LIFR 1DX,A00,889394,Van Moer; Vinciane G,8,0,20,12
1746600932564,LIGN 7,A00,886923,Staff,25,0,50,25
1746600933594,LIGN 17,A00,886924,Kehler; Andrew Scott,126,0,150,24
1746600934623,LTAM 110,A00,889395,Staff,15,0,30,15
1746600935653,LTAM 110GS,A00,958010,Rodriguez; Bretton Sigfred,0,0,0,28
1746600936889,LTCH 101,A00,889397,Staff,23,0,25,2
1746600937919,LTCS 130,A00,889398,Staff,23,0,25,2
1746600938948,LTEA 138,A00,889399,Staff,24,0,40,16
1746600939975,LTEN 149,A00,889400,Wesling; Megan E.,0,3,25,25
1746600941001,LTEN 169,A00,889401,Staff,20,0,25,5
1746600942031,LTEN 180,A00,889402,Staff,10,0,15,5
1746600943060,LTEN 181,A00,889403,Staff,21,0,25,4
1746600944089,LTWL 100,A00,889404,Myerston Santana; Jacobo,2,0,25,23
1746600945121,LTWL 180GS,A00,889405,Staff,0,0,20,20
1746600946149,LTWL 181,A00,889406,Staff,16,0,25,9
1746600947173,LTWL 184,A00,889475,Mukherjee; Silpa,22,0,25,3
1746600948200,LTWR 102C,A00,889486,Staff,29,0,30,1
1746600949230,LTWR 115W,A00,889491,Staff,0,2,15,15
1746600950254,MAE 8,A01,886905,Staff,0,2,0,0
1746600951285,MAE 11,A00,886906,Bandaru; Prabhakar,0,7,50,50
1746600952312,MAE 20,A00,886907,Evdokimenko; Ekaterina,43,0,70,27
1746600953356,MAE 30B,A00,886909,Ghazinejad; Maziar,25,0,45,20
1746600954383,MAE 101B,A00,886910,Saintillan; David,30,0,45,15
1746600955408,MAE 105,A00,886911,Bandaru; Prabhakar,18,0,50,32
1746600956436,MAE 107,B00,958024,Staff,7,0,50,43
1746600957464,MAE 143B,A00,886913,Bewley; Thomas R,2,0,40,38
1746600958487,MAE 148,A01,886915,Silberman; Jack,0,3,14,14
1746600959511,MAE 160,A00,886916,Evdokimenko; Ekaterina,30,0,60,30
1746600960540,MATH 3C,A01,889681,Staff,0,2,30,30
1746600960540,MATH 3C,A02,960048,Staff,23,0,30,7
1746600961566,MATH 10A,A01,889760,Staff,26,0,30,4
1746600961566,MATH 10A,A02,889783,Staff,29,0,30,1
1746600962594,MATH 10B,A01,889785,Verstraete; Jacques Allan,1,0,35,34
1746600962594,MATH 10B,A02,889795,Verstraete; Jacques Allan,4,0,35,31
1746600962594,MATH 10B,B01,889797,Verstraete; Jacques Allan,3,0,35,32
1746600962594,MATH 10B,B02,889828,Verstraete; Jacques Allan,3,0,35,32
1746600963619,MATH 10C,A01,889849,Habib; Yousaf,8,0,30,22
1746600963619,MATH 10C,A02,889852,Habib; Yousaf,14,0,30,16
1746600963619,MATH 10C,A03,889853,Habib; Yousaf,22,0,30,8
1746600963619,MATH 10C,A04,889858,Habib; Yousaf,20,0,30,10
1746600963619,MATH 10C,B01,889861,Staff,1,0,30,29
1746600963619,MATH 10C,B02,889862,Staff,24,0,30,6
1746600963619,MATH 10C,B03,889863,Staff,27,0,30,3
1746600963619,MATH 10C,B04,889967,Staff,23,0,30,7
1746600964647,MATH 18,A01,889974,Staff,7,0,30,23
1746600964647,MATH 18,A02,889977,Staff,20,0,30,10
1746600964647,MATH 18,B01,889984,Hardiman; Liam,20,0,30,10
1746600964647,MATH 18,B02,889985,Hardiman; Liam,25,0,30,5
1746600965676,MATH 20A,A01,889990,Suk; Andrew Hoon,30,0,35,5
1746600966707,MATH 20B,A01,889993,Ohm; Ko Woon,21,0,30,9
1746600966707,MATH 20B,A02,889994,Ohm; Ko Woon,30,0,30,0
1746600966707,MATH 20B,B01,889996,Ohm; Ko Woon,22,0,30,8
1746600966707,MATH 20B,B02,889997,Ohm; Ko Woon,23,0,30,7
1746600967732,MATH 20C,A01,889999,Hammock; Frances H,17,0,30,13
1746600967732,MATH 20C,A02,890003,Hammock; Frances H,23,0,30,7
1746600967732,MATH 20C,B01,890006,Hammock; Frances H,2,0,30,28
1746600967732,MATH 20C,B02,890007,Hammock; Frances H,12,0,30,18
1746600968759,MATH 20D,A01,890011,Cheng; Hsiao-Bing,1,0,30,29
1746600968759,MATH 20D,A02,890012,Cheng; Hsiao-Bing,14,0,30,16
1746600968759,MATH 20D,B01,890016,Cheng; Hsiao-Bing,13,0,30,17
1746600968759,MATH 20D,B02,890017,Cheng; Hsiao-Bing,13,0,30,17
1746600969787,MATH 20E,A01,890026,Harel; Guershon,1,0,30,29
1746600969787,MATH 20E,A02,890029,Harel; Guershon,22,0,30,8
1746600969787,MATH 20E,B01,890033,Harel; Guershon,7,0,30,23
1746600969787,MATH 20E,B02,890101,Harel; Guershon,21,0,30,9
1746600970816,MATH 102,A01,890104,Staff,18,0,30,12
1746600970816,MATH 102,A02,890105,Staff,27,0,30,3
1746600971847,MATH 103B,A01,890116,Salehi Golsefidy; Alireza,3,0,30,27
1746600971847,MATH 103B,B01,890118,Staff,0,3,34,34
1746600972877,MATH 109,A01,890121,Aliabadi Sr.; Mohsen,0,0,30,30
1746600972877,MATH 109,B01,890124,Upadrashta; Pranav Kumar,18,0,30,12
1746600973905,MATH 120A,A01,890126,Eggers; John Dietrich,13,0,30,17
1746600974933,MATH 142B,A01,890128,Ioana; Adrian,19,0,30,11
1746600974933,MATH 142B,A02,890129,Ioana; Adrian,12,0,30,18
1746600975959,MATH 154,A01,890174,Staff,0,1,30,30
1746600975959,MATH 154,A02,890182,Staff,0,0,30,30
1746600976984,MATH 168A,A01,890197,Dumitriu; Ioana,21,0,35,14
1746600978012,MATH 170A,A01,890240,Nie; Jiawang,1,0,30,29
1746600978012,MATH 170A,A02,890241,Nie; Jiawang,11,0,30,19
1746600978012,MATH 170A,A03,890249,Nie; Jiawang,23,0,30,7
1746600979038,MATH 170B,A01,957891,Nag; Panchali,13,0,35,22
1746600981095,MATH 181A,A01,908025,Staff,0,3,35,35
1746600981095,MATH 181A,A02,960115,Staff,26,0,35,9
1746600982122,MATH 181B,A01,959874,Staff,24,0,30,6
1746600983152,MATH 193B,A01,890265,Staff,0,4,35,35
1746600984219,MGT 4,A01,890311,Anderson; John Charles,42,0,88,46
1746600985245,MGT 5,A00,907740,Staff,12,0,98,86
1746600986276,MGT 12,A00,890312,Lindenberger; Wade Douglas,67,0,98,31
1746600987301,MGT 16,A00,957883,Staff,78,0,98,20
1746600989357,MGT 45,A00,890314,Pecore; Joseph P.,45,0,98,53
1746600990381,MGT 71,A00,890315,Staff,0,12,98,98
1746600991411,MGT 100,A00,890316,Yavorsky; Daniel Ryan,44,0,98,54
1746600992439,MGT 103,A00,890317,Ehrich; Kristine R,73,0,98,25
1746600993465,MGT 105,A00,890356,Bates; Kenneth Walter,0,8,98,98
1746600994491,MGT 112,A00,890360,Ehrich; Kristine R,55,0,98,43
1746600995521,MGT 127R,A00,907732,Zhu; Kevin Xiaoguo,23,0,98,75
1746600996549,MGT 131B,A00,890361,Anderson; John Charles,59,0,98,39
1746600997578,MGT 137,A00,890362,Lindenberger; Wade Douglas,65,0,98,33
1746600998605,MGT 160,A00,890369,Johnson; Erik Barry,9,0,98,89
1746601000653,MGT 164,A00,890372,Zimmermann; Carsten,0,40,98,98
1746601001678,MGT 180,A00,890374,Bliss; Barbara Ann,11,0,98,87
1746601002708,MMW 15,A01,886414,Chang; Edmond Yi-Teh,0,12,28,28
1746601002708,MMW 15,A02,886415,Chang; Edmond Yi-Teh,0,8,28,28
1746601002708,MMW 15,A03,886416,Chang; Edmond Yi-Teh,0,9,28,28
1746601002708,MMW 15,A04,886417,Chang; Edmond Yi-Teh,0,8,28,28
1746601002708,MMW 15,B01,886419,Chang; Edmond Yi-Teh,0,7,28,28
1746601002708,MMW 15,B02,886420,Chang; Edmond Yi-Teh,0,7,28,28
1746601002708,MMW 15,B03,886421,Chang; Edmond Yi-Teh,0,7,28,28
1746601002708,MMW 15,B04,886422,Chang; Edmond Yi-Teh,0,8,28,28
1746601002708,MMW 15,C01,886424,Staff,0,9,28,28
1746601002708,MMW 15,C02,886425,Staff,0,8,28,28
1746601002708,MMW 15,C03,886426,Staff,0,8,28,28
1746601002708,MMW 15,C04,886427,Staff,0,8,28,28
1746601002708,MMW 15,C05,958038,Staff,0,8,28,28
1746601002708,MMW 15,C06,958039,Staff,0,7,28,28
1746601003734,MMW 15GS,A00,906910,Patterson; Patrick H.,4,0,28,24
1746601004760,MMW 122R,A01,886429,Rahimi; Babak,0,13,28,28
1746601004760,MMW 122R,A02,886430,Rahimi; Babak,0,12,28,28
1746601004760,MMW 122R,A03,958040,Rahimi; Babak,0,11,28,28
1746601005787,MUS 1A,A01,890937,Staff,2,0,25,23
1746601005787,MUS 1A,A02,891035,Staff,6,0,25,19
1746601005787,MUS 1A,C01,958912,Staff,24,0,25,1
1746601005787,MUS 1A,C02,958913,Staff,25,0,25,0
1746601007843,MUS 2AK,A00,957092,Ohnishi; Takae,15,0,15,0
1746601008876,MUS 4,A01,891044,Staff,0,0,25,25
1746601008876,MUS 4,A02,891045,Staff,22,0,25,3
1746601008876,MUS 4,B01,891048,Staff,17,0,25,8
1746601008876,MUS 4,B02,891050,Staff,25,0,25,0
1746601009904,MUS 5,A01,957506,Dubnov; Shlomo,0,0,25,25
1746601009904,MUS 5,A02,957622,Dubnov; Shlomo,13,0,25,12
1746601009904,MUS 5,A03,957623,Dubnov; Shlomo,20,0,25,5
1746601010933,MUS 6,A01,891053,Freitas Caetano; Marcelo,24,0,25,1
1746601010933,MUS 6,A02,891054,Freitas Caetano; Marcelo,23,0,25,2
1746601011964,MUS 7,A01,891081,Staff,0,0,25,25
1746601011964,MUS 7,A02,891082,Staff,3,0,25,22
1746601012993,MUS 8GS,A00,891118,Borgo; David Garcia,1,0,25,24
1746601014023,MUS 11,A01,891140,Staff,8,0,25,17
1746601014023,MUS 11,A02,891141,Staff,21,0,25,4
1746601015048,MUS 13,A01,891143,Staff,8,0,25,17
1746601015048,MUS 13,A02,891144,Staff,24,0,25,1
1746601016074,MUS 15,A01,891146,Staff,9,0,25,16
1746601016074,MUS 15,A02,891148,Staff,21,0,25,4
1746601016074,MUS 15,B01,891150,Staff,18,0,25,7
1746601016074,MUS 15,B02,891151,Staff,25,0,25,0
1746601017102,MUS 20,A01,891153,Staff,5,0,20,15
1746601017102,MUS 20,A02,891155,Staff,14,0,20,6
1746601018128,MUS 80,A00,891156,Staff,19,0,25,6
1746601018128,MUS 80,B00,891157,Staff,23,0,25,2
1746601019153,MUS 130,A00,891158,Ohnishi; Takae,35,0,35,0
1746601020178,MUS 150GS,A01,891160,Borgo; David Garcia,1,0,25,24
1746601021208,MUS 170,A01,891162,Freitas Caetano; Marcelo,20,0,25,5
1746601021208,MUS 170,A02,891164,Freitas Caetano; Marcelo,21,0,25,4
1746601022233,NANO 11,A00,886220,Vazquez Mena; Oscar,13,0,15,2
1746601023258,NANO 15,A01,886222,Drews; Aaron,4,0,7,3
1746601024283,NANO 104,A00,886224,Sirbuly; Donald,17,0,25,8
1746601025311,PH 40,A00,886528,Staff,23,0,40,17
1746601026339,PH 45,A01,886799,Staff,35,0,40,5
1746601027365,PH 110,A00,886802,Staff,0,6,40,40
1746601028392,PH 172,A00,906716,Staff,19,0,35,16
1746601029420,PH 191,A00,886803,Staff,6,0,40,34
1746601030444,PHIL 1,A00,889500,Staff,20,0,30,10
1746601031469,PHIL 10,A01,889549,Grush; Rick Scott,16,0,22,6
1746601031469,PHIL 10,A02,889551,Grush; Rick Scott,22,0,22,0
1746601032495,PHIL 28,A01,889559,Lamey; Andy M.,0,2,31,31
1746601032495,PHIL 28,A02,889561,Lamey; Andy M.,0,1,30,30
1746601032495,PHIL 28,A03,889572,Lamey; Andy M.,0,1,30,30
1746601033522,PHIL 35,A00,907839,Staff,13,0,15,2
1746601034548,PHIL 60,A00,889574,Staff,73,0,90,17
1746601035573,PHIL 101,A00,958004,Staff,12,0,15,3
1746601037628,PHIL 136,A00,889582,Fulkerson; Matthew Todd,26,0,45,19
1746601038654,PHIL 163,A01,889601,Staff,21,0,30,9
1746601038654,PHIL 163,B01,889606,Brandt; Reuven A,0,3,0,0
1746601039679,PHIL 164,A00,889610,Staff,16,0,30,14
1746601040706,PHIL 165,A00,889613,Staff,22,0,30,8
1746601041730,PHYS 1A,A00,886431,Staff,30,0,70,40
1746601042756,PHYS 1AL,001,886432,Tsai; Philbert S,0,1,30,30
1746601042756,PHYS 1AL,002,886436,Tsai; Philbert S,13,0,30,17
1746601043783,PHYS 1B,A00,886439,Staff,184,0,240,56
1746601044810,PHYS 1BL,001,886441,Tsai; Philbert S,0,4,30,30
1746601044810,PHYS 1BL,002,886444,Tsai; Philbert S,2,0,30,28
1746601045835,PHYS 1C,A00,896092,Arnold; Kam S,78,0,146,68
1746601046860,PHYS 1CL,001,886448,Tsai; Philbert S,0,0,30,30
1746601046860,PHYS 1CL,002,886449,Tsai; Philbert S,1,0,30,29
1746601046860,PHYS 1CL,003,886450,Tsai; Philbert S,16,0,30,14
1746601046860,PHYS 1CL,004,886451,Tsai; Philbert S,15,0,30,15
1746601047886,PHYS 2B,A01,886457,Staff,67,0,115,48
1746601048912,PHYS 2C,A01,886460,Shotwell; Brian,0,9,65,65
1746601049938,PHYS 2CL,A01,886467,Staff,0,4,28,28
1746601049938,PHYS 2CL,A02,886468,Staff,0,3,28,28
1746601050968,PHYS 2D,A01,886470,Staff,10,0,50,40
1746601051994,PHYS 4B,A01,886475,Grinstein; Benjamin,22,0,40,18
1746601053023,POLI 5,A00,891173,Desposato; Scott,7,0,25,18
1746601054049,POLI 5D,A01,891175,Staff,5,0,5,0
1746601054049,POLI 5D,B01,891178,Staff,5,0,5,0
1746601055075,POLI 11,A00,891179,Ferree; Karen E,0,0,35,35
1746601056100,POLI 12,A00,891180,Staff,15,0,30,15
1746601057129,POLI 27,A01,891182,Staff,11,0,75,64
1746601058157,POLI 30,A00,891183,Staff,8,0,50,42
1746601059183,POLI 100B,A00,891244,Staff,5,1,35,30
1746601060212,POLI 100I,A00,891247,Staff,7,0,30,23
1746601061238,POLI 104J,A00,891248,Nichter; Maysa,14,0,30,16
1746601062267,POLI 104U,A00,891250,Nichter; Maysa,1,0,30,29
1746601064315,POLI 110B,A00,891255,Wiens; David,19,0,25,6
1746601065341,POLI 112A,A00,891256,Wiens; David,6,0,25,19
1746601066367,POLI 114BR,A00,891261,Staff,19,0,30,11
1746601067392,POLI 117R,A00,891262,Forman; Fonna,0,6,50,50
1746601068418,POLI 118,A00,891264,Ingham; Sean,17,0,25,8
1746601069446,POLI 124A,A00,891265,Staff,18,0,20,2
1746601070471,POLI 125D,A00,891266,Nichter; Simeon C,2,0,25,23
1746601071499,POLI 126,A00,891268,Nichter; Simeon C,7,0,25,18
1746601072527,POLI 126AA,A00,891272,Staff,15,0,25,10
1746601073554,POLI 130AA,A00,891273,Staff,15,0,20,5
1746601074579,POLI 134AA,A00,891274,Staff,4,0,20,16
1746601076634,POLI 138,A00,891278,Staff,21,0,25,4
1746601077660,POLI 142K,A00,891280,Staff,10,0,25,15
1746601078686,POLI 142M,A00,891281,Gartzke; Erik,16,0,30,14
1746601079712,POLI 142P,A00,891284,Staff,20,0,30,10
1746601080737,POLI 143,A00,891285,Gartzke; Erik,12,0,30,18
1746601081763,POLI 153,A00,891286,Staff,19,0,20,1
1746601083812,POLI 175,A00,891290,Staff,15,0,20,5
1746601084840,PSYC 1,A00,890674,Steiner; Eric Tomas,0,11,45,45
1746601085867,PSYC 2,A00,890676,Albright; Thomas D,20,0,35,15
1746601086891,PSYC 3,A00,890679,Staff,17,0,20,3
1746601087972,PSYC 6,A00,959858,Staff,19,0,20,1
1746601088999,PSYC 60,A01,890684,Rickard; Timothy C.,0,6,45,45
1746601090028,PSYC 70,A01,890689,Geller; Emma Harlan,6,0,30,24
1746601091056,PSYC 71,A01,959860,Staff,21,0,25,4
1746601092084,PSYC 100,A00,890690,Lacefield; Katharine I,0,50,180,180
1746601093113,PSYC 102,A00,890695,Staff,18,0,40,22
1746601094143,PSYC 105,A00,890699,Geller; Emma Harlan,70,0,100,30
1746601095170,PSYC 106,A00,890701,Gorman; Michael R.,5,0,30,25
1746601096197,PSYC 108,A00,890704,Adrian; Julia Anna,0,29,50,50
1746601097223,PSYC 118,A01,890712,Staff,11,0,30,19
1746601098251,PSYC 124,A00,890716,Chapman; Eddie Nathaniel,25,0,60,35
1746601099276,PSYC 131,A00,890717,Anagnostaras; Stephan,0,7,80,80
1746601100303,PSYC 137,A00,890719,Winkielman; Piotr,0,11,30,30
1746601101329,PSYC 144,A00,890721,Adrian; Julia Anna,0,9,45,45
1746601102357,PSYC 162,A00,890805,Staff,0,1,75,75
1746601103382,PSYC 169,A00,890810,Staff,0,15,30,30
1746601104407,PSYC 172,A00,890814,Gorman; Michael R.,9,0,30,21
1746601105436,PSYC 181,A00,890818,Anagnostaras; Stephan,7,0,200,193
1746601106461,PSYC 184,A00,959861,Staff,162,0,175,13
1746601107488,PSYC 189,A00,890823,Staff,0,2,30,30
1746601108516,PSYC 191,A00,890884,Rickard; Timothy C.,0,11,35,35
1746601109543,PSYC 193,A00,890913,Staff,19,0,30,11
1746601109543,PSYC 193,B00,890914,Chapman; Eddie Nathaniel,24,0,30,6
1746601110571,PSYC 193L,A01,890918,Lowe; Angela Beth,20,0,30,10
1746601110571,PSYC 193L,B01,890921,Hurwitz; Ethan Scott,20,0,30,10
1746601110571,PSYC 193L,C01,890928,Staff,30,0,30,0
1746601111596,RELI 149,A00,886806,Rahimi; Babak,23,0,40,17
1746601112624,SE 9,A01,886814,Staff,7,0,20,13
1746601113653,SE 101B,A01,886816,Chadha; Mayank,3,0,35,32
1746601114681,SE 110B,A00,886818,Zhu; Qiang,4,0,75,71
1746601115709,SE 125,A01,886830,Staff,10,0,30,20
1746601116738,SE 130B,A01,886835,Staff,14,0,40,26
1746601117764,SE 131A,A01,886838,Krysl; Petr,34,0,55,21
1746601118794,SE 154,A00,886840,Staff,28,0,50,22
1746601119818,SE 164GS,A01,886849,Staff,6,0,20,14
1746601120844,SE 167GS,A01,886853,Staff,6,0,20,14
1746601121869,SIO 25,A01,890107,Staff,19,0,30,11
1746601122898,SIO 45,A00,890109,Cook; Geoffrey W,115,0,200,85
1746601123924,SIO 109R,A00,890110,Forman; Fonna,0,16,20,20
1746601124949,SIO 187,A01,890114,Kacev; David,15,0,40,25
1746601125975,SOCI 1,A01,890431,Thorpe; Charles Robert,14,0,30,16
1746601125975,SOCI 1,A02,890518,Thorpe; Charles Robert,30,0,30,0
1746601127002,SOCI 2,A01,957978,Staff,25,0,25,0
1746601127002,SOCI 2,A02,957979,Staff,23,0,25,2
1746601128031,SOCI 20,A01,890523,Calderon-Zaks; Michael Aar,21,0,30,9
1746601128031,SOCI 20,A02,890526,Calderon-Zaks; Michael Aar,29,0,30,1
1746601129057,SOCI 30,A01,890533,Pardo Guerra; Juan Pablo,37,0,40,3
1746601130087,SOCI 40,A01,890535,Staff,27,0,45,18
1746601131115,SOCI 104Q,A00,890559,Staff,18,0,30,12
1746601132139,SOCI 106,A00,890560,Arnal; Maud Marie Leonie,20,0,30,10
1746601133165,SOCI 110,A00,890567,Holkenbrink-Monk; Charlene,19,0,30,11
1746601134190,SOCI 112,A00,890568,Victoria Torres; Pablo,2,0,55,53
1746601135214,SOCI 115,A00,890597,Arnal; Maud Marie Leonie,28,0,45,17
1746601137264,SOCI 121,A00,890604,Pardo Guerra; Juan Pablo,38,0,45,7
1746601138290,SOCI 126,A01,890608,Staff,8,0,10,2
1746601139315,SOCI 127,A00,890609,Staff,18,0,30,12
1746601140344,SOCI 131,A00,890610,Thorpe; Charles Robert,37,0,45,8
1746601141369,SOCI 135,A00,890615,Payne; Christine Anna,14,0,45,31
1746601142394,SOCI 139,A00,890620,Staff,38,0,45,7
1746601143421,SOCI 148E,A00,890622,Calderon-Zaks; Michael Aar,36,0,45,9
1746601144446,SOCI 150,A00,890623,Kohler; Kristopher M.,31,0,45,14
1746601145474,SOCI 157,A00,890625,Jules-Rosette; Bennetta W.,18,0,20,2
1746601146502,SOCI 160,A00,890627,Payne; Christine Anna,21,0,45,24
1746601147542,SYN 1,A00,886855,Fish; Gwendolyn Anne,0,1,0,0
1746601147542,SYN 1,B00,906086,Fish; Gwendolyn Anne,0,2,0,2
1746601148567,SYN 2R,A00,886860,Staff,0,17,15,15
1746601148567,SYN 2R,B00,906106,Atkinson; Arthur Laird,0,16,15,15
1746601149592,SYN 100,A01,886866,Browne; Emily,0,28,20,20
1746601149592,SYN 100,B01,906128,Rock; Martin,0,4,20,20
1746601149592,SYN 100,C01,906140,Deavenport; James Cary,0,4,20,20
1746601149592,SYN 100,D01,907816,Deavenport; James Cary,0,5,20,20
1746601150621,TDAC 1,A00,890286,Walsh; Kim C.,7,0,20,13
1746601151646,TDAC 101,A00,890296,Basso; Beatrice,15,0,20,5
1746601152673,TDDE 131,A00,890297,Staff,47,0,50,3
1746601153699,TDDM 1,A00,890287,Weinberg; Sadie,25,0,30,5
1746601154727,TDGE 11,A00,890288,Fulton; Julia,138,0,200,62
1746601154727,TDGE 11,B00,890289,Castro; Robert Jess,184,0,200,16
1746601155756,TDGE 25,B00,957359,Walsh; Kim C.,5,0,20,15
1746601156781,TDGE 40,A01,890292,Power; Jade Yukana,26,0,30,4
1746601157805,TDGE 124,A00,890298,Havis; Allan,0,2,50,50
1746601158833,TDGE 131R,A00,890299,Burelle; Julie Sara Veronique,15,0,42,27
1746601159858,TDHT 101,A00,890300,Staff,10,0,20,10
1746601160883,TDHT 109,A01,890302,Anderson; Mysia Anyse,31,0,40,9
1746601161906,TDMV 1,A00,890293,Arcidiacono; Kristin,18,0,30,12
1746601162933,TDMV 2,A00,890294,Weinberg; Sadie,23,0,30,7
1746601163961,TDMV 3,A00,957878,Arcidiacono; Kristin,28,0,30,2
1746601166014,TDMV 138,A00,890304,Jun; Grace Shin Hae,25,0,40,15
1746601167038,TDMV 140,A00,890305,Corrales; Joseph Bernales,25,0,30,5
1746601168065,TDMV 142,A00,890307,Caligagan; Tony,32,0,40,8
1746601169090,TDMV 144,A00,890308,Camaya; Michelle Ann,25,0,30,5
1746601170115,TDPW 1,A00,890295,Stein; Deborah Isobel,3,0,20,17
1746601171145,USP 2,A01,890272,Lerner; Amy M,7,0,20,13
1746601172171,USP 3,A01,890274,Staff,12,0,30,18
1746601173199,USP 15,A01,890276,Sun; Feiyang,16,0,30,14
1746601174226,USP 25,A00,890277,Shenkman; Michael Thomas,18,0,25,7
1746601175251,USP 138,A00,890278,Staff,13,0,25,12
1746601176277,USP 143,A00,890279,Staff,21,0,70,49
1746601177305,USP 144,A00,890280,Chowdhury; Muhammed Zohir,16,0,30,14
1746601178330,USP 150,A00,890281,Boomhower; Matthew Charles,4,0,30,26
1746601179355,USP 151,A00,890282,Staff,16,0,20,4
1746601180382,USP 162,A00,890283,Andrews; Abigail Leslie,16,0,20,4
1746601181409,USP 168,A00,920477,Kwak; Nancy,0,0,5,5
1746601182435,USP 181,A00,890284,Staff,3,0,20,17
1746601183460,USP 191A,A00,890285,Staff,12,0,20,8
1746601184487,VIS 101,A00,886512,Staff,26,0,75,49
1746601185512,VIS 103,A00,886513,Cruz; Edwin Teddy,61,0,75,14
1746601186537,VIS 108,A00,886514,Staff,4,0,15,11
1746601187564,VIS 127P,A00,886515,Shen; Kuiyi,80,0,146,66
1746601188589,VIS 149,A00,886516,Yoldas; Pinar,0,0,15,15
1746601189616,VIS 164,A00,886526,Erdmann; Dean,19,0,22,3
1746601190640,VIS 194S,A00,886527,Staff,61,0,75,14
1746601191708,WCWP 10A,C00,886484,Martiniuk; Jill,12,0,15,3
1746601192735,WCWP 10B,A00,886490,Uriarte; Emma,0,0,15,15
1746601192735,WCWP 10B,B00,886491,Dhir; Simrita,8,0,15,7
1746601192735,WCWP 10B,C00,886492,Ornelas; Tricia,0,0,15,15
1746601193760,WCWP 100,A00,886494,Young; Mark T,0,6,15,15
1746601195838,AAS 10,A01,886199,Childs; Dennis R.,0,3,0,0
1746601196863,ANAR 104,A01,886940,Shtienberg; Gilad,27,0,30,3
1746601197891,ANAR 120,A00,886953,Staff,13,0,20,7
1746601198918,ANBI 148,A01,886955,Wilder; Linnea Lorene,30,0,40,10
1746601200968,ANSC 122,A00,886957,Staff,24,0,30,6
1746601201997,ANSC 150,A00,886958,Sloane; Julia Kathryn,2,0,15,13
1746601203027,ANSC 156,A00,886959,Jenkins; Janis A.,0,1,15,15
1746601204057,ANSC 180,A00,886960,Staff,11,0,17,6
1746601205084,ANSC 188,A00,886961,Jassal; Aftab,9,0,25,16
1746601206112,ANSC 190,A00,886962,Jassal; Aftab,14,0,25,11
1746601207137,ANSC 191,A00,886963,Staff,18,0,20,2
1746601208167,ANTH 3,A01,891689,Staff,17,0,20,3
1746601209194,ANTH 5,A00,886933,Semendeferi; Ekaterini,16,0,20,4
1746601210224,ANTH 10,A00,886934,Staff,0,12,30,30
1746601211249,ANTH 21,A01,886936,Staff,41,0,60,19
1746601212278,ANTH 23,A01,886938,Staff,92,0,100,8
1746601213308,ANTH 105,A00,886964,Stewart; Alexander B,84,0,100,16
1746601214336,ANTH 108,A00,886965,Pedersen; David,9,0,20,11
1746601215363,AWP 10,001,886147,Staff,0,0,0,0
1746601215363,AWP 10,002,886148,Staff,0,0,0,0
1746601215363,AWP 10,003,886149,Staff,0,0,0,0
1746601215363,AWP 10,004,886150,Staff,0,0,0,0
1746601215363,AWP 10,005,886151,Staff,0,0,0,0
1746601215363,AWP 10,006,886152,Staff,0,0,0,0
1746601215363,AWP 10,007,886153,Staff,0,0,0,0
1746601215363,AWP 10,008,886154,Staff,0,0,0,0
1746601215363,AWP 10,009,886155,Staff,0,0,0,0
1746601215363,AWP 10,010,886156,Staff,0,0,0,0
1746601215363,AWP 10,011,886158,Staff,0,0,0,0
1746601215363,AWP 10,012,886160,Staff,0,0,0,0
1746601215363,AWP 10,013,886161,Staff,0,0,0,0
1746601215363,AWP 10,014,886162,Staff,0,0,0,0
1746601215363,AWP 10,015,886163,Staff,0,0,0,0
1746601215363,AWP 10,016,886164,Staff,0,0,0,0
1746601215363,AWP 10,017,886165,Staff,0,0,0,0
1746601215363,AWP 10,018,886166,Staff,0,0,0,0
1746601215363,AWP 10,019,886168,Staff,0,0,0,0
1746601215363,AWP 10,020,886170,Staff,0,0,0,0
1746601215363,AWP 10,021,886172,Staff,0,0,0,0
1746601216402,AWP 10R,001,886173,Staff,0,1,0,0
1746601216402,AWP 10R,002,886174,Staff,0,1,0,0
1746601216402,AWP 10R,003,886175,Staff,0,0,0,0
1746601216402,AWP 10R,004,886176,Staff,0,0,0,0
1746601216402,AWP 10R,005,886177,Staff,0,0,0,0
1746601216402,AWP 10R,006,886178,Staff,0,0,0,0
1746601216402,AWP 10R,007,886179,Staff,0,0,0,0
1746601216402,AWP 10R,008,886181,Staff,0,0,0,0
1746601216402,AWP 10R,009,886182,Staff,0,0,0,0
1746601216402,AWP 10R,010,886183,Staff,0,0,0,0
1746601216402,AWP 10R,011,886184,Staff,0,0,0,0
1746601216402,AWP 10R,012,886185,Staff,0,0,0,0
1746601216402,AWP 10R,013,886186,Staff,0,0,0,0
1746601216402,AWP 10R,014,886187,Staff,0,0,0,0
1746601216402,AWP 10R,015,886188,Staff,0,0,0,0
1746601216402,AWP 10R,016,886189,Staff,0,0,0,0
1746601216402,AWP 10R,017,960532,Staff,0,0,0,0
1746601216402,AWP 10R,018,960533,Staff,0,0,0,0
1746601216402,AWP 10R,019,960534,Staff,0,0,0,0
1746601216402,AWP 10R,020,960538,Staff,0,0,0,0
1746601216402,AWP 10R,021,960540,Staff,0,0,0,0
1746601216402,AWP 10R,022,960541,Staff,0,0,0,0
1746601216402,AWP 10R,023,960542,Staff,0,0,0,0
1746601216402,AWP 10R,024,960544,Staff,0,0,0,0
1746601216402,AWP 10R,025,960545,Staff,0,0,0,0
1746601216402,AWP 10R,026,960548,Staff,0,0,0,0
1746601217430,AWP 102R,A00,886190,Staff,0,0,0,0
1746601217430,AWP 102R,B00,886191,Staff,0,0,0,0
1746601218456,BENG 100,A01,886193,Staff,17,0,30,13
1746601219484,BENG 122A,A01,886195,Hasty; Jeff M,13,0,30,17
1746601220513,BENG 166A,A00,886196,Sah; Robert Lie-Yuan,0,3,30,30
1746601221540,BENG 190,A00,958050,Khojah; Reem I,17,0,25,8
1746601222570,BIBC 102,A01,894320,Staff,0,1,46,46
1746601222570,BIBC 102,A02,894321,Staff,0,0,46,46
1746601222570,BIBC 102,A03,894344,Staff,6,0,46,40
1746601222570,BIBC 102,A04,894345,Staff,27,0,47,20
1746601223600,BICD 100R,A01,894365,Smith; Laurie,0,2,58,58
1746601223600,BICD 100R,A02,894366,Smith; Laurie,0,4,58,58
1746601223600,BICD 100R,A03,894367,Smith; Laurie,0,0,59,59
1746601223600,BICD 100R,A04,959869,Smith; Laurie,38,0,59,21
1746601224626,BICD 136,A01,894383,Gustafson-Brown; Cindy,14,0,50,36
1746601225659,BIEB 102,A01,894494,Butler; Shannon Rhey,51,0,130,79
1746601227714,BIEB 150,A01,894617,Wills; Christopher,3,0,20,17
1746601227714,BIEB 150,A02,894631,Wills; Christopher,3,0,20,17
1746601227714,BIEB 150,A03,894937,Wills; Christopher,3,0,20,17
1746601227714,BIEB 150,A04,894946,Wills; Christopher,5,0,20,15
1746601228743,BIEB 194,A00,906141,Kurle; Carolyn M.,5,0,20,15
1746601229769,BILD 1,A01,894154,Staff,3,0,19,16
1746601229769,BILD 1,A02,894155,Staff,14,0,19,5
1746601229769,BILD 1,A03,894160,Staff,13,0,19,6
1746601229769,BILD 1,A04,894161,Staff,15,0,18,3
1746601230793,BILD 2,A01,894168,Staff,0,0,50,50
1746601230793,BILD 2,A02,894169,Staff,0,0,50,50
1746601230793,BILD 2,A03,894179,Staff,0,0,50,50
1746601230793,BILD 2,A04,894203,Staff,22,0,50,28
1746601231819,BILD 3,A01,894213,Staff,23,0,31,8
1746601231819,BILD 3,A02,894214,Staff,26,0,31,5
1746601231819,BILD 3,A03,894235,Staff,28,0,31,3
1746601231819,BILD 3,A04,894236,Staff,28,0,32,4
1746601232849,BILD 4,A01,894253,Reuther; Keefe,5,0,24,19
1746601232849,BILD 4,A02,894258,Reuther; Keefe,16,0,24,8
1746601233876,BILD 5,A01,894276,Reuther; Keefe,34,0,50,16
1746601233876,BILD 5,A02,894277,Reuther; Keefe,45,0,50,5
1746601233876,BILD 5,A03,894290,Reuther; Keefe,44,0,50,6
1746601233876,BILD 5,A04,894291,Reuther; Keefe,48,0,50,2
1746601234901,BILD 24,A01,894297,Pirino; Giorgia,40,0,60,20
1746601235933,BIMM 100,B01,958915,Staff,71,0,100,29
1746601236961,BIMM 101,A01,895017,McDonnell; Lisa Marie,0,5,24,24
1746601236961,BIMM 101,A02,895018,McDonnell; Lisa Marie,0,5,24,24
1746601236961,BIMM 101,B01,895020,McDonnell; Lisa Marie,0,5,24,24
1746601236961,BIMM 101,B02,895021,McDonnell; Lisa Marie,0,4,24,24
1746601237985,BIMM 110,A01,895023,Staff,1,0,25,24
1746601237985,BIMM 110,A02,895024,Staff,9,0,25,16
1746601237985,BIMM 110,A03,895025,Staff,18,0,25,7
1746601237985,BIMM 110,A04,895031,Staff,20,0,25,5
1746601239016,BIMM 120,A01,895114,Gustafson-Brown; Cindy,14,0,28,14
1746601239016,BIMM 120,A02,895126,Gustafson-Brown; Cindy,21,0,27,6
1746601240043,BIPN 100,A01,895130,Yang; Mingyu,0,0,38,38
1746601240043,BIPN 100,A02,895131,Yang; Mingyu,31,0,38,7
1746601240043,BIPN 100,A03,895132,Yang; Mingyu,32,0,38,6
1746601240043,BIPN 100,A04,895133,Yang; Mingyu,27,0,36,9
1746601241071,BIPN 120,A01,895135,Cooke; James Edward,0,3,13,13
1746601241071,BIPN 120,A02,895136,Cooke; James Edward,0,1,13,13
1746601241071,BIPN 120,A03,895137,Cooke; James Edward,0,3,13,13
1746601241071,BIPN 120,A04,895156,Cooke; James Edward,0,2,11,11
1746601242101,BIPN 134,A01,895235,Cooke; James Edward,0,1,25,25
1746601242101,BIPN 134,A02,895237,Cooke; James Edward,0,0,25,25
1746601242101,BIPN 134,A03,895240,Cooke; James Edward,1,0,25,24
1746601242101,BIPN 134,A04,895270,Cooke; James Edward,20,0,25,5
1746601243129,BIPN 189,A00,892103,Staff,0,14,14,14
1746601245180,BISP 194,A00,958008,Staff,0,2,0,0
1746601246205,CAT 124,A01,922009,Staff,0,5,20,20
1746601247233,CAT 125R,A00,886390,Morales; Celeste Georgianna,0,3,20,20
1746601247233,CAT 125R,B00,886391,Irwin; Matthew Joseph,0,4,20,20
1746601247233,CAT 125R,C00,886392,Smith; Lauryn Alissa,0,2,20,20
1746601247233,CAT 125R,D00,886393,Vanderschuit; Maya Alysia,0,3,20,20
1746601247233,CAT 125R,E00,886394,Marchisotto; Jennifer Anne,0,3,20,20
1746601248258,CENG 15,A01,886218,Drews; Aaron,3,0,8,5
1746601249282,CENG 113,A00,886219,Opatkiewicz; Justin Paul,15,0,25,10
1746601250309,CGS 101,A00,887044,Staff,7,0,20,13
1746601251333,CGS 105,A01,887046,Staff,14,0,25,11
1746601252360,CGS 112,A00,887047,Cuong; Marisol,12,0,15,3
1746601253387,CGS 113,A00,887048,Staff,23,0,30,7
1746601254416,CGS 120,A00,887049,Staff,9,0,17,8
1746601255446,CHEM 6A,A01,886336,Lam; Tin Yiu,38,0,50,12
1746601255446,CHEM 6A,A02,886338,Lam; Tin Yiu,37,0,50,13
1746601256471,CHEM 6B,A01,886341,Hopkins; Patrycja Anna,16,0,50,34
1746601256471,CHEM 6B,A02,886343,Hopkins; Patrycja Anna,42,0,50,8
1746601257497,CHEM 6C,A01,886346,Albizati; Kim F.,0,2,50,50
1746601257497,CHEM 6C,A02,886348,Albizati; Kim F.,24,0,50,26
1746601258523,CHEM 40A,A01,886352,Klosterman; Jeremy K,65,0,100,35
1746601259615,CHEM 40B,A01,886356,Klosterman; Jeremy K,0,24,100,100
1746601260645,CHEM 41B,A01,886360,Theodorakis; Emmanuel,25,0,50,25
1746601260645,CHEM 41B,A02,886362,Theodorakis; Emmanuel,47,0,50,3
1746601261675,CHIN 165A,A00,886382,Xu; Li,18,0,20,2
1746601262726,CLAS 120,A00,886387,Myerston Santana; Jacobo,33,0,40,7
1746601263756,COGS 9,A01,886967,Shannon; Kyle Michael,42,0,60,18
1746601264791,COGS 11,A01,886969,Staff,9,0,30,21
1746601265818,COGS 14A,A01,886971,Staff,5,0,60,55
1746601266852,COGS 14B,A01,886973,Hoffman; Drew Ellen,4,0,60,56
1746601267884,COGS 18,A01,886975,Morgan; Eric,34,0,60,26
1746601268911,COGS 20,A01,886977,Staff,3,0,8,5
1746601268911,COGS 20,A02,886978,Staff,5,0,7,2
1746601269947,COGS 100,A01,907783,Staff,0,1,30,30
1746601270974,COGS 101B,A01,886980,Staff,0,4,48,48
1746601272005,COGS 101C,A01,886982,Delgado; Tania,0,5,44,44
1746601273031,COGS 102A,A01,886984,Johnson; Christine M.,3,0,30,27
1746601274061,COGS 118B,A01,886986,Staff,0,4,88,88
1746601275093,COGS 150,A01,886988,Bergen; Benjamin,22,0,50,28
1746601276120,COGS 153,A00,886989,Delgado; Tania,0,3,41,41
1746601277146,COGS 186,A01,886991,Staff,0,0,32,32
1746601278178,COGS 187A,A01,886993,Boyle; Mary E. T.,7,0,30,23
1746601279205,COGS 189,A00,886994,Staff,0,1,30,30
1746601280234,COMM 10,A01,886996,Staff,0,0,20,21
1746601280234,COMM 10,A02,886997,Staff,10,0,20,10
1746601280234,COMM 10,A03,959845,Staff,19,0,20,1
1746601281425,COMM 20,A01,886999,Leuning; Grant Maurstad,24,0,40,16
1746601283476,COMM 100A,A01,887002,Staff,0,0,20,25
1746601283476,COMM 100A,A02,887003,Staff,5,0,20,15
1746601284611,COMM 100B,A01,887005,Staff,0,8,20,24
1746601285637,COMM 106D,A00,887006,Staff,14,0,40,26
1746601286662,COMM 110G,A00,887007,Whitworth-Smith; Andrew C,12,0,40,28
1746601289272,COMM 111B,A00,887008,Staff,31,0,40,9
1746601290297,COMM 113T,A00,887009,Abuelhiga; Soraya Jill,28,0,40,12
1746601290297,COMM 113T,B00,906733,Staff,39,0,40,1
1746601291323,COMM 145,A00,887010,Staff,13,0,40,27
1746601292351,COMM 146,A00,887054,Staff,32,0,40,8
1746601293377,COMM 190,A00,887012,Staff,8,0,23,15
1746601294402,CSE 8A,A50,887015,Cao; Yingjun,56,0,85,29
1746601295427,CSE 11,A01,887017,Cao; Yingjun,11,0,70,59
1746601296453,CSE 20,A01,887019,Staff,30,0,50,20
1746601297480,CSE 21,A01,887021,Staff,79,0,100,21
1746601297480,CSE 21,B01,892583,Braun; Oliver,45,0,50,5
1746601298517,CSE 30,A01,887025,Eldon; John,142,0,200,58
1746601299542,CSE 100,A01,887027,Staff,26,0,50,24
1746601299542,CSE 100,A02,887028,Staff,42,0,50,8
1746601300578,CSE 101,A01,887030,Braun; Oliver,74,0,100,26
1746601300578,CSE 101,B01,887032,Jones; Miles E,0,3,50,50
1746601300578,CSE 101,B02,887033,Jones; Miles E,0,2,50,50
1746601301605,CSE 105,A01,908084,Jones; Miles E,32,0,50,18
1746601301605,CSE 105,A02,908087,Jones; Miles E,31,0,50,19
1746601302632,CSE 135,A01,887035,Powell; Thomas Allan,0,5,50,50
1746601303659,CSE 142,A01,887037,Staff,8,0,60,52
1746601304690,CSE 142L,A01,887039,Staff,34,0,60,26
1746601305728,CSE 151A,A01,887041,Solares; Edwin A,47,0,100,53
1746601306760,CSE 175,A01,887043,Kumar; Rakesh,30,0,30,0
1746601307791,CSS 1,A01,886389,Staff,0,1,40,40
1746601308818,DSC 30,A01,908097,Liao; Soohyun Nam,47,0,75,28
1746601309844,DSC 40A,A01,908099,Shannon; Kyle Michael,30,0,50,20
1746601310871,DSC 40B,A01,908112,Staff,15,0,50,35
1746601311900,DSC 80,A01,908116,Staff,19,0,60,41
1746601312930,DSC 197,001,956863,Eldridge; Justin Matthew,9999,0,9999,0
1746601313958,ECE 5,A01,886400,Morris; Karcher William,1,0,6,5
1746601313958,ECE 5,A02,886401,Morris; Karcher William,3,0,6,3
1746601314987,ECE 148,A01,886403,Silberman; Jack,0,14,14,14
1746601316013,ECON 1,A01,887265,Crane; Meredith Helen,11,0,70,59
1746601316013,ECON 1,B01,887268,Staff,42,0,50,8
1746601317040,ECON 2,A01,887273,Crane; Meredith Helen,54,0,70,16
1746601318070,ECON 3,A01,887279,Rondina; Giacomo,31,0,70,39
1746601319101,ECON 4,A01,887282,Anderson; John Charles,0,2,10,10
1746601320133,ECON 5,A01,887285,Staff,34,0,45,11
1746601320133,ECON 5,B01,887292,Staff,41,0,45,4
1746601321162,ECON 100A,A01,887337,Newhouse; Herbert S,54,0,70,16
1746601321162,ECON 100A,B01,887349,Staff,45,0,50,5
1746601322189,ECON 100B,A01,887361,Du; Songzi,29,0,70,41
1746601323220,ECON 100C,A01,887445,Newhouse; Herbert S,59,0,70,11
1746601324248,ECON 105,A00,887488,Vespa; Emanuel Ignacio,23,0,35,12
1746601325280,ECON 109,A01,887506,Shishkin; Denis,28,0,35,7
1746601326311,ECON 110A,A01,887568,Alon; Titan Michael,0,2,35,35
1746601326311,ECON 110A,B01,907601,Alon; Titan Michael,20,0,35,15
1746601327337,ECON 110B,A01,887598,Levkoff; Steven B.,0,24,70,70
1746601328364,ECON 112,A00,887599,Rondina; Giacomo,19,0,35,16
1746601329389,ECON 120A,A01,887603,Dai; Yinlin,36,0,70,34
1746601330424,ECON 120C,A01,887608,Sun; Yixiao,0,1,35,35
1746601330424,ECON 120C,B01,887614,Sun; Yixiao,0,0,35,35
1746601331456,ECON 138,A00,887621,Bharadwaj; Prashant,0,21,20,20
1746601332484,ECON 144,A00,958007,Squires; Dale E,12,0,35,23
1746601333510,ECON 171,A01,907666,Staff,18,0,35,17
1746601334536,ECON 175,A00,887626,Wu; Pak Yeung,22,0,35,13
1746601335563,ECON 190,A00,887640,Vespa; Emanuel Ignacio,22,0,35,13
1746601336592,EDS 25,A01,888197,Staff,0,0,0,0
1746601336592,EDS 25,A02,888209,Staff,0,0,0,0
1746601336592,EDS 25,A03,888210,Staff,0,0,0,0
1746601336592,EDS 25,A04,888212,Staff,0,0,0,0
1746601336592,EDS 25,A05,888213,Staff,0,0,0,0
1746601336592,EDS 25,A06,888214,Staff,0,0,0,0
1746601336592,EDS 25,A07,888235,Staff,0,2,0,0
1746601336592,EDS 25,A08,888236,Staff,0,0,0,0
1746601336592,EDS 25,A09,888240,Staff,0,0,0,0
1746601336592,EDS 25,A10,888244,Staff,0,0,0,0
1746601336592,EDS 25,B01,888273,Staff,0,0,0,0
1746601336592,EDS 25,B02,888285,Staff,0,0,0,0
1746601336592,EDS 25,B03,888423,Staff,0,0,0,1
1746601336592,EDS 25,B04,888432,Staff,0,0,0,0
1746601336592,EDS 25,B05,888433,Staff,0,0,0,0
1746601336592,EDS 25,B06,888467,Staff,0,0,0,0
1746601336592,EDS 25,B07,888468,Staff,0,0,0,0
1746601336592,EDS 25,B08,888479,Staff,0,0,0,0
1746601336592,EDS 25,B09,888484,Staff,0,0,0,0
1746601336592,EDS 25,B10,888487,Staff,0,0,0,0
1746601337625,EDS 38,A01,907700,Choi; Bailey Miyeon,30,0,30,0
1746601338656,EDS 112,A01,888601,Chapman; Thandeka K,12,0,40,28
1746601339690,EDS 115,A00,888697,Mendez; Kathrina Mendoza,10,0,30,20
1746601340717,EDS 116,A01,888893,Staff,33,0,40,7
1746601342773,EDS 124AR,A00,889133,Staff,29,0,50,21
1746601342773,EDS 124AR,B00,907471,Simon; Elizabeth A,37,0,50,13
1746601343803,EDS 124BR,A00,889134,Simon; Elizabeth A,44,0,100,56
1746601344832,EDS 125,A00,889135,Staff,25,0,30,5
1746601345859,EDS 126,A01,889138,Staff,35,0,40,5
1746601346884,EDS 164R,A01,889142,Wishard Guerra; Alison G.,32,0,50,18
1746601347911,ENG 30,A01,886396,Staff,0,0,0,0
1746601347911,ENG 30,B01,886398,Staff,0,0,0,0
1746601348942,ENVR 102,A00,906150,Montejo; Carolina,23,0,25,2
1746601349976,ETHN 103A,A00,887236,Man; Simeon S,0,2,0,0
1746601351005,ETHN 113,A00,887239,Staff,16,0,30,14
1746601352031,ETHN 116,A00,887240,Staff,16,0,25,9
1746601353056,ETHN 117,A00,887241,Choi; Esther Min,28,0,30,2
1746601354084,ETHN 118,A00,887243,Staff,24,0,30,6
1746601355110,ETHN 127,A00,887248,Cuong; Marisol,11,0,15,4
1746601356137,ETHN 139,A00,887250,Staff,7,0,10,3
1746601357167,ETHN 142,A00,887252,Staff,9,0,30,21
1746601358193,ETHN 161,A00,887253,Browne; Errol Tsekani,24,0,30,6
1746601359221,ETHN 163FR,A00,887255,Burelle; Julie Sara Veronique,0,0,5,5
1746601360250,GLBH 20,A00,889149,Elwardani; Nile Regina,8,0,42,34
1746601362309,GLBH 111,A01,889152,Burgos; Jose L.,17,0,17,0
1746601363339,GLBH 150,A00,889181,Sloane; Julia Kathryn,0,5,15,15
1746601365393,HDS 60,A01,886406,Warstadt; Melissa Fawn,72,0,80,8
1746601366417,HIAF 111,A00,889324,Gyamfi; Bright,25,0,32,7
1746601367444,HIEA 131,A00,889328,Staff,15,0,32,17
1746601368471,HIEA 144,A00,889333,Henry; Todd A.,26,0,32,6
1746601369497,HIEA 154,A00,889336,Henry; Todd A.,24,0,32,8
1746601370526,HIEU 106,A00,889339,Staff,22,0,32,10
1746601372580,HIEU 114,A00,889340,Staff,4,0,32,28
1746601373610,HIEU 135GS,A00,889342,Patterson; Patrick H.,0,0,1,24
1746601374640,HIEU 137,A00,889343,Edington; Claire Ellen,10,0,25,15
1746601375664,HIEU 148,A00,889345,Staff,14,0,32,18
1746601376690,HIEU 154,A00,889346,Biess; Frank Peter,21,0,32,11
1746601377718,HILA 102,A00,889351,Staff,12,0,32,20
1746601378746,HILD 2A,A01,889221,Lewandoski; Julia Mavis,0,8,32,32
1746601379776,HILD 7B,A01,889225,Man; Simeon S,0,12,32,32
1746601380803,HILD 7C,A01,889288,Alvarez; Luis A,0,14,32,32
1746601381833,HILD 30,A01,889323,Staff,0,5,32,32
1746601383885,HISC 119,A00,889383,Golan; Tal,20,0,32,12
1746601384914,HIUS 103,A00,889384,Man; Simeon S,0,0,32,32
1746601385938,HIUS 117,A00,919797,Kwak; Nancy,18,0,32,14
1746601386969,HIUS 142A,A00,919788,Staff,22,0,32,10
1746601389030,HIUS 149,A00,889386,Gyamfi; Bright,26,0,32,6
1746601390058,HIUS 155,A00,889387,Alvarez; Luis A,15,0,32,17
1746601391724,HUM 3,A01,886499,Caldwell; Michael Alan,19,0,50,31
1746601392753,HUM 3GS,A00,886500,Rodriguez; Bretton Sigfred,0,0,0,28
1746601393779,HUM 3R,A01,886502,Markman; Kristina,0,36,50,50
1746601394807,HUM 4,A01,886504,Crum; Matthew Stephen,23,0,50,27
1746601394807,HUM 4,B01,886506,West; Geoffrey Scott,17,0,50,33
1746601395831,HUM 4GS,A00,886507,Staff,0,0,0,19
1746601396857,HUM 5,A01,886509,Staff,31,0,50,19
1746601397884,HUM 5R,A01,886511,Zavodny; Tatiana Sophia,0,39,50,50
1746601398910,JAPN 180,A00,886407,Staff,16,0,40,24
1746601399947,LATI 50,A01,886409,Martin-Cabrera; Luis,3,0,22,19
1746601399947,LATI 50,A02,886410,Martin-Cabrera; Luis,19,0,22,3
1746601399947,LATI 50,A03,886411,Martin-Cabrera; Luis,21,0,22,1
1746601399947,LATI 50,A04,886412,Martin-Cabrera; Luis,8,0,22,14
1746601400977,LAWS 101,A00,907664,Staff,28,0,60,32
1746601402006,LIAB 1A,A00,889388,Saab; Dima,17,0,20,3
1746601403034,LIAB 1AX,A00,889389,El Cheddadi; Youniss,18,0,20,2
1746601404065,LIFR 1C,A00,889391,Van Moer; Vinciane G,8,0,20,12
1746601405095,LIFR 1CX,A00,889392,Van Moer; Vinciane G,7,0,20,13
1746601406122,LIFR 1D,A00,889393,Van Moer; Vinciane G,7,0,20,13
1746601407146,LIFR 1DX,A00,889394,Van Moer; Vinciane G,8,0,20,12
1746601408174,LIGN 7,A00,886923,Staff,25,0,50,25
1746601409237,LIGN 17,A00,886924,Kehler; Andrew Scott,126,0,150,24
1746601410266,LTAM 110,A00,889395,Staff,15,0,30,15
1746601411292,LTAM 110GS,A00,958010,Rodriguez; Bretton Sigfred,0,0,0,28
1746601412319,LTCH 101,A00,889397,Staff,23,0,25,2
1746601413345,LTCS 130,A00,889398,Staff,23,0,25,2
1746601414373,LTEA 138,A00,889399,Staff,24,0,40,16
1746601415398,LTEN 149,A00,889400,Wesling; Megan E.,0,3,25,25
1746601416426,LTEN 169,A00,889401,Staff,20,0,25,5
1746601417457,LTEN 180,A00,889402,Staff,10,0,15,5
1746601418482,LTEN 181,A00,889403,Staff,21,0,25,4
1746601419508,LTWL 100,A00,889404,Myerston Santana; Jacobo,2,0,25,23
1746601420537,LTWL 180GS,A00,889405,Staff,0,0,20,20
1746601421568,LTWL 181,A00,889406,Staff,16,0,25,9
1746601422595,LTWL 184,A00,889475,Mukherjee; Silpa,22,0,25,3
1746601423623,LTWR 102C,A00,889486,Staff,29,0,30,1
1746601424651,LTWR 115W,A00,889491,Staff,0,2,15,15
1746601425681,MAE 8,A01,886905,Staff,0,2,0,0
1746601426709,MAE 11,A00,886906,Bandaru; Prabhakar,0,7,50,50
1746601427735,MAE 20,A00,886907,Evdokimenko; Ekaterina,43,0,70,27
1746601428762,MAE 30B,A00,886909,Ghazinejad; Maziar,25,0,45,20
1746601429793,MAE 101B,A00,886910,Saintillan; David,30,0,45,15
1746601430820,MAE 105,A00,886911,Bandaru; Prabhakar,18,0,50,32
1746601431849,MAE 107,B00,958024,Staff,7,0,50,43
1746601432880,MAE 143B,A00,886913,Bewley; Thomas R,2,0,40,38
1746601433908,MAE 148,A01,886915,Silberman; Jack,0,3,14,14
1746601434933,MAE 160,A00,886916,Evdokimenko; Ekaterina,30,0,60,30
1746601435964,MATH 3C,A01,889681,Staff,0,2,30,30
1746601435964,MATH 3C,A02,960048,Staff,23,0,30,7
1746601436998,MATH 10A,A01,889760,Staff,26,0,30,4
1746601436998,MATH 10A,A02,889783,Staff,29,0,30,1
1746601438025,MATH 10B,A01,889785,Verstraete; Jacques Allan,1,0,35,34
1746601438025,MATH 10B,A02,889795,Verstraete; Jacques Allan,4,0,35,31
1746601438025,MATH 10B,B01,889797,Verstraete; Jacques Allan,3,0,35,32
1746601438025,MATH 10B,B02,889828,Verstraete; Jacques Allan,3,0,35,32
1746601439053,MATH 10C,A01,889849,Habib; Yousaf,8,0,30,22
1746601439053,MATH 10C,A02,889852,Habib; Yousaf,14,0,30,16
1746601439053,MATH 10C,A03,889853,Habib; Yousaf,22,0,30,8
1746601439053,MATH 10C,A04,889858,Habib; Yousaf,20,0,30,10
1746601439053,MATH 10C,B01,889861,Staff,1,0,30,29
1746601439053,MATH 10C,B02,889862,Staff,24,0,30,6
1746601439053,MATH 10C,B03,889863,Staff,27,0,30,3
1746601439053,MATH 10C,B04,889967,Staff,23,0,30,7
1746601440085,MATH 18,A01,889974,Staff,7,0,30,23
1746601440085,MATH 18,A02,889977,Staff,20,0,30,10
1746601440085,MATH 18,B01,889984,Hardiman; Liam,20,0,30,10
1746601440085,MATH 18,B02,889985,Hardiman; Liam,25,0,30,5
1746601441112,MATH 20A,A01,889990,Suk; Andrew Hoon,30,0,35,5
1746601442149,MATH 20B,A01,889993,Ohm; Ko Woon,21,0,30,9
1746601442149,MATH 20B,A02,889994,Ohm; Ko Woon,30,0,30,0
1746601442149,MATH 20B,B01,889996,Ohm; Ko Woon,22,0,30,8
1746601442149,MATH 20B,B02,889997,Ohm; Ko Woon,23,0,30,7
1746601443178,MATH 20C,A01,889999,Hammock; Frances H,17,0,30,13
1746601443178,MATH 20C,A02,890003,Hammock; Frances H,23,0,30,7
1746601443178,MATH 20C,B01,890006,Hammock; Frances H,2,0,30,28
1746601443178,MATH 20C,B02,890007,Hammock; Frances H,12,0,30,18
1746601444220,MATH 20D,A01,890011,Cheng; Hsiao-Bing,1,0,30,29
1746601444220,MATH 20D,A02,890012,Cheng; Hsiao-Bing,14,0,30,16
1746601444220,MATH 20D,B01,890016,Cheng; Hsiao-Bing,13,0,30,17
1746601444220,MATH 20D,B02,890017,Cheng; Hsiao-Bing,13,0,30,17
1746601445246,MATH 20E,A01,890026,Harel; Guershon,1,0,30,29
1746601445246,MATH 20E,A02,890029,Harel; Guershon,22,0,30,8
1746601445246,MATH 20E,B01,890033,Harel; Guershon,7,0,30,23
1746601445246,MATH 20E,B02,890101,Harel; Guershon,21,0,30,9
1746601446271,MATH 102,A01,890104,Staff,18,0,30,12
1746601446271,MATH 102,A02,890105,Staff,27,0,30,3
1746601447296,MATH 103B,A01,890116,Salehi Golsefidy; Alireza,3,0,30,27
1746601447296,MATH 103B,B01,890118,Staff,0,3,34,34
1746601448320,MATH 109,A01,890121,Aliabadi Sr.; Mohsen,0,0,30,30
1746601448320,MATH 109,B01,890124,Upadrashta; Pranav Kumar,18,0,30,12
1746601449351,MATH 120A,A01,890126,Eggers; John Dietrich,13,0,30,17
1746601450376,MATH 142B,A01,890128,Ioana; Adrian,19,0,30,11
1746601450376,MATH 142B,A02,890129,Ioana; Adrian,12,0,30,18
1746601451402,MATH 154,A01,890174,Staff,0,1,30,30
1746601451402,MATH 154,A02,890182,Staff,0,0,30,30
1746601452433,MATH 168A,A01,890197,Dumitriu; Ioana,21,0,35,14
1746601453462,MATH 170A,A01,890240,Nie; Jiawang,1,0,30,29
1746601453462,MATH 170A,A02,890241,Nie; Jiawang,11,0,30,19
1746601453462,MATH 170A,A03,890249,Nie; Jiawang,23,0,30,7
1746601454491,MATH 170B,A01,957891,Nag; Panchali,13,0,35,22
1746601456541,MATH 181A,A01,908025,Staff,0,3,35,35
1746601456541,MATH 181A,A02,960115,Staff,26,0,35,9
1746601457570,MATH 181B,A01,959874,Staff,24,0,30,6
1746601458601,MATH 193B,A01,890265,Staff,0,4,35,35
1746601459626,MGT 4,A01,890311,Anderson; John Charles,42,0,88,46
1746601460651,MGT 5,A00,907740,Staff,12,0,98,86
1746601461680,MGT 12,A00,890312,Lindenberger; Wade Douglas,67,0,98,31
1746601462705,MGT 16,A00,957883,Staff,78,0,98,20
1746601464758,MGT 45,A00,890314,Pecore; Joseph P.,45,0,98,53
1746601465787,MGT 71,A00,890315,Staff,0,12,98,98
1746601466816,MGT 100,A00,890316,Yavorsky; Daniel Ryan,44,0,98,54
1746601467844,MGT 103,A00,890317,Ehrich; Kristine R,73,0,98,25
1746601468871,MGT 105,A00,890356,Bates; Kenneth Walter,0,8,98,98
1746601469897,MGT 112,A00,890360,Ehrich; Kristine R,55,0,98,43
1746601470927,MGT 127R,A00,907732,Zhu; Kevin Xiaoguo,23,0,98,75
1746601471954,MGT 131B,A00,890361,Anderson; John Charles,59,0,98,39
1746601472981,MGT 137,A00,890362,Lindenberger; Wade Douglas,65,0,98,33
1746601474005,MGT 160,A00,890369,Johnson; Erik Barry,9,0,98,89
1746601476068,MGT 164,A00,890372,Zimmermann; Carsten,0,40,98,98
1746601477100,MGT 180,A00,890374,Bliss; Barbara Ann,11,0,98,87
1746601478130,MMW 15,A01,886414,Chang; Edmond Yi-Teh,0,12,28,28
1746601478130,MMW 15,A02,886415,Chang; Edmond Yi-Teh,0,8,28,28
1746601478130,MMW 15,A03,886416,Chang; Edmond Yi-Teh,0,9,28,28
1746601478130,MMW 15,A04,886417,Chang; Edmond Yi-Teh,0,8,28,28
1746601478130,MMW 15,B01,886419,Chang; Edmond Yi-Teh,0,7,28,28
1746601478130,MMW 15,B02,886420,Chang; Edmond Yi-Teh,0,7,28,28
1746601478130,MMW 15,B03,886421,Chang; Edmond Yi-Teh,0,7,28,28
1746601478130,MMW 15,B04,886422,Chang; Edmond Yi-Teh,0,8,28,28
1746601478130,MMW 15,C01,886424,Staff,0,9,28,28
1746601478130,MMW 15,C02,886425,Staff,0,8,28,28
1746601478130,MMW 15,C03,886426,Staff,0,8,28,28
1746601478130,MMW 15,C04,886427,Staff,0,8,28,28
1746601478130,MMW 15,C05,958038,Staff,0,8,28,28
1746601478130,MMW 15,C06,958039,Staff,0,7,28,28
1746601479155,MMW 15GS,A00,906910,Patterson; Patrick H.,4,0,28,24
1746601480184,MMW 122R,A01,886429,Rahimi; Babak,0,13,28,28
1746601480184,MMW 122R,A02,886430,Rahimi; Babak,0,12,28,28
1746601480184,MMW 122R,A03,958040,Rahimi; Babak,0,11,28,28
1746601481209,MUS 1A,A01,890937,Staff,2,0,25,23
1746601481209,MUS 1A,A02,891035,Staff,6,0,25,19
1746601481209,MUS 1A,C01,958912,Staff,24,0,25,1
1746601481209,MUS 1A,C02,958913,Staff,25,0,25,0
1746601483264,MUS 2AK,A00,957092,Ohnishi; Takae,15,0,15,0
1746601484294,MUS 4,A01,891044,Staff,0,0,25,25
1746601484294,MUS 4,A02,891045,Staff,22,0,25,3
1746601484294,MUS 4,B01,891048,Staff,17,0,25,8
1746601484294,MUS 4,B02,891050,Staff,25,0,25,0
1746601485322,MUS 5,A01,957506,Dubnov; Shlomo,0,0,25,25
1746601485322,MUS 5,A02,957622,Dubnov; Shlomo,13,0,25,12
1746601485322,MUS 5,A03,957623,Dubnov; Shlomo,20,0,25,5
1746601486349,MUS 6,A01,891053,Freitas Caetano; Marcelo,24,0,25,1
1746601486349,MUS 6,A02,891054,Freitas Caetano; Marcelo,23,0,25,2
1746601487378,MUS 7,A01,891081,Staff,0,0,25,25
1746601487378,MUS 7,A02,891082,Staff,3,0,25,22
1746601488409,MUS 8GS,A00,891118,Borgo; David Garcia,1,0,25,24
1746601489436,MUS 11,A01,891140,Staff,8,0,25,17
1746601489436,MUS 11,A02,891141,Staff,21,0,25,4
1746601490463,MUS 13,A01,891143,Staff,8,0,25,17
1746601490463,MUS 13,A02,891144,Staff,24,0,25,1
1746601491490,MUS 15,A01,891146,Staff,9,0,25,16
1746601491490,MUS 15,A02,891148,Staff,21,0,25,4
1746601491490,MUS 15,B01,891150,Staff,18,0,25,7
1746601491490,MUS 15,B02,891151,Staff,25,0,25,0
1746601492517,MUS 20,A01,891153,Staff,5,0,20,15
1746601492517,MUS 20,A02,891155,Staff,14,0,20,6
1746601493545,MUS 80,A00,891156,Staff,19,0,25,6
1746601493545,MUS 80,B00,891157,Staff,23,0,25,2
1746601494570,MUS 130,A00,891158,Ohnishi; Takae,35,0,35,0
1746601495597,MUS 150GS,A01,891160,Borgo; David Garcia,1,0,25,24
1746601496623,MUS 170,A01,891162,Freitas Caetano; Marcelo,20,0,25,5
1746601496623,MUS 170,A02,891164,Freitas Caetano; Marcelo,21,0,25,4
1746601497647,NANO 11,A00,886220,Vazquez Mena; Oscar,13,0,15,2
1746601498673,NANO 15,A01,886222,Drews; Aaron,4,0,7,3
1746601499701,NANO 104,A00,886224,Sirbuly; Donald,17,0,25,8
1746601500726,PH 40,A00,886528,Staff,23,0,40,17
1746601501757,PH 45,A01,886799,Staff,35,0,40,5
1746601502784,PH 110,A00,886802,Staff,0,6,40,40
1746601503813,PH 172,A00,906716,Staff,19,0,35,16
1746601504842,PH 191,A00,886803,Staff,6,0,40,34
1746601505869,PHIL 1,A00,889500,Staff,20,0,30,10
1746601506899,PHIL 10,A01,889549,Grush; Rick Scott,16,0,22,6
1746601506899,PHIL 10,A02,889551,Grush; Rick Scott,22,0,22,0
1746601507928,PHIL 28,A01,889559,Lamey; Andy M.,0,2,31,31
1746601507928,PHIL 28,A02,889561,Lamey; Andy M.,0,1,30,30
1746601507928,PHIL 28,A03,889572,Lamey; Andy M.,0,1,30,30
1746601508955,PHIL 35,A00,907839,Staff,13,0,15,2
1746601509982,PHIL 60,A00,889574,Staff,73,0,90,17
1746601511011,PHIL 101,A00,958004,Staff,12,0,15,3
1746601513067,PHIL 136,A00,889582,Fulkerson; Matthew Todd,26,0,45,19
1746601514106,PHIL 163,A01,889601,Staff,21,0,30,9
1746601514106,PHIL 163,B01,889606,Brandt; Reuven A,0,3,0,0
1746601515136,PHIL 164,A00,889610,Staff,16,0,30,14
1746601516164,PHIL 165,A00,889613,Staff,22,0,30,8
1746601517192,PHYS 1A,A00,886431,Staff,30,0,70,40
1746601518220,PHYS 1AL,001,886432,Tsai; Philbert S,0,1,30,30
1746601518220,PHYS 1AL,002,886436,Tsai; Philbert S,13,0,30,17
1746601519247,PHYS 1B,A00,886439,Staff,184,0,240,56
1746601520272,PHYS 1BL,001,886441,Tsai; Philbert S,0,4,30,30
1746601520272,PHYS 1BL,002,886444,Tsai; Philbert S,2,0,30,28
1746601521298,PHYS 1C,A00,896092,Arnold; Kam S,78,0,146,68
1746601522328,PHYS 1CL,001,886448,Tsai; Philbert S,0,0,30,30
1746601522328,PHYS 1CL,002,886449,Tsai; Philbert S,1,0,30,29
1746601522328,PHYS 1CL,003,886450,Tsai; Philbert S,16,0,30,14
1746601522328,PHYS 1CL,004,886451,Tsai; Philbert S,15,0,30,15
1746601523357,PHYS 2B,A01,886457,Staff,67,0,115,48
1746601524381,PHYS 2C,A01,886460,Shotwell; Brian,0,9,65,65
1746601525407,PHYS 2CL,A01,886467,Staff,0,4,28,28
1746601525407,PHYS 2CL,A02,886468,Staff,0,3,28,28
1746601526436,PHYS 2D,A01,886470,Staff,10,0,50,40
1746601527463,PHYS 4B,A01,886475,Grinstein; Benjamin,22,0,40,18
1746601528488,POLI 5,A00,891173,Desposato; Scott,7,0,25,18
1746601529518,POLI 5D,A01,891175,Staff,5,0,5,0
1746601529518,POLI 5D,B01,891178,Staff,5,0,5,0
1746601530547,POLI 11,A00,891179,Ferree; Karen E,0,0,35,35
1746601531577,POLI 12,A00,891180,Staff,15,0,30,15
1746601532604,POLI 27,A01,891182,Staff,11,0,75,64
1746601533633,POLI 30,A00,891183,Staff,8,0,50,42
1746601534660,POLI 100B,A00,891244,Staff,5,1,35,30
1746601535687,POLI 100I,A00,891247,Staff,7,0,30,23
1746601536715,POLI 104J,A00,891248,Nichter; Maysa,14,0,30,16
1746601537742,POLI 104U,A00,891250,Nichter; Maysa,1,0,30,29
1746601539792,POLI 110B,A00,891255,Wiens; David,19,0,25,6
1746601540820,POLI 112A,A00,891256,Wiens; David,6,0,25,19
1746601541850,POLI 114BR,A00,891261,Staff,19,0,30,11
1746601542878,POLI 117R,A00,891262,Forman; Fonna,0,6,50,50
1746601543905,POLI 118,A00,891264,Ingham; Sean,17,0,25,8
1746601544934,POLI 124A,A00,891265,Staff,18,0,20,2
1746601545959,POLI 125D,A00,891266,Nichter; Simeon C,2,0,25,23
1746601546990,POLI 126,A00,891268,Nichter; Simeon C,7,0,25,18
1746601548017,POLI 126AA,A00,891272,Staff,15,0,25,10
1746601549045,POLI 130AA,A00,891273,Staff,15,0,20,5
1746601550076,POLI 134AA,A00,891274,Staff,4,0,20,16
1746601552132,POLI 138,A00,891278,Staff,21,0,25,4
1746601553157,POLI 142K,A00,891280,Staff,10,0,25,15
1746601554187,POLI 142M,A00,891281,Gartzke; Erik,16,0,30,14
1746601555215,POLI 142P,A00,891284,Staff,20,0,30,10
1746601556246,POLI 143,A00,891285,Gartzke; Erik,12,0,30,18
1746601557279,POLI 153,A00,891286,Staff,19,0,20,1
1746601559331,POLI 175,A00,891290,Staff,15,0,20,5
1746601560360,PSYC 1,A00,890674,Steiner; Eric Tomas,0,11,45,45
1746601561384,PSYC 2,A00,890676,Albright; Thomas D,20,0,35,15
1746601562415,PSYC 3,A00,890679,Staff,17,0,20,3
1746601563441,PSYC 6,A00,959858,Staff,19,0,20,1
1746601564464,PSYC 60,A01,890684,Rickard; Timothy C.,0,6,45,45
1746601565493,PSYC 70,A01,890689,Geller; Emma Harlan,6,0,30,24
1746601566522,PSYC 71,A01,959860,Staff,21,0,25,4
1746601567549,PSYC 100,A00,890690,Lacefield; Katharine I,0,50,180,180
1746601568577,PSYC 102,A00,890695,Staff,18,0,40,22
1746601569603,PSYC 105,A00,890699,Geller; Emma Harlan,70,0,100,30
1746601570629,PSYC 106,A00,890701,Gorman; Michael R.,5,0,30,25
1746601571658,PSYC 108,A00,890704,Adrian; Julia Anna,0,29,50,50
1746601572686,PSYC 118,A01,890712,Staff,11,0,30,19
1746601573712,PSYC 124,A00,890716,Chapman; Eddie Nathaniel,25,0,60,35
1746601574738,PSYC 131,A00,890717,Anagnostaras; Stephan,0,7,80,80
1746601575764,PSYC 137,A00,890719,Winkielman; Piotr,0,11,30,30
1746601576794,PSYC 144,A00,890721,Adrian; Julia Anna,0,9,45,45
1746601577823,PSYC 162,A00,890805,Staff,0,1,75,75
1746601578853,PSYC 169,A00,890810,Staff,0,15,30,30
1746601579880,PSYC 172,A00,890814,Gorman; Michael R.,9,0,30,21
1746601580910,PSYC 181,A00,890818,Anagnostaras; Stephan,7,0,200,193
1746601581938,PSYC 184,A00,959861,Staff,162,0,175,13
1746601582966,PSYC 189,A00,890823,Staff,0,2,30,30
1746601583993,PSYC 191,A00,890884,Rickard; Timothy C.,0,11,35,35
1746601585021,PSYC 193,A00,890913,Staff,19,0,30,11
1746601585021,PSYC 193,B00,890914,Chapman; Eddie Nathaniel,24,0,30,6
1746601586046,PSYC 193L,A01,890918,Lowe; Angela Beth,20,0,30,10
1746601586046,PSYC 193L,B01,890921,Hurwitz; Ethan Scott,20,0,30,10
1746601586046,PSYC 193L,C01,890928,Staff,30,0,30,0
1746601587074,RELI 149,A00,886806,Rahimi; Babak,23,0,40,17
1746601588100,SE 9,A01,886814,Staff,7,0,20,13
1746601589125,SE 101B,A01,886816,Chadha; Mayank,3,0,35,32
1746601590216,SE 110B,A00,886818,Zhu; Qiang,4,0,75,71
1746601591242,SE 125,A01,886830,Staff,10,0,30,20
1746601592267,SE 130B,A01,886835,Staff,14,0,40,26
1746601593321,SE 131A,A01,886838,Krysl; Petr,34,0,55,21
1746601594353,SE 154,A00,886840,Staff,28,0,50,22
1746601595382,SE 164GS,A01,886849,Staff,6,0,20,14
1746601596410,SE 167GS,A01,886853,Staff,6,0,20,14
1746601597437,SIO 25,A01,890107,Staff,19,0,30,11
1746601598463,SIO 45,A00,890109,Cook; Geoffrey W,115,0,200,85
1746601599491,SIO 109R,A00,890110,Forman; Fonna,0,16,20,20
1746601600518,SIO 187,A01,890114,Kacev; David,15,0,40,25
1746601601548,SOCI 1,A01,890431,Thorpe; Charles Robert,14,0,30,16
1746601601548,SOCI 1,A02,890518,Thorpe; Charles Robert,30,0,30,0
1746601602574,SOCI 2,A01,957978,Staff,25,0,25,0
1746601602574,SOCI 2,A02,957979,Staff,23,0,25,2
1746601603602,SOCI 20,A01,890523,Calderon-Zaks; Michael Aar,21,0,30,9
1746601603602,SOCI 20,A02,890526,Calderon-Zaks; Michael Aar,29,0,30,1
1746601604628,SOCI 30,A01,890533,Pardo Guerra; Juan Pablo,37,0,40,3
1746601605653,SOCI 40,A01,890535,Staff,27,0,45,18
1746601606681,SOCI 104Q,A00,890559,Staff,18,0,30,12
1746601607709,SOCI 106,A00,890560,Arnal; Maud Marie Leonie,20,0,30,10
1746601608736,SOCI 110,A00,890567,Holkenbrink-Monk; Charlene,19,0,30,11
1746601609762,SOCI 112,A00,890568,Victoria Torres; Pablo,2,0,55,53
1746601610792,SOCI 115,A00,890597,Arnal; Maud Marie Leonie,28,0,45,17
1746601612851,SOCI 121,A00,890604,Pardo Guerra; Juan Pablo,38,0,45,7
1746601613880,SOCI 126,A01,890608,Staff,8,0,10,2
1746601614911,SOCI 127,A00,890609,Staff,18,0,30,12
1746601615940,SOCI 131,A00,890610,Thorpe; Charles Robert,37,0,45,8
1746601617008,SOCI 135,A00,890615,Payne; Christine Anna,14,0,45,31
1746601618036,SOCI 139,A00,890620,Staff,38,0,45,7
1746601619063,SOCI 148E,A00,890622,Calderon-Zaks; Michael Aar,36,0,45,9
1746601620089,SOCI 150,A00,890623,Kohler; Kristopher M.,31,0,45,14
1746601621115,SOCI 157,A00,890625,Jules-Rosette; Bennetta W.,18,0,20,2
1746601622142,SOCI 160,A00,890627,Payne; Christine Anna,21,0,45,24
1746601623168,SYN 1,A00,886855,Fish; Gwendolyn Anne,0,1,0,0
1746601623168,SYN 1,B00,906086,Fish; Gwendolyn Anne,0,2,0,2
1746601624193,SYN 2R,A00,886860,Staff,0,17,15,15
1746601624193,SYN 2R,B00,906106,Atkinson; Arthur Laird,0,16,15,15
1746601625221,SYN 100,A01,886866,Browne; Emily,0,28,20,20
1746601625221,SYN 100,B01,906128,Rock; Martin,0,4,20,20
1746601625221,SYN 100,C01,906140,Deavenport; James Cary,0,4,20,20
1746601625221,SYN 100,D01,907816,Deavenport; James Cary,0,5,20,20
1746601626248,TDAC 1,A00,890286,Walsh; Kim C.,7,0,20,13
1746601627272,TDAC 101,A00,890296,Basso; Beatrice,15,0,20,5
1746601628298,TDDE 131,A00,890297,Staff,47,0,50,3
1746601629329,TDDM 1,A00,890287,Weinberg; Sadie,25,0,30,5
1746601630356,TDGE 11,A00,890288,Fulton; Julia,138,0,200,62
1746601630356,TDGE 11,B00,890289,Castro; Robert Jess,184,0,200,16
1746601631382,TDGE 25,B00,957359,Walsh; Kim C.,5,0,20,15
1746601632416,TDGE 40,A01,890292,Power; Jade Yukana,26,0,30,4
1746601633442,TDGE 124,A00,890298,Havis; Allan,0,2,50,50
1746601634466,TDGE 131R,A00,890299,Burelle; Julie Sara Veronique,15,0,42,27
1746601635496,TDHT 101,A00,890300,Staff,10,0,20,10
1746601636525,TDHT 109,A01,890302,Anderson; Mysia Anyse,31,0,40,9
1746601637550,TDMV 1,A00,890293,Arcidiacono; Kristin,18,0,30,12
1746601638575,TDMV 2,A00,890294,Weinberg; Sadie,23,0,30,7
1746601639605,TDMV 3,A00,957878,Arcidiacono; Kristin,28,0,30,2
1746601641655,TDMV 138,A00,890304,Jun; Grace Shin Hae,25,0,40,15
1746601642685,TDMV 140,A00,890305,Corrales; Joseph Bernales,25,0,30,5
1746601643712,TDMV 142,A00,890307,Caligagan; Tony,32,0,40,8
1746601644737,TDMV 144,A00,890308,Camaya; Michelle Ann,25,0,30,5
1746601645761,TDPW 1,A00,890295,Stein; Deborah Isobel,3,0,20,17
1746601646788,USP 2,A01,890272,Lerner; Amy M,7,0,20,13
1746601647815,USP 3,A01,890274,Staff,12,0,30,18
1746601648845,USP 15,A01,890276,Sun; Feiyang,16,0,30,14
1746601649870,USP 25,A00,890277,Shenkman; Michael Thomas,18,0,25,7
1746601650899,USP 138,A00,890278,Staff,13,0,25,12
1746601651925,USP 143,A00,890279,Staff,21,0,70,49
1746601652957,USP 144,A00,890280,Chowdhury; Muhammed Zohir,16,0,30,14
1746601653981,USP 150,A00,890281,Boomhower; Matthew Charles,4,0,30,26
1746601655011,USP 151,A00,890282,Staff,16,0,20,4
1746601656039,USP 162,A00,890283,Andrews; Abigail Leslie,16,0,20,4
1746601657066,USP 168,A00,920477,Kwak; Nancy,0,0,5,5
1746601658096,USP 181,A00,890284,Staff,3,0,20,17
1746601659125,USP 191A,A00,890285,Staff,12,0,20,8
1746601660151,VIS 101,A00,886512,Staff,26,0,75,49
1746601661177,VIS 103,A00,886513,Cruz; Edwin Teddy,61,0,75,14
1746601662204,VIS 108,A00,886514,Staff,4,0,15,11
1746601663233,VIS 127P,A00,886515,Shen; Kuiyi,80,0,146,66
1746601664260,VIS 149,A00,886516,Yoldas; Pinar,0,0,15,15
1746601665305,VIS 164,A00,886526,Erdmann; Dean,19,0,22,3
1746601666332,VIS 194S,A00,886527,Staff,61,0,75,14
1746601667362,WCWP 10A,C00,886484,Martiniuk; Jill,12,0,15,3
1746601668396,WCWP 10B,A00,886490,Uriarte; Emma,0,0,15,15
1746601668396,WCWP 10B,B00,886491,Dhir; Simrita,8,0,15,7
1746601668396,WCWP 10B,C00,886492,Ornelas; Tricia,0,0,15,15
1746601669421,WCWP 100,A00,886494,Young; Mark T,0,6,15,15
1746601671560,AAS 10,A01,886199,Childs; Dennis R.,0,3,0,0
1746601672585,ANAR 104,A01,886940,Shtienberg; Gilad,27,0,30,3
1746601673615,ANAR 120,A00,886953,Staff,13,0,20,7
1746601674644,ANBI 148,A01,886955,Wilder; Linnea Lorene,30,0,40,10
1746601676695,ANSC 122,A00,886957,Staff,24,0,30,6
1746601677720,ANSC 150,A00,886958,Sloane; Julia Kathryn,2,0,15,13
1746601678745,ANSC 156,A00,886959,Jenkins; Janis A.,0,1,15,15
1746601679771,ANSC 180,A00,886960,Staff,11,0,17,6
1746601680796,ANSC 188,A00,886961,Jassal; Aftab,9,0,25,16
1746601681826,ANSC 190,A00,886962,Jassal; Aftab,14,0,25,11
1746601682851,ANSC 191,A00,886963,Staff,18,0,20,2
1746601683877,ANTH 3,A01,891689,Staff,17,0,20,3
1746601684905,ANTH 5,A00,886933,Semendeferi; Ekaterini,16,0,20,4
1746601685934,ANTH 10,A00,886934,Staff,0,12,30,30
1746601686960,ANTH 21,A01,886936,Staff,41,0,60,19
1746601687986,ANTH 23,A01,886938,Staff,92,0,100,8
1746601689015,ANTH 105,A00,886964,Stewart; Alexander B,84,0,100,16
1746601690041,ANTH 108,A00,886965,Pedersen; David,9,0,20,11
1746601691075,AWP 10,001,886147,Staff,0,0,0,0
1746601691075,AWP 10,002,886148,Staff,0,0,0,0
1746601691075,AWP 10,003,886149,Staff,0,0,0,0
1746601691075,AWP 10,004,886150,Staff,0,0,0,0
1746601691075,AWP 10,005,886151,Staff,0,0,0,0
1746601691075,AWP 10,006,886152,Staff,0,0,0,0
1746601691075,AWP 10,007,886153,Staff,0,0,0,0
1746601691075,AWP 10,008,886154,Staff,0,0,0,0
1746601691075,AWP 10,009,886155,Staff,0,0,0,0
1746601691075,AWP 10,010,886156,Staff,0,0,0,0
1746601691075,AWP 10,011,886158,Staff,0,0,0,0
1746601691075,AWP 10,012,886160,Staff,0,0,0,0
1746601691075,AWP 10,013,886161,Staff,0,0,0,0
1746601691075,AWP 10,014,886162,Staff,0,0,0,0
1746601691075,AWP 10,015,886163,Staff,0,0,0,0
1746601691075,AWP 10,016,886164,Staff,0,0,0,0
1746601691075,AWP 10,017,886165,Staff,0,0,0,0
1746601691075,AWP 10,018,886166,Staff,0,0,0,0
1746601691075,AWP 10,019,886168,Staff,0,0,0,0
1746601691075,AWP 10,020,886170,Staff,0,0,0,0
1746601691075,AWP 10,021,886172,Staff,0,0,0,0
1746601692103,AWP 10R,001,886173,Staff,0,1,0,0
1746601692103,AWP 10R,002,886174,Staff,0,1,0,0
1746601692103,AWP 10R,003,886175,Staff,0,0,0,0
1746601692103,AWP 10R,004,886176,Staff,0,0,0,0
1746601692103,AWP 10R,005,886177,Staff,0,0,0,0
1746601692103,AWP 10R,006,886178,Staff,0,0,0,0
1746601692103,AWP 10R,007,886179,Staff,0,0,0,0
1746601692103,AWP 10R,008,886181,Staff,0,0,0,0
1746601692103,AWP 10R,009,886182,Staff,0,0,0,0
1746601692103,AWP 10R,010,886183,Staff,0,0,0,0
1746601692103,AWP 10R,011,886184,Staff,0,0,0,0
1746601692103,AWP 10R,012,886185,Staff,0,0,0,0
1746601692103,AWP 10R,013,886186,Staff,0,0,0,0
1746601692103,AWP 10R,014,886187,Staff,0,0,0,0
1746601692103,AWP 10R,015,886188,Staff,0,0,0,0
1746601692103,AWP 10R,016,886189,Staff,0,0,0,0
1746601692103,AWP 10R,017,960532,Staff,0,0,0,0
1746601692103,AWP 10R,018,960533,Staff,0,0,0,0
1746601692103,AWP 10R,019,960534,Staff,0,0,0,0
1746601692103,AWP 10R,020,960538,Staff,0,0,0,0
1746601692103,AWP 10R,021,960540,Staff,0,0,0,0
1746601692103,AWP 10R,022,960541,Staff,0,0,0,0
1746601692103,AWP 10R,023,960542,Staff,0,0,0,0
1746601692103,AWP 10R,024,960544,Staff,0,0,0,0
1746601692103,AWP 10R,025,960545,Staff,0,0,0,0
1746601692103,AWP 10R,026,960548,Staff,0,0,0,0
1746601693129,AWP 102R,A00,886190,Staff,0,0,0,0
1746601693129,AWP 102R,B00,886191,Staff,0,0,0,0
1746601694157,BENG 100,A01,886193,Staff,17,0,30,13
1746601695181,BENG 122A,A01,886195,Hasty; Jeff M,13,0,30,17
1746601696206,BENG 166A,A00,886196,Sah; Robert Lie-Yuan,0,3,30,30
1746601697231,BENG 190,A00,958050,Khojah; Reem I,17,0,25,8
1746601698256,BIBC 102,A01,894320,Staff,0,1,46,46
1746601698256,BIBC 102,A02,894321,Staff,0,0,46,46
1746601698256,BIBC 102,A03,894344,Staff,6,0,46,40
1746601698256,BIBC 102,A04,894345,Staff,27,0,47,20
1746601699283,BICD 100R,A01,894365,Smith; Laurie,0,2,58,58
1746601699283,BICD 100R,A02,894366,Smith; Laurie,0,4,58,58
1746601699283,BICD 100R,A03,894367,Smith; Laurie,0,0,59,59
1746601699283,BICD 100R,A04,959869,Smith; Laurie,38,0,59,21
1746601700317,BICD 136,A01,894383,Gustafson-Brown; Cindy,14,0,50,36
1746601701343,BIEB 102,A01,894494,Butler; Shannon Rhey,51,0,130,79
1746601703395,BIEB 150,A01,894617,Wills; Christopher,3,0,20,17
1746601703395,BIEB 150,A02,894631,Wills; Christopher,3,0,20,17
1746601703395,BIEB 150,A03,894937,Wills; Christopher,3,0,20,17
1746601703395,BIEB 150,A04,894946,Wills; Christopher,5,0,20,15
1746601704424,BIEB 194,A00,906141,Kurle; Carolyn M.,5,0,20,15
1746601705449,BILD 1,A01,894154,Staff,3,0,19,16
1746601705449,BILD 1,A02,894155,Staff,14,0,19,5
1746601705449,BILD 1,A03,894160,Staff,13,0,19,6
1746601705449,BILD 1,A04,894161,Staff,15,0,18,3
1746601706475,BILD 2,A01,894168,Staff,0,0,50,50
1746601706475,BILD 2,A02,894169,Staff,0,0,50,50
1746601706475,BILD 2,A03,894179,Staff,0,0,50,50
1746601706475,BILD 2,A04,894203,Staff,22,0,50,28
1746601707505,BILD 3,A01,894213,Staff,23,0,31,8
1746601707505,BILD 3,A02,894214,Staff,26,0,31,5
1746601707505,BILD 3,A03,894235,Staff,28,0,31,3
1746601707505,BILD 3,A04,894236,Staff,28,0,32,4
1746601708532,BILD 4,A01,894253,Reuther; Keefe,5,0,24,19
1746601708532,BILD 4,A02,894258,Reuther; Keefe,16,0,24,8
1746601709558,BILD 5,A01,894276,Reuther; Keefe,34,0,50,16
1746601709558,BILD 5,A02,894277,Reuther; Keefe,45,0,50,5
1746601709558,BILD 5,A03,894290,Reuther; Keefe,44,0,50,6
1746601709558,BILD 5,A04,894291,Reuther; Keefe,48,0,50,2
1746601710586,BILD 24,A01,894297,Pirino; Giorgia,40,0,60,20
1746601711616,BIMM 100,B01,958915,Staff,71,0,100,29
1746601712647,BIMM 101,A01,895017,McDonnell; Lisa Marie,0,5,24,24
1746601712647,BIMM 101,A02,895018,McDonnell; Lisa Marie,0,5,24,24
1746601712647,BIMM 101,B01,895020,McDonnell; Lisa Marie,0,5,24,24
1746601712647,BIMM 101,B02,895021,McDonnell; Lisa Marie,0,4,24,24
1746601713673,BIMM 110,A01,895023,Staff,1,0,25,24
1746601713673,BIMM 110,A02,895024,Staff,9,0,25,16
1746601713673,BIMM 110,A03,895025,Staff,18,0,25,7
1746601713673,BIMM 110,A04,895031,Staff,20,0,25,5
1746601714698,BIMM 120,A01,895114,Gustafson-Brown; Cindy,14,0,28,14
1746601714698,BIMM 120,A02,895126,Gustafson-Brown; Cindy,21,0,27,6
1746601715725,BIPN 100,A01,895130,Yang; Mingyu,0,0,38,38
1746601715725,BIPN 100,A02,895131,Yang; Mingyu,31,0,38,7
1746601715725,BIPN 100,A03,895132,Yang; Mingyu,32,0,38,6
1746601715725,BIPN 100,A04,895133,Yang; Mingyu,27,0,36,9
1746601716750,BIPN 120,A01,895135,Cooke; James Edward,0,3,13,13
1746601716750,BIPN 120,A02,895136,Cooke; James Edward,0,1,13,13
1746601716750,BIPN 120,A03,895137,Cooke; James Edward,0,3,13,13
1746601716750,BIPN 120,A04,895156,Cooke; James Edward,0,2,11,11
1746601717777,BIPN 134,A01,895235,Cooke; James Edward,0,1,25,25
1746601717777,BIPN 134,A02,895237,Cooke; James Edward,0,0,25,25
1746601717777,BIPN 134,A03,895240,Cooke; James Edward,1,0,25,24
1746601717777,BIPN 134,A04,895270,Cooke; James Edward,20,0,25,5
1746601718802,BIPN 189,A00,892103,Staff,0,14,14,14
1746601720859,BISP 194,A00,958008,Staff,0,2,0,0
1746601721890,CAT 124,A01,922009,Staff,0,5,20,20
1746601722916,CAT 125R,A00,886390,Morales; Celeste Georgianna,0,3,20,20
1746601722916,CAT 125R,B00,886391,Irwin; Matthew Joseph,0,4,20,20
1746601722916,CAT 125R,C00,886392,Smith; Lauryn Alissa,0,2,20,20
1746601722916,CAT 125R,D00,886393,Vanderschuit; Maya Alysia,0,3,20,20
1746601722916,CAT 125R,E00,886394,Marchisotto; Jennifer Anne,0,3,20,20
1746601723942,CENG 15,A01,886218,Drews; Aaron,3,0,8,5
1746601724972,CENG 113,A00,886219,Opatkiewicz; Justin Paul,15,0,25,10
1746601725997,CGS 101,A00,887044,Staff,7,0,20,13
1746601727026,CGS 105,A01,887046,Staff,14,0,25,11
1746601728051,CGS 112,A00,887047,Cuong; Marisol,12,0,15,3
1746601729078,CGS 113,A00,887048,Staff,23,0,30,7
1746601730105,CGS 120,A00,887049,Staff,9,0,17,8
1746601731132,CHEM 6A,A01,886336,Lam; Tin Yiu,38,0,50,12
1746601731132,CHEM 6A,A02,886338,Lam; Tin Yiu,37,0,50,13
1746601732158,CHEM 6B,A01,886341,Hopkins; Patrycja Anna,16,0,50,34
1746601732158,CHEM 6B,A02,886343,Hopkins; Patrycja Anna,42,0,50,8
1746601733187,CHEM 6C,A01,886346,Albizati; Kim F.,0,2,50,50
1746601733187,CHEM 6C,A02,886348,Albizati; Kim F.,24,0,50,26
1746601734214,CHEM 40A,A01,886352,Klosterman; Jeremy K,65,0,100,35
1746601735241,CHEM 40B,A01,886356,Klosterman; Jeremy K,0,24,100,100
1746601736275,CHEM 41B,A01,886360,Theodorakis; Emmanuel,25,0,50,25
1746601736275,CHEM 41B,A02,886362,Theodorakis; Emmanuel,47,0,50,3
1746601737300,CHIN 165A,A00,886382,Xu; Li,18,0,20,2
1746601738356,CLAS 120,A00,886387,Myerston Santana; Jacobo,33,0,40,7
1746601739384,COGS 9,A01,886967,Shannon; Kyle Michael,42,0,60,18
1746601740412,COGS 11,A01,886969,Staff,9,0,30,21
1746601741438,COGS 14A,A01,886971,Staff,5,0,60,55
1746601742461,COGS 14B,A01,886973,Hoffman; Drew Ellen,4,0,60,56
1746601743489,COGS 18,A01,886975,Morgan; Eric,34,0,60,26
1746601744516,COGS 20,A01,886977,Staff,3,0,8,5
1746601744516,COGS 20,A02,886978,Staff,5,0,7,2
1746601745541,COGS 100,A01,907783,Staff,0,1,30,30
1746601746567,COGS 101B,A01,886980,Staff,0,4,48,48
1746601747593,COGS 101C,A01,886982,Delgado; Tania,0,5,44,44
1746601748626,COGS 102A,A01,886984,Johnson; Christine M.,3,0,30,27
1746601749654,COGS 118B,A01,886986,Staff,0,4,88,88
1746601750679,COGS 150,A01,886988,Bergen; Benjamin,22,0,50,28
1746601751703,COGS 153,A00,886989,Delgado; Tania,0,3,41,41
1746601752731,COGS 186,A01,886991,Staff,0,0,32,32
1746601753756,COGS 187A,A01,886993,Boyle; Mary E. T.,7,0,30,23
1746601754786,COGS 189,A00,886994,Staff,0,1,30,30
1746601755816,COMM 10,A01,886996,Staff,0,0,20,21
1746601755816,COMM 10,A02,886997,Staff,10,0,20,10
1746601755816,COMM 10,A03,959845,Staff,19,0,20,1
1746601756842,COMM 20,A01,886999,Leuning; Grant Maurstad,24,0,40,16
1746601758901,COMM 100A,A01,887002,Staff,0,0,20,25
1746601758901,COMM 100A,A02,887003,Staff,5,0,20,15
1746601759926,COMM 100B,A01,887005,Staff,0,8,20,24
1746601760954,COMM 106D,A00,887006,Staff,14,0,40,26
1746601761983,COMM 110G,A00,887007,Whitworth-Smith; Andrew C,12,0,40,28
1746601763009,COMM 111B,A00,887008,Staff,31,0,40,9
1746601764036,COMM 113T,A00,887009,Abuelhiga; Soraya Jill,28,0,40,12
1746601764036,COMM 113T,B00,906733,Staff,39,0,40,1
1746601765064,COMM 145,A00,887010,Staff,13,0,40,27
1746601766088,COMM 146,A00,887054,Staff,32,0,40,8
1746601767116,COMM 190,A00,887012,Staff,8,0,23,15
1746601768141,CSE 8A,A50,887015,Cao; Yingjun,56,0,85,29
1746601769166,CSE 11,A01,887017,Cao; Yingjun,11,0,70,59
1746601770196,CSE 20,A01,887019,Staff,30,0,50,20
1746601771219,CSE 21,A01,887021,Staff,79,0,100,21
1746601771219,CSE 21,B01,892583,Braun; Oliver,45,0,50,5
1746601772244,CSE 30,A01,887025,Eldon; John,142,0,200,58
1746601773271,CSE 100,A01,887027,Staff,26,0,50,24
1746601773271,CSE 100,A02,887028,Staff,42,0,50,8
1746601774297,CSE 101,A01,887030,Braun; Oliver,74,0,100,26
1746601774297,CSE 101,B01,887032,Jones; Miles E,0,3,50,50
1746601774297,CSE 101,B02,887033,Jones; Miles E,0,2,50,50
1746601775322,CSE 105,A01,908084,Jones; Miles E,32,0,50,18
1746601775322,CSE 105,A02,908087,Jones; Miles E,31,0,50,19
1746601776348,CSE 135,A01,887035,Powell; Thomas Allan,0,5,50,50
1746601777376,CSE 142,A01,887037,Staff,8,0,60,52
1746601778401,CSE 142L,A01,887039,Staff,34,0,60,26
1746601779474,CSE 151A,A01,887041,Solares; Edwin A,47,0,100,53
1746601780524,CSE 175,A01,887043,Kumar; Rakesh,30,0,30,0
1746601781551,CSS 1,A01,886389,Staff,0,1,40,40
1746601782581,DSC 30,A01,908097,Liao; Soohyun Nam,47,0,75,28
1746601783605,DSC 40A,A01,908099,Shannon; Kyle Michael,30,0,50,20
1746601784630,DSC 40B,A01,908112,Staff,15,0,50,35
1746601785654,DSC 80,A01,908116,Staff,19,0,60,41
1746601786680,DSC 197,001,956863,Eldridge; Justin Matthew,9999,0,9999,0
1746601787704,ECE 5,A01,886400,Morris; Karcher William,1,0,6,5
1746601787704,ECE 5,A02,886401,Morris; Karcher William,3,0,6,3
1746601788729,ECE 148,A01,886403,Silberman; Jack,0,14,14,14
1746601789755,ECON 1,A01,887265,Crane; Meredith Helen,11,0,70,59
1746601789755,ECON 1,B01,887268,Staff,42,0,50,8
1746601790786,ECON 2,A01,887273,Crane; Meredith Helen,54,0,70,16
1746601791814,ECON 3,A01,887279,Rondina; Giacomo,31,0,70,39
1746601792842,ECON 4,A01,887282,Anderson; John Charles,0,2,10,10
1746601793873,ECON 5,A01,887285,Staff,34,0,45,11
1746601793873,ECON 5,B01,887292,Staff,41,0,45,4
1746601794905,ECON 100A,A01,887337,Newhouse; Herbert S,54,0,70,16
1746601794905,ECON 100A,B01,887349,Staff,45,0,50,5
1746601795934,ECON 100B,A01,887361,Du; Songzi,29,0,70,41
1746601796969,ECON 100C,A01,887445,Newhouse; Herbert S,59,0,70,11
1746601797996,ECON 105,A00,887488,Vespa; Emanuel Ignacio,23,0,35,12
1746601799025,ECON 109,A01,887506,Shishkin; Denis,28,0,35,7
1746601800058,ECON 110A,A01,887568,Alon; Titan Michael,0,2,35,35
1746601800058,ECON 110A,B01,907601,Alon; Titan Michael,20,0,35,15
1746601801085,ECON 110B,A01,887598,Levkoff; Steven B.,0,24,70,70
1746601802116,ECON 112,A00,887599,Rondina; Giacomo,19,0,35,16
1746601803194,ECON 120A,A01,887603,Dai; Yinlin,36,0,70,34
1746601804220,ECON 120C,A01,887608,Sun; Yixiao,0,1,35,35
1746601804220,ECON 120C,B01,887614,Sun; Yixiao,0,0,35,35
1746601805246,ECON 138,A00,887621,Bharadwaj; Prashant,0,21,20,20
1746601806276,ECON 144,A00,958007,Squires; Dale E,12,0,35,23
1746601807301,ECON 171,A01,907666,Staff,18,0,35,17
1746601808327,ECON 175,A00,887626,Wu; Pak Yeung,22,0,35,13
1746601809356,ECON 190,A00,887640,Vespa; Emanuel Ignacio,22,0,35,13
1746601810383,EDS 25,A01,888197,Staff,0,0,0,0
1746601810383,EDS 25,A02,888209,Staff,0,0,0,0
1746601810383,EDS 25,A03,888210,Staff,0,0,0,0
1746601810383,EDS 25,A04,888212,Staff,0,0,0,0
1746601810383,EDS 25,A05,888213,Staff,0,0,0,0
1746601810383,EDS 25,A06,888214,Staff,0,0,0,0
1746601810383,EDS 25,A07,888235,Staff,0,2,0,0
1746601810383,EDS 25,A08,888236,Staff,0,0,0,0
1746601810383,EDS 25,A09,888240,Staff,0,0,0,0
1746601810383,EDS 25,A10,888244,Staff,0,0,0,0
1746601810383,EDS 25,B01,888273,Staff,0,0,0,0
1746601810383,EDS 25,B02,888285,Staff,0,0,0,0
1746601810383,EDS 25,B03,888423,Staff,0,0,0,1
1746601810383,EDS 25,B04,888432,Staff,0,0,0,0
1746601810383,EDS 25,B05,888433,Staff,0,0,0,0
1746601810383,EDS 25,B06,888467,Staff,0,0,0,0
1746601810383,EDS 25,B07,888468,Staff,0,0,0,0
1746601810383,EDS 25,B08,888479,Staff,0,0,0,0
1746601810383,EDS 25,B09,888484,Staff,0,0,0,0
1746601810383,EDS 25,B10,888487,Staff,0,0,0,0
1746601811413,EDS 38,A01,907700,Choi; Bailey Miyeon,30,0,30,0
1746601812438,EDS 112,A01,888601,Chapman; Thandeka K,12,0,40,28
1746601813464,EDS 115,A00,888697,Mendez; Kathrina Mendoza,10,0,30,20
1746601814496,EDS 116,A01,888893,Staff,33,0,40,7
1746601816548,EDS 124AR,A00,889133,Staff,29,0,50,21
1746601816548,EDS 124AR,B00,907471,Simon; Elizabeth A,37,0,50,13
1746601817575,EDS 124BR,A00,889134,Simon; Elizabeth A,44,0,100,56
1746601818600,EDS 125,A00,889135,Staff,25,0,30,5
1746601819629,EDS 126,A01,889138,Staff,35,0,40,5
1746601820655,EDS 164R,A01,889142,Wishard Guerra; Alison G.,32,0,50,18
1746601821685,ENG 30,A01,886396,Staff,0,0,0,0
1746601821685,ENG 30,B01,886398,Staff,0,0,0,0
1746601822715,ENVR 102,A00,906150,Montejo; Carolina,23,0,25,2
1746601823745,ETHN 103A,A00,887236,Man; Simeon S,0,2,0,0
1746601824771,ETHN 113,A00,887239,Staff,16,0,30,14
1746601825796,ETHN 116,A00,887240,Staff,16,0,25,9
1746601826826,ETHN 117,A00,887241,Choi; Esther Min,28,0,30,2
1746601827855,ETHN 118,A00,887243,Staff,24,0,30,6
1746601828881,ETHN 127,A00,887248,Cuong; Marisol,11,0,15,4
1746601829906,ETHN 139,A00,887250,Staff,7,0,10,3
1746601830936,ETHN 142,A00,887252,Staff,9,0,30,21
1746601831966,ETHN 161,A00,887253,Browne; Errol Tsekani,24,0,30,6
1746601832992,ETHN 163FR,A00,887255,Burelle; Julie Sara Veronique,0,0,5,5
1746601834017,GLBH 20,A00,889149,Elwardani; Nile Regina,8,0,42,34
1746601836073,GLBH 111,A01,889152,Burgos; Jose L.,17,0,17,0
1746601837102,GLBH 150,A00,889181,Sloane; Julia Kathryn,0,5,15,15
1746601839153,HDS 60,A01,886406,Warstadt; Melissa Fawn,72,0,80,8
1746601840180,HIAF 111,A00,889324,Gyamfi; Bright,25,0,32,7
1746601841207,HIEA 131,A00,889328,Staff,15,0,32,17
1746601842237,HIEA 144,A00,889333,Henry; Todd A.,26,0,32,6
1746601843267,HIEA 154,A00,889336,Henry; Todd A.,24,0,32,8
1746601844291,HIEU 106,A00,889339,Staff,22,0,32,10
1746601846347,HIEU 114,A00,889340,Staff,4,0,32,28
1746601847378,HIEU 135GS,A00,889342,Patterson; Patrick H.,0,0,1,24
1746601848403,HIEU 137,A00,889343,Edington; Claire Ellen,10,0,25,15
1746601849429,HIEU 148,A00,889345,Staff,14,0,32,18
1746601850458,HIEU 154,A00,889346,Biess; Frank Peter,21,0,32,11
1746601851484,HILA 102,A00,889351,Staff,12,0,32,20
1746601852509,HILD 2A,A01,889221,Lewandoski; Julia Mavis,0,8,32,32
1746601853534,HILD 7B,A01,889225,Man; Simeon S,0,12,32,32
1746601854565,HILD 7C,A01,889288,Alvarez; Luis A,0,14,32,32
1746601855590,HILD 30,A01,889323,Staff,0,5,32,32
1746601857645,HISC 119,A00,889383,Golan; Tal,20,0,32,12
1746601858675,HIUS 103,A00,889384,Man; Simeon S,0,0,32,32
1746601859703,HIUS 117,A00,919797,Kwak; Nancy,18,0,32,14
1746601860735,HIUS 142A,A00,919788,Staff,22,0,32,10
1746601862787,HIUS 149,A00,889386,Gyamfi; Bright,26,0,32,6
1746601863817,HIUS 155,A00,889387,Alvarez; Luis A,15,0,32,17
1746601864851,HUM 3,A01,886499,Caldwell; Michael Alan,19,0,50,31
1746601865882,HUM 3GS,A00,886500,Rodriguez; Bretton Sigfred,0,0,0,28
1746601866908,HUM 3R,A01,886502,Markman; Kristina,0,36,50,50
1746601867941,HUM 4,A01,886504,Crum; Matthew Stephen,23,0,50,27
1746601867941,HUM 4,B01,886506,West; Geoffrey Scott,17,0,50,33
1746601868968,HUM 4GS,A00,886507,Staff,0,0,0,19
1746601869995,HUM 5,A01,886509,Staff,31,0,50,19
1746601871021,HUM 5R,A01,886511,Zavodny; Tatiana Sophia,0,39,50,50
1746601872047,JAPN 180,A00,886407,Staff,16,0,40,24
1746601873073,LATI 50,A01,886409,Martin-Cabrera; Luis,3,0,22,19
1746601873073,LATI 50,A02,886410,Martin-Cabrera; Luis,19,0,22,3
1746601873073,LATI 50,A03,886411,Martin-Cabrera; Luis,21,0,22,1
1746601873073,LATI 50,A04,886412,Martin-Cabrera; Luis,8,0,22,14
1746601874110,LAWS 101,A00,907664,Staff,28,0,60,32
1746601875136,LIAB 1A,A00,889388,Saab; Dima,17,0,20,3
1746601876163,LIAB 1AX,A00,889389,El Cheddadi; Youniss,18,0,20,2
1746601877188,LIFR 1C,A00,889391,Van Moer; Vinciane G,8,0,20,12
1746601878214,LIFR 1CX,A00,889392,Van Moer; Vinciane G,7,0,20,13
1746601879245,LIFR 1D,A00,889393,Van Moer; Vinciane G,7,0,20,13
1746601880272,LIFR 1DX,A00,889394,Van Moer; Vinciane G,8,0,20,12
1746601881302,LIGN 7,A00,886923,Staff,25,0,50,25
1746601882327,LIGN 17,A00,886924,Kehler; Andrew Scott,126,0,150,24
1746601883357,LTAM 110,A00,889395,Staff,15,0,30,15
1746601884387,LTAM 110GS,A00,958010,Rodriguez; Bretton Sigfred,0,0,0,28
1746601885414,LTCH 101,A00,889397,Staff,23,0,25,2
1746601886440,LTCS 130,A00,889398,Staff,23,0,25,2
1746601887469,LTEA 138,A00,889399,Staff,24,0,40,16
1746601888501,LTEN 149,A00,889400,Wesling; Megan E.,0,3,25,25
1746601889530,LTEN 169,A00,889401,Staff,20,0,25,5
1746601890561,LTEN 180,A00,889402,Staff,10,0,15,5
1746601891589,LTEN 181,A00,889403,Staff,21,0,25,4
1746601892619,LTWL 100,A00,889404,Myerston Santana; Jacobo,2,0,25,23
1746601893650,LTWL 180GS,A00,889405,Staff,0,0,20,20
1746601894675,LTWL 181,A00,889406,Staff,16,0,25,9
1746601895701,LTWL 184,A00,889475,Mukherjee; Silpa,22,0,25,3
1746601896727,LTWR 102C,A00,889486,Staff,29,0,30,1
1746601897757,LTWR 115W,A00,889491,Staff,0,2,15,15
1746601898785,MAE 8,A01,886905,Staff,0,2,0,0
1746601899816,MAE 11,A00,886906,Bandaru; Prabhakar,0,7,50,50
1746601900842,MAE 20,A00,886907,Evdokimenko; Ekaterina,43,0,70,27
1746601901870,MAE 30B,A00,886909,Ghazinejad; Maziar,25,0,45,20
1746601902900,MAE 101B,A00,886910,Saintillan; David,30,0,45,15
1746601903926,MAE 105,A00,886911,Bandaru; Prabhakar,18,0,50,32
1746601904953,MAE 107,B00,958024,Staff,7,0,50,43
1746601905979,MAE 143B,A00,886913,Bewley; Thomas R,2,0,40,38
1746601907044,MAE 148,A01,886915,Silberman; Jack,0,3,14,14
1746601908072,MAE 160,A00,886916,Evdokimenko; Ekaterina,30,0,60,30
1746601909100,MATH 3C,A01,889681,Staff,0,2,30,30
1746601909100,MATH 3C,A02,960048,Staff,23,0,30,7
1746601910132,MATH 10A,A01,889760,Staff,26,0,30,4
1746601910132,MATH 10A,A02,889783,Staff,29,0,30,1
1746601911161,MATH 10B,A01,889785,Verstraete; Jacques Allan,1,0,35,34
1746601911161,MATH 10B,A02,889795,Verstraete; Jacques Allan,4,0,35,31
1746601911161,MATH 10B,B01,889797,Verstraete; Jacques Allan,3,0,35,32
1746601911161,MATH 10B,B02,889828,Verstraete; Jacques Allan,3,0,35,32
1746601912189,MATH 10C,A01,889849,Habib; Yousaf,8,0,30,22
1746601912189,MATH 10C,A02,889852,Habib; Yousaf,14,0,30,16
1746601912189,MATH 10C,A03,889853,Habib; Yousaf,22,0,30,8
1746601912189,MATH 10C,A04,889858,Habib; Yousaf,20,0,30,10
1746601912189,MATH 10C,B01,889861,Staff,1,0,30,29
1746601912189,MATH 10C,B02,889862,Staff,24,0,30,6
1746601912189,MATH 10C,B03,889863,Staff,27,0,30,3
1746601912189,MATH 10C,B04,889967,Staff,23,0,30,7
1746601913217,MATH 18,A01,889974,Staff,7,0,30,23
1746601913217,MATH 18,A02,889977,Staff,20,0,30,10
1746601913217,MATH 18,B01,889984,Hardiman; Liam,20,0,30,10
1746601913217,MATH 18,B02,889985,Hardiman; Liam,25,0,30,5
1746601914250,MATH 20A,A01,889990,Suk; Andrew Hoon,30,0,35,5
1746601915277,MATH 20B,A01,889993,Ohm; Ko Woon,21,0,30,9
1746601915277,MATH 20B,A02,889994,Ohm; Ko Woon,30,0,30,0
1746601915277,MATH 20B,B01,889996,Ohm; Ko Woon,22,0,30,8
1746601915277,MATH 20B,B02,889997,Ohm; Ko Woon,23,0,30,7
1746601916305,MATH 20C,A01,889999,Hammock; Frances H,17,0,30,13
1746601916305,MATH 20C,A02,890003,Hammock; Frances H,23,0,30,7
1746601916305,MATH 20C,B01,890006,Hammock; Frances H,2,0,30,28
1746601916305,MATH 20C,B02,890007,Hammock; Frances H,12,0,30,18
1746601917334,MATH 20D,A01,890011,Cheng; Hsiao-Bing,1,0,30,29
1746601917334,MATH 20D,A02,890012,Cheng; Hsiao-Bing,14,0,30,16
1746601917334,MATH 20D,B01,890016,Cheng; Hsiao-Bing,13,0,30,17
1746601917334,MATH 20D,B02,890017,Cheng; Hsiao-Bing,13,0,30,17
1746601918362,MATH 20E,A01,890026,Harel; Guershon,1,0,30,29
1746601918362,MATH 20E,A02,890029,Harel; Guershon,22,0,30,8
1746601918362,MATH 20E,B01,890033,Harel; Guershon,7,0,30,23
1746601918362,MATH 20E,B02,890101,Harel; Guershon,21,0,30,9
1746601919391,MATH 102,A01,890104,Staff,18,0,30,12
1746601919391,MATH 102,A02,890105,Staff,27,0,30,3
1746601920423,MATH 103B,A01,890116,Salehi Golsefidy; Alireza,3,0,30,27
1746601920423,MATH 103B,B01,890118,Staff,0,3,34,34
1746601921449,MATH 109,A01,890121,Aliabadi Sr.; Mohsen,0,0,30,30
1746601921449,MATH 109,B01,890124,Upadrashta; Pranav Kumar,18,0,30,12
1746601922482,MATH 120A,A01,890126,Eggers; John Dietrich,13,0,30,17
1746601923512,MATH 142B,A01,890128,Ioana; Adrian,19,0,30,11
1746601923512,MATH 142B,A02,890129,Ioana; Adrian,12,0,30,18
1746601924537,MATH 154,A01,890174,Staff,0,1,30,30
1746601924537,MATH 154,A02,890182,Staff,0,0,30,30
1746601925564,MATH 168A,A01,890197,Dumitriu; Ioana,21,0,35,14
1746601926590,MATH 170A,A01,890240,Nie; Jiawang,1,0,30,29
1746601926590,MATH 170A,A02,890241,Nie; Jiawang,11,0,30,19
1746601926590,MATH 170A,A03,890249,Nie; Jiawang,23,0,30,7
1746601927617,MATH 170B,A01,957891,Nag; Panchali,13,0,35,22
1746601929677,MATH 181A,A01,908025,Staff,0,3,35,35
1746601929677,MATH 181A,A02,960115,Staff,26,0,35,9
1746601930705,MATH 181B,A01,959874,Staff,24,0,30,6
1746601931737,MATH 193B,A01,890265,Staff,0,4,35,35
1746601932766,MGT 4,A01,890311,Anderson; John Charles,42,0,88,46
1746601933794,MGT 5,A00,907740,Staff,12,0,98,86
1746601934820,MGT 12,A00,890312,Lindenberger; Wade Douglas,67,0,98,31
1746601935852,MGT 16,A00,957883,Staff,78,0,98,20
1746601937912,MGT 45,A00,890314,Pecore; Joseph P.,45,0,98,53
1746601938937,MGT 71,A00,890315,Staff,0,12,98,98
1746601939972,MGT 100,A00,890316,Yavorsky; Daniel Ryan,44,0,98,54
1746601940998,MGT 103,A00,890317,Ehrich; Kristine R,73,0,98,25
1746601942029,MGT 105,A00,890356,Bates; Kenneth Walter,0,8,98,98
1746601943059,MGT 112,A00,890360,Ehrich; Kristine R,55,0,98,43
1746601944091,MGT 127R,A00,907732,Zhu; Kevin Xiaoguo,23,0,98,75
1746601945125,MGT 131B,A00,890361,Anderson; John Charles,59,0,98,39
1746601946156,MGT 137,A00,890362,Lindenberger; Wade Douglas,65,0,98,33
1746601947182,MGT 160,A00,890369,Johnson; Erik Barry,9,0,98,89
1746601949241,MGT 164,A00,890372,Zimmermann; Carsten,0,40,98,98
1746601950274,MGT 180,A00,890374,Bliss; Barbara Ann,11,0,98,87
1746601951304,MMW 15,A01,886414,Chang; Edmond Yi-Teh,0,12,28,28
1746601951304,MMW 15,A02,886415,Chang; Edmond Yi-Teh,0,8,28,28
1746601951304,MMW 15,A03,886416,Chang; Edmond Yi-Teh,0,9,28,28
1746601951304,MMW 15,A04,886417,Chang; Edmond Yi-Teh,0,8,28,28
1746601951304,MMW 15,B01,886419,Chang; Edmond Yi-Teh,0,7,28,28
1746601951304,MMW 15,B02,886420,Chang; Edmond Yi-Teh,0,7,28,28
1746601951304,MMW 15,B03,886421,Chang; Edmond Yi-Teh,0,7,28,28
1746601951304,MMW 15,B04,886422,Chang; Edmond Yi-Teh,0,8,28,28
1746601951304,MMW 15,C01,886424,Staff,0,9,28,28
1746601951304,MMW 15,C02,886425,Staff,0,8,28,28
1746601951304,MMW 15,C03,886426,Staff,0,8,28,28
1746601951304,MMW 15,C04,886427,Staff,0,8,28,28
1746601951304,MMW 15,C05,958038,Staff,0,8,28,28
1746601951304,MMW 15,C06,958039,Staff,0,7,28,28
1746601952334,MMW 15GS,A00,906910,Patterson; Patrick H.,4,0,28,24
1746601953366,MMW 122R,A01,886429,Rahimi; Babak,0,13,28,28
1746601953366,MMW 122R,A02,886430,Rahimi; Babak,0,12,28,28
1746601953366,MMW 122R,A03,958040,Rahimi; Babak,0,11,28,28
1746601954394,MUS 1A,A01,890937,Staff,2,0,25,23
1746601954394,MUS 1A,A02,891035,Staff,6,0,25,19
1746601954394,MUS 1A,C01,958912,Staff,24,0,25,1
1746601954394,MUS 1A,C02,958913,Staff,25,0,25,0
1746601956451,MUS 2AK,A00,957092,Ohnishi; Takae,15,0,15,0
1746601957483,MUS 4,A01,891044,Staff,0,0,25,25
1746601957483,MUS 4,A02,891045,Staff,22,0,25,3
1746601957483,MUS 4,B01,891048,Staff,17,0,25,8
1746601957483,MUS 4,B02,891050,Staff,25,0,25,0
1746601958511,MUS 5,A01,957506,Dubnov; Shlomo,0,0,25,25
1746601958511,MUS 5,A02,957622,Dubnov; Shlomo,12,0,25,13
1746601958511,MUS 5,A03,957623,Dubnov; Shlomo,20,0,25,5
1746601959538,MUS 6,A01,891053,Freitas Caetano; Marcelo,24,0,25,1
1746601959538,MUS 6,A02,891054,Freitas Caetano; Marcelo,23,0,25,2
1746601960569,MUS 7,A01,891081,Staff,0,0,25,25
1746601960569,MUS 7,A02,891082,Staff,3,0,25,22
1746601961599,MUS 8GS,A00,891118,Borgo; David Garcia,1,0,25,24
1746601962631,MUS 11,A01,891140,Staff,8,0,25,17
1746601962631,MUS 11,A02,891141,Staff,21,0,25,4
1746601963658,MUS 13,A01,891143,Staff,8,0,25,17
1746601963658,MUS 13,A02,891144,Staff,24,0,25,1
1746601964689,MUS 15,A01,891146,Staff,9,0,25,16
1746601964689,MUS 15,A02,891148,Staff,21,0,25,4
1746601964689,MUS 15,B01,891150,Staff,18,0,25,7
1746601964689,MUS 15,B02,891151,Staff,25,0,25,0
1746601965729,MUS 20,A01,891153,Staff,5,0,20,15
1746601965729,MUS 20,A02,891155,Staff,14,0,20,6
1746601966761,MUS 80,A00,891156,Staff,19,0,25,6
1746601966761,MUS 80,B00,891157,Staff,23,0,25,2
1746601967794,MUS 130,A00,891158,Ohnishi; Takae,35,0,35,0
1746601968830,MUS 150GS,A01,891160,Borgo; David Garcia,1,0,25,24
1746601969861,MUS 170,A01,891162,Freitas Caetano; Marcelo,20,0,25,5
1746601969861,MUS 170,A02,891164,Freitas Caetano; Marcelo,21,0,25,4
1746601970891,NANO 11,A00,886220,Vazquez Mena; Oscar,13,0,15,2
1746601971923,NANO 15,A01,886222,Drews; Aaron,4,0,7,3
1746601973499,NANO 104,A00,886224,Sirbuly; Donald,17,0,25,8
1746601974528,PH 40,A00,886528,Staff,23,0,40,17
1746601975555,PH 45,A01,886799,Staff,35,0,40,5
1746601976582,PH 110,A00,886802,Staff,0,6,40,40
1746601977615,PH 172,A00,906716,Staff,19,0,35,16
1746601978645,PH 191,A00,886803,Staff,6,0,40,34
1746601979687,PHIL 1,A00,889500,Staff,20,0,30,10
1746601980718,PHIL 10,A01,889549,Grush; Rick Scott,16,0,22,6
1746601980718,PHIL 10,A02,889551,Grush; Rick Scott,22,0,22,0
1746601981750,PHIL 28,A01,889559,Lamey; Andy M.,0,2,31,31
1746601981750,PHIL 28,A02,889561,Lamey; Andy M.,0,1,30,30
1746601981750,PHIL 28,A03,889572,Lamey; Andy M.,0,1,30,30
1746601982777,PHIL 35,A00,907839,Staff,13,0,15,2
1746601983812,PHIL 60,A00,889574,Staff,73,0,90,17
1746601984849,PHIL 101,A00,958004,Staff,12,0,15,3
1746601986918,PHIL 136,A00,889582,Fulkerson; Matthew Todd,26,0,45,19
1746601987947,PHIL 163,A01,889601,Staff,21,0,30,9
1746601987947,PHIL 163,B01,889606,Brandt; Reuven A,0,3,0,0
1746601988976,PHIL 164,A00,889610,Staff,16,0,30,14
1746601990005,PHIL 165,A00,889613,Staff,22,0,30,8
1746601991042,PHYS 1A,A00,886431,Staff,30,0,70,40
1746601992070,PHYS 1AL,001,886432,Tsai; Philbert S,0,1,30,30
1746601992070,PHYS 1AL,002,886436,Tsai; Philbert S,13,0,30,17
1746601993113,PHYS 1B,A00,886439,Staff,184,0,240,56
1746601994143,PHYS 1BL,001,886441,Tsai; Philbert S,0,4,30,30
1746601994143,PHYS 1BL,002,886444,Tsai; Philbert S,2,0,30,28
1746601995172,PHYS 1C,A00,896092,Arnold; Kam S,78,0,146,68
1746601996201,PHYS 1CL,001,886448,Tsai; Philbert S,0,0,30,30
1746601996201,PHYS 1CL,002,886449,Tsai; Philbert S,1,0,30,29
1746601996201,PHYS 1CL,003,886450,Tsai; Philbert S,16,0,30,14
1746601996201,PHYS 1CL,004,886451,Tsai; Philbert S,15,0,30,15
1746601997237,PHYS 2B,A01,886457,Staff,67,0,115,48
1746601998266,PHYS 2C,A01,886460,Shotwell; Brian,0,9,65,65
1746601999304,PHYS 2CL,A01,886467,Staff,0,4,28,28
1746601999304,PHYS 2CL,A02,886468,Staff,0,3,28,28
1746602000334,PHYS 2D,A01,886470,Staff,10,0,50,40
1746602001360,PHYS 4B,A01,886475,Grinstein; Benjamin,22,0,40,18
1746602002392,POLI 5,A00,891173,Desposato; Scott,7,0,25,18
1746602003428,POLI 5D,A01,891175,Staff,5,0,5,0
1746602003428,POLI 5D,B01,891178,Staff,5,0,5,0
1746602004461,POLI 11,A00,891179,Ferree; Karen E,0,0,35,35
1746602005488,POLI 12,A00,891180,Staff,15,0,30,15
1746602006517,POLI 27,A01,891182,Staff,11,0,75,64
1746602007549,POLI 30,A00,891183,Staff,8,0,50,42
1746602008583,POLI 100B,A00,891244,Staff,5,1,35,30
1746602009613,POLI 100I,A00,891247,Staff,7,0,30,23
1746602010638,POLI 104J,A00,891248,Nichter; Maysa,14,0,30,16
1746602011668,POLI 104U,A00,891250,Nichter; Maysa,1,0,30,29
1746602013725,POLI 110B,A00,891255,Wiens; David,19,0,25,6
1746602014766,POLI 112A,A00,891256,Wiens; David,6,0,25,19
1746602015797,POLI 114BR,A00,891261,Staff,19,0,30,11
1746602016835,POLI 117R,A00,891262,Forman; Fonna,0,6,50,50
1746602017862,POLI 118,A00,891264,Ingham; Sean,17,0,25,8
1746602018892,POLI 124A,A00,891265,Staff,18,0,20,2
1746602019920,POLI 125D,A00,891266,Nichter; Simeon C,2,0,25,23
1746602020948,POLI 126,A00,891268,Nichter; Simeon C,7,0,25,18
1746602021980,POLI 126AA,A00,891272,Staff,15,0,25,10
1746602023007,POLI 130AA,A00,891273,Staff,15,0,20,5
1746602024041,POLI 134AA,A00,891274,Staff,4,0,20,16
1746602026097,POLI 138,A00,891278,Staff,21,0,25,4
1746602027133,POLI 142K,A00,891280,Staff,10,0,25,15
1746602028160,POLI 142M,A00,891281,Gartzke; Erik,16,0,30,14
1746602029188,POLI 142P,A00,891284,Staff,20,0,30,10
1746602030215,POLI 143,A00,891285,Gartzke; Erik,12,0,30,18
1746602031244,POLI 153,A00,891286,Staff,19,0,20,1
1746602033302,POLI 175,A00,891290,Staff,15,0,20,5
1746602034339,PSYC 1,A00,890674,Steiner; Eric Tomas,0,11,45,45
1746602035367,PSYC 2,A00,890676,Albright; Thomas D,20,0,35,15
1746602036393,PSYC 3,A00,890679,Staff,17,0,20,3
1746602037420,PSYC 6,A00,959858,Staff,19,0,20,1
1746602038451,PSYC 60,A01,890684,Rickard; Timothy C.,0,6,45,45
1746602039477,PSYC 70,A01,890689,Geller; Emma Harlan,6,0,30,24
1746602040504,PSYC 71,A01,959860,Staff,21,0,25,4
1746602041532,PSYC 100,A00,890690,Lacefield; Katharine I,0,50,180,180
1746602042557,PSYC 102,A00,890695,Staff,18,0,40,22
1746602043584,PSYC 105,A00,890699,Geller; Emma Harlan,70,0,100,30
1746602044611,PSYC 106,A00,890701,Gorman; Michael R.,5,0,30,25
1746602045638,PSYC 108,A00,890704,Adrian; Julia Anna,0,29,50,50
1746602046671,PSYC 118,A01,890712,Staff,11,0,30,19
1746602047699,PSYC 124,A00,890716,Chapman; Eddie Nathaniel,25,0,60,35
1746602048727,PSYC 131,A00,890717,Anagnostaras; Stephan,0,7,80,80
1746602049757,PSYC 137,A00,890719,Winkielman; Piotr,0,11,30,30
1746602050784,PSYC 144,A00,890721,Adrian; Julia Anna,0,9,45,45
1746602051814,PSYC 162,A00,890805,Staff,0,1,75,75
1746602052844,PSYC 169,A00,890810,Staff,0,15,30,30
1746602053872,PSYC 172,A00,890814,Gorman; Michael R.,9,0,30,21
1746602054899,PSYC 181,A00,890818,Anagnostaras; Stephan,7,0,200,193
1746602055933,PSYC 184,A00,959861,Staff,162,0,175,13
1746602056963,PSYC 189,A00,890823,Staff,0,2,30,30
1746602057993,PSYC 191,A00,890884,Rickard; Timothy C.,0,11,35,35
1746602059024,PSYC 193,A00,890913,Staff,19,0,30,11
1746602059024,PSYC 193,B00,890914,Chapman; Eddie Nathaniel,24,0,30,6
1746602060068,PSYC 193L,A01,890918,Lowe; Angela Beth,20,0,30,10
1746602060068,PSYC 193L,B01,890921,Hurwitz; Ethan Scott,20,0,30,10
1746602060068,PSYC 193L,C01,890928,Staff,30,0,30,0
1746602061100,RELI 149,A00,886806,Rahimi; Babak,23,0,40,17
1746602062126,SE 9,A01,886814,Staff,7,0,20,13
1746602063156,SE 101B,A01,886816,Chadha; Mayank,3,0,35,32
1746602064184,SE 110B,A00,886818,Zhu; Qiang,4,0,75,71
1746602065212,SE 125,A01,886830,Staff,10,0,30,20
1746602066238,SE 130B,A01,886835,Staff,14,0,40,26
1746602067271,SE 131A,A01,886838,Krysl; Petr,34,0,55,21
1746602068298,SE 154,A00,886840,Staff,28,0,50,22
1746602069328,SE 164GS,A01,886849,Staff,6,0,20,14
1746602070357,SE 167GS,A01,886853,Staff,6,0,20,14
1746602071388,SIO 25,A01,890107,Staff,19,0,30,11
1746602072414,SIO 45,A00,890109,Cook; Geoffrey W,115,0,200,85
1746602073441,SIO 109R,A00,890110,Forman; Fonna,0,16,20,20
1746602074466,SIO 187,A01,890114,Kacev; David,15,0,40,25
1746602075497,SOCI 1,A01,890431,Thorpe; Charles Robert,14,0,30,16
1746602075497,SOCI 1,A02,890518,Thorpe; Charles Robert,30,0,30,0
1746602076524,SOCI 2,A01,957978,Staff,25,0,25,0
1746602076524,SOCI 2,A02,957979,Staff,23,0,25,2
1746602077552,SOCI 20,A01,890523,Calderon-Zaks; Michael Aar,21,0,30,9
1746602077552,SOCI 20,A02,890526,Calderon-Zaks; Michael Aar,29,0,30,1
1746602078582,SOCI 30,A01,890533,Pardo Guerra; Juan Pablo,37,0,40,3
1746602079608,SOCI 40,A01,890535,Staff,27,0,45,18
1746602080636,SOCI 104Q,A00,890559,Staff,18,0,30,12
1746602081663,SOCI 106,A00,890560,Arnal; Maud Marie Leonie,20,0,30,10
1746602082694,SOCI 110,A00,890567,Holkenbrink-Monk; Charlene,19,0,30,11
1746602083726,SOCI 112,A00,890568,Victoria Torres; Pablo,2,0,55,53
1746602084755,SOCI 115,A00,890597,Arnal; Maud Marie Leonie,28,0,45,17
1746602086809,SOCI 121,A00,890604,Pardo Guerra; Juan Pablo,38,0,45,7
1746602087839,SOCI 126,A01,890608,Staff,8,0,10,2
1746602088868,SOCI 127,A00,890609,Staff,18,0,30,12
1746602089898,SOCI 131,A00,890610,Thorpe; Charles Robert,37,0,45,8
1746602090924,SOCI 135,A00,890615,Payne; Christine Anna,14,0,45,31
1746602091951,SOCI 139,A00,890620,Staff,38,0,45,7
1746602092982,SOCI 148E,A00,890622,Calderon-Zaks; Michael Aar,36,0,45,9
1746602094014,SOCI 150,A00,890623,Kohler; Kristopher M.,31,0,45,14
1746602095045,SOCI 157,A00,890625,Jules-Rosette; Bennetta W.,18,0,20,2
1746602096079,SOCI 160,A00,890627,Payne; Christine Anna,21,0,45,24
1746602097110,SYN 1,A00,886855,Fish; Gwendolyn Anne,0,1,0,0
1746602097110,SYN 1,B00,906086,Fish; Gwendolyn Anne,0,2,0,2
1746602098137,SYN 2R,A00,886860,Staff,0,17,15,15
1746602098137,SYN 2R,B00,906106,Atkinson; Arthur Laird,0,16,15,15
1746602099179,SYN 100,A01,886866,Browne; Emily,0,28,20,20
1746602099179,SYN 100,B01,906128,Rock; Martin,0,4,20,20
1746602099179,SYN 100,C01,906140,Deavenport; James Cary,0,4,20,20
1746602099179,SYN 100,D01,907816,Deavenport; James Cary,0,5,20,20
1746602100210,TDAC 1,A00,890286,Walsh; Kim C.,7,0,20,13
1746602101239,TDAC 101,A00,890296,Basso; Beatrice,15,0,20,5
1746602102268,TDDE 131,A00,890297,Staff,47,0,50,3
1746602103295,TDDM 1,A00,890287,Weinberg; Sadie,25,0,30,5
1746602104323,TDGE 11,A00,890288,Fulton; Julia,138,0,200,62
1746602104323,TDGE 11,B00,890289,Castro; Robert Jess,184,0,200,16
1746602105352,TDGE 25,B00,957359,Walsh; Kim C.,5,0,20,15
1746602106388,TDGE 40,A01,890292,Power; Jade Yukana,26,0,30,4
1746602107417,TDGE 124,A00,890298,Havis; Allan,0,2,50,50
1746602108448,TDGE 131R,A00,890299,Burelle; Julie Sara Veronique,15,0,42,27
1746602109474,TDHT 101,A00,890300,Staff,10,0,20,10
1746602110500,TDHT 109,A01,890302,Anderson; Mysia Anyse,31,0,40,9
1746602111527,TDMV 1,A00,890293,Arcidiacono; Kristin,18,0,30,12
1746602112554,TDMV 2,A00,890294,Weinberg; Sadie,23,0,30,7
1746602113582,TDMV 3,A00,957878,Arcidiacono; Kristin,28,0,30,2
1746602115640,TDMV 138,A00,890304,Jun; Grace Shin Hae,25,0,40,15
1746602116677,TDMV 140,A00,890305,Corrales; Joseph Bernales,25,0,30,5
1746602117705,TDMV 142,A00,890307,Caligagan; Tony,32,0,40,8
1746602118737,TDMV 144,A00,890308,Camaya; Michelle Ann,25,0,30,5
1746602119772,TDPW 1,A00,890295,Stein; Deborah Isobel,3,0,20,17
1746602120802,USP 2,A01,890272,Lerner; Amy M,7,0,20,13
1746602121829,USP 3,A01,890274,Staff,12,0,30,18
1746602122856,USP 15,A01,890276,Sun; Feiyang,16,0,30,14
1746602123886,USP 25,A00,890277,Shenkman; Michael Thomas,18,0,25,7
1746602124914,USP 138,A00,890278,Staff,13,0,25,12
1746602125941,USP 143,A00,890279,Staff,21,0,70,49
1746602126972,USP 144,A00,890280,Chowdhury; Muhammed Zohir,16,0,30,14
1746602128004,USP 150,A00,890281,Boomhower; Matthew Charles,4,0,30,26
1746602129033,USP 151,A00,890282,Staff,16,0,20,4
1746602130065,USP 162,A00,890283,Andrews; Abigail Leslie,16,0,20,4
1746602131092,USP 168,A00,920477,Kwak; Nancy,0,0,5,5
1746602132124,USP 181,A00,890284,Staff,3,0,20,17
1746602133151,USP 191A,A00,890285,Staff,12,0,20,8
1746602134178,VIS 101,A00,886512,Staff,26,0,75,49
1746602135208,VIS 103,A00,886513,Cruz; Edwin Teddy,61,0,75,14
1746602136238,VIS 108,A00,886514,Staff,4,0,15,11
1746602137271,VIS 127P,A00,886515,Shen; Kuiyi,80,0,146,66
1746602138300,VIS 149,A00,886516,Yoldas; Pinar,0,0,15,15
1746602139330,VIS 164,A00,886526,Erdmann; Dean,19,0,22,3
1746602140361,VIS 194S,A00,886527,Staff,61,0,75,14
1746602141392,WCWP 10A,C00,886484,Martiniuk; Jill,12,0,15,3
1746602142424,WCWP 10B,A00,886490,Uriarte; Emma,0,0,15,15
1746602142424,WCWP 10B,B00,886491,Dhir; Simrita,8,0,15,7
1746602142424,WCWP 10B,C00,886492,Ornelas; Tricia,0,0,15,15
1746602143449,WCWP 100,A00,886494,Young; Mark T,0,6,15,15
1746602145568,AAS 10,A01,886199,Childs; Dennis R.,0,3,0,0
1746602146598,ANAR 104,A01,886940,Shtienberg; Gilad,27,0,30,3
1746602147626,ANAR 120,A00,886953,Staff,13,0,20,7
1746602148654,ANBI 148,A01,886955,Wilder; Linnea Lorene,30,0,40,10
1746602150721,ANSC 122,A00,886957,Staff,24,0,30,6
1746602151752,ANSC 150,A00,886958,Sloane; Julia Kathryn,2,0,15,13
1746602152785,ANSC 156,A00,886959,Jenkins; Janis A.,0,1,15,15
1746602153819,ANSC 180,A00,886960,Staff,11,0,17,6
1746602154855,ANSC 188,A00,886961,Jassal; Aftab,9,0,25,16
1746602155891,ANSC 190,A00,886962,Jassal; Aftab,14,0,25,11
1746602156924,ANSC 191,A00,886963,Staff,18,0,20,2
1746602157957,ANTH 3,A01,891689,Staff,17,0,20,3
1746602158991,ANTH 5,A00,886933,Semendeferi; Ekaterini,16,0,20,4
1746602160029,ANTH 10,A00,886934,Staff,0,12,30,30
1746602161076,ANTH 21,A01,886936,Staff,41,0,60,19
1746602162119,ANTH 23,A01,886938,Staff,92,0,100,8
1746602163155,ANTH 105,A00,886964,Stewart; Alexander B,84,0,100,16
1746602164194,ANTH 108,A00,886965,Pedersen; David,9,0,20,11
1746602165226,AWP 10,001,886147,Staff,0,0,0,0
1746602165226,AWP 10,002,886148,Staff,0,0,0,0
1746602165226,AWP 10,003,886149,Staff,0,0,0,0
1746602165226,AWP 10,004,886150,Staff,0,0,0,0
1746602165226,AWP 10,005,886151,Staff,0,0,0,0
1746602165226,AWP 10,006,886152,Staff,0,0,0,0
1746602165226,AWP 10,007,886153,Staff,0,0,0,0
1746602165226,AWP 10,008,886154,Staff,0,0,0,0
1746602165226,AWP 10,009,886155,Staff,0,0,0,0
1746602165226,AWP 10,010,886156,Staff,0,0,0,0
1746602165226,AWP 10,011,886158,Staff,0,0,0,0
1746602165226,AWP 10,012,886160,Staff,0,0,0,0
1746602165226,AWP 10,013,886161,Staff,0,0,0,0
1746602165226,AWP 10,014,886162,Staff,0,0,0,0
1746602165226,AWP 10,015,886163,Staff,0,0,0,0
1746602165226,AWP 10,016,886164,Staff,0,0,0,0
1746602165226,AWP 10,017,886165,Staff,0,0,0,0
1746602165226,AWP 10,018,886166,Staff,0,0,0,0
1746602165226,AWP 10,019,886168,Staff,0,0,0,0
1746602165226,AWP 10,020,886170,Staff,0,0,0,0
1746602165226,AWP 10,021,886172,Staff,0,0,0,0
1746602166264,AWP 10R,001,886173,Staff,0,1,0,0
1746602166264,AWP 10R,002,886174,Staff,0,1,0,0
1746602166264,AWP 10R,003,886175,Staff,0,0,0,0
1746602166264,AWP 10R,004,886176,Staff,0,0,0,0
1746602166264,AWP 10R,005,886177,Staff,0,0,0,0
1746602166264,AWP 10R,006,886178,Staff,0,0,0,0
1746602166264,AWP 10R,007,886179,Staff,0,0,0,0
1746602166264,AWP 10R,008,886181,Staff,0,0,0,0
1746602166264,AWP 10R,009,886182,Staff,0,0,0,0
1746602166264,AWP 10R,010,886183,Staff,0,0,0,0
1746602166264,AWP 10R,011,886184,Staff,0,0,0,0
1746602166264,AWP 10R,012,886185,Staff,0,0,0,0
1746602166264,AWP 10R,013,886186,Staff,0,0,0,0
1746602166264,AWP 10R,014,886187,Staff,0,0,0,0
1746602166264,AWP 10R,015,886188,Staff,0,0,0,0
1746602166264,AWP 10R,016,886189,Staff,0,0,0,0
1746602166264,AWP 10R,017,960532,Staff,0,0,0,0
1746602166264,AWP 10R,018,960533,Staff,0,0,0,0
1746602166264,AWP 10R,019,960534,Staff,0,0,0,0
1746602166264,AWP 10R,020,960538,Staff,0,0,0,0
1746602166264,AWP 10R,021,960540,Staff,0,0,0,0
1746602166264,AWP 10R,022,960541,Staff,0,0,0,0
1746602166264,AWP 10R,023,960542,Staff,0,0,0,0
1746602166264,AWP 10R,024,960544,Staff,0,0,0,0
1746602166264,AWP 10R,025,960545,Staff,0,0,0,0
1746602166264,AWP 10R,026,960548,Staff,0,0,0,0
1746602167292,AWP 102R,A00,886190,Staff,0,0,0,0
1746602167292,AWP 102R,B00,886191,Staff,0,0,0,0
1746602168319,BENG 100,A01,886193,Staff,17,0,30,13
1746602169350,BENG 122A,A01,886195,Hasty; Jeff M,13,0,30,17
1746602170376,BENG 166A,A00,886196,Sah; Robert Lie-Yuan,0,3,30,30
1746602171403,BENG 190,A00,958050,Khojah; Reem I,17,0,25,8
1746602172435,BIBC 102,A01,894320,Staff,0,1,46,46
1746602172435,BIBC 102,A02,894321,Staff,0,0,46,46
1746602172435,BIBC 102,A03,894344,Staff,6,0,46,40
1746602172435,BIBC 102,A04,894345,Staff,27,0,47,20
1746602173465,BICD 100R,A01,894365,Smith; Laurie,0,2,58,58
1746602173465,BICD 100R,A02,894366,Smith; Laurie,0,4,58,58
1746602173465,BICD 100R,A03,894367,Smith; Laurie,0,0,59,59
1746602173465,BICD 100R,A04,959869,Smith; Laurie,38,0,59,21
1746602174492,BICD 136,A01,894383,Gustafson-Brown; Cindy,14,0,50,36
1746602175521,BIEB 102,A01,894494,Butler; Shannon Rhey,51,0,130,79
1746602177576,BIEB 150,A01,894617,Wills; Christopher,3,0,20,17
1746602177576,BIEB 150,A02,894631,Wills; Christopher,3,0,20,17
1746602177576,BIEB 150,A03,894937,Wills; Christopher,3,0,20,17
1746602177576,BIEB 150,A04,894946,Wills; Christopher,5,0,20,15
1746602178604,BIEB 194,A00,906141,Kurle; Carolyn M.,5,0,20,15
1746602179630,BILD 1,A01,894154,Staff,3,0,19,16
1746602179630,BILD 1,A02,894155,Staff,14,0,19,5
1746602179630,BILD 1,A03,894160,Staff,13,0,19,6
1746602179630,BILD 1,A04,894161,Staff,15,0,18,3
1746602180659,BILD 2,A01,894168,Staff,0,0,50,50
1746602180659,BILD 2,A02,894169,Staff,0,0,50,50
1746602180659,BILD 2,A03,894179,Staff,0,0,50,50
1746602180659,BILD 2,A04,894203,Staff,22,0,50,28
1746602181691,BILD 3,A01,894213,Staff,23,0,31,8
1746602181691,BILD 3,A02,894214,Staff,26,0,31,5
1746602181691,BILD 3,A03,894235,Staff,28,0,31,3
1746602181691,BILD 3,A04,894236,Staff,28,0,32,4
1746602182717,BILD 4,A01,894253,Reuther; Keefe,5,0,24,19
1746602182717,BILD 4,A02,894258,Reuther; Keefe,16,0,24,8
1746602183743,BILD 5,A01,894276,Reuther; Keefe,34,0,50,16
1746602183743,BILD 5,A02,894277,Reuther; Keefe,45,0,50,5
1746602183743,BILD 5,A03,894290,Reuther; Keefe,44,0,50,6
1746602183743,BILD 5,A04,894291,Reuther; Keefe,48,0,50,2
1746602184771,BILD 24,A01,894297,Pirino; Giorgia,40,0,60,20
1746602185797,BIMM 100,B01,958915,Staff,71,0,100,29
1746602186828,BIMM 101,A01,895017,McDonnell; Lisa Marie,0,5,24,24
1746602186828,BIMM 101,A02,895018,McDonnell; Lisa Marie,0,5,24,24
1746602186828,BIMM 101,B01,895020,McDonnell; Lisa Marie,0,5,24,24
1746602186828,BIMM 101,B02,895021,McDonnell; Lisa Marie,0,4,24,24
1746602187862,BIMM 110,A01,895023,Staff,1,0,25,24
1746602187862,BIMM 110,A02,895024,Staff,9,0,25,16
1746602187862,BIMM 110,A03,895025,Staff,18,0,25,7
1746602187862,BIMM 110,A04,895031,Staff,20,0,25,5
1746602188892,BIMM 120,A01,895114,Gustafson-Brown; Cindy,14,0,28,14
1746602188892,BIMM 120,A02,895126,Gustafson-Brown; Cindy,21,0,27,6
1746602189918,BIPN 100,A01,895130,Yang; Mingyu,0,0,38,38
1746602189918,BIPN 100,A02,895131,Yang; Mingyu,31,0,38,7
1746602189918,BIPN 100,A03,895132,Yang; Mingyu,32,0,38,6
1746602189918,BIPN 100,A04,895133,Yang; Mingyu,27,0,36,9
1746602190950,BIPN 120,A01,895135,Cooke; James Edward,0,3,13,13
1746602190950,BIPN 120,A02,895136,Cooke; James Edward,0,1,13,13
1746602190950,BIPN 120,A03,895137,Cooke; James Edward,0,3,13,13
1746602190950,BIPN 120,A04,895156,Cooke; James Edward,0,2,11,11
1746602191977,BIPN 134,A01,895235,Cooke; James Edward,0,1,25,25
1746602191977,BIPN 134,A02,895237,Cooke; James Edward,0,0,25,25
1746602191977,BIPN 134,A03,895240,Cooke; James Edward,1,0,25,24
1746602191977,BIPN 134,A04,895270,Cooke; James Edward,20,0,25,5
1746602193003,BIPN 189,A00,892103,Staff,0,14,14,14
1746602195053,BISP 194,A00,958008,Staff,0,2,0,0
1746602196083,CAT 124,A01,922009,Staff,0,5,20,20
1746602197116,CAT 125R,A00,886390,Morales; Celeste Georgianna,0,3,20,20
1746602197116,CAT 125R,B00,886391,Irwin; Matthew Joseph,0,4,20,20
1746602197116,CAT 125R,C00,886392,Smith; Lauryn Alissa,0,2,20,20
1746602197116,CAT 125R,D00,886393,Vanderschuit; Maya Alysia,0,3,20,20
1746602197116,CAT 125R,E00,886394,Marchisotto; Jennifer Anne,0,3,20,20
1746602198147,CENG 15,A01,886218,Drews; Aaron,3,0,8,5
1746602199173,CENG 113,A00,886219,Opatkiewicz; Justin Paul,15,0,25,10
1746602200200,CGS 101,A00,887044,Staff,7,0,20,13
1746602201229,CGS 105,A01,887046,Staff,14,0,25,11
1746602202258,CGS 112,A00,887047,Cuong; Marisol,12,0,15,3
1746602203287,CGS 113,A00,887048,Staff,23,0,30,7
1746602204314,CGS 120,A00,887049,Staff,9,0,17,8
1746602205343,CHEM 6A,A01,886336,Lam; Tin Yiu,38,0,50,12
1746602205343,CHEM 6A,A02,886338,Lam; Tin Yiu,37,0,50,13
1746602206373,CHEM 6B,A01,886341,Hopkins; Patrycja Anna,16,0,50,34
1746602206373,CHEM 6B,A02,886343,Hopkins; Patrycja Anna,42,0,50,8
1746602207399,CHEM 6C,A01,886346,Albizati; Kim F.,0,2,50,50
1746602207399,CHEM 6C,A02,886348,Albizati; Kim F.,24,0,50,26
1746602208430,CHEM 40A,A01,886352,Klosterman; Jeremy K,65,0,100,35
1746602209456,CHEM 40B,A01,886356,Klosterman; Jeremy K,0,24,100,100
1746602210489,CHEM 41B,A01,886360,Theodorakis; Emmanuel,25,0,50,25
1746602210489,CHEM 41B,A02,886362,Theodorakis; Emmanuel,47,0,50,3
1746602211513,CHIN 165A,A00,886382,Xu; Li,18,0,20,2
1746602212542,CLAS 120,A00,886387,Myerston Santana; Jacobo,33,0,40,7
1746602213569,COGS 9,A01,886967,Shannon; Kyle Michael,42,0,60,18
1746602214600,COGS 11,A01,886969,Staff,9,0,30,21
1746602215628,COGS 14A,A01,886971,Staff,5,0,60,55
1746602216659,COGS 14B,A01,886973,Hoffman; Drew Ellen,4,0,60,56
1746602217691,COGS 18,A01,886975,Morgan; Eric,34,0,60,26
1746602218717,COGS 20,A01,886977,Staff,3,0,8,5
1746602218717,COGS 20,A02,886978,Staff,5,0,7,2
1746602219756,COGS 100,A01,907783,Staff,0,1,30,30
1746602220783,COGS 101B,A01,886980,Staff,0,4,48,48
1746602221809,COGS 101C,A01,886982,Delgado; Tania,0,5,44,44
1746602222851,COGS 102A,A01,886984,Johnson; Christine M.,3,0,30,27
1746602223882,COGS 118B,A01,886986,Staff,0,4,88,88
1746602224912,COGS 150,A01,886988,Bergen; Benjamin,22,0,50,28
1746602225940,COGS 153,A00,886989,Delgado; Tania,0,3,41,41
1746602226971,COGS 186,A01,886991,Staff,0,0,32,32
1746602227996,COGS 187A,A01,886993,Boyle; Mary E. T.,7,0,30,23
1746602229023,COGS 189,A00,886994,Staff,0,1,30,30
1746602230055,COMM 10,A01,886996,Staff,0,0,20,21
1746602230055,COMM 10,A02,886997,Staff,10,0,20,10
1746602230055,COMM 10,A03,959845,Staff,19,0,20,1
1746602231087,COMM 20,A01,886999,Leuning; Grant Maurstad,24,0,40,16
1746602233149,COMM 100A,A01,887002,Staff,0,0,20,25
1746602233149,COMM 100A,A02,887003,Staff,5,0,20,15
1746602234179,COMM 100B,A01,887005,Staff,0,8,20,24
1746602235209,COMM 106D,A00,887006,Staff,14,0,40,26
1746602236235,COMM 110G,A00,887007,Whitworth-Smith; Andrew C,12,0,40,28
1746602237264,COMM 111B,A00,887008,Staff,31,0,40,9
1746602238291,COMM 113T,A00,887009,Abuelhiga; Soraya Jill,28,0,40,12
1746602238291,COMM 113T,B00,906733,Staff,39,0,40,1
1746602239316,COMM 145,A00,887010,Staff,13,0,40,27
1746602240343,COMM 146,A00,887054,Staff,32,0,40,8
1746602241373,COMM 190,A00,887012,Staff,8,0,23,15
1746602242406,CSE 8A,A50,887015,Cao; Yingjun,56,0,85,29
1746602243430,CSE 11,A01,887017,Cao; Yingjun,11,0,70,59
1746602244457,CSE 20,A01,887019,Staff,30,0,50,20
1746602245483,CSE 21,A01,887021,Staff,79,0,100,21
1746602245483,CSE 21,B01,892583,Braun; Oliver,45,0,50,5
1746602246509,CSE 30,A01,887025,Eldon; John,142,0,200,58
1746602247536,CSE 100,A01,887027,Staff,26,0,50,24
1746602247536,CSE 100,A02,887028,Staff,42,0,50,8
1746602248561,CSE 101,A01,887030,Braun; Oliver,74,0,100,26
1746602248561,CSE 101,B01,887032,Jones; Miles E,0,3,50,50
1746602248561,CSE 101,B02,887033,Jones; Miles E,0,2,50,50
1746602249593,CSE 105,A01,908084,Jones; Miles E,32,0,50,18
1746602249593,CSE 105,A02,908087,Jones; Miles E,31,0,50,19
1746602250623,CSE 135,A01,887035,Powell; Thomas Allan,0,5,50,50
1746602251650,CSE 142,A01,887037,Staff,7,0,60,53
1746602252677,CSE 142L,A01,887039,Staff,34,0,60,26
1746602253707,CSE 151A,A01,887041,Solares; Edwin A,47,0,100,53
1746602254736,CSE 175,A01,887043,Kumar; Rakesh,30,0,30,0
1746602255762,CSS 1,A01,886389,Staff,0,1,40,40
1746602256787,DSC 30,A01,908097,Liao; Soohyun Nam,47,0,75,28
1746602257813,DSC 40A,A01,908099,Shannon; Kyle Michael,30,0,50,20
1746602258839,DSC 40B,A01,908112,Staff,15,0,50,35
1746602259864,DSC 80,A01,908116,Staff,19,0,60,41
1746602260903,DSC 197,001,956863,Eldridge; Justin Matthew,9999,0,9999,0
1746602261938,ECE 5,A01,886400,Morris; Karcher William,1,0,6,5
1746602261938,ECE 5,A02,886401,Morris; Karcher William,3,0,6,3
1746602262964,ECE 148,A01,886403,Silberman; Jack,0,14,14,14
1746602263996,ECON 1,A01,887265,Crane; Meredith Helen,11,0,70,59
1746602263996,ECON 1,B01,887268,Staff,42,0,50,8
1746602265022,ECON 2,A01,887273,Crane; Meredith Helen,54,0,70,16
1746602266052,ECON 3,A01,887279,Rondina; Giacomo,31,0,70,39
1746602267077,ECON 4,A01,887282,Anderson; John Charles,0,2,10,10
1746602268109,ECON 5,A01,887285,Staff,34,0,45,11
1746602268109,ECON 5,B01,887292,Staff,41,0,45,4
1746602269142,ECON 100A,A01,887337,Newhouse; Herbert S,54,0,70,16
1746602269142,ECON 100A,B01,887349,Staff,45,0,50,5
1746602270174,ECON 100B,A01,887361,Du; Songzi,29,0,70,41
1746602271206,ECON 100C,A01,887445,Newhouse; Herbert S,59,0,70,11
1746602272237,ECON 105,A00,887488,Vespa; Emanuel Ignacio,23,0,35,12
1746602273263,ECON 109,A01,887506,Shishkin; Denis,28,0,35,7
1746602274295,ECON 110A,A01,887568,Alon; Titan Michael,0,2,35,35
1746602274295,ECON 110A,B01,907601,Alon; Titan Michael,20,0,35,15
1746602275321,ECON 110B,A01,887598,Levkoff; Steven B.,0,24,70,70
1746602276348,ECON 112,A00,887599,Rondina; Giacomo,19,0,35,16
1746602277375,ECON 120A,A01,887603,Dai; Yinlin,36,0,70,34
1746602278402,ECON 120C,A01,887608,Sun; Yixiao,0,1,35,35
1746602278402,ECON 120C,B01,887614,Sun; Yixiao,0,0,35,35
1746602279433,ECON 138,A00,887621,Bharadwaj; Prashant,0,21,20,20
1746602280464,ECON 144,A00,958007,Squires; Dale E,11,0,35,24
1746602281493,ECON 171,A01,907666,Staff,18,0,35,17
1746602282519,ECON 175,A00,887626,Wu; Pak Yeung,22,0,35,13
1746602283550,ECON 190,A00,887640,Vespa; Emanuel Ignacio,22,0,35,13
1746602284588,EDS 25,A01,888197,Staff,0,0,0,0
1746602284588,EDS 25,A02,888209,Staff,0,0,0,0
1746602284588,EDS 25,A03,888210,Staff,0,0,0,0
1746602284588,EDS 25,A04,888212,Staff,0,0,0,0
1746602284588,EDS 25,A05,888213,Staff,0,0,0,0
1746602284588,EDS 25,A06,888214,Staff,0,0,0,0
1746602284588,EDS 25,A07,888235,Staff,0,2,0,0
1746602284588,EDS 25,A08,888236,Staff,0,0,0,0
1746602284588,EDS 25,A09,888240,Staff,0,0,0,0
1746602284588,EDS 25,A10,888244,Staff,0,0,0,0
1746602284588,EDS 25,B01,888273,Staff,0,0,0,0
1746602284588,EDS 25,B02,888285,Staff,0,0,0,0
1746602284588,EDS 25,B03,888423,Staff,0,0,0,1
1746602284588,EDS 25,B04,888432,Staff,0,0,0,0
1746602284588,EDS 25,B05,888433,Staff,0,0,0,0
1746602284588,EDS 25,B06,888467,Staff,0,0,0,0
1746602284588,EDS 25,B07,888468,Staff,0,0,0,0
1746602284588,EDS 25,B08,888479,Staff,0,0,0,0
1746602284588,EDS 25,B09,888484,Staff,0,0,0,0
1746602284588,EDS 25,B10,888487,Staff,0,0,0,0
1746602285615,EDS 38,A01,907700,Choi; Bailey Miyeon,30,0,30,0
1746602286642,EDS 112,A01,888601,Chapman; Thandeka K,12,0,40,28
1746602287673,EDS 115,A00,888697,Mendez; Kathrina Mendoza,10,0,30,20
1746602288700,EDS 116,A01,888893,Staff,33,0,40,7
1746602290752,EDS 124AR,A00,889133,Staff,29,0,50,21
1746602290752,EDS 124AR,B00,907471,Simon; Elizabeth A,37,0,50,13
1746602291778,EDS 124BR,A00,889134,Simon; Elizabeth A,44,0,100,56
1746602292803,EDS 125,A00,889135,Staff,25,0,30,5
1746602293830,EDS 126,A01,889138,Staff,35,0,40,5
1746602294859,EDS 164R,A01,889142,Wishard Guerra; Alison G.,32,0,50,18
1746602295891,ENG 30,A01,886396,Staff,0,0,0,0
1746602295891,ENG 30,B01,886398,Staff,0,0,0,0
1746602296918,ENVR 102,A00,906150,Montejo; Carolina,23,0,25,2
1746602297947,ETHN 103A,A00,887236,Man; Simeon S,0,2,0,0
1746602298977,ETHN 113,A00,887239,Staff,16,0,30,14
1746602300007,ETHN 116,A00,887240,Staff,16,0,25,9
1746602301033,ETHN 117,A00,887241,Choi; Esther Min,28,0,30,2
1746602302059,ETHN 118,A00,887243,Staff,24,0,30,6
1746602303085,ETHN 127,A00,887248,Cuong; Marisol,11,0,15,4
1746602304110,ETHN 139,A00,887250,Staff,7,0,10,3
1746602305136,ETHN 142,A00,887252,Staff,9,0,30,21
1746602306165,ETHN 161,A00,887253,Browne; Errol Tsekani,24,0,30,6
1746602307196,ETHN 163FR,A00,887255,Burelle; Julie Sara Veronique,0,0,5,5
1746602308222,GLBH 20,A00,889149,Elwardani; Nile Regina,8,0,42,34
1746602310282,GLBH 111,A01,889152,Burgos; Jose L.,17,0,17,0
1746602311306,GLBH 150,A00,889181,Sloane; Julia Kathryn,0,5,15,15
1746602313359,HDS 60,A01,886406,Warstadt; Melissa Fawn,72,0,80,8
1746602314388,HIAF 111,A00,889324,Gyamfi; Bright,25,0,32,7
1746602315414,HIEA 131,A00,889328,Staff,15,0,32,17
1746602316440,HIEA 144,A00,889333,Henry; Todd A.,26,0,32,6
1746602317467,HIEA 154,A00,889336,Henry; Todd A.,24,0,32,8
1746602318492,HIEU 106,A00,889339,Staff,22,0,32,10
1746602320550,HIEU 114,A00,889340,Staff,4,0,32,28
1746602321576,HIEU 135GS,A00,889342,Patterson; Patrick H.,0,0,1,24
1746602322610,HIEU 137,A00,889343,Edington; Claire Ellen,10,0,25,15
1746602323636,HIEU 148,A00,889345,Staff,14,0,32,18
1746602324664,HIEU 154,A00,889346,Biess; Frank Peter,21,0,32,11
1746602325695,HILA 102,A00,889351,Staff,12,0,32,20
1746602326725,HILD 2A,A01,889221,Lewandoski; Julia Mavis,0,8,32,32
1746602327756,HILD 7B,A01,889225,Man; Simeon S,0,12,32,32
1746602328782,HILD 7C,A01,889288,Alvarez; Luis A,0,14,32,32
1746602329807,HILD 30,A01,889323,Staff,0,5,32,32
1746602331864,HISC 119,A00,889383,Golan; Tal,20,0,32,12
1746602332890,HIUS 103,A00,889384,Man; Simeon S,0,0,32,32
1746602333917,HIUS 117,A00,919797,Kwak; Nancy,18,0,32,14
1746602334943,HIUS 142A,A00,919788,Staff,22,0,32,10
1746602336997,HIUS 149,A00,889386,Gyamfi; Bright,26,0,32,6
1746602338025,HIUS 155,A00,889387,Alvarez; Luis A,15,0,32,17
1746602339053,HUM 3,A01,886499,Caldwell; Michael Alan,19,0,50,31
1746602340082,HUM 3GS,A00,886500,Rodriguez; Bretton Sigfred,0,0,0,28
1746602341110,HUM 3R,A01,886502,Markman; Kristina,0,36,50,50
1746602342142,HUM 4,A01,886504,Crum; Matthew Stephen,23,0,50,27
1746602342142,HUM 4,B01,886506,West; Geoffrey Scott,17,0,50,33
1746602343170,HUM 4GS,A00,886507,Staff,0,0,0,19
1746602344198,HUM 5,A01,886509,Staff,31,0,50,19
1746602345229,HUM 5R,A01,886511,Zavodny; Tatiana Sophia,0,39,50,50
1746602346255,JAPN 180,A00,886407,Staff,16,0,40,24
1746602347282,LATI 50,A01,886409,Martin-Cabrera; Luis,3,0,22,19
1746602347282,LATI 50,A02,886410,Martin-Cabrera; Luis,19,0,22,3
1746602347282,LATI 50,A03,886411,Martin-Cabrera; Luis,21,0,22,1
1746602347282,LATI 50,A04,886412,Martin-Cabrera; Luis,8,0,22,14
1746602348309,LAWS 101,A00,907664,Staff,28,0,60,32
1746602349337,LIAB 1A,A00,889388,Saab; Dima,17,0,20,3
1746602350365,LIAB 1AX,A00,889389,El Cheddadi; Youniss,18,0,20,2
1746602351398,LIFR 1C,A00,889391,Van Moer; Vinciane G,8,0,20,12
1746602352426,LIFR 1CX,A00,889392,Van Moer; Vinciane G,7,0,20,13
1746602353453,LIFR 1D,A00,889393,Van Moer; Vinciane G,7,0,20,13
1746602354480,LIFR 1DX,A00,889394,Van Moer; Vinciane G,8,0,20,12
1746602355509,LIGN 7,A00,886923,Staff,25,0,50,25
1746602356540,LIGN 17,A00,886924,Kehler; Andrew Scott,126,0,150,24
1746602357574,LTAM 110,A00,889395,Staff,15,0,30,15
1746602358602,LTAM 110GS,A00,958010,Rodriguez; Bretton Sigfred,0,0,0,28
1746602359628,LTCH 101,A00,889397,Staff,23,0,25,2
1746602360656,LTCS 130,A00,889398,Staff,23,0,25,2
1746602361684,LTEA 138,A00,889399,Staff,24,0,40,16
1746602362711,LTEN 149,A00,889400,Wesling; Megan E.,0,3,25,25
1746602363737,LTEN 169,A00,889401,Staff,20,0,25,5
1746602364764,LTEN 180,A00,889402,Staff,10,0,15,5
1746602365790,LTEN 181,A00,889403,Staff,21,0,25,4
1746602366817,LTWL 100,A00,889404,Myerston Santana; Jacobo,2,0,25,23
1746602367841,LTWL 180GS,A00,889405,Staff,0,0,20,20
1746602368867,LTWL 181,A00,889406,Staff,16,0,25,9
1746602369895,LTWL 184,A00,889475,Mukherjee; Silpa,22,0,25,3
1746602370923,LTWR 102C,A00,889486,Staff,29,0,30,1
1746602371949,LTWR 115W,A00,889491,Staff,0,2,15,15
1746602372975,MAE 8,A01,886905,Staff,0,2,0,0
1746602374000,MAE 11,A00,886906,Bandaru; Prabhakar,0,7,50,50
1746602375028,MAE 20,A00,886907,Evdokimenko; Ekaterina,43,0,70,27
1746602376054,MAE 30B,A00,886909,Ghazinejad; Maziar,25,0,45,20
1746602377081,MAE 101B,A00,886910,Saintillan; David,30,0,45,15
1746602378107,MAE 105,A00,886911,Bandaru; Prabhakar,18,0,50,32
1746602379139,MAE 107,B00,958024,Staff,7,0,50,43
1746602380170,MAE 143B,A00,886913,Bewley; Thomas R,2,0,40,38
1746602381200,MAE 148,A01,886915,Silberman; Jack,0,3,14,14
1746602382227,MAE 160,A00,886916,Evdokimenko; Ekaterina,30,0,60,30
1746602383257,MATH 3C,A01,889681,Staff,0,2,30,30
1746602383257,MATH 3C,A02,960048,Staff,23,0,30,7
1746602384289,MATH 10A,A01,889760,Staff,26,0,30,4
1746602384289,MATH 10A,A02,889783,Staff,29,0,30,1
1746602385325,MATH 10B,A01,889785,Verstraete; Jacques Allan,1,0,35,34
1746602385325,MATH 10B,A02,889795,Verstraete; Jacques Allan,4,0,35,31
1746602385325,MATH 10B,B01,889797,Verstraete; Jacques Allan,3,0,35,32
1746602385325,MATH 10B,B02,889828,Verstraete; Jacques Allan,3,0,35,32
1746602386354,MATH 10C,A01,889849,Habib; Yousaf,8,0,30,22
1746602386354,MATH 10C,A02,889852,Habib; Yousaf,14,0,30,16
1746602386354,MATH 10C,A03,889853,Habib; Yousaf,22,0,30,8
1746602386354,MATH 10C,A04,889858,Habib; Yousaf,20,0,30,10
1746602386354,MATH 10C,B01,889861,Staff,1,0,30,29
1746602386354,MATH 10C,B02,889862,Staff,24,0,30,6
1746602386354,MATH 10C,B03,889863,Staff,27,0,30,3
1746602386354,MATH 10C,B04,889967,Staff,23,0,30,7
1746602387396,MATH 18,A01,889974,Staff,7,0,30,23
1746602387396,MATH 18,A02,889977,Staff,20,0,30,10
1746602387396,MATH 18,B01,889984,Hardiman; Liam,20,0,30,10
1746602387396,MATH 18,B02,889985,Hardiman; Liam,25,0,30,5
1746602388428,MATH 20A,A01,889990,Suk; Andrew Hoon,30,0,35,5
1746602389453,MATH 20B,A01,889993,Ohm; Ko Woon,21,0,30,9
1746602389453,MATH 20B,A02,889994,Ohm; Ko Woon,30,0,30,0
1746602389453,MATH 20B,B01,889996,Ohm; Ko Woon,22,0,30,8
1746602389453,MATH 20B,B02,889997,Ohm; Ko Woon,23,0,30,7
1746602390482,MATH 20C,A01,889999,Hammock; Frances H,17,0,30,13
1746602390482,MATH 20C,A02,890003,Hammock; Frances H,23,0,30,7
1746602390482,MATH 20C,B01,890006,Hammock; Frances H,2,0,30,28
1746602390482,MATH 20C,B02,890007,Hammock; Frances H,12,0,30,18
1746602391510,MATH 20D,A01,890011,Cheng; Hsiao-Bing,1,0,30,29
1746602391510,MATH 20D,A02,890012,Cheng; Hsiao-Bing,14,0,30,16
1746602391510,MATH 20D,B01,890016,Cheng; Hsiao-Bing,13,0,30,17
1746602391510,MATH 20D,B02,890017,Cheng; Hsiao-Bing,13,0,30,17
1746602392545,MATH 20E,A01,890026,Harel; Guershon,1,0,30,29
1746602392545,MATH 20E,A02,890029,Harel; Guershon,22,0,30,8
1746602392545,MATH 20E,B01,890033,Harel; Guershon,7,0,30,23
1746602392545,MATH 20E,B02,890101,Harel; Guershon,21,0,30,9
1746602393574,MATH 102,A01,890104,Staff,18,0,30,12
1746602393574,MATH 102,A02,890105,Staff,27,0,30,3
1746602394603,MATH 103B,A01,890116,Salehi Golsefidy; Alireza,3,0,30,27
1746602394603,MATH 103B,B01,890118,Staff,0,3,34,34
1746602395634,MATH 109,A01,890121,Aliabadi Sr.; Mohsen,0,0,30,30
1746602395634,MATH 109,B01,890124,Upadrashta; Pranav Kumar,18,0,30,12
1746602396664,MATH 120A,A01,890126,Eggers; John Dietrich,13,0,30,17
1746602397689,MATH 142B,A01,890128,Ioana; Adrian,19,0,30,11
1746602397689,MATH 142B,A02,890129,Ioana; Adrian,12,0,30,18
1746602398718,MATH 154,A01,890174,Staff,0,1,30,30
1746602398718,MATH 154,A02,890182,Staff,0,0,30,30
1746602399746,MATH 168A,A01,890197,Dumitriu; Ioana,21,0,35,14
1746602400774,MATH 170A,A01,890240,Nie; Jiawang,1,0,30,29
1746602400774,MATH 170A,A02,890241,Nie; Jiawang,11,0,30,19
1746602400774,MATH 170A,A03,890249,Nie; Jiawang,23,0,30,7
1746602401808,MATH 170B,A01,957891,Nag; Panchali,13,0,35,22
1746602403862,MATH 181A,A01,908025,Staff,0,3,35,35
1746602403862,MATH 181A,A02,960115,Staff,26,0,35,9
1746602404892,MATH 181B,A01,959874,Staff,24,0,30,6
1746602405918,MATH 193B,A01,890265,Staff,0,4,35,35
1746602406946,MGT 4,A01,890311,Anderson; John Charles,42,0,88,46
1746602407976,MGT 5,A00,907740,Staff,12,0,98,86
1746602409004,MGT 12,A00,890312,Lindenberger; Wade Douglas,67,0,98,31
1746602410033,MGT 16,A00,957883,Staff,78,0,98,20
1746602412090,MGT 45,A00,890314,Pecore; Joseph P.,45,0,98,53
1746602413116,MGT 71,A00,890315,Staff,0,12,98,98
1746602414140,MGT 100,A00,890316,Yavorsky; Daniel Ryan,44,0,98,54
1746602415166,MGT 103,A00,890317,Ehrich; Kristine R,73,0,98,25
1746602416195,MGT 105,A00,890356,Bates; Kenneth Walter,0,8,98,98
1746602417222,MGT 112,A00,890360,Ehrich; Kristine R,55,0,98,43
1746602418254,MGT 127R,A00,907732,Zhu; Kevin Xiaoguo,23,0,98,75
1746602419285,MGT 131B,A00,890361,Anderson; John Charles,59,0,98,39
1746602420315,MGT 137,A00,890362,Lindenberger; Wade Douglas,65,0,98,33
1746602421339,MGT 160,A00,890369,Johnson; Erik Barry,9,0,98,89
1746602423391,MGT 164,A00,890372,Zimmermann; Carsten,0,40,98,98
1746602424418,MGT 180,A00,890374,Bliss; Barbara Ann,11,0,98,87
1746602425445,MMW 15,A01,886414,Chang; Edmond Yi-Teh,0,12,28,28
1746602425445,MMW 15,A02,886415,Chang; Edmond Yi-Teh,0,8,28,28
1746602425445,MMW 15,A03,886416,Chang; Edmond Yi-Teh,0,9,28,28
1746602425445,MMW 15,A04,886417,Chang; Edmond Yi-Teh,0,8,28,28
1746602425445,MMW 15,B01,886419,Chang; Edmond Yi-Teh,0,7,28,28
1746602425445,MMW 15,B02,886420,Chang; Edmond Yi-Teh,0,7,28,28
1746602425445,MMW 15,B03,886421,Chang; Edmond Yi-Teh,0,7,28,28
1746602425445,MMW 15,B04,886422,Chang; Edmond Yi-Teh,0,8,28,28
1746602425445,MMW 15,C01,886424,Staff,0,9,28,28
1746602425445,MMW 15,C02,886425,Staff,0,8,28,28
1746602425445,MMW 15,C03,886426,Staff,0,8,28,28
1746602425445,MMW 15,C04,886427,Staff,0,8,28,28
1746602425445,MMW 15,C05,958038,Staff,0,8,28,28
1746602425445,MMW 15,C06,958039,Staff,0,7,28,28
1746602426472,MMW 15GS,A00,906910,Patterson; Patrick H.,4,0,28,24
1746602427499,MMW 122R,A01,886429,Rahimi; Babak,0,13,28,28
1746602427499,MMW 122R,A02,886430,Rahimi; Babak,0,12,28,28
1746602427499,MMW 122R,A03,958040,Rahimi; Babak,0,11,28,28
1746602428530,MUS 1A,A01,890937,Staff,2,0,25,23
1746602428530,MUS 1A,A02,891035,Staff,6,0,25,19
1746602428530,MUS 1A,C01,958912,Staff,24,0,25,1
1746602428530,MUS 1A,C02,958913,Staff,25,0,25,0
1746602430586,MUS 2AK,A00,957092,Ohnishi; Takae,15,0,15,0
1746602431614,MUS 4,A01,891044,Staff,0,0,25,25
1746602431614,MUS 4,A02,891045,Staff,22,0,25,3
1746602431614,MUS 4,B01,891048,Staff,17,0,25,8
1746602431614,MUS 4,B02,891050,Staff,25,0,25,0
1746602432646,MUS 5,A01,957506,Dubnov; Shlomo,0,0,25,25
1746602432646,MUS 5,A02,957622,Dubnov; Shlomo,12,0,25,13
1746602432646,MUS 5,A03,957623,Dubnov; Shlomo,20,0,25,5
1746602433675,MUS 6,A01,891053,Freitas Caetano; Marcelo,24,0,25,1
1746602433675,MUS 6,A02,891054,Freitas Caetano; Marcelo,23,0,25,2
1746602434705,MUS 7,A01,891081,Staff,0,0,25,25
1746602434705,MUS 7,A02,891082,Staff,3,0,25,22
1746602435733,MUS 8GS,A00,891118,Borgo; David Garcia,1,0,25,24
1746602436762,MUS 11,A01,891140,Staff,8,0,25,17
1746602436762,MUS 11,A02,891141,Staff,21,0,25,4
1746602437827,MUS 13,A01,891143,Staff,8,0,25,17
1746602437827,MUS 13,A02,891144,Staff,24,0,25,1
1746602438855,MUS 15,A01,891146,Staff,9,0,25,16
1746602438855,MUS 15,A02,891148,Staff,21,0,25,4
1746602438855,MUS 15,B01,891150,Staff,18,0,25,7
1746602438855,MUS 15,B02,891151,Staff,25,0,25,0
1746602439882,MUS 20,A01,891153,Staff,5,0,20,15
1746602439882,MUS 20,A02,891155,Staff,14,0,20,6
1746602440911,MUS 80,A00,891156,Staff,19,0,25,6
1746602440911,MUS 80,B00,891157,Staff,23,0,25,2
1746602441941,MUS 130,A00,891158,Ohnishi; Takae,35,0,35,0
1746602442966,MUS 150GS,A01,891160,Borgo; David Garcia,1,0,25,24
1746602443994,MUS 170,A01,891162,Freitas Caetano; Marcelo,20,0,25,5
1746602443994,MUS 170,A02,891164,Freitas Caetano; Marcelo,21,0,25,4
1746602445030,NANO 11,A00,886220,Vazquez Mena; Oscar,13,0,15,2
1746602446060,NANO 15,A01,886222,Drews; Aaron,4,0,7,3
1746602447091,NANO 104,A00,886224,Sirbuly; Donald,17,0,25,8
1746602448119,PH 40,A00,886528,Staff,23,0,40,17
1746602449150,PH 45,A01,886799,Staff,35,0,40,5
1746602450179,PH 110,A00,886802,Staff,0,6,40,40
1746602451209,PH 172,A00,906716,Staff,19,0,35,16
1746602452234,PH 191,A00,886803,Staff,6,0,40,34
1746602453262,PHIL 1,A00,889500,Staff,20,0,30,10
1746602454289,PHIL 10,A01,889549,Grush; Rick Scott,16,0,22,6
1746602454289,PHIL 10,A02,889551,Grush; Rick Scott,22,0,22,0
1746602455321,PHIL 28,A01,889559,Lamey; Andy M.,0,2,31,31
1746602455321,PHIL 28,A02,889561,Lamey; Andy M.,0,1,30,30
1746602455321,PHIL 28,A03,889572,Lamey; Andy M.,0,1,30,30
1746602456350,PHIL 35,A00,907839,Staff,13,0,15,2
1746602457379,PHIL 60,A00,889574,Staff,73,0,90,17
1746602458408,PHIL 101,A00,958004,Staff,12,0,15,3
1746602460468,PHIL 136,A00,889582,Fulkerson; Matthew Todd,26,0,45,19
1746602461504,PHIL 163,A01,889601,Staff,21,0,30,9
1746602461504,PHIL 163,B01,889606,Brandt; Reuven A,0,3,0,0
1746602462530,PHIL 164,A00,889610,Staff,16,0,30,14
1746602463560,PHIL 165,A00,889613,Staff,22,0,30,8
1746602464587,PHYS 1A,A00,886431,Staff,30,0,70,40
1746602465617,PHYS 1AL,001,886432,Tsai; Philbert S,0,1,30,30
1746602465617,PHYS 1AL,002,886436,Tsai; Philbert S,13,0,30,17
1746602466642,PHYS 1B,A00,886439,Staff,184,0,240,56
1746602467668,PHYS 1BL,001,886441,Tsai; Philbert S,0,4,30,30
1746602467668,PHYS 1BL,002,886444,Tsai; Philbert S,2,0,30,28
1746602468698,PHYS 1C,A00,896092,Arnold; Kam S,78,0,146,68
1746602469723,PHYS 1CL,001,886448,Tsai; Philbert S,0,0,30,30
1746602469723,PHYS 1CL,002,886449,Tsai; Philbert S,1,0,30,29
1746602469723,PHYS 1CL,003,886450,Tsai; Philbert S,16,0,30,14
1746602469723,PHYS 1CL,004,886451,Tsai; Philbert S,15,0,30,15
1746602470754,PHYS 2B,A01,886457,Staff,67,0,115,48
1746602471780,PHYS 2C,A01,886460,Shotwell; Brian,0,9,65,65
1746602472809,PHYS 2CL,A01,886467,Staff,0,4,28,28
1746602472809,PHYS 2CL,A02,886468,Staff,0,3,28,28
1746602473838,PHYS 2D,A01,886470,Staff,10,0,50,40
1746602474873,PHYS 4B,A01,886475,Grinstein; Benjamin,22,0,40,18
1746602475901,POLI 5,A00,891173,Desposato; Scott,7,0,25,18
1746602476926,POLI 5D,A01,891175,Staff,5,0,5,0
1746602476926,POLI 5D,B01,891178,Staff,5,0,5,0
1746602477953,POLI 11,A00,891179,Ferree; Karen E,0,0,35,35
1746602478985,POLI 12,A00,891180,Staff,15,0,30,15
1746602480012,POLI 27,A01,891182,Staff,11,0,75,64
1746602481037,POLI 30,A00,891183,Staff,8,0,50,42
1746602482066,POLI 100B,A00,891244,Staff,5,1,35,30
1746602483092,POLI 100I,A00,891247,Staff,7,0,30,23
1746602484120,POLI 104J,A00,891248,Nichter; Maysa,14,0,30,16
1746602485147,POLI 104U,A00,891250,Nichter; Maysa,1,0,30,29
1746602487202,POLI 110B,A00,891255,Wiens; David,19,0,25,6
1746602488437,POLI 112A,A00,891256,Wiens; David,6,0,25,19
1746602489465,POLI 114BR,A00,891261,Staff,19,0,30,11
1746602490493,POLI 117R,A00,891262,Forman; Fonna,0,6,50,50
1746602491519,POLI 118,A00,891264,Ingham; Sean,17,0,25,8
1746602492551,POLI 124A,A00,891265,Staff,18,0,20,2
1746602493578,POLI 125D,A00,891266,Nichter; Simeon C,2,0,25,23
1746602494609,POLI 126,A00,891268,Nichter; Simeon C,7,0,25,18
1746602495636,POLI 126AA,A00,891272,Staff,15,0,25,10
1746602496666,POLI 130AA,A00,891273,Staff,15,0,20,5
1746602497695,POLI 134AA,A00,891274,Staff,4,0,20,16
1746602499755,POLI 138,A00,891278,Staff,21,0,25,4
1746602500784,POLI 142K,A00,891280,Staff,10,0,25,15
1746602501811,POLI 142M,A00,891281,Gartzke; Erik,16,0,30,14
1746602502841,POLI 142P,A00,891284,Staff,20,0,30,10
1746602503865,POLI 143,A00,891285,Gartzke; Erik,12,0,30,18
1746602504891,POLI 153,A00,891286,Staff,19,0,20,1
1746602506946,POLI 175,A00,891290,Staff,15,0,20,5
1746602507973,PSYC 1,A00,890674,Steiner; Eric Tomas,0,11,45,45
1746602509004,PSYC 2,A00,890676,Albright; Thomas D,20,0,35,15
1746602510032,PSYC 3,A00,890679,Staff,17,0,20,3
1746602511056,PSYC 6,A00,959858,Staff,19,0,20,1
1746602512095,PSYC 60,A01,890684,Rickard; Timothy C.,0,6,45,45
1746602513123,PSYC 70,A01,890689,Geller; Emma Harlan,6,0,30,24
1746602514159,PSYC 71,A01,959860,Staff,21,0,25,4
1746602515186,PSYC 100,A00,890690,Lacefield; Katharine I,0,50,180,180
1746602516211,PSYC 102,A00,890695,Staff,18,0,40,22
1746602517236,PSYC 105,A00,890699,Geller; Emma Harlan,70,0,100,30
1746602518261,PSYC 106,A00,890701,Gorman; Michael R.,5,0,30,25
1746602519289,PSYC 108,A00,890704,Adrian; Julia Anna,0,29,50,50
1746602520313,PSYC 118,A01,890712,Staff,11,0,30,19
1746602521337,PSYC 124,A00,890716,Chapman; Eddie Nathaniel,25,0,60,35
1746602522365,PSYC 131,A00,890717,Anagnostaras; Stephan,0,7,80,80
1746602523393,PSYC 137,A00,890719,Winkielman; Piotr,0,11,30,30
1746602524420,PSYC 144,A00,890721,Adrian; Julia Anna,0,9,45,45
1746602525447,PSYC 162,A00,890805,Staff,0,1,75,75
1746602526475,PSYC 169,A00,890810,Staff,0,15,30,30
1746602527544,PSYC 172,A00,890814,Gorman; Michael R.,9,0,30,21
1746602528571,PSYC 181,A00,890818,Anagnostaras; Stephan,7,0,200,193
1746602529598,PSYC 184,A00,959861,Staff,162,0,175,13
1746602530624,PSYC 189,A00,890823,Staff,0,2,30,30
1746602531654,PSYC 191,A00,890884,Rickard; Timothy C.,0,11,35,35
1746602532679,PSYC 193,A00,890913,Staff,19,0,30,11
1746602532679,PSYC 193,B00,890914,Chapman; Eddie Nathaniel,24,0,30,6
1746602533707,PSYC 193L,A01,890918,Lowe; Angela Beth,20,0,30,10
1746602533707,PSYC 193L,B01,890921,Hurwitz; Ethan Scott,20,0,30,10
1746602533707,PSYC 193L,C01,890928,Staff,30,0,30,0
1746602534733,RELI 149,A00,886806,Rahimi; Babak,23,0,40,17
1746602535765,SE 9,A01,886814,Staff,7,0,20,13
1746602536798,SE 101B,A01,886816,Chadha; Mayank,3,0,35,32
1746602537826,SE 110B,A00,886818,Zhu; Qiang,4,0,75,71
1746602538851,SE 125,A01,886830,Staff,10,0,30,20
1746602539879,SE 130B,A01,886835,Staff,14,0,40,26
1746602540905,SE 131A,A01,886838,Krysl; Petr,34,0,55,21
1746602541934,SE 154,A00,886840,Staff,28,0,50,22
1746602542958,SE 164GS,A01,886849,Staff,6,0,20,14
1746602543987,SE 167GS,A01,886853,Staff,6,0,20,14
1746602545024,SIO 25,A01,890107,Staff,19,0,30,11
1746602546049,SIO 45,A00,890109,Cook; Geoffrey W,115,0,200,85
1746602547073,SIO 109R,A00,890110,Forman; Fonna,0,16,20,20
1746602548101,SIO 187,A01,890114,Kacev; David,15,0,40,25
1746602549131,SOCI 1,A01,890431,Thorpe; Charles Robert,14,0,30,16
1746602549131,SOCI 1,A02,890518,Thorpe; Charles Robert,30,0,30,0
1746602550159,SOCI 2,A01,957978,Staff,25,0,25,0
1746602550159,SOCI 2,A02,957979,Staff,23,0,25,2
1746602551188,SOCI 20,A01,890523,Calderon-Zaks; Michael Aar,21,0,30,9
1746602551188,SOCI 20,A02,890526,Calderon-Zaks; Michael Aar,29,0,30,1
1746602552218,SOCI 30,A01,890533,Pardo Guerra; Juan Pablo,37,0,40,3
1746602553245,SOCI 40,A01,890535,Staff,27,0,45,18
1746602554271,SOCI 104Q,A00,890559,Staff,18,0,30,12
1746602555325,SOCI 106,A00,890560,Arnal; Maud Marie Leonie,20,0,30,10
1746602556350,SOCI 110,A00,890567,Holkenbrink-Monk; Charlene,19,0,30,11
1746602557377,SOCI 112,A00,890568,Victoria Torres; Pablo,2,0,55,53
1746602558405,SOCI 115,A00,890597,Arnal; Maud Marie Leonie,28,0,45,17
1746602560458,SOCI 121,A00,890604,Pardo Guerra; Juan Pablo,38,0,45,7
1746602561489,SOCI 126,A01,890608,Staff,8,0,10,2
1746602562516,SOCI 127,A00,890609,Staff,18,0,30,12
1746602563541,SOCI 131,A00,890610,Thorpe; Charles Robert,37,0,45,8
1746602564569,SOCI 135,A00,890615,Payne; Christine Anna,14,0,45,31
1746602565594,SOCI 139,A00,890620,Staff,38,0,45,7
1746602566622,SOCI 148E,A00,890622,Calderon-Zaks; Michael Aar,36,0,45,9
1746602567650,SOCI 150,A00,890623,Kohler; Kristopher M.,31,0,45,14
1746602568675,SOCI 157,A00,890625,Jules-Rosette; Bennetta W.,18,0,20,2
1746602569699,SOCI 160,A00,890627,Payne; Christine Anna,21,0,45,24
1746602570728,SYN 1,A00,886855,Fish; Gwendolyn Anne,0,1,0,0
1746602570728,SYN 1,B00,906086,Fish; Gwendolyn Anne,0,2,0,2
1746602571753,SYN 2R,A00,886860,Staff,0,17,15,15
1746602571753,SYN 2R,B00,906106,Atkinson; Arthur Laird,0,16,15,15
1746602572786,SYN 100,A01,886866,Browne; Emily,0,28,20,20
1746602572786,SYN 100,B01,906128,Rock; Martin,0,4,20,20
1746602572786,SYN 100,C01,906140,Deavenport; James Cary,0,4,20,20
1746602572786,SYN 100,D01,907816,Deavenport; James Cary,0,5,20,20
1746602573816,TDAC 1,A00,890286,Walsh; Kim C.,7,0,20,13
1746602574858,TDAC 101,A00,890296,Basso; Beatrice,15,0,20,5
1746602575888,TDDE 131,A00,890297,Staff,47,0,50,3
1746602576913,TDDM 1,A00,890287,Weinberg; Sadie,25,0,30,5
1746602577939,TDGE 11,A00,890288,Fulton; Julia,138,0,200,62
1746602577939,TDGE 11,B00,890289,Castro; Robert Jess,184,0,200,16
1746602578970,TDGE 25,B00,957359,Walsh; Kim C.,5,0,20,15
1746602579997,TDGE 40,A01,890292,Power; Jade Yukana,26,0,30,4
1746602581025,TDGE 124,A00,890298,Havis; Allan,0,2,50,50
1746602582054,TDGE 131R,A00,890299,Burelle; Julie Sara Veronique,15,0,42,27
1746602583084,TDHT 101,A00,890300,Staff,10,0,20,10
1746602584108,TDHT 109,A01,890302,Anderson; Mysia Anyse,31,0,40,9
1746602585139,TDMV 1,A00,890293,Arcidiacono; Kristin,18,0,30,12
1746602586165,TDMV 2,A00,890294,Weinberg; Sadie,23,0,30,7
1746602587191,TDMV 3,A00,957878,Arcidiacono; Kristin,28,0,30,2
1746602589242,TDMV 138,A00,890304,Jun; Grace Shin Hae,25,0,40,15
1746602590267,TDMV 140,A00,890305,Corrales; Joseph Bernales,25,0,30,5
1746602591296,TDMV 142,A00,890307,Caligagan; Tony,32,0,40,8
1746602592323,TDMV 144,A00,890308,Camaya; Michelle Ann,25,0,30,5
1746602593350,TDPW 1,A00,890295,Stein; Deborah Isobel,3,0,20,17
1746602594374,USP 2,A01,890272,Lerner; Amy M,7,0,20,13
1746602595405,USP 3,A01,890274,Staff,12,0,30,18
1746602596429,USP 15,A01,890276,Sun; Feiyang,16,0,30,14
1746602597457,USP 25,A00,890277,Shenkman; Michael Thomas,18,0,25,7
1746602598497,USP 138,A00,890278,Staff,13,0,25,12
1746602599520,USP 143,A00,890279,Staff,21,0,70,49
1746602600550,USP 144,A00,890280,Chowdhury; Muhammed Zohir,16,0,30,14
1746602601579,USP 150,A00,890281,Boomhower; Matthew Charles,4,0,30,26
1746602602605,USP 151,A00,890282,Staff,16,0,20,4
1746602603629,USP 162,A00,890283,Andrews; Abigail Leslie,16,0,20,4
1746602604664,USP 168,A00,920477,Kwak; Nancy,0,0,5,5
1746602605688,USP 181,A00,890284,Staff,3,0,20,17
1746602606715,USP 191A,A00,890285,Staff,12,0,20,8
1746602607750,VIS 101,A00,886512,Staff,26,0,75,49
1746602608776,VIS 103,A00,886513,Cruz; Edwin Teddy,61,0,75,14
1746602609804,VIS 108,A00,886514,Staff,4,0,15,11
1746602610829,VIS 127P,A00,886515,Shen; Kuiyi,80,0,146,66
1746602611859,VIS 149,A00,886516,Yoldas; Pinar,0,0,15,15
1746602612886,VIS 164,A00,886526,Erdmann; Dean,19,0,22,3
1746602613911,VIS 194S,A00,886527,Staff,61,0,75,14
1746602614953,WCWP 10A,C00,886484,Martiniuk; Jill,12,0,15,3
1746602615996,WCWP 10B,A00,886490,Uriarte; Emma,0,0,15,15
1746602615996,WCWP 10B,B00,886491,Dhir; Simrita,8,0,15,7
1746602615996,WCWP 10B,C00,886492,Ornelas; Tricia,0,0,15,15
1746602617054,WCWP 100,A00,886494,Young; Mark T,0,6,15,15
1746602619262,AAS 10,A01,886199,Childs; Dennis R.,0,3,0,0
1746602620298,ANAR 104,A01,886940,Shtienberg; Gilad,27,0,30,3
1746602621324,ANAR 120,A00,886953,Staff,13,0,20,7
1746602622352,ANBI 148,A01,886955,Wilder; Linnea Lorene,30,0,40,10
1746602624402,ANSC 122,A00,886957,Staff,24,0,30,6
1746602625428,ANSC 150,A00,886958,Sloane; Julia Kathryn,2,0,15,13
1746602626461,ANSC 156,A00,886959,Jenkins; Janis A.,0,1,15,15
1746602627489,ANSC 180,A00,886960,Staff,11,0,17,6
1746602628519,ANSC 188,A00,886961,Jassal; Aftab,9,0,25,16
1746602629544,ANSC 190,A00,886962,Jassal; Aftab,14,0,25,11
1746602630570,ANSC 191,A00,886963,Staff,18,0,20,2
1746602631601,ANTH 3,A01,891689,Staff,17,0,20,3
1746602632632,ANTH 5,A00,886933,Semendeferi; Ekaterini,16,0,20,4
1746602633658,ANTH 10,A00,886934,Staff,0,12,30,30
1746602634690,ANTH 21,A01,886936,Staff,41,0,60,19
1746602635715,ANTH 23,A01,886938,Staff,92,0,100,8
1746602636744,ANTH 105,A00,886964,Stewart; Alexander B,84,0,100,16
1746602637770,ANTH 108,A00,886965,Pedersen; David,9,0,20,11
1746602638813,AWP 10,001,886147,Staff,0,0,0,0
1746602638813,AWP 10,002,886148,Staff,0,0,0,0
1746602638813,AWP 10,003,886149,Staff,0,0,0,0
1746602638813,AWP 10,004,886150,Staff,0,0,0,0
1746602638813,AWP 10,005,886151,Staff,0,0,0,0
1746602638813,AWP 10,006,886152,Staff,0,0,0,0
1746602638813,AWP 10,007,886153,Staff,0,0,0,0
1746602638813,AWP 10,008,886154,Staff,0,0,0,0
1746602638813,AWP 10,009,886155,Staff,0,0,0,0
1746602638813,AWP 10,010,886156,Staff,0,0,0,0
1746602638813,AWP 10,011,886158,Staff,0,0,0,0
1746602638813,AWP 10,012,886160,Staff,0,0,0,0
1746602638813,AWP 10,013,886161,Staff,0,0,0,0
1746602638813,AWP 10,014,886162,Staff,0,0,0,0
1746602638813,AWP 10,015,886163,Staff,0,0,0,0
1746602638813,AWP 10,016,886164,Staff,0,0,0,0
1746602638813,AWP 10,017,886165,Staff,0,0,0,0
1746602638813,AWP 10,018,886166,Staff,0,0,0,0
1746602638813,AWP 10,019,886168,Staff,0,0,0,0
1746602638813,AWP 10,020,886170,Staff,0,0,0,0
1746602638813,AWP 10,021,886172,Staff,0,0,0,0
1746602639859,AWP 10R,001,886173,Staff,0,1,0,0
1746602639859,AWP 10R,002,886174,Staff,0,1,0,0
1746602639859,AWP 10R,003,886175,Staff,0,0,0,0
1746602639859,AWP 10R,004,886176,Staff,0,0,0,0
1746602639859,AWP 10R,005,886177,Staff,0,0,0,0
1746602639859,AWP 10R,006,886178,Staff,0,0,0,0
1746602639859,AWP 10R,007,886179,Staff,0,0,0,0
1746602639859,AWP 10R,008,886181,Staff,0,0,0,0
1746602639859,AWP 10R,009,886182,Staff,0,0,0,0
1746602639859,AWP 10R,010,886183,Staff,0,0,0,0
1746602639859,AWP 10R,011,886184,Staff,0,0,0,0
1746602639859,AWP 10R,012,886185,Staff,0,0,0,0
1746602639859,AWP 10R,013,886186,Staff,0,0,0,0
1746602639859,AWP 10R,014,886187,Staff,0,0,0,0
1746602639859,AWP 10R,015,886188,Staff,0,0,0,0
1746602639859,AWP 10R,016,886189,Staff,0,0,0,0
1746602639859,AWP 10R,017,960532,Staff,0,0,0,0
1746602639859,AWP 10R,018,960533,Staff,0,0,0,0
1746602639859,AWP 10R,019,960534,Staff,0,0,0,0
1746602639859,AWP 10R,020,960538,Staff,0,0,0,0
1746602639859,AWP 10R,021,960540,Staff,0,0,0,0
1746602639859,AWP 10R,022,960541,Staff,0,0,0,0
1746602639859,AWP 10R,023,960542,Staff,0,0,0,0
1746602639859,AWP 10R,024,960544,Staff,0,0,0,0
1746602639859,AWP 10R,025,960545,Staff,0,0,0,0
1746602639859,AWP 10R,026,960548,Staff,0,0,0,0
1746602640884,AWP 102R,A00,886190,Staff,0,0,0,0
1746602640884,AWP 102R,B00,886191,Staff,0,0,0,0
1746602641910,BENG 100,A01,886193,Staff,17,0,30,13
1746602642938,BENG 122A,A01,886195,Hasty; Jeff M,13,0,30,17
1746602643965,BENG 166A,A00,886196,Sah; Robert Lie-Yuan,0,3,30,30
1746602645004,BENG 190,A00,958050,Khojah; Reem I,17,0,25,8
1746602646030,BIBC 102,A01,894320,Staff,0,1,46,46
1746602646030,BIBC 102,A02,894321,Staff,0,0,46,46
1746602646030,BIBC 102,A03,894344,Staff,6,0,46,40
1746602646030,BIBC 102,A04,894345,Staff,27,0,47,20
1746602647056,BICD 100R,A01,894365,Smith; Laurie,0,2,58,58
1746602647056,BICD 100R,A02,894366,Smith; Laurie,0,4,58,58
1746602647056,BICD 100R,A03,894367,Smith; Laurie,0,0,59,59
1746602647056,BICD 100R,A04,959869,Smith; Laurie,38,0,59,21
1746602648092,BICD 136,A01,894383,Gustafson-Brown; Cindy,14,0,50,36
1746602649143,BIEB 102,A01,894494,Butler; Shannon Rhey,51,0,130,79
1746602651219,BIEB 150,A01,894617,Wills; Christopher,3,0,20,17
1746602651219,BIEB 150,A02,894631,Wills; Christopher,3,0,20,17
1746602651219,BIEB 150,A03,894937,Wills; Christopher,3,0,20,17
1746602651219,BIEB 150,A04,894946,Wills; Christopher,5,0,20,15
1746602652290,BIEB 194,A00,906141,Kurle; Carolyn M.,5,0,20,15
1746602653323,BILD 1,A01,894154,Staff,3,0,19,16
1746602653323,BILD 1,A02,894155,Staff,14,0,19,5
1746602653323,BILD 1,A03,894160,Staff,13,0,19,6
1746602653323,BILD 1,A04,894161,Staff,15,0,18,3
1746602654357,BILD 2,A01,894168,Staff,0,0,50,50
1746602654357,BILD 2,A02,894169,Staff,0,0,50,50
1746602654357,BILD 2,A03,894179,Staff,0,0,50,50
1746602654357,BILD 2,A04,894203,Staff,22,0,50,28
1746602655383,BILD 3,A01,894213,Staff,23,0,31,8
1746602655383,BILD 3,A02,894214,Staff,26,0,31,5
1746602655383,BILD 3,A03,894235,Staff,28,0,31,3
1746602655383,BILD 3,A04,894236,Staff,28,0,32,4
1746602656411,BILD 4,A01,894253,Reuther; Keefe,5,0,24,19
1746602656411,BILD 4,A02,894258,Reuther; Keefe,16,0,24,8
1746602657444,BILD 5,A01,894276,Reuther; Keefe,34,0,50,16
1746602657444,BILD 5,A02,894277,Reuther; Keefe,45,0,50,5
1746602657444,BILD 5,A03,894290,Reuther; Keefe,44,0,50,6
1746602657444,BILD 5,A04,894291,Reuther; Keefe,48,0,50,2
1746602658475,BILD 24,A01,894297,Pirino; Giorgia,40,0,60,20
1746602659503,BIMM 100,B01,958915,Staff,71,0,100,29
1746602660536,BIMM 101,A01,895017,McDonnell; Lisa Marie,0,5,24,24
1746602660536,BIMM 101,A02,895018,McDonnell; Lisa Marie,0,5,24,24
1746602660536,BIMM 101,B01,895020,McDonnell; Lisa Marie,0,5,24,24
1746602660536,BIMM 101,B02,895021,McDonnell; Lisa Marie,0,4,24,24
1746602661563,BIMM 110,A01,895023,Staff,1,0,25,24
1746602661563,BIMM 110,A02,895024,Staff,9,0,25,16
1746602661563,BIMM 110,A03,895025,Staff,18,0,25,7
1746602661563,BIMM 110,A04,895031,Staff,20,0,25,5
1746602662592,BIMM 120,A01,895114,Gustafson-Brown; Cindy,14,0,28,14
1746602662592,BIMM 120,A02,895126,Gustafson-Brown; Cindy,21,0,27,6
1746602663630,BIPN 100,A01,895130,Yang; Mingyu,0,0,38,38
1746602663630,BIPN 100,A02,895131,Yang; Mingyu,31,0,38,7
1746602663630,BIPN 100,A03,895132,Yang; Mingyu,32,0,38,6
1746602663630,BIPN 100,A04,895133,Yang; Mingyu,27,0,36,9
1746602664663,BIPN 120,A01,895135,Cooke; James Edward,0,3,13,13
1746602664663,BIPN 120,A02,895136,Cooke; James Edward,0,1,13,13
1746602664663,BIPN 120,A03,895137,Cooke; James Edward,0,3,13,13
1746602664663,BIPN 120,A04,895156,Cooke; James Edward,0,2,11,11
1746602665703,BIPN 134,A01,895235,Cooke; James Edward,0,1,25,25
1746602665703,BIPN 134,A02,895237,Cooke; James Edward,0,0,25,25
1746602665703,BIPN 134,A03,895240,Cooke; James Edward,1,0,25,24
1746602665703,BIPN 134,A04,895270,Cooke; James Edward,20,0,25,5
1746602666743,BIPN 189,A00,892103,Staff,0,14,14,14
1746602668801,BISP 194,A00,958008,Staff,0,2,0,0
1746602669830,CAT 124,A01,922009,Staff,0,5,20,20
1746602670899,CAT 125R,A00,886390,Morales; Celeste Georgianna,0,3,20,20
1746602670899,CAT 125R,B00,886391,Irwin; Matthew Joseph,0,4,20,20
1746602670899,CAT 125R,C00,886392,Smith; Lauryn Alissa,0,2,20,20
1746602670899,CAT 125R,D00,886393,Vanderschuit; Maya Alysia,0,3,20,20
1746602670899,CAT 125R,E00,886394,Marchisotto; Jennifer Anne,0,3,20,20
1746602671929,CENG 15,A01,886218,Drews; Aaron,3,0,8,5
1746602672963,CENG 113,A00,886219,Opatkiewicz; Justin Paul,15,0,25,10
1746602673992,CGS 101,A00,887044,Staff,7,0,20,13
1746602675018,CGS 105,A01,887046,Staff,14,0,25,11
1746602676048,CGS 112,A00,887047,Cuong; Marisol,12,0,15,3
1746602677076,CGS 113,A00,887048,Staff,23,0,30,7
1746602678100,CGS 120,A00,887049,Staff,9,0,17,8
1746602679135,CHEM 6A,A01,886336,Lam; Tin Yiu,38,0,50,12
1746602679135,CHEM 6A,A02,886338,Lam; Tin Yiu,37,0,50,13
1746602680161,CHEM 6B,A01,886341,Hopkins; Patrycja Anna,16,0,50,34
1746602680161,CHEM 6B,A02,886343,Hopkins; Patrycja Anna,42,0,50,8
1746602681189,CHEM 6C,A01,886346,Albizati; Kim F.,0,2,50,50
1746602681189,CHEM 6C,A02,886348,Albizati; Kim F.,24,0,50,26
1746602682222,CHEM 40A,A01,886352,Klosterman; Jeremy K,65,0,100,35
1746602683248,CHEM 40B,A01,886356,Klosterman; Jeremy K,0,24,100,100
1746602684276,CHEM 41B,A01,886360,Theodorakis; Emmanuel,25,0,50,25
1746602684276,CHEM 41B,A02,886362,Theodorakis; Emmanuel,47,0,50,3
1746602685308,CHIN 165A,A00,886382,Xu; Li,18,0,20,2
1746602686335,CLAS 120,A00,886387,Myerston Santana; Jacobo,33,0,40,7
1746602687361,COGS 9,A01,886967,Shannon; Kyle Michael,42,0,60,18
1746602688387,COGS 11,A01,886969,Staff,9,0,30,21
1746602689413,COGS 14A,A01,886971,Staff,5,0,60,55
1746602690441,COGS 14B,A01,886973,Hoffman; Drew Ellen,4,0,60,56
1746602691468,COGS 18,A01,886975,Morgan; Eric,34,0,60,26
1746602692493,COGS 20,A01,886977,Staff,3,0,8,5
1746602692493,COGS 20,A02,886978,Staff,5,0,7,2
1746602693519,COGS 100,A01,907783,Staff,0,1,30,30
1746602694550,COGS 101B,A01,886980,Staff,0,4,48,48
1746602695598,COGS 101C,A01,886982,Delgado; Tania,0,5,44,44
1746602696631,COGS 102A,A01,886984,Johnson; Christine M.,3,0,30,27
1746602697659,COGS 118B,A01,886986,Staff,0,4,88,88
1746602698687,COGS 150,A01,886988,Bergen; Benjamin,22,0,50,28
1746602699713,COGS 153,A00,886989,Delgado; Tania,0,3,41,41
1746602700740,COGS 186,A01,886991,Staff,0,0,32,32
1746602701766,COGS 187A,A01,886993,Boyle; Mary E. T.,7,0,30,23
1746602702792,COGS 189,A00,886994,Staff,0,1,30,30
1746602703825,COMM 10,A01,886996,Staff,0,0,20,21
1746602703825,COMM 10,A02,886997,Staff,10,0,20,10
1746602703825,COMM 10,A03,959845,Staff,19,0,20,1
1746602704853,COMM 20,A01,886999,Leuning; Grant Maurstad,24,0,40,16
1746602706906,COMM 100A,A01,887002,Staff,0,0,20,25
1746602706906,COMM 100A,A02,887003,Staff,5,0,20,15
1746602707933,COMM 100B,A01,887005,Staff,0,8,20,24
1746602708963,COMM 106D,A00,887006,Staff,14,0,40,26
1746602709994,COMM 110G,A00,887007,Whitworth-Smith; Andrew C,12,0,40,28
1746602711020,COMM 111B,A00,887008,Staff,31,0,40,9
1746602712045,COMM 113T,A00,887009,Abuelhiga; Soraya Jill,28,0,40,12
1746602712045,COMM 113T,B00,906733,Staff,39,0,40,1
1746602713073,COMM 145,A00,887010,Staff,13,0,40,27
1746602714102,COMM 146,A00,887054,Staff,32,0,40,8
1746602715126,COMM 190,A00,887012,Staff,8,0,23,15
1746602716157,CSE 8A,A50,887015,Cao; Yingjun,56,0,85,29
1746602717185,CSE 11,A01,887017,Cao; Yingjun,11,0,70,59
1746602718214,CSE 20,A01,887019,Staff,30,0,50,20
1746602719241,CSE 21,A01,887021,Staff,79,0,100,21
1746602719241,CSE 21,B01,892583,Braun; Oliver,45,0,50,5
1746602720268,CSE 30,A01,887025,Eldon; John,142,0,200,58
1746602721297,CSE 100,A01,887027,Staff,26,0,50,24
1746602721297,CSE 100,A02,887028,Staff,42,0,50,8
1746602722324,CSE 101,A01,887030,Braun; Oliver,74,0,100,26
1746602722324,CSE 101,B01,887032,Jones; Miles E,0,3,50,50
1746602722324,CSE 101,B02,887033,Jones; Miles E,0,2,50,50
1746602723351,CSE 105,A01,908084,Jones; Miles E,32,0,50,18
1746602723351,CSE 105,A02,908087,Jones; Miles E,31,0,50,19
1746602724380,CSE 135,A01,887035,Powell; Thomas Allan,0,5,50,50
1746602725407,CSE 142,A01,887037,Staff,7,0,60,53
1746602726436,CSE 142L,A01,887039,Staff,34,0,60,26
1746602727463,CSE 151A,A01,887041,Solares; Edwin A,47,0,100,53
1746602728493,CSE 175,A01,887043,Kumar; Rakesh,30,0,30,0
1746602729527,CSS 1,A01,886389,Staff,0,1,40,40
1746602730556,DSC 30,A01,908097,Liao; Soohyun Nam,47,0,75,28
1746602731583,DSC 40A,A01,908099,Shannon; Kyle Michael,30,0,50,20
1746602732608,DSC 40B,A01,908112,Staff,15,0,50,35
1746602733636,DSC 80,A01,908116,Staff,19,0,60,41
1746602734663,DSC 197,001,956863,Eldridge; Justin Matthew,9999,0,9999,0
1746602735699,ECE 5,A01,886400,Morris; Karcher William,1,0,6,5
1746602735699,ECE 5,A02,886401,Morris; Karcher William,3,0,6,3
1746602736730,ECE 148,A01,886403,Silberman; Jack,0,14,14,14
1746602737761,ECON 1,A01,887265,Crane; Meredith Helen,11,0,70,59
1746602737761,ECON 1,B01,887268,Staff,42,0,50,8
1746602738789,ECON 2,A01,887273,Crane; Meredith Helen,54,0,70,16
1746602739819,ECON 3,A01,887279,Rondina; Giacomo,31,0,70,39
1746602740847,ECON 4,A01,887282,Anderson; John Charles,0,2,10,10
1746602741873,ECON 5,A01,887285,Staff,34,0,45,11
1746602741873,ECON 5,B01,887292,Staff,41,0,45,4
1746602742916,ECON 100A,A01,887337,Newhouse; Herbert S,54,0,70,16
1746602742916,ECON 100A,B01,887349,Staff,45,0,50,5
1746602743956,ECON 100B,A01,887361,Du; Songzi,29,0,70,41
1746602744987,ECON 100C,A01,887445,Newhouse; Herbert S,59,0,70,11
1746602746013,ECON 105,A00,887488,Vespa; Emanuel Ignacio,23,0,35,12
1746602747042,ECON 109,A01,887506,Shishkin; Denis,28,0,35,7
1746602748070,ECON 110A,A01,887568,Alon; Titan Michael,0,2,35,35
1746602748070,ECON 110A,B01,907601,Alon; Titan Michael,20,0,35,15
1746602749113,ECON 110B,A01,887598,Levkoff; Steven B.,0,24,70,70
1746602750141,ECON 112,A00,887599,Rondina; Giacomo,19,0,35,16
1746602751171,ECON 120A,A01,887603,Dai; Yinlin,36,0,70,34
1746602752196,ECON 120C,A01,887608,Sun; Yixiao,0,1,35,35
1746602752196,ECON 120C,B01,887614,Sun; Yixiao,0,0,35,35
1746602753224,ECON 138,A00,887621,Bharadwaj; Prashant,0,21,20,20
1746602754255,ECON 144,A00,958007,Squires; Dale E,11,0,35,24
1746602755280,ECON 171,A01,907666,Staff,18,0,35,17
1746602756346,ECON 175,A00,887626,Wu; Pak Yeung,22,0,35,13
1746602757373,ECON 190,A00,887640,Vespa; Emanuel Ignacio,22,0,35,13
1746602758410,EDS 25,A01,888197,Staff,0,0,0,0
1746602758410,EDS 25,A02,888209,Staff,0,0,0,0
1746602758410,EDS 25,A03,888210,Staff,0,0,0,0
1746602758410,EDS 25,A04,888212,Staff,0,0,0,0
1746602758410,EDS 25,A05,888213,Staff,0,0,0,0
1746602758410,EDS 25,A06,888214,Staff,0,0,0,0
1746602758410,EDS 25,A07,888235,Staff,0,2,0,0
1746602758410,EDS 25,A08,888236,Staff,0,0,0,0
1746602758410,EDS 25,A09,888240,Staff,0,0,0,0
1746602758410,EDS 25,A10,888244,Staff,0,0,0,0
1746602758410,EDS 25,B01,888273,Staff,0,0,0,0
1746602758410,EDS 25,B02,888285,Staff,0,0,0,0
1746602758410,EDS 25,B03,888423,Staff,0,0,0,1
1746602758410,EDS 25,B04,888432,Staff,0,0,0,0
1746602758410,EDS 25,B05,888433,Staff,0,0,0,0
1746602758410,EDS 25,B06,888467,Staff,0,0,0,0
1746602758410,EDS 25,B07,888468,Staff,0,0,0,0
1746602758410,EDS 25,B08,888479,Staff,0,0,0,0
1746602758410,EDS 25,B09,888484,Staff,0,0,0,0
1746602758410,EDS 25,B10,888487,Staff,0,0,0,0
1746602759437,EDS 38,A01,907700,Choi; Bailey Miyeon,30,0,30,0
1746602760467,EDS 112,A01,888601,Chapman; Thandeka K,12,0,40,28
1746602761495,EDS 115,A00,888697,Mendez; Kathrina Mendoza,10,0,30,20
1746602762537,EDS 116,A01,888893,Staff,33,0,40,7
1746602764606,EDS 124AR,A00,889133,Staff,29,0,50,21
1746602764606,EDS 124AR,B00,907471,Simon; Elizabeth A,37,0,50,13
1746602765633,EDS 124BR,A00,889134,Simon; Elizabeth A,44,0,100,56
1746602766658,EDS 125,A00,889135,Staff,25,0,30,5
1746602767723,EDS 126,A01,889138,Staff,35,0,40,5
1746602768754,EDS 164R,A01,889142,Wishard Guerra; Alison G.,32,0,50,18
1746602769784,ENG 30,A01,886396,Staff,0,0,0,0
1746602769784,ENG 30,B01,886398,Staff,0,0,0,0
1746602770812,ENVR 102,A00,906150,Montejo; Carolina,23,0,25,2
1746602771841,ETHN 103A,A00,887236,Man; Simeon S,0,2,0,0
1746602772872,ETHN 113,A00,887239,Staff,16,0,30,14
1746602773897,ETHN 116,A00,887240,Staff,16,0,25,9
1746602774927,ETHN 117,A00,887241,Choi; Esther Min,28,0,30,2
1746602775954,ETHN 118,A00,887243,Staff,24,0,30,6
1746602776980,ETHN 127,A00,887248,Cuong; Marisol,11,0,15,4
1746602778010,ETHN 139,A00,887250,Staff,7,0,10,3
1746602779036,ETHN 142,A00,887252,Staff,9,0,30,21
1746602780074,ETHN 161,A00,887253,Browne; Errol Tsekani,24,0,30,6
1746602781100,ETHN 163FR,A00,887255,Burelle; Julie Sara Veronique,0,0,5,5
1746602782129,GLBH 20,A00,889149,Elwardani; Nile Regina,8,0,42,34
1746602784187,GLBH 111,A01,889152,Burgos; Jose L.,17,0,17,0
1746602785211,GLBH 150,A00,889181,Sloane; Julia Kathryn,0,5,15,15
1746602787265,HDS 60,A01,886406,Warstadt; Melissa Fawn,72,0,80,8
1746602788295,HIAF 111,A00,889324,Gyamfi; Bright,25,0,32,7
1746602789325,HIEA 131,A00,889328,Staff,15,0,32,17
1746602790352,HIEA 144,A00,889333,Henry; Todd A.,26,0,32,6
1746602791378,HIEA 154,A00,889336,Henry; Todd A.,24,0,32,8
1746602792416,HIEU 106,A00,889339,Staff,22,0,32,10
1746602794468,HIEU 114,A00,889340,Staff,4,0,32,28
1746602795496,HIEU 135GS,A00,889342,Patterson; Patrick H.,0,0,1,24
1746602796524,HIEU 137,A00,889343,Edington; Claire Ellen,10,0,25,15
1746602797550,HIEU 148,A00,889345,Staff,14,0,32,18
1746602798576,HIEU 154,A00,889346,Biess; Frank Peter,21,0,32,11
1746602799602,HILA 102,A00,889351,Staff,12,0,32,20
1746602800629,HILD 2A,A01,889221,Lewandoski; Julia Mavis,0,8,32,32
1746602801658,HILD 7B,A01,889225,Man; Simeon S,0,12,32,32
1746602802694,HILD 7C,A01,889288,Alvarez; Luis A,0,14,32,32
1746602803719,HILD 30,A01,889323,Staff,0,5,32,32
1746602805782,HISC 119,A00,889383,Golan; Tal,20,0,32,12
1746602806810,HIUS 103,A00,889384,Man; Simeon S,0,0,32,32
1746602807837,HIUS 117,A00,919797,Kwak; Nancy,18,0,32,14
1746602808864,HIUS 142A,A00,919788,Staff,22,0,32,10
1746602810919,HIUS 149,A00,889386,Gyamfi; Bright,26,0,32,6
1746602811946,HIUS 155,A00,889387,Alvarez; Luis A,15,0,32,17
1746602812977,HUM 3,A01,886499,Caldwell; Michael Alan,19,0,50,31
1746602814003,HUM 3GS,A00,886500,Rodriguez; Bretton Sigfred,0,0,0,28
1746602815042,HUM 3R,A01,886502,Markman; Kristina,0,36,50,50
1746602816097,HUM 4,A01,886504,Crum; Matthew Stephen,23,0,50,27
1746602816097,HUM 4,B01,886506,West; Geoffrey Scott,17,0,50,33
1746602817122,HUM 4GS,A00,886507,Staff,0,0,0,19
1746602818151,HUM 5,A01,886509,Staff,31,0,50,19
1746602819186,HUM 5R,A01,886511,Zavodny; Tatiana Sophia,0,39,50,50
1746602820215,JAPN 180,A00,886407,Staff,16,0,40,24
1746602821243,LATI 50,A01,886409,Martin-Cabrera; Luis,3,0,22,19
1746602821243,LATI 50,A02,886410,Martin-Cabrera; Luis,19,0,22,3
1746602821243,LATI 50,A03,886411,Martin-Cabrera; Luis,21,0,22,1
1746602821243,LATI 50,A04,886412,Martin-Cabrera; Luis,8,0,22,14
1746602822273,LAWS 101,A00,907664,Staff,28,0,60,32
1746602823300,LIAB 1A,A00,889388,Saab; Dima,17,0,20,3
1746602824332,LIAB 1AX,A00,889389,El Cheddadi; Youniss,18,0,20,2
1746602825361,LIFR 1C,A00,889391,Van Moer; Vinciane G,8,0,20,12
1746602826388,LIFR 1CX,A00,889392,Van Moer; Vinciane G,7,0,20,13
1746602827417,LIFR 1D,A00,889393,Van Moer; Vinciane G,7,0,20,13
1746602828443,LIFR 1DX,A00,889394,Van Moer; Vinciane G,8,0,20,12
1746602829475,LIGN 7,A00,886923,Staff,25,0,50,25
1746602830502,LIGN 17,A00,886924,Kehler; Andrew Scott,126,0,150,24
1746602831530,LTAM 110,A00,889395,Staff,15,0,30,15
1746602832557,LTAM 110GS,A00,958010,Rodriguez; Bretton Sigfred,0,0,0,28
1746602833583,LTCH 101,A00,889397,Staff,23,0,25,2
1746602834610,LTCS 130,A00,889398,Staff,23,0,25,2
1746602835636,LTEA 138,A00,889399,Staff,24,0,40,16
1746602836663,LTEN 149,A00,889400,Wesling; Megan E.,0,3,25,25
1746602837692,LTEN 169,A00,889401,Staff,20,0,25,5
1746602838718,LTEN 180,A00,889402,Staff,10,0,15,5
1746602839745,LTEN 181,A00,889403,Staff,21,0,25,4
1746602840772,LTWL 100,A00,889404,Myerston Santana; Jacobo,2,0,25,23
1746602841798,LTWL 180GS,A00,889405,Staff,0,0,20,20
1746602842827,LTWL 181,A00,889406,Staff,16,0,25,9
1746602843857,LTWL 184,A00,889475,Mukherjee; Silpa,22,0,25,3
1746602844884,LTWR 102C,A00,889486,Staff,29,0,30,1
1746602845910,LTWR 115W,A00,889491,Staff,0,2,15,15
1746602846936,MAE 8,A01,886905,Staff,0,2,0,0
1746602847968,MAE 11,A00,886906,Bandaru; Prabhakar,0,7,50,50
1746602849011,MAE 20,A00,886907,Evdokimenko; Ekaterina,43,0,70,27
1746602850040,MAE 30B,A00,886909,Ghazinejad; Maziar,25,0,45,20
1746602851070,MAE 101B,A00,886910,Saintillan; David,30,0,45,15
1746602852097,MAE 105,A00,886911,Bandaru; Prabhakar,18,0,50,32
1746602853126,MAE 107,B00,958024,Staff,7,0,50,43
1746602854150,MAE 143B,A00,886913,Bewley; Thomas R,2,0,40,38
1746602855178,MAE 148,A01,886915,Silberman; Jack,0,3,14,14
1746602856204,MAE 160,A00,886916,Evdokimenko; Ekaterina,30,0,60,30
1746602857237,MATH 3C,A01,889681,Staff,0,2,30,30
1746602857237,MATH 3C,A02,960048,Staff,23,0,30,7
1746602858268,MATH 10A,A01,889760,Staff,26,0,30,4
1746602858268,MATH 10A,A02,889783,Staff,29,0,30,1
1746602859316,MATH 10B,A01,889785,Verstraete; Jacques Allan,1,0,35,34
1746602859316,MATH 10B,A02,889795,Verstraete; Jacques Allan,4,0,35,31
1746602859316,MATH 10B,B01,889797,Verstraete; Jacques Allan,3,0,35,32
1746602859316,MATH 10B,B02,889828,Verstraete; Jacques Allan,3,0,35,32
1746602860384,MATH 10C,A01,889849,Habib; Yousaf,8,0,30,22
1746602860384,MATH 10C,A02,889852,Habib; Yousaf,14,0,30,16
1746602860384,MATH 10C,A03,889853,Habib; Yousaf,22,0,30,8
1746602860384,MATH 10C,A04,889858,Habib; Yousaf,20,0,30,10
1746602860384,MATH 10C,B01,889861,Staff,1,0,30,29
1746602860384,MATH 10C,B02,889862,Staff,24,0,30,6
1746602860384,MATH 10C,B03,889863,Staff,27,0,30,3
1746602860384,MATH 10C,B04,889967,Staff,23,0,30,7
1746602861411,MATH 18,A01,889974,Staff,7,0,30,23
1746602861411,MATH 18,A02,889977,Staff,20,0,30,10
1746602861411,MATH 18,B01,889984,Hardiman; Liam,20,0,30,10
1746602861411,MATH 18,B02,889985,Hardiman; Liam,25,0,30,5
1746602862485,MATH 20A,A01,889990,Suk; Andrew Hoon,30,0,35,5
1746602863520,MATH 20B,A01,889993,Ohm; Ko Woon,21,0,30,9
1746602863520,MATH 20B,A02,889994,Ohm; Ko Woon,30,0,30,0
1746602863520,MATH 20B,B01,889996,Ohm; Ko Woon,22,0,30,8
1746602863520,MATH 20B,B02,889997,Ohm; Ko Woon,23,0,30,7
1746602864548,MATH 20C,A01,889999,Hammock; Frances H,17,0,30,13
1746602864548,MATH 20C,A02,890003,Hammock; Frances H,23,0,30,7
1746602864548,MATH 20C,B01,890006,Hammock; Frances H,2,0,30,28
1746602864548,MATH 20C,B02,890007,Hammock; Frances H,12,0,30,18
1746602865576,MATH 20D,A01,890011,Cheng; Hsiao-Bing,1,0,30,29
1746602865576,MATH 20D,A02,890012,Cheng; Hsiao-Bing,14,0,30,16
1746602865576,MATH 20D,B01,890016,Cheng; Hsiao-Bing,13,0,30,17
1746602865576,MATH 20D,B02,890017,Cheng; Hsiao-Bing,13,0,30,17
1746602866603,MATH 20E,A01,890026,Harel; Guershon,1,0,30,29
1746602866603,MATH 20E,A02,890029,Harel; Guershon,22,0,30,8
1746602866603,MATH 20E,B01,890033,Harel; Guershon,7,0,30,23
1746602866603,MATH 20E,B02,890101,Harel; Guershon,21,0,30,9
1746602867632,MATH 102,A01,890104,Staff,18,0,30,12
1746602867632,MATH 102,A02,890105,Staff,27,0,30,3
1746602868665,MATH 103B,A01,890116,Salehi Golsefidy; Alireza,3,0,30,27
1746602868665,MATH 103B,B01,890118,Staff,0,3,34,34
1746602869702,MATH 109,A01,890121,Aliabadi Sr.; Mohsen,0,0,30,30
1746602869702,MATH 109,B01,890124,Upadrashta; Pranav Kumar,18,0,30,12
1746602870727,MATH 120A,A01,890126,Eggers; John Dietrich,13,0,30,17
1746602871755,MATH 142B,A01,890128,Ioana; Adrian,19,0,30,11
1746602871755,MATH 142B,A02,890129,Ioana; Adrian,12,0,30,18
1746602872781,MATH 154,A01,890174,Staff,0,1,30,30
1746602872781,MATH 154,A02,890182,Staff,0,0,30,30
1746602873809,MATH 168A,A01,890197,Dumitriu; Ioana,21,0,35,14
1746602874835,MATH 170A,A01,890240,Nie; Jiawang,1,0,30,29
1746602874835,MATH 170A,A02,890241,Nie; Jiawang,11,0,30,19
1746602874835,MATH 170A,A03,890249,Nie; Jiawang,23,0,30,7
1746602875868,MATH 170B,A01,957891,Nag; Panchali,13,0,35,22
1746602877926,MATH 181A,A01,908025,Staff,0,3,35,35
1746602877926,MATH 181A,A02,960115,Staff,26,0,35,9
1746602878958,MATH 181B,A01,959874,Staff,24,0,30,6
1746602879985,MATH 193B,A01,890265,Staff,0,4,35,35
1746602881010,MGT 4,A01,890311,Anderson; John Charles,42,0,88,46
1746602882039,MGT 5,A00,907740,Staff,12,0,98,86
1746602883081,MGT 12,A00,890312,Lindenberger; Wade Douglas,67,0,98,31
1746602884106,MGT 16,A00,957883,Staff,78,0,98,20
1746602886159,MGT 45,A00,890314,Pecore; Joseph P.,45,0,98,53
1746602887184,MGT 71,A00,890315,Staff,0,12,98,98
1746602888214,MGT 100,A00,890316,Yavorsky; Daniel Ryan,44,0,98,54
1746602889245,MGT 103,A00,890317,Ehrich; Kristine R,73,0,98,25
1746602890271,MGT 105,A00,890356,Bates; Kenneth Walter,0,9,98,98
1746602891301,MGT 112,A00,890360,Ehrich; Kristine R,55,0,98,43
1746602892331,MGT 127R,A00,907732,Zhu; Kevin Xiaoguo,23,0,98,75
1746602893358,MGT 131B,A00,890361,Anderson; John Charles,59,0,98,39
1746602894386,MGT 137,A00,890362,Lindenberger; Wade Douglas,65,0,98,33
1746602895412,MGT 160,A00,890369,Johnson; Erik Barry,9,0,98,89
1746602897505,MGT 164,A00,890372,Zimmermann; Carsten,0,40,98,98
1746602898531,MGT 180,A00,890374,Bliss; Barbara Ann,11,0,98,87
1746602899565,MMW 15,A01,886414,Chang; Edmond Yi-Teh,0,12,28,28
1746602899565,MMW 15,A02,886415,Chang; Edmond Yi-Teh,0,8,28,28
1746602899565,MMW 15,A03,886416,Chang; Edmond Yi-Teh,0,9,28,28
1746602899565,MMW 15,A04,886417,Chang; Edmond Yi-Teh,0,8,28,28
1746602899565,MMW 15,B01,886419,Chang; Edmond Yi-Teh,0,7,28,28
1746602899565,MMW 15,B02,886420,Chang; Edmond Yi-Teh,0,7,28,28
1746602899565,MMW 15,B03,886421,Chang; Edmond Yi-Teh,0,7,28,28
1746602899565,MMW 15,B04,886422,Chang; Edmond Yi-Teh,0,8,28,28
1746602899565,MMW 15,C01,886424,Staff,0,9,28,28
1746602899565,MMW 15,C02,886425,Staff,0,8,28,28
1746602899565,MMW 15,C03,886426,Staff,0,8,28,28
1746602899565,MMW 15,C04,886427,Staff,0,8,28,28
1746602899565,MMW 15,C05,958038,Staff,0,8,28,28
1746602899565,MMW 15,C06,958039,Staff,0,7,28,28
1746602900597,MMW 15GS,A00,906910,Patterson; Patrick H.,4,0,28,24
1746602901628,MMW 122R,A01,886429,Rahimi; Babak,0,13,28,28
1746602901628,MMW 122R,A02,886430,Rahimi; Babak,0,12,28,28
1746602901628,MMW 122R,A03,958040,Rahimi; Babak,0,11,28,28
1746602902661,MUS 1A,A01,890937,Staff,2,0,25,23
1746602902661,MUS 1A,A02,891035,Staff,6,0,25,19
1746602902661,MUS 1A,C01,958912,Staff,24,0,25,1
1746602902661,MUS 1A,C02,958913,Staff,25,0,25,0
1746602904718,MUS 2AK,A00,957092,Ohnishi; Takae,15,0,15,0
1746602905749,MUS 4,A01,891044,Staff,0,0,25,25
1746602905749,MUS 4,A02,891045,Staff,22,0,25,3
1746602905749,MUS 4,B01,891048,Staff,17,0,25,8
1746602905749,MUS 4,B02,891050,Staff,25,0,25,0
1746602906788,MUS 5,A01,957506,Dubnov; Shlomo,0,0,25,25
1746602906788,MUS 5,A02,957622,Dubnov; Shlomo,12,0,25,13
1746602906788,MUS 5,A03,957623,Dubnov; Shlomo,20,0,25,5
1746602907819,MUS 6,A01,891053,Freitas Caetano; Marcelo,24,0,25,1
1746602907819,MUS 6,A02,891054,Freitas Caetano; Marcelo,23,0,25,2
1746602908847,MUS 7,A01,891081,Staff,0,0,25,25
1746602908847,MUS 7,A02,891082,Staff,3,0,25,22
1746602909874,MUS 8GS,A00,891118,Borgo; David Garcia,1,0,25,24
1746602910900,MUS 11,A01,891140,Staff,8,0,25,17
1746602910900,MUS 11,A02,891141,Staff,21,0,25,4
1746602911925,MUS 13,A01,891143,Staff,8,0,25,17
1746602911925,MUS 13,A02,891144,Staff,24,0,25,1
1746602912953,MUS 15,A01,891146,Staff,9,0,25,16
1746602912953,MUS 15,A02,891148,Staff,21,0,25,4
1746602912953,MUS 15,B01,891150,Staff,18,0,25,7
1746602912953,MUS 15,B02,891151,Staff,25,0,25,0
1746602913981,MUS 20,A01,891153,Staff,5,0,20,15
1746602913981,MUS 20,A02,891155,Staff,14,0,20,6
1746602915011,MUS 80,A00,891156,Staff,19,0,25,6
1746602915011,MUS 80,B00,891157,Staff,23,0,25,2
1746602916043,MUS 130,A00,891158,Ohnishi; Takae,35,0,35,0
1746602917077,MUS 150GS,A01,891160,Borgo; David Garcia,1,0,25,24
1746602918108,MUS 170,A01,891162,Freitas Caetano; Marcelo,20,0,25,5
1746602918108,MUS 170,A02,891164,Freitas Caetano; Marcelo,21,0,25,4
1746602919137,NANO 11,A00,886220,Vazquez Mena; Oscar,13,0,15,2
1746602920175,NANO 15,A01,886222,Drews; Aaron,4,0,7,3
1746602921259,NANO 104,A00,886224,Sirbuly; Donald,17,0,25,8
1746602922287,PH 40,A00,886528,Staff,23,0,40,17
1746602923312,PH 45,A01,886799,Staff,35,0,40,5
1746602924340,PH 110,A00,886802,Staff,0,6,40,40
1746602925367,PH 172,A00,906716,Staff,19,0,35,16
1746602926399,PH 191,A00,886803,Staff,6,0,40,34
1746602927430,PHIL 1,A00,889500,Staff,20,0,30,10
1746602928468,PHIL 10,A01,889549,Grush; Rick Scott,16,0,22,6
1746602928468,PHIL 10,A02,889551,Grush; Rick Scott,22,0,22,0
1746602929514,PHIL 28,A01,889559,Lamey; Andy M.,0,2,31,31
1746602929514,PHIL 28,A02,889561,Lamey; Andy M.,0,1,30,30
1746602929514,PHIL 28,A03,889572,Lamey; Andy M.,0,1,30,30
1746602930539,PHIL 35,A00,907839,Staff,13,0,15,2
1746602931564,PHIL 60,A00,889574,Staff,73,0,90,17
1746602932589,PHIL 101,A00,958004,Staff,12,0,15,3
1746602934652,PHIL 136,A00,889582,Fulkerson; Matthew Todd,26,0,45,19
1746602935680,PHIL 163,A01,889601,Staff,21,0,30,9
1746602935680,PHIL 163,B01,889606,Brandt; Reuven A,0,3,0,0
1746602936706,PHIL 164,A00,889610,Staff,16,0,30,14
1746602937730,PHIL 165,A00,889613,Staff,22,0,30,8
1746602938762,PHYS 1A,A00,886431,Staff,30,0,70,40
1746602939793,PHYS 1AL,001,886432,Tsai; Philbert S,0,1,30,30
1746602939793,PHYS 1AL,002,886436,Tsai; Philbert S,13,0,30,17
1746602940833,PHYS 1B,A00,886439,Staff,184,0,240,56
1746602941862,PHYS 1BL,001,886441,Tsai; Philbert S,0,4,30,30
1746602941862,PHYS 1BL,002,886444,Tsai; Philbert S,2,0,30,28
1746602942890,PHYS 1C,A00,896092,Arnold; Kam S,78,0,146,68
1746602943916,PHYS 1CL,001,886448,Tsai; Philbert S,0,0,30,30
1746602943916,PHYS 1CL,002,886449,Tsai; Philbert S,1,0,30,29
1746602943916,PHYS 1CL,003,886450,Tsai; Philbert S,16,0,30,14
1746602943916,PHYS 1CL,004,886451,Tsai; Philbert S,15,0,30,15
1746602944944,PHYS 2B,A01,886457,Staff,67,0,115,48
1746602945969,PHYS 2C,A01,886460,Shotwell; Brian,0,9,65,65
1746602946997,PHYS 2CL,A01,886467,Staff,0,4,28,28
1746602946997,PHYS 2CL,A02,886468,Staff,0,3,28,28
1746602948024,PHYS 2D,A01,886470,Staff,10,0,50,40
1746602949050,PHYS 4B,A01,886475,Grinstein; Benjamin,22,0,40,18
1746602950077,POLI 5,A00,891173,Desposato; Scott,7,0,25,18
1746602951107,POLI 5D,A01,891175,Staff,5,0,5,0
1746602951107,POLI 5D,B01,891178,Staff,5,0,5,0
1746602952131,POLI 11,A00,891179,Ferree; Karen E,0,0,35,35
1746602953158,POLI 12,A00,891180,Staff,15,0,30,15
1746602954184,POLI 27,A01,891182,Staff,11,0,75,64
1746602955215,POLI 30,A00,891183,Staff,8,0,50,42
1746602956239,POLI 100B,A00,891244,Staff,5,1,35,30
1746602957265,POLI 100I,A00,891247,Staff,7,0,30,23
1746602958291,POLI 104J,A00,891248,Nichter; Maysa,14,0,30,16
1746602959315,POLI 104U,A00,891250,Nichter; Maysa,1,0,30,29
1746602961371,POLI 110B,A00,891255,Wiens; David,19,0,25,6
1746602962407,POLI 112A,A00,891256,Wiens; David,6,0,25,19
1746602963433,POLI 114BR,A00,891261,Staff,19,0,30,11
1746602964457,POLI 117R,A00,891262,Forman; Fonna,0,6,50,50
1746602965482,POLI 118,A00,891264,Ingham; Sean,17,0,25,8
1746602966510,POLI 124A,A00,891265,Staff,18,0,20,2
1746602967537,POLI 125D,A00,891266,Nichter; Simeon C,2,0,25,23
1746602968565,POLI 126,A00,891268,Nichter; Simeon C,7,0,25,18
1746602969591,POLI 126AA,A00,891272,Staff,15,0,25,10
1746602970618,POLI 130AA,A00,891273,Staff,15,0,20,5
1746602971642,POLI 134AA,A00,891274,Staff,4,0,20,16
1746602973692,POLI 138,A00,891278,Staff,21,0,25,4
1746602974717,POLI 142K,A00,891280,Staff,10,0,25,15
1746602975745,POLI 142M,A00,891281,Gartzke; Erik,16,0,30,14
1746602976770,POLI 142P,A00,891284,Staff,20,0,30,10
1746602977794,POLI 143,A00,891285,Gartzke; Erik,12,0,30,18
1746602978821,POLI 153,A00,891286,Staff,19,0,20,1
1746602980874,POLI 175,A00,891290,Staff,15,0,20,5
1746602981901,PSYC 1,A00,890674,Steiner; Eric Tomas,0,11,45,45
1746602982933,PSYC 2,A00,890676,Albright; Thomas D,20,0,35,15
1746602983957,PSYC 3,A00,890679,Staff,17,0,20,3
1746602984993,PSYC 6,A00,959858,Staff,19,0,20,1
1746602986020,PSYC 60,A01,890684,Rickard; Timothy C.,0,6,45,45
1746602987048,PSYC 70,A01,890689,Geller; Emma Harlan,6,0,30,24
1746602988073,PSYC 71,A01,959860,Staff,21,0,25,4
1746602989098,PSYC 100,A00,890690,Lacefield; Katharine I,0,50,180,180
1746602990127,PSYC 102,A00,890695,Staff,18,0,40,22
1746602991152,PSYC 105,A00,890699,Geller; Emma Harlan,70,0,100,30
1746602992178,PSYC 106,A00,890701,Gorman; Michael R.,5,0,30,25
1746602993207,PSYC 108,A00,890704,Adrian; Julia Anna,0,29,50,50
1746602994232,PSYC 118,A01,890712,Staff,11,0,30,19
1746602995259,PSYC 124,A00,890716,Chapman; Eddie Nathaniel,25,0,60,35
1746602996288,PSYC 131,A00,890717,Anagnostaras; Stephan,0,7,80,80
1746602997315,PSYC 137,A00,890719,Winkielman; Piotr,0,11,30,30
1746602998345,PSYC 144,A00,890721,Adrian; Julia Anna,0,9,45,45
1746602999375,PSYC 162,A00,890805,Staff,0,2,75,75
1746603000401,PSYC 169,A00,890810,Staff,0,15,30,30
1746603001433,PSYC 172,A00,890814,Gorman; Michael R.,9,0,30,21
1746603002458,PSYC 181,A00,890818,Anagnostaras; Stephan,6,0,200,194
1746603003483,PSYC 184,A00,959861,Staff,161,0,175,14
1746603004512,PSYC 189,A00,890823,Staff,0,2,30,30
1746603005541,PSYC 191,A00,890884,Rickard; Timothy C.,0,11,35,35
1746603006572,PSYC 193,A00,890913,Staff,19,0,30,11
1746603006572,PSYC 193,B00,890914,Chapman; Eddie Nathaniel,24,0,30,6
1746603007602,PSYC 193L,A01,890918,Lowe; Angela Beth,20,0,30,10
1746603007602,PSYC 193L,B01,890921,Hurwitz; Ethan Scott,20,0,30,10
1746603007602,PSYC 193L,C01,890928,Staff,30,0,30,0
1746603008628,RELI 149,A00,886806,Rahimi; Babak,23,0,40,17
1746603009655,SE 9,A01,886814,Staff,7,0,20,13
1746603010679,SE 101B,A01,886816,Chadha; Mayank,3,0,35,32
1746603011711,SE 110B,A00,886818,Zhu; Qiang,4,0,75,71
1746603012734,SE 125,A01,886830,Staff,10,0,30,20
1746603013762,SE 130B,A01,886835,Staff,14,0,40,26
1746603014788,SE 131A,A01,886838,Krysl; Petr,34,0,55,21
1746603015813,SE 154,A00,886840,Staff,28,0,50,22
1746603016842,SE 164GS,A01,886849,Staff,6,0,20,14
1746603017871,SE 167GS,A01,886853,Staff,6,0,20,14
1746603018899,SIO 25,A01,890107,Staff,19,0,30,11
1746603019927,SIO 45,A00,890109,Cook; Geoffrey W,115,0,200,85
1746603020951,SIO 109R,A00,890110,Forman; Fonna,0,16,20,20
1746603021996,SIO 187,A01,890114,Kacev; David,15,0,40,25
1746603023028,SOCI 1,A01,890431,Thorpe; Charles Robert,14,0,30,16
1746603023028,SOCI 1,A02,890518,Thorpe; Charles Robert,30,0,30,0
1746603024054,SOCI 2,A01,957978,Staff,25,0,25,0
1746603024054,SOCI 2,A02,957979,Staff,23,0,25,2
1746603025078,SOCI 20,A01,890523,Calderon-Zaks; Michael Aar,21,0,30,9
1746603025078,SOCI 20,A02,890526,Calderon-Zaks; Michael Aar,29,0,30,1
1746603026103,SOCI 30,A01,890533,Pardo Guerra; Juan Pablo,37,0,40,3
1746603027127,SOCI 40,A01,890535,Staff,27,0,45,18
1746603028155,SOCI 104Q,A00,890559,Staff,18,0,30,12
1746603029182,SOCI 106,A00,890560,Arnal; Maud Marie Leonie,20,0,30,10
1746603030210,SOCI 110,A00,890567,Holkenbrink-Monk; Charlene,19,0,30,11
1746603031238,SOCI 112,A00,890568,Victoria Torres; Pablo,2,0,55,53
1746603032277,SOCI 115,A00,890597,Arnal; Maud Marie Leonie,28,0,45,17
1746603034330,SOCI 121,A00,890604,Pardo Guerra; Juan Pablo,38,0,45,7
1746603035355,SOCI 126,A01,890608,Staff,8,0,10,2
1746603036386,SOCI 127,A00,890609,Staff,18,0,30,12
1746603037412,SOCI 131,A00,890610,Thorpe; Charles Robert,37,0,45,8
1746603038438,SOCI 135,A00,890615,Payne; Christine Anna,14,0,45,31
1746603039465,SOCI 139,A00,890620,Staff,38,0,45,7
1746603040490,SOCI 148E,A00,890622,Calderon-Zaks; Michael Aar,36,0,45,9
1746603041518,SOCI 150,A00,890623,Kohler; Kristopher M.,31,0,45,14
1746603042547,SOCI 157,A00,890625,Jules-Rosette; Bennetta W.,18,0,20,2
1746603043573,SOCI 160,A00,890627,Payne; Christine Anna,21,0,45,24
1746603044599,SYN 1,A00,886855,Fish; Gwendolyn Anne,0,1,0,0
1746603044599,SYN 1,B00,906086,Fish; Gwendolyn Anne,0,2,0,2
1746603045624,SYN 2R,A00,886860,Staff,0,17,15,15
1746603045624,SYN 2R,B00,906106,Atkinson; Arthur Laird,0,16,15,15
1746603046654,SYN 100,A01,886866,Browne; Emily,0,28,20,20
1746603046654,SYN 100,B01,906128,Rock; Martin,0,4,20,20
1746603046654,SYN 100,C01,906140,Deavenport; James Cary,0,4,20,20
1746603046654,SYN 100,D01,907816,Deavenport; James Cary,0,5,20,20
1746603047684,TDAC 1,A00,890286,Walsh; Kim C.,7,0,20,13
1746603048711,TDAC 101,A00,890296,Basso; Beatrice,15,0,20,5
1746603049735,TDDE 131,A00,890297,Staff,47,0,50,3
1746603050760,TDDM 1,A00,890287,Weinberg; Sadie,25,0,30,5
1746603051787,TDGE 11,A00,890288,Fulton; Julia,138,0,200,62
1746603051787,TDGE 11,B00,890289,Castro; Robert Jess,184,0,200,16
1746603052814,TDGE 25,B00,957359,Walsh; Kim C.,5,0,20,15
1746603053844,TDGE 40,A01,890292,Power; Jade Yukana,26,0,30,4
1746603054869,TDGE 124,A00,890298,Havis; Allan,0,2,50,50
1746603055897,TDGE 131R,A00,890299,Burelle; Julie Sara Veronique,15,0,42,27
1746603056924,TDHT 101,A00,890300,Staff,10,0,20,10
1746603057951,TDHT 109,A01,890302,Anderson; Mysia Anyse,31,0,40,9
1746603058980,TDMV 1,A00,890293,Arcidiacono; Kristin,18,0,30,12
1746603060005,TDMV 2,A00,890294,Weinberg; Sadie,23,0,30,7
1746603061035,TDMV 3,A00,957878,Arcidiacono; Kristin,28,0,30,2
1746603063091,TDMV 138,A00,890304,Jun; Grace Shin Hae,25,0,40,15
1746603064124,TDMV 140,A00,890305,Corrales; Joseph Bernales,25,0,30,5
1746603065149,TDMV 142,A00,890307,Caligagan; Tony,32,0,40,8
1746603066175,TDMV 144,A00,890308,Camaya; Michelle Ann,25,0,30,5
1746603067200,TDPW 1,A00,890295,Stein; Deborah Isobel,3,0,20,17
1746603068234,USP 2,A01,890272,Lerner; Amy M,7,0,20,13
1746603069259,USP 3,A01,890274,Staff,12,0,30,18
1746603070286,USP 15,A01,890276,Sun; Feiyang,16,0,30,14
1746603071317,USP 25,A00,890277,Shenkman; Michael Thomas,18,0,25,7
1746603072342,USP 138,A00,890278,Staff,13,0,25,12
1746603073371,USP 143,A00,890279,Staff,21,0,70,49
1746603074404,USP 144,A00,890280,Chowdhury; Muhammed Zohir,16,0,30,14
1746603075431,USP 150,A00,890281,Boomhower; Matthew Charles,4,0,30,26
1746603076459,USP 151,A00,890282,Staff,16,0,20,4
1746603077489,USP 162,A00,890283,Andrews; Abigail Leslie,16,0,20,4
1746603078516,USP 168,A00,920477,Kwak; Nancy,0,0,5,5
1746603079545,USP 181,A00,890284,Staff,3,0,20,17
1746603080572,USP 191A,A00,890285,Staff,12,0,20,8
1746603081596,VIS 101,A00,886512,Staff,26,0,75,49
1746603082633,VIS 103,A00,886513,Cruz; Edwin Teddy,61,0,75,14
1746603083659,VIS 108,A00,886514,Staff,4,0,15,11
1746603084685,VIS 127P,A00,886515,Shen; Kuiyi,80,0,146,66
1746603085718,VIS 149,A00,886516,Yoldas; Pinar,0,0,15,15
1746603086752,VIS 164,A00,886526,Erdmann; Dean,19,0,22,3
1746603087780,VIS 194S,A00,886527,Staff,61,0,75,14
1746603088809,WCWP 10A,C00,886484,Martiniuk; Jill,12,0,15,3
1746603089835,WCWP 10B,A00,886490,Uriarte; Emma,0,0,15,15
1746603089835,WCWP 10B,B00,886491,Dhir; Simrita,8,0,15,7
1746603089835,WCWP 10B,C00,886492,Ornelas; Tricia,0,0,15,15
1746603090872,WCWP 100,A00,886494,Young; Mark T,0,6,15,15
1746603093036,AAS 10,A01,886199,Childs; Dennis R.,0,3,0,0
1746603094061,ANAR 104,A01,886940,Shtienberg; Gilad,27,0,30,3
1746603095090,ANAR 120,A00,886953,Staff,13,0,20,7
1746603096116,ANBI 148,A01,886955,Wilder; Linnea Lorene,30,0,40,10
1746603098169,ANSC 122,A00,886957,Staff,24,0,30,6
1746603099194,ANSC 150,A00,886958,Sloane; Julia Kathryn,2,0,15,13
1746603100220,ANSC 156,A00,886959,Jenkins; Janis A.,0,1,15,15
1746603101244,ANSC 180,A00,886960,Staff,11,0,17,6
1746603102269,ANSC 188,A00,886961,Jassal; Aftab,9,0,25,16
1746603103350,ANSC 190,A00,886962,Jassal; Aftab,14,0,25,11
1746603104376,ANSC 191,A00,886963,Staff,18,0,20,2
1746603105411,ANTH 3,A01,891689,Staff,17,0,20,3
1746603106436,ANTH 5,A00,886933,Semendeferi; Ekaterini,16,0,20,4
1746603107463,ANTH 10,A00,886934,Staff,0,12,30,30
1746603108497,ANTH 21,A01,886936,Staff,41,0,60,19
1746603109527,ANTH 23,A01,886938,Staff,92,0,100,8
1746603110559,ANTH 105,A00,886964,Stewart; Alexander B,84,0,100,16
1746603111584,ANTH 108,A00,886965,Pedersen; David,9,0,20,11
1746603112618,AWP 10,001,886147,Staff,0,0,0,0
1746603112618,AWP 10,002,886148,Staff,0,0,0,0
1746603112618,AWP 10,003,886149,Staff,0,0,0,0
1746603112618,AWP 10,004,886150,Staff,0,0,0,0
1746603112618,AWP 10,005,886151,Staff,0,0,0,0
1746603112618,AWP 10,006,886152,Staff,0,0,0,0
1746603112618,AWP 10,007,886153,Staff,0,0,0,0
1746603112618,AWP 10,008,886154,Staff,0,0,0,0
1746603112618,AWP 10,009,886155,Staff,0,0,0,0
1746603112618,AWP 10,010,886156,Staff,0,0,0,0
1746603112618,AWP 10,011,886158,Staff,0,0,0,0
1746603112618,AWP 10,012,886160,Staff,0,0,0,0
1746603112618,AWP 10,013,886161,Staff,0,0,0,0
1746603112618,AWP 10,014,886162,Staff,0,0,0,0
1746603112618,AWP 10,015,886163,Staff,0,0,0,0
1746603112618,AWP 10,016,886164,Staff,0,0,0,0
1746603112618,AWP 10,017,886165,Staff,0,0,0,0
1746603112618,AWP 10,018,886166,Staff,0,0,0,0
1746603112618,AWP 10,019,886168,Staff,0,0,0,0
1746603112618,AWP 10,020,886170,Staff,0,0,0,0
1746603112618,AWP 10,021,886172,Staff,0,0,0,0
1746603113667,AWP 10R,001,886173,Staff,0,1,0,0
1746603113667,AWP 10R,002,886174,Staff,0,1,0,0
1746603113667,AWP 10R,003,886175,Staff,0,0,0,0
1746603113667,AWP 10R,004,886176,Staff,0,0,0,0
1746603113667,AWP 10R,005,886177,Staff,0,0,0,0
1746603113667,AWP 10R,006,886178,Staff,0,0,0,0
1746603113667,AWP 10R,007,886179,Staff,0,0,0,0
1746603113667,AWP 10R,008,886181,Staff,0,0,0,0
1746603113667,AWP 10R,009,886182,Staff,0,0,0,0
1746603113667,AWP 10R,010,886183,Staff,0,0,0,0
1746603113667,AWP 10R,011,886184,Staff,0,0,0,0
1746603113667,AWP 10R,012,886185,Staff,0,0,0,0
1746603113667,AWP 10R,013,886186,Staff,0,0,0,0
1746603113667,AWP 10R,014,886187,Staff,0,0,0,0
1746603113667,AWP 10R,015,886188,Staff,0,0,0,0
1746603113667,AWP 10R,016,886189,Staff,0,0,0,0
1746603113667,AWP 10R,017,960532,Staff,0,0,0,0
1746603113667,AWP 10R,018,960533,Staff,0,0,0,0
1746603113667,AWP 10R,019,960534,Staff,0,0,0,0
1746603113667,AWP 10R,020,960538,Staff,0,0,0,0
1746603113667,AWP 10R,021,960540,Staff,0,0,0,0
1746603113667,AWP 10R,022,960541,Staff,0,0,0,0
1746603113667,AWP 10R,023,960542,Staff,0,0,0,0
1746603113667,AWP 10R,024,960544,Staff,0,0,0,0
1746603113667,AWP 10R,025,960545,Staff,0,0,0,0
1746603113667,AWP 10R,026,960548,Staff,0,0,0,0
1746603114694,AWP 102R,A00,886190,Staff,0,0,0,0
1746603114694,AWP 102R,B00,886191,Staff,0,0,0,0
1746603115720,BENG 100,A01,886193,Staff,17,0,30,13
1746603116758,BENG 122A,A01,886195,Hasty; Jeff M,13,0,30,17
1746603117788,BENG 166A,A00,886196,Sah; Robert Lie-Yuan,0,3,30,30
1746603118823,BENG 190,A00,958050,Khojah; Reem I,17,0,25,8
1746603119856,BIBC 102,A01,894320,Staff,0,1,46,46
1746603119856,BIBC 102,A02,894321,Staff,0,0,46,46
1746603119856,BIBC 102,A03,894344,Staff,6,0,46,40
1746603119856,BIBC 102,A04,894345,Staff,27,0,47,20
1746603120883,BICD 100R,A01,894365,Smith; Laurie,0,2,58,58
1746603120883,BICD 100R,A02,894366,Smith; Laurie,0,4,58,58
1746603120883,BICD 100R,A03,894367,Smith; Laurie,0,0,59,59
1746603120883,BICD 100R,A04,959869,Smith; Laurie,38,0,59,21
1746603121916,BICD 136,A01,894383,Gustafson-Brown; Cindy,14,0,50,36
1746603122944,BIEB 102,A01,894494,Butler; Shannon Rhey,51,0,130,79
1746603125567,BIEB 150,A01,894617,Wills; Christopher,3,0,20,17
1746603125567,BIEB 150,A02,894631,Wills; Christopher,3,0,20,17
1746603125567,BIEB 150,A03,894937,Wills; Christopher,3,0,20,17
1746603125567,BIEB 150,A04,894946,Wills; Christopher,5,0,20,15
1746603126597,BIEB 194,A00,906141,Kurle; Carolyn M.,5,0,20,15
1746603127632,BILD 1,A01,894154,Staff,3,0,19,16
1746603127632,BILD 1,A02,894155,Staff,14,0,19,5
1746603127632,BILD 1,A03,894160,Staff,13,0,19,6
1746603127632,BILD 1,A04,894161,Staff,15,0,18,3
1746603128660,BILD 2,A01,894168,Staff,0,0,50,50
1746603128660,BILD 2,A02,894169,Staff,0,0,50,50
1746603128660,BILD 2,A03,894179,Staff,0,0,50,50
1746603128660,BILD 2,A04,894203,Staff,22,0,50,28
1746603129694,BILD 3,A01,894213,Staff,23,0,31,8
1746603129694,BILD 3,A02,894214,Staff,26,0,31,5
1746603129694,BILD 3,A03,894235,Staff,28,0,31,3
1746603129694,BILD 3,A04,894236,Staff,28,0,32,4
1746603130730,BILD 4,A01,894253,Reuther; Keefe,5,0,24,19
1746603130730,BILD 4,A02,894258,Reuther; Keefe,16,0,24,8
1746603131759,BILD 5,A01,894276,Reuther; Keefe,34,0,50,16
1746603131759,BILD 5,A02,894277,Reuther; Keefe,45,0,50,5
1746603131759,BILD 5,A03,894290,Reuther; Keefe,44,0,50,6
1746603131759,BILD 5,A04,894291,Reuther; Keefe,48,0,50,2
1746603132794,BILD 24,A01,894297,Pirino; Giorgia,40,0,60,20
1746603133821,BIMM 100,B01,958915,Staff,71,0,100,29
1746603134863,BIMM 101,A01,895017,McDonnell; Lisa Marie,0,5,24,24
1746603134863,BIMM 101,A02,895018,McDonnell; Lisa Marie,0,5,24,24
1746603134863,BIMM 101,B01,895020,McDonnell; Lisa Marie,0,5,24,24
1746603134863,BIMM 101,B02,895021,McDonnell; Lisa Marie,0,4,24,24
1746603135892,BIMM 110,A01,895023,Staff,1,0,25,24
1746603135892,BIMM 110,A02,895024,Staff,9,0,25,16
1746603135892,BIMM 110,A03,895025,Staff,18,0,25,7
1746603135892,BIMM 110,A04,895031,Staff,20,0,25,5
1746603136918,BIMM 120,A01,895114,Gustafson-Brown; Cindy,14,0,28,14
1746603136918,BIMM 120,A02,895126,Gustafson-Brown; Cindy,21,0,27,6
1746603137944,BIPN 100,A01,895130,Yang; Mingyu,0,0,38,38
1746603137944,BIPN 100,A02,895131,Yang; Mingyu,31,0,38,7
1746603137944,BIPN 100,A03,895132,Yang; Mingyu,32,0,38,6
1746603137944,BIPN 100,A04,895133,Yang; Mingyu,27,0,36,9
1746603138980,BIPN 120,A01,895135,Cooke; James Edward,0,3,13,13
1746603138980,BIPN 120,A02,895136,Cooke; James Edward,0,1,13,13
1746603138980,BIPN 120,A03,895137,Cooke; James Edward,0,3,13,13
1746603138980,BIPN 120,A04,895156,Cooke; James Edward,0,2,11,11
1746603140015,BIPN 134,A01,895235,Cooke; James Edward,0,1,25,25
1746603140015,BIPN 134,A02,895237,Cooke; James Edward,0,0,25,25
1746603140015,BIPN 134,A03,895240,Cooke; James Edward,1,0,25,24
1746603140015,BIPN 134,A04,895270,Cooke; James Edward,20,0,25,5
1746603141043,BIPN 189,A00,892103,Staff,0,14,14,14
1746603143102,BISP 194,A00,958008,Staff,0,2,0,0
1746603144145,CAT 124,A01,922009,Staff,0,5,20,20
1746603145186,CAT 125R,A00,886390,Morales; Celeste Georgianna,0,4,20,20
1746603145186,CAT 125R,B00,886391,Irwin; Matthew Joseph,0,4,20,20
1746603145186,CAT 125R,C00,886392,Smith; Lauryn Alissa,0,2,20,20
1746603145186,CAT 125R,D00,886393,Vanderschuit; Maya Alysia,0,3,20,20
1746603145186,CAT 125R,E00,886394,Marchisotto; Jennifer Anne,0,3,20,20
1746603146220,CENG 15,A01,886218,Drews; Aaron,3,0,8,5
1746603147246,CENG 113,A00,886219,Opatkiewicz; Justin Paul,15,0,25,10
1746603148273,CGS 101,A00,887044,Staff,7,0,20,13
1746603149300,CGS 105,A01,887046,Staff,14,0,25,11
1746603150326,CGS 112,A00,887047,Cuong; Marisol,12,0,15,3
1746603151351,CGS 113,A00,887048,Staff,23,0,30,7
1746603152380,CGS 120,A00,887049,Staff,9,0,17,8
1746603153429,CHEM 6A,A01,886336,Lam; Tin Yiu,38,0,50,12
1746603153429,CHEM 6A,A02,886338,Lam; Tin Yiu,37,0,50,13
1746603154468,CHEM 6B,A01,886341,Hopkins; Patrycja Anna,16,0,50,34
1746603154468,CHEM 6B,A02,886343,Hopkins; Patrycja Anna,42,0,50,8
1746603155503,CHEM 6C,A01,886346,Albizati; Kim F.,0,2,50,50
1746603155503,CHEM 6C,A02,886348,Albizati; Kim F.,24,0,50,26
1746603156530,CHEM 40A,A01,886352,Klosterman; Jeremy K,65,0,100,35
1746603157561,CHEM 40B,A01,886356,Klosterman; Jeremy K,0,24,100,100
1746603158596,CHEM 41B,A01,886360,Theodorakis; Emmanuel,25,0,50,25
1746603158596,CHEM 41B,A02,886362,Theodorakis; Emmanuel,47,0,50,3
1746603159625,CHIN 165A,A00,886382,Xu; Li,18,0,20,2
1746603160655,CLAS 120,A00,886387,Myerston Santana; Jacobo,33,0,40,7
1746603161682,COGS 9,A01,886967,Shannon; Kyle Michael,42,0,60,18
1746603162713,COGS 11,A01,886969,Staff,9,0,30,21
1746603163740,COGS 14A,A01,886971,Staff,5,0,60,55
1746603164768,COGS 14B,A01,886973,Hoffman; Drew Ellen,4,0,60,56
1746603165800,COGS 18,A01,886975,Morgan; Eric,34,0,60,26
1746603166827,COGS 20,A01,886977,Staff,3,0,8,5
1746603166827,COGS 20,A02,886978,Staff,5,0,7,2
1746603167853,COGS 100,A01,907783,Staff,0,1,30,30
1746603168881,COGS 101B,A01,886980,Staff,0,4,48,48
1746603169912,COGS 101C,A01,886982,Delgado; Tania,0,5,44,44
1746603170944,COGS 102A,A01,886984,Johnson; Christine M.,3,0,30,27
1746603171971,COGS 118B,A01,886986,Staff,0,4,88,88
1746603172998,COGS 150,A01,886988,Bergen; Benjamin,22,0,50,28
1746603174029,COGS 153,A00,886989,Delgado; Tania,0,3,41,41
1746603175055,COGS 186,A01,886991,Staff,0,0,32,32
1746603176081,COGS 187A,A01,886993,Boyle; Mary E. T.,7,0,30,23
1746603177114,COGS 189,A00,886994,Staff,0,1,30,30
1746603178144,COMM 10,A01,886996,Staff,0,0,20,21
1746603178144,COMM 10,A02,886997,Staff,10,0,20,10
1746603178144,COMM 10,A03,959845,Staff,19,0,20,1
1746603179170,COMM 20,A01,886999,Leuning; Grant Maurstad,24,0,40,16
1746603181230,COMM 100A,A01,887002,Staff,0,0,20,25
1746603181230,COMM 100A,A02,887003,Staff,5,0,20,15
1746603182255,COMM 100B,A01,887005,Staff,0,8,20,24
1746603183282,COMM 106D,A00,887006,Staff,14,0,40,26
1746603184313,COMM 110G,A00,887007,Whitworth-Smith; Andrew C,12,0,40,28
1746603185342,COMM 111B,A00,887008,Staff,31,0,40,9
1746603186381,COMM 113T,A00,887009,Abuelhiga; Soraya Jill,28,0,40,12
1746603186381,COMM 113T,B00,906733,Staff,39,0,40,1
1746603187409,COMM 145,A00,887010,Staff,13,0,40,27
1746603188441,COMM 146,A00,887054,Staff,32,0,40,8
1746603189468,COMM 190,A00,887012,Staff,8,0,23,15
1746603190499,CSE 8A,A50,887015,Cao; Yingjun,56,0,85,29
1746603191525,CSE 11,A01,887017,Cao; Yingjun,11,0,70,59
1746603192560,CSE 20,A01,887019,Staff,30,0,50,20
1746603193598,CSE 21,A01,887021,Staff,79,0,100,21
1746603193598,CSE 21,B01,892583,Braun; Oliver,45,0,50,5
1746603194688,CSE 30,A01,887025,Eldon; John,142,0,200,58
1746603195717,CSE 100,A01,887027,Staff,26,0,50,24
1746603195717,CSE 100,A02,887028,Staff,42,0,50,8
1746603196753,CSE 101,A01,887030,Braun; Oliver,74,0,100,26
1746603196753,CSE 101,B01,887032,Jones; Miles E,0,3,50,50
1746603196753,CSE 101,B02,887033,Jones; Miles E,0,2,50,50
1746603197788,CSE 105,A01,908084,Jones; Miles E,32,0,50,18
1746603197788,CSE 105,A02,908087,Jones; Miles E,31,0,50,19
1746603198817,CSE 135,A01,887035,Powell; Thomas Allan,0,5,50,50
1746603199846,CSE 142,A01,887037,Staff,7,0,60,53
1746603200873,CSE 142L,A01,887039,Staff,34,0,60,26
1746603201911,CSE 151A,A01,887041,Solares; Edwin A,47,0,100,53
1746603202937,CSE 175,A01,887043,Kumar; Rakesh,30,0,30,0
1746603203965,CSS 1,A01,886389,Staff,0,1,40,40
1746603204995,DSC 30,A01,908097,Liao; Soohyun Nam,47,0,75,28
1746603206022,DSC 40A,A01,908099,Shannon; Kyle Michael,30,0,50,20
1746603207049,DSC 40B,A01,908112,Staff,15,0,50,35
1746603208081,DSC 80,A01,908116,Staff,19,0,60,41
1746603209111,DSC 197,001,956863,Eldridge; Justin Matthew,9999,0,9999,0
1746603210140,ECE 5,A01,886400,Morris; Karcher William,1,0,6,5
1746603210140,ECE 5,A02,886401,Morris; Karcher William,3,0,6,3
1746603211167,ECE 148,A01,886403,Silberman; Jack,0,14,14,14
1746603212204,ECON 1,A01,887265,Crane; Meredith Helen,11,0,70,59
1746603212204,ECON 1,B01,887268,Staff,42,0,50,8
1746603213232,ECON 2,A01,887273,Crane; Meredith Helen,54,0,70,16
1746603214257,ECON 3,A01,887279,Rondina; Giacomo,31,0,70,39
1746603215290,ECON 4,A01,887282,Anderson; John Charles,0,2,10,10
1746603216316,ECON 5,A01,887285,Staff,34,0,45,11
1746603216316,ECON 5,B01,887292,Staff,41,0,45,4
1746603217359,ECON 100A,A01,887337,Newhouse; Herbert S,54,0,70,16
1746603217359,ECON 100A,B01,887349,Staff,45,0,50,5
1746603218402,ECON 100B,A01,887361,Du; Songzi,29,0,70,41
1746603219436,ECON 100C,A01,887445,Newhouse; Herbert S,59,0,70,11
1746603221059,ECON 105,A00,887488,Vespa; Emanuel Ignacio,23,0,35,12
1746603222087,ECON 109,A01,887506,Shishkin; Denis,28,0,35,7
1746603223116,ECON 110A,A01,887568,Alon; Titan Michael,0,2,35,35
1746603223116,ECON 110A,B01,907601,Alon; Titan Michael,20,0,35,15
1746603224144,ECON 110B,A01,887598,Levkoff; Steven B.,0,24,70,70
1746603225172,ECON 112,A00,887599,Rondina; Giacomo,19,0,35,16
1746603226203,ECON 120A,A01,887603,Dai; Yinlin,36,0,70,34
1746603227231,ECON 120C,A01,887608,Sun; Yixiao,0,1,35,35
1746603227231,ECON 120C,B01,887614,Sun; Yixiao,0,0,35,35
1746603228258,ECON 138,A00,887621,Bharadwaj; Prashant,0,21,20,20
1746603229287,ECON 144,A00,958007,Squires; Dale E,11,0,35,24
1746603230316,ECON 171,A01,907666,Staff,18,0,35,17
1746603231362,ECON 175,A00,887626,Wu; Pak Yeung,22,0,35,13
1746603232400,ECON 190,A00,887640,Vespa; Emanuel Ignacio,22,0,35,13
1746603233454,EDS 25,A01,888197,Staff,0,0,0,0
1746603233454,EDS 25,A02,888209,Staff,0,0,0,0
1746603233454,EDS 25,A03,888210,Staff,0,0,0,0
1746603233454,EDS 25,A04,888212,Staff,0,0,0,0
1746603233454,EDS 25,A05,888213,Staff,0,0,0,0
1746603233454,EDS 25,A06,888214,Staff,0,0,0,0
1746603233454,EDS 25,A07,888235,Staff,0,2,0,0
1746603233454,EDS 25,A08,888236,Staff,0,0,0,0
1746603233454,EDS 25,A09,888240,Staff,0,0,0,0
1746603233454,EDS 25,A10,888244,Staff,0,0,0,0
1746603233454,EDS 25,B01,888273,Staff,0,0,0,0
1746603233454,EDS 25,B02,888285,Staff,0,0,0,0
1746603233454,EDS 25,B03,888423,Staff,0,0,0,1
1746603233454,EDS 25,B04,888432,Staff,0,0,0,0
1746603233454,EDS 25,B05,888433,Staff,0,0,0,0
1746603233454,EDS 25,B06,888467,Staff,0,0,0,0
1746603233454,EDS 25,B07,888468,Staff,0,0,0,0
1746603233454,EDS 25,B08,888479,Staff,0,0,0,0
1746603233454,EDS 25,B09,888484,Staff,0,0,0,0
1746603233454,EDS 25,B10,888487,Staff,0,0,0,0
1746603234493,EDS 38,A01,907700,Choi; Bailey Miyeon,30,0,30,0
1746603235523,EDS 112,A01,888601,Chapman; Thandeka K,12,0,40,28
1746603236553,EDS 115,A00,888697,Mendez; Kathrina Mendoza,10,0,30,20
1746603237588,EDS 116,A01,888893,Staff,33,0,40,7
1746603239646,EDS 124AR,A00,889133,Staff,29,0,50,21
1746603239646,EDS 124AR,B00,907471,Simon; Elizabeth A,37,0,50,13
1746603240679,EDS 124BR,A00,889134,Simon; Elizabeth A,44,0,100,56
1746603241706,EDS 125,A00,889135,Staff,25,0,30,5
1746603242733,EDS 126,A01,889138,Staff,35,0,40,5
1746603243758,EDS 164R,A01,889142,Wishard Guerra; Alison G.,32,0,50,18
1746603244793,ENG 30,A01,886396,Staff,0,0,0,0
1746603244793,ENG 30,B01,886398,Staff,0,0,0,0
1746603245838,ENVR 102,A00,906150,Montejo; Carolina,23,0,25,2
1746603246867,ETHN 103A,A00,887236,Man; Simeon S,0,2,0,0
1746603247893,ETHN 113,A00,887239,Staff,16,0,30,14
1746603248920,ETHN 116,A00,887240,Staff,16,0,25,9
1746603249948,ETHN 117,A00,887241,Choi; Esther Min,28,0,30,2
1746603250973,ETHN 118,A00,887243,Staff,24,0,30,6
1746603252000,ETHN 127,A00,887248,Cuong; Marisol,11,0,15,4
1746603253027,ETHN 139,A00,887250,Staff,7,0,10,3
1746603254061,ETHN 142,A00,887252,Staff,9,0,30,21
1746603255091,ETHN 161,A00,887253,Browne; Errol Tsekani,24,0,30,6
1746603256123,ETHN 163FR,A00,887255,Burelle; Julie Sara Veronique,0,0,5,5
1746603257159,GLBH 20,A00,889149,Elwardani; Nile Regina,8,0,42,34
1746603259227,GLBH 111,A01,889152,Burgos; Jose L.,17,0,17,0
1746603260256,GLBH 150,A00,889181,Sloane; Julia Kathryn,0,5,15,15
1746603262307,HDS 60,A01,886406,Warstadt; Melissa Fawn,72,0,80,8
1746603263342,HIAF 111,A00,889324,Gyamfi; Bright,25,0,32,7
1746603264367,HIEA 131,A00,889328,Staff,15,0,32,17
1746603265392,HIEA 144,A00,889333,Henry; Todd A.,26,0,32,6
1746603266418,HIEA 154,A00,889336,Henry; Todd A.,24,0,32,8
1746603267449,HIEU 106,A00,889339,Staff,22,0,32,10
1746603269510,HIEU 114,A00,889340,Staff,4,0,32,28
1746603270537,HIEU 135GS,A00,889342,Patterson; Patrick H.,0,0,1,24
1746603271562,HIEU 137,A00,889343,Edington; Claire Ellen,10,0,25,15
1746603272589,HIEU 148,A00,889345,Staff,14,0,32,18
1746603273623,HIEU 154,A00,889346,Biess; Frank Peter,21,0,32,11
1746603274654,HILA 102,A00,889351,Staff,12,0,32,20
1746603275681,HILD 2A,A01,889221,Lewandoski; Julia Mavis,0,8,32,32
1746603276707,HILD 7B,A01,889225,Man; Simeon S,0,12,32,32
1746603277738,HILD 7C,A01,889288,Alvarez; Luis A,0,14,32,32
1746603278767,HILD 30,A01,889323,Staff,0,5,32,32
1746603280836,HISC 119,A00,889383,Golan; Tal,20,0,32,12
1746603281868,HIUS 103,A00,889384,Man; Simeon S,0,0,32,32
1746603282897,HIUS 117,A00,919797,Kwak; Nancy,18,0,32,14
1746603283923,HIUS 142A,A00,919788,Staff,22,0,32,10
1746603285995,HIUS 149,A00,889386,Gyamfi; Bright,26,0,32,6
1746603287021,HIUS 155,A00,889387,Alvarez; Luis A,15,0,32,17
1746603288050,HUM 3,A01,886499,Caldwell; Michael Alan,19,0,50,31
1746603289076,HUM 3GS,A00,886500,Rodriguez; Bretton Sigfred,0,0,0,28
1746603290105,HUM 3R,A01,886502,Markman; Kristina,0,36,50,50
1746603291133,HUM 4,A01,886504,Crum; Matthew Stephen,23,0,50,27
1746603291133,HUM 4,B01,886506,West; Geoffrey Scott,17,0,50,33
1746603292160,HUM 4GS,A00,886507,Staff,0,0,0,19
1746603293190,HUM 5,A01,886509,Staff,31,0,50,19
1746603294220,HUM 5R,A01,886511,Zavodny; Tatiana Sophia,0,39,50,50
1746603295250,JAPN 180,A00,886407,Staff,16,0,40,24
1746603296277,LATI 50,A01,886409,Martin-Cabrera; Luis,3,0,22,19
1746603296277,LATI 50,A02,886410,Martin-Cabrera; Luis,19,0,22,3
1746603296277,LATI 50,A03,886411,Martin-Cabrera; Luis,21,0,22,1
1746603296277,LATI 50,A04,886412,Martin-Cabrera; Luis,8,0,22,14
1746603297310,LAWS 101,A00,907664,Staff,28,0,60,32
1746603298336,LIAB 1A,A00,889388,Saab; Dima,17,0,20,3
1746603299383,LIAB 1AX,A00,889389,El Cheddadi; Youniss,18,0,20,2
1746603300417,LIFR 1C,A00,889391,Van Moer; Vinciane G,8,0,20,12
1746603301444,LIFR 1CX,A00,889392,Van Moer; Vinciane G,7,0,20,13
1746603302476,LIFR 1D,A00,889393,Van Moer; Vinciane G,7,0,20,13
1746603303502,LIFR 1DX,A00,889394,Van Moer; Vinciane G,8,0,20,12
1746603304534,LIGN 7,A00,886923,Staff,25,0,50,25
1746603305562,LIGN 17,A00,886924,Kehler; Andrew Scott,126,0,150,24
1746603306590,LTAM 110,A00,889395,Staff,15,0,30,15
1746603307621,LTAM 110GS,A00,958010,Rodriguez; Bretton Sigfred,0,0,0,28
1746603308646,LTCH 101,A00,889397,Staff,23,0,25,2
1746603309680,LTCS 130,A00,889398,Staff,23,0,25,2
1746603310709,LTEA 138,A00,889399,Staff,24,0,40,16
1746603311742,LTEN 149,A00,889400,Wesling; Megan E.,0,3,25,25
1746603312768,LTEN 169,A00,889401,Staff,20,0,25,5
1746603313798,LTEN 180,A00,889402,Staff,10,0,15,5
1746603314829,LTEN 181,A00,889403,Staff,21,0,25,4
1746603315856,LTWL 100,A00,889404,Myerston Santana; Jacobo,2,0,25,23
1746603316885,LTWL 180GS,A00,889405,Staff,0,0,20,20
1746603317915,LTWL 181,A00,889406,Staff,16,0,25,9
1746603318951,LTWL 184,A00,889475,Mukherjee; Silpa,22,0,25,3
1746603319977,LTWR 102C,A00,889486,Staff,29,0,30,1
1746603321004,LTWR 115W,A00,889491,Staff,0,2,15,15
1746603322037,MAE 8,A01,886905,Staff,0,2,0,0
1746603323071,MAE 11,A00,886906,Bandaru; Prabhakar,0,7,50,50
1746603324097,MAE 20,A00,886907,Evdokimenko; Ekaterina,43,0,70,27
1746603325124,MAE 30B,A00,886909,Ghazinejad; Maziar,25,0,45,20
1746603326156,MAE 101B,A00,886910,Saintillan; David,30,0,45,15
1746603327184,MAE 105,A00,886911,Bandaru; Prabhakar,18,0,50,32
1746603328218,MAE 107,B00,958024,Staff,7,0,50,43
1746603329249,MAE 143B,A00,886913,Bewley; Thomas R,2,0,40,38
1746603330281,MAE 148,A01,886915,Silberman; Jack,0,3,14,14
1746603331310,MAE 160,A00,886916,Evdokimenko; Ekaterina,30,0,60,30
1746603332342,MATH 3C,A01,889681,Staff,0,2,30,30
1746603332342,MATH 3C,A02,960048,Staff,23,0,30,7
1746603333375,MATH 10A,A01,889760,Staff,26,0,30,4
1746603333375,MATH 10A,A02,889783,Staff,29,0,30,1
1746603334404,MATH 10B,A01,889785,Verstraete; Jacques Allan,1,0,35,34
1746603334404,MATH 10B,A02,889795,Verstraete; Jacques Allan,4,0,35,31
1746603334404,MATH 10B,B01,889797,Verstraete; Jacques Allan,3,0,35,32
1746603334404,MATH 10B,B02,889828,Verstraete; Jacques Allan,3,0,35,32
1746603335444,MATH 10C,A01,889849,Habib; Yousaf,8,0,30,22
1746603335444,MATH 10C,A02,889852,Habib; Yousaf,14,0,30,16
1746603335444,MATH 10C,A03,889853,Habib; Yousaf,22,0,30,8
1746603335444,MATH 10C,A04,889858,Habib; Yousaf,20,0,30,10
1746603335444,MATH 10C,B01,889861,Staff,1,0,30,29
1746603335444,MATH 10C,B02,889862,Staff,24,0,30,6
1746603335444,MATH 10C,B03,889863,Staff,27,0,30,3
1746603335444,MATH 10C,B04,889967,Staff,23,0,30,7
1746603336475,MATH 18,A01,889974,Staff,7,0,30,23
1746603336475,MATH 18,A02,889977,Staff,20,0,30,10
1746603336475,MATH 18,B01,889984,Hardiman; Liam,20,0,30,10
1746603336475,MATH 18,B02,889985,Hardiman; Liam,25,0,30,5
1746603337507,MATH 20A,A01,889990,Suk; Andrew Hoon,30,0,35,5
1746603338552,MATH 20B,A01,889993,Ohm; Ko Woon,21,0,30,9
1746603338552,MATH 20B,A02,889994,Ohm; Ko Woon,30,0,30,0
1746603338552,MATH 20B,B01,889996,Ohm; Ko Woon,22,0,30,8
1746603338552,MATH 20B,B02,889997,Ohm; Ko Woon,23,0,30,7
1746603339586,MATH 20C,A01,889999,Hammock; Frances H,17,0,30,13
1746603339586,MATH 20C,A02,890003,Hammock; Frances H,23,0,30,7
1746603339586,MATH 20C,B01,890006,Hammock; Frances H,2,0,30,28
1746603339586,MATH 20C,B02,890007,Hammock; Frances H,12,0,30,18
1746603340624,MATH 20D,A01,890011,Cheng; Hsiao-Bing,1,0,30,29
1746603340624,MATH 20D,A02,890012,Cheng; Hsiao-Bing,14,0,30,16
1746603340624,MATH 20D,B01,890016,Cheng; Hsiao-Bing,13,0,30,17
1746603340624,MATH 20D,B02,890017,Cheng; Hsiao-Bing,13,0,30,17
1746603341661,MATH 20E,A01,890026,Harel; Guershon,1,0,30,29
1746603341661,MATH 20E,A02,890029,Harel; Guershon,22,0,30,8
1746603341661,MATH 20E,B01,890033,Harel; Guershon,7,0,30,23
1746603341661,MATH 20E,B02,890101,Harel; Guershon,21,0,30,9
1746603342691,MATH 102,A01,890104,Staff,18,0,30,12
1746603342691,MATH 102,A02,890105,Staff,27,0,30,3
1746603343728,MATH 103B,A01,890116,Salehi Golsefidy; Alireza,3,0,30,27
1746603343728,MATH 103B,B01,890118,Staff,0,3,34,34
1746603344755,MATH 109,A01,890121,Aliabadi Sr.; Mohsen,0,0,30,30
1746603344755,MATH 109,B01,890124,Upadrashta; Pranav Kumar,18,0,30,12
1746603345789,MATH 120A,A01,890126,Eggers; John Dietrich,13,0,30,17
1746603346814,MATH 142B,A01,890128,Ioana; Adrian,19,0,30,11
1746603346814,MATH 142B,A02,890129,Ioana; Adrian,12,0,30,18
1746603347842,MATH 154,A01,890174,Staff,0,1,30,30
1746603347842,MATH 154,A02,890182,Staff,0,0,30,30
1746603348873,MATH 168A,A01,890197,Dumitriu; Ioana,21,0,35,14
1746603349903,MATH 170A,A01,890240,Nie; Jiawang,1,0,30,29
1746603349903,MATH 170A,A02,890241,Nie; Jiawang,11,0,30,19
1746603349903,MATH 170A,A03,890249,Nie; Jiawang,23,0,30,7
1746603350930,MATH 170B,A01,957891,Nag; Panchali,13,0,35,22
1746603352990,MATH 181A,A01,908025,Staff,0,3,35,35
1746603352990,MATH 181A,A02,960115,Staff,26,0,35,9
1746603354019,MATH 181B,A01,959874,Staff,24,0,30,6
1746603355050,MATH 193B,A01,890265,Staff,0,4,35,35
1746603356083,MGT 4,A01,890311,Anderson; John Charles,42,0,88,46
1746603357110,MGT 5,A00,907740,Staff,12,0,98,86
1746603358154,MGT 12,A00,890312,Lindenberger; Wade Douglas,67,0,98,31
1746603359183,MGT 16,A00,957883,Staff,78,0,98,20
1746603361242,MGT 45,A00,890314,Pecore; Joseph P.,45,0,98,53
1746603362279,MGT 71,A00,890315,Staff,0,12,98,98
1746603363307,MGT 100,A00,890316,Yavorsky; Daniel Ryan,44,0,98,54
1746603364333,MGT 103,A00,890317,Ehrich; Kristine R,73,0,98,25
1746603365362,MGT 105,A00,890356,Bates; Kenneth Walter,0,8,98,98
1746603366390,MGT 112,A00,890360,Ehrich; Kristine R,55,0,98,43
1746603367416,MGT 127R,A00,907732,Zhu; Kevin Xiaoguo,23,0,98,75
1746603368440,MGT 131B,A00,890361,Anderson; John Charles,59,0,98,39
1746603369471,MGT 137,A00,890362,Lindenberger; Wade Douglas,65,0,98,33
1746603370510,MGT 160,A00,890369,Johnson; Erik Barry,9,0,98,89
1746603372570,MGT 164,A00,890372,Zimmermann; Carsten,0,40,98,98
1746603373610,MGT 180,A00,890374,Bliss; Barbara Ann,11,0,98,87
1746603374636,MMW 15,A01,886414,Chang; Edmond Yi-Teh,0,12,28,28
1746603374636,MMW 15,A02,886415,Chang; Edmond Yi-Teh,0,8,28,28
1746603374636,MMW 15,A03,886416,Chang; Edmond Yi-Teh,0,9,28,28
1746603374636,MMW 15,A04,886417,Chang; Edmond Yi-Teh,0,8,28,28
1746603374636,MMW 15,B01,886419,Chang; Edmond Yi-Teh,0,7,28,28
1746603374636,MMW 15,B02,886420,Chang; Edmond Yi-Teh,0,7,28,28
1746603374636,MMW 15,B03,886421,Chang; Edmond Yi-Teh,0,7,28,28
1746603374636,MMW 15,B04,886422,Chang; Edmond Yi-Teh,0,8,28,28
1746603374636,MMW 15,C01,886424,Staff,0,9,28,28
1746603374636,MMW 15,C02,886425,Staff,0,8,28,28
1746603374636,MMW 15,C03,886426,Staff,0,8,28,28
1746603374636,MMW 15,C04,886427,Staff,0,8,28,28
1746603374636,MMW 15,C05,958038,Staff,0,8,28,28
1746603374636,MMW 15,C06,958039,Staff,0,7,28,28
1746603375673,MMW 15GS,A00,906910,Patterson; Patrick H.,4,0,28,24
1746603376707,MMW 122R,A01,886429,Rahimi; Babak,0,13,28,28
1746603376707,MMW 122R,A02,886430,Rahimi; Babak,0,12,28,28
1746603376707,MMW 122R,A03,958040,Rahimi; Babak,0,11,28,28
1746603377737,MUS 1A,A01,890937,Staff,2,0,25,23
1746603377737,MUS 1A,A02,891035,Staff,6,0,25,19
1746603377737,MUS 1A,C01,958912,Staff,24,0,25,1
1746603377737,MUS 1A,C02,958913,Staff,25,0,25,0
1746603379792,MUS 2AK,A00,957092,Ohnishi; Takae,15,0,15,0
1746603380829,MUS 4,A01,891044,Staff,0,0,25,25
1746603380829,MUS 4,A02,891045,Staff,22,0,25,3
1746603380829,MUS 4,B01,891048,Staff,17,0,25,8
1746603380829,MUS 4,B02,891050,Staff,25,0,25,0
1746603381865,MUS 5,A01,957506,Dubnov; Shlomo,0,0,25,25
1746603381865,MUS 5,A02,957622,Dubnov; Shlomo,12,0,25,13
1746603381865,MUS 5,A03,957623,Dubnov; Shlomo,20,0,25,5
1746603382907,MUS 6,A01,891053,Freitas Caetano; Marcelo,24,0,25,1
1746603382907,MUS 6,A02,891054,Freitas Caetano; Marcelo,23,0,25,2
1746603383935,MUS 7,A01,891081,Staff,0,0,25,25
1746603383935,MUS 7,A02,891082,Staff,3,0,25,22
1746603384980,MUS 8GS,A00,891118,Borgo; David Garcia,1,0,25,24
1746603386010,MUS 11,A01,891140,Staff,8,0,25,17
1746603386010,MUS 11,A02,891141,Staff,21,0,25,4
1746603387037,MUS 13,A01,891143,Staff,8,0,25,17
1746603387037,MUS 13,A02,891144,Staff,24,0,25,1
1746603388120,MUS 15,A01,891146,Staff,9,0,25,16
1746603388120,MUS 15,A02,891148,Staff,21,0,25,4
1746603388120,MUS 15,B01,891150,Staff,18,0,25,7
1746603388120,MUS 15,B02,891151,Staff,25,0,25,0
1746603389152,MUS 20,A01,891153,Staff,5,0,20,15
1746603389152,MUS 20,A02,891155,Staff,14,0,20,6
1746603390179,MUS 80,A00,891156,Staff,19,0,25,6
1746603390179,MUS 80,B00,891157,Staff,23,0,25,2
1746603391202,MUS 130,A00,891158,Ohnishi; Takae,35,0,35,0
1746603392235,MUS 150GS,A01,891160,Borgo; David Garcia,1,0,25,24
1746603393261,MUS 170,A01,891162,Freitas Caetano; Marcelo,20,0,25,5
1746603393261,MUS 170,A02,891164,Freitas Caetano; Marcelo,21,0,25,4
1746603394296,NANO 11,A00,886220,Vazquez Mena; Oscar,13,0,15,2
1746603395331,NANO 15,A01,886222,Drews; Aaron,4,0,7,3
1746603396359,NANO 104,A00,886224,Sirbuly; Donald,17,0,25,8
1746603397388,PH 40,A00,886528,Staff,23,0,40,17
1746603398422,PH 45,A01,886799,Staff,35,0,40,5
1746603399451,PH 110,A00,886802,Staff,0,6,40,40
1746603400484,PH 172,A00,906716,Staff,19,0,35,16
1746603401511,PH 191,A00,886803,Staff,6,0,40,34
1746603402551,PHIL 1,A00,889500,Staff,20,0,30,10
1746603403580,PHIL 10,A01,889549,Grush; Rick Scott,16,0,22,6
1746603403580,PHIL 10,A02,889551,Grush; Rick Scott,22,0,22,0
1746603404617,PHIL 28,A01,889559,Lamey; Andy M.,0,2,31,31
1746603404617,PHIL 28,A02,889561,Lamey; Andy M.,0,1,30,30
1746603404617,PHIL 28,A03,889572,Lamey; Andy M.,0,1,30,30
1746603405650,PHIL 35,A00,907839,Staff,13,0,15,2
1746603406676,PHIL 60,A00,889574,Staff,73,0,90,17
1746603407701,PHIL 101,A00,958004,Staff,12,0,15,3
1746603409760,PHIL 136,A00,889582,Fulkerson; Matthew Todd,26,0,45,19
1746603410787,PHIL 163,A01,889601,Staff,21,0,30,9
1746603410787,PHIL 163,B01,889606,Brandt; Reuven A,0,3,0,0
1746603411813,PHIL 164,A00,889610,Staff,16,0,30,14
1746603412839,PHIL 165,A00,889613,Staff,22,0,30,8
1746603413867,PHYS 1A,A00,886431,Staff,30,0,70,40
1746603414896,PHYS 1AL,001,886432,Tsai; Philbert S,0,1,30,30
1746603414896,PHYS 1AL,002,886436,Tsai; Philbert S,13,0,30,17
1746603415924,PHYS 1B,A00,886439,Staff,184,0,240,56
1746603416951,PHYS 1BL,001,886441,Tsai; Philbert S,0,4,30,30
1746603416951,PHYS 1BL,002,886444,Tsai; Philbert S,2,0,30,28
1746603417983,PHYS 1C,A00,896092,Arnold; Kam S,78,0,146,68
1746603419017,PHYS 1CL,001,886448,Tsai; Philbert S,0,0,30,30
1746603419017,PHYS 1CL,002,886449,Tsai; Philbert S,1,0,30,29
1746603419017,PHYS 1CL,003,886450,Tsai; Philbert S,16,0,30,14
1746603419017,PHYS 1CL,004,886451,Tsai; Philbert S,15,0,30,15
1746603420078,PHYS 2B,A01,886457,Staff,67,0,115,48
1746603421106,PHYS 2C,A01,886460,Shotwell; Brian,0,9,65,65
1746603422144,PHYS 2CL,A01,886467,Staff,0,4,28,28
1746603422144,PHYS 2CL,A02,886468,Staff,0,3,28,28
1746603423171,PHYS 2D,A01,886470,Staff,10,0,50,40
1746603424199,PHYS 4B,A01,886475,Grinstein; Benjamin,22,0,40,18
1746603425234,POLI 5,A00,891173,Desposato; Scott,7,0,25,18
1746603426264,POLI 5D,A01,891175,Staff,5,0,5,0
1746603426264,POLI 5D,B01,891178,Staff,5,0,5,0
1746603427293,POLI 11,A00,891179,Ferree; Karen E,0,0,35,35
1746603428319,POLI 12,A00,891180,Staff,15,0,30,15
1746603429352,POLI 27,A01,891182,Staff,11,0,75,64
1746603430379,POLI 30,A00,891183,Staff,8,0,50,42
1746603431413,POLI 100B,A00,891244,Staff,5,1,35,30
1746603432441,POLI 100I,A00,891247,Staff,7,0,30,23
1746603433467,POLI 104J,A00,891248,Nichter; Maysa,14,0,30,16
1746603434497,POLI 104U,A00,891250,Nichter; Maysa,1,0,30,29
1746603436558,POLI 110B,A00,891255,Wiens; David,19,0,25,6
1746603437583,POLI 112A,A00,891256,Wiens; David,6,0,25,19
1746603438608,POLI 114BR,A00,891261,Staff,19,0,30,11
1746603439634,POLI 117R,A00,891262,Forman; Fonna,0,6,50,50
1746603440659,POLI 118,A00,891264,Ingham; Sean,17,0,25,8
1746603441687,POLI 124A,A00,891265,Staff,18,0,20,2
1746603442715,POLI 125D,A00,891266,Nichter; Simeon C,2,0,25,23
1746603443740,POLI 126,A00,891268,Nichter; Simeon C,7,0,25,18
1746603444766,POLI 126AA,A00,891272,Staff,15,0,25,10
1746603445795,POLI 130AA,A00,891273,Staff,15,0,20,5
1746603446819,POLI 134AA,A00,891274,Staff,4,0,20,16
1746603448873,POLI 138,A00,891278,Staff,21,0,25,4
1746603449900,POLI 142K,A00,891280,Staff,10,0,25,15
1746603450927,POLI 142M,A00,891281,Gartzke; Erik,16,0,30,14
1746603451953,POLI 142P,A00,891284,Staff,20,0,30,10
1746603452979,POLI 143,A00,891285,Gartzke; Erik,12,0,30,18
1746603454010,POLI 153,A00,891286,Staff,19,0,20,1
1746603456067,POLI 175,A00,891290,Staff,15,0,20,5
1746603457178,PSYC 1,A00,890674,Steiner; Eric Tomas,0,11,45,45
1746603458214,PSYC 2,A00,890676,Albright; Thomas D,20,0,35,15
1746603459240,PSYC 3,A00,890679,Staff,17,0,20,3
1746603460268,PSYC 6,A00,959858,Staff,19,0,20,1
1746603461295,PSYC 60,A01,890684,Rickard; Timothy C.,0,6,45,45
1746603462324,PSYC 70,A01,890689,Geller; Emma Harlan,6,0,30,24
1746603463350,PSYC 71,A01,959860,Staff,21,0,25,4
1746603464389,PSYC 100,A00,890690,Lacefield; Katharine I,0,50,180,180
1746603465422,PSYC 102,A00,890695,Staff,18,0,40,22
1746603466465,PSYC 105,A00,890699,Geller; Emma Harlan,70,0,100,30
1746603467498,PSYC 106,A00,890701,Gorman; Michael R.,5,0,30,25
1746603468540,PSYC 108,A00,890704,Adrian; Julia Anna,0,29,50,50
1746603469569,PSYC 118,A01,890712,Staff,11,0,30,19
1746603470599,PSYC 124,A00,890716,Chapman; Eddie Nathaniel,25,0,60,35
1746603471633,PSYC 131,A00,890717,Anagnostaras; Stephan,0,7,80,80
1746603472661,PSYC 137,A00,890719,Winkielman; Piotr,0,11,30,30
1746603473689,PSYC 144,A00,890721,Adrian; Julia Anna,0,9,45,45
1746603474722,PSYC 162,A00,890805,Staff,0,2,75,75
1746603475748,PSYC 169,A00,890810,Staff,0,15,30,30
1746603476775,PSYC 172,A00,890814,Gorman; Michael R.,9,0,30,21
1746603477800,PSYC 181,A00,890818,Anagnostaras; Stephan,6,0,200,194
1746603478829,PSYC 184,A00,959861,Staff,161,0,175,14
1746603479853,PSYC 189,A00,890823,Staff,0,2,30,30
1746603480886,PSYC 191,A00,890884,Rickard; Timothy C.,0,11,35,35
1746603481924,PSYC 193,A00,890913,Staff,19,0,30,11
1746603481924,PSYC 193,B00,890914,Chapman; Eddie Nathaniel,24,0,30,6
1746603482954,PSYC 193L,A01,890918,Lowe; Angela Beth,20,0,30,10
1746603482954,PSYC 193L,B01,890921,Hurwitz; Ethan Scott,20,0,30,10
1746603482954,PSYC 193L,C01,890928,Staff,30,0,30,0
1746603483979,RELI 149,A00,886806,Rahimi; Babak,23,0,40,17
1746603485023,SE 9,A01,886814,Staff,7,0,20,13
1746603486057,SE 101B,A01,886816,Chadha; Mayank,3,0,35,32
1746603487093,SE 110B,A00,886818,Zhu; Qiang,4,0,75,71
1746603488121,SE 125,A01,886830,Staff,10,0,30,20
1746603489148,SE 130B,A01,886835,Staff,14,0,40,26
1746603490175,SE 131A,A01,886838,Krysl; Petr,34,0,55,21
1746603491201,SE 154,A00,886840,Staff,28,0,50,22
1746603492267,SE 164GS,A01,886849,Staff,6,0,20,14
1746603493294,SE 167GS,A01,886853,Staff,6,0,20,14
1746603494323,SIO 25,A01,890107,Staff,19,0,30,11
1746603495350,SIO 45,A00,890109,Cook; Geoffrey W,115,0,200,85
1746603496377,SIO 109R,A00,890110,Forman; Fonna,0,16,20,20
1746603497415,SIO 187,A01,890114,Kacev; David,15,0,40,25
1746603498458,SOCI 1,A01,890431,Thorpe; Charles Robert,14,0,30,16
1746603498458,SOCI 1,A02,890518,Thorpe; Charles Robert,30,0,30,0
1746603499484,SOCI 2,A01,957978,Staff,25,0,25,0
1746603499484,SOCI 2,A02,957979,Staff,23,0,25,2
1746603500510,SOCI 20,A01,890523,Calderon-Zaks; Michael Aar,21,0,30,9
1746603500510,SOCI 20,A02,890526,Calderon-Zaks; Michael Aar,29,0,30,1
1746603501547,SOCI 30,A01,890533,Pardo Guerra; Juan Pablo,37,0,40,3
1746603502575,SOCI 40,A01,890535,Staff,27,0,45,18
1746603503606,SOCI 104Q,A00,890559,Staff,18,0,30,12
1746603504633,SOCI 106,A00,890560,Arnal; Maud Marie Leonie,20,0,30,10
1746603505662,SOCI 110,A00,890567,Holkenbrink-Monk; Charlene,19,0,30,11
1746603506691,SOCI 112,A00,890568,Victoria Torres; Pablo,2,0,55,53
1746603507717,SOCI 115,A00,890597,Arnal; Maud Marie Leonie,28,0,45,17
1746603509781,SOCI 121,A00,890604,Pardo Guerra; Juan Pablo,38,0,45,7
1746603510812,SOCI 126,A01,890608,Staff,8,0,10,2
1746603511840,SOCI 127,A00,890609,Staff,18,0,30,12
1746603512869,SOCI 131,A00,890610,Thorpe; Charles Robert,37,0,45,8
1746603513900,SOCI 135,A00,890615,Payne; Christine Anna,14,0,45,31
1746603514925,SOCI 139,A00,890620,Staff,38,0,45,7
1746603515956,SOCI 148E,A00,890622,Calderon-Zaks; Michael Aar,36,0,45,9
1746603516988,SOCI 150,A00,890623,Kohler; Kristopher M.,31,0,45,14
1746603518014,SOCI 157,A00,890625,Jules-Rosette; Bennetta W.,18,0,20,2
1746603519041,SOCI 160,A00,890627,Payne; Christine Anna,21,0,45,24
1746603520070,SYN 1,A00,886855,Fish; Gwendolyn Anne,0,1,0,0
1746603520070,SYN 1,B00,906086,Fish; Gwendolyn Anne,0,2,0,2
1746603521106,SYN 2R,A00,886860,Staff,0,17,15,15
1746603521106,SYN 2R,B00,906106,Atkinson; Arthur Laird,0,16,15,15
1746603522145,SYN 100,A01,886866,Browne; Emily,0,28,20,20
1746603522145,SYN 100,B01,906128,Rock; Martin,0,4,20,20
1746603522145,SYN 100,C01,906140,Deavenport; James Cary,0,4,20,20
1746603522145,SYN 100,D01,907816,Deavenport; James Cary,0,5,20,20
1746603523188,TDAC 1,A00,890286,Walsh; Kim C.,7,0,20,13
1746603524215,TDAC 101,A00,890296,Basso; Beatrice,15,0,20,5
1746603525241,TDDE 131,A00,890297,Staff,47,0,50,3
1746603526269,TDDM 1,A00,890287,Weinberg; Sadie,25,0,30,5
1746603527302,TDGE 11,A00,890288,Fulton; Julia,138,0,200,62
1746603527302,TDGE 11,B00,890289,Castro; Robert Jess,184,0,200,16
1746603528328,TDGE 25,B00,957359,Walsh; Kim C.,5,0,20,15
1746603529354,TDGE 40,A01,890292,Power; Jade Yukana,26,0,30,4
1746603530384,TDGE 124,A00,890298,Havis; Allan,0,2,50,50
1746603531411,TDGE 131R,A00,890299,Burelle; Julie Sara Veronique,15,0,42,27
1746603532436,TDHT 101,A00,890300,Staff,10,0,20,10
1746603533470,TDHT 109,A01,890302,Anderson; Mysia Anyse,31,0,40,9
1746603534498,TDMV 1,A00,890293,Arcidiacono; Kristin,18,0,30,12
1746603535525,TDMV 2,A00,890294,Weinberg; Sadie,23,0,30,7
1746603536554,TDMV 3,A00,957878,Arcidiacono; Kristin,28,0,30,2
1746603538606,TDMV 138,A00,890304,Jun; Grace Shin Hae,25,0,40,15
1746603539635,TDMV 140,A00,890305,Corrales; Joseph Bernales,25,0,30,5
1746603540661,TDMV 142,A00,890307,Caligagan; Tony,32,0,40,8
1746603541690,TDMV 144,A00,890308,Camaya; Michelle Ann,25,0,30,5
1746603542718,TDPW 1,A00,890295,Stein; Deborah Isobel,3,0,20,17
1746603543747,USP 2,A01,890272,Lerner; Amy M,7,0,20,13
1746603544773,USP 3,A01,890274,Staff,12,0,30,18
1746603545806,USP 15,A01,890276,Sun; Feiyang,16,0,30,14
1746603546839,USP 25,A00,890277,Shenkman; Michael Thomas,18,0,25,7
1746603547864,USP 138,A00,890278,Staff,13,0,25,12
1746603548892,USP 143,A00,890279,Staff,21,0,70,49
1746603549919,USP 144,A00,890280,Chowdhury; Muhammed Zohir,16,0,30,14
1746603550948,USP 150,A00,890281,Boomhower; Matthew Charles,4,0,30,26
1746603551978,USP 151,A00,890282,Staff,16,0,20,4
1746603553004,USP 162,A00,890283,Andrews; Abigail Leslie,16,0,20,4
1746603554030,USP 168,A00,920477,Kwak; Nancy,0,0,5,5
1746603555057,USP 181,A00,890284,Staff,3,0,20,17
1746603556083,USP 191A,A00,890285,Staff,12,0,20,8
1746603557114,VIS 101,A00,886512,Staff,26,0,75,49
1746603558141,VIS 103,A00,886513,Cruz; Edwin Teddy,61,0,75,14
1746603559168,VIS 108,A00,886514,Staff,4,0,15,11
1746603560200,VIS 127P,A00,886515,Shen; Kuiyi,80,0,146,66
1746603561231,VIS 149,A00,886516,Yoldas; Pinar,0,0,15,15
1746603562258,VIS 164,A00,886526,Erdmann; Dean,19,0,22,3
1746603563287,VIS 194S,A00,886527,Staff,61,0,75,14
1746603564315,WCWP 10A,C00,886484,Martiniuk; Jill,12,0,15,3
1746603565353,WCWP 10B,A00,886490,Uriarte; Emma,0,0,15,15
1746603565353,WCWP 10B,B00,886491,Dhir; Simrita,8,0,15,7
1746603565353,WCWP 10B,C00,886492,Ornelas; Tricia,0,0,15,15
1746603566380,WCWP 100,A00,886494,Young; Mark T,0,6,15,15
1746603568572,AAS 10,A01,886199,Childs; Dennis R.,0,3,0,0
1746603569606,ANAR 104,A01,886940,Shtienberg; Gilad,27,0,30,3
1746603570633,ANAR 120,A00,886953,Staff,13,0,20,7
1746603571663,ANBI 148,A01,886955,Wilder; Linnea Lorene,30,0,40,10
1746603573717,ANSC 122,A00,886957,Staff,24,0,30,6
1746603574745,ANSC 150,A00,886958,Sloane; Julia Kathryn,2,0,15,13
1746603575776,ANSC 156,A00,886959,Jenkins; Janis A.,0,1,15,15
1746603576804,ANSC 180,A00,886960,Staff,11,0,17,6
1746603577837,ANSC 188,A00,886961,Jassal; Aftab,9,0,25,16
1746603578862,ANSC 190,A00,886962,Jassal; Aftab,14,0,25,11
1746603579891,ANSC 191,A00,886963,Staff,18,0,20,2
1746603580921,ANTH 3,A01,891689,Staff,17,0,20,3
1746603581953,ANTH 5,A00,886933,Semendeferi; Ekaterini,16,0,20,4
1746603582979,ANTH 10,A00,886934,Staff,0,12,30,30
1746603584010,ANTH 21,A01,886936,Staff,41,0,60,19
1746603585035,ANTH 23,A01,886938,Staff,92,0,100,8
1746603586064,ANTH 105,A00,886964,Stewart; Alexander B,84,0,100,16
1746603587097,ANTH 108,A00,886965,Pedersen; David,9,0,20,11
1746603588125,AWP 10,001,886147,Staff,0,0,0,0
1746603588125,AWP 10,002,886148,Staff,0,0,0,0
1746603588125,AWP 10,003,886149,Staff,0,0,0,0
1746603588125,AWP 10,004,886150,Staff,0,0,0,0
1746603588125,AWP 10,005,886151,Staff,0,0,0,0
1746603588125,AWP 10,006,886152,Staff,0,0,0,0
1746603588125,AWP 10,007,886153,Staff,0,0,0,0
1746603588125,AWP 10,008,886154,Staff,0,0,0,0
1746603588125,AWP 10,009,886155,Staff,0,0,0,0
1746603588125,AWP 10,010,886156,Staff,0,0,0,0
1746603588125,AWP 10,011,886158,Staff,0,0,0,0
1746603588125,AWP 10,012,886160,Staff,0,0,0,0
1746603588125,AWP 10,013,886161,Staff,0,0,0,0
1746603588125,AWP 10,014,886162,Staff,0,0,0,0
1746603588125,AWP 10,015,886163,Staff,0,0,0,0
1746603588125,AWP 10,016,886164,Staff,0,0,0,0
1746603588125,AWP 10,017,886165,Staff,0,0,0,0
1746603588125,AWP 10,018,886166,Staff,0,0,0,0
1746603588125,AWP 10,019,886168,Staff,0,0,0,0
1746603588125,AWP 10,020,886170,Staff,0,0,0,0
1746603588125,AWP 10,021,886172,Staff,0,0,0,0
1746603589159,AWP 10R,001,886173,Staff,0,1,0,0
1746603589159,AWP 10R,002,886174,Staff,0,1,0,0
1746603589159,AWP 10R,003,886175,Staff,0,0,0,0
1746603589159,AWP 10R,004,886176,Staff,0,0,0,0
1746603589159,AWP 10R,005,886177,Staff,0,0,0,0
1746603589159,AWP 10R,006,886178,Staff,0,0,0,0
1746603589159,AWP 10R,007,886179,Staff,0,0,0,0
1746603589159,AWP 10R,008,886181,Staff,0,0,0,0
1746603589159,AWP 10R,009,886182,Staff,0,0,0,0
1746603589159,AWP 10R,010,886183,Staff,0,0,0,0
1746603589159,AWP 10R,011,886184,Staff,0,0,0,0
1746603589159,AWP 10R,012,886185,Staff,0,0,0,0
1746603589159,AWP 10R,013,886186,Staff,0,0,0,0
1746603589159,AWP 10R,014,886187,Staff,0,0,0,0
1746603589159,AWP 10R,015,886188,Staff,0,0,0,0
1746603589159,AWP 10R,016,886189,Staff,0,0,0,0
1746603589159,AWP 10R,017,960532,Staff,0,0,0,0
1746603589159,AWP 10R,018,960533,Staff,0,0,0,0
1746603589159,AWP 10R,019,960534,Staff,0,0,0,0
1746603589159,AWP 10R,020,960538,Staff,0,0,0,0
1746603589159,AWP 10R,021,960540,Staff,0,0,0,0
1746603589159,AWP 10R,022,960541,Staff,0,0,0,0
1746603589159,AWP 10R,023,960542,Staff,0,0,0,0
1746603589159,AWP 10R,024,960544,Staff,0,0,0,0
1746603589159,AWP 10R,025,960545,Staff,0,0,0,0
1746603589159,AWP 10R,026,960548,Staff,0,0,0,0
1746603590185,AWP 102R,A00,886190,Staff,0,0,0,0
1746603590185,AWP 102R,B00,886191,Staff,0,0,0,0
1746603591212,BENG 100,A01,886193,Staff,17,0,30,13
1746603592238,BENG 122A,A01,886195,Hasty; Jeff M,13,0,30,17
1746603593266,BENG 166A,A00,886196,Sah; Robert Lie-Yuan,0,3,30,30
1746603594293,BENG 190,A00,958050,Khojah; Reem I,17,0,25,8
1746603595320,BIBC 102,A01,894320,Staff,0,1,46,46
1746603595320,BIBC 102,A02,894321,Staff,0,0,46,46
1746603595320,BIBC 102,A03,894344,Staff,6,0,46,40
1746603595320,BIBC 102,A04,894345,Staff,27,0,47,20
1746603596391,BICD 100R,A01,894365,Smith; Laurie,0,2,58,58
1746603596391,BICD 100R,A02,894366,Smith; Laurie,0,4,58,58
1746603596391,BICD 100R,A03,894367,Smith; Laurie,0,0,59,59
1746603596391,BICD 100R,A04,959869,Smith; Laurie,38,0,59,21
1746603597427,BICD 136,A01,894383,Gustafson-Brown; Cindy,14,0,50,36
1746603598457,BIEB 102,A01,894494,Butler; Shannon Rhey,51,0,130,79
1746603600538,BIEB 150,A01,894617,Wills; Christopher,3,0,20,17
1746603600538,BIEB 150,A02,894631,Wills; Christopher,3,0,20,17
1746603600538,BIEB 150,A03,894937,Wills; Christopher,3,0,20,17
1746603600538,BIEB 150,A04,894946,Wills; Christopher,5,0,20,15
1746603601569,BIEB 194,A00,906141,Kurle; Carolyn M.,5,0,20,15
1746603602599,BILD 1,A01,894154,Staff,3,0,19,16
1746603602599,BILD 1,A02,894155,Staff,14,0,19,5
1746603602599,BILD 1,A03,894160,Staff,13,0,19,6
1746603602599,BILD 1,A04,894161,Staff,15,0,18,3
1746603603629,BILD 2,A01,894168,Staff,0,0,50,50
1746603603629,BILD 2,A02,894169,Staff,0,0,50,50
1746603603629,BILD 2,A03,894179,Staff,0,0,50,50
1746603603629,BILD 2,A04,894203,Staff,22,0,50,28
1746603604665,BILD 3,A01,894213,Staff,23,0,31,8
1746603604665,BILD 3,A02,894214,Staff,26,0,31,5
1746603604665,BILD 3,A03,894235,Staff,28,0,31,3
1746603604665,BILD 3,A04,894236,Staff,28,0,32,4
1746603605697,BILD 4,A01,894253,Reuther; Keefe,5,0,24,19
1746603605697,BILD 4,A02,894258,Reuther; Keefe,16,0,24,8
1746603606722,BILD 5,A01,894276,Reuther; Keefe,34,0,50,16
1746603606722,BILD 5,A02,894277,Reuther; Keefe,45,0,50,5
1746603606722,BILD 5,A03,894290,Reuther; Keefe,44,0,50,6
1746603606722,BILD 5,A04,894291,Reuther; Keefe,48,0,50,2
1746603607750,BILD 24,A01,894297,Pirino; Giorgia,40,0,60,20
1746603608790,BIMM 100,B01,958915,Staff,71,0,100,29
1746603609823,BIMM 101,A01,895017,McDonnell; Lisa Marie,0,5,24,24
1746603609823,BIMM 101,A02,895018,McDonnell; Lisa Marie,0,5,24,24
1746603609823,BIMM 101,B01,895020,McDonnell; Lisa Marie,0,5,24,24
1746603609823,BIMM 101,B02,895021,McDonnell; Lisa Marie,0,4,24,24
1746603610859,BIMM 110,A01,895023,Staff,1,0,25,24
1746603610859,BIMM 110,A02,895024,Staff,9,0,25,16
1746603610859,BIMM 110,A03,895025,Staff,18,0,25,7
1746603610859,BIMM 110,A04,895031,Staff,20,0,25,5
1746603611895,BIMM 120,A01,895114,Gustafson-Brown; Cindy,14,0,28,14
1746603611895,BIMM 120,A02,895126,Gustafson-Brown; Cindy,21,0,27,6
1746603612921,BIPN 100,A01,895130,Yang; Mingyu,0,0,38,38
1746603612921,BIPN 100,A02,895131,Yang; Mingyu,31,0,38,7
1746603612921,BIPN 100,A03,895132,Yang; Mingyu,32,0,38,6
1746603612921,BIPN 100,A04,895133,Yang; Mingyu,27,0,36,9
1746603613957,BIPN 120,A01,895135,Cooke; James Edward,0,3,13,13
1746603613957,BIPN 120,A02,895136,Cooke; James Edward,0,1,13,13
1746603613957,BIPN 120,A03,895137,Cooke; James Edward,0,3,13,13
1746603613957,BIPN 120,A04,895156,Cooke; James Edward,0,2,11,11
1746603614988,BIPN 134,A01,895235,Cooke; James Edward,0,1,25,25
1746603614988,BIPN 134,A02,895237,Cooke; James Edward,0,0,25,25
1746603614988,BIPN 134,A03,895240,Cooke; James Edward,1,0,25,24
1746603614988,BIPN 134,A04,895270,Cooke; James Edward,20,0,25,5
1746603616017,BIPN 189,A00,892103,Staff,0,14,14,14
1746603618073,BISP 194,A00,958008,Staff,0,2,0,0
1746603619105,CAT 124,A01,922009,Staff,0,5,20,20
1746603620137,CAT 125R,A00,886390,Morales; Celeste Georgianna,0,4,20,20
1746603620137,CAT 125R,B00,886391,Irwin; Matthew Joseph,0,4,20,20
1746603620137,CAT 125R,C00,886392,Smith; Lauryn Alissa,0,2,20,20
1746603620137,CAT 125R,D00,886393,Vanderschuit; Maya Alysia,0,3,20,20
1746603620137,CAT 125R,E00,886394,Marchisotto; Jennifer Anne,0,3,20,20
1746603621170,CENG 15,A01,886218,Drews; Aaron,3,0,8,5
1746603622205,CENG 113,A00,886219,Opatkiewicz; Justin Paul,15,0,25,10
1746603623235,CGS 101,A00,887044,Staff,7,0,20,13
1746603624262,CGS 105,A01,887046,Staff,14,0,25,11
1746603625293,CGS 112,A00,887047,Cuong; Marisol,12,0,15,3
1746603626320,CGS 113,A00,887048,Staff,23,0,30,7
1746603627346,CGS 120,A00,887049,Staff,9,0,17,8
1746603628386,CHEM 6A,A01,886336,Lam; Tin Yiu,38,0,50,12
1746603628386,CHEM 6A,A02,886338,Lam; Tin Yiu,37,0,50,13
1746603629416,CHEM 6B,A01,886341,Hopkins; Patrycja Anna,16,0,50,34
1746603629416,CHEM 6B,A02,886343,Hopkins; Patrycja Anna,42,0,50,8
1746603630445,CHEM 6C,A01,886346,Albizati; Kim F.,0,2,50,50
1746603630445,CHEM 6C,A02,886348,Albizati; Kim F.,24,0,50,26
1746603631471,CHEM 40A,A01,886352,Klosterman; Jeremy K,65,0,100,35
1746603632498,CHEM 40B,A01,886356,Klosterman; Jeremy K,0,24,100,100
1746603633541,CHEM 41B,A01,886360,Theodorakis; Emmanuel,25,0,50,25
1746603633541,CHEM 41B,A02,886362,Theodorakis; Emmanuel,47,0,50,3
1746603634575,CHIN 165A,A00,886382,Xu; Li,18,0,20,2
1746603635601,CLAS 120,A00,886387,Myerston Santana; Jacobo,33,0,40,7
1746603636634,COGS 9,A01,886967,Shannon; Kyle Michael,42,0,60,18
1746603637665,COGS 11,A01,886969,Staff,9,0,30,21
1746603638697,COGS 14A,A01,886971,Staff,5,0,60,55
1746603639723,COGS 14B,A01,886973,Hoffman; Drew Ellen,4,0,60,56
1746603640749,COGS 18,A01,886975,Morgan; Eric,34,0,60,26
1746603641779,COGS 20,A01,886977,Staff,3,0,8,5
1746603641779,COGS 20,A02,886978,Staff,5,0,7,2
1746603642812,COGS 100,A01,907783,Staff,0,1,30,30
1746603643847,COGS 101B,A01,886980,Staff,0,4,48,48
1746603644885,COGS 101C,A01,886982,Delgado; Tania,0,5,44,44
1746603645912,COGS 102A,A01,886984,Johnson; Christine M.,3,0,30,27
1746603646938,COGS 118B,A01,886986,Staff,0,4,88,88
1746603647970,COGS 150,A01,886988,Bergen; Benjamin,22,0,50,28
1746603648998,COGS 153,A00,886989,Delgado; Tania,0,3,41,41
1746603650026,COGS 186,A01,886991,Staff,0,0,32,32
1746603651053,COGS 187A,A01,886993,Boyle; Mary E. T.,7,0,30,23
1746603652082,COGS 189,A00,886994,Staff,0,1,30,30
1746603653113,COMM 10,A01,886996,Staff,0,0,20,21
1746603653113,COMM 10,A02,886997,Staff,10,0,20,10
1746603653113,COMM 10,A03,959845,Staff,19,0,20,1
1746603654141,COMM 20,A01,886999,Leuning; Grant Maurstad,24,0,40,16
1746603656201,COMM 100A,A01,887002,Staff,0,0,20,25
1746603656201,COMM 100A,A02,887003,Staff,5,0,20,15
1746603657229,COMM 100B,A01,887005,Staff,0,8,20,24
1746603658256,COMM 106D,A00,887006,Staff,14,0,40,26
1746603659284,COMM 110G,A00,887007,Whitworth-Smith; Andrew C,12,0,40,28
1746603660313,COMM 111B,A00,887008,Staff,31,0,40,9
1746603661349,COMM 113T,A00,887009,Abuelhiga; Soraya Jill,28,0,40,12
1746603661349,COMM 113T,B00,906733,Staff,39,0,40,1
1746603662380,COMM 145,A00,887010,Staff,13,0,40,27
1746603663407,COMM 146,A00,887054,Staff,32,0,40,8
1746603664437,COMM 190,A00,887012,Staff,8,0,23,15
1746603665471,CSE 8A,A50,887015,Cao; Yingjun,56,0,85,29
1746603666506,CSE 11,A01,887017,Cao; Yingjun,11,0,70,59
1746603667532,CSE 20,A01,887019,Staff,30,0,50,20
1746603668563,CSE 21,A01,887021,Staff,79,0,100,21
1746603668563,CSE 21,B01,892583,Braun; Oliver,45,0,50,5
1746603669590,CSE 30,A01,887025,Eldon; John,142,0,200,58
1746603670615,CSE 100,A01,887027,Staff,26,0,50,24
1746603670615,CSE 100,A02,887028,Staff,42,0,50,8
1746603671641,CSE 101,A01,887030,Braun; Oliver,74,0,100,26
1746603671641,CSE 101,B01,887032,Jones; Miles E,0,3,50,50
1746603671641,CSE 101,B02,887033,Jones; Miles E,0,2,50,50
1746603672670,CSE 105,A01,908084,Jones; Miles E,32,0,50,18
1746603672670,CSE 105,A02,908087,Jones; Miles E,31,0,50,19
1746603673705,CSE 135,A01,887035,Powell; Thomas Allan,0,5,50,50
1746603674733,CSE 142,A01,887037,Staff,7,0,60,53
1746603675763,CSE 142L,A01,887039,Staff,34,0,60,26
1746603676792,CSE 151A,A01,887041,Solares; Edwin A,47,0,100,53
1746603677818,CSE 175,A01,887043,Kumar; Rakesh,30,0,30,0
1746603678847,CSS 1,A01,886389,Staff,0,1,40,40
1746603679874,DSC 30,A01,908097,Liao; Soohyun Nam,47,0,75,28
1746603680908,DSC 40A,A01,908099,Shannon; Kyle Michael,30,0,50,20
1746603681935,DSC 40B,A01,908112,Staff,15,0,50,35
1746603682962,DSC 80,A01,908116,Staff,19,0,60,41
1746603683994,DSC 197,001,956863,Eldridge; Justin Matthew,9999,0,9999,0
1746603685042,ECE 5,A01,886400,Morris; Karcher William,1,0,6,5
1746603685042,ECE 5,A02,886401,Morris; Karcher William,3,0,6,3
1746603686075,ECE 148,A01,886403,Silberman; Jack,0,14,14,14
1746603687107,ECON 1,A01,887265,Crane; Meredith Helen,11,0,70,59
1746603687107,ECON 1,B01,887268,Staff,42,0,50,8
1746603688136,ECON 2,A01,887273,Crane; Meredith Helen,54,0,70,16
1746603689167,ECON 3,A01,887279,Rondina; Giacomo,31,0,70,39
1746603690197,ECON 4,A01,887282,Anderson; John Charles,0,2,10,10
1746603691231,ECON 5,A01,887285,Staff,34,0,45,11
1746603691231,ECON 5,B01,887292,Staff,41,0,45,4
1746603692271,ECON 100A,A01,887337,Newhouse; Herbert S,54,0,70,16
1746603692271,ECON 100A,B01,887349,Staff,45,0,50,5
1746603693305,ECON 100B,A01,887361,Du; Songzi,29,0,70,41
1746603694336,ECON 100C,A01,887445,Newhouse; Herbert S,59,0,70,11
1746603695371,ECON 105,A00,887488,Vespa; Emanuel Ignacio,23,0,35,12
1746603696399,ECON 109,A01,887506,Shishkin; Denis,28,0,35,7
1746603697428,ECON 110A,A01,887568,Alon; Titan Michael,0,2,35,35
1746603697428,ECON 110A,B01,907601,Alon; Titan Michael,20,0,35,15
1746603698456,ECON 110B,A01,887598,Levkoff; Steven B.,0,24,70,70
1746603699484,ECON 112,A00,887599,Rondina; Giacomo,19,0,35,16
1746603700510,ECON 120A,A01,887603,Dai; Yinlin,36,0,70,34
1746603701547,ECON 120C,A01,887608,Sun; Yixiao,0,1,35,35
1746603701547,ECON 120C,B01,887614,Sun; Yixiao,0,0,35,35
1746603702583,ECON 138,A00,887621,Bharadwaj; Prashant,0,21,20,20
1746603703617,ECON 144,A00,958007,Squires; Dale E,11,0,35,24
1746603704645,ECON 171,A01,907666,Staff,18,0,35,17
1746603705673,ECON 175,A00,887626,Wu; Pak Yeung,22,0,35,13
1746603706706,ECON 190,A00,887640,Vespa; Emanuel Ignacio,22,0,35,13
1746603707821,EDS 25,A01,888197,Staff,0,0,0,0
1746603707821,EDS 25,A02,888209,Staff,0,0,0,0
1746603707821,EDS 25,A03,888210,Staff,0,0,0,0
1746603707821,EDS 25,A04,888212,Staff,0,0,0,0
1746603707821,EDS 25,A05,888213,Staff,0,0,0,0
1746603707821,EDS 25,A06,888214,Staff,0,0,0,0
1746603707821,EDS 25,A07,888235,Staff,0,2,0,0
1746603707821,EDS 25,A08,888236,Staff,0,0,0,0
1746603707821,EDS 25,A09,888240,Staff,0,0,0,0
1746603707821,EDS 25,A10,888244,Staff,0,0,0,0
1746603707821,EDS 25,B01,888273,Staff,0,0,0,0
1746603707821,EDS 25,B02,888285,Staff,0,0,0,0
1746603707821,EDS 25,B03,888423,Staff,0,0,0,1
1746603707821,EDS 25,B04,888432,Staff,0,0,0,0
1746603707821,EDS 25,B05,888433,Staff,0,0,0,0
1746603707821,EDS 25,B06,888467,Staff,0,0,0,0
1746603707821,EDS 25,B07,888468,Staff,0,0,0,0
1746603707821,EDS 25,B08,888479,Staff,0,0,0,0
1746603707821,EDS 25,B09,888484,Staff,0,0,0,0
1746603707821,EDS 25,B10,888487,Staff,0,0,0,0
1746603708849,EDS 38,A01,907700,Choi; Bailey Miyeon,30,0,30,0
1746603709881,EDS 112,A01,888601,Chapman; Thandeka K,12,0,40,28
1746603710908,EDS 115,A00,888697,Mendez; Kathrina Mendoza,10,0,30,20
1746603711937,EDS 116,A01,888893,Staff,33,0,40,7
1746603713990,EDS 124AR,A00,889133,Staff,29,0,50,21
1746603713990,EDS 124AR,B00,907471,Simon; Elizabeth A,37,0,50,13
1746603715048,EDS 124BR,A00,889134,Simon; Elizabeth A,44,0,100,56
1746603716081,EDS 125,A00,889135,Staff,25,0,30,5
1746603717109,EDS 126,A01,889138,Staff,35,0,40,5
1746603718138,EDS 164R,A01,889142,Wishard Guerra; Alison G.,32,0,50,18
1746603719164,ENG 30,A01,886396,Staff,0,0,0,0
1746603719164,ENG 30,B01,886398,Staff,0,0,0,0
1746603720197,ENVR 102,A00,906150,Montejo; Carolina,23,0,25,2
1746603721232,ETHN 103A,A00,887236,Man; Simeon S,0,2,0,0
1746603722268,ETHN 113,A00,887239,Staff,16,0,30,14
1746603723295,ETHN 116,A00,887240,Staff,16,0,25,9
1746603724320,ETHN 117,A00,887241,Choi; Esther Min,28,0,30,2
1746603725347,ETHN 118,A00,887243,Staff,24,0,30,6
1746603726373,ETHN 127,A00,887248,Cuong; Marisol,11,0,15,4
1746603727399,ETHN 139,A00,887250,Staff,7,0,10,3
1746603728430,ETHN 142,A00,887252,Staff,9,0,30,21
1746603729457,ETHN 161,A00,887253,Browne; Errol Tsekani,24,0,30,6
1746603730486,ETHN 163FR,A00,887255,Burelle; Julie Sara Veronique,0,0,5,5
1746603731513,GLBH 20,A00,889149,Elwardani; Nile Regina,8,0,42,34
1746603733567,GLBH 111,A01,889152,Burgos; Jose L.,17,0,17,0
1746603734602,GLBH 150,A00,889181,Sloane; Julia Kathryn,0,5,15,15
1746603736655,HDS 60,A01,886406,Warstadt; Melissa Fawn,72,0,80,8
1746603737690,HIAF 111,A00,889324,Gyamfi; Bright,25,0,32,7
1746603738718,HIEA 131,A00,889328,Staff,15,0,32,17
1746603739747,HIEA 144,A00,889333,Henry; Todd A.,26,0,32,6
1746603740773,HIEA 154,A00,889336,Henry; Todd A.,24,0,32,8
1746603741803,HIEU 106,A00,889339,Staff,22,0,32,10
1746603743859,HIEU 114,A00,889340,Staff,4,0,32,28
1746603744894,HIEU 135GS,A00,889342,Patterson; Patrick H.,0,0,1,24
1746603745925,HIEU 137,A00,889343,Edington; Claire Ellen,10,0,25,15
1746603746955,HIEU 148,A00,889345,Staff,14,0,32,18
1746603747989,HIEU 154,A00,889346,Biess; Frank Peter,21,0,32,11
1746603749015,HILA 102,A00,889351,Staff,12,0,32,20
1746603750041,HILD 2A,A01,889221,Lewandoski; Julia Mavis,0,8,32,32
1746603751069,HILD 7B,A01,889225,Man; Simeon S,0,12,32,32
1746603752095,HILD 7C,A01,889288,Alvarez; Luis A,0,14,32,32
1746603753121,HILD 30,A01,889323,Staff,0,5,32,32
1746603755189,HISC 119,A00,889383,Golan; Tal,20,0,32,12
1746603756222,HIUS 103,A00,889384,Man; Simeon S,0,0,32,32
1746603757250,HIUS 117,A00,919797,Kwak; Nancy,18,0,32,14
1746603758276,HIUS 142A,A00,919788,Staff,22,0,32,10
1746603760333,HIUS 149,A00,889386,Gyamfi; Bright,26,0,32,6
1746603761364,HIUS 155,A00,889387,Alvarez; Luis A,15,0,32,17
1746603762415,HUM 3,A01,886499,Caldwell; Michael Alan,19,0,50,31
1746603763440,HUM 3GS,A00,886500,Rodriguez; Bretton Sigfred,0,0,0,28
1746603764472,HUM 3R,A01,886502,Markman; Kristina,0,36,50,50
1746603765509,HUM 4,A01,886504,Crum; Matthew Stephen,23,0,50,27
1746603765509,HUM 4,B01,886506,West; Geoffrey Scott,17,0,50,33
1746603766537,HUM 4GS,A00,886507,Staff,0,0,0,19
1746603767568,HUM 5,A01,886509,Staff,31,0,50,19
1746603768604,HUM 5R,A01,886511,Zavodny; Tatiana Sophia,0,39,50,50
1746603769636,JAPN 180,A00,886407,Staff,16,0,40,24
1746603770666,LATI 50,A01,886409,Martin-Cabrera; Luis,3,0,22,19
1746603770666,LATI 50,A02,886410,Martin-Cabrera; Luis,19,0,22,3
1746603770666,LATI 50,A03,886411,Martin-Cabrera; Luis,21,0,22,1
1746603770666,LATI 50,A04,886412,Martin-Cabrera; Luis,8,0,22,14
1746603771693,LAWS 101,A00,907664,Staff,28,0,60,32
1746603772721,LIAB 1A,A00,889388,Saab; Dima,17,0,20,3
1746603773751,LIAB 1AX,A00,889389,El Cheddadi; Youniss,18,0,20,2
1746603774779,LIFR 1C,A00,889391,Van Moer; Vinciane G,8,0,20,12
1746603775805,LIFR 1CX,A00,889392,Van Moer; Vinciane G,7,0,20,13
1746603776837,LIFR 1D,A00,889393,Van Moer; Vinciane G,7,0,20,13
1746603777863,LIFR 1DX,A00,889394,Van Moer; Vinciane G,8,0,20,12
1746603778895,LIGN 7,A00,886923,Staff,25,0,50,25
1746603779923,LIGN 17,A00,886924,Kehler; Andrew Scott,126,0,150,24
1746603780950,LTAM 110,A00,889395,Staff,15,0,30,15
1746603781981,LTAM 110GS,A00,958010,Rodriguez; Bretton Sigfred,0,0,0,28
1746603783007,LTCH 101,A00,889397,Staff,23,0,25,2
1746603784032,LTCS 130,A00,889398,Staff,23,0,25,2
1746603785059,LTEA 138,A00,889399,Staff,24,0,40,16
1746603786091,LTEN 149,A00,889400,Wesling; Megan E.,0,3,25,25
1746603787119,LTEN 169,A00,889401,Staff,20,0,25,5
1746603788145,LTEN 180,A00,889402,Staff,10,0,15,5
1746603789171,LTEN 181,A00,889403,Staff,21,0,25,4
1746603790198,LTWL 100,A00,889404,Myerston Santana; Jacobo,2,0,25,23
1746603791226,LTWL 180GS,A00,889405,Staff,0,0,20,20
1746603792256,LTWL 181,A00,889406,Staff,16,0,25,9
1746603793282,LTWL 184,A00,889475,Mukherjee; Silpa,22,0,25,3
1746603794308,LTWR 102C,A00,889486,Staff,29,0,30,1
1746603795347,LTWR 115W,A00,889491,Staff,0,2,15,15
1746603796374,MAE 8,A01,886905,Staff,0,2,0,0
1746603797408,MAE 11,A00,886906,Bandaru; Prabhakar,0,7,50,50
1746603798434,MAE 20,A00,886907,Evdokimenko; Ekaterina,43,0,70,27
1746603799462,MAE 30B,A00,886909,Ghazinejad; Maziar,25,0,45,20
1746603800489,MAE 101B,A00,886910,Saintillan; David,30,0,45,15
1746603801525,MAE 105,A00,886911,Bandaru; Prabhakar,18,0,50,32
1746603802552,MAE 107,B00,958024,Staff,7,0,50,43
1746603803586,MAE 143B,A00,886913,Bewley; Thomas R,2,0,40,38
1746603804613,MAE 148,A01,886915,Silberman; Jack,0,3,14,14
1746603805639,MAE 160,A00,886916,Evdokimenko; Ekaterina,30,0,60,30
1746603806669,MATH 3C,A01,889681,Staff,0,2,30,30
1746603806669,MATH 3C,A02,960048,Staff,23,0,30,7
1746603807695,MATH 10A,A01,889760,Staff,26,0,30,4
1746603807695,MATH 10A,A02,889783,Staff,29,0,30,1
1746603808730,MATH 10B,A01,889785,Verstraete; Jacques Allan,1,0,35,34
1746603808730,MATH 10B,A02,889795,Verstraete; Jacques Allan,4,0,35,31
1746603808730,MATH 10B,B01,889797,Verstraete; Jacques Allan,3,0,35,32
1746603808730,MATH 10B,B02,889828,Verstraete; Jacques Allan,3,0,35,32
1746603809762,MATH 10C,A01,889849,Habib; Yousaf,8,0,30,22
1746603809762,MATH 10C,A02,889852,Habib; Yousaf,14,0,30,16
1746603809762,MATH 10C,A03,889853,Habib; Yousaf,22,0,30,8
1746603809762,MATH 10C,A04,889858,Habib; Yousaf,20,0,30,10
1746603809762,MATH 10C,B01,889861,Staff,1,0,30,29
1746603809762,MATH 10C,B02,889862,Staff,24,0,30,6
1746603809762,MATH 10C,B03,889863,Staff,27,0,30,3
1746603809762,MATH 10C,B04,889967,Staff,23,0,30,7
1746603810797,MATH 18,A01,889974,Staff,7,0,30,23
1746603810797,MATH 18,A02,889977,Staff,20,0,30,10
1746603810797,MATH 18,B01,889984,Hardiman; Liam,20,0,30,10
1746603810797,MATH 18,B02,889985,Hardiman; Liam,25,0,30,5
1746603811825,MATH 20A,A01,889990,Suk; Andrew Hoon,30,0,35,5
1746603812862,MATH 20B,A01,889993,Ohm; Ko Woon,21,0,30,9
1746603812862,MATH 20B,A02,889994,Ohm; Ko Woon,30,0,30,0
1746603812862,MATH 20B,B01,889996,Ohm; Ko Woon,22,0,30,8
1746603812862,MATH 20B,B02,889997,Ohm; Ko Woon,23,0,30,7
1746603813892,MATH 20C,A01,889999,Hammock; Frances H,17,0,30,13
1746603813892,MATH 20C,A02,890003,Hammock; Frances H,23,0,30,7
1746603813892,MATH 20C,B01,890006,Hammock; Frances H,2,0,30,28
1746603813892,MATH 20C,B02,890007,Hammock; Frances H,12,0,30,18
1746603814919,MATH 20D,A01,890011,Cheng; Hsiao-Bing,1,0,30,29
1746603814919,MATH 20D,A02,890012,Cheng; Hsiao-Bing,14,0,30,16
1746603814919,MATH 20D,B01,890016,Cheng; Hsiao-Bing,13,0,30,17
1746603814919,MATH 20D,B02,890017,Cheng; Hsiao-Bing,13,0,30,17
1746603815958,MATH 20E,A01,890026,Harel; Guershon,1,0,30,29
1746603815958,MATH 20E,A02,890029,Harel; Guershon,22,0,30,8
1746603815958,MATH 20E,B01,890033,Harel; Guershon,7,0,30,23
1746603815958,MATH 20E,B02,890101,Harel; Guershon,21,0,30,9
1746603816982,MATH 102,A01,890104,Staff,18,0,30,12
1746603816982,MATH 102,A02,890105,Staff,27,0,30,3
1746603818015,MATH 103B,A01,890116,Salehi Golsefidy; Alireza,3,0,30,27
1746603818015,MATH 103B,B01,890118,Staff,0,3,34,34
1746603819052,MATH 109,A01,890121,Aliabadi Sr.; Mohsen,0,0,30,30
1746603819052,MATH 109,B01,890124,Upadrashta; Pranav Kumar,18,0,30,12
1746603820087,MATH 120A,A01,890126,Eggers; John Dietrich,13,0,30,17
1746603821117,MATH 142B,A01,890128,Ioana; Adrian,19,0,30,11
1746603821117,MATH 142B,A02,890129,Ioana; Adrian,12,0,30,18
1746603822143,MATH 154,A01,890174,Staff,0,1,30,30
1746603822143,MATH 154,A02,890182,Staff,0,0,30,30
1746603823171,MATH 168A,A01,890197,Dumitriu; Ioana,21,0,35,14
1746603824200,MATH 170A,A01,890240,Nie; Jiawang,1,0,30,29
1746603824200,MATH 170A,A02,890241,Nie; Jiawang,11,0,30,19
1746603824200,MATH 170A,A03,890249,Nie; Jiawang,23,0,30,7
1746603825231,MATH 170B,A01,957891,Nag; Panchali,13,0,35,22
1746603827285,MATH 181A,A01,908025,Staff,0,3,35,35
1746603827285,MATH 181A,A02,960115,Staff,26,0,35,9
1746603828316,MATH 181B,A01,959874,Staff,24,0,30,6
1746603829341,MATH 193B,A01,890265,Staff,0,4,35,35
1746603830369,MGT 4,A01,890311,Anderson; John Charles,42,0,88,46
1746603831399,MGT 5,A00,907740,Staff,12,0,98,86
1746603832427,MGT 12,A00,890312,Lindenberger; Wade Douglas,67,0,98,31
1746603833452,MGT 16,A00,957883,Staff,78,0,98,20
1746603835506,MGT 45,A00,890314,Pecore; Joseph P.,45,0,98,53
1746603836532,MGT 71,A00,890315,Staff,0,12,98,98
1746603837560,MGT 100,A00,890316,Yavorsky; Daniel Ryan,44,0,98,54
1746603838590,MGT 103,A00,890317,Ehrich; Kristine R,73,0,98,25
1746603839624,MGT 105,A00,890356,Bates; Kenneth Walter,0,8,98,98
1746603840650,MGT 112,A00,890360,Ehrich; Kristine R,55,0,98,43
1746603841682,MGT 127R,A00,907732,Zhu; Kevin Xiaoguo,23,0,98,75
1746603842711,MGT 131B,A00,890361,Anderson; John Charles,59,0,98,39
1746603843752,MGT 137,A00,890362,Lindenberger; Wade Douglas,65,0,98,33
1746603844780,MGT 160,A00,890369,Johnson; Erik Barry,9,0,98,89
1746603846838,MGT 164,A00,890372,Zimmermann; Carsten,0,40,98,98
1746603847867,MGT 180,A00,890374,Bliss; Barbara Ann,11,0,98,87
1746603848894,MMW 15,A01,886414,Chang; Edmond Yi-Teh,0,12,28,28
1746603848894,MMW 15,A02,886415,Chang; Edmond Yi-Teh,0,8,28,28
1746603848894,MMW 15,A03,886416,Chang; Edmond Yi-Teh,0,9,28,28
1746603848894,MMW 15,A04,886417,Chang; Edmond Yi-Teh,0,8,28,28
1746603848894,MMW 15,B01,886419,Chang; Edmond Yi-Teh,0,7,28,28
1746603848894,MMW 15,B02,886420,Chang; Edmond Yi-Teh,0,7,28,28
1746603848894,MMW 15,B03,886421,Chang; Edmond Yi-Teh,0,7,28,28
1746603848894,MMW 15,B04,886422,Chang; Edmond Yi-Teh,0,8,28,28
1746603848894,MMW 15,C01,886424,Staff,0,9,28,28
1746603848894,MMW 15,C02,886425,Staff,0,8,28,28
1746603848894,MMW 15,C03,886426,Staff,0,8,28,28
1746603848894,MMW 15,C04,886427,Staff,0,8,28,28
1746603848894,MMW 15,C05,958038,Staff,0,8,28,28
1746603848894,MMW 15,C06,958039,Staff,0,7,28,28
1746603849921,MMW 15GS,A00,906910,Patterson; Patrick H.,4,0,28,24
1746603850948,MMW 122R,A01,886429,Rahimi; Babak,0,13,28,28
1746603850948,MMW 122R,A02,886430,Rahimi; Babak,0,12,28,28
1746603850948,MMW 122R,A03,958040,Rahimi; Babak,0,11,28,28
1746603851976,MUS 1A,A01,890937,Staff,2,0,25,23
1746603851976,MUS 1A,A02,891035,Staff,6,0,25,19
1746603851976,MUS 1A,C01,958912,Staff,24,0,25,1
1746603851976,MUS 1A,C02,958913,Staff,25,0,25,0
1746603854037,MUS 2AK,A00,957092,Ohnishi; Takae,15,0,15,0
1746603855066,MUS 4,A01,891044,Staff,0,0,25,25
1746603855066,MUS 4,A02,891045,Staff,22,0,25,3
1746603855066,MUS 4,B01,891048,Staff,17,0,25,8
1746603855066,MUS 4,B02,891050,Staff,25,0,25,0
1746603856108,MUS 5,A01,957506,Dubnov; Shlomo,0,0,25,25
1746603856108,MUS 5,A02,957622,Dubnov; Shlomo,12,0,25,13
1746603856108,MUS 5,A03,957623,Dubnov; Shlomo,20,0,25,5
1746603857138,MUS 6,A01,891053,Freitas Caetano; Marcelo,24,0,25,1
1746603857138,MUS 6,A02,891054,Freitas Caetano; Marcelo,23,0,25,2
1746603858164,MUS 7,A01,891081,Staff,0,0,25,25
1746603858164,MUS 7,A02,891082,Staff,3,0,25,22
1746603859199,MUS 8GS,A00,891118,Borgo; David Garcia,1,0,25,24
1746603860224,MUS 11,A01,891140,Staff,8,0,25,17
1746603860224,MUS 11,A02,891141,Staff,21,0,25,4
1746603861249,MUS 13,A01,891143,Staff,8,0,25,17
1746603861249,MUS 13,A02,891144,Staff,24,0,25,1
1746603862277,MUS 15,A01,891146,Staff,9,0,25,16
1746603862277,MUS 15,A02,891148,Staff,21,0,25,4
1746603862277,MUS 15,B01,891150,Staff,18,0,25,7
1746603862277,MUS 15,B02,891151,Staff,25,0,25,0
1746603863305,MUS 20,A01,891153,Staff,5,0,20,15
1746603863305,MUS 20,A02,891155,Staff,14,0,20,6
1746603864331,MUS 80,A00,891156,Staff,19,0,25,6
1746603864331,MUS 80,B00,891157,Staff,23,0,25,2
1746603865357,MUS 130,A00,891158,Ohnishi; Takae,35,0,35,0
1746603866384,MUS 150GS,A01,891160,Borgo; David Garcia,1,0,25,24
1746603867409,MUS 170,A01,891162,Freitas Caetano; Marcelo,20,0,25,5
1746603867409,MUS 170,A02,891164,Freitas Caetano; Marcelo,21,0,25,4
1746603868437,NANO 11,A00,886220,Vazquez Mena; Oscar,13,0,15,2
1746603869463,NANO 15,A01,886222,Drews; Aaron,4,0,7,3
1746603870489,NANO 104,A00,886224,Sirbuly; Donald,17,0,25,8
1746603871520,PH 40,A00,886528,Staff,23,0,40,17
1746603872554,PH 45,A01,886799,Staff,35,0,40,5
1746603873579,PH 110,A00,886802,Staff,0,6,40,40
1746603874605,PH 172,A00,906716,Staff,19,0,35,16
1746603875632,PH 191,A00,886803,Staff,6,0,40,34
1746603876659,PHIL 1,A00,889500,Staff,20,0,30,10
1746603877688,PHIL 10,A01,889549,Grush; Rick Scott,16,0,22,6
1746603877688,PHIL 10,A02,889551,Grush; Rick Scott,22,0,22,0
1746603878717,PHIL 28,A01,889559,Lamey; Andy M.,0,2,31,31
1746603878717,PHIL 28,A02,889561,Lamey; Andy M.,0,1,30,30
1746603878717,PHIL 28,A03,889572,Lamey; Andy M.,0,1,30,30
1746603879750,PHIL 35,A00,907839,Staff,13,0,15,2
1746603880778,PHIL 60,A00,889574,Staff,73,0,90,17
1746603881807,PHIL 101,A00,958004,Staff,12,0,15,3
1746603883862,PHIL 136,A00,889582,Fulkerson; Matthew Todd,26,0,45,19
1746603884900,PHIL 163,A01,889601,Staff,21,0,30,9
1746603884900,PHIL 163,B01,889606,Brandt; Reuven A,0,3,0,0
1746603885929,PHIL 164,A00,889610,Staff,16,0,30,14
1746603886955,PHIL 165,A00,889613,Staff,22,0,30,8
1746603887984,PHYS 1A,A00,886431,Staff,30,0,70,40
1746603889013,PHYS 1AL,001,886432,Tsai; Philbert S,0,1,30,30
1746603889013,PHYS 1AL,002,886436,Tsai; Philbert S,13,0,30,17
1746603890045,PHYS 1B,A00,886439,Staff,184,0,240,56
1746603891076,PHYS 1BL,001,886441,Tsai; Philbert S,0,4,30,30
1746603891076,PHYS 1BL,002,886444,Tsai; Philbert S,2,0,30,28
1746603892105,PHYS 1C,A00,896092,Arnold; Kam S,78,0,146,68
1746603893139,PHYS 1CL,001,886448,Tsai; Philbert S,0,0,30,30
1746603893139,PHYS 1CL,002,886449,Tsai; Philbert S,1,0,30,29
1746603893139,PHYS 1CL,003,886450,Tsai; Philbert S,16,0,30,14
1746603893139,PHYS 1CL,004,886451,Tsai; Philbert S,15,0,30,15
1746603894167,PHYS 2B,A01,886457,Staff,67,0,115,48
1746603895195,PHYS 2C,A01,886460,Shotwell; Brian,0,9,65,65
1746603896225,PHYS 2CL,A01,886467,Staff,0,4,28,28
1746603896225,PHYS 2CL,A02,886468,Staff,0,3,28,28
1746603897253,PHYS 2D,A01,886470,Staff,10,0,50,40
1746603898279,PHYS 4B,A01,886475,Grinstein; Benjamin,22,0,40,18
1746603899308,POLI 5,A00,891173,Desposato; Scott,7,0,25,18
1746603900338,POLI 5D,A01,891175,Staff,5,0,5,0
1746603900338,POLI 5D,B01,891178,Staff,5,0,5,0
1746603901365,POLI 11,A00,891179,Ferree; Karen E,0,0,35,35
1746603902391,POLI 12,A00,891180,Staff,15,0,30,15
1746603903416,POLI 27,A01,891182,Staff,11,0,75,64
1746603904441,POLI 30,A00,891183,Staff,8,0,50,42
1746603905469,POLI 100B,A00,891244,Staff,5,1,35,30
1746603906496,POLI 100I,A00,891247,Staff,7,0,30,23
1746603907582,POLI 104J,A00,891248,Nichter; Maysa,14,0,30,16
1746603908609,POLI 104U,A00,891250,Nichter; Maysa,1,0,30,29
1746603910663,POLI 110B,A00,891255,Wiens; David,19,0,25,6
1746603911689,POLI 112A,A00,891256,Wiens; David,6,0,25,19
1746603912715,POLI 114BR,A00,891261,Staff,19,0,30,11
1746603913745,POLI 117R,A00,891262,Forman; Fonna,0,6,50,50
1746603914770,POLI 118,A00,891264,Ingham; Sean,17,0,25,8
1746603915796,POLI 124A,A00,891265,Staff,18,0,20,2
1746603916826,POLI 125D,A00,891266,Nichter; Simeon C,2,0,25,23
1746603917853,POLI 126,A00,891268,Nichter; Simeon C,7,0,25,18
1746603918880,POLI 126AA,A00,891272,Staff,15,0,25,10
1746603919908,POLI 130AA,A00,891273,Staff,15,0,20,5
1746603920933,POLI 134AA,A00,891274,Staff,4,0,20,16
1746603922992,POLI 138,A00,891278,Staff,21,0,25,4
1746603924021,POLI 142K,A00,891280,Staff,10,0,25,15
1746603925053,POLI 142M,A00,891281,Gartzke; Erik,16,0,30,14
1746603926081,POLI 142P,A00,891284,Staff,20,0,30,10
1746603927110,POLI 143,A00,891285,Gartzke; Erik,12,0,30,18
1746603928136,POLI 153,A00,891286,Staff,19,0,20,1
1746603930193,POLI 175,A00,891290,Staff,15,0,20,5
1746603931221,PSYC 1,A00,890674,Steiner; Eric Tomas,0,11,45,45
1746603932254,PSYC 2,A00,890676,Albright; Thomas D,20,0,35,15
1746603933284,PSYC 3,A00,890679,Staff,17,0,20,3
1746603934310,PSYC 6,A00,959858,Staff,19,0,20,1
1746603935337,PSYC 60,A01,890684,Rickard; Timothy C.,0,6,45,45
1746603936366,PSYC 70,A01,890689,Geller; Emma Harlan,6,0,30,24
1746603937397,PSYC 71,A01,959860,Staff,21,0,25,4
1746603938429,PSYC 100,A00,890690,Lacefield; Katharine I,0,50,180,180
1746603939454,PSYC 102,A00,890695,Staff,18,0,40,22
1746603940485,PSYC 105,A00,890699,Geller; Emma Harlan,70,0,100,30
1746603941514,PSYC 106,A00,890701,Gorman; Michael R.,5,0,30,25
1746603942544,PSYC 108,A00,890704,Adrian; Julia Anna,0,29,50,50
1746603943570,PSYC 118,A01,890712,Staff,11,0,30,19
1746603944599,PSYC 124,A00,890716,Chapman; Eddie Nathaniel,25,0,60,35
1746603945639,PSYC 131,A00,890717,Anagnostaras; Stephan,0,7,80,80
1746603946671,PSYC 137,A00,890719,Winkielman; Piotr,0,11,30,30
1746603947700,PSYC 144,A00,890721,Adrian; Julia Anna,0,9,45,45
1746603948728,PSYC 162,A00,890805,Staff,0,2,75,75
1746603949759,PSYC 169,A00,890810,Staff,0,15,30,30
1746603950789,PSYC 172,A00,890814,Gorman; Michael R.,9,0,30,21
1746603951819,PSYC 181,A00,890818,Anagnostaras; Stephan,6,0,200,194
1746603952845,PSYC 184,A00,959861,Staff,161,0,175,14
1746603953872,PSYC 189,A00,890823,Staff,0,2,30,30
1746603954905,PSYC 191,A00,890884,Rickard; Timothy C.,0,11,35,35
1746603955938,PSYC 193,A00,890913,Staff,19,0,30,11
1746603955938,PSYC 193,B00,890914,Chapman; Eddie Nathaniel,24,0,30,6
1746603956965,PSYC 193L,A01,890918,Lowe; Angela Beth,20,0,30,10
1746603956965,PSYC 193L,B01,890921,Hurwitz; Ethan Scott,20,0,30,10
1746603956965,PSYC 193L,C01,890928,Staff,30,0,30,0
1746603957993,RELI 149,A00,886806,Rahimi; Babak,23,0,40,17
1746603959020,SE 9,A01,886814,Staff,7,0,20,13
1746603960052,SE 101B,A01,886816,Chadha; Mayank,3,0,35,32
1746603961083,SE 110B,A00,886818,Zhu; Qiang,4,0,75,71
1746603962114,SE 125,A01,886830,Staff,10,0,30,20
1746603963141,SE 130B,A01,886835,Staff,14,0,40,26
1746603964167,SE 131A,A01,886838,Krysl; Petr,34,0,55,21
1746603965195,SE 154,A00,886840,Staff,28,0,50,22
1746603966225,SE 164GS,A01,886849,Staff,6,0,20,14
1746603967252,SE 167GS,A01,886853,Staff,6,0,20,14
1746603968278,SIO 25,A01,890107,Staff,19,0,30,11
1746603969311,SIO 45,A00,890109,Cook; Geoffrey W,115,0,200,85
1746603970337,SIO 109R,A00,890110,Forman; Fonna,0,16,20,20
1746603971363,SIO 187,A01,890114,Kacev; David,15,0,40,25
1746603972392,SOCI 1,A01,890431,Thorpe; Charles Robert,14,0,30,16
1746603972392,SOCI 1,A02,890518,Thorpe; Charles Robert,30,0,30,0
1746603973419,SOCI 2,A01,957978,Staff,25,0,25,0
1746603973419,SOCI 2,A02,957979,Staff,23,0,25,2
1746603974465,SOCI 20,A01,890523,Calderon-Zaks; Michael Aar,21,0,30,9
1746603974465,SOCI 20,A02,890526,Calderon-Zaks; Michael Aar,29,0,30,1
1746603975493,SOCI 30,A01,890533,Pardo Guerra; Juan Pablo,37,0,40,3
1746603976519,SOCI 40,A01,890535,Staff,27,0,45,18
1746603977548,SOCI 104Q,A00,890559,Staff,17,0,30,13
1746603978573,SOCI 106,A00,890560,Arnal; Maud Marie Leonie,20,0,30,10
1746603979603,SOCI 110,A00,890567,Holkenbrink-Monk; Charlene,19,0,30,11
1746603980628,SOCI 112,A00,890568,Victoria Torres; Pablo,2,0,55,53
1746603981656,SOCI 115,A00,890597,Arnal; Maud Marie Leonie,28,0,45,17
1746603983712,SOCI 121,A00,890604,Pardo Guerra; Juan Pablo,38,0,45,7
1746603984747,SOCI 126,A01,890608,Staff,8,0,10,2
1746603985773,SOCI 127,A00,890609,Staff,18,0,30,12
1746603986803,SOCI 131,A00,890610,Thorpe; Charles Robert,37,0,45,8
1746603987828,SOCI 135,A00,890615,Payne; Christine Anna,14,0,45,31
1746603988854,SOCI 139,A00,890620,Staff,38,0,45,7
1746603989881,SOCI 148E,A00,890622,Calderon-Zaks; Michael Aar,36,0,45,9
1746603990948,SOCI 150,A00,890623,Kohler; Kristopher M.,31,0,45,14
1746603991977,SOCI 157,A00,890625,Jules-Rosette; Bennetta W.,18,0,20,2
1746603993004,SOCI 160,A00,890627,Payne; Christine Anna,21,0,45,24
1746603994034,SYN 1,A00,886855,Fish; Gwendolyn Anne,0,1,0,0
1746603994034,SYN 1,B00,906086,Fish; Gwendolyn Anne,0,2,0,2
1746603995067,SYN 2R,A00,886860,Staff,0,17,15,15
1746603995067,SYN 2R,B00,906106,Atkinson; Arthur Laird,0,16,15,15
1746603996102,SYN 100,A01,886866,Browne; Emily,0,28,20,20
1746603996102,SYN 100,B01,906128,Rock; Martin,0,4,20,20
1746603996102,SYN 100,C01,906140,Deavenport; James Cary,0,4,20,20
1746603996102,SYN 100,D01,907816,Deavenport; James Cary,0,5,20,20
1746603997132,TDAC 1,A00,890286,Walsh; Kim C.,7,0,20,13
1746603998159,TDAC 101,A00,890296,Basso; Beatrice,15,0,20,5
1746603999188,TDDE 131,A00,890297,Staff,47,0,50,3
1746604000213,TDDM 1,A00,890287,Weinberg; Sadie,25,0,30,5
1746604001241,TDGE 11,A00,890288,Fulton; Julia,138,0,200,62
1746604001241,TDGE 11,B00,890289,Castro; Robert Jess,184,0,200,16
1746604002266,TDGE 25,B00,957359,Walsh; Kim C.,5,0,20,15
1746604003293,TDGE 40,A01,890292,Power; Jade Yukana,26,0,30,4
1746604004321,TDGE 124,A00,890298,Havis; Allan,0,2,50,50
1746604005350,TDGE 131R,A00,890299,Burelle; Julie Sara Veronique,15,0,42,27
1746604006376,TDHT 101,A00,890300,Staff,10,0,20,10
1746604007407,TDHT 109,A01,890302,Anderson; Mysia Anyse,31,0,40,9
1746604008433,TDMV 1,A00,890293,Arcidiacono; Kristin,18,0,30,12
1746604009459,TDMV 2,A00,890294,Weinberg; Sadie,23,0,30,7
1746604010488,TDMV 3,A00,957878,Arcidiacono; Kristin,28,0,30,2
1746604012543,TDMV 138,A00,890304,Jun; Grace Shin Hae,25,0,40,15
1746604013568,TDMV 140,A00,890305,Corrales; Joseph Bernales,25,0,30,5
1746604014594,TDMV 142,A00,890307,Caligagan; Tony,32,0,40,8
1746604015627,TDMV 144,A00,890308,Camaya; Michelle Ann,25,0,30,5
1746604016654,TDPW 1,A00,890295,Stein; Deborah Isobel,3,0,20,17
1746604017687,USP 2,A01,890272,Lerner; Amy M,7,0,20,13
1746604018716,USP 3,A01,890274,Staff,12,0,30,18
1746604019744,USP 15,A01,890276,Sun; Feiyang,16,0,30,14
1746604020776,USP 25,A00,890277,Shenkman; Michael Thomas,18,0,25,7
1746604021805,USP 138,A00,890278,Staff,13,0,25,12
1746604022831,USP 143,A00,890279,Staff,21,0,70,49
1746604023858,USP 144,A00,890280,Chowdhury; Muhammed Zohir,16,0,30,14
1746604024884,USP 150,A00,890281,Boomhower; Matthew Charles,4,0,30,26
1746604025912,USP 151,A00,890282,Staff,16,0,20,4
1746604026937,USP 162,A00,890283,Andrews; Abigail Leslie,16,0,20,4
1746604027969,USP 168,A00,920477,Kwak; Nancy,0,0,5,5
1746604028997,USP 181,A00,890284,Staff,3,0,20,17
1746604030030,USP 191A,A00,890285,Staff,12,0,20,8
1746604031062,VIS 101,A00,886512,Staff,26,0,75,49
1746604032091,VIS 103,A00,886513,Cruz; Edwin Teddy,61,0,75,14
1746604033119,VIS 108,A00,886514,Staff,4,0,15,11
1746604034145,VIS 127P,A00,886515,Shen; Kuiyi,80,0,146,66
1746604035174,VIS 149,A00,886516,Yoldas; Pinar,0,0,15,15
1746604036201,VIS 164,A00,886526,Erdmann; Dean,19,0,22,3
1746604037227,VIS 194S,A00,886527,Staff,61,0,75,14
1746604038258,WCWP 10A,C00,886484,Martiniuk; Jill,12,0,15,3
1746604039291,WCWP 10B,A00,886490,Uriarte; Emma,0,0,15,15
1746604039291,WCWP 10B,B00,886491,Dhir; Simrita,8,0,15,7
1746604039291,WCWP 10B,C00,886492,Ornelas; Tricia,0,0,15,15
1746604040324,WCWP 100,A00,886494,Young; Mark T,0,6,15,15
1746604042469,AAS 10,A01,886199,Childs; Dennis R.,0,3,0,0
1746604043497,ANAR 104,A01,886940,Shtienberg; Gilad,27,0,30,3
1746604044525,ANAR 120,A00,886953,Staff,13,0,20,7
1746604045551,ANBI 148,A01,886955,Wilder; Linnea Lorene,30,0,40,10
1746604047602,ANSC 122,A00,886957,Staff,24,0,30,6
1746604048633,ANSC 150,A00,886958,Sloane; Julia Kathryn,2,0,15,13
1746604049663,ANSC 156,A00,886959,Jenkins; Janis A.,0,1,15,15
1746604050689,ANSC 180,A00,886960,Staff,11,0,17,6
1746604051718,ANSC 188,A00,886961,Jassal; Aftab,9,0,25,16
1746604052747,ANSC 190,A00,886962,Jassal; Aftab,14,0,25,11
1746604053777,ANSC 191,A00,886963,Staff,18,0,20,2
1746604054803,ANTH 3,A01,891689,Staff,17,0,20,3
1746604055830,ANTH 5,A00,886933,Semendeferi; Ekaterini,16,0,20,4
1746604056860,ANTH 10,A00,886934,Staff,0,12,30,30
1746604057890,ANTH 21,A01,886936,Staff,41,0,60,19
1746604058915,ANTH 23,A01,886938,Staff,92,0,100,8
1746604059942,ANTH 105,A00,886964,Stewart; Alexander B,84,0,100,16
1746604060970,ANTH 108,A00,886965,Pedersen; David,9,0,20,11
1746604062001,AWP 10,001,886147,Staff,0,0,0,0
1746604062001,AWP 10,002,886148,Staff,0,0,0,0
1746604062001,AWP 10,003,886149,Staff,0,0,0,0
1746604062001,AWP 10,004,886150,Staff,0,0,0,0
1746604062001,AWP 10,005,886151,Staff,0,0,0,0
1746604062001,AWP 10,006,886152,Staff,0,0,0,0
1746604062001,AWP 10,007,886153,Staff,0,0,0,0
1746604062001,AWP 10,008,886154,Staff,0,0,0,0
1746604062001,AWP 10,009,886155,Staff,0,0,0,0
1746604062001,AWP 10,010,886156,Staff,0,0,0,0
1746604062001,AWP 10,011,886158,Staff,0,0,0,0
1746604062001,AWP 10,012,886160,Staff,0,0,0,0
1746604062001,AWP 10,013,886161,Staff,0,0,0,0
1746604062001,AWP 10,014,886162,Staff,0,0,0,0
1746604062001,AWP 10,015,886163,Staff,0,0,0,0
1746604062001,AWP 10,016,886164,Staff,0,0,0,0
1746604062001,AWP 10,017,886165,Staff,0,0,0,0
1746604062001,AWP 10,018,886166,Staff,0,0,0,0
1746604062001,AWP 10,019,886168,Staff,0,0,0,0
1746604062001,AWP 10,020,886170,Staff,0,0,0,0
1746604062001,AWP 10,021,886172,Staff,0,0,0,0
1746604063044,AWP 10R,001,886173,Staff,0,1,0,0
1746604063044,AWP 10R,002,886174,Staff,0,1,0,0
1746604063044,AWP 10R,003,886175,Staff,0,0,0,0
1746604063044,AWP 10R,004,886176,Staff,0,0,0,0
1746604063044,AWP 10R,005,886177,Staff,0,0,0,0
1746604063044,AWP 10R,006,886178,Staff,0,0,0,0
1746604063044,AWP 10R,007,886179,Staff,0,0,0,0
1746604063044,AWP 10R,008,886181,Staff,0,0,0,0
1746604063044,AWP 10R,009,886182,Staff,0,0,0,0
1746604063044,AWP 10R,010,886183,Staff,0,0,0,0
1746604063044,AWP 10R,011,886184,Staff,0,0,0,0
1746604063044,AWP 10R,012,886185,Staff,0,0,0,0
1746604063044,AWP 10R,013,886186,Staff,0,0,0,0
1746604063044,AWP 10R,014,886187,Staff,0,0,0,0
1746604063044,AWP 10R,015,886188,Staff,0,0,0,0
1746604063044,AWP 10R,016,886189,Staff,0,0,0,0
1746604063044,AWP 10R,017,960532,Staff,0,0,0,0
1746604063044,AWP 10R,018,960533,Staff,0,0,0,0
1746604063044,AWP 10R,019,960534,Staff,0,0,0,0
1746604063044,AWP 10R,020,960538,Staff,0,0,0,0
1746604063044,AWP 10R,021,960540,Staff,0,0,0,0
1746604063044,AWP 10R,022,960541,Staff,0,0,0,0
1746604063044,AWP 10R,023,960542,Staff,0,0,0,0
1746604063044,AWP 10R,024,960544,Staff,0,0,0,0
1746604063044,AWP 10R,025,960545,Staff,0,0,0,0
1746604063044,AWP 10R,026,960548,Staff,0,0,0,0
1746604064069,AWP 102R,A00,886190,Staff,0,0,0,0
1746604064069,AWP 102R,B00,886191,Staff,0,0,0,0
1746604065102,BENG 100,A01,886193,Staff,17,0,30,13
1746604066129,BENG 122A,A01,886195,Hasty; Jeff M,13,0,30,17
1746604067154,BENG 166A,A00,886196,Sah; Robert Lie-Yuan,0,3,30,30
1746604068182,BENG 190,A00,958050,Khojah; Reem I,17,0,25,8
1746604069215,BIBC 102,A01,894320,Staff,0,1,46,46
1746604069215,BIBC 102,A02,894321,Staff,0,0,46,46
1746604069215,BIBC 102,A03,894344,Staff,6,0,46,40
1746604069215,BIBC 102,A04,894345,Staff,27,0,47,20
1746604070245,BICD 100R,A01,894365,Smith; Laurie,0,2,58,58
1746604070245,BICD 100R,A02,894366,Smith; Laurie,0,4,58,58
1746604070245,BICD 100R,A03,894367,Smith; Laurie,0,0,59,59
1746604070245,BICD 100R,A04,959869,Smith; Laurie,38,0,59,21
1746604071278,BICD 136,A01,894383,Gustafson-Brown; Cindy,14,0,50,36
1746604072317,BIEB 102,A01,894494,Butler; Shannon Rhey,51,0,130,79
1746604074383,BIEB 150,A01,894617,Wills; Christopher,3,0,20,17
1746604074383,BIEB 150,A02,894631,Wills; Christopher,3,0,20,17
1746604074383,BIEB 150,A03,894937,Wills; Christopher,3,0,20,17
1746604074383,BIEB 150,A04,894946,Wills; Christopher,5,0,20,15
1746604075414,BIEB 194,A00,906141,Kurle; Carolyn M.,5,0,20,15
1746604076441,BILD 1,A01,894154,Staff,3,0,19,16
1746604076441,BILD 1,A02,894155,Staff,14,0,19,5
1746604076441,BILD 1,A03,894160,Staff,13,0,19,6
1746604076441,BILD 1,A04,894161,Staff,15,0,18,3
1746604077468,BILD 2,A01,894168,Staff,0,0,50,50
1746604077468,BILD 2,A02,894169,Staff,0,0,50,50
1746604077468,BILD 2,A03,894179,Staff,0,0,50,50
1746604077468,BILD 2,A04,894203,Staff,22,0,50,28
1746604078499,BILD 3,A01,894213,Staff,23,0,31,8
1746604078499,BILD 3,A02,894214,Staff,26,0,31,5
1746604078499,BILD 3,A03,894235,Staff,28,0,31,3
1746604078499,BILD 3,A04,894236,Staff,28,0,32,4
1746604079526,BILD 4,A01,894253,Reuther; Keefe,5,0,24,19
1746604079526,BILD 4,A02,894258,Reuther; Keefe,16,0,24,8
1746604080561,BILD 5,A01,894276,Reuther; Keefe,34,0,50,16
1746604080561,BILD 5,A02,894277,Reuther; Keefe,45,0,50,5
1746604080561,BILD 5,A03,894290,Reuther; Keefe,44,0,50,6
1746604080561,BILD 5,A04,894291,Reuther; Keefe,48,0,50,2
1746604081589,BILD 24,A01,894297,Pirino; Giorgia,40,0,60,20
1746604082617,BIMM 100,B01,958915,Staff,71,0,100,29
1746604083645,BIMM 101,A01,895017,McDonnell; Lisa Marie,0,5,24,24
1746604083645,BIMM 101,A02,895018,McDonnell; Lisa Marie,0,5,24,24
1746604083645,BIMM 101,B01,895020,McDonnell; Lisa Marie,0,5,24,24
1746604083645,BIMM 101,B02,895021,McDonnell; Lisa Marie,0,4,24,24
1746604084673,BIMM 110,A01,895023,Staff,1,0,25,24
1746604084673,BIMM 110,A02,895024,Staff,9,0,25,16
1746604084673,BIMM 110,A03,895025,Staff,18,0,25,7
1746604084673,BIMM 110,A04,895031,Staff,20,0,25,5
1746604085704,BIMM 120,A01,895114,Gustafson-Brown; Cindy,14,0,28,14
1746604085704,BIMM 120,A02,895126,Gustafson-Brown; Cindy,21,0,27,6
1746604086731,BIPN 100,A01,895130,Yang; Mingyu,0,0,38,38
1746604086731,BIPN 100,A02,895131,Yang; Mingyu,31,0,38,7
1746604086731,BIPN 100,A03,895132,Yang; Mingyu,32,0,38,6
1746604086731,BIPN 100,A04,895133,Yang; Mingyu,27,0,36,9
1746604087760,BIPN 120,A01,895135,Cooke; James Edward,0,3,13,13
1746604087760,BIPN 120,A02,895136,Cooke; James Edward,0,1,13,13
1746604087760,BIPN 120,A03,895137,Cooke; James Edward,0,3,13,13
1746604087760,BIPN 120,A04,895156,Cooke; James Edward,0,2,11,11
1746604088787,BIPN 134,A01,895235,Cooke; James Edward,0,1,25,25
1746604088787,BIPN 134,A02,895237,Cooke; James Edward,0,0,25,25
1746604088787,BIPN 134,A03,895240,Cooke; James Edward,1,0,25,24
1746604088787,BIPN 134,A04,895270,Cooke; James Edward,20,0,25,5
1746604089817,BIPN 189,A00,892103,Staff,0,14,14,14
1746604091874,BISP 194,A00,958008,Staff,0,2,0,0
1746604092902,CAT 124,A01,922009,Staff,0,5,20,20
1746604093948,CAT 125R,A00,886390,Morales; Celeste Georgianna,0,4,20,20
1746604093948,CAT 125R,B00,886391,Irwin; Matthew Joseph,0,4,20,20
1746604093948,CAT 125R,C00,886392,Smith; Lauryn Alissa,0,2,20,20
1746604093948,CAT 125R,D00,886393,Vanderschuit; Maya Alysia,0,3,20,20
1746604093948,CAT 125R,E00,886394,Marchisotto; Jennifer Anne,0,3,20,20
1746604094977,CENG 15,A01,886218,Drews; Aaron,3,0,8,5
1746604096008,CENG 113,A00,886219,Opatkiewicz; Justin Paul,15,0,25,10
1746604097035,CGS 101,A00,887044,Staff,7,0,20,13
1746604098065,CGS 105,A01,887046,Staff,14,0,25,11
1746604099097,CGS 112,A00,887047,Cuong; Marisol,12,0,15,3
1746604100125,CGS 113,A00,887048,Staff,23,0,30,7
1746604101150,CGS 120,A00,887049,Staff,9,0,17,8
1746604102186,CHEM 6A,A01,886336,Lam; Tin Yiu,38,0,50,12
1746604102186,CHEM 6A,A02,886338,Lam; Tin Yiu,37,0,50,13
1746604103213,CHEM 6B,A01,886341,Hopkins; Patrycja Anna,16,0,50,34
1746604103213,CHEM 6B,A02,886343,Hopkins; Patrycja Anna,42,0,50,8
1746604104243,CHEM 6C,A01,886346,Albizati; Kim F.,0,2,50,50
1746604104243,CHEM 6C,A02,886348,Albizati; Kim F.,24,0,50,26
1746604105272,CHEM 40A,A01,886352,Klosterman; Jeremy K,65,0,100,35
1746604106303,CHEM 40B,A01,886356,Klosterman; Jeremy K,0,24,100,100
1746604107331,CHEM 41B,A01,886360,Theodorakis; Emmanuel,25,0,50,25
1746604107331,CHEM 41B,A02,886362,Theodorakis; Emmanuel,47,0,50,3
1746604108361,CHIN 165A,A00,886382,Xu; Li,18,0,20,2
1746604109389,CLAS 120,A00,886387,Myerston Santana; Jacobo,33,0,40,7
1746604110415,COGS 9,A01,886967,Shannon; Kyle Michael,42,0,60,18
1746604111441,COGS 11,A01,886969,Staff,9,0,30,21
1746604112471,COGS 14A,A01,886971,Staff,5,0,60,55
1746604113501,COGS 14B,A01,886973,Hoffman; Drew Ellen,4,0,60,56
1746604114531,COGS 18,A01,886975,Morgan; Eric,34,0,60,26
1746604115612,COGS 20,A01,886977,Staff,3,0,8,5
1746604115612,COGS 20,A02,886978,Staff,5,0,7,2
1746604116642,COGS 100,A01,907783,Staff,0,1,30,30
1746604117669,COGS 101B,A01,886980,Staff,0,4,48,48
1746604118698,COGS 101C,A01,886982,Delgado; Tania,0,5,44,44
1746604119727,COGS 102A,A01,886984,Johnson; Christine M.,3,0,30,27
1746604120766,COGS 118B,A01,886986,Staff,0,4,88,88
1746604121794,COGS 150,A01,886988,Bergen; Benjamin,22,0,50,28
1746604122820,COGS 153,A00,886989,Delgado; Tania,0,3,41,41
1746604123849,COGS 186,A01,886991,Staff,0,0,32,32
1746604124881,COGS 187A,A01,886993,Boyle; Mary E. T.,7,0,30,23
1746604125910,COGS 189,A00,886994,Staff,0,1,30,30
1746604126941,COMM 10,A01,886996,Staff,0,0,20,21
1746604126941,COMM 10,A02,886997,Staff,10,0,20,10
1746604126941,COMM 10,A03,959845,Staff,19,0,20,1
1746604127969,COMM 20,A01,886999,Leuning; Grant Maurstad,24,0,40,16
1746604130035,COMM 100A,A01,887002,Staff,0,0,20,25
1746604130035,COMM 100A,A02,887003,Staff,5,0,20,15
1746604131060,COMM 100B,A01,887005,Staff,0,8,20,24
1746604132086,COMM 106D,A00,887006,Staff,14,0,40,26
1746604133111,COMM 110G,A00,887007,Whitworth-Smith; Andrew C,12,0,40,28
1746604134137,COMM 111B,A00,887008,Staff,31,0,40,9
1746604135164,COMM 113T,A00,887009,Abuelhiga; Soraya Jill,28,0,40,12
1746604135164,COMM 113T,B00,906733,Staff,39,0,40,1
1746604136193,COMM 145,A00,887010,Staff,13,0,40,27
1746604137219,COMM 146,A00,887054,Staff,32,0,40,8
1746604138249,COMM 190,A00,887012,Staff,8,0,23,15
1746604139276,CSE 8A,A50,887015,Cao; Yingjun,56,0,85,29
1746604140306,CSE 11,A01,887017,Cao; Yingjun,11,0,70,59
1746604141332,CSE 20,A01,887019,Staff,30,0,50,20
1746604142372,CSE 21,A01,887021,Staff,79,0,100,21
1746604142372,CSE 21,B01,892583,Braun; Oliver,45,0,50,5
1746604143398,CSE 30,A01,887025,Eldon; John,142,0,200,58
1746604144427,CSE 100,A01,887027,Staff,26,0,50,24
1746604144427,CSE 100,A02,887028,Staff,42,0,50,8
1746604145461,CSE 101,A01,887030,Braun; Oliver,74,0,100,26
1746604145461,CSE 101,B01,887032,Jones; Miles E,0,3,50,50
1746604145461,CSE 101,B02,887033,Jones; Miles E,0,2,50,50
1746604146490,CSE 105,A01,908084,Jones; Miles E,32,0,50,18
1746604146490,CSE 105,A02,908087,Jones; Miles E,31,0,50,19
1746604147516,CSE 135,A01,887035,Powell; Thomas Allan,0,5,50,50
1746604148542,CSE 142,A01,887037,Staff,7,0,60,53
1746604149568,CSE 142L,A01,887039,Staff,34,0,60,26
1746604150596,CSE 151A,A01,887041,Solares; Edwin A,47,0,100,53
1746604151626,CSE 175,A01,887043,Kumar; Rakesh,30,0,30,0
1746604152653,CSS 1,A01,886389,Staff,0,1,40,40
1746604153680,DSC 30,A01,908097,Liao; Soohyun Nam,47,0,75,28
1746604154708,DSC 40A,A01,908099,Shannon; Kyle Michael,30,0,50,20
1746604155739,DSC 40B,A01,908112,Staff,15,0,50,35
1746604156765,DSC 80,A01,908116,Staff,19,0,60,41
1746604157791,DSC 197,001,956863,Eldridge; Justin Matthew,9999,0,9999,0
1746604158818,ECE 5,A01,886400,Morris; Karcher William,1,0,6,5
1746604158818,ECE 5,A02,886401,Morris; Karcher William,3,0,6,3
1746604159849,ECE 148,A01,886403,Silberman; Jack,0,14,14,14
1746604160875,ECON 1,A01,887265,Crane; Meredith Helen,11,0,70,59
1746604160875,ECON 1,B01,887268,Staff,42,0,50,8
1746604161902,ECON 2,A01,887273,Crane; Meredith Helen,54,0,70,16
1746604162931,ECON 3,A01,887279,Rondina; Giacomo,31,0,70,39
1746604163970,ECON 4,A01,887282,Anderson; John Charles,0,2,10,10
1746604164999,ECON 5,A01,887285,Staff,34,0,45,11
1746604164999,ECON 5,B01,887292,Staff,41,0,45,4
1746604166035,ECON 100A,A01,887337,Newhouse; Herbert S,54,0,70,16
1746604166035,ECON 100A,B01,887349,Staff,45,0,50,5
1746604167063,ECON 100B,A01,887361,Du; Songzi,29,0,70,41
1746604168092,ECON 100C,A01,887445,Newhouse; Herbert S,59,0,70,11
1746604169118,ECON 105,A00,887488,Vespa; Emanuel Ignacio,23,0,35,12
1746604170149,ECON 109,A01,887506,Shishkin; Denis,28,0,35,7
1746604171184,ECON 110A,A01,887568,Alon; Titan Michael,0,2,35,35
1746604171184,ECON 110A,B01,907601,Alon; Titan Michael,20,0,35,15
1746604172212,ECON 110B,A01,887598,Levkoff; Steven B.,0,24,70,70
1746604173239,ECON 112,A00,887599,Rondina; Giacomo,19,0,35,16
1746604174264,ECON 120A,A01,887603,Dai; Yinlin,36,0,70,34
1746604175295,ECON 120C,A01,887608,Sun; Yixiao,0,1,35,35
1746604175295,ECON 120C,B01,887614,Sun; Yixiao,0,0,35,35
1746604176323,ECON 138,A00,887621,Bharadwaj; Prashant,0,21,20,20
1746604177354,ECON 144,A00,958007,Squires; Dale E,11,0,35,24
1746604178384,ECON 171,A01,907666,Staff,18,0,35,17
1746604179425,ECON 175,A00,887626,Wu; Pak Yeung,22,0,35,13
1746604180457,ECON 190,A00,887640,Vespa; Emanuel Ignacio,22,0,35,13
1746604181490,EDS 25,A01,888197,Staff,0,0,0,0
1746604181490,EDS 25,A02,888209,Staff,0,0,0,0
1746604181490,EDS 25,A03,888210,Staff,0,0,0,0
1746604181490,EDS 25,A04,888212,Staff,0,0,0,0
1746604181490,EDS 25,A05,888213,Staff,0,0,0,0
1746604181490,EDS 25,A06,888214,Staff,0,0,0,0
1746604181490,EDS 25,A07,888235,Staff,0,2,0,0
1746604181490,EDS 25,A08,888236,Staff,0,0,0,0
1746604181490,EDS 25,A09,888240,Staff,0,0,0,0
1746604181490,EDS 25,A10,888244,Staff,0,0,0,0
1746604181490,EDS 25,B01,888273,Staff,0,0,0,0
1746604181490,EDS 25,B02,888285,Staff,0,0,0,0
1746604181490,EDS 25,B03,888423,Staff,0,0,0,1
1746604181490,EDS 25,B04,888432,Staff,0,0,0,0
1746604181490,EDS 25,B05,888433,Staff,0,0,0,0
1746604181490,EDS 25,B06,888467,Staff,0,0,0,0
1746604181490,EDS 25,B07,888468,Staff,0,0,0,0
1746604181490,EDS 25,B08,888479,Staff,0,0,0,0
1746604181490,EDS 25,B09,888484,Staff,0,0,0,0
1746604181490,EDS 25,B10,888487,Staff,0,0,0,0
1746604182517,EDS 38,A01,907700,Choi; Bailey Miyeon,30,0,30,0
1746604183545,EDS 112,A01,888601,Chapman; Thandeka K,12,0,40,28
1746604184574,EDS 115,A00,888697,Mendez; Kathrina Mendoza,10,0,30,20
1746604185604,EDS 116,A01,888893,Staff,33,0,40,7
1746604187664,EDS 124AR,A00,889133,Staff,29,0,50,21
1746604187664,EDS 124AR,B00,907471,Simon; Elizabeth A,37,0,50,13
1746604188691,EDS 124BR,A00,889134,Simon; Elizabeth A,44,0,100,56
1746604189718,EDS 125,A00,889135,Staff,25,0,30,5
1746604190747,EDS 126,A01,889138,Staff,35,0,40,5
1746604191777,EDS 164R,A01,889142,Wishard Guerra; Alison G.,32,0,50,18
1746604192804,ENG 30,A01,886396,Staff,0,0,0,0
1746604192804,ENG 30,B01,886398,Staff,0,0,0,0
1746604193829,ENVR 102,A00,906150,Montejo; Carolina,23,0,25,2
1746604194857,ETHN 103A,A00,887236,Man; Simeon S,0,2,0,0
1746604195882,ETHN 113,A00,887239,Staff,16,0,30,14
1746604196909,ETHN 116,A00,887240,Staff,16,0,25,9
1746604197937,ETHN 117,A00,887241,Choi; Esther Min,28,0,30,2
1746604198962,ETHN 118,A00,887243,Staff,24,0,30,6
1746604199991,ETHN 127,A00,887248,Cuong; Marisol,11,0,15,4
1746604201018,ETHN 139,A00,887250,Staff,7,0,10,3
1746604202045,ETHN 142,A00,887252,Staff,9,0,30,21
1746604203076,ETHN 161,A00,887253,Browne; Errol Tsekani,24,0,30,6
1746604204107,ETHN 163FR,A00,887255,Burelle; Julie Sara Veronique,0,0,5,5
1746604205141,GLBH 20,A00,889149,Elwardani; Nile Regina,8,0,42,34
1746604207199,GLBH 111,A01,889152,Burgos; Jose L.,17,0,17,0
1746604208233,GLBH 150,A00,889181,Sloane; Julia Kathryn,0,5,15,15
1746604210287,HDS 60,A01,886406,Warstadt; Melissa Fawn,72,0,80,8
1746604211319,HIAF 111,A00,889324,Gyamfi; Bright,25,0,32,7
1746604212348,HIEA 131,A00,889328,Staff,15,0,32,17
1746604213380,HIEA 144,A00,889333,Henry; Todd A.,26,0,32,6
1746604214406,HIEA 154,A00,889336,Henry; Todd A.,24,0,32,8
1746604215434,HIEU 106,A00,889339,Staff,22,0,32,10
1746604217490,HIEU 114,A00,889340,Staff,4,0,32,28
1746604218519,HIEU 135GS,A00,889342,Patterson; Patrick H.,0,0,1,24
1746604219551,HIEU 137,A00,889343,Edington; Claire Ellen,10,0,25,15
1746604220578,HIEU 148,A00,889345,Staff,14,0,32,18
1746604221607,HIEU 154,A00,889346,Biess; Frank Peter,21,0,32,11
1746604222634,HILA 102,A00,889351,Staff,12,0,32,20
1746604223664,HILD 2A,A01,889221,Lewandoski; Julia Mavis,0,8,32,32
1746604224690,HILD 7B,A01,889225,Man; Simeon S,0,12,32,32
1746604225718,HILD 7C,A01,889288,Alvarez; Luis A,0,14,32,32
1746604226744,HILD 30,A01,889323,Staff,0,5,32,32
1746604228804,HISC 119,A00,889383,Golan; Tal,20,0,32,12
1746604229829,HIUS 103,A00,889384,Man; Simeon S,0,0,32,32
1746604230855,HIUS 117,A00,919797,Kwak; Nancy,18,0,32,14
1746604231885,HIUS 142A,A00,919788,Staff,22,0,32,10
1746604233938,HIUS 149,A00,889386,Gyamfi; Bright,26,0,32,6
1746604234965,HIUS 155,A00,889387,Alvarez; Luis A,15,0,32,17
1746604235995,HUM 3,A01,886499,Caldwell; Michael Alan,19,0,50,31
1746604237025,HUM 3GS,A00,886500,Rodriguez; Bretton Sigfred,0,0,0,28
1746604238054,HUM 3R,A01,886502,Markman; Kristina,0,36,50,50
1746604239088,HUM 4,A01,886504,Crum; Matthew Stephen,23,0,50,27
1746604239088,HUM 4,B01,886506,West; Geoffrey Scott,17,0,50,33
1746604240114,HUM 4GS,A00,886507,Staff,0,0,0,19
1746604241143,HUM 5,A01,886509,Staff,31,0,50,19
1746604242169,HUM 5R,A01,886511,Zavodny; Tatiana Sophia,0,39,50,50
1746604243196,JAPN 180,A00,886407,Staff,16,0,40,24
1746604244224,LATI 50,A01,886409,Martin-Cabrera; Luis,3,0,22,19
1746604244224,LATI 50,A02,886410,Martin-Cabrera; Luis,19,0,22,3
1746604244224,LATI 50,A03,886411,Martin-Cabrera; Luis,21,0,22,1
1746604244224,LATI 50,A04,886412,Martin-Cabrera; Luis,8,0,22,14
1746604245255,LAWS 101,A00,907664,Staff,28,0,60,32
1746604246287,LIAB 1A,A00,889388,Saab; Dima,17,0,20,3
1746604247315,LIAB 1AX,A00,889389,El Cheddadi; Youniss,18,0,20,2
1746604248343,LIFR 1C,A00,889391,Van Moer; Vinciane G,8,0,20,12
1746604249367,LIFR 1CX,A00,889392,Van Moer; Vinciane G,7,0,20,13
1746604250398,LIFR 1D,A00,889393,Van Moer; Vinciane G,7,0,20,13
1746604251427,LIFR 1DX,A00,889394,Van Moer; Vinciane G,8,0,20,12
1746604252453,LIGN 7,A00,886923,Staff,25,0,50,25
1746604253482,LIGN 17,A00,886924,Kehler; Andrew Scott,126,0,150,24
1746604254507,LTAM 110,A00,889395,Staff,15,0,30,15
1746604255534,LTAM 110GS,A00,958010,Rodriguez; Bretton Sigfred,0,0,0,28
1746604256561,LTCH 101,A00,889397,Staff,23,0,25,2
1746604257590,LTCS 130,A00,889398,Staff,23,0,25,2
1746604258621,LTEA 138,A00,889399,Staff,24,0,40,16
1746604259648,LTEN 149,A00,889400,Wesling; Megan E.,0,3,25,25
1746604260674,LTEN 169,A00,889401,Staff,20,0,25,5
1746604261701,LTEN 180,A00,889402,Staff,10,0,15,5
1746604262725,LTEN 181,A00,889403,Staff,21,0,25,4
1746604263756,LTWL 100,A00,889404,Myerston Santana; Jacobo,2,0,25,23
1746604264782,LTWL 180GS,A00,889405,Staff,0,0,20,20
1746604265809,LTWL 181,A00,889406,Staff,16,0,25,9
1746604266836,LTWL 184,A00,889475,Mukherjee; Silpa,22,0,25,3
1746604267864,LTWR 102C,A00,889486,Staff,29,0,30,1
1746604268890,LTWR 115W,A00,889491,Staff,0,2,15,15
1746604269915,MAE 8,A01,886905,Staff,0,2,0,0
1746604270948,MAE 11,A00,886906,Bandaru; Prabhakar,0,7,50,50
1746604271988,MAE 20,A00,886907,Evdokimenko; Ekaterina,43,0,70,27
1746604273015,MAE 30B,A00,886909,Ghazinejad; Maziar,25,0,45,20
1746604274046,MAE 101B,A00,886910,Saintillan; David,30,0,45,15
1746604275074,MAE 105,A00,886911,Bandaru; Prabhakar,18,0,50,32
1746604276107,MAE 107,B00,958024,Staff,7,0,50,43
1746604277142,MAE 143B,A00,886913,Bewley; Thomas R,2,0,40,38
1746604278169,MAE 148,A01,886915,Silberman; Jack,0,3,14,14
1746604279196,MAE 160,A00,886916,Evdokimenko; Ekaterina,30,0,60,30
1746604280229,MATH 3C,A01,889681,Staff,0,2,30,30
1746604280229,MATH 3C,A02,960048,Staff,23,0,30,7
1746604281258,MATH 10A,A01,889760,Staff,26,0,30,4
1746604281258,MATH 10A,A02,889783,Staff,29,0,30,1
1746604282286,MATH 10B,A01,889785,Verstraete; Jacques Allan,1,0,35,34
1746604282286,MATH 10B,A02,889795,Verstraete; Jacques Allan,4,0,35,31
1746604282286,MATH 10B,B01,889797,Verstraete; Jacques Allan,3,0,35,32
1746604282286,MATH 10B,B02,889828,Verstraete; Jacques Allan,3,0,35,32
1746604283318,MATH 10C,A01,889849,Habib; Yousaf,8,0,30,22
1746604283318,MATH 10C,A02,889852,Habib; Yousaf,14,0,30,16
1746604283318,MATH 10C,A03,889853,Habib; Yousaf,22,0,30,8
1746604283318,MATH 10C,A04,889858,Habib; Yousaf,20,0,30,10
1746604283318,MATH 10C,B01,889861,Staff,1,0,30,29
1746604283318,MATH 10C,B02,889862,Staff,24,0,30,6
1746604283318,MATH 10C,B03,889863,Staff,27,0,30,3
1746604283318,MATH 10C,B04,889967,Staff,23,0,30,7
1746604284346,MATH 18,A01,889974,Staff,7,0,30,23
1746604284346,MATH 18,A02,889977,Staff,20,0,30,10
1746604284346,MATH 18,B01,889984,Hardiman; Liam,20,0,30,10
1746604284346,MATH 18,B02,889985,Hardiman; Liam,25,0,30,5
1746604285372,MATH 20A,A01,889990,Suk; Andrew Hoon,30,0,35,5
1746604286402,MATH 20B,A01,889993,Ohm; Ko Woon,21,0,30,9
1746604286402,MATH 20B,A02,889994,Ohm; Ko Woon,30,0,30,0
1746604286402,MATH 20B,B01,889996,Ohm; Ko Woon,22,0,30,8
1746604286402,MATH 20B,B02,889997,Ohm; Ko Woon,23,0,30,7
1746604287430,MATH 20C,A01,889999,Hammock; Frances H,17,0,30,13
1746604287430,MATH 20C,A02,890003,Hammock; Frances H,23,0,30,7
1746604287430,MATH 20C,B01,890006,Hammock; Frances H,2,0,30,28
1746604287430,MATH 20C,B02,890007,Hammock; Frances H,12,0,30,18
1746604288462,MATH 20D,A01,890011,Cheng; Hsiao-Bing,1,0,30,29
1746604288462,MATH 20D,A02,890012,Cheng; Hsiao-Bing,14,0,30,16
1746604288462,MATH 20D,B01,890016,Cheng; Hsiao-Bing,13,0,30,17
1746604288462,MATH 20D,B02,890017,Cheng; Hsiao-Bing,13,0,30,17
1746604290020,MATH 20E,A01,890026,Harel; Guershon,1,0,30,29
1746604290020,MATH 20E,A02,890029,Harel; Guershon,22,0,30,8
1746604290020,MATH 20E,B01,890033,Harel; Guershon,7,0,30,23
1746604290020,MATH 20E,B02,890101,Harel; Guershon,21,0,30,9
1746604291048,MATH 102,A01,890104,Staff,18,0,30,12
1746604291048,MATH 102,A02,890105,Staff,27,0,30,3
1746604292075,MATH 103B,A01,890116,Salehi Golsefidy; Alireza,3,0,30,27
1746604292075,MATH 103B,B01,890118,Staff,0,3,34,34
1746604293105,MATH 109,A01,890121,Aliabadi Sr.; Mohsen,0,0,30,30
1746604293105,MATH 109,B01,890124,Upadrashta; Pranav Kumar,18,0,30,12
1746604294130,MATH 120A,A01,890126,Eggers; John Dietrich,13,0,30,17
1746604295158,MATH 142B,A01,890128,Ioana; Adrian,19,0,30,11
1746604295158,MATH 142B,A02,890129,Ioana; Adrian,12,0,30,18
1746604296184,MATH 154,A01,890174,Staff,0,1,30,30
1746604296184,MATH 154,A02,890182,Staff,0,0,30,30
1746604297213,MATH 168A,A01,890197,Dumitriu; Ioana,21,0,35,14
1746604298242,MATH 170A,A01,890240,Nie; Jiawang,1,0,30,29
1746604298242,MATH 170A,A02,890241,Nie; Jiawang,11,0,30,19
1746604298242,MATH 170A,A03,890249,Nie; Jiawang,23,0,30,7
1746604299272,MATH 170B,A01,957891,Nag; Panchali,13,0,35,22
1746604301328,MATH 181A,A01,908025,Staff,0,3,35,35
1746604301328,MATH 181A,A02,960115,Staff,26,0,35,9
1746604302355,MATH 181B,A01,959874,Staff,24,0,30,6
1746604303380,MATH 193B,A01,890265,Staff,0,4,35,35
1746604304408,MGT 4,A01,890311,Anderson; John Charles,42,0,88,46
1746604305438,MGT 5,A00,907740,Staff,12,0,98,86
1746604306465,MGT 12,A00,890312,Lindenberger; Wade Douglas,67,0,98,31
1746604307490,MGT 16,A00,957883,Staff,78,0,98,20
1746604309548,MGT 45,A00,890314,Pecore; Joseph P.,45,0,98,53
1746604310576,MGT 71,A00,890315,Staff,0,12,98,98
1746604311602,MGT 100,A00,890316,Yavorsky; Daniel Ryan,44,0,98,54
1746604312626,MGT 103,A00,890317,Ehrich; Kristine R,73,0,98,25
1746604313655,MGT 105,A00,890356,Bates; Kenneth Walter,0,8,98,98
1746604314681,MGT 112,A00,890360,Ehrich; Kristine R,55,0,98,43
1746604315709,MGT 127R,A00,907732,Zhu; Kevin Xiaoguo,23,0,98,75
1746604316739,MGT 131B,A00,890361,Anderson; John Charles,59,0,98,39
1746604317769,MGT 137,A00,890362,Lindenberger; Wade Douglas,65,0,98,33
1746604318795,MGT 160,A00,890369,Johnson; Erik Barry,9,0,98,89
1746604320850,MGT 164,A00,890372,Zimmermann; Carsten,0,40,98,98
1746604321879,MGT 180,A00,890374,Bliss; Barbara Ann,11,0,98,87
1746604322916,MMW 15,A01,886414,Chang; Edmond Yi-Teh,0,12,28,28
1746604322916,MMW 15,A02,886415,Chang; Edmond Yi-Teh,0,8,28,28
1746604322916,MMW 15,A03,886416,Chang; Edmond Yi-Teh,0,9,28,28
1746604322916,MMW 15,A04,886417,Chang; Edmond Yi-Teh,0,8,28,28
1746604322916,MMW 15,B01,886419,Chang; Edmond Yi-Teh,0,7,28,28
1746604322916,MMW 15,B02,886420,Chang; Edmond Yi-Teh,0,7,28,28
1746604322916,MMW 15,B03,886421,Chang; Edmond Yi-Teh,0,7,28,28
1746604322916,MMW 15,B04,886422,Chang; Edmond Yi-Teh,0,8,28,28
1746604322916,MMW 15,C01,886424,Staff,0,9,28,28
1746604322916,MMW 15,C02,886425,Staff,0,8,28,28
1746604322916,MMW 15,C03,886426,Staff,0,8,28,28
1746604322916,MMW 15,C04,886427,Staff,0,8,28,28
1746604322916,MMW 15,C05,958038,Staff,0,8,28,28
1746604322916,MMW 15,C06,958039,Staff,0,7,28,28
1746604323944,MMW 15GS,A00,906910,Patterson; Patrick H.,4,0,28,24
1746604324985,MMW 122R,A01,886429,Rahimi; Babak,0,13,28,28
1746604324985,MMW 122R,A02,886430,Rahimi; Babak,0,12,28,28
1746604324985,MMW 122R,A03,958040,Rahimi; Babak,0,11,28,28
1746604326016,MUS 1A,A01,890937,Staff,2,0,25,23
1746604326016,MUS 1A,A02,891035,Staff,6,0,25,19
1746604326016,MUS 1A,C01,958912,Staff,24,0,25,1
1746604326016,MUS 1A,C02,958913,Staff,25,0,25,0
1746604328069,MUS 2AK,A00,957092,Ohnishi; Takae,15,0,15,0
1746604329097,MUS 4,A01,891044,Staff,0,0,25,25
1746604329097,MUS 4,A02,891045,Staff,22,0,25,3
1746604329097,MUS 4,B01,891048,Staff,17,0,25,8
1746604329097,MUS 4,B02,891050,Staff,25,0,25,0
1746604330129,MUS 5,A01,957506,Dubnov; Shlomo,0,0,25,25
1746604330129,MUS 5,A02,957622,Dubnov; Shlomo,12,0,25,13
1746604330129,MUS 5,A03,957623,Dubnov; Shlomo,20,0,25,5
1746604331157,MUS 6,A01,891053,Freitas Caetano; Marcelo,24,0,25,1
1746604331157,MUS 6,A02,891054,Freitas Caetano; Marcelo,23,0,25,2
1746604332193,MUS 7,A01,891081,Staff,0,0,25,25
1746604332193,MUS 7,A02,891082,Staff,3,0,25,22
1746604333222,MUS 8GS,A00,891118,Borgo; David Garcia,1,0,25,24
1746604334248,MUS 11,A01,891140,Staff,8,0,25,17
1746604334248,MUS 11,A02,891141,Staff,21,0,25,4
1746604335277,MUS 13,A01,891143,Staff,8,0,25,17
1746604335277,MUS 13,A02,891144,Staff,24,0,25,1
1746604336306,MUS 15,A01,891146,Staff,9,0,25,16
1746604336306,MUS 15,A02,891148,Staff,21,0,25,4
1746604336306,MUS 15,B01,891150,Staff,18,0,25,7
1746604336306,MUS 15,B02,891151,Staff,25,0,25,0
1746604337332,MUS 20,A01,891153,Staff,5,0,20,15
1746604337332,MUS 20,A02,891155,Staff,14,0,20,6
1746604338359,MUS 80,A00,891156,Staff,19,0,25,6
1746604338359,MUS 80,B00,891157,Staff,23,0,25,2
1746604339385,MUS 130,A00,891158,Ohnishi; Takae,35,0,35,0
1746604340414,MUS 150GS,A01,891160,Borgo; David Garcia,1,0,25,24
1746604341448,MUS 170,A01,891162,Freitas Caetano; Marcelo,20,0,25,5
1746604341448,MUS 170,A02,891164,Freitas Caetano; Marcelo,21,0,25,4
1746604342483,NANO 11,A00,886220,Vazquez Mena; Oscar,13,0,15,2
1746604343514,NANO 15,A01,886222,Drews; Aaron,4,0,7,3
1746604344543,NANO 104,A00,886224,Sirbuly; Donald,17,0,25,8
1746604345569,PH 40,A00,886528,Staff,23,0,40,17
1746604346596,PH 45,A01,886799,Staff,35,0,40,5
1746604347621,PH 110,A00,886802,Staff,0,6,40,40
1746604348648,PH 172,A00,906716,Staff,19,0,35,16
1746604349680,PH 191,A00,886803,Staff,6,0,40,34
1746604350707,PHIL 1,A00,889500,Staff,20,0,30,10
1746604351734,PHIL 10,A01,889549,Grush; Rick Scott,16,0,22,6
1746604351734,PHIL 10,A02,889551,Grush; Rick Scott,22,0,22,0
1746604352763,PHIL 28,A01,889559,Lamey; Andy M.,0,2,31,31
1746604352763,PHIL 28,A02,889561,Lamey; Andy M.,0,1,30,30
1746604352763,PHIL 28,A03,889572,Lamey; Andy M.,0,1,30,30
1746604353794,PHIL 35,A00,907839,Staff,13,0,15,2
1746604354823,PHIL 60,A00,889574,Staff,73,0,90,17
1746604355850,PHIL 101,A00,958004,Staff,12,0,15,3
1746604357907,PHIL 136,A00,889582,Fulkerson; Matthew Todd,26,0,45,19
1746604358940,PHIL 163,A01,889601,Staff,21,0,30,9
1746604358940,PHIL 163,B01,889606,Brandt; Reuven A,0,3,0,0
1746604359974,PHIL 164,A00,889610,Staff,16,0,30,14
1746604361000,PHIL 165,A00,889613,Staff,22,0,30,8
1746604362027,PHYS 1A,A00,886431,Staff,30,0,70,40
1746604363053,PHYS 1AL,001,886432,Tsai; Philbert S,0,1,30,30
1746604363053,PHYS 1AL,002,886436,Tsai; Philbert S,13,0,30,17
1746604364082,PHYS 1B,A00,886439,Staff,184,0,240,56
1746604365109,PHYS 1BL,001,886441,Tsai; Philbert S,0,4,30,30
1746604365109,PHYS 1BL,002,886444,Tsai; Philbert S,2,0,30,28
1746604366137,PHYS 1C,A00,896092,Arnold; Kam S,78,0,146,68
1746604367169,PHYS 1CL,001,886448,Tsai; Philbert S,0,0,30,30
1746604367169,PHYS 1CL,002,886449,Tsai; Philbert S,1,0,30,29
1746604367169,PHYS 1CL,003,886450,Tsai; Philbert S,16,0,30,14
1746604367169,PHYS 1CL,004,886451,Tsai; Philbert S,15,0,30,15
1746604368207,PHYS 2B,A01,886457,Staff,67,0,115,48
1746604369232,PHYS 2C,A01,886460,Shotwell; Brian,0,9,65,65
1746604370260,PHYS 2CL,A01,886467,Staff,0,4,28,28
1746604370260,PHYS 2CL,A02,886468,Staff,0,3,28,28
1746604371288,PHYS 2D,A01,886470,Staff,10,0,50,40
1746604372318,PHYS 4B,A01,886475,Grinstein; Benjamin,22,0,40,18
1746604373349,POLI 5,A00,891173,Desposato; Scott,7,0,25,18
1746604374376,POLI 5D,A01,891175,Staff,5,0,5,0
1746604374376,POLI 5D,B01,891178,Staff,5,0,5,0
1746604375412,POLI 11,A00,891179,Ferree; Karen E,0,0,35,35
1746604376441,POLI 12,A00,891180,Staff,15,0,30,15
1746604377471,POLI 27,A01,891182,Staff,11,0,75,64
1746604378499,POLI 30,A00,891183,Staff,8,0,50,42
1746604379532,POLI 100B,A00,891244,Staff,5,1,35,30
1746604380564,POLI 100I,A00,891247,Staff,7,0,30,23
1746604381593,POLI 104J,A00,891248,Nichter; Maysa,14,0,30,16
1746604382619,POLI 104U,A00,891250,Nichter; Maysa,1,0,30,29
1746604384680,POLI 110B,A00,891255,Wiens; David,19,0,25,6
1746604385706,POLI 112A,A00,891256,Wiens; David,6,0,25,19
1746604386735,POLI 114BR,A00,891261,Staff,19,0,30,11
1746604387760,POLI 117R,A00,891262,Forman; Fonna,0,6,50,50
1746604388786,POLI 118,A00,891264,Ingham; Sean,17,0,25,8
1746604389816,POLI 124A,A00,891265,Staff,18,0,20,2
1746604390842,POLI 125D,A00,891266,Nichter; Simeon C,2,0,25,23
1746604391869,POLI 126,A00,891268,Nichter; Simeon C,7,0,25,18
1746604392897,POLI 126AA,A00,891272,Staff,15,0,25,10
1746604393926,POLI 130AA,A00,891273,Staff,15,0,20,5
1746604394954,POLI 134AA,A00,891274,Staff,4,0,20,16
1746604397009,POLI 138,A00,891278,Staff,21,0,25,4
1746604398034,POLI 142K,A00,891280,Staff,10,0,25,15
1746604399063,POLI 142M,A00,891281,Gartzke; Erik,16,0,30,14
1746604400092,POLI 142P,A00,891284,Staff,20,0,30,10
1746604401121,POLI 143,A00,891285,Gartzke; Erik,12,0,30,18
1746604402146,POLI 153,A00,891286,Staff,19,0,20,1
1746604404202,POLI 175,A00,891290,Staff,15,0,20,5
1746604405229,PSYC 1,A00,890674,Steiner; Eric Tomas,0,11,45,45
1746604406257,PSYC 2,A00,890676,Albright; Thomas D,20,0,35,15
1746604407284,PSYC 3,A00,890679,Staff,17,0,20,3
1746604408316,PSYC 6,A00,959858,Staff,19,0,20,1
1746604409348,PSYC 60,A01,890684,Rickard; Timothy C.,0,6,45,45
1746604410374,PSYC 70,A01,890689,Geller; Emma Harlan,6,0,30,24
1746604411406,PSYC 71,A01,959860,Staff,21,0,25,4
1746604412439,PSYC 100,A00,890690,Lacefield; Katharine I,0,50,180,180
1746604413465,PSYC 102,A00,890695,Staff,18,0,40,22
1746604414491,PSYC 105,A00,890699,Geller; Emma Harlan,70,0,100,30
1746604415518,PSYC 106,A00,890701,Gorman; Michael R.,5,0,30,25
1746604416551,PSYC 108,A00,890704,Adrian; Julia Anna,0,29,50,50
1746604417578,PSYC 118,A01,890712,Staff,11,0,30,19
1746604418609,PSYC 124,A00,890716,Chapman; Eddie Nathaniel,25,0,60,35
1746604419634,PSYC 131,A00,890717,Anagnostaras; Stephan,0,7,80,80
1746604420668,PSYC 137,A00,890719,Winkielman; Piotr,0,11,30,30
1746604421700,PSYC 144,A00,890721,Adrian; Julia Anna,0,9,45,45
1746604422727,PSYC 162,A00,890805,Staff,0,2,75,75
1746604423754,PSYC 169,A00,890810,Staff,0,15,30,30
1746604424789,PSYC 172,A00,890814,Gorman; Michael R.,9,0,30,21
1746604425815,PSYC 181,A00,890818,Anagnostaras; Stephan,6,0,200,194
1746604426840,PSYC 184,A00,959861,Staff,160,0,175,15
1746604427866,PSYC 189,A00,890823,Staff,0,2,30,30
1746604428900,PSYC 191,A00,890884,Rickard; Timothy C.,0,11,35,35
1746604429928,PSYC 193,A00,890913,Staff,19,0,30,11
1746604429928,PSYC 193,B00,890914,Chapman; Eddie Nathaniel,24,0,30,6
1746604430957,PSYC 193L,A01,890918,Lowe; Angela Beth,20,0,30,10
1746604430957,PSYC 193L,B01,890921,Hurwitz; Ethan Scott,20,0,30,10
1746604430957,PSYC 193L,C01,890928,Staff,30,0,30,0
1746604431986,RELI 149,A00,886806,Rahimi; Babak,23,0,40,17
1746604433012,SE 9,A01,886814,Staff,7,0,20,13
1746604434040,SE 101B,A01,886816,Chadha; Mayank,3,0,35,32
1746604435069,SE 110B,A00,886818,Zhu; Qiang,4,0,75,71
1746604436095,SE 125,A01,886830,Staff,10,0,30,20
1746604437122,SE 130B,A01,886835,Staff,14,0,40,26
1746604438148,SE 131A,A01,886838,Krysl; Petr,34,0,55,21
1746604439176,SE 154,A00,886840,Staff,28,0,50,22
1746604440201,SE 164GS,A01,886849,Staff,6,0,20,14
1746604441229,SE 167GS,A01,886853,Staff,6,0,20,14
1746604442257,SIO 25,A01,890107,Staff,19,0,30,11
1746604443285,SIO 45,A00,890109,Cook; Geoffrey W,115,0,200,85
1746604444313,SIO 109R,A00,890110,Forman; Fonna,0,16,20,20
1746604445345,SIO 187,A01,890114,Kacev; David,15,0,40,25
1746604446430,SOCI 1,A01,890431,Thorpe; Charles Robert,14,0,30,16
1746604446430,SOCI 1,A02,890518,Thorpe; Charles Robert,30,0,30,0
1746604447458,SOCI 2,A01,957978,Staff,25,0,25,0
1746604447458,SOCI 2,A02,957979,Staff,23,0,25,2
1746604448485,SOCI 20,A01,890523,Calderon-Zaks; Michael Aar,21,0,30,9
1746604448485,SOCI 20,A02,890526,Calderon-Zaks; Michael Aar,29,0,30,1
1746604449511,SOCI 30,A01,890533,Pardo Guerra; Juan Pablo,37,0,40,3
1746604450542,SOCI 40,A01,890535,Staff,27,0,45,18
1746604451571,SOCI 104Q,A00,890559,Staff,17,0,30,13
1746604452603,SOCI 106,A00,890560,Arnal; Maud Marie Leonie,20,0,30,10
1746604453635,SOCI 110,A00,890567,Holkenbrink-Monk; Charlene,19,0,30,11
1746604454662,SOCI 112,A00,890568,Victoria Torres; Pablo,2,0,55,53
1746604455689,SOCI 115,A00,890597,Arnal; Maud Marie Leonie,28,0,45,17
1746604457744,SOCI 121,A00,890604,Pardo Guerra; Juan Pablo,38,0,45,7
1746604458777,SOCI 126,A01,890608,Staff,8,0,10,2
1746604459804,SOCI 127,A00,890609,Staff,18,0,30,12
1746604460833,SOCI 131,A00,890610,Thorpe; Charles Robert,37,0,45,8
1746604461860,SOCI 135,A00,890615,Payne; Christine Anna,14,0,45,31
1746604462890,SOCI 139,A00,890620,Staff,38,0,45,7
1746604463917,SOCI 148E,A00,890622,Calderon-Zaks; Michael Aar,36,0,45,9
1746604464947,SOCI 150,A00,890623,Kohler; Kristopher M.,31,0,45,14
1746604465978,SOCI 157,A00,890625,Jules-Rosette; Bennetta W.,18,0,20,2
1746604467007,SOCI 160,A00,890627,Payne; Christine Anna,21,0,45,24
1746604468035,SYN 1,A00,886855,Fish; Gwendolyn Anne,0,1,0,0
1746604468035,SYN 1,B00,906086,Fish; Gwendolyn Anne,0,2,0,2
1746604469064,SYN 2R,A00,886860,Staff,0,17,15,15
1746604469064,SYN 2R,B00,906106,Atkinson; Arthur Laird,0,16,15,15
1746604470097,SYN 100,A01,886866,Browne; Emily,0,28,20,20
1746604470097,SYN 100,B01,906128,Rock; Martin,0,4,20,20
1746604470097,SYN 100,C01,906140,Deavenport; James Cary,0,4,20,20
1746604470097,SYN 100,D01,907816,Deavenport; James Cary,0,5,20,20
1746604471136,TDAC 1,A00,890286,Walsh; Kim C.,7,0,20,13
1746604472166,TDAC 101,A00,890296,Basso; Beatrice,15,0,20,5
1746604473196,TDDE 131,A00,890297,Staff,47,0,50,3
1746604474220,TDDM 1,A00,890287,Weinberg; Sadie,25,0,30,5
1746604475245,TDGE 11,A00,890288,Fulton; Julia,138,0,200,62
1746604475245,TDGE 11,B00,890289,Castro; Robert Jess,184,0,200,16
1746604476275,TDGE 25,B00,957359,Walsh; Kim C.,5,0,20,15
1746604477306,TDGE 40,A01,890292,Power; Jade Yukana,26,0,30,4
1746604478361,TDGE 124,A00,890298,Havis; Allan,0,2,50,50
1746604479390,TDGE 131R,A00,890299,Burelle; Julie Sara Veronique,15,0,42,27
1746604480415,TDHT 101,A00,890300,Staff,10,0,20,10
1746604481450,TDHT 109,A01,890302,Anderson; Mysia Anyse,31,0,40,9
1746604482513,TDMV 1,A00,890293,Arcidiacono; Kristin,18,0,30,12
1746604483543,TDMV 2,A00,890294,Weinberg; Sadie,23,0,30,7
1746604484580,TDMV 3,A00,957878,Arcidiacono; Kristin,28,0,30,2
1746604486675,TDMV 138,A00,890304,Jun; Grace Shin Hae,25,0,40,15
1746604487700,TDMV 140,A00,890305,Corrales; Joseph Bernales,25,0,30,5
1746604488768,TDMV 142,A00,890307,Caligagan; Tony,32,0,40,8
1746604489797,TDMV 144,A00,890308,Camaya; Michelle Ann,25,0,30,5
1746604490826,TDPW 1,A00,890295,Stein; Deborah Isobel,3,0,20,17
1746604491853,USP 2,A01,890272,Lerner; Amy M,7,0,20,13
1746604492882,USP 3,A01,890274,Staff,12,0,30,18
1746604493911,USP 15,A01,890276,Sun; Feiyang,16,0,30,14
1746604494936,USP 25,A00,890277,Shenkman; Michael Thomas,18,0,25,7
1746604495967,USP 138,A00,890278,Staff,13,0,25,12
1746604496997,USP 143,A00,890279,Staff,21,0,70,49
1746604498025,USP 144,A00,890280,Chowdhury; Muhammed Zohir,16,0,30,14
1746604499050,USP 150,A00,890281,Boomhower; Matthew Charles,4,0,30,26
1746604500075,USP 151,A00,890282,Staff,16,0,20,4
1746604501099,USP 162,A00,890283,Andrews; Abigail Leslie,16,0,20,4
1746604502127,USP 168,A00,920477,Kwak; Nancy,0,0,5,5
1746604503153,USP 181,A00,890284,Staff,3,0,20,17
1746604504179,USP 191A,A00,890285,Staff,12,0,20,8
1746604505245,VIS 101,A00,886512,Staff,26,0,75,49
1746604506274,VIS 103,A00,886513,Cruz; Edwin Teddy,61,0,75,14
1746604507300,VIS 108,A00,886514,Staff,4,0,15,11
1746604508327,VIS 127P,A00,886515,Shen; Kuiyi,80,0,146,66
1746604509396,VIS 149,A00,886516,Yoldas; Pinar,0,0,15,15
1746604510421,VIS 164,A00,886526,Erdmann; Dean,19,0,22,3
1746604511450,VIS 194S,A00,886527,Staff,61,0,75,14
1746604512480,WCWP 10A,C00,886484,Martiniuk; Jill,12,0,15,3
1746604513507,WCWP 10B,A00,886490,Uriarte; Emma,0,0,15,15
1746604513507,WCWP 10B,B00,886491,Dhir; Simrita,8,0,15,7
1746604513507,WCWP 10B,C00,886492,Ornelas; Tricia,0,0,15,15
1746604514537,WCWP 100,A00,886494,Young; Mark T,0,6,15,15
1746604516698,AAS 10,A01,886199,Childs; Dennis R.,0,3,0,0
1746604517726,ANAR 104,A01,886940,Shtienberg; Gilad,27,0,30,3
1746604518757,ANAR 120,A00,886953,Staff,13,0,20,7
1746604519784,ANBI 148,A01,886955,Wilder; Linnea Lorene,30,0,40,10
1746604521846,ANSC 122,A00,886957,Staff,24,0,30,6
1746604522875,ANSC 150,A00,886958,Sloane; Julia Kathryn,2,0,15,13
1746604523906,ANSC 156,A00,886959,Jenkins; Janis A.,0,1,15,15
1746604524933,ANSC 180,A00,886960,Staff,11,0,17,6
1746604525962,ANSC 188,A00,886961,Jassal; Aftab,9,0,25,16
1746604526991,ANSC 190,A00,886962,Jassal; Aftab,14,0,25,11
1746604528019,ANSC 191,A00,886963,Staff,18,0,20,2
1746604529046,ANTH 3,A01,891689,Staff,17,0,20,3
1746604530100,ANTH 5,A00,886933,Semendeferi; Ekaterini,16,0,20,4
1746604531129,ANTH 10,A00,886934,Staff,0,12,30,30
1746604532156,ANTH 21,A01,886936,Staff,41,0,60,19
1746604533187,ANTH 23,A01,886938,Staff,92,0,100,8
1746604534216,ANTH 105,A00,886964,Stewart; Alexander B,84,0,100,16
1746604535255,ANTH 108,A00,886965,Pedersen; David,9,0,20,11
1746604536286,AWP 10,001,886147,Staff,0,0,0,0
1746604536286,AWP 10,002,886148,Staff,0,0,0,0
1746604536286,AWP 10,003,886149,Staff,0,0,0,0
1746604536286,AWP 10,004,886150,Staff,0,0,0,0
1746604536286,AWP 10,005,886151,Staff,0,0,0,0
1746604536286,AWP 10,006,886152,Staff,0,0,0,0
1746604536286,AWP 10,007,886153,Staff,0,0,0,0
1746604536286,AWP 10,008,886154,Staff,0,0,0,0
1746604536286,AWP 10,009,886155,Staff,0,0,0,0
1746604536286,AWP 10,010,886156,Staff,0,0,0,0
1746604536286,AWP 10,011,886158,Staff,0,0,0,0
1746604536286,AWP 10,012,886160,Staff,0,0,0,0
1746604536286,AWP 10,013,886161,Staff,0,0,0,0
1746604536286,AWP 10,014,886162,Staff,0,0,0,0
1746604536286,AWP 10,015,886163,Staff,0,0,0,0
1746604536286,AWP 10,016,886164,Staff,0,0,0,0
1746604536286,AWP 10,017,886165,Staff,0,0,0,0
1746604536286,AWP 10,018,886166,Staff,0,0,0,0
1746604536286,AWP 10,019,886168,Staff,0,0,0,0
1746604536286,AWP 10,020,886170,Staff,0,0,0,0
1746604536286,AWP 10,021,886172,Staff,0,0,0,0
1746604537329,AWP 10R,001,886173,Staff,0,1,0,0
1746604537329,AWP 10R,002,886174,Staff,0,1,0,0
1746604537329,AWP 10R,003,886175,Staff,0,0,0,0
1746604537329,AWP 10R,004,886176,Staff,0,0,0,0
1746604537329,AWP 10R,005,886177,Staff,0,0,0,0
1746604537329,AWP 10R,006,886178,Staff,0,0,0,0
1746604537329,AWP 10R,007,886179,Staff,0,0,0,0
1746604537329,AWP 10R,008,886181,Staff,0,0,0,0
1746604537329,AWP 10R,009,886182,Staff,0,0,0,0
1746604537329,AWP 10R,010,886183,Staff,0,0,0,0
1746604537329,AWP 10R,011,886184,Staff,0,0,0,0
1746604537329,AWP 10R,012,886185,Staff,0,0,0,0
1746604537329,AWP 10R,013,886186,Staff,0,0,0,0
1746604537329,AWP 10R,014,886187,Staff,0,0,0,0
1746604537329,AWP 10R,015,886188,Staff,0,0,0,0
1746604537329,AWP 10R,016,886189,Staff,0,0,0,0
1746604537329,AWP 10R,017,960532,Staff,0,0,0,0
1746604537329,AWP 10R,018,960533,Staff,0,0,0,0
1746604537329,AWP 10R,019,960534,Staff,0,0,0,0
1746604537329,AWP 10R,020,960538,Staff,0,0,0,0
1746604537329,AWP 10R,021,960540,Staff,0,0,0,0
1746604537329,AWP 10R,022,960541,Staff,0,0,0,0
1746604537329,AWP 10R,023,960542,Staff,0,0,0,0
1746604537329,AWP 10R,024,960544,Staff,0,0,0,0
1746604537329,AWP 10R,025,960545,Staff,0,0,0,0
1746604537329,AWP 10R,026,960548,Staff,0,0,0,0
1746604538358,AWP 102R,A00,886190,Staff,0,0,0,0
1746604538358,AWP 102R,B00,886191,Staff,0,0,0,0
1746604539383,BENG 100,A01,886193,Staff,17,0,30,13
1746604540413,BENG 122A,A01,886195,Hasty; Jeff M,13,0,30,17
1746604541439,BENG 166A,A00,886196,Sah; Robert Lie-Yuan,0,3,30,30
1746604542467,BENG 190,A00,958050,Khojah; Reem I,17,0,25,8
1746604543502,BIBC 102,A01,894320,Staff,0,1,46,46
1746604543502,BIBC 102,A02,894321,Staff,0,0,46,46
1746604543502,BIBC 102,A03,894344,Staff,6,0,46,40
1746604543502,BIBC 102,A04,894345,Staff,27,0,47,20
1746604544538,BICD 100R,A01,894365,Smith; Laurie,0,2,58,58
1746604544538,BICD 100R,A02,894366,Smith; Laurie,0,4,58,58
1746604544538,BICD 100R,A03,894367,Smith; Laurie,0,0,59,59
1746604544538,BICD 100R,A04,959869,Smith; Laurie,38,0,59,21
1746604545567,BICD 136,A01,894383,Gustafson-Brown; Cindy,14,0,50,36
1746604546598,BIEB 102,A01,894494,Butler; Shannon Rhey,51,0,130,79
1746604548662,BIEB 150,A01,894617,Wills; Christopher,3,0,20,17
1746604548662,BIEB 150,A02,894631,Wills; Christopher,3,0,20,17
1746604548662,BIEB 150,A03,894937,Wills; Christopher,3,0,20,17
1746604548662,BIEB 150,A04,894946,Wills; Christopher,5,0,20,15
1746604549690,BIEB 194,A00,906141,Kurle; Carolyn M.,5,0,20,15
1746604550762,BILD 1,A01,894154,Staff,3,0,19,16
1746604550762,BILD 1,A02,894155,Staff,14,0,19,5
1746604550762,BILD 1,A03,894160,Staff,13,0,19,6
1746604550762,BILD 1,A04,894161,Staff,15,0,18,3
1746604551792,BILD 2,A01,894168,Staff,0,0,50,50
1746604551792,BILD 2,A02,894169,Staff,0,0,50,50
1746604551792,BILD 2,A03,894179,Staff,0,0,50,50
1746604551792,BILD 2,A04,894203,Staff,22,0,50,28
1746604552824,BILD 3,A01,894213,Staff,23,0,31,8
1746604552824,BILD 3,A02,894214,Staff,26,0,31,5
1746604552824,BILD 3,A03,894235,Staff,28,0,31,3
1746604552824,BILD 3,A04,894236,Staff,28,0,32,4
1746604553859,BILD 4,A01,894253,Reuther; Keefe,5,0,24,19
1746604553859,BILD 4,A02,894258,Reuther; Keefe,16,0,24,8
1746604554888,BILD 5,A01,894276,Reuther; Keefe,34,0,50,16
1746604554888,BILD 5,A02,894277,Reuther; Keefe,45,0,50,5
1746604554888,BILD 5,A03,894290,Reuther; Keefe,44,0,50,6
1746604554888,BILD 5,A04,894291,Reuther; Keefe,48,0,50,2
1746604555917,BILD 24,A01,894297,Pirino; Giorgia,40,0,60,20
1746604556947,BIMM 100,B01,958915,Staff,71,0,100,29
1746604557976,BIMM 101,A01,895017,McDonnell; Lisa Marie,0,5,24,24
1746604557976,BIMM 101,A02,895018,McDonnell; Lisa Marie,0,5,24,24
1746604557976,BIMM 101,B01,895020,McDonnell; Lisa Marie,0,5,24,24
1746604557976,BIMM 101,B02,895021,McDonnell; Lisa Marie,0,4,24,24
1746604559006,BIMM 110,A01,895023,Staff,1,0,25,24
1746604559006,BIMM 110,A02,895024,Staff,9,0,25,16
1746604559006,BIMM 110,A03,895025,Staff,18,0,25,7
1746604559006,BIMM 110,A04,895031,Staff,20,0,25,5
1746604560050,BIMM 120,A01,895114,Gustafson-Brown; Cindy,14,0,28,14
1746604560050,BIMM 120,A02,895126,Gustafson-Brown; Cindy,21,0,27,6
1746604561088,BIPN 100,A01,895130,Yang; Mingyu,0,0,38,38
1746604561088,BIPN 100,A02,895131,Yang; Mingyu,31,0,38,7
1746604561088,BIPN 100,A03,895132,Yang; Mingyu,32,0,38,6
1746604561088,BIPN 100,A04,895133,Yang; Mingyu,27,0,36,9
1746604562115,BIPN 120,A01,895135,Cooke; James Edward,0,3,13,13
1746604562115,BIPN 120,A02,895136,Cooke; James Edward,0,1,13,13
1746604562115,BIPN 120,A03,895137,Cooke; James Edward,0,3,13,13
1746604562115,BIPN 120,A04,895156,Cooke; James Edward,0,2,11,11
1746604563151,BIPN 134,A01,895235,Cooke; James Edward,0,1,25,25
1746604563151,BIPN 134,A02,895237,Cooke; James Edward,0,0,25,25
1746604563151,BIPN 134,A03,895240,Cooke; James Edward,1,0,25,24
1746604563151,BIPN 134,A04,895270,Cooke; James Edward,20,0,25,5
1746604564182,BIPN 189,A00,892103,Staff,0,14,14,14
1746604566238,BISP 194,A00,958008,Staff,0,2,0,0
1746604567265,CAT 124,A01,922009,Staff,0,5,20,20
1746604568297,CAT 125R,A00,886390,Morales; Celeste Georgianna,0,4,20,20
1746604568297,CAT 125R,B00,886391,Irwin; Matthew Joseph,0,4,20,20
1746604568297,CAT 125R,C00,886392,Smith; Lauryn Alissa,0,2,20,20
1746604568297,CAT 125R,D00,886393,Vanderschuit; Maya Alysia,0,3,20,20
1746604568297,CAT 125R,E00,886394,Marchisotto; Jennifer Anne,0,3,20,20
1746604569333,CENG 15,A01,886218,Drews; Aaron,3,0,8,5
1746604570364,CENG 113,A00,886219,Opatkiewicz; Justin Paul,15,0,25,10
1746604571390,CGS 101,A00,887044,Staff,7,0,20,13
1746604572431,CGS 105,A01,887046,Staff,14,0,25,11
1746604573467,CGS 112,A00,887047,Cuong; Marisol,12,0,15,3
1746604574497,CGS 113,A00,887048,Staff,23,0,30,7
1746604575523,CGS 120,A00,887049,Staff,9,0,17,8
1746604576560,CHEM 6A,A01,886336,Lam; Tin Yiu,38,0,50,12
1746604576560,CHEM 6A,A02,886338,Lam; Tin Yiu,37,0,50,13
1746604577586,CHEM 6B,A01,886341,Hopkins; Patrycja Anna,16,0,50,34
1746604577586,CHEM 6B,A02,886343,Hopkins; Patrycja Anna,42,0,50,8
1746604578613,CHEM 6C,A01,886346,Albizati; Kim F.,0,2,50,50
1746604578613,CHEM 6C,A02,886348,Albizati; Kim F.,24,0,50,26
1746604579641,CHEM 40A,A01,886352,Klosterman; Jeremy K,65,0,100,35
1746604580675,CHEM 40B,A01,886356,Klosterman; Jeremy K,0,24,100,100
1746604581712,CHEM 41B,A01,886360,Theodorakis; Emmanuel,25,0,50,25
1746604581712,CHEM 41B,A02,886362,Theodorakis; Emmanuel,47,0,50,3
1746604582739,CHIN 165A,A00,886382,Xu; Li,18,0,20,2
1746604583766,CLAS 120,A00,886387,Myerston Santana; Jacobo,33,0,40,7
1746604584794,COGS 9,A01,886967,Shannon; Kyle Michael,42,0,60,18
1746604585827,COGS 11,A01,886969,Staff,9,0,30,21
1746604586857,COGS 14A,A01,886971,Staff,5,0,60,55
1746604587896,COGS 14B,A01,886973,Hoffman; Drew Ellen,4,0,60,56
1746604588929,COGS 18,A01,886975,Morgan; Eric,34,0,60,26
1746604589963,COGS 20,A01,886977,Staff,3,0,8,5
1746604589963,COGS 20,A02,886978,Staff,5,0,7,2
1746604590998,COGS 100,A01,907783,Staff,0,1,30,30
1746604592026,COGS 101B,A01,886980,Staff,0,4,48,48
1746604593056,COGS 101C,A01,886982,Delgado; Tania,0,5,44,44
1746604594081,COGS 102A,A01,886984,Johnson; Christine M.,3,0,30,27
1746604595109,COGS 118B,A01,886986,Staff,0,4,88,88
1746604596141,COGS 150,A01,886988,Bergen; Benjamin,22,0,50,28
1746604597169,COGS 153,A00,886989,Delgado; Tania,0,3,41,41
1746604598199,COGS 186,A01,886991,Staff,0,0,32,32
1746604599226,COGS 187A,A01,886993,Boyle; Mary E. T.,7,0,30,23
1746604600252,COGS 189,A00,886994,Staff,0,1,30,30
1746604601283,COMM 10,A01,886996,Staff,0,0,20,21
1746604601283,COMM 10,A02,886997,Staff,10,0,20,10
1746604601283,COMM 10,A03,959845,Staff,19,0,20,1
1746604602311,COMM 20,A01,886999,Leuning; Grant Maurstad,24,0,40,16
1746604604371,COMM 100A,A01,887002,Staff,0,0,20,25
1746604604371,COMM 100A,A02,887003,Staff,5,0,20,15
1746604605401,COMM 100B,A01,887005,Staff,0,8,20,24
1746604606426,COMM 106D,A00,887006,Staff,14,0,40,26
1746604607454,COMM 110G,A00,887007,Whitworth-Smith; Andrew C,12,0,40,28
1746604608482,COMM 111B,A00,887008,Staff,31,0,40,9
1746604609509,COMM 113T,A00,887009,Abuelhiga; Soraya Jill,28,0,40,12
1746604609509,COMM 113T,B00,906733,Staff,39,0,40,1
1746604610536,COMM 145,A00,887010,Staff,13,0,40,27
1746604611568,COMM 146,A00,887054,Staff,32,0,40,8
1746604612593,COMM 190,A00,887012,Staff,8,0,23,15
1746604613621,CSE 8A,A50,887015,Cao; Yingjun,56,0,85,29
1746604614657,CSE 11,A01,887017,Cao; Yingjun,11,0,70,59
1746604615688,CSE 20,A01,887019,Staff,30,0,50,20
1746604616717,CSE 21,A01,887021,Staff,79,0,100,21
1746604616717,CSE 21,B01,892583,Braun; Oliver,45,0,50,5
1746604617745,CSE 30,A01,887025,Eldon; John,142,0,200,58
1746604618775,CSE 100,A01,887027,Staff,26,0,50,24
1746604618775,CSE 100,A02,887028,Staff,42,0,50,8
1746604619802,CSE 101,A01,887030,Braun; Oliver,74,0,100,26
1746604619802,CSE 101,B01,887032,Jones; Miles E,0,3,50,50
1746604619802,CSE 101,B02,887033,Jones; Miles E,0,2,50,50
1746604620834,CSE 105,A01,908084,Jones; Miles E,32,0,50,18
1746604620834,CSE 105,A02,908087,Jones; Miles E,31,0,50,19
1746604621865,CSE 135,A01,887035,Powell; Thomas Allan,0,5,50,50
1746604622894,CSE 142,A01,887037,Staff,7,0,60,53
1746604623923,CSE 142L,A01,887039,Staff,34,0,60,26
1746604624950,CSE 151A,A01,887041,Solares; Edwin A,47,0,100,53
1746604625977,CSE 175,A01,887043,Kumar; Rakesh,30,0,30,0
1746604627011,CSS 1,A01,886389,Staff,0,1,40,40
1746604628045,DSC 30,A01,908097,Liao; Soohyun Nam,47,0,75,28
1746604629072,DSC 40A,A01,908099,Shannon; Kyle Michael,30,0,50,20
1746604630099,DSC 40B,A01,908112,Staff,15,0,50,35
1746604631191,DSC 80,A01,908116,Staff,19,0,60,41
1746604632219,DSC 197,001,956863,Eldridge; Justin Matthew,9999,0,9999,0
1746604633248,ECE 5,A01,886400,Morris; Karcher William,1,0,6,5
1746604633248,ECE 5,A02,886401,Morris; Karcher William,3,0,6,3
1746604634277,ECE 148,A01,886403,Silberman; Jack,0,14,14,14
1746604635304,ECON 1,A01,887265,Crane; Meredith Helen,11,0,70,59
1746604635304,ECON 1,B01,887268,Staff,42,0,50,8
1746604636329,ECON 2,A01,887273,Crane; Meredith Helen,54,0,70,16
1746604637359,ECON 3,A01,887279,Rondina; Giacomo,31,0,70,39
1746604638388,ECON 4,A01,887282,Anderson; John Charles,0,2,10,10
1746604639418,ECON 5,A01,887285,Staff,34,0,45,11
1746604639418,ECON 5,B01,887292,Staff,41,0,45,4
1746604640457,ECON 100A,A01,887337,Newhouse; Herbert S,54,0,70,16
1746604640457,ECON 100A,B01,887349,Staff,45,0,50,5
1746604642004,ECON 100B,A01,887361,Du; Songzi,29,0,70,41
1746604643035,ECON 100C,A01,887445,Newhouse; Herbert S,59,0,70,11
1746604644069,ECON 105,A00,887488,Vespa; Emanuel Ignacio,23,0,35,12
1746604645109,ECON 109,A01,887506,Shishkin; Denis,28,0,35,7
1746604646146,ECON 110A,A01,887568,Alon; Titan Michael,0,2,35,35
1746604646146,ECON 110A,B01,907601,Alon; Titan Michael,20,0,35,15
1746604647181,ECON 110B,A01,887598,Levkoff; Steven B.,0,24,70,70
1746604648212,ECON 112,A00,887599,Rondina; Giacomo,19,0,35,16
1746604649247,ECON 120A,A01,887603,Dai; Yinlin,36,0,70,34
1746604650285,ECON 120C,A01,887608,Sun; Yixiao,0,1,35,35
1746604650285,ECON 120C,B01,887614,Sun; Yixiao,0,0,35,35
1746604651319,ECON 138,A00,887621,Bharadwaj; Prashant,0,21,20,20
1746604652352,ECON 144,A00,958007,Squires; Dale E,11,0,35,24
1746604653378,ECON 171,A01,907666,Staff,18,0,35,17
1746604654404,ECON 175,A00,887626,Wu; Pak Yeung,22,0,35,13
1746604655430,ECON 190,A00,887640,Vespa; Emanuel Ignacio,22,0,35,13
1746604656466,EDS 25,A01,888197,Staff,0,0,0,0
1746604656466,EDS 25,A02,888209,Staff,0,0,0,0
1746604656466,EDS 25,A03,888210,Staff,0,0,0,0
1746604656466,EDS 25,A04,888212,Staff,0,0,0,0
1746604656466,EDS 25,A05,888213,Staff,0,0,0,0
1746604656466,EDS 25,A06,888214,Staff,0,0,0,0
1746604656466,EDS 25,A07,888235,Staff,0,2,0,0
1746604656466,EDS 25,A08,888236,Staff,0,0,0,0
1746604656466,EDS 25,A09,888240,Staff,0,0,0,0
1746604656466,EDS 25,A10,888244,Staff,0,0,0,0
1746604656466,EDS 25,B01,888273,Staff,0,0,0,0
1746604656466,EDS 25,B02,888285,Staff,0,0,0,0
1746604656466,EDS 25,B03,888423,Staff,0,0,0,1
1746604656466,EDS 25,B04,888432,Staff,0,0,0,0
1746604656466,EDS 25,B05,888433,Staff,0,0,0,0
1746604656466,EDS 25,B06,888467,Staff,0,0,0,0
1746604656466,EDS 25,B07,888468,Staff,0,0,0,0
1746604656466,EDS 25,B08,888479,Staff,0,0,0,0
1746604656466,EDS 25,B09,888484,Staff,0,0,0,0
1746604656466,EDS 25,B10,888487,Staff,0,0,0,0
1746604657497,EDS 38,A01,907700,Choi; Bailey Miyeon,30,0,30,0
1746604658523,EDS 112,A01,888601,Chapman; Thandeka K,12,0,40,28
1746604659550,EDS 115,A00,888697,Mendez; Kathrina Mendoza,10,0,30,20
1746604660583,EDS 116,A01,888893,Staff,33,0,40,7
1746604662642,EDS 124AR,A00,889133,Staff,29,0,50,21
1746604662642,EDS 124AR,B00,907471,Simon; Elizabeth A,37,0,50,13
1746604663672,EDS 124BR,A00,889134,Simon; Elizabeth A,44,0,100,56
1746604664696,EDS 125,A00,889135,Staff,25,0,30,5
1746604665726,EDS 126,A01,889138,Staff,35,0,40,5
1746604666763,EDS 164R,A01,889142,Wishard Guerra; Alison G.,32,0,50,18
1746604667815,ENG 30,A01,886396,Staff,0,0,0,0
1746604667815,ENG 30,B01,886398,Staff,0,0,0,0
1746604668845,ENVR 102,A00,906150,Montejo; Carolina,23,0,25,2
1746604669874,ETHN 103A,A00,887236,Man; Simeon S,0,2,0,0
1746604670901,ETHN 113,A00,887239,Staff,16,0,30,14
1746604671927,ETHN 116,A00,887240,Staff,16,0,25,9
1746604672955,ETHN 117,A00,887241,Choi; Esther Min,28,0,30,2
1746604673980,ETHN 118,A00,887243,Staff,24,0,30,6
1746604675006,ETHN 127,A00,887248,Cuong; Marisol,11,0,15,4
1746604676032,ETHN 139,A00,887250,Staff,7,0,10,3
1746604677062,ETHN 142,A00,887252,Staff,9,0,30,21
1746604678087,ETHN 161,A00,887253,Browne; Errol Tsekani,24,0,30,6
1746604679121,ETHN 163FR,A00,887255,Burelle; Julie Sara Veronique,0,0,5,5
1746604680147,GLBH 20,A00,889149,Elwardani; Nile Regina,8,0,42,34
1746604682205,GLBH 111,A01,889152,Burgos; Jose L.,17,0,17,0
1746604683236,GLBH 150,A00,889181,Sloane; Julia Kathryn,0,5,15,15
1746604685290,HDS 60,A01,886406,Warstadt; Melissa Fawn,72,0,80,8
1746604686315,HIAF 111,A00,889324,Gyamfi; Bright,25,0,32,7
1746604687345,HIEA 131,A00,889328,Staff,15,0,32,17
1746604688370,HIEA 144,A00,889333,Henry; Todd A.,26,0,32,6
1746604689399,HIEA 154,A00,889336,Henry; Todd A.,24,0,32,8
1746604690427,HIEU 106,A00,889339,Staff,22,0,32,10
1746604692483,HIEU 114,A00,889340,Staff,4,0,32,28
1746604693507,HIEU 135GS,A00,889342,Patterson; Patrick H.,0,0,1,24
1746604694541,HIEU 137,A00,889343,Edington; Claire Ellen,10,0,25,15
1746604695566,HIEU 148,A00,889345,Staff,14,0,32,18
1746604696596,HIEU 154,A00,889346,Biess; Frank Peter,21,0,32,11
1746604697627,HILA 102,A00,889351,Staff,12,0,32,20
1746604698657,HILD 2A,A01,889221,Lewandoski; Julia Mavis,0,8,32,32
1746604699689,HILD 7B,A01,889225,Man; Simeon S,0,12,32,32
1746604700714,HILD 7C,A01,889288,Alvarez; Luis A,0,14,32,32
1746604701744,HILD 30,A01,889323,Staff,0,5,32,32
1746604703804,HISC 119,A00,889383,Golan; Tal,20,0,32,12
1746604704831,HIUS 103,A00,889384,Man; Simeon S,0,0,32,32
1746604705862,HIUS 117,A00,919797,Kwak; Nancy,18,0,32,14
1746604706888,HIUS 142A,A00,919788,Staff,22,0,32,10
1746604708945,HIUS 149,A00,889386,Gyamfi; Bright,26,0,32,6
1746604709987,HIUS 155,A00,889387,Alvarez; Luis A,15,0,32,17
1746604711012,HUM 3,A01,886499,Caldwell; Michael Alan,19,0,50,31
1746604712038,HUM 3GS,A00,886500,Rodriguez; Bretton Sigfred,0,0,0,28
1746604713064,HUM 3R,A01,886502,Markman; Kristina,0,36,50,50
1746604714089,HUM 4,A01,886504,Crum; Matthew Stephen,23,0,50,27
1746604714089,HUM 4,B01,886506,West; Geoffrey Scott,17,0,50,33
1746604715116,HUM 4GS,A00,886507,Staff,0,0,0,19
1746604716144,HUM 5,A01,886509,Staff,31,0,50,19
1746604717191,HUM 5R,A01,886511,Zavodny; Tatiana Sophia,0,39,50,50
1746604718219,JAPN 180,A00,886407,Staff,16,0,40,24
1746604719247,LATI 50,A01,886409,Martin-Cabrera; Luis,3,0,22,19
1746604719247,LATI 50,A02,886410,Martin-Cabrera; Luis,19,0,22,3
1746604719247,LATI 50,A03,886411,Martin-Cabrera; Luis,21,0,22,1
1746604719247,LATI 50,A04,886412,Martin-Cabrera; Luis,8,0,22,14
1746604720273,LAWS 101,A00,907664,Staff,28,0,60,32
1746604721301,LIAB 1A,A00,889388,Saab; Dima,17,0,20,3
1746604722331,LIAB 1AX,A00,889389,El Cheddadi; Youniss,18,0,20,2
1746604723356,LIFR 1C,A00,889391,Van Moer; Vinciane G,8,0,20,12
1746604724387,LIFR 1CX,A00,889392,Van Moer; Vinciane G,7,0,20,13
1746604725414,LIFR 1D,A00,889393,Van Moer; Vinciane G,7,0,20,13
1746604726439,LIFR 1DX,A00,889394,Van Moer; Vinciane G,8,0,20,12
1746604727465,LIGN 7,A00,886923,Staff,25,0,50,25
1746604728497,LIGN 17,A00,886924,Kehler; Andrew Scott,126,0,150,24
1746604729523,LTAM 110,A00,889395,Staff,15,0,30,15
1746604730548,LTAM 110GS,A00,958010,Rodriguez; Bretton Sigfred,0,0,0,28
1746604731572,LTCH 101,A00,889397,Staff,23,0,25,2
1746604732597,LTCS 130,A00,889398,Staff,23,0,25,2
1746604733623,LTEA 138,A00,889399,Staff,24,0,40,16
1746604734648,LTEN 149,A00,889400,Wesling; Megan E.,0,3,25,25
1746604735678,LTEN 169,A00,889401,Staff,20,0,25,5
1746604736704,LTEN 180,A00,889402,Staff,10,0,15,5
1746604737734,LTEN 181,A00,889403,Staff,21,0,25,4
1746604738762,LTWL 100,A00,889404,Myerston Santana; Jacobo,2,0,25,23
1746604739794,LTWL 180GS,A00,889405,Staff,0,0,20,20
1746604740819,LTWL 181,A00,889406,Staff,16,0,25,9
1746604741847,LTWL 184,A00,889475,Mukherjee; Silpa,22,0,25,3
1746604742878,LTWR 102C,A00,889486,Staff,29,0,30,1
1746604743905,LTWR 115W,A00,889491,Staff,0,2,15,15
1746604744934,MAE 8,A01,886905,Staff,0,2,0,0
1746604745968,MAE 11,A00,886906,Bandaru; Prabhakar,0,7,50,50
1746604746994,MAE 20,A00,886907,Evdokimenko; Ekaterina,43,0,70,27
1746604748021,MAE 30B,A00,886909,Ghazinejad; Maziar,25,0,45,20
1746604749047,MAE 101B,A00,886910,Saintillan; David,30,0,45,15
1746604750074,MAE 105,A00,886911,Bandaru; Prabhakar,18,0,50,32
1746604751101,MAE 107,B00,958024,Staff,7,0,50,43
1746604752127,MAE 143B,A00,886913,Bewley; Thomas R,2,0,40,38
1746604753154,MAE 148,A01,886915,Silberman; Jack,0,3,14,14
1746604754180,MAE 160,A00,886916,Evdokimenko; Ekaterina,30,0,60,30
1746604755210,MATH 3C,A01,889681,Staff,0,2,30,30
1746604755210,MATH 3C,A02,960048,Staff,23,0,30,7
1746604756243,MATH 10A,A01,889760,Staff,26,0,30,4
1746604756243,MATH 10A,A02,889783,Staff,29,0,30,1
1746604757288,MATH 10B,A01,889785,Verstraete; Jacques Allan,1,0,35,34
1746604757288,MATH 10B,A02,889795,Verstraete; Jacques Allan,4,0,35,31
1746604757288,MATH 10B,B01,889797,Verstraete; Jacques Allan,3,0,35,32
1746604757288,MATH 10B,B02,889828,Verstraete; Jacques Allan,3,0,35,32
1746604758321,MATH 10C,A01,889849,Habib; Yousaf,8,0,30,22
1746604758321,MATH 10C,A02,889852,Habib; Yousaf,14,0,30,16
1746604758321,MATH 10C,A03,889853,Habib; Yousaf,22,0,30,8
1746604758321,MATH 10C,A04,889858,Habib; Yousaf,20,0,30,10
1746604758321,MATH 10C,B01,889861,Staff,1,0,30,29
1746604758321,MATH 10C,B02,889862,Staff,24,0,30,6
1746604758321,MATH 10C,B03,889863,Staff,27,0,30,3
1746604758321,MATH 10C,B04,889967,Staff,23,0,30,7
1746604759356,MATH 18,A01,889974,Staff,6,0,30,24
1746604759356,MATH 18,A02,889977,Staff,20,0,30,10
1746604759356,MATH 18,B01,889984,Hardiman; Liam,20,0,30,10
1746604759356,MATH 18,B02,889985,Hardiman; Liam,25,0,30,5
1746604760384,MATH 20A,A01,889990,Suk; Andrew Hoon,30,0,35,5
1746604761412,MATH 20B,A01,889993,Ohm; Ko Woon,21,0,30,9
1746604761412,MATH 20B,A02,889994,Ohm; Ko Woon,30,0,30,0
1746604761412,MATH 20B,B01,889996,Ohm; Ko Woon,22,0,30,8
1746604761412,MATH 20B,B02,889997,Ohm; Ko Woon,23,0,30,7
1746604762442,MATH 20C,A01,889999,Hammock; Frances H,17,0,30,13
1746604762442,MATH 20C,A02,890003,Hammock; Frances H,23,0,30,7
1746604762442,MATH 20C,B01,890006,Hammock; Frances H,2,0,30,28
1746604762442,MATH 20C,B02,890007,Hammock; Frances H,11,0,30,19
1746604763468,MATH 20D,A01,890011,Cheng; Hsiao-Bing,1,0,30,29
1746604763468,MATH 20D,A02,890012,Cheng; Hsiao-Bing,14,0,30,16
1746604763468,MATH 20D,B01,890016,Cheng; Hsiao-Bing,13,0,30,17
1746604763468,MATH 20D,B02,890017,Cheng; Hsiao-Bing,13,0,30,17
1746604764510,MATH 20E,A01,890026,Harel; Guershon,1,0,30,29
1746604764510,MATH 20E,A02,890029,Harel; Guershon,22,0,30,8
1746604764510,MATH 20E,B01,890033,Harel; Guershon,7,0,30,23
1746604764510,MATH 20E,B02,890101,Harel; Guershon,21,0,30,9
1746604765534,MATH 102,A01,890104,Staff,18,0,30,12
1746604765534,MATH 102,A02,890105,Staff,27,0,30,3
1746604766561,MATH 103B,A01,890116,Salehi Golsefidy; Alireza,3,0,30,27
1746604766561,MATH 103B,B01,890118,Staff,0,3,34,34
1746604767589,MATH 109,A01,890121,Aliabadi Sr.; Mohsen,0,0,30,30
1746604767589,MATH 109,B01,890124,Upadrashta; Pranav Kumar,18,0,30,12
1746604768620,MATH 120A,A01,890126,Eggers; John Dietrich,13,0,30,17
1746604769647,MATH 142B,A01,890128,Ioana; Adrian,19,0,30,11
1746604769647,MATH 142B,A02,890129,Ioana; Adrian,12,0,30,18
1746604770692,MATH 154,A01,890174,Staff,0,1,30,30
1746604770692,MATH 154,A02,890182,Staff,0,0,30,30
1746604771717,MATH 168A,A01,890197,Dumitriu; Ioana,21,0,35,14
1746604772745,MATH 170A,A01,890240,Nie; Jiawang,1,0,30,29
1746604772745,MATH 170A,A02,890241,Nie; Jiawang,11,0,30,19
1746604772745,MATH 170A,A03,890249,Nie; Jiawang,23,0,30,7
1746604773771,MATH 170B,A01,957891,Nag; Panchali,13,0,35,22
1746604775834,MATH 181A,A01,908025,Staff,0,3,35,35
1746604775834,MATH 181A,A02,960115,Staff,26,0,35,9
1746604776870,MATH 181B,A01,959874,Staff,24,0,30,6
1746604777899,MATH 193B,A01,890265,Staff,0,4,35,35
1746604778934,MGT 4,A01,890311,Anderson; John Charles,42,0,88,46
1746604779961,MGT 5,A00,907740,Staff,12,0,98,86
1746604780989,MGT 12,A00,890312,Lindenberger; Wade Douglas,67,0,98,31
1746604782015,MGT 16,A00,957883,Staff,78,0,98,20
1746604784076,MGT 45,A00,890314,Pecore; Joseph P.,45,0,98,53
1746604785111,MGT 71,A00,890315,Staff,0,12,98,98
1746604786142,MGT 100,A00,890316,Yavorsky; Daniel Ryan,44,0,98,54
1746604787171,MGT 103,A00,890317,Ehrich; Kristine R,73,0,98,25
1746604788197,MGT 105,A00,890356,Bates; Kenneth Walter,0,8,98,98
1746604789247,MGT 112,A00,890360,Ehrich; Kristine R,55,0,98,43
1746604790280,MGT 127R,A00,907732,Zhu; Kevin Xiaoguo,23,0,98,75
1746604791306,MGT 131B,A00,890361,Anderson; John Charles,59,0,98,39
1746604792335,MGT 137,A00,890362,Lindenberger; Wade Douglas,65,0,98,33
1746604793360,MGT 160,A00,890369,Johnson; Erik Barry,9,0,98,89
1746604795413,MGT 164,A00,890372,Zimmermann; Carsten,0,40,98,98
1746604796441,MGT 180,A00,890374,Bliss; Barbara Ann,11,0,98,87
1746604797469,MMW 15,A01,886414,Chang; Edmond Yi-Teh,0,12,28,28
1746604797469,MMW 15,A02,886415,Chang; Edmond Yi-Teh,0,8,28,28
1746604797469,MMW 15,A03,886416,Chang; Edmond Yi-Teh,0,9,28,28
1746604797469,MMW 15,A04,886417,Chang; Edmond Yi-Teh,0,8,28,28
1746604797469,MMW 15,B01,886419,Chang; Edmond Yi-Teh,0,7,28,28
1746604797469,MMW 15,B02,886420,Chang; Edmond Yi-Teh,0,7,28,28
1746604797469,MMW 15,B03,886421,Chang; Edmond Yi-Teh,0,7,28,28
1746604797469,MMW 15,B04,886422,Chang; Edmond Yi-Teh,0,8,28,28
1746604797469,MMW 15,C01,886424,Staff,0,9,28,28
1746604797469,MMW 15,C02,886425,Staff,0,8,28,28
1746604797469,MMW 15,C03,886426,Staff,0,8,28,28
1746604797469,MMW 15,C04,886427,Staff,0,8,28,28
1746604797469,MMW 15,C05,958038,Staff,0,8,28,28
1746604797469,MMW 15,C06,958039,Staff,0,7,28,28
1746604798502,MMW 15GS,A00,906910,Patterson; Patrick H.,4,0,28,24
1746604799533,MMW 122R,A01,886429,Rahimi; Babak,0,13,28,28
1746604799533,MMW 122R,A02,886430,Rahimi; Babak,0,12,28,28
1746604799533,MMW 122R,A03,958040,Rahimi; Babak,0,11,28,28
1746604800573,MUS 1A,A01,890937,Staff,2,0,25,23
1746604800573,MUS 1A,A02,891035,Staff,6,0,25,19
1746604800573,MUS 1A,C01,958912,Staff,24,0,25,1
1746604800573,MUS 1A,C02,958913,Staff,25,0,25,0
1746604802683,MUS 2AK,A00,957092,Ohnishi; Takae,15,0,15,0
1746604803717,MUS 4,A01,891044,Staff,0,0,25,25
1746604803717,MUS 4,A02,891045,Staff,22,0,25,3
1746604803717,MUS 4,B01,891048,Staff,17,0,25,8
1746604803717,MUS 4,B02,891050,Staff,25,0,25,0
1746604804766,MUS 5,A01,957506,Dubnov; Shlomo,0,0,25,25
1746604804766,MUS 5,A02,957622,Dubnov; Shlomo,12,0,25,13
1746604804766,MUS 5,A03,957623,Dubnov; Shlomo,20,0,25,5
1746604805791,MUS 6,A01,891053,Freitas Caetano; Marcelo,24,0,25,1
1746604805791,MUS 6,A02,891054,Freitas Caetano; Marcelo,23,0,25,2
1746604806822,MUS 7,A01,891081,Staff,0,0,25,25
1746604806822,MUS 7,A02,891082,Staff,3,0,25,22
1746604807851,MUS 8GS,A00,891118,Borgo; David Garcia,1,0,25,24
1746604808883,MUS 11,A01,891140,Staff,8,0,25,17
1746604808883,MUS 11,A02,891141,Staff,21,0,25,4
1746604809909,MUS 13,A01,891143,Staff,8,0,25,17
1746604809909,MUS 13,A02,891144,Staff,24,0,25,1
1746604810941,MUS 15,A01,891146,Staff,9,0,25,16
1746604810941,MUS 15,A02,891148,Staff,21,0,25,4
1746604810941,MUS 15,B01,891150,Staff,18,0,25,7
1746604810941,MUS 15,B02,891151,Staff,25,0,25,0
1746604811968,MUS 20,A01,891153,Staff,5,0,20,15
1746604811968,MUS 20,A02,891155,Staff,14,0,20,6
1746604812995,MUS 80,A00,891156,Staff,19,0,25,6
1746604812995,MUS 80,B00,891157,Staff,23,0,25,2
1746604814035,MUS 130,A00,891158,Ohnishi; Takae,35,0,35,0
1746604815061,MUS 150GS,A01,891160,Borgo; David Garcia,1,0,25,24
1746604816098,MUS 170,A01,891162,Freitas Caetano; Marcelo,20,0,25,5
1746604816098,MUS 170,A02,891164,Freitas Caetano; Marcelo,21,0,25,4
1746604817139,NANO 11,A00,886220,Vazquez Mena; Oscar,13,0,15,2
1746604818169,NANO 15,A01,886222,Drews; Aaron,4,0,7,3
1746604819205,NANO 104,A00,886224,Sirbuly; Donald,17,0,25,8
1746604820232,PH 40,A00,886528,Staff,23,0,40,17
1746604821260,PH 45,A01,886799,Staff,35,0,40,5
1746604822302,PH 110,A00,886802,Staff,0,6,40,40
1746604823343,PH 172,A00,906716,Staff,19,0,35,16
1746604824372,PH 191,A00,886803,Staff,6,0,40,34
1746604825410,PHIL 1,A00,889500,Staff,20,0,30,10
1746604826448,PHIL 10,A01,889549,Grush; Rick Scott,16,0,22,6
1746604826448,PHIL 10,A02,889551,Grush; Rick Scott,22,0,22,0
1746604827502,PHIL 28,A01,889559,Lamey; Andy M.,0,2,31,31
1746604827502,PHIL 28,A02,889561,Lamey; Andy M.,0,1,30,30
1746604827502,PHIL 28,A03,889572,Lamey; Andy M.,0,1,30,30
1746604828534,PHIL 35,A00,907839,Staff,13,0,15,2
1746604829565,PHIL 60,A00,889574,Staff,73,0,90,17
1746604830602,PHIL 101,A00,958004,Staff,12,0,15,3
1746604832657,PHIL 136,A00,889582,Fulkerson; Matthew Todd,26,0,45,19
1746604833701,PHIL 163,A01,889601,Staff,21,0,30,9
1746604833701,PHIL 163,B01,889606,Brandt; Reuven A,0,3,0,0
1746604834728,PHIL 164,A00,889610,Staff,16,0,30,14
1746604835757,PHIL 165,A00,889613,Staff,22,0,30,8
1746604836794,PHYS 1A,A00,886431,Staff,30,0,70,40
1746604837828,PHYS 1AL,001,886432,Tsai; Philbert S,0,1,30,30
1746604837828,PHYS 1AL,002,886436,Tsai; Philbert S,13,0,30,17
1746604838853,PHYS 1B,A00,886439,Staff,184,0,240,56
1746604839882,PHYS 1BL,001,886441,Tsai; Philbert S,0,4,30,30
1746604839882,PHYS 1BL,002,886444,Tsai; Philbert S,2,0,30,28
1746604840910,PHYS 1C,A00,896092,Arnold; Kam S,78,0,146,68
1746604841938,PHYS 1CL,001,886448,Tsai; Philbert S,0,0,30,30
1746604841938,PHYS 1CL,002,886449,Tsai; Philbert S,1,0,30,29
1746604841938,PHYS 1CL,003,886450,Tsai; Philbert S,16,0,30,14
1746604841938,PHYS 1CL,004,886451,Tsai; Philbert S,15,0,30,15
1746604842968,PHYS 2B,A01,886457,Staff,67,0,115,48
1746604843997,PHYS 2C,A01,886460,Shotwell; Brian,0,9,65,65
1746604845037,PHYS 2CL,A01,886467,Staff,0,4,28,28
1746604845037,PHYS 2CL,A02,886468,Staff,0,3,28,28
1746604846064,PHYS 2D,A01,886470,Staff,10,0,50,40
1746604847101,PHYS 4B,A01,886475,Grinstein; Benjamin,22,0,40,18
1746604848140,POLI 5,A00,891173,Desposato; Scott,7,0,25,18
1746604849171,POLI 5D,A01,891175,Staff,5,0,5,0
1746604849171,POLI 5D,B01,891178,Staff,5,0,5,0
1746604850205,POLI 11,A00,891179,Ferree; Karen E,0,0,35,35
1746604851231,POLI 12,A00,891180,Staff,15,0,30,15
1746604852256,POLI 27,A01,891182,Staff,11,0,75,64
1746604853287,POLI 30,A00,891183,Staff,8,0,50,42
1746604854318,POLI 100B,A00,891244,Staff,5,1,35,30
1746604855350,POLI 100I,A00,891247,Staff,7,0,30,23
1746604856376,POLI 104J,A00,891248,Nichter; Maysa,14,0,30,16
1746604857403,POLI 104U,A00,891250,Nichter; Maysa,1,0,30,29
1746604859459,POLI 110B,A00,891255,Wiens; David,19,0,25,6
1746604860490,POLI 112A,A00,891256,Wiens; David,6,0,25,19
1746604861516,POLI 114BR,A00,891261,Staff,19,0,30,11
1746604862542,POLI 117R,A00,891262,Forman; Fonna,0,6,50,50
1746604863575,POLI 118,A00,891264,Ingham; Sean,17,0,25,8
1746604864609,POLI 124A,A00,891265,Staff,18,0,20,2
1746604865643,POLI 125D,A00,891266,Nichter; Simeon C,2,0,25,23
1746604866674,POLI 126,A00,891268,Nichter; Simeon C,7,0,25,18
1746604867701,POLI 126AA,A00,891272,Staff,15,0,25,10
1746604868737,POLI 130AA,A00,891273,Staff,15,0,20,5
1746604869780,POLI 134AA,A00,891274,Staff,4,0,20,16
1746604871839,POLI 138,A00,891278,Staff,21,0,25,4
1746604872870,POLI 142K,A00,891280,Staff,10,0,25,15
1746604873899,POLI 142M,A00,891281,Gartzke; Erik,16,0,30,14
1746604874925,POLI 142P,A00,891284,Staff,20,0,30,10
1746604875955,POLI 143,A00,891285,Gartzke; Erik,12,0,30,18
1746604876990,POLI 153,A00,891286,Staff,19,0,20,1
1746604879053,POLI 175,A00,891290,Staff,15,0,20,5
1746604880084,PSYC 1,A00,890674,Steiner; Eric Tomas,0,11,45,45
1746604881119,PSYC 2,A00,890676,Albright; Thomas D,20,0,35,15
1746604882147,PSYC 3,A00,890679,Staff,17,0,20,3
1746604883184,PSYC 6,A00,959858,Staff,19,0,20,1
1746604884213,PSYC 60,A01,890684,Rickard; Timothy C.,0,6,45,45
1746604885241,PSYC 70,A01,890689,Geller; Emma Harlan,6,0,30,24
1746604886271,PSYC 71,A01,959860,Staff,21,0,25,4
1746604887307,PSYC 100,A00,890690,Lacefield; Katharine I,0,50,180,180
1746604888332,PSYC 102,A00,890695,Staff,18,0,40,22
1746604889369,PSYC 105,A00,890699,Geller; Emma Harlan,70,0,100,30
1746604890395,PSYC 106,A00,890701,Gorman; Michael R.,5,0,30,25
1746604891436,PSYC 108,A00,890704,Adrian; Julia Anna,0,29,50,50
1746604892464,PSYC 118,A01,890712,Staff,11,0,30,19
1746604893491,PSYC 124,A00,890716,Chapman; Eddie Nathaniel,25,0,60,35
1746604894520,PSYC 131,A00,890717,Anagnostaras; Stephan,0,7,80,80
1746604895548,PSYC 137,A00,890719,Winkielman; Piotr,0,11,30,30
1746604896578,PSYC 144,A00,890721,Adrian; Julia Anna,0,9,45,45
1746604897606,PSYC 162,A00,890805,Staff,0,2,75,75
1746604898631,PSYC 169,A00,890810,Staff,0,15,30,30
1746604899701,PSYC 172,A00,890814,Gorman; Michael R.,9,0,30,21
1746604900728,PSYC 181,A00,890818,Anagnostaras; Stephan,6,0,200,194
1746604901755,PSYC 184,A00,959861,Staff,160,0,175,15
1746604902781,PSYC 189,A00,890823,Staff,0,2,30,30
1746604903808,PSYC 191,A00,890884,Rickard; Timothy C.,0,12,35,35
1746604904836,PSYC 193,A00,890913,Staff,19,0,30,11
1746604904836,PSYC 193,B00,890914,Chapman; Eddie Nathaniel,24,0,30,6
1746604905871,PSYC 193L,A01,890918,Lowe; Angela Beth,20,0,30,10
1746604905871,PSYC 193L,B01,890921,Hurwitz; Ethan Scott,20,0,30,10
1746604905871,PSYC 193L,C01,890928,Staff,30,0,30,0
1746604906899,RELI 149,A00,886806,Rahimi; Babak,23,0,40,17
1746604907932,SE 9,A01,886814,Staff,7,0,20,13
1746604908959,SE 101B,A01,886816,Chadha; Mayank,3,0,35,32
1746604909990,SE 110B,A00,886818,Zhu; Qiang,4,0,75,71
1746604911015,SE 125,A01,886830,Staff,10,0,30,20
1746604912045,SE 130B,A01,886835,Staff,14,0,40,26
1746604913077,SE 131A,A01,886838,Krysl; Petr,34,0,55,21
1746604914107,SE 154,A00,886840,Staff,28,0,50,22
1746604915137,SE 164GS,A01,886849,Staff,6,0,20,14
1746604916163,SE 167GS,A01,886853,Staff,6,0,20,14
1746604917191,SIO 25,A01,890107,Staff,19,0,30,11
1746604918217,SIO 45,A00,890109,Cook; Geoffrey W,115,0,200,85
1746604919245,SIO 109R,A00,890110,Forman; Fonna,0,16,20,20
1746604920272,SIO 187,A01,890114,Kacev; David,15,0,40,25
1746604921301,SOCI 1,A01,890431,Thorpe; Charles Robert,14,0,30,16
1746604921301,SOCI 1,A02,890518,Thorpe; Charles Robert,30,0,30,0
1746604922327,SOCI 2,A01,957978,Staff,25,0,25,0
1746604922327,SOCI 2,A02,957979,Staff,23,0,25,2
1746604923355,SOCI 20,A01,890523,Calderon-Zaks; Michael Aar,21,0,30,9
1746604923355,SOCI 20,A02,890526,Calderon-Zaks; Michael Aar,29,0,30,1
1746604924380,SOCI 30,A01,890533,Pardo Guerra; Juan Pablo,37,0,40,3
1746604925409,SOCI 40,A01,890535,Staff,27,0,45,18
1746604926437,SOCI 104Q,A00,890559,Staff,17,0,30,13
1746604927464,SOCI 106,A00,890560,Arnal; Maud Marie Leonie,20,0,30,10
1746604928491,SOCI 110,A00,890567,Holkenbrink-Monk; Charlene,19,0,30,11
1746604929517,SOCI 112,A00,890568,Victoria Torres; Pablo,2,0,55,53
1746604930545,SOCI 115,A00,890597,Arnal; Maud Marie Leonie,28,0,45,17
1746604932601,SOCI 121,A00,890604,Pardo Guerra; Juan Pablo,38,0,45,7
1746604933630,SOCI 126,A01,890608,Staff,8,0,10,2
1746604934659,SOCI 127,A00,890609,Staff,18,0,30,12
1746604935690,SOCI 131,A00,890610,Thorpe; Charles Robert,37,0,45,8
1746604936716,SOCI 135,A00,890615,Payne; Christine Anna,14,0,45,31
1746604937749,SOCI 139,A00,890620,Staff,38,0,45,7
1746604938780,SOCI 148E,A00,890622,Calderon-Zaks; Michael Aar,36,0,45,9
1746604939806,SOCI 150,A00,890623,Kohler; Kristopher M.,31,0,45,14
1746604940831,SOCI 157,A00,890625,Jules-Rosette; Bennetta W.,18,0,20,2
1746604941858,SOCI 160,A00,890627,Payne; Christine Anna,21,0,45,24
1746604942887,SYN 1,A00,886855,Fish; Gwendolyn Anne,0,1,0,0
1746604942887,SYN 1,B00,906086,Fish; Gwendolyn Anne,0,2,0,2
1746604943914,SYN 2R,A00,886860,Staff,0,17,15,15
1746604943914,SYN 2R,B00,906106,Atkinson; Arthur Laird,0,16,15,15
1746604944963,SYN 100,A01,886866,Browne; Emily,0,28,20,20
1746604944963,SYN 100,B01,906128,Rock; Martin,0,4,20,20
1746604944963,SYN 100,C01,906140,Deavenport; James Cary,0,4,20,20
1746604944963,SYN 100,D01,907816,Deavenport; James Cary,0,5,20,20
1746604945989,TDAC 1,A00,890286,Walsh; Kim C.,7,0,20,13
1746604947017,TDAC 101,A00,890296,Basso; Beatrice,15,0,20,5
1746604948044,TDDE 131,A00,890297,Staff,47,0,50,3
1746604949071,TDDM 1,A00,890287,Weinberg; Sadie,25,0,30,5
1746604950099,TDGE 11,A00,890288,Fulton; Julia,138,0,200,62
1746604950099,TDGE 11,B00,890289,Castro; Robert Jess,184,0,200,16
1746604951127,TDGE 25,B00,957359,Walsh; Kim C.,5,0,20,15
1746604952156,TDGE 40,A01,890292,Power; Jade Yukana,26,0,30,4
1746604953182,TDGE 124,A00,890298,Havis; Allan,0,2,50,50
1746604954207,TDGE 131R,A00,890299,Burelle; Julie Sara Veronique,15,0,42,27
1746604955233,TDHT 101,A00,890300,Staff,10,0,20,10
1746604956260,TDHT 109,A01,890302,Anderson; Mysia Anyse,31,0,40,9
1746604957289,TDMV 1,A00,890293,Arcidiacono; Kristin,18,0,30,12
1746604958317,TDMV 2,A00,890294,Weinberg; Sadie,23,0,30,7
1746604959345,TDMV 3,A00,957878,Arcidiacono; Kristin,28,0,30,2
1746604961396,TDMV 138,A00,890304,Jun; Grace Shin Hae,25,0,40,15
1746604962422,TDMV 140,A00,890305,Corrales; Joseph Bernales,25,0,30,5
1746604963452,TDMV 142,A00,890307,Caligagan; Tony,32,0,40,8
1746604964482,TDMV 144,A00,890308,Camaya; Michelle Ann,25,0,30,5
1746604965512,TDPW 1,A00,890295,Stein; Deborah Isobel,3,0,20,17
1746604966540,USP 2,A01,890272,Lerner; Amy M,7,0,20,13
1746604967568,USP 3,A01,890274,Staff,12,0,30,18
1746604968601,USP 15,A01,890276,Sun; Feiyang,16,0,30,14
1746604969634,USP 25,A00,890277,Shenkman; Michael Thomas,18,0,25,7
1746604970660,USP 138,A00,890278,Staff,13,0,25,12
1746604971690,USP 143,A00,890279,Staff,21,0,70,49
1746604972715,USP 144,A00,890280,Chowdhury; Muhammed Zohir,16,0,30,14
1746604973746,USP 150,A00,890281,Boomhower; Matthew Charles,4,0,30,26
1746604974781,USP 151,A00,890282,Staff,16,0,20,4
1746604975806,USP 162,A00,890283,Andrews; Abigail Leslie,16,0,20,4
1746604976834,USP 168,A00,920477,Kwak; Nancy,0,0,5,5
1746604977868,USP 181,A00,890284,Staff,3,0,20,17
1746604978901,USP 191A,A00,890285,Staff,12,0,20,8
1746604979929,VIS 101,A00,886512,Staff,26,0,75,49
1746604980962,VIS 103,A00,886513,Cruz; Edwin Teddy,61,0,75,14
1746604981996,VIS 108,A00,886514,Staff,4,0,15,11
1746604983023,VIS 127P,A00,886515,Shen; Kuiyi,80,0,146,66
1746604984049,VIS 149,A00,886516,Yoldas; Pinar,0,0,15,15
1746604985076,VIS 164,A00,886526,Erdmann; Dean,19,0,22,3
1746604986101,VIS 194S,A00,886527,Staff,61,0,75,14
1746604987132,WCWP 10A,C00,886484,Martiniuk; Jill,12,0,15,3
1746604988161,WCWP 10B,A00,886490,Uriarte; Emma,0,0,15,15
1746604988161,WCWP 10B,B00,886491,Dhir; Simrita,8,0,15,7
1746604988161,WCWP 10B,C00,886492,Ornelas; Tricia,0,0,15,15
1746604989192,WCWP 100,A00,886494,Young; Mark T,0,6,15,15
1746604991362,AAS 10,A01,886199,Childs; Dennis R.,0,3,0,0
1746604992397,ANAR 104,A01,886940,Shtienberg; Gilad,27,0,30,3
1746604993422,ANAR 120,A00,886953,Staff,13,0,20,7
1746604994449,ANBI 148,A01,886955,Wilder; Linnea Lorene,30,0,40,10
1746604996504,ANSC 122,A00,886957,Staff,24,0,30,6
1746604997529,ANSC 150,A00,886958,Sloane; Julia Kathryn,2,0,15,13
1746604998556,ANSC 156,A00,886959,Jenkins; Janis A.,0,1,15,15
1746604999581,ANSC 180,A00,886960,Staff,11,0,17,6
1746605000613,ANSC 188,A00,886961,Jassal; Aftab,9,0,25,16
1746605001639,ANSC 190,A00,886962,Jassal; Aftab,14,0,25,11
1746605002664,ANSC 191,A00,886963,Staff,18,0,20,2
1746605003733,ANTH 3,A01,891689,Staff,17,0,20,3
1746605004769,ANTH 5,A00,886933,Semendeferi; Ekaterini,16,0,20,4
1746605005799,ANTH 10,A00,886934,Staff,0,12,30,30
1746605006826,ANTH 21,A01,886936,Staff,41,0,60,19
1746605007854,ANTH 23,A01,886938,Staff,92,0,100,8
1746605008882,ANTH 105,A00,886964,Stewart; Alexander B,84,0,100,16
1746605009909,ANTH 108,A00,886965,Pedersen; David,9,0,20,11
1746605010941,AWP 10,001,886147,Staff,0,0,0,0
1746605010941,AWP 10,002,886148,Staff,0,0,0,0
1746605010941,AWP 10,003,886149,Staff,0,0,0,0
1746605010941,AWP 10,004,886150,Staff,0,0,0,0
1746605010941,AWP 10,005,886151,Staff,0,0,0,0
1746605010941,AWP 10,006,886152,Staff,0,0,0,0
1746605010941,AWP 10,007,886153,Staff,0,0,0,0
1746605010941,AWP 10,008,886154,Staff,0,0,0,0
1746605010941,AWP 10,009,886155,Staff,0,0,0,0
1746605010941,AWP 10,010,886156,Staff,0,0,0,0
1746605010941,AWP 10,011,886158,Staff,0,0,0,0
1746605010941,AWP 10,012,886160,Staff,0,0,0,0
1746605010941,AWP 10,013,886161,Staff,0,0,0,0
1746605010941,AWP 10,014,886162,Staff,0,0,0,0
1746605010941,AWP 10,015,886163,Staff,0,0,0,0
1746605010941,AWP 10,016,886164,Staff,0,0,0,0
1746605010941,AWP 10,017,886165,Staff,0,0,0,0
1746605010941,AWP 10,018,886166,Staff,0,0,0,0
1746605010941,AWP 10,019,886168,Staff,0,0,0,0
1746605010941,AWP 10,020,886170,Staff,0,0,0,0
1746605010941,AWP 10,021,886172,Staff,0,0,0,0
1746605011972,AWP 10R,001,886173,Staff,0,1,0,0
1746605011972,AWP 10R,002,886174,Staff,0,1,0,0
1746605011972,AWP 10R,003,886175,Staff,0,0,0,0
1746605011972,AWP 10R,004,886176,Staff,0,0,0,0
1746605011972,AWP 10R,005,886177,Staff,0,0,0,0
1746605011972,AWP 10R,006,886178,Staff,0,0,0,0
1746605011972,AWP 10R,007,886179,Staff,0,0,0,0
1746605011972,AWP 10R,008,886181,Staff,0,0,0,0
1746605011972,AWP 10R,009,886182,Staff,0,0,0,0
1746605011972,AWP 10R,010,886183,Staff,0,0,0,0
1746605011972,AWP 10R,011,886184,Staff,0,0,0,0
1746605011972,AWP 10R,012,886185,Staff,0,0,0,0
1746605011972,AWP 10R,013,886186,Staff,0,0,0,0
1746605011972,AWP 10R,014,886187,Staff,0,0,0,0
1746605011972,AWP 10R,015,886188,Staff,0,0,0,0
1746605011972,AWP 10R,016,886189,Staff,0,0,0,0
1746605011972,AWP 10R,017,960532,Staff,0,0,0,0
1746605011972,AWP 10R,018,960533,Staff,0,0,0,0
1746605011972,AWP 10R,019,960534,Staff,0,0,0,0
1746605011972,AWP 10R,020,960538,Staff,0,0,0,0
1746605011972,AWP 10R,021,960540,Staff,0,0,0,0
1746605011972,AWP 10R,022,960541,Staff,0,0,0,0
1746605011972,AWP 10R,023,960542,Staff,0,0,0,0
1746605011972,AWP 10R,024,960544,Staff,0,0,0,0
1746605011972,AWP 10R,025,960545,Staff,0,0,0,0
1746605011972,AWP 10R,026,960548,Staff,0,0,0,0
1746605012996,AWP 102R,A00,886190,Staff,0,0,0,0
1746605012996,AWP 102R,B00,886191,Staff,0,0,0,0
1746605014022,BENG 100,A01,886193,Staff,17,0,30,13
1746605015057,BENG 122A,A01,886195,Hasty; Jeff M,13,0,30,17
1746605016084,BENG 166A,A00,886196,Sah; Robert Lie-Yuan,0,3,30,30
1746605017112,BENG 190,A00,958050,Khojah; Reem I,17,0,25,8
1746605018138,BIBC 102,A01,894320,Staff,0,1,46,46
1746605018138,BIBC 102,A02,894321,Staff,0,0,46,46
1746605018138,BIBC 102,A03,894344,Staff,6,0,46,40
1746605018138,BIBC 102,A04,894345,Staff,27,0,47,20
1746605019174,BICD 100R,A01,894365,Smith; Laurie,0,2,58,58
1746605019174,BICD 100R,A02,894366,Smith; Laurie,0,4,58,58
1746605019174,BICD 100R,A03,894367,Smith; Laurie,0,0,59,59
1746605019174,BICD 100R,A04,959869,Smith; Laurie,38,0,59,21
1746605020200,BICD 136,A01,894383,Gustafson-Brown; Cindy,14,0,50,36
1746605021230,BIEB 102,A01,894494,Butler; Shannon Rhey,51,0,130,79
1746605023299,BIEB 150,A01,894617,Wills; Christopher,3,0,20,17
1746605023299,BIEB 150,A02,894631,Wills; Christopher,3,0,20,17
1746605023299,BIEB 150,A03,894937,Wills; Christopher,3,0,20,17
1746605023299,BIEB 150,A04,894946,Wills; Christopher,5,0,20,15
1746605024325,BIEB 194,A00,906141,Kurle; Carolyn M.,5,0,20,15
1746605025357,BILD 1,A01,894154,Staff,3,0,19,16
1746605025357,BILD 1,A02,894155,Staff,14,0,19,5
1746605025357,BILD 1,A03,894160,Staff,13,0,19,6
1746605025357,BILD 1,A04,894161,Staff,15,0,18,3
1746605026387,BILD 2,A01,894168,Staff,0,0,50,50
1746605026387,BILD 2,A02,894169,Staff,0,0,50,50
1746605026387,BILD 2,A03,894179,Staff,0,0,50,50
1746605026387,BILD 2,A04,894203,Staff,22,0,50,28
1746605027415,BILD 3,A01,894213,Staff,23,0,31,8
1746605027415,BILD 3,A02,894214,Staff,26,0,31,5
1746605027415,BILD 3,A03,894235,Staff,28,0,31,3
1746605027415,BILD 3,A04,894236,Staff,28,0,32,4
1746605028453,BILD 4,A01,894253,Reuther; Keefe,5,0,24,19
1746605028453,BILD 4,A02,894258,Reuther; Keefe,16,0,24,8
1746605029487,BILD 5,A01,894276,Reuther; Keefe,34,0,50,16
1746605029487,BILD 5,A02,894277,Reuther; Keefe,45,0,50,5
1746605029487,BILD 5,A03,894290,Reuther; Keefe,44,0,50,6
1746605029487,BILD 5,A04,894291,Reuther; Keefe,48,0,50,2
1746605030513,BILD 24,A01,894297,Pirino; Giorgia,40,0,60,20
1746605031549,BIMM 100,B01,958915,Staff,71,0,100,29
1746605032582,BIMM 101,A01,895017,McDonnell; Lisa Marie,0,5,24,24
1746605032582,BIMM 101,A02,895018,McDonnell; Lisa Marie,0,5,24,24
1746605032582,BIMM 101,B01,895020,McDonnell; Lisa Marie,0,5,24,24
1746605032582,BIMM 101,B02,895021,McDonnell; Lisa Marie,0,4,24,24
1746605033617,BIMM 110,A01,895023,Staff,1,0,25,24
1746605033617,BIMM 110,A02,895024,Staff,9,0,25,16
1746605033617,BIMM 110,A03,895025,Staff,18,0,25,7
1746605033617,BIMM 110,A04,895031,Staff,20,0,25,5
1746605034650,BIMM 120,A01,895114,Gustafson-Brown; Cindy,14,0,28,14
1746605034650,BIMM 120,A02,895126,Gustafson-Brown; Cindy,21,0,27,6
1746605035676,BIPN 100,A01,895130,Yang; Mingyu,0,0,38,38
1746605035676,BIPN 100,A02,895131,Yang; Mingyu,31,0,38,7
1746605035676,BIPN 100,A03,895132,Yang; Mingyu,32,0,38,6
1746605035676,BIPN 100,A04,895133,Yang; Mingyu,27,0,36,9
1746605036711,BIPN 120,A01,895135,Cooke; James Edward,0,3,13,13
1746605036711,BIPN 120,A02,895136,Cooke; James Edward,0,1,13,13
1746605036711,BIPN 120,A03,895137,Cooke; James Edward,0,3,13,13
1746605036711,BIPN 120,A04,895156,Cooke; James Edward,0,2,11,11
1746605037745,BIPN 134,A01,895235,Cooke; James Edward,0,1,25,25
1746605037745,BIPN 134,A02,895237,Cooke; James Edward,0,0,25,25
1746605037745,BIPN 134,A03,895240,Cooke; James Edward,1,0,25,24
1746605037745,BIPN 134,A04,895270,Cooke; James Edward,20,0,25,5
1746605038772,BIPN 189,A00,892103,Staff,0,14,14,14
1746605040859,BISP 194,A00,958008,Staff,0,2,0,0
1746605041886,CAT 124,A01,922009,Staff,0,5,20,20
1746605042919,CAT 125R,A00,886390,Morales; Celeste Georgianna,0,4,20,20
1746605042919,CAT 125R,B00,886391,Irwin; Matthew Joseph,0,4,20,20
1746605042919,CAT 125R,C00,886392,Smith; Lauryn Alissa,0,2,20,20
1746605042919,CAT 125R,D00,886393,Vanderschuit; Maya Alysia,0,3,20,20
1746605042919,CAT 125R,E00,886394,Marchisotto; Jennifer Anne,0,3,20,20
1746605043948,CENG 15,A01,886218,Drews; Aaron,3,0,8,5
1746605044989,CENG 113,A00,886219,Opatkiewicz; Justin Paul,15,0,25,10
1746605046018,CGS 101,A00,887044,Staff,7,0,20,13
1746605047045,CGS 105,A01,887046,Staff,14,0,25,11
1746605048079,CGS 112,A00,887047,Cuong; Marisol,12,0,15,3
1746605049108,CGS 113,A00,887048,Staff,23,0,30,7
1746605050136,CGS 120,A00,887049,Staff,9,0,17,8
1746605051166,CHEM 6A,A01,886336,Lam; Tin Yiu,38,0,50,12
1746605051166,CHEM 6A,A02,886338,Lam; Tin Yiu,37,0,50,13
1746605052201,CHEM 6B,A01,886341,Hopkins; Patrycja Anna,16,0,50,34
1746605052201,CHEM 6B,A02,886343,Hopkins; Patrycja Anna,42,0,50,8
1746605053235,CHEM 6C,A01,886346,Albizati; Kim F.,0,2,50,50
1746605053235,CHEM 6C,A02,886348,Albizati; Kim F.,24,0,50,26
1746605054262,CHEM 40A,A01,886352,Klosterman; Jeremy K,65,0,100,35
1746605055289,CHEM 40B,A01,886356,Klosterman; Jeremy K,0,24,100,100
1746605056316,CHEM 41B,A01,886360,Theodorakis; Emmanuel,25,0,50,25
1746605056316,CHEM 41B,A02,886362,Theodorakis; Emmanuel,47,0,50,3
1746605057342,CHIN 165A,A00,886382,Xu; Li,18,0,20,2
1746605058376,CLAS 120,A00,886387,Myerston Santana; Jacobo,33,0,40,7
1746605059407,COGS 9,A01,886967,Shannon; Kyle Michael,42,0,60,18
1746605060437,COGS 11,A01,886969,Staff,9,0,30,21
1746605061467,COGS 14A,A01,886971,Staff,5,0,60,55
1746605062497,COGS 14B,A01,886973,Hoffman; Drew Ellen,4,0,60,56
1746605063523,COGS 18,A01,886975,Morgan; Eric,34,0,60,26
1746605064549,COGS 20,A01,886977,Staff,3,0,8,5
1746605064549,COGS 20,A02,886978,Staff,5,0,7,2
1746605065587,COGS 100,A01,907783,Staff,0,1,30,30
1746605066617,COGS 101B,A01,886980,Staff,0,4,48,48
1746605067644,COGS 101C,A01,886982,Delgado; Tania,0,5,44,44
1746605068670,COGS 102A,A01,886984,Johnson; Christine M.,3,0,30,27
1746605069696,COGS 118B,A01,886986,Staff,0,4,88,88
1746605070722,COGS 150,A01,886988,Bergen; Benjamin,22,0,50,28
1746605071759,COGS 153,A00,886989,Delgado; Tania,1,3,41,40
1746605072793,COGS 186,A01,886991,Staff,0,0,32,32
1746605073824,COGS 187A,A01,886993,Boyle; Mary E. T.,7,0,30,23
1746605074851,COGS 189,A00,886994,Staff,0,1,30,30
1746605075879,COMM 10,A01,886996,Staff,0,0,20,21
1746605075879,COMM 10,A02,886997,Staff,10,0,20,10
1746605075879,COMM 10,A03,959845,Staff,19,0,20,1
1746605076912,COMM 20,A01,886999,Leuning; Grant Maurstad,24,0,40,16
1746605078967,COMM 100A,A01,887002,Staff,0,0,20,25
1746605078967,COMM 100A,A02,887003,Staff,5,0,20,15
1746605079995,COMM 100B,A01,887005,Staff,0,8,20,24
1746605081023,COMM 106D,A00,887006,Staff,14,0,40,26
1746605082053,COMM 110G,A00,887007,Whitworth-Smith; Andrew C,12,0,40,28
1746605083078,COMM 111B,A00,887008,Staff,31,0,40,9
1746605084108,COMM 113T,A00,887009,Abuelhiga; Soraya Jill,28,0,40,12
1746605084108,COMM 113T,B00,906733,Staff,39,0,40,1
1746605085135,COMM 145,A00,887010,Staff,13,0,40,27
1746605086163,COMM 146,A00,887054,Staff,32,0,40,8
1746605087189,COMM 190,A00,887012,Staff,8,0,23,15
1746605088219,CSE 8A,A50,887015,Cao; Yingjun,56,0,85,29
1746605089247,CSE 11,A01,887017,Cao; Yingjun,11,0,70,59
1746605090282,CSE 20,A01,887019,Staff,30,0,50,20
1746605091318,CSE 21,A01,887021,Staff,79,0,100,21
1746605091318,CSE 21,B01,892583,Braun; Oliver,45,0,50,5
1746605092346,CSE 30,A01,887025,Eldon; John,142,0,200,58
1746605093380,CSE 100,A01,887027,Staff,26,0,50,24
1746605093380,CSE 100,A02,887028,Staff,42,0,50,8
1746605094409,CSE 101,A01,887030,Braun; Oliver,74,0,100,26
1746605094409,CSE 101,B01,887032,Jones; Miles E,0,3,50,50
1746605094409,CSE 101,B02,887033,Jones; Miles E,0,2,50,50
1746605095435,CSE 105,A01,908084,Jones; Miles E,32,0,50,18
1746605095435,CSE 105,A02,908087,Jones; Miles E,31,0,50,19
1746605096464,CSE 135,A01,887035,Powell; Thomas Allan,0,5,50,50
1746605097495,CSE 142,A01,887037,Staff,7,0,60,53
1746605098520,CSE 142L,A01,887039,Staff,34,0,60,26
1746605099545,CSE 151A,A01,887041,Solares; Edwin A,47,0,100,53
1746605100574,CSE 175,A01,887043,Kumar; Rakesh,30,0,30,0
1746605101609,CSS 1,A01,886389,Staff,0,1,40,40
1746605102647,DSC 30,A01,908097,Liao; Soohyun Nam,47,0,75,28
1746605103686,DSC 40A,A01,908099,Shannon; Kyle Michael,30,0,50,20
1746605104715,DSC 40B,A01,908112,Staff,15,0,50,35
1746605105745,DSC 80,A01,908116,Staff,19,0,60,41
1746605106772,DSC 197,001,956863,Eldridge; Justin Matthew,9999,0,9999,0
1746605107837,ECE 5,A01,886400,Morris; Karcher William,1,0,6,5
1746605107837,ECE 5,A02,886401,Morris; Karcher William,3,0,6,3
1746605108870,ECE 148,A01,886403,Silberman; Jack,0,14,14,14
1746605109899,ECON 1,A01,887265,Crane; Meredith Helen,11,0,70,59
1746605109899,ECON 1,B01,887268,Staff,42,0,50,8
1746605110928,ECON 2,A01,887273,Crane; Meredith Helen,54,0,70,16
1746605111957,ECON 3,A01,887279,Rondina; Giacomo,31,0,70,39
1746605112985,ECON 4,A01,887282,Anderson; John Charles,0,2,10,10
1746605114014,ECON 5,A01,887285,Staff,34,0,45,11
1746605114014,ECON 5,B01,887292,Staff,41,0,45,4
1746605115045,ECON 100A,A01,887337,Newhouse; Herbert S,54,0,70,16
1746605115045,ECON 100A,B01,887349,Staff,45,0,50,5
1746605116072,ECON 100B,A01,887361,Du; Songzi,29,0,70,41
1746605117099,ECON 100C,A01,887445,Newhouse; Herbert S,59,0,70,11
1746605118127,ECON 105,A00,887488,Vespa; Emanuel Ignacio,23,0,35,12
1746605119162,ECON 109,A01,887506,Shishkin; Denis,28,0,35,7
1746605120192,ECON 110A,A01,887568,Alon; Titan Michael,0,2,35,35
1746605120192,ECON 110A,B01,907601,Alon; Titan Michael,20,0,35,15
1746605121220,ECON 110B,A01,887598,Levkoff; Steven B.,0,24,70,70
1746605122245,ECON 112,A00,887599,Rondina; Giacomo,19,0,35,16
1746605123272,ECON 120A,A01,887603,Dai; Yinlin,36,0,70,34
1746605124302,ECON 120C,A01,887608,Sun; Yixiao,0,1,35,35
1746605124302,ECON 120C,B01,887614,Sun; Yixiao,0,0,35,35
1746605125333,ECON 138,A00,887621,Bharadwaj; Prashant,0,21,20,20
1746605126364,ECON 144,A00,958007,Squires; Dale E,11,0,35,24
1746605127396,ECON 171,A01,907666,Staff,18,0,35,17
1746605128424,ECON 175,A00,887626,Wu; Pak Yeung,22,0,35,13
1746605129467,ECON 190,A00,887640,Vespa; Emanuel Ignacio,22,0,35,13
1746605130518,EDS 25,A01,888197,Staff,0,0,0,0
1746605130518,EDS 25,A02,888209,Staff,0,0,0,0
1746605130518,EDS 25,A03,888210,Staff,0,0,0,0
1746605130518,EDS 25,A04,888212,Staff,0,0,0,0
1746605130518,EDS 25,A05,888213,Staff,0,0,0,0
1746605130518,EDS 25,A06,888214,Staff,0,0,0,0
1746605130518,EDS 25,A07,888235,Staff,0,2,0,0
1746605130518,EDS 25,A08,888236,Staff,0,0,0,0
1746605130518,EDS 25,A09,888240,Staff,0,0,0,0
1746605130518,EDS 25,A10,888244,Staff,0,0,0,0
1746605130518,EDS 25,B01,888273,Staff,0,0,0,0
1746605130518,EDS 25,B02,888285,Staff,0,0,0,0
1746605130518,EDS 25,B03,888423,Staff,0,0,0,1
1746605130518,EDS 25,B04,888432,Staff,0,0,0,0
1746605130518,EDS 25,B05,888433,Staff,0,0,0,0
1746605130518,EDS 25,B06,888467,Staff,0,0,0,0
1746605130518,EDS 25,B07,888468,Staff,0,0,0,0
1746605130518,EDS 25,B08,888479,Staff,0,0,0,0
1746605130518,EDS 25,B09,888484,Staff,0,0,0,0
1746605130518,EDS 25,B10,888487,Staff,0,0,0,0
1746605131548,EDS 38,A01,907700,Choi; Bailey Miyeon,30,0,30,0
1746605132576,EDS 112,A01,888601,Chapman; Thandeka K,12,0,40,28
1746605133605,EDS 115,A00,888697,Mendez; Kathrina Mendoza,10,0,30,20
1746605134633,EDS 116,A01,888893,Staff,33,0,40,7
1746605136689,EDS 124AR,A00,889133,Staff,29,0,50,21
1746605136689,EDS 124AR,B00,907471,Simon; Elizabeth A,37,0,50,13
1746605137716,EDS 124BR,A00,889134,Simon; Elizabeth A,44,0,100,56
1746605138747,EDS 125,A00,889135,Staff,25,0,30,5
1746605139774,EDS 126,A01,889138,Staff,35,0,40,5
1746605140802,EDS 164R,A01,889142,Wishard Guerra; Alison G.,32,0,50,18
1746605141828,ENG 30,A01,886396,Staff,0,0,0,0
1746605141828,ENG 30,B01,886398,Staff,0,0,0,0
1746605142858,ENVR 102,A00,906150,Montejo; Carolina,23,0,25,2
1746605143894,ETHN 103A,A00,887236,Man; Simeon S,0,2,0,0
1746605144921,ETHN 113,A00,887239,Staff,16,0,30,14
1746605145947,ETHN 116,A00,887240,Staff,16,0,25,9
1746605146980,ETHN 117,A00,887241,Choi; Esther Min,28,0,30,2
1746605148011,ETHN 118,A00,887243,Staff,24,0,30,6
1746605149039,ETHN 127,A00,887248,Cuong; Marisol,11,0,15,4
1746605150072,ETHN 139,A00,887250,Staff,7,0,10,3
1746605151099,ETHN 142,A00,887252,Staff,9,0,30,21
1746605152133,ETHN 161,A00,887253,Browne; Errol Tsekani,24,0,30,6
1746605153162,ETHN 163FR,A00,887255,Burelle; Julie Sara Veronique,0,0,5,5
1746605154197,GLBH 20,A00,889149,Elwardani; Nile Regina,8,0,42,34
1746605156255,GLBH 111,A01,889152,Burgos; Jose L.,17,0,17,0
1746605157286,GLBH 150,A00,889181,Sloane; Julia Kathryn,0,5,15,15
1746605159346,HDS 60,A01,886406,Warstadt; Melissa Fawn,72,0,80,8
1746605160381,HIAF 111,A00,889324,Gyamfi; Bright,25,0,32,7
1746605161410,HIEA 131,A00,889328,Staff,15,0,32,17
1746605162447,HIEA 144,A00,889333,Henry; Todd A.,26,0,32,6
1746605163473,HIEA 154,A00,889336,Henry; Todd A.,24,0,32,8
1746605164500,HIEU 106,A00,889339,Staff,22,0,32,10
1746605166555,HIEU 114,A00,889340,Staff,4,0,32,28
1746605167583,HIEU 135GS,A00,889342,Patterson; Patrick H.,0,0,1,24
1746605168612,HIEU 137,A00,889343,Edington; Claire Ellen,10,0,25,15
1746605169640,HIEU 148,A00,889345,Staff,14,0,32,18
1746605170666,HIEU 154,A00,889346,Biess; Frank Peter,21,0,32,11
1746605171693,HILA 102,A00,889351,Staff,12,0,32,20
1746605172721,HILD 2A,A01,889221,Lewandoski; Julia Mavis,0,8,32,32
1746605173758,HILD 7B,A01,889225,Man; Simeon S,0,12,32,32
1746605174785,HILD 7C,A01,889288,Alvarez; Luis A,0,14,32,32
1746605175812,HILD 30,A01,889323,Staff,0,5,32,32
1746605177881,HISC 119,A00,889383,Golan; Tal,20,0,32,12
1746605178912,HIUS 103,A00,889384,Man; Simeon S,0,0,32,32
1746605179943,HIUS 117,A00,919797,Kwak; Nancy,18,0,32,14
1746605180971,HIUS 142A,A00,919788,Staff,22,0,32,10
1746605183030,HIUS 149,A00,889386,Gyamfi; Bright,26,0,32,6
1746605184060,HIUS 155,A00,889387,Alvarez; Luis A,15,0,32,17
1746605185090,HUM 3,A01,886499,Caldwell; Michael Alan,19,0,50,31
1746605186116,HUM 3GS,A00,886500,Rodriguez; Bretton Sigfred,0,0,0,28
1746605187146,HUM 3R,A01,886502,Markman; Kristina,0,36,50,50
1746605188174,HUM 4,A01,886504,Crum; Matthew Stephen,23,0,50,27
1746605188174,HUM 4,B01,886506,West; Geoffrey Scott,17,0,50,33
1746605189201,HUM 4GS,A00,886507,Staff,0,0,0,19
1746605190228,HUM 5,A01,886509,Staff,31,0,50,19
1746605191256,HUM 5R,A01,886511,Zavodny; Tatiana Sophia,0,39,50,50
1746605192283,JAPN 180,A00,886407,Staff,16,0,40,24
1746605193316,LATI 50,A01,886409,Martin-Cabrera; Luis,3,0,22,19
1746605193316,LATI 50,A02,886410,Martin-Cabrera; Luis,19,0,22,3
1746605193316,LATI 50,A03,886411,Martin-Cabrera; Luis,21,0,22,1
1746605193316,LATI 50,A04,886412,Martin-Cabrera; Luis,8,0,22,14
1746605194343,LAWS 101,A00,907664,Staff,28,0,60,32
1746605195376,LIAB 1A,A00,889388,Saab; Dima,17,0,20,3
1746605196417,LIAB 1AX,A00,889389,El Cheddadi; Youniss,18,0,20,2
1746605197444,LIFR 1C,A00,889391,Van Moer; Vinciane G,8,0,20,12
1746605198471,LIFR 1CX,A00,889392,Van Moer; Vinciane G,7,0,20,13
1746605199498,LIFR 1D,A00,889393,Van Moer; Vinciane G,7,0,20,13
1746605200524,LIFR 1DX,A00,889394,Van Moer; Vinciane G,8,0,20,12
1746605201552,LIGN 7,A00,886923,Staff,25,0,50,25
1746605202579,LIGN 17,A00,886924,Kehler; Andrew Scott,126,0,150,24
1746605203609,LTAM 110,A00,889395,Staff,15,0,30,15
1746605204637,LTAM 110GS,A00,958010,Rodriguez; Bretton Sigfred,0,0,0,28
1746605205664,LTCH 101,A00,889397,Staff,23,0,25,2
1746605206691,LTCS 130,A00,889398,Staff,23,0,25,2
1746605207717,LTEA 138,A00,889399,Staff,24,0,40,16
1746605208747,LTEN 149,A00,889400,Wesling; Megan E.,0,3,25,25
1746605209773,LTEN 169,A00,889401,Staff,20,0,25,5
1746605210802,LTEN 180,A00,889402,Staff,10,0,15,5
1746605211866,LTEN 181,A00,889403,Staff,21,0,25,4
1746605212897,LTWL 100,A00,889404,Myerston Santana; Jacobo,2,0,25,23
1746605213925,LTWL 180GS,A00,889405,Staff,0,0,20,20
1746605214952,LTWL 181,A00,889406,Staff,16,0,25,9
1746605215985,LTWL 184,A00,889475,Mukherjee; Silpa,22,0,25,3
1746605217011,LTWR 102C,A00,889486,Staff,29,0,30,1
1746605218041,LTWR 115W,A00,889491,Staff,0,2,15,15
1746605219072,MAE 8,A01,886905,Staff,0,2,0,0
1746605220101,MAE 11,A00,886906,Bandaru; Prabhakar,0,7,50,50
1746605221128,MAE 20,A00,886907,Evdokimenko; Ekaterina,43,0,70,27
1746605222156,MAE 30B,A00,886909,Ghazinejad; Maziar,25,0,45,20
1746605223182,MAE 101B,A00,886910,Saintillan; David,30,0,45,15
1746605224208,MAE 105,A00,886911,Bandaru; Prabhakar,18,0,50,32
1746605225244,MAE 107,B00,958024,Staff,7,0,50,43
1746605226277,MAE 143B,A00,886913,Bewley; Thomas R,2,0,40,38
1746605227304,MAE 148,A01,886915,Silberman; Jack,0,3,14,14
1746605228332,MAE 160,A00,886916,Evdokimenko; Ekaterina,30,0,60,30
1746605229360,MATH 3C,A01,889681,Staff,0,2,30,30
1746605229360,MATH 3C,A02,960048,Staff,23,0,30,7
1746605230388,MATH 10A,A01,889760,Staff,26,0,30,4
1746605230388,MATH 10A,A02,889783,Staff,29,0,30,1
1746605231423,MATH 10B,A01,889785,Verstraete; Jacques Allan,1,0,35,34
1746605231423,MATH 10B,A02,889795,Verstraete; Jacques Allan,4,0,35,31
1746605231423,MATH 10B,B01,889797,Verstraete; Jacques Allan,3,0,35,32
1746605231423,MATH 10B,B02,889828,Verstraete; Jacques Allan,3,0,35,32
1746605232462,MATH 10C,A01,889849,Habib; Yousaf,8,0,30,22
1746605232462,MATH 10C,A02,889852,Habib; Yousaf,14,0,30,16
1746605232462,MATH 10C,A03,889853,Habib; Yousaf,22,0,30,8
1746605232462,MATH 10C,A04,889858,Habib; Yousaf,20,0,30,10
1746605232462,MATH 10C,B01,889861,Staff,1,0,30,29
1746605232462,MATH 10C,B02,889862,Staff,24,0,30,6
1746605232462,MATH 10C,B03,889863,Staff,27,0,30,3
1746605232462,MATH 10C,B04,889967,Staff,23,0,30,7
1746605234089,MATH 18,A01,889974,Staff,6,0,30,24
1746605234089,MATH 18,A02,889977,Staff,20,0,30,10
1746605234089,MATH 18,B01,889984,Hardiman; Liam,20,0,30,10
1746605234089,MATH 18,B02,889985,Hardiman; Liam,25,0,30,5
1746605235117,MATH 20A,A01,889990,Suk; Andrew Hoon,30,0,35,5
1746605236147,MATH 20B,A01,889993,Ohm; Ko Woon,21,0,30,9
1746605236147,MATH 20B,A02,889994,Ohm; Ko Woon,30,0,30,0
1746605236147,MATH 20B,B01,889996,Ohm; Ko Woon,22,0,30,8
1746605236147,MATH 20B,B02,889997,Ohm; Ko Woon,23,0,30,7
1746605237176,MATH 20C,A01,889999,Hammock; Frances H,17,0,30,13
1746605237176,MATH 20C,A02,890003,Hammock; Frances H,23,0,30,7
1746605237176,MATH 20C,B01,890006,Hammock; Frances H,2,0,30,28
1746605237176,MATH 20C,B02,890007,Hammock; Frances H,11,0,30,19
1746605238206,MATH 20D,A01,890011,Cheng; Hsiao-Bing,1,0,30,29
1746605238206,MATH 20D,A02,890012,Cheng; Hsiao-Bing,14,0,30,16
1746605238206,MATH 20D,B01,890016,Cheng; Hsiao-Bing,13,0,30,17
1746605238206,MATH 20D,B02,890017,Cheng; Hsiao-Bing,13,0,30,17
1746605239246,MATH 20E,A01,890026,Harel; Guershon,1,0,30,29
1746605239246,MATH 20E,A02,890029,Harel; Guershon,22,0,30,8
1746605239246,MATH 20E,B01,890033,Harel; Guershon,7,0,30,23
1746605239246,MATH 20E,B02,890101,Harel; Guershon,21,0,30,9
1746605240278,MATH 102,A01,890104,Staff,18,0,30,12
1746605240278,MATH 102,A02,890105,Staff,27,0,30,3
1746605241306,MATH 103B,A01,890116,Salehi Golsefidy; Alireza,3,0,30,27
1746605241306,MATH 103B,B01,890118,Staff,0,3,34,34
1746605242335,MATH 109,A01,890121,Aliabadi Sr.; Mohsen,0,0,30,30
1746605242335,MATH 109,B01,890124,Upadrashta; Pranav Kumar,18,0,30,12
1746605243364,MATH 120A,A01,890126,Eggers; John Dietrich,13,0,30,17
1746605244398,MATH 142B,A01,890128,Ioana; Adrian,19,0,30,11
1746605244398,MATH 142B,A02,890129,Ioana; Adrian,12,0,30,18
1746605245432,MATH 154,A01,890174,Staff,0,1,30,30
1746605245432,MATH 154,A02,890182,Staff,0,0,30,30
1746605246462,MATH 168A,A01,890197,Dumitriu; Ioana,21,0,35,14
1746605247493,MATH 170A,A01,890240,Nie; Jiawang,1,0,30,29
1746605247493,MATH 170A,A02,890241,Nie; Jiawang,11,0,30,19
1746605247493,MATH 170A,A03,890249,Nie; Jiawang,23,0,30,7
1746605248526,MATH 170B,A01,957891,Nag; Panchali,13,0,35,22
1746605250584,MATH 181A,A01,908025,Staff,0,3,35,35
1746605250584,MATH 181A,A02,960115,Staff,26,0,35,9
1746605251610,MATH 181B,A01,959874,Staff,24,0,30,6
1746605252637,MATH 193B,A01,890265,Staff,0,4,35,35
1746605253664,MGT 4,A01,890311,Anderson; John Charles,42,0,88,46
1746605254719,MGT 5,A00,907740,Staff,12,0,98,86
1746605255748,MGT 12,A00,890312,Lindenberger; Wade Douglas,67,0,98,31
1746605256772,MGT 16,A00,957883,Staff,78,0,98,20
1746605258826,MGT 45,A00,890314,Pecore; Joseph P.,45,0,98,53
1746605259853,MGT 71,A00,890315,Staff,0,12,98,98
1746605260881,MGT 100,A00,890316,Yavorsky; Daniel Ryan,44,0,98,54
1746605261908,MGT 103,A00,890317,Ehrich; Kristine R,73,0,98,25
1746605262945,MGT 105,A00,890356,Bates; Kenneth Walter,0,8,98,98
1746605263977,MGT 112,A00,890360,Ehrich; Kristine R,55,0,98,43
1746605265004,MGT 127R,A00,907732,Zhu; Kevin Xiaoguo,23,0,98,75
1746605266034,MGT 131B,A00,890361,Anderson; John Charles,59,0,98,39
1746605267066,MGT 137,A00,890362,Lindenberger; Wade Douglas,65,0,98,33
1746605268095,MGT 160,A00,890369,Johnson; Erik Barry,9,0,98,89
1746605270150,MGT 164,A00,890372,Zimmermann; Carsten,0,40,98,98
1746605271184,MGT 180,A00,890374,Bliss; Barbara Ann,11,0,98,87
1746605272216,MMW 15,A01,886414,Chang; Edmond Yi-Teh,0,12,28,28
1746605272216,MMW 15,A02,886415,Chang; Edmond Yi-Teh,0,8,28,28
1746605272216,MMW 15,A03,886416,Chang; Edmond Yi-Teh,0,9,28,28
1746605272216,MMW 15,A04,886417,Chang; Edmond Yi-Teh,0,8,28,28
1746605272216,MMW 15,B01,886419,Chang; Edmond Yi-Teh,0,7,28,28
1746605272216,MMW 15,B02,886420,Chang; Edmond Yi-Teh,0,7,28,28
1746605272216,MMW 15,B03,886421,Chang; Edmond Yi-Teh,0,7,28,28
1746605272216,MMW 15,B04,886422,Chang; Edmond Yi-Teh,0,8,28,28
1746605272216,MMW 15,C01,886424,Staff,0,9,28,28
1746605272216,MMW 15,C02,886425,Staff,0,8,28,28
1746605272216,MMW 15,C03,886426,Staff,0,8,28,28
1746605272216,MMW 15,C04,886427,Staff,0,8,28,28
1746605272216,MMW 15,C05,958038,Staff,0,8,28,28
1746605272216,MMW 15,C06,958039,Staff,0,7,28,28
1746605273246,MMW 15GS,A00,906910,Patterson; Patrick H.,4,0,28,24
1746605274276,MMW 122R,A01,886429,Rahimi; Babak,0,13,28,28
1746605274276,MMW 122R,A02,886430,Rahimi; Babak,0,12,28,28
1746605274276,MMW 122R,A03,958040,Rahimi; Babak,0,11,28,28
1746605275312,MUS 1A,A01,890937,Staff,2,0,25,23
1746605275312,MUS 1A,A02,891035,Staff,6,0,25,19
1746605275312,MUS 1A,C01,958912,Staff,24,0,25,1
1746605275312,MUS 1A,C02,958913,Staff,25,0,25,0
1746605277367,MUS 2AK,A00,957092,Ohnishi; Takae,15,0,15,0
1746605278397,MUS 4,A01,891044,Staff,0,0,25,25
1746605278397,MUS 4,A02,891045,Staff,22,0,25,3
1746605278397,MUS 4,B01,891048,Staff,17,0,25,8
1746605278397,MUS 4,B02,891050,Staff,25,0,25,0
1746605279434,MUS 5,A01,957506,Dubnov; Shlomo,0,0,25,25
1746605279434,MUS 5,A02,957622,Dubnov; Shlomo,12,0,25,13
1746605279434,MUS 5,A03,957623,Dubnov; Shlomo,20,0,25,5
1746605280461,MUS 6,A01,891053,Freitas Caetano; Marcelo,24,0,25,1
1746605280461,MUS 6,A02,891054,Freitas Caetano; Marcelo,23,0,25,2
1746605281486,MUS 7,A01,891081,Staff,0,0,25,25
1746605281486,MUS 7,A02,891082,Staff,3,0,25,22
1746605282515,MUS 8GS,A00,891118,Borgo; David Garcia,1,0,25,24
1746605283539,MUS 11,A01,891140,Staff,8,0,25,17
1746605283539,MUS 11,A02,891141,Staff,21,0,25,4
1746605284566,MUS 13,A01,891143,Staff,8,0,25,17
1746605284566,MUS 13,A02,891144,Staff,24,0,25,1
1746605285595,MUS 15,A01,891146,Staff,9,0,25,16
1746605285595,MUS 15,A02,891148,Staff,21,0,25,4
1746605285595,MUS 15,B01,891150,Staff,18,0,25,7
1746605285595,MUS 15,B02,891151,Staff,25,0,25,0
1746605286624,MUS 20,A01,891153,Staff,5,0,20,15
1746605286624,MUS 20,A02,891155,Staff,14,0,20,6
1746605287653,MUS 80,A00,891156,Staff,19,0,25,6
1746605287653,MUS 80,B00,891157,Staff,23,0,25,2
1746605288679,MUS 130,A00,891158,Ohnishi; Takae,35,0,35,0
1746605289709,MUS 150GS,A01,891160,Borgo; David Garcia,1,0,25,24
1746605290736,MUS 170,A01,891162,Freitas Caetano; Marcelo,20,0,25,5
1746605290736,MUS 170,A02,891164,Freitas Caetano; Marcelo,21,0,25,4
1746605291766,NANO 11,A00,886220,Vazquez Mena; Oscar,13,0,15,2
1746605292793,NANO 15,A01,886222,Drews; Aaron,4,0,7,3
1746605293820,NANO 104,A00,886224,Sirbuly; Donald,17,0,25,8
1746605294844,PH 40,A00,886528,Staff,23,0,40,17
1746605295877,PH 45,A01,886799,Staff,35,0,40,5
1746605296906,PH 110,A00,886802,Staff,0,6,40,40
1746605297934,PH 172,A00,906716,Staff,19,0,35,16
1746605298964,PH 191,A00,886803,Staff,6,0,40,34
1746605299995,PHIL 1,A00,889500,Staff,20,0,30,10
1746605301035,PHIL 10,A01,889549,Grush; Rick Scott,16,0,22,6
1746605301035,PHIL 10,A02,889551,Grush; Rick Scott,22,0,22,0
1746605302075,PHIL 28,A01,889559,Lamey; Andy M.,0,2,31,31
1746605302075,PHIL 28,A02,889561,Lamey; Andy M.,0,1,30,30
1746605302075,PHIL 28,A03,889572,Lamey; Andy M.,0,1,30,30
1746605303106,PHIL 35,A00,907839,Staff,13,0,15,2
1746605304131,PHIL 60,A00,889574,Staff,73,0,90,17
1746605305158,PHIL 101,A00,958004,Staff,12,0,15,3
1746605307211,PHIL 136,A00,889582,Fulkerson; Matthew Todd,26,0,45,19
1746605308241,PHIL 163,A01,889601,Staff,21,0,30,9
1746605308241,PHIL 163,B01,889606,Brandt; Reuven A,0,3,0,0
1746605309292,PHIL 164,A00,889610,Staff,16,0,30,14
1746605310319,PHIL 165,A00,889613,Staff,22,0,30,8
1746605311346,PHYS 1A,A00,886431,Staff,30,0,70,40
1746605312374,PHYS 1AL,001,886432,Tsai; Philbert S,0,1,30,30
1746605312374,PHYS 1AL,002,886436,Tsai; Philbert S,13,0,30,17
1746605313407,PHYS 1B,A00,886439,Staff,184,0,240,56
1746605314432,PHYS 1BL,001,886441,Tsai; Philbert S,0,4,30,30
1746605314432,PHYS 1BL,002,886444,Tsai; Philbert S,2,0,30,28
1746605315468,PHYS 1C,A00,896092,Arnold; Kam S,78,0,146,68
1746605316495,PHYS 1CL,001,886448,Tsai; Philbert S,0,0,30,30
1746605316495,PHYS 1CL,002,886449,Tsai; Philbert S,1,0,30,29
1746605316495,PHYS 1CL,003,886450,Tsai; Philbert S,16,0,30,14
1746605316495,PHYS 1CL,004,886451,Tsai; Philbert S,15,0,30,15
1746605317520,PHYS 2B,A01,886457,Staff,67,0,115,48
1746605318547,PHYS 2C,A01,886460,Shotwell; Brian,0,9,65,65
1746605319575,PHYS 2CL,A01,886467,Staff,0,4,28,28
1746605319575,PHYS 2CL,A02,886468,Staff,0,3,28,28
1746605320604,PHYS 2D,A01,886470,Staff,10,0,50,40
1746605321631,PHYS 4B,A01,886475,Grinstein; Benjamin,22,0,40,18
1746605322657,POLI 5,A00,891173,Desposato; Scott,7,0,25,18
1746605323684,POLI 5D,A01,891175,Staff,5,0,5,0
1746605323684,POLI 5D,B01,891178,Staff,5,0,5,0
1746605324731,POLI 11,A00,891179,Ferree; Karen E,0,0,35,35
1746605325759,POLI 12,A00,891180,Staff,15,0,30,15
1746605326787,POLI 27,A01,891182,Staff,11,0,75,64
1746605327815,POLI 30,A00,891183,Staff,8,0,50,42
1746605328843,POLI 100B,A00,891244,Staff,5,1,35,30
1746605329869,POLI 100I,A00,891247,Staff,7,0,30,23
1746605330897,POLI 104J,A00,891248,Nichter; Maysa,14,0,30,16
1746605331925,POLI 104U,A00,891250,Nichter; Maysa,1,0,30,29
1746605333978,POLI 110B,A00,891255,Wiens; David,19,0,25,6
1746605335007,POLI 112A,A00,891256,Wiens; David,6,0,25,19
1746605336036,POLI 114BR,A00,891261,Staff,19,0,30,11
1746605337067,POLI 117R,A00,891262,Forman; Fonna,0,6,50,50
1746605338092,POLI 118,A00,891264,Ingham; Sean,17,0,25,8
1746605339131,POLI 124A,A00,891265,Staff,18,0,20,2
1746605340158,POLI 125D,A00,891266,Nichter; Simeon C,2,0,25,23
1746605341184,POLI 126,A00,891268,Nichter; Simeon C,7,0,25,18
1746605342221,POLI 126AA,A00,891272,Staff,15,0,25,10
1746605343248,POLI 130AA,A00,891273,Staff,15,0,20,5
1746605344276,POLI 134AA,A00,891274,Staff,4,0,20,16
1746605346336,POLI 138,A00,891278,Staff,21,0,25,4
1746605347366,POLI 142K,A00,891280,Staff,10,0,25,15
1746605348395,POLI 142M,A00,891281,Gartzke; Erik,16,0,30,14
1746605349425,POLI 142P,A00,891284,Staff,20,0,30,10
1746605350452,POLI 143,A00,891285,Gartzke; Erik,12,0,30,18
1746605351481,POLI 153,A00,891286,Staff,19,0,20,1
1746605353536,POLI 175,A00,891290,Staff,15,0,20,5
1746605354569,PSYC 1,A00,890674,Steiner; Eric Tomas,0,11,45,45
1746605355596,PSYC 2,A00,890676,Albright; Thomas D,20,0,35,15
1746605356629,PSYC 3,A00,890679,Staff,17,0,20,3
1746605357655,PSYC 6,A00,959858,Staff,19,0,20,1
1746605358683,PSYC 60,A01,890684,Rickard; Timothy C.,0,6,45,45
1746605359711,PSYC 70,A01,890689,Geller; Emma Harlan,6,0,30,24
1746605360737,PSYC 71,A01,959860,Staff,21,0,25,4
1746605361768,PSYC 100,A00,890690,Lacefield; Katharine I,0,50,180,180
1746605362794,PSYC 102,A00,890695,Staff,18,0,40,22
1746605363820,PSYC 105,A00,890699,Geller; Emma Harlan,70,0,100,30
1746605364848,PSYC 106,A00,890701,Gorman; Michael R.,5,0,30,25
1746605365875,PSYC 108,A00,890704,Adrian; Julia Anna,0,29,50,50
1746605366903,PSYC 118,A01,890712,Staff,11,0,30,19
1746605367929,PSYC 124,A00,890716,Chapman; Eddie Nathaniel,25,0,60,35
1746605368958,PSYC 131,A00,890717,Anagnostaras; Stephan,0,7,80,80
1746605369986,PSYC 137,A00,890719,Winkielman; Piotr,0,11,30,30
1746605371015,PSYC 144,A00,890721,Adrian; Julia Anna,0,9,45,45
1746605372043,PSYC 162,A00,890805,Staff,0,2,75,75
1746605373068,PSYC 169,A00,890810,Staff,0,15,30,30
1746605374093,PSYC 172,A00,890814,Gorman; Michael R.,9,0,30,21
1746605375122,PSYC 181,A00,890818,Anagnostaras; Stephan,6,0,200,194
1746605376148,PSYC 184,A00,959861,Staff,160,0,175,15
1746605377179,PSYC 189,A00,890823,Staff,0,2,30,30
1746605378210,PSYC 191,A00,890884,Rickard; Timothy C.,0,12,35,35
1746605379267,PSYC 193,A00,890913,Staff,19,0,30,11
1746605379267,PSYC 193,B00,890914,Chapman; Eddie Nathaniel,24,0,30,6
1746605380294,PSYC 193L,A01,890918,Lowe; Angela Beth,20,0,30,10
1746605380294,PSYC 193L,B01,890921,Hurwitz; Ethan Scott,20,0,30,10
1746605380294,PSYC 193L,C01,890928,Staff,30,0,30,0
1746605381321,RELI 149,A00,886806,Rahimi; Babak,23,0,40,17
1746605382348,SE 9,A01,886814,Staff,7,0,20,13
1746605383373,SE 101B,A01,886816,Chadha; Mayank,3,0,35,32
1746605384400,SE 110B,A00,886818,Zhu; Qiang,4,0,75,71
1746605385426,SE 125,A01,886830,Staff,10,0,30,20
1746605386452,SE 130B,A01,886835,Staff,14,0,40,26
1746605387478,SE 131A,A01,886838,Krysl; Petr,34,0,55,21
1746605388520,SE 154,A00,886840,Staff,28,0,50,22
1746605389551,SE 164GS,A01,886849,Staff,6,0,20,14
1746605390576,SE 167GS,A01,886853,Staff,6,0,20,14
1746605391607,SIO 25,A01,890107,Staff,19,0,30,11
1746605392637,SIO 45,A00,890109,Cook; Geoffrey W,115,0,200,85
1746605393668,SIO 109R,A00,890110,Forman; Fonna,0,16,20,20
1746605394695,SIO 187,A01,890114,Kacev; David,15,0,40,25
1746605395724,SOCI 1,A01,890431,Thorpe; Charles Robert,14,0,30,16
1746605395724,SOCI 1,A02,890518,Thorpe; Charles Robert,30,0,30,0
1746605396753,SOCI 2,A01,957978,Staff,25,0,25,0
1746605396753,SOCI 2,A02,957979,Staff,23,0,25,2
1746605397779,SOCI 20,A01,890523,Calderon-Zaks; Michael Aar,21,0,30,9
1746605397779,SOCI 20,A02,890526,Calderon-Zaks; Michael Aar,29,0,30,1
1746605398808,SOCI 30,A01,890533,Pardo Guerra; Juan Pablo,37,0,40,3
1746605399837,SOCI 40,A01,890535,Staff,27,0,45,18
1746605400867,SOCI 104Q,A00,890559,Staff,17,0,30,13
1746605401897,SOCI 106,A00,890560,Arnal; Maud Marie Leonie,20,0,30,10
1746605402925,SOCI 110,A00,890567,Holkenbrink-Monk; Charlene,19,0,30,11
1746605403951,SOCI 112,A00,890568,Victoria Torres; Pablo,2,0,55,53
1746605404985,SOCI 115,A00,890597,Arnal; Maud Marie Leonie,28,0,45,17
1746605407036,SOCI 121,A00,890604,Pardo Guerra; Juan Pablo,38,0,45,7
1746605408062,SOCI 126,A01,890608,Staff,8,0,10,2
1746605409091,SOCI 127,A00,890609,Staff,18,0,30,12
1746605410125,SOCI 131,A00,890610,Thorpe; Charles Robert,37,0,45,8
1746605411150,SOCI 135,A00,890615,Payne; Christine Anna,14,0,45,31
1746605412179,SOCI 139,A00,890620,Staff,38,0,45,7
1746605413203,SOCI 148E,A00,890622,Calderon-Zaks; Michael Aar,36,0,45,9
1746605414230,SOCI 150,A00,890623,Kohler; Kristopher M.,31,0,45,14
1746605415258,SOCI 157,A00,890625,Jules-Rosette; Bennetta W.,18,0,20,2
1746605416284,SOCI 160,A00,890627,Payne; Christine Anna,21,0,45,24
1746605417321,SYN 1,A00,886855,Fish; Gwendolyn Anne,0,1,0,0
1746605417321,SYN 1,B00,906086,Fish; Gwendolyn Anne,0,2,0,2
1746605418356,SYN 2R,A00,886860,Staff,0,17,15,15
1746605418356,SYN 2R,B00,906106,Atkinson; Arthur Laird,0,16,15,15
1746605419385,SYN 100,A01,886866,Browne; Emily,0,28,20,20
1746605419385,SYN 100,B01,906128,Rock; Martin,0,4,20,20
1746605419385,SYN 100,C01,906140,Deavenport; James Cary,0,4,20,20
1746605419385,SYN 100,D01,907816,Deavenport; James Cary,0,5,20,20
1746605420412,TDAC 1,A00,890286,Walsh; Kim C.,7,0,20,13
1746605421641,TDAC 101,A00,890296,Basso; Beatrice,15,0,20,5
1746605422667,TDDE 131,A00,890297,Staff,47,0,50,3
1746605423694,TDDM 1,A00,890287,Weinberg; Sadie,25,0,30,5
1746605424726,TDGE 11,A00,890288,Fulton; Julia,138,0,200,62
1746605424726,TDGE 11,B00,890289,Castro; Robert Jess,184,0,200,16
1746605425754,TDGE 25,B00,957359,Walsh; Kim C.,5,0,20,15
1746605426780,TDGE 40,A01,890292,Power; Jade Yukana,26,0,30,4
1746605427809,TDGE 124,A00,890298,Havis; Allan,0,2,50,50
1746605428839,TDGE 131R,A00,890299,Burelle; Julie Sara Veronique,15,0,42,27
1746605429867,TDHT 101,A00,890300,Staff,10,0,20,10
1746605430899,TDHT 109,A01,890302,Anderson; Mysia Anyse,31,0,40,9
1746605431926,TDMV 1,A00,890293,Arcidiacono; Kristin,18,0,30,12
1746605432954,TDMV 2,A00,890294,Weinberg; Sadie,23,0,30,7
1746605433982,TDMV 3,A00,957878,Arcidiacono; Kristin,28,0,30,2
1746605436046,TDMV 138,A00,890304,Jun; Grace Shin Hae,25,0,40,15
1746605437073,TDMV 140,A00,890305,Corrales; Joseph Bernales,25,0,30,5
1746605438100,TDMV 142,A00,890307,Caligagan; Tony,32,0,40,8
1746605439131,TDMV 144,A00,890308,Camaya; Michelle Ann,25,0,30,5
1746605440158,TDPW 1,A00,890295,Stein; Deborah Isobel,3,0,20,17
1746605441186,USP 2,A01,890272,Lerner; Amy M,7,0,20,13
1746605442213,USP 3,A01,890274,Staff,12,0,30,18
1746605443240,USP 15,A01,890276,Sun; Feiyang,16,0,30,14
1746605444267,USP 25,A00,890277,Shenkman; Michael Thomas,18,0,25,7
1746605445296,USP 138,A00,890278,Staff,13,0,25,12
1746605446325,USP 143,A00,890279,Staff,21,0,70,49
1746605447352,USP 144,A00,890280,Chowdhury; Muhammed Zohir,16,0,30,14
1746605448383,USP 150,A00,890281,Boomhower; Matthew Charles,4,0,30,26
1746605449409,USP 151,A00,890282,Staff,16,0,20,4
1746605450436,USP 162,A00,890283,Andrews; Abigail Leslie,16,0,20,4
1746605451469,USP 168,A00,920477,Kwak; Nancy,0,0,5,5
1746605452501,USP 181,A00,890284,Staff,3,0,20,17
1746605453529,USP 191A,A00,890285,Staff,12,0,20,8
1746605454560,VIS 101,A00,886512,Staff,26,0,75,49
1746605455588,VIS 103,A00,886513,Cruz; Edwin Teddy,61,0,75,14
1746605456614,VIS 108,A00,886514,Staff,4,0,15,11
1746605457640,VIS 127P,A00,886515,Shen; Kuiyi,80,0,146,66
1746605458672,VIS 149,A00,886516,Yoldas; Pinar,0,0,15,15
1746605459716,VIS 164,A00,886526,Erdmann; Dean,19,0,22,3
1746605460745,VIS 194S,A00,886527,Staff,61,0,75,14
1746605461773,WCWP 10A,C00,886484,Martiniuk; Jill,12,0,15,3
1746605462806,WCWP 10B,A00,886490,Uriarte; Emma,0,0,15,15
1746605462806,WCWP 10B,B00,886491,Dhir; Simrita,8,0,15,7
1746605462806,WCWP 10B,C00,886492,Ornelas; Tricia,0,0,15,15
1746605463833,WCWP 100,A00,886494,Young; Mark T,0,6,15,15
1746605465989,AAS 10,A01,886199,Childs; Dennis R.,0,3,0,0
1746605467016,ANAR 104,A01,886940,Shtienberg; Gilad,27,0,30,3
1746605468046,ANAR 120,A00,886953,Staff,13,0,20,7
1746605469076,ANBI 148,A01,886955,Wilder; Linnea Lorene,30,0,40,10
1746605471133,ANSC 122,A00,886957,Staff,24,0,30,6
1746605472161,ANSC 150,A00,886958,Sloane; Julia Kathryn,2,0,15,13
1746605473188,ANSC 156,A00,886959,Jenkins; Janis A.,0,1,15,15
1746605474217,ANSC 180,A00,886960,Staff,11,0,17,6
1746605475244,ANSC 188,A00,886961,Jassal; Aftab,9,0,25,16
1746605476269,ANSC 190,A00,886962,Jassal; Aftab,14,0,25,11
1746605477296,ANSC 191,A00,886963,Staff,18,0,20,2
1746605478323,ANTH 3,A01,891689,Staff,17,0,20,3
1746605479351,ANTH 5,A00,886933,Semendeferi; Ekaterini,16,0,20,4
1746605480378,ANTH 10,A00,886934,Staff,0,12,30,30
1746605481406,ANTH 21,A01,886936,Staff,41,0,60,19
1746605482432,ANTH 23,A01,886938,Staff,92,0,100,8
1746605483462,ANTH 105,A00,886964,Stewart; Alexander B,84,0,100,16
1746605484488,ANTH 108,A00,886965,Pedersen; David,9,0,20,11
1746605485517,AWP 10,001,886147,Staff,0,0,0,0
1746605485517,AWP 10,002,886148,Staff,0,0,0,0
1746605485517,AWP 10,003,886149,Staff,0,0,0,0
1746605485517,AWP 10,004,886150,Staff,0,0,0,0
1746605485517,AWP 10,005,886151,Staff,0,0,0,0
1746605485517,AWP 10,006,886152,Staff,0,0,0,0
1746605485517,AWP 10,007,886153,Staff,0,0,0,0
1746605485517,AWP 10,008,886154,Staff,0,0,0,0
1746605485517,AWP 10,009,886155,Staff,0,0,0,0
1746605485517,AWP 10,010,886156,Staff,0,0,0,0
1746605485517,AWP 10,011,886158,Staff,0,0,0,0
1746605485517,AWP 10,012,886160,Staff,0,0,0,0
1746605485517,AWP 10,013,886161,Staff,0,0,0,0
1746605485517,AWP 10,014,886162,Staff,0,0,0,0
1746605485517,AWP 10,015,886163,Staff,0,0,0,0
1746605485517,AWP 10,016,886164,Staff,0,0,0,0
1746605485517,AWP 10,017,886165,Staff,0,0,0,0
1746605485517,AWP 10,018,886166,Staff,0,0,0,0
1746605485517,AWP 10,019,886168,Staff,0,0,0,0
1746605485517,AWP 10,020,886170,Staff,0,0,0,0
1746605485517,AWP 10,021,886172,Staff,0,0,0,0
1746605486553,AWP 10R,001,886173,Staff,0,1,0,0
1746605486553,AWP 10R,002,886174,Staff,0,1,0,0
1746605486553,AWP 10R,003,886175,Staff,0,0,0,0
1746605486553,AWP 10R,004,886176,Staff,0,0,0,0
1746605486553,AWP 10R,005,886177,Staff,0,0,0,0
1746605486553,AWP 10R,006,886178,Staff,0,0,0,0
1746605486553,AWP 10R,007,886179,Staff,0,0,0,0
1746605486553,AWP 10R,008,886181,Staff,0,0,0,0
1746605486553,AWP 10R,009,886182,Staff,0,0,0,0
1746605486553,AWP 10R,010,886183,Staff,0,0,0,0
1746605486553,AWP 10R,011,886184,Staff,0,0,0,0
1746605486553,AWP 10R,012,886185,Staff,0,0,0,0
1746605486553,AWP 10R,013,886186,Staff,0,0,0,0
1746605486553,AWP 10R,014,886187,Staff,0,0,0,0
1746605486553,AWP 10R,015,886188,Staff,0,0,0,0
1746605486553,AWP 10R,016,886189,Staff,0,0,0,0
1746605486553,AWP 10R,017,960532,Staff,0,0,0,0
1746605486553,AWP 10R,018,960533,Staff,0,0,0,0
1746605486553,AWP 10R,019,960534,Staff,0,0,0,0
1746605486553,AWP 10R,020,960538,Staff,0,0,0,0
1746605486553,AWP 10R,021,960540,Staff,0,0,0,0
1746605486553,AWP 10R,022,960541,Staff,0,0,0,0
1746605486553,AWP 10R,023,960542,Staff,0,0,0,0
1746605486553,AWP 10R,024,960544,Staff,0,0,0,0
1746605486553,AWP 10R,025,960545,Staff,0,0,0,0
1746605486553,AWP 10R,026,960548,Staff,0,0,0,0
1746605487579,AWP 102R,A00,886190,Staff,0,0,0,0
1746605487579,AWP 102R,B00,886191,Staff,0,0,0,0
1746605488609,BENG 100,A01,886193,Staff,17,0,30,13
1746605489643,BENG 122A,A01,886195,Hasty; Jeff M,13,0,30,17
1746605490669,BENG 166A,A00,886196,Sah; Robert Lie-Yuan,0,3,30,30
1746605491698,BENG 190,A00,958050,Khojah; Reem I,17,0,25,8
1746605492724,BIBC 102,A01,894320,Staff,0,1,46,46
1746605492724,BIBC 102,A02,894321,Staff,0,0,46,46
1746605492724,BIBC 102,A03,894344,Staff,6,0,46,40
1746605492724,BIBC 102,A04,894345,Staff,27,0,47,20
1746605493753,BICD 100R,A01,894365,Smith; Laurie,0,2,58,58
1746605493753,BICD 100R,A02,894366,Smith; Laurie,0,4,58,58
1746605493753,BICD 100R,A03,894367,Smith; Laurie,0,0,59,59
1746605493753,BICD 100R,A04,959869,Smith; Laurie,38,0,59,21
1746605494795,BICD 136,A01,894383,Gustafson-Brown; Cindy,14,0,50,36
1746605495831,BIEB 102,A01,894494,Butler; Shannon Rhey,51,0,130,79
1746605497893,BIEB 150,A01,894617,Wills; Christopher,3,0,20,17
1746605497893,BIEB 150,A02,894631,Wills; Christopher,3,0,20,17
1746605497893,BIEB 150,A03,894937,Wills; Christopher,3,0,20,17
1746605497893,BIEB 150,A04,894946,Wills; Christopher,5,0,20,15
1746605498921,BIEB 194,A00,906141,Kurle; Carolyn M.,5,0,20,15
1746605499949,BILD 1,A01,894154,Staff,3,0,19,16
1746605499949,BILD 1,A02,894155,Staff,14,0,19,5
1746605499949,BILD 1,A03,894160,Staff,13,0,19,6
1746605499949,BILD 1,A04,894161,Staff,15,0,18,3
1746605500976,BILD 2,A01,894168,Staff,0,0,50,50
1746605500976,BILD 2,A02,894169,Staff,0,0,50,50
1746605500976,BILD 2,A03,894179,Staff,0,0,50,50
1746605500976,BILD 2,A04,894203,Staff,22,0,50,28
1746605502005,BILD 3,A01,894213,Staff,23,0,31,8
1746605502005,BILD 3,A02,894214,Staff,26,0,31,5
1746605502005,BILD 3,A03,894235,Staff,28,0,31,3
1746605502005,BILD 3,A04,894236,Staff,28,0,32,4
1746605503035,BILD 4,A01,894253,Reuther; Keefe,5,0,24,19
1746605503035,BILD 4,A02,894258,Reuther; Keefe,16,0,24,8
1746605504066,BILD 5,A01,894276,Reuther; Keefe,34,0,50,16
1746605504066,BILD 5,A02,894277,Reuther; Keefe,45,0,50,5
1746605504066,BILD 5,A03,894290,Reuther; Keefe,44,0,50,6
1746605504066,BILD 5,A04,894291,Reuther; Keefe,48,0,50,2
1746605505102,BILD 24,A01,894297,Pirino; Giorgia,40,0,60,20
1746605506131,BIMM 100,B01,958915,Staff,71,0,100,29
1746605507160,BIMM 101,A01,895017,McDonnell; Lisa Marie,0,5,24,24
1746605507160,BIMM 101,A02,895018,McDonnell; Lisa Marie,0,5,24,24
1746605507160,BIMM 101,B01,895020,McDonnell; Lisa Marie,0,5,24,24
1746605507160,BIMM 101,B02,895021,McDonnell; Lisa Marie,0,4,24,24
1746605508187,BIMM 110,A01,895023,Staff,1,0,25,24
1746605508187,BIMM 110,A02,895024,Staff,9,0,25,16
1746605508187,BIMM 110,A03,895025,Staff,18,0,25,7
1746605508187,BIMM 110,A04,895031,Staff,20,0,25,5
1746605509218,BIMM 120,A01,895114,Gustafson-Brown; Cindy,14,0,28,14
1746605509218,BIMM 120,A02,895126,Gustafson-Brown; Cindy,21,0,27,6
1746605510245,BIPN 100,A01,895130,Yang; Mingyu,0,0,38,38
1746605510245,BIPN 100,A02,895131,Yang; Mingyu,31,0,38,7
1746605510245,BIPN 100,A03,895132,Yang; Mingyu,32,0,38,6
1746605510245,BIPN 100,A04,895133,Yang; Mingyu,27,0,36,9
1746605511278,BIPN 120,A01,895135,Cooke; James Edward,0,3,13,13
1746605511278,BIPN 120,A02,895136,Cooke; James Edward,0,1,13,13
1746605511278,BIPN 120,A03,895137,Cooke; James Edward,0,3,13,13
1746605511278,BIPN 120,A04,895156,Cooke; James Edward,0,2,11,11
1746605512313,BIPN 134,A01,895235,Cooke; James Edward,0,1,25,25
1746605512313,BIPN 134,A02,895237,Cooke; James Edward,0,0,25,25
1746605512313,BIPN 134,A03,895240,Cooke; James Edward,1,0,25,24
1746605512313,BIPN 134,A04,895270,Cooke; James Edward,20,0,25,5
1746605513346,BIPN 189,A00,892103,Staff,0,14,14,14
1746605515398,BISP 194,A00,958008,Staff,0,2,0,0
1746605516464,CAT 124,A01,922009,Staff,0,5,20,20
1746605517558,CAT 125R,A00,886390,Morales; Celeste Georgianna,0,4,20,20
1746605517558,CAT 125R,B00,886391,Irwin; Matthew Joseph,0,4,20,20
1746605517558,CAT 125R,C00,886392,Smith; Lauryn Alissa,0,2,20,20
1746605517558,CAT 125R,D00,886393,Vanderschuit; Maya Alysia,0,3,20,20
1746605517558,CAT 125R,E00,886394,Marchisotto; Jennifer Anne,0,3,20,20
1746605518586,CENG 15,A01,886218,Drews; Aaron,3,0,8,5
1746605519613,CENG 113,A00,886219,Opatkiewicz; Justin Paul,15,0,25,10
1746605520641,CGS 101,A00,887044,Staff,7,0,20,13
1746605521671,CGS 105,A01,887046,Staff,14,0,25,11
1746605522699,CGS 112,A00,887047,Cuong; Marisol,12,0,15,3
1746605523728,CGS 113,A00,887048,Staff,23,0,30,7
1746605524757,CGS 120,A00,887049,Staff,9,0,17,8
1746605525789,CHEM 6A,A01,886336,Lam; Tin Yiu,38,0,50,12
1746605525789,CHEM 6A,A02,886338,Lam; Tin Yiu,37,0,50,13
1746605526815,CHEM 6B,A01,886341,Hopkins; Patrycja Anna,16,0,50,34
1746605526815,CHEM 6B,A02,886343,Hopkins; Patrycja Anna,42,0,50,8
1746605527844,CHEM 6C,A01,886346,Albizati; Kim F.,0,2,50,50
1746605527844,CHEM 6C,A02,886348,Albizati; Kim F.,24,0,50,26
1746605528870,CHEM 40A,A01,886352,Klosterman; Jeremy K,65,0,100,35
1746605529895,CHEM 40B,A01,886356,Klosterman; Jeremy K,0,24,100,100
1746605530922,CHEM 41B,A01,886360,Theodorakis; Emmanuel,25,0,50,25
1746605530922,CHEM 41B,A02,886362,Theodorakis; Emmanuel,47,0,50,3
1746605531953,CHIN 165A,A00,886382,Xu; Li,18,0,20,2
1746605532979,CLAS 120,A00,886387,Myerston Santana; Jacobo,33,0,40,7
1746605534008,COGS 9,A01,886967,Shannon; Kyle Michael,42,0,60,18
1746605535054,COGS 11,A01,886969,Staff,9,0,30,21
1746605536082,COGS 14A,A01,886971,Staff,5,0,60,55
1746605537109,COGS 14B,A01,886973,Hoffman; Drew Ellen,4,0,60,56
1746605538143,COGS 18,A01,886975,Morgan; Eric,34,0,60,26
1746605539169,COGS 20,A01,886977,Staff,3,0,8,5
1746605539169,COGS 20,A02,886978,Staff,5,0,7,2
1746605540200,COGS 100,A01,907783,Staff,0,1,30,30
1746605541231,COGS 101B,A01,886980,Staff,0,4,48,48
1746605542261,COGS 101C,A01,886982,Delgado; Tania,0,5,44,44
1746605543289,COGS 102A,A01,886984,Johnson; Christine M.,3,0,30,27
1746605544319,COGS 118B,A01,886986,Staff,0,4,88,88
1746605545359,COGS 150,A01,886988,Bergen; Benjamin,22,0,50,28
1746605546391,COGS 153,A00,886989,Delgado; Tania,1,3,41,40
1746605547419,COGS 186,A01,886991,Staff,0,0,32,32
1746605548450,COGS 187A,A01,886993,Boyle; Mary E. T.,7,0,30,23
1746605549478,COGS 189,A00,886994,Staff,0,1,30,30
1746605550507,COMM 10,A01,886996,Staff,0,0,20,21
1746605550507,COMM 10,A02,886997,Staff,10,0,20,10
1746605550507,COMM 10,A03,959845,Staff,19,0,20,1
1746605551536,COMM 20,A01,886999,Leuning; Grant Maurstad,24,0,40,16
1746605553592,COMM 100A,A01,887002,Staff,0,0,20,25
1746605553592,COMM 100A,A02,887003,Staff,5,0,20,15
1746605554619,COMM 100B,A01,887005,Staff,0,8,20,24
1746605555646,COMM 106D,A00,887006,Staff,14,0,40,26
1746605556672,COMM 110G,A00,887007,Whitworth-Smith; Andrew C,12,0,40,28
1746605557703,COMM 111B,A00,887008,Staff,31,0,40,9
1746605558730,COMM 113T,A00,887009,Abuelhiga; Soraya Jill,28,0,40,12
1746605558730,COMM 113T,B00,906733,Staff,39,0,40,1
1746605559772,COMM 145,A00,887010,Staff,13,0,40,27
1746605560802,COMM 146,A00,887054,Staff,32,0,40,8
1746605561830,COMM 190,A00,887012,Staff,8,0,23,15
1746605562857,CSE 8A,A50,887015,Cao; Yingjun,56,0,85,29
1746605563887,CSE 11,A01,887017,Cao; Yingjun,11,0,70,59
1746605564917,CSE 20,A01,887019,Staff,30,0,50,20
1746605565945,CSE 21,A01,887021,Staff,79,0,100,21
1746605565945,CSE 21,B01,892583,Braun; Oliver,45,0,50,5
1746605566970,CSE 30,A01,887025,Eldon; John,142,0,200,58
1746605567996,CSE 100,A01,887027,Staff,26,0,50,24
1746605567996,CSE 100,A02,887028,Staff,42,0,50,8
1746605569029,CSE 101,A01,887030,Braun; Oliver,74,0,100,26
1746605569029,CSE 101,B01,887032,Jones; Miles E,0,3,50,50
1746605569029,CSE 101,B02,887033,Jones; Miles E,0,2,50,50
1746605570057,CSE 105,A01,908084,Jones; Miles E,32,0,50,18
1746605570057,CSE 105,A02,908087,Jones; Miles E,31,0,50,19
1746605571089,CSE 135,A01,887035,Powell; Thomas Allan,0,5,50,50
1746605572114,CSE 142,A01,887037,Staff,7,0,60,53
1746605573140,CSE 142L,A01,887039,Staff,34,0,60,26
1746605574167,CSE 151A,A01,887041,Solares; Edwin A,47,0,100,53
1746605575196,CSE 175,A01,887043,Kumar; Rakesh,30,0,30,0
1746605576229,CSS 1,A01,886389,Staff,0,1,40,40
1746605577255,DSC 30,A01,908097,Liao; Soohyun Nam,47,0,75,28
1746605578282,DSC 40A,A01,908099,Shannon; Kyle Michael,30,0,50,20
1746605579308,DSC 40B,A01,908112,Staff,15,0,50,35
1746605580334,DSC 80,A01,908116,Staff,19,0,60,41
1746605581361,DSC 197,001,956863,Eldridge; Justin Matthew,9999,0,9999,0
1746605582398,ECE 5,A01,886400,Morris; Karcher William,1,0,6,5
1746605582398,ECE 5,A02,886401,Morris; Karcher William,3,0,6,3
1746605583425,ECE 148,A01,886403,Silberman; Jack,0,14,14,14
1746605584450,ECON 1,A01,887265,Crane; Meredith Helen,11,0,70,59
1746605584450,ECON 1,B01,887268,Staff,42,0,50,8
1746605585476,ECON 2,A01,887273,Crane; Meredith Helen,54,0,70,16
1746605586505,ECON 3,A01,887279,Rondina; Giacomo,31,0,70,39
1746605587532,ECON 4,A01,887282,Anderson; John Charles,0,2,10,10
1746605588561,ECON 5,A01,887285,Staff,34,0,45,11
1746605588561,ECON 5,B01,887292,Staff,41,0,45,4
1746605589597,ECON 100A,A01,887337,Newhouse; Herbert S,54,0,70,16
1746605589597,ECON 100A,B01,887349,Staff,45,0,50,5
1746605590622,ECON 100B,A01,887361,Du; Songzi,29,0,70,41
1746605591649,ECON 100C,A01,887445,Newhouse; Herbert S,59,0,70,11
1746605592679,ECON 105,A00,887488,Vespa; Emanuel Ignacio,23,0,35,12
1746605593707,ECON 109,A01,887506,Shishkin; Denis,28,0,35,7
1746605594745,ECON 110A,A01,887568,Alon; Titan Michael,0,2,35,35
1746605594745,ECON 110A,B01,907601,Alon; Titan Michael,20,0,35,15
1746605595771,ECON 110B,A01,887598,Levkoff; Steven B.,0,24,70,70
1746605596798,ECON 112,A00,887599,Rondina; Giacomo,19,0,35,16
1746605597829,ECON 120A,A01,887603,Dai; Yinlin,36,0,70,34
1746605598867,ECON 120C,A01,887608,Sun; Yixiao,0,1,35,35
1746605598867,ECON 120C,B01,887614,Sun; Yixiao,0,0,35,35
1746605599893,ECON 138,A00,887621,Bharadwaj; Prashant,0,21,20,20
1746605600918,ECON 144,A00,958007,Squires; Dale E,11,0,35,24
1746605601946,ECON 171,A01,907666,Staff,18,0,35,17
1746605602972,ECON 175,A00,887626,Wu; Pak Yeung,22,0,35,13
1746605604005,ECON 190,A00,887640,Vespa; Emanuel Ignacio,22,0,35,13
1746605605036,EDS 25,A01,888197,Staff,0,0,0,0
1746605605036,EDS 25,A02,888209,Staff,0,0,0,0
1746605605036,EDS 25,A03,888210,Staff,0,0,0,0
1746605605036,EDS 25,A04,888212,Staff,0,0,0,0
1746605605036,EDS 25,A05,888213,Staff,0,0,0,0
1746605605036,EDS 25,A06,888214,Staff,0,0,0,0
1746605605036,EDS 25,A07,888235,Staff,0,2,0,0
1746605605036,EDS 25,A08,888236,Staff,0,0,0,0
1746605605036,EDS 25,A09,888240,Staff,0,0,0,0
1746605605036,EDS 25,A10,888244,Staff,0,0,0,0
1746605605036,EDS 25,B01,888273,Staff,0,0,0,0
1746605605036,EDS 25,B02,888285,Staff,0,0,0,0
1746605605036,EDS 25,B03,888423,Staff,0,0,0,1
1746605605036,EDS 25,B04,888432,Staff,0,0,0,0
1746605605036,EDS 25,B05,888433,Staff,0,0,0,0
1746605605036,EDS 25,B06,888467,Staff,0,0,0,0
1746605605036,EDS 25,B07,888468,Staff,0,0,0,0
1746605605036,EDS 25,B08,888479,Staff,0,0,0,0
1746605605036,EDS 25,B09,888484,Staff,0,0,0,0
1746605605036,EDS 25,B10,888487,Staff,0,0,0,0
1746605606063,EDS 38,A01,907700,Choi; Bailey Miyeon,30,0,30,0
1746605607097,EDS 112,A01,888601,Chapman; Thandeka K,12,0,40,28
1746605608124,EDS 115,A00,888697,Mendez; Kathrina Mendoza,10,0,30,20
1746605609155,EDS 116,A01,888893,Staff,33,0,40,7
1746605611211,EDS 124AR,A00,889133,Staff,29,0,50,21
1746605611211,EDS 124AR,B00,907471,Simon; Elizabeth A,37,0,50,13
1746605612235,EDS 124BR,A00,889134,Simon; Elizabeth A,44,0,100,56
1746605613264,EDS 125,A00,889135,Staff,25,0,30,5
1746605614290,EDS 126,A01,889138,Staff,35,0,40,5
1746605615318,EDS 164R,A01,889142,Wishard Guerra; Alison G.,32,0,50,18
1746605616346,ENG 30,A01,886396,Staff,0,0,0,0
1746605616346,ENG 30,B01,886398,Staff,0,0,0,0
1746605617372,ENVR 102,A00,906150,Montejo; Carolina,23,0,25,2
1746605618406,ETHN 103A,A00,887236,Man; Simeon S,0,2,0,0
1746605619431,ETHN 113,A00,887239,Staff,16,0,30,14
1746605620458,ETHN 116,A00,887240,Staff,16,0,25,9
1746605621486,ETHN 117,A00,887241,Choi; Esther Min,28,0,30,2
1746605622516,ETHN 118,A00,887243,Staff,24,0,30,6
1746605623542,ETHN 127,A00,887248,Cuong; Marisol,11,0,15,4
1746605624571,ETHN 139,A00,887250,Staff,7,0,10,3
1746605625601,ETHN 142,A00,887252,Staff,9,0,30,21
1746605626631,ETHN 161,A00,887253,Browne; Errol Tsekani,24,0,30,6
1746605627656,ETHN 163FR,A00,887255,Burelle; Julie Sara Veronique,0,0,5,5
1746605628683,GLBH 20,A00,889149,Elwardani; Nile Regina,8,0,42,34
1746605630737,GLBH 111,A01,889152,Burgos; Jose L.,17,0,17,0
1746605631764,GLBH 150,A00,889181,Sloane; Julia Kathryn,0,5,15,15
1746605633815,HDS 60,A01,886406,Warstadt; Melissa Fawn,72,0,80,8
1746605634842,HIAF 111,A00,889324,Gyamfi; Bright,25,0,32,7
1746605635872,HIEA 131,A00,889328,Staff,15,0,32,17
1746605636900,HIEA 144,A00,889333,Henry; Todd A.,26,0,32,6
1746605637934,HIEA 154,A00,889336,Henry; Todd A.,24,0,32,8
1746605638963,HIEU 106,A00,889339,Staff,22,0,32,10
1746605641017,HIEU 114,A00,889340,Staff,4,0,32,28
1746605642042,HIEU 135GS,A00,889342,Patterson; Patrick H.,0,0,1,24
1746605643069,HIEU 137,A00,889343,Edington; Claire Ellen,10,0,25,15
1746605644099,HIEU 148,A00,889345,Staff,14,0,32,18
1746605645130,HIEU 154,A00,889346,Biess; Frank Peter,21,0,32,11
1746605646157,HILA 102,A00,889351,Staff,12,0,32,20
1746605647183,HILD 2A,A01,889221,Lewandoski; Julia Mavis,0,8,32,32
1746605648213,HILD 7B,A01,889225,Man; Simeon S,0,12,32,32
1746605649240,HILD 7C,A01,889288,Alvarez; Luis A,0,14,32,32
1746605650265,HILD 30,A01,889323,Staff,0,5,32,32
1746605652325,HISC 119,A00,889383,Golan; Tal,20,0,32,12
1746605653354,HIUS 103,A00,889384,Man; Simeon S,0,0,32,32
1746605654380,HIUS 117,A00,919797,Kwak; Nancy,18,0,32,14
1746605655407,HIUS 142A,A00,919788,Staff,22,0,32,10
1746605657460,HIUS 149,A00,889386,Gyamfi; Bright,26,0,32,6
1746605658491,HIUS 155,A00,889387,Alvarez; Luis A,15,0,32,17
1746605659518,HUM 3,A01,886499,Caldwell; Michael Alan,19,0,50,31
1746605660543,HUM 3GS,A00,886500,Rodriguez; Bretton Sigfred,0,0,0,28
1746605661571,HUM 3R,A01,886502,Markman; Kristina,0,36,50,50
1746605662598,HUM 4,A01,886504,Crum; Matthew Stephen,23,0,50,27
1746605662598,HUM 4,B01,886506,West; Geoffrey Scott,17,0,50,33
1746605663624,HUM 4GS,A00,886507,Staff,0,0,0,19
1746605664652,HUM 5,A01,886509,Staff,31,0,50,19
1746605665678,HUM 5R,A01,886511,Zavodny; Tatiana Sophia,0,39,50,50
1746605666704,JAPN 180,A00,886407,Staff,16,0,40,24
1746605667737,LATI 50,A01,886409,Martin-Cabrera; Luis,3,0,22,19
1746605667737,LATI 50,A02,886410,Martin-Cabrera; Luis,19,0,22,3
1746605667737,LATI 50,A03,886411,Martin-Cabrera; Luis,21,0,22,1
1746605667737,LATI 50,A04,886412,Martin-Cabrera; Luis,8,0,22,14
1746605668764,LAWS 101,A00,907664,Staff,28,0,60,32
1746605669800,LIAB 1A,A00,889388,Saab; Dima,17,0,20,3
1746605670832,LIAB 1AX,A00,889389,El Cheddadi; Youniss,18,0,20,2
1746605671857,LIFR 1C,A00,889391,Van Moer; Vinciane G,8,0,20,12
1746605672885,LIFR 1CX,A00,889392,Van Moer; Vinciane G,7,0,20,13
1746605673914,LIFR 1D,A00,889393,Van Moer; Vinciane G,7,0,20,13
1746605674948,LIFR 1DX,A00,889394,Van Moer; Vinciane G,8,0,20,12
1746605675977,LIGN 7,A00,886923,Staff,25,0,50,25
1746605677004,LIGN 17,A00,886924,Kehler; Andrew Scott,126,0,150,24
1746605678032,LTAM 110,A00,889395,Staff,15,0,30,15
1746605679062,LTAM 110GS,A00,958010,Rodriguez; Bretton Sigfred,0,0,0,28
1746605680090,LTCH 101,A00,889397,Staff,23,0,25,2
1746605681118,LTCS 130,A00,889398,Staff,23,0,25,2
1746605682144,LTEA 138,A00,889399,Staff,24,0,40,16
1746605683172,LTEN 149,A00,889400,Wesling; Megan E.,0,3,25,25
1746605684201,LTEN 169,A00,889401,Staff,20,0,25,5
1746605685228,LTEN 180,A00,889402,Staff,10,0,15,5
1746605686258,LTEN 181,A00,889403,Staff,21,0,25,4
1746605687289,LTWL 100,A00,889404,Myerston Santana; Jacobo,2,0,25,23
1746605688319,LTWL 180GS,A00,889405,Staff,0,0,20,20
1746605689343,LTWL 181,A00,889406,Staff,16,0,25,9
1746605690376,LTWL 184,A00,889475,Mukherjee; Silpa,22,0,25,3
1746605691403,LTWR 102C,A00,889486,Staff,29,0,30,1
1746605692428,LTWR 115W,A00,889491,Staff,0,2,15,15
1746605693456,MAE 8,A01,886905,Staff,0,2,0,0
1746605694488,MAE 11,A00,886906,Bandaru; Prabhakar,0,7,50,50
1746605695515,MAE 20,A00,886907,Evdokimenko; Ekaterina,43,0,70,27
1746605696544,MAE 30B,A00,886909,Ghazinejad; Maziar,25,0,45,20
1746605697577,MAE 101B,A00,886910,Saintillan; David,30,0,45,15
1746605698606,MAE 105,A00,886911,Bandaru; Prabhakar,18,0,50,32
1746605699633,MAE 107,B00,958024,Staff,7,0,50,43
1746605700659,MAE 143B,A00,886913,Bewley; Thomas R,2,0,40,38
1746605701688,MAE 148,A01,886915,Silberman; Jack,0,3,14,14
1746605702714,MAE 160,A00,886916,Evdokimenko; Ekaterina,30,0,60,30
1746605703759,MATH 3C,A01,889681,Staff,0,2,30,30
1746605703759,MATH 3C,A02,960048,Staff,23,0,30,7
1746605704790,MATH 10A,A01,889760,Staff,26,0,30,4
1746605704790,MATH 10A,A02,889783,Staff,29,0,30,1
1746605705819,MATH 10B,A01,889785,Verstraete; Jacques Allan,1,0,35,34
1746605705819,MATH 10B,A02,889795,Verstraete; Jacques Allan,4,0,35,31
1746605705819,MATH 10B,B01,889797,Verstraete; Jacques Allan,3,0,35,32
1746605705819,MATH 10B,B02,889828,Verstraete; Jacques Allan,3,0,35,32
1746605706847,MATH 10C,A01,889849,Habib; Yousaf,8,0,30,22
1746605706847,MATH 10C,A02,889852,Habib; Yousaf,14,0,30,16
1746605706847,MATH 10C,A03,889853,Habib; Yousaf,22,0,30,8
1746605706847,MATH 10C,A04,889858,Habib; Yousaf,20,0,30,10
1746605706847,MATH 10C,B01,889861,Staff,1,0,30,29
1746605706847,MATH 10C,B02,889862,Staff,24,0,30,6
1746605706847,MATH 10C,B03,889863,Staff,27,0,30,3
1746605706847,MATH 10C,B04,889967,Staff,23,0,30,7
1746605707873,MATH 18,A01,889974,Staff,6,0,30,24
1746605707873,MATH 18,A02,889977,Staff,20,0,30,10
1746605707873,MATH 18,B01,889984,Hardiman; Liam,20,0,30,10
1746605707873,MATH 18,B02,889985,Hardiman; Liam,25,0,30,5
1746605708900,MATH 20A,A01,889990,Suk; Andrew Hoon,30,0,35,5
1746605709953,MATH 20B,A01,889993,Ohm; Ko Woon,21,0,30,9
1746605709953,MATH 20B,A02,889994,Ohm; Ko Woon,30,0,30,0
1746605709953,MATH 20B,B01,889996,Ohm; Ko Woon,22,0,30,8
1746605709953,MATH 20B,B02,889997,Ohm; Ko Woon,23,0,30,7
1746605710989,MATH 20C,A01,889999,Hammock; Frances H,17,0,30,13
1746605710989,MATH 20C,A02,890003,Hammock; Frances H,23,0,30,7
1746605710989,MATH 20C,B01,890006,Hammock; Frances H,2,0,30,28
1746605710989,MATH 20C,B02,890007,Hammock; Frances H,11,0,30,19
1746605712023,MATH 20D,A01,890011,Cheng; Hsiao-Bing,1,0,30,29
1746605712023,MATH 20D,A02,890012,Cheng; Hsiao-Bing,14,0,30,16
1746605712023,MATH 20D,B01,890016,Cheng; Hsiao-Bing,13,0,30,17
1746605712023,MATH 20D,B02,890017,Cheng; Hsiao-Bing,13,0,30,17
1746605713058,MATH 20E,A01,890026,Harel; Guershon,1,0,30,29
1746605713058,MATH 20E,A02,890029,Harel; Guershon,22,0,30,8
1746605713058,MATH 20E,B01,890033,Harel; Guershon,7,0,30,23
1746605713058,MATH 20E,B02,890101,Harel; Guershon,21,0,30,9
1746605714084,MATH 102,A01,890104,Staff,18,0,30,12
1746605714084,MATH 102,A02,890105,Staff,27,0,30,3
1746605715117,MATH 103B,A01,890116,Salehi Golsefidy; Alireza,3,0,30,27
1746605715117,MATH 103B,B01,890118,Staff,0,3,34,34
1746605716150,MATH 109,A01,890121,Aliabadi Sr.; Mohsen,0,0,30,30
1746605716150,MATH 109,B01,890124,Upadrashta; Pranav Kumar,18,0,30,12
1746605717181,MATH 120A,A01,890126,Eggers; John Dietrich,13,0,30,17
1746605718206,MATH 142B,A01,890128,Ioana; Adrian,19,0,30,11
1746605718206,MATH 142B,A02,890129,Ioana; Adrian,12,0,30,18
1746605719233,MATH 154,A01,890174,Staff,0,1,30,30
1746605719233,MATH 154,A02,890182,Staff,0,0,30,30
1746605720266,MATH 168A,A01,890197,Dumitriu; Ioana,21,0,35,14
1746605721300,MATH 170A,A01,890240,Nie; Jiawang,1,0,30,29
1746605721300,MATH 170A,A02,890241,Nie; Jiawang,11,0,30,19
1746605721300,MATH 170A,A03,890249,Nie; Jiawang,23,0,30,7
1746605722331,MATH 170B,A01,957891,Nag; Panchali,13,0,35,22
1746605724391,MATH 181A,A01,908025,Staff,0,3,35,35
1746605724391,MATH 181A,A02,960115,Staff,26,0,35,9
1746605725423,MATH 181B,A01,959874,Staff,24,0,30,6
1746605726450,MATH 193B,A01,890265,Staff,0,4,35,35
1746605727476,MGT 4,A01,890311,Anderson; John Charles,42,0,88,46
1746605728501,MGT 5,A00,907740,Staff,12,0,98,86
1746605729526,MGT 12,A00,890312,Lindenberger; Wade Douglas,67,0,98,31
1746605730551,MGT 16,A00,957883,Staff,78,0,98,20
1746605732606,MGT 45,A00,890314,Pecore; Joseph P.,45,0,98,53
1746605733633,MGT 71,A00,890315,Staff,0,12,98,98
1746605734661,MGT 100,A00,890316,Yavorsky; Daniel Ryan,44,0,98,54
1746605735688,MGT 103,A00,890317,Ehrich; Kristine R,73,0,98,25
1746605736713,MGT 105,A00,890356,Bates; Kenneth Walter,0,8,98,98
1746605737738,MGT 112,A00,890360,Ehrich; Kristine R,55,0,98,43
1746605738773,MGT 127R,A00,907732,Zhu; Kevin Xiaoguo,23,0,98,75
1746605739798,MGT 131B,A00,890361,Anderson; John Charles,59,0,98,39
1746605740824,MGT 137,A00,890362,Lindenberger; Wade Douglas,65,0,98,33
1746605741854,MGT 160,A00,890369,Johnson; Erik Barry,9,0,98,89
1746605743911,MGT 164,A00,890372,Zimmermann; Carsten,0,40,98,98
1746605744940,MGT 180,A00,890374,Bliss; Barbara Ann,11,0,98,87
1746605745967,MMW 15,A01,886414,Chang; Edmond Yi-Teh,0,12,28,28
1746605745967,MMW 15,A02,886415,Chang; Edmond Yi-Teh,0,8,28,28
1746605745967,MMW 15,A03,886416,Chang; Edmond Yi-Teh,0,9,28,28
1746605745967,MMW 15,A04,886417,Chang; Edmond Yi-Teh,0,8,28,28
1746605745967,MMW 15,B01,886419,Chang; Edmond Yi-Teh,0,7,28,28
1746605745967,MMW 15,B02,886420,Chang; Edmond Yi-Teh,0,7,28,28
1746605745967,MMW 15,B03,886421,Chang; Edmond Yi-Teh,0,7,28,28
1746605745967,MMW 15,B04,886422,Chang; Edmond Yi-Teh,0,8,28,28
1746605745967,MMW 15,C01,886424,Staff,0,9,28,28
1746605745967,MMW 15,C02,886425,Staff,0,8,28,28
1746605745967,MMW 15,C03,886426,Staff,0,8,28,28
1746605745967,MMW 15,C04,886427,Staff,0,8,28,28
1746605745967,MMW 15,C05,958038,Staff,0,8,28,28
1746605745967,MMW 15,C06,958039,Staff,0,7,28,28
1746605746994,MMW 15GS,A00,906910,Patterson; Patrick H.,4,0,28,24
1746605748021,MMW 122R,A01,886429,Rahimi; Babak,0,13,28,28
1746605748021,MMW 122R,A02,886430,Rahimi; Babak,0,12,28,28
1746605748021,MMW 122R,A03,958040,Rahimi; Babak,0,11,28,28
1746605749050,MUS 1A,A01,890937,Staff,2,0,25,23
1746605749050,MUS 1A,A02,891035,Staff,6,0,25,19
1746605749050,MUS 1A,C01,958912,Staff,24,0,25,1
1746605749050,MUS 1A,C02,958913,Staff,25,0,25,0
1746605751103,MUS 2AK,A00,957092,Ohnishi; Takae,15,0,15,0
1746605752133,MUS 4,A01,891044,Staff,0,0,25,25
1746605752133,MUS 4,A02,891045,Staff,22,0,25,3
1746605752133,MUS 4,B01,891048,Staff,17,0,25,8
1746605752133,MUS 4,B02,891050,Staff,25,0,25,0
1746605753163,MUS 5,A01,957506,Dubnov; Shlomo,0,0,25,25
1746605753163,MUS 5,A02,957622,Dubnov; Shlomo,12,0,25,13
1746605753163,MUS 5,A03,957623,Dubnov; Shlomo,20,0,25,5
1746605754189,MUS 6,A01,891053,Freitas Caetano; Marcelo,24,0,25,1
1746605754189,MUS 6,A02,891054,Freitas Caetano; Marcelo,23,0,25,2
1746605755213,MUS 7,A01,891081,Staff,0,0,25,25
1746605755213,MUS 7,A02,891082,Staff,3,0,25,22
1746605756243,MUS 8GS,A00,891118,Borgo; David Garcia,1,0,25,24
1746605757268,MUS 11,A01,891140,Staff,8,0,25,17
1746605757268,MUS 11,A02,891141,Staff,21,0,25,4
1746605758295,MUS 13,A01,891143,Staff,8,0,25,17
1746605758295,MUS 13,A02,891144,Staff,24,0,25,1
1746605759322,MUS 15,A01,891146,Staff,9,0,25,16
1746605759322,MUS 15,A02,891148,Staff,21,0,25,4
1746605759322,MUS 15,B01,891150,Staff,18,0,25,7
1746605759322,MUS 15,B02,891151,Staff,25,0,25,0
1746605760352,MUS 20,A01,891153,Staff,5,0,20,15
1746605760352,MUS 20,A02,891155,Staff,14,0,20,6
1746605761386,MUS 80,A00,891156,Staff,19,0,25,6
1746605761386,MUS 80,B00,891157,Staff,23,0,25,2
1746605762424,MUS 130,A00,891158,Ohnishi; Takae,35,0,35,0
1746605763454,MUS 150GS,A01,891160,Borgo; David Garcia,1,0,25,24
1746605764484,MUS 170,A01,891162,Freitas Caetano; Marcelo,20,0,25,5
1746605764484,MUS 170,A02,891164,Freitas Caetano; Marcelo,21,0,25,4
1746605765518,NANO 11,A00,886220,Vazquez Mena; Oscar,13,0,15,2
1746605766545,NANO 15,A01,886222,Drews; Aaron,4,0,7,3
1746605767571,NANO 104,A00,886224,Sirbuly; Donald,17,0,25,8
1746605768598,PH 40,A00,886528,Staff,23,0,40,17
1746605769628,PH 45,A01,886799,Staff,35,0,40,5
1746605770654,PH 110,A00,886802,Staff,0,6,40,40
1746605771680,PH 172,A00,906716,Staff,19,0,35,16
1746605772707,PH 191,A00,886803,Staff,6,0,40,34
1746605773735,PHIL 1,A00,889500,Staff,20,0,30,10
1746605774797,PHIL 10,A01,889549,Grush; Rick Scott,16,0,22,6
1746605774797,PHIL 10,A02,889551,Grush; Rick Scott,22,0,22,0
1746605775824,PHIL 28,A01,889559,Lamey; Andy M.,0,2,31,31
1746605775824,PHIL 28,A02,889561,Lamey; Andy M.,0,1,30,30
1746605775824,PHIL 28,A03,889572,Lamey; Andy M.,0,1,30,30
1746605776852,PHIL 35,A00,907839,Staff,13,0,15,2
1746605777881,PHIL 60,A00,889574,Staff,73,0,90,17
1746605778906,PHIL 101,A00,958004,Staff,12,0,15,3
1746605780960,PHIL 136,A00,889582,Fulkerson; Matthew Todd,26,0,45,19
1746605781988,PHIL 163,A01,889601,Staff,21,0,30,9
1746605781988,PHIL 163,B01,889606,Brandt; Reuven A,0,3,0,0
1746605783014,PHIL 164,A00,889610,Staff,16,0,30,14
1746605784043,PHIL 165,A00,889613,Staff,22,0,30,8
1746605785081,PHYS 1A,A00,886431,Staff,30,0,70,40
1746605786111,PHYS 1AL,001,886432,Tsai; Philbert S,0,1,30,30
1746605786111,PHYS 1AL,002,886436,Tsai; Philbert S,13,0,30,17
1746605787138,PHYS 1B,A00,886439,Staff,184,0,240,56
1746605788163,PHYS 1BL,001,886441,Tsai; Philbert S,0,4,30,30
1746605788163,PHYS 1BL,002,886444,Tsai; Philbert S,2,0,30,28
1746605789193,PHYS 1C,A00,896092,Arnold; Kam S,78,0,146,68
1746605790219,PHYS 1CL,001,886448,Tsai; Philbert S,0,0,30,30
1746605790219,PHYS 1CL,002,886449,Tsai; Philbert S,1,0,30,29
1746605790219,PHYS 1CL,003,886450,Tsai; Philbert S,16,0,30,14
1746605790219,PHYS 1CL,004,886451,Tsai; Philbert S,15,0,30,15
1746605791251,PHYS 2B,A01,886457,Staff,67,0,115,48
1746605792277,PHYS 2C,A01,886460,Shotwell; Brian,0,9,65,65
1746605793305,PHYS 2CL,A01,886467,Staff,0,4,28,28
1746605793305,PHYS 2CL,A02,886468,Staff,0,3,28,28
1746605794330,PHYS 2D,A01,886470,Staff,10,0,50,40
1746605795356,PHYS 4B,A01,886475,Grinstein; Benjamin,22,0,40,18
1746605796386,POLI 5,A00,891173,Desposato; Scott,7,0,25,18
1746605797411,POLI 5D,A01,891175,Staff,5,0,5,0
1746605797411,POLI 5D,B01,891178,Staff,5,0,5,0
1746605798438,POLI 11,A00,891179,Ferree; Karen E,0,0,35,35
1746605799465,POLI 12,A00,891180,Staff,15,0,30,15
1746605800494,POLI 27,A01,891182,Staff,11,0,75,64
1746605801522,POLI 30,A00,891183,Staff,8,0,50,42
1746605802549,POLI 100B,A00,891244,Staff,5,1,35,30
1746605803581,POLI 100I,A00,891247,Staff,7,0,30,23
1746605804615,POLI 104J,A00,891248,Nichter; Maysa,14,0,30,16
1746605805640,POLI 104U,A00,891250,Nichter; Maysa,1,0,30,29
1746605807693,POLI 110B,A00,891255,Wiens; David,19,0,25,6
1746605808723,POLI 112A,A00,891256,Wiens; David,6,0,25,19
1746605809753,POLI 114BR,A00,891261,Staff,19,0,30,11
1746605810782,POLI 117R,A00,891262,Forman; Fonna,0,6,50,50
1746605811811,POLI 118,A00,891264,Ingham; Sean,17,0,25,8
1746605812838,POLI 124A,A00,891265,Staff,18,0,20,2
1746605813866,POLI 125D,A00,891266,Nichter; Simeon C,2,0,25,23
1746605814894,POLI 126,A00,891268,Nichter; Simeon C,7,0,25,18
1746605815919,POLI 126AA,A00,891272,Staff,15,0,25,10
1746605816948,POLI 130AA,A00,891273,Staff,15,0,20,5
1746605817974,POLI 134AA,A00,891274,Staff,4,0,20,16
1746605820034,POLI 138,A00,891278,Staff,21,0,25,4
1746605821059,POLI 142K,A00,891280,Staff,10,0,25,15
1746605822086,POLI 142M,A00,891281,Gartzke; Erik,16,0,30,14
1746605823113,POLI 142P,A00,891284,Staff,20,0,30,10
1746605824143,POLI 143,A00,891285,Gartzke; Erik,12,0,30,18
1746605825168,POLI 153,A00,891286,Staff,19,0,20,1
1746605827226,POLI 175,A00,891290,Staff,15,0,20,5
1746605828308,PSYC 1,A00,890674,Steiner; Eric Tomas,0,11,45,45
1746605829339,PSYC 2,A00,890676,Albright; Thomas D,20,0,35,15
1746605830377,PSYC 3,A00,890679,Staff,17,0,20,3
1746605831401,PSYC 6,A00,959858,Staff,19,0,20,1
1746605832426,PSYC 60,A01,890684,Rickard; Timothy C.,0,6,45,45
1746605833457,PSYC 70,A01,890689,Geller; Emma Harlan,6,0,30,24
1746605834483,PSYC 71,A01,959860,Staff,21,0,25,4
1746605835510,PSYC 100,A00,890690,Lacefield; Katharine I,0,50,180,180
1746605836536,PSYC 102,A00,890695,Staff,18,0,40,22
1746605837563,PSYC 105,A00,890699,Geller; Emma Harlan,70,0,100,30
1746605838589,PSYC 106,A00,890701,Gorman; Michael R.,5,0,30,25
1746605839616,PSYC 108,A00,890704,Adrian; Julia Anna,0,29,50,50
1746605840641,PSYC 118,A01,890712,Staff,11,0,30,19
1746605841670,PSYC 124,A00,890716,Chapman; Eddie Nathaniel,25,0,60,35
1746605842698,PSYC 131,A00,890717,Anagnostaras; Stephan,0,7,80,80
1746605843729,PSYC 137,A00,890719,Winkielman; Piotr,0,11,30,30
1746605844759,PSYC 144,A00,890721,Adrian; Julia Anna,0,9,45,45
1746605845790,PSYC 162,A00,890805,Staff,0,2,75,75
1746605846819,PSYC 169,A00,890810,Staff,0,15,30,30
1746605847846,PSYC 172,A00,890814,Gorman; Michael R.,9,0,30,21
1746605848875,PSYC 181,A00,890818,Anagnostaras; Stephan,6,0,200,194
1746605849901,PSYC 184,A00,959861,Staff,160,0,175,15
1746605850925,PSYC 189,A00,890823,Staff,0,2,30,30
1746605851953,PSYC 191,A00,890884,Rickard; Timothy C.,0,12,35,35
1746605852979,PSYC 193,A00,890913,Staff,19,0,30,11
1746605852979,PSYC 193,B00,890914,Chapman; Eddie Nathaniel,24,0,30,6
1746605854009,PSYC 193L,A01,890918,Lowe; Angela Beth,20,0,30,10
1746605854009,PSYC 193L,B01,890921,Hurwitz; Ethan Scott,20,0,30,10
1746605854009,PSYC 193L,C01,890928,Staff,30,0,30,0
1746605855039,RELI 149,A00,886806,Rahimi; Babak,23,0,40,17
1746605856064,SE 9,A01,886814,Staff,7,0,20,13
1746605857094,SE 101B,A01,886816,Chadha; Mayank,3,0,35,32
1746605858128,SE 110B,A00,886818,Zhu; Qiang,4,0,75,71
1746605859155,SE 125,A01,886830,Staff,10,0,30,20
1746605860184,SE 130B,A01,886835,Staff,14,0,40,26
1746605861213,SE 131A,A01,886838,Krysl; Petr,34,0,55,21
1746605862240,SE 154,A00,886840,Staff,28,0,50,22
1746605863267,SE 164GS,A01,886849,Staff,6,0,20,14
1746605864295,SE 167GS,A01,886853,Staff,6,0,20,14
1746605865324,SIO 25,A01,890107,Staff,19,0,30,11
1746605866353,SIO 45,A00,890109,Cook; Geoffrey W,115,0,200,85
1746605867382,SIO 109R,A00,890110,Forman; Fonna,0,16,20,20
1746605868412,SIO 187,A01,890114,Kacev; David,15,0,40,25
1746605869439,SOCI 1,A01,890431,Thorpe; Charles Robert,14,0,30,16
1746605869439,SOCI 1,A02,890518,Thorpe; Charles Robert,30,0,30,0
1746605870465,SOCI 2,A01,957978,Staff,25,0,25,0
1746605870465,SOCI 2,A02,957979,Staff,23,0,25,2
1746605871491,SOCI 20,A01,890523,Calderon-Zaks; Michael Aar,21,0,30,9
1746605871491,SOCI 20,A02,890526,Calderon-Zaks; Michael Aar,29,0,30,1
1746605872517,SOCI 30,A01,890533,Pardo Guerra; Juan Pablo,37,0,40,3
1746605873543,SOCI 40,A01,890535,Staff,27,0,45,18
1746605874568,SOCI 104Q,A00,890559,Staff,17,0,30,13
1746605875609,SOCI 106,A00,890560,Arnal; Maud Marie Leonie,20,0,30,10
1746605876635,SOCI 110,A00,890567,Holkenbrink-Monk; Charlene,19,0,30,11
1746605877661,SOCI 112,A00,890568,Victoria Torres; Pablo,2,0,55,53
1746605878689,SOCI 115,A00,890597,Arnal; Maud Marie Leonie,28,0,45,17
1746605880744,SOCI 121,A00,890604,Pardo Guerra; Juan Pablo,38,0,45,7
1746605881770,SOCI 126,A01,890608,Staff,8,0,10,2
1746605882796,SOCI 127,A00,890609,Staff,18,0,30,12
1746605883821,SOCI 131,A00,890610,Thorpe; Charles Robert,37,0,45,8
1746605884851,SOCI 135,A00,890615,Payne; Christine Anna,14,0,45,31
1746605885878,SOCI 139,A00,890620,Staff,38,0,45,7
1746605886906,SOCI 148E,A00,890622,Calderon-Zaks; Michael Aar,36,0,45,9
1746605887936,SOCI 150,A00,890623,Kohler; Kristopher M.,31,0,45,14
1746605888962,SOCI 157,A00,890625,Jules-Rosette; Bennetta W.,18,0,20,2
1746605889997,SOCI 160,A00,890627,Payne; Christine Anna,21,0,45,24
1746605891025,SYN 1,A00,886855,Fish; Gwendolyn Anne,0,1,0,0
1746605891025,SYN 1,B00,906086,Fish; Gwendolyn Anne,0,2,0,2
1746605892053,SYN 2R,A00,886860,Staff,0,17,15,15
1746605892053,SYN 2R,B00,906106,Atkinson; Arthur Laird,0,16,15,15
1746605893081,SYN 100,A01,886866,Browne; Emily,0,28,20,20
1746605893081,SYN 100,B01,906128,Rock; Martin,0,4,20,20
1746605893081,SYN 100,C01,906140,Deavenport; James Cary,0,4,20,20
1746605893081,SYN 100,D01,907816,Deavenport; James Cary,0,5,20,20
1746605894111,TDAC 1,A00,890286,Walsh; Kim C.,7,0,20,13
1746605895139,TDAC 101,A00,890296,Basso; Beatrice,15,0,20,5
1746605896168,TDDE 131,A00,890297,Staff,47,0,50,3
1746605897200,TDDM 1,A00,890287,Weinberg; Sadie,25,0,30,5
1746605898232,TDGE 11,A00,890288,Fulton; Julia,138,0,200,62
1746605898232,TDGE 11,B00,890289,Castro; Robert Jess,184,0,200,16
1746605899258,TDGE 25,B00,957359,Walsh; Kim C.,5,0,20,15
1746605900286,TDGE 40,A01,890292,Power; Jade Yukana,26,0,30,4
1746605901315,TDGE 124,A00,890298,Havis; Allan,0,2,50,50
1746605902340,TDGE 131R,A00,890299,Burelle; Julie Sara Veronique,15,0,42,27
1746605903367,TDHT 101,A00,890300,Staff,10,0,20,10
1746605904395,TDHT 109,A01,890302,Anderson; Mysia Anyse,31,0,40,9
1746605905425,TDMV 1,A00,890293,Arcidiacono; Kristin,18,0,30,12
1746605906454,TDMV 2,A00,890294,Weinberg; Sadie,23,0,30,7
1746605907485,TDMV 3,A00,957878,Arcidiacono; Kristin,28,0,30,2
1746605909542,TDMV 138,A00,890304,Jun; Grace Shin Hae,25,0,40,15
1746605910570,TDMV 140,A00,890305,Corrales; Joseph Bernales,25,0,30,5
1746605911600,TDMV 142,A00,890307,Caligagan; Tony,32,0,40,8
1746605912630,TDMV 144,A00,890308,Camaya; Michelle Ann,25,0,30,5
1746605913656,TDPW 1,A00,890295,Stein; Deborah Isobel,3,0,20,17
1746605914687,USP 2,A01,890272,Lerner; Amy M,7,0,20,13
1746605915714,USP 3,A01,890274,Staff,12,0,30,18
1746605916743,USP 15,A01,890276,Sun; Feiyang,16,0,30,14
1746605917775,USP 25,A00,890277,Shenkman; Michael Thomas,18,0,25,7
1746605918805,USP 138,A00,890278,Staff,13,0,25,12
1746605919834,USP 143,A00,890279,Staff,21,0,70,49
1746605920861,USP 144,A00,890280,Chowdhury; Muhammed Zohir,16,0,30,14
1746605921890,USP 150,A00,890281,Boomhower; Matthew Charles,4,0,30,26
1746605922916,USP 151,A00,890282,Staff,16,0,20,4
1746605923942,USP 162,A00,890283,Andrews; Abigail Leslie,16,0,20,4
1746605924970,USP 168,A00,920477,Kwak; Nancy,0,0,5,5
1746605925997,USP 181,A00,890284,Staff,3,0,20,17
1746605927023,USP 191A,A00,890285,Staff,12,0,20,8
1746605928056,VIS 101,A00,886512,Staff,26,0,75,49
1746605929081,VIS 103,A00,886513,Cruz; Edwin Teddy,61,0,75,14
1746605930105,VIS 108,A00,886514,Staff,4,0,15,11
1746605931133,VIS 127P,A00,886515,Shen; Kuiyi,80,0,146,66
1746605932198,VIS 149,A00,886516,Yoldas; Pinar,0,0,15,15
1746605933225,VIS 164,A00,886526,Erdmann; Dean,19,0,22,3
1746605934253,VIS 194S,A00,886527,Staff,61,0,75,14
1746605935287,WCWP 10A,C00,886484,Martiniuk; Jill,12,0,15,3
1746605936319,WCWP 10B,A00,886490,Uriarte; Emma,0,0,15,15
1746605936319,WCWP 10B,B00,886491,Dhir; Simrita,8,0,15,7
1746605936319,WCWP 10B,C00,886492,Ornelas; Tricia,0,0,15,15
1746605937346,WCWP 100,A00,886494,Young; Mark T,0,6,15,15
1746605939507,AAS 10,A01,886199,Childs; Dennis R.,0,3,0,0
1746605940535,ANAR 104,A01,886940,Shtienberg; Gilad,27,0,30,3
1746605941560,ANAR 120,A00,886953,Staff,13,0,20,7
1746605942592,ANBI 148,A01,886955,Wilder; Linnea Lorene,30,0,40,10
1746605944651,ANSC 122,A00,886957,Staff,24,0,30,6
1746605945676,ANSC 150,A00,886958,Sloane; Julia Kathryn,2,0,15,13
1746605946705,ANSC 156,A00,886959,Jenkins; Janis A.,0,1,15,15
1746605947733,ANSC 180,A00,886960,Staff,11,0,17,6
1746605948762,ANSC 188,A00,886961,Jassal; Aftab,9,0,25,16
1746605949792,ANSC 190,A00,886962,Jassal; Aftab,14,0,25,11
1746605950819,ANSC 191,A00,886963,Staff,18,0,20,2
1746605951848,ANTH 3,A01,891689,Staff,17,0,20,3
1746605952874,ANTH 5,A00,886933,Semendeferi; Ekaterini,16,0,20,4
1746605953899,ANTH 10,A00,886934,Staff,0,12,30,30
1746605954925,ANTH 21,A01,886936,Staff,41,0,60,19
1746605955954,ANTH 23,A01,886938,Staff,92,0,100,8
1746605956982,ANTH 105,A00,886964,Stewart; Alexander B,84,0,100,16
1746605958007,ANTH 108,A00,886965,Pedersen; David,9,0,20,11
1746605959043,AWP 10,001,886147,Staff,0,0,0,0
1746605959043,AWP 10,002,886148,Staff,0,0,0,0
1746605959043,AWP 10,003,886149,Staff,0,0,0,0
1746605959043,AWP 10,004,886150,Staff,0,0,0,0
1746605959043,AWP 10,005,886151,Staff,0,0,0,0
1746605959043,AWP 10,006,886152,Staff,0,0,0,0
1746605959043,AWP 10,007,886153,Staff,0,0,0,0
1746605959043,AWP 10,008,886154,Staff,0,0,0,0
1746605959043,AWP 10,009,886155,Staff,0,0,0,0
1746605959043,AWP 10,010,886156,Staff,0,0,0,0
1746605959043,AWP 10,011,886158,Staff,0,0,0,0
1746605959043,AWP 10,012,886160,Staff,0,0,0,0
1746605959043,AWP 10,013,886161,Staff,0,0,0,0
1746605959043,AWP 10,014,886162,Staff,0,0,0,0
1746605959043,AWP 10,015,886163,Staff,0,0,0,0
1746605959043,AWP 10,016,886164,Staff,0,0,0,0
1746605959043,AWP 10,017,886165,Staff,0,0,0,0
1746605959043,AWP 10,018,886166,Staff,0,0,0,0
1746605959043,AWP 10,019,886168,Staff,0,0,0,0
1746605959043,AWP 10,020,886170,Staff,0,0,0,0
1746605959043,AWP 10,021,886172,Staff,0,0,0,0
1746605960077,AWP 10R,001,886173,Staff,0,1,0,0
1746605960077,AWP 10R,002,886174,Staff,0,1,0,0
1746605960077,AWP 10R,003,886175,Staff,0,0,0,0
1746605960077,AWP 10R,004,886176,Staff,0,0,0,0
1746605960077,AWP 10R,005,886177,Staff,0,0,0,0
1746605960077,AWP 10R,006,886178,Staff,0,0,0,0
1746605960077,AWP 10R,007,886179,Staff,0,0,0,0
1746605960077,AWP 10R,008,886181,Staff,0,0,0,0
1746605960077,AWP 10R,009,886182,Staff,0,0,0,0
1746605960077,AWP 10R,010,886183,Staff,0,0,0,0
1746605960077,AWP 10R,011,886184,Staff,0,0,0,0
1746605960077,AWP 10R,012,886185,Staff,0,0,0,0
1746605960077,AWP 10R,013,886186,Staff,0,0,0,0
1746605960077,AWP 10R,014,886187,Staff,0,0,0,0
1746605960077,AWP 10R,015,886188,Staff,0,0,0,0
1746605960077,AWP 10R,016,886189,Staff,0,0,0,0
1746605960077,AWP 10R,017,960532,Staff,0,0,0,0
1746605960077,AWP 10R,018,960533,Staff,0,0,0,0
1746605960077,AWP 10R,019,960534,Staff,0,0,0,0
1746605960077,AWP 10R,020,960538,Staff,0,0,0,0
1746605960077,AWP 10R,021,960540,Staff,0,0,0,0
1746605960077,AWP 10R,022,960541,Staff,0,0,0,0
1746605960077,AWP 10R,023,960542,Staff,0,0,0,0
1746605960077,AWP 10R,024,960544,Staff,0,0,0,0
1746605960077,AWP 10R,025,960545,Staff,0,0,0,0
1746605960077,AWP 10R,026,960548,Staff,0,0,0,0
1746605961101,AWP 102R,A00,886190,Staff,0,0,0,0
1746605961101,AWP 102R,B00,886191,Staff,0,0,0,0
1746605962127,BENG 100,A01,886193,Staff,17,0,30,13
1746605963157,BENG 122A,A01,886195,Hasty; Jeff M,13,0,30,17
1746605964183,BENG 166A,A00,886196,Sah; Robert Lie-Yuan,0,3,30,30
1746605965209,BENG 190,A00,958050,Khojah; Reem I,17,0,25,8
1746605966237,BIBC 102,A01,894320,Staff,0,1,46,46
1746605966237,BIBC 102,A02,894321,Staff,0,0,46,46
1746605966237,BIBC 102,A03,894344,Staff,6,0,46,40
1746605966237,BIBC 102,A04,894345,Staff,27,0,47,20
1746605967264,BICD 100R,A01,894365,Smith; Laurie,0,2,58,58
1746605967264,BICD 100R,A02,894366,Smith; Laurie,0,4,58,58
1746605967264,BICD 100R,A03,894367,Smith; Laurie,0,0,59,59
1746605967264,BICD 100R,A04,959869,Smith; Laurie,38,0,59,21
1746605968291,BICD 136,A01,894383,Gustafson-Brown; Cindy,14,0,50,36
1746605969318,BIEB 102,A01,894494,Butler; Shannon Rhey,51,0,130,79
1746605971380,BIEB 150,A01,894617,Wills; Christopher,3,0,20,17
1746605971380,BIEB 150,A02,894631,Wills; Christopher,3,0,20,17
1746605971380,BIEB 150,A03,894937,Wills; Christopher,3,0,20,17
1746605971380,BIEB 150,A04,894946,Wills; Christopher,5,0,20,15
1746605972407,BIEB 194,A00,906141,Kurle; Carolyn M.,5,0,20,15
1746605973434,BILD 1,A01,894154,Staff,3,0,19,16
1746605973434,BILD 1,A02,894155,Staff,14,0,19,5
1746605973434,BILD 1,A03,894160,Staff,13,0,19,6
1746605973434,BILD 1,A04,894161,Staff,15,0,18,3
1746605974460,BILD 2,A01,894168,Staff,0,0,50,50
1746605974460,BILD 2,A02,894169,Staff,0,0,50,50
1746605974460,BILD 2,A03,894179,Staff,0,0,50,50
1746605974460,BILD 2,A04,894203,Staff,22,0,50,28
1746605975489,BILD 3,A01,894213,Staff,23,0,31,8
1746605975489,BILD 3,A02,894214,Staff,26,0,31,5
1746605975489,BILD 3,A03,894235,Staff,28,0,31,3
1746605975489,BILD 3,A04,894236,Staff,28,0,32,4
1746605976515,BILD 4,A01,894253,Reuther; Keefe,5,0,24,19
1746605976515,BILD 4,A02,894258,Reuther; Keefe,16,0,24,8
1746605977546,BILD 5,A01,894276,Reuther; Keefe,34,0,50,16
1746605977546,BILD 5,A02,894277,Reuther; Keefe,45,0,50,5
1746605977546,BILD 5,A03,894290,Reuther; Keefe,44,0,50,6
1746605977546,BILD 5,A04,894291,Reuther; Keefe,48,0,50,2
1746605978572,BILD 24,A01,894297,Pirino; Giorgia,40,0,60,20
1746605979604,BIMM 100,B01,958915,Staff,71,0,100,29
1746605980634,BIMM 101,A01,895017,McDonnell; Lisa Marie,0,5,24,24
1746605980634,BIMM 101,A02,895018,McDonnell; Lisa Marie,0,5,24,24
1746605980634,BIMM 101,B01,895020,McDonnell; Lisa Marie,0,5,24,24
1746605980634,BIMM 101,B02,895021,McDonnell; Lisa Marie,0,4,24,24
1746605981658,BIMM 110,A01,895023,Staff,1,0,25,24
1746605981658,BIMM 110,A02,895024,Staff,9,0,25,16
1746605981658,BIMM 110,A03,895025,Staff,18,0,25,7
1746605981658,BIMM 110,A04,895031,Staff,20,0,25,5
1746605982693,BIMM 120,A01,895114,Gustafson-Brown; Cindy,14,0,28,14
1746605982693,BIMM 120,A02,895126,Gustafson-Brown; Cindy,21,0,27,6
1746605983719,BIPN 100,A01,895130,Yang; Mingyu,0,0,38,38
1746605983719,BIPN 100,A02,895131,Yang; Mingyu,31,0,38,7
1746605983719,BIPN 100,A03,895132,Yang; Mingyu,32,0,38,6
1746605983719,BIPN 100,A04,895133,Yang; Mingyu,27,0,36,9
1746605984753,BIPN 120,A01,895135,Cooke; James Edward,0,3,13,13
1746605984753,BIPN 120,A02,895136,Cooke; James Edward,0,1,13,13
1746605984753,BIPN 120,A03,895137,Cooke; James Edward,0,3,13,13
1746605984753,BIPN 120,A04,895156,Cooke; James Edward,0,2,11,11
1746605985780,BIPN 134,A01,895235,Cooke; James Edward,0,1,25,25
1746605985780,BIPN 134,A02,895237,Cooke; James Edward,0,0,25,25
1746605985780,BIPN 134,A03,895240,Cooke; James Edward,1,0,25,24
1746605985780,BIPN 134,A04,895270,Cooke; James Edward,20,0,25,5
1746605986805,BIPN 189,A00,892103,Staff,0,14,14,14
1746605988865,BISP 194,A00,958008,Staff,0,2,0,0
1746605989893,CAT 124,A01,922009,Staff,0,5,20,20
1746605990925,CAT 125R,A00,886390,Morales; Celeste Georgianna,0,4,20,20
1746605990925,CAT 125R,B00,886391,Irwin; Matthew Joseph,0,4,20,20
1746605990925,CAT 125R,C00,886392,Smith; Lauryn Alissa,0,2,20,20
1746605990925,CAT 125R,D00,886393,Vanderschuit; Maya Alysia,0,3,20,20
1746605990925,CAT 125R,E00,886394,Marchisotto; Jennifer Anne,0,3,20,20
1746605991956,CENG 15,A01,886218,Drews; Aaron,3,0,8,5
1746605992984,CENG 113,A00,886219,Opatkiewicz; Justin Paul,15,0,25,10
1746605994015,CGS 101,A00,887044,Staff,7,0,20,13
1746605995042,CGS 105,A01,887046,Staff,14,0,25,11
1746605996067,CGS 112,A00,887047,Cuong; Marisol,12,0,15,3
1746605997092,CGS 113,A00,887048,Staff,23,0,30,7
1746605998117,CGS 120,A00,887049,Staff,9,0,17,8
1746605999142,CHEM 6A,A01,886336,Lam; Tin Yiu,38,0,50,12
1746605999142,CHEM 6A,A02,886338,Lam; Tin Yiu,37,0,50,13
1746606000169,CHEM 6B,A01,886341,Hopkins; Patrycja Anna,16,0,50,34
1746606000169,CHEM 6B,A02,886343,Hopkins; Patrycja Anna,42,0,50,8
1746606001195,CHEM 6C,A01,886346,Albizati; Kim F.,0,2,50,50
1746606001195,CHEM 6C,A02,886348,Albizati; Kim F.,24,0,50,26
1746606002231,CHEM 40A,A01,886352,Klosterman; Jeremy K,65,0,100,35
1746606003256,CHEM 40B,A01,886356,Klosterman; Jeremy K,0,24,100,100
1746606004286,CHEM 41B,A01,886360,Theodorakis; Emmanuel,25,0,50,25
1746606004286,CHEM 41B,A02,886362,Theodorakis; Emmanuel,47,0,50,3
1746606005316,CHIN 165A,A00,886382,Xu; Li,18,0,20,2
1746606006348,CLAS 120,A00,886387,Myerston Santana; Jacobo,33,0,40,7
1746606007378,COGS 9,A01,886967,Shannon; Kyle Michael,42,0,60,18
1746606008407,COGS 11,A01,886969,Staff,9,0,30,21
1746606009435,COGS 14A,A01,886971,Staff,5,0,60,55
1746606010461,COGS 14B,A01,886973,Hoffman; Drew Ellen,4,0,60,56
1746606011489,COGS 18,A01,886975,Morgan; Eric,34,0,60,26
1746606012514,COGS 20,A01,886977,Staff,3,0,8,5
1746606012514,COGS 20,A02,886978,Staff,5,0,7,2
1746606013541,COGS 100,A01,907783,Staff,0,1,30,30
1746606014569,COGS 101B,A01,886980,Staff,0,4,48,48
1746606015602,COGS 101C,A01,886982,Delgado; Tania,0,5,44,44
1746606016631,COGS 102A,A01,886984,Johnson; Christine M.,3,0,30,27
1746606017656,COGS 118B,A01,886986,Staff,0,4,88,88
1746606018686,COGS 150,A01,886988,Bergen; Benjamin,22,0,50,28
1746606019713,COGS 153,A00,886989,Delgado; Tania,1,3,41,40
1746606020741,COGS 186,A01,886991,Staff,0,0,32,32
1746606021828,COGS 187A,A01,886993,Boyle; Mary E. T.,7,0,30,23
1746606022853,COGS 189,A00,886994,Staff,0,1,30,30
1746606023878,COMM 10,A01,886996,Staff,0,0,20,21
1746606023878,COMM 10,A02,886997,Staff,10,0,20,10
1746606023878,COMM 10,A03,959845,Staff,19,0,20,1
1746606024905,COMM 20,A01,886999,Leuning; Grant Maurstad,24,0,40,16
1746606026966,COMM 100A,A01,887002,Staff,0,0,20,25
1746606026966,COMM 100A,A02,887003,Staff,5,0,20,15
1746606027995,COMM 100B,A01,887005,Staff,0,8,20,24
1746606029022,COMM 106D,A00,887006,Staff,14,0,40,26
1746606030053,COMM 110G,A00,887007,Whitworth-Smith; Andrew C,12,0,40,28
1746606031082,COMM 111B,A00,887008,Staff,31,0,40,9
1746606032113,COMM 113T,A00,887009,Abuelhiga; Soraya Jill,28,0,40,12
1746606032113,COMM 113T,B00,906733,Staff,39,0,40,1
1746606033141,COMM 145,A00,887010,Staff,13,0,40,27
1746606034171,COMM 146,A00,887054,Staff,32,0,40,8
1746606035197,COMM 190,A00,887012,Staff,8,0,23,15
1746606036224,CSE 8A,A50,887015,Cao; Yingjun,56,0,85,29
1746606037248,CSE 11,A01,887017,Cao; Yingjun,11,0,70,59
1746606038276,CSE 20,A01,887019,Staff,30,0,50,20
1746606039303,CSE 21,A01,887021,Staff,79,0,100,21
1746606039303,CSE 21,B01,892583,Braun; Oliver,45,0,50,5
1746606040329,CSE 30,A01,887025,Eldon; John,142,0,200,58
1746606041355,CSE 100,A01,887027,Staff,26,0,50,24
1746606041355,CSE 100,A02,887028,Staff,42,0,50,8
1746606042383,CSE 101,A01,887030,Braun; Oliver,74,0,100,26
1746606042383,CSE 101,B01,887032,Jones; Miles E,0,3,50,50
1746606042383,CSE 101,B02,887033,Jones; Miles E,0,2,50,50
1746606043411,CSE 105,A01,908084,Jones; Miles E,32,0,50,18
1746606043411,CSE 105,A02,908087,Jones; Miles E,31,0,50,19
1746606044442,CSE 135,A01,887035,Powell; Thomas Allan,0,5,50,50
1746606045470,CSE 142,A01,887037,Staff,7,0,60,53
1746606046501,CSE 142L,A01,887039,Staff,34,0,60,26
1746606047525,CSE 151A,A01,887041,Solares; Edwin A,47,0,100,53
1746606048554,CSE 175,A01,887043,Kumar; Rakesh,30,0,30,0
1746606049584,CSS 1,A01,886389,Staff,0,1,40,40
1746606050613,DSC 30,A01,908097,Liao; Soohyun Nam,47,0,75,28
1746606051643,DSC 40A,A01,908099,Shannon; Kyle Michael,30,0,50,20
1746606052673,DSC 40B,A01,908112,Staff,15,0,50,35
1746606053700,DSC 80,A01,908116,Staff,19,0,60,41
1746606054727,DSC 197,001,956863,Eldridge; Justin Matthew,9999,0,9999,0
1746606055760,ECE 5,A01,886400,Morris; Karcher William,1,0,6,5
1746606055760,ECE 5,A02,886401,Morris; Karcher William,3,0,6,3
1746606056787,ECE 148,A01,886403,Silberman; Jack,0,14,14,14
1746606057821,ECON 1,A01,887265,Crane; Meredith Helen,11,0,70,59
1746606057821,ECON 1,B01,887268,Staff,42,0,50,8
1746606058852,ECON 2,A01,887273,Crane; Meredith Helen,54,0,70,16
1746606059879,ECON 3,A01,887279,Rondina; Giacomo,31,0,70,39
1746606060908,ECON 4,A01,887282,Anderson; John Charles,0,2,10,10
1746606061935,ECON 5,A01,887285,Staff,34,0,45,11
1746606061935,ECON 5,B01,887292,Staff,41,0,45,4
1746606062964,ECON 100A,A01,887337,Newhouse; Herbert S,54,0,70,16
1746606062964,ECON 100A,B01,887349,Staff,45,0,50,5
1746606063991,ECON 100B,A01,887361,Du; Songzi,29,0,70,41
1746606065045,ECON 100C,A01,887445,Newhouse; Herbert S,59,0,70,11
1746606066076,ECON 105,A00,887488,Vespa; Emanuel Ignacio,23,0,35,12
1746606067104,ECON 109,A01,887506,Shishkin; Denis,28,0,35,7
1746606068132,ECON 110A,A01,887568,Alon; Titan Michael,0,2,35,35
1746606068132,ECON 110A,B01,907601,Alon; Titan Michael,20,0,35,15
1746606069165,ECON 110B,A01,887598,Levkoff; Steven B.,0,24,70,70
1746606070192,ECON 112,A00,887599,Rondina; Giacomo,19,0,35,16
1746606071221,ECON 120A,A01,887603,Dai; Yinlin,36,0,70,34
1746606072257,ECON 120C,A01,887608,Sun; Yixiao,0,1,35,35
1746606072257,ECON 120C,B01,887614,Sun; Yixiao,0,0,35,35
1746606073282,ECON 138,A00,887621,Bharadwaj; Prashant,0,21,20,20
1746606074310,ECON 144,A00,958007,Squires; Dale E,11,0,35,24
1746606075341,ECON 171,A01,907666,Staff,18,0,35,17
1746606076367,ECON 175,A00,887626,Wu; Pak Yeung,22,0,35,13
1746606077396,ECON 190,A00,887640,Vespa; Emanuel Ignacio,22,0,35,13
1746606078436,EDS 25,A01,888197,Staff,0,0,0,0
1746606078436,EDS 25,A02,888209,Staff,0,0,0,0
1746606078436,EDS 25,A03,888210,Staff,0,0,0,0
1746606078436,EDS 25,A04,888212,Staff,0,0,0,0
1746606078436,EDS 25,A05,888213,Staff,0,0,0,0
1746606078436,EDS 25,A06,888214,Staff,0,0,0,0
1746606078436,EDS 25,A07,888235,Staff,0,2,0,0
1746606078436,EDS 25,A08,888236,Staff,0,0,0,0
1746606078436,EDS 25,A09,888240,Staff,0,0,0,0
1746606078436,EDS 25,A10,888244,Staff,0,0,0,0
1746606078436,EDS 25,B01,888273,Staff,0,0,0,0
1746606078436,EDS 25,B02,888285,Staff,0,0,0,0
1746606078436,EDS 25,B03,888423,Staff,0,0,0,1
1746606078436,EDS 25,B04,888432,Staff,0,0,0,0
1746606078436,EDS 25,B05,888433,Staff,0,0,0,0
1746606078436,EDS 25,B06,888467,Staff,0,0,0,0
1746606078436,EDS 25,B07,888468,Staff,0,0,0,0
1746606078436,EDS 25,B08,888479,Staff,0,0,0,0
1746606078436,EDS 25,B09,888484,Staff,0,0,0,0
1746606078436,EDS 25,B10,888487,Staff,0,0,0,0
1746606079462,EDS 38,A01,907700,Choi; Bailey Miyeon,30,0,30,0
1746606080491,EDS 112,A01,888601,Chapman; Thandeka K,12,0,40,28
1746606081521,EDS 115,A00,888697,Mendez; Kathrina Mendoza,10,0,30,20
1746606082547,EDS 116,A01,888893,Staff,33,0,40,7
1746606084608,EDS 124AR,A00,889133,Staff,29,0,50,21
1746606084608,EDS 124AR,B00,907471,Simon; Elizabeth A,37,0,50,13
1746606085637,EDS 124BR,A00,889134,Simon; Elizabeth A,44,0,100,56
1746606086663,EDS 125,A00,889135,Staff,25,0,30,5
1746606087690,EDS 126,A01,889138,Staff,35,0,40,5
1746606088719,EDS 164R,A01,889142,Wishard Guerra; Alison G.,32,0,50,18
1746606089744,ENG 30,A01,886396,Staff,0,0,0,0
1746606089744,ENG 30,B01,886398,Staff,0,0,0,0
1746606090771,ENVR 102,A00,906150,Montejo; Carolina,23,0,25,2
1746606091796,ETHN 103A,A00,887236,Man; Simeon S,0,2,0,0
1746606092823,ETHN 113,A00,887239,Staff,16,0,30,14
1746606093889,ETHN 116,A00,887240,Staff,16,0,25,9
1746606094915,ETHN 117,A00,887241,Choi; Esther Min,28,0,30,2
1746606095942,ETHN 118,A00,887243,Staff,24,0,30,6
1746606096971,ETHN 127,A00,887248,Cuong; Marisol,11,0,15,4
1746606097998,ETHN 139,A00,887250,Staff,7,0,10,3
1746606099026,ETHN 142,A00,887252,Staff,9,0,30,21
1746606100056,ETHN 161,A00,887253,Browne; Errol Tsekani,24,0,30,6
1746606101085,ETHN 163FR,A00,887255,Burelle; Julie Sara Veronique,0,0,5,5
1746606102111,GLBH 20,A00,889149,Elwardani; Nile Regina,8,0,42,34
1746606104167,GLBH 111,A01,889152,Burgos; Jose L.,17,0,17,0
1746606105198,GLBH 150,A00,889181,Sloane; Julia Kathryn,0,5,15,15
1746606107252,HDS 60,A01,886406,Warstadt; Melissa Fawn,72,0,80,8
1746606108285,HIAF 111,A00,889324,Gyamfi; Bright,25,0,32,7
1746606109314,HIEA 131,A00,889328,Staff,15,0,32,17
1746606110341,HIEA 144,A00,889333,Henry; Todd A.,26,0,32,6
1746606111370,HIEA 154,A00,889336,Henry; Todd A.,24,0,32,8
1746606112408,HIEU 106,A00,889339,Staff,22,0,32,10
1746606114459,HIEU 114,A00,889340,Staff,4,0,32,28
1746606115485,HIEU 135GS,A00,889342,Patterson; Patrick H.,0,0,1,24
1746606116511,HIEU 137,A00,889343,Edington; Claire Ellen,10,0,25,15
1746606117537,HIEU 148,A00,889345,Staff,14,0,32,18
1746606118563,HIEU 154,A00,889346,Biess; Frank Peter,21,0,32,11
1746606119592,HILA 102,A00,889351,Staff,12,0,32,20
1746606120621,HILD 2A,A01,889221,Lewandoski; Julia Mavis,0,8,32,32
1746606121650,HILD 7B,A01,889225,Man; Simeon S,0,12,32,32
1746606122678,HILD 7C,A01,889288,Alvarez; Luis A,0,14,32,32
1746606123705,HILD 30,A01,889323,Staff,0,5,32,32
1746606125758,HISC 119,A00,889383,Golan; Tal,20,0,32,12
1746606126784,HIUS 103,A00,889384,Man; Simeon S,0,0,32,32
1746606127810,HIUS 117,A00,919797,Kwak; Nancy,18,0,32,14
1746606128839,HIUS 142A,A00,919788,Staff,22,0,32,10
1746606130891,HIUS 149,A00,889386,Gyamfi; Bright,26,0,32,6
1746606131915,HIUS 155,A00,889387,Alvarez; Luis A,15,0,32,17
1746606132943,HUM 3,A01,886499,Caldwell; Michael Alan,19,0,50,31
1746606133971,HUM 3GS,A00,886500,Rodriguez; Bretton Sigfred,0,0,0,28
1746606134997,HUM 3R,A01,886502,Markman; Kristina,0,36,50,50
1746606136027,HUM 4,A01,886504,Crum; Matthew Stephen,23,0,50,27
1746606136027,HUM 4,B01,886506,West; Geoffrey Scott,17,0,50,33
1746606137056,HUM 4GS,A00,886507,Staff,0,0,0,19
1746606138086,HUM 5,A01,886509,Staff,31,0,50,19
1746606139115,HUM 5R,A01,886511,Zavodny; Tatiana Sophia,0,39,50,50
1746606140145,JAPN 180,A00,886407,Staff,16,0,40,24
1746606141174,LATI 50,A01,886409,Martin-Cabrera; Luis,3,0,22,19
1746606141174,LATI 50,A02,886410,Martin-Cabrera; Luis,19,0,22,3
1746606141174,LATI 50,A03,886411,Martin-Cabrera; Luis,21,0,22,1
1746606141174,LATI 50,A04,886412,Martin-Cabrera; Luis,8,0,22,14
1746606142200,LAWS 101,A00,907664,Staff,28,0,60,32
1746606143226,LIAB 1A,A00,889388,Saab; Dima,17,0,20,3
1746606144258,LIAB 1AX,A00,889389,El Cheddadi; Youniss,18,0,20,2
1746606145286,LIFR 1C,A00,889391,Van Moer; Vinciane G,8,0,20,12
1746606146315,LIFR 1CX,A00,889392,Van Moer; Vinciane G,7,0,20,13
1746606147341,LIFR 1D,A00,889393,Van Moer; Vinciane G,7,0,20,13
1746606148369,LIFR 1DX,A00,889394,Van Moer; Vinciane G,8,0,20,12
1746606149400,LIGN 7,A00,886923,Staff,25,0,50,25
1746606150426,LIGN 17,A00,886924,Kehler; Andrew Scott,126,0,150,24
1746606151454,LTAM 110,A00,889395,Staff,15,0,30,15
1746606152480,LTAM 110GS,A00,958010,Rodriguez; Bretton Sigfred,0,0,0,28
1746606153510,LTCH 101,A00,889397,Staff,23,0,25,2
1746606154535,LTCS 130,A00,889398,Staff,23,0,25,2
1746606155559,LTEA 138,A00,889399,Staff,24,0,40,16
1746606156586,LTEN 149,A00,889400,Wesling; Megan E.,0,3,25,25
1746606157613,LTEN 169,A00,889401,Staff,20,0,25,5
1746606158642,LTEN 180,A00,889402,Staff,10,0,15,5
1746606159672,LTEN 181,A00,889403,Staff,21,0,25,4
1746606160700,LTWL 100,A00,889404,Myerston Santana; Jacobo,2,0,25,23
1746606161727,LTWL 180GS,A00,889405,Staff,0,0,20,20
1746606162753,LTWL 181,A00,889406,Staff,16,0,25,9
1746606163781,LTWL 184,A00,889475,Mukherjee; Silpa,22,0,25,3
1746606164807,LTWR 102C,A00,889486,Staff,29,0,30,1
1746606165835,LTWR 115W,A00,889491,Staff,0,2,15,15
1746606166863,MAE 8,A01,886905,Staff,0,2,0,0
1746606167891,MAE 11,A00,886906,Bandaru; Prabhakar,0,7,50,50
1746606168920,MAE 20,A00,886907,Evdokimenko; Ekaterina,43,0,70,27
1746606169945,MAE 30B,A00,886909,Ghazinejad; Maziar,25,0,45,20
1746606170976,MAE 101B,A00,886910,Saintillan; David,30,0,45,15
1746606172003,MAE 105,A00,886911,Bandaru; Prabhakar,18,0,50,32
1746606173028,MAE 107,B00,958024,Staff,7,0,50,43
1746606174056,MAE 143B,A00,886913,Bewley; Thomas R,2,0,40,38
1746606175082,MAE 148,A01,886915,Silberman; Jack,0,3,14,14
1746606176112,MAE 160,A00,886916,Evdokimenko; Ekaterina,30,0,60,30
1746606177142,MATH 3C,A01,889681,Staff,0,2,30,30
1746606177142,MATH 3C,A02,960048,Staff,23,0,30,7
1746606178167,MATH 10A,A01,889760,Staff,26,0,30,4
1746606178167,MATH 10A,A02,889783,Staff,29,0,30,1
1746606179196,MATH 10B,A01,889785,Verstraete; Jacques Allan,1,0,35,34
1746606179196,MATH 10B,A02,889795,Verstraete; Jacques Allan,4,0,35,31
1746606179196,MATH 10B,B01,889797,Verstraete; Jacques Allan,3,0,35,32
1746606179196,MATH 10B,B02,889828,Verstraete; Jacques Allan,3,0,35,32
1746606180228,MATH 10C,A01,889849,Habib; Yousaf,8,0,30,22
1746606180228,MATH 10C,A02,889852,Habib; Yousaf,14,0,30,16
1746606180228,MATH 10C,A03,889853,Habib; Yousaf,22,0,30,8
1746606180228,MATH 10C,A04,889858,Habib; Yousaf,20,0,30,10
1746606180228,MATH 10C,B01,889861,Staff,1,0,30,29
1746606180228,MATH 10C,B02,889862,Staff,24,0,30,6
1746606180228,MATH 10C,B03,889863,Staff,27,0,30,3
1746606180228,MATH 10C,B04,889967,Staff,23,0,30,7
1746606181258,MATH 18,A01,889974,Staff,6,0,30,24
1746606181258,MATH 18,A02,889977,Staff,20,0,30,10
1746606181258,MATH 18,B01,889984,Hardiman; Liam,20,0,30,10
1746606181258,MATH 18,B02,889985,Hardiman; Liam,25,0,30,5
1746606182287,MATH 20A,A01,889990,Suk; Andrew Hoon,30,0,35,5
1746606183314,MATH 20B,A01,889993,Ohm; Ko Woon,21,0,30,9
1746606183314,MATH 20B,A02,889994,Ohm; Ko Woon,30,0,30,0
1746606183314,MATH 20B,B01,889996,Ohm; Ko Woon,22,0,30,8
1746606183314,MATH 20B,B02,889997,Ohm; Ko Woon,23,0,30,7
1746606184339,MATH 20C,A01,889999,Hammock; Frances H,17,0,30,13
1746606184339,MATH 20C,A02,890003,Hammock; Frances H,23,0,30,7
1746606184339,MATH 20C,B01,890006,Hammock; Frances H,2,0,30,28
1746606184339,MATH 20C,B02,890007,Hammock; Frances H,11,0,30,19
1746606185367,MATH 20D,A01,890011,Cheng; Hsiao-Bing,1,0,30,29
1746606185367,MATH 20D,A02,890012,Cheng; Hsiao-Bing,14,0,30,16
1746606185367,MATH 20D,B01,890016,Cheng; Hsiao-Bing,13,0,30,17
1746606185367,MATH 20D,B02,890017,Cheng; Hsiao-Bing,13,0,30,17
1746606186394,MATH 20E,A01,890026,Harel; Guershon,1,0,30,29
1746606186394,MATH 20E,A02,890029,Harel; Guershon,22,0,30,8
1746606186394,MATH 20E,B01,890033,Harel; Guershon,7,0,30,23
1746606186394,MATH 20E,B02,890101,Harel; Guershon,21,0,30,9
1746606187422,MATH 102,A01,890104,Staff,18,0,30,12
1746606187422,MATH 102,A02,890105,Staff,27,0,30,3
1746606188448,MATH 103B,A01,890116,Salehi Golsefidy; Alireza,3,0,30,27
1746606188448,MATH 103B,B01,890118,Staff,0,3,34,34
1746606189483,MATH 109,A01,890121,Aliabadi Sr.; Mohsen,0,0,30,30
1746606189483,MATH 109,B01,890124,Upadrashta; Pranav Kumar,18,0,30,12
1746606190509,MATH 120A,A01,890126,Eggers; John Dietrich,13,0,30,17
1746606191540,MATH 142B,A01,890128,Ioana; Adrian,19,0,30,11
1746606191540,MATH 142B,A02,890129,Ioana; Adrian,12,0,30,18
1746606192572,MATH 154,A01,890174,Staff,0,1,30,30
1746606192572,MATH 154,A02,890182,Staff,0,0,30,30
1746606193597,MATH 168A,A01,890197,Dumitriu; Ioana,21,0,35,14
1746606194623,MATH 170A,A01,890240,Nie; Jiawang,1,0,30,29
1746606194623,MATH 170A,A02,890241,Nie; Jiawang,11,0,30,19
1746606194623,MATH 170A,A03,890249,Nie; Jiawang,23,0,30,7
1746606195649,MATH 170B,A01,957891,Nag; Panchali,13,0,35,22
1746606197745,MATH 181A,A01,908025,Staff,0,3,35,35
1746606197745,MATH 181A,A02,960115,Staff,26,0,35,9
1746606198779,MATH 181B,A01,959874,Staff,24,0,30,6
1746606199805,MATH 193B,A01,890265,Staff,0,4,35,35
1746606200831,MGT 4,A01,890311,Anderson; John Charles,42,0,88,46
1746606201862,MGT 5,A00,907740,Staff,12,0,98,86
1746606202891,MGT 12,A00,890312,Lindenberger; Wade Douglas,67,0,98,31
1746606203917,MGT 16,A00,957883,Staff,78,0,98,20
1746606205968,MGT 45,A00,890314,Pecore; Joseph P.,45,0,98,53
1746606206994,MGT 71,A00,890315,Staff,0,12,98,98
1746606208019,MGT 100,A00,890316,Yavorsky; Daniel Ryan,44,0,98,54
1746606209045,MGT 103,A00,890317,Ehrich; Kristine R,73,0,98,25
1746606210069,MGT 105,A00,890356,Bates; Kenneth Walter,0,8,98,98
1746606211094,MGT 112,A00,890360,Ehrich; Kristine R,55,0,98,43
1746606212124,MGT 127R,A00,907732,Zhu; Kevin Xiaoguo,23,0,98,75
1746606213150,MGT 131B,A00,890361,Anderson; John Charles,59,0,98,39
1746606214175,MGT 137,A00,890362,Lindenberger; Wade Douglas,65,0,98,33
1746606215205,MGT 160,A00,890369,Johnson; Erik Barry,9,0,98,89
1746606217259,MGT 164,A00,890372,Zimmermann; Carsten,0,40,98,98
1746606218288,MGT 180,A00,890374,Bliss; Barbara Ann,11,0,98,87
1746606219320,MMW 15,A01,886414,Chang; Edmond Yi-Teh,0,12,28,28
1746606219320,MMW 15,A02,886415,Chang; Edmond Yi-Teh,0,8,28,28
1746606219320,MMW 15,A03,886416,Chang; Edmond Yi-Teh,0,9,28,28
1746606219320,MMW 15,A04,886417,Chang; Edmond Yi-Teh,0,8,28,28
1746606219320,MMW 15,B01,886419,Chang; Edmond Yi-Teh,0,7,28,28
1746606219320,MMW 15,B02,886420,Chang; Edmond Yi-Teh,0,7,28,28
1746606219320,MMW 15,B03,886421,Chang; Edmond Yi-Teh,0,7,28,28
1746606219320,MMW 15,B04,886422,Chang; Edmond Yi-Teh,0,8,28,28
1746606219320,MMW 15,C01,886424,Staff,0,9,28,28
1746606219320,MMW 15,C02,886425,Staff,0,8,28,28
1746606219320,MMW 15,C03,886426,Staff,0,8,28,28
1746606219320,MMW 15,C04,886427,Staff,0,8,28,28
1746606219320,MMW 15,C05,958038,Staff,0,8,28,28
1746606219320,MMW 15,C06,958039,Staff,0,7,28,28
1746606220346,MMW 15GS,A00,906910,Patterson; Patrick H.,4,0,28,24
1746606221375,MMW 122R,A01,886429,Rahimi; Babak,0,13,28,28
1746606221375,MMW 122R,A02,886430,Rahimi; Babak,0,12,28,28
1746606221375,MMW 122R,A03,958040,Rahimi; Babak,0,11,28,28
1746606222403,MUS 1A,A01,890937,Staff,2,0,25,23
1746606222403,MUS 1A,A02,891035,Staff,6,0,25,19
1746606222403,MUS 1A,C01,958912,Staff,24,0,25,1
1746606222403,MUS 1A,C02,958913,Staff,25,0,25,0
1746606224454,MUS 2AK,A00,957092,Ohnishi; Takae,15,0,15,0
1746606225486,MUS 4,A01,891044,Staff,0,0,25,25
1746606225486,MUS 4,A02,891045,Staff,22,0,25,3
1746606225486,MUS 4,B01,891048,Staff,17,0,25,8
1746606225486,MUS 4,B02,891050,Staff,25,0,25,0
1746606226513,MUS 5,A01,957506,Dubnov; Shlomo,0,0,25,25
1746606226513,MUS 5,A02,957622,Dubnov; Shlomo,12,0,25,13
1746606226513,MUS 5,A03,957623,Dubnov; Shlomo,20,0,25,5
1746606227544,MUS 6,A01,891053,Freitas Caetano; Marcelo,24,0,25,1
1746606227544,MUS 6,A02,891054,Freitas Caetano; Marcelo,23,0,25,2
1746606228574,MUS 7,A01,891081,Staff,0,0,25,25
1746606228574,MUS 7,A02,891082,Staff,3,0,25,22
1746606229602,MUS 8GS,A00,891118,Borgo; David Garcia,1,0,25,24
1746606230630,MUS 11,A01,891140,Staff,8,0,25,17
1746606230630,MUS 11,A02,891141,Staff,21,0,25,4
1746606231658,MUS 13,A01,891143,Staff,8,0,25,17
1746606231658,MUS 13,A02,891144,Staff,24,0,25,1
1746606232684,MUS 15,A01,891146,Staff,9,0,25,16
1746606232684,MUS 15,A02,891148,Staff,21,0,25,4
1746606232684,MUS 15,B01,891150,Staff,18,0,25,7
1746606232684,MUS 15,B02,891151,Staff,25,0,25,0
1746606233710,MUS 20,A01,891153,Staff,5,0,20,15
1746606233710,MUS 20,A02,891155,Staff,14,0,20,6
1746606234735,MUS 80,A00,891156,Staff,19,0,25,6
1746606234735,MUS 80,B00,891157,Staff,23,0,25,2
1746606235764,MUS 130,A00,891158,Ohnishi; Takae,35,0,35,0
1746606236793,MUS 150GS,A01,891160,Borgo; David Garcia,1,0,25,24
1746606237822,MUS 170,A01,891162,Freitas Caetano; Marcelo,20,0,25,5
1746606237822,MUS 170,A02,891164,Freitas Caetano; Marcelo,21,0,25,4
1746606238849,NANO 11,A00,886220,Vazquez Mena; Oscar,13,0,15,2
1746606239876,NANO 15,A01,886222,Drews; Aaron,4,0,7,3
1746606240906,NANO 104,A00,886224,Sirbuly; Donald,17,0,25,8
1746606241934,PH 40,A00,886528,Staff,23,0,40,17
1746606242961,PH 45,A01,886799,Staff,35,0,40,5
1746606243988,PH 110,A00,886802,Staff,0,6,40,40
1746606245019,PH 172,A00,906716,Staff,19,0,35,16
1746606246047,PH 191,A00,886803,Staff,6,0,40,34
1746606247078,PHIL 1,A00,889500,Staff,20,0,30,10
1746606248110,PHIL 10,A01,889549,Grush; Rick Scott,16,0,22,6
1746606248110,PHIL 10,A02,889551,Grush; Rick Scott,22,0,22,0
1746606249137,PHIL 28,A01,889559,Lamey; Andy M.,0,2,31,31
1746606249137,PHIL 28,A02,889561,Lamey; Andy M.,0,1,30,30
1746606249137,PHIL 28,A03,889572,Lamey; Andy M.,0,1,30,30
1746606250167,PHIL 35,A00,907839,Staff,13,0,15,2
1746606251191,PHIL 60,A00,889574,Staff,73,0,90,17
1746606252217,PHIL 101,A00,958004,Staff,12,0,15,3
1746606254272,PHIL 136,A00,889582,Fulkerson; Matthew Todd,26,0,45,19
1746606255300,PHIL 163,A01,889601,Staff,21,0,30,9
1746606255300,PHIL 163,B01,889606,Brandt; Reuven A,0,3,0,0
1746606256324,PHIL 164,A00,889610,Staff,16,0,30,14
1746606257352,PHIL 165,A00,889613,Staff,22,0,30,8
1746606258380,PHYS 1A,A00,886431,Staff,30,0,70,40
1746606259404,PHYS 1AL,001,886432,Tsai; Philbert S,0,1,30,30
1746606259404,PHYS 1AL,002,886436,Tsai; Philbert S,13,0,30,17
1746606260429,PHYS 1B,A00,886439,Staff,184,0,240,56
1746606261456,PHYS 1BL,001,886441,Tsai; Philbert S,0,4,30,30
1746606261456,PHYS 1BL,002,886444,Tsai; Philbert S,2,0,30,28
1746606262483,PHYS 1C,A00,896092,Arnold; Kam S,78,0,146,68
1746606263510,PHYS 1CL,001,886448,Tsai; Philbert S,0,0,30,30
1746606263510,PHYS 1CL,002,886449,Tsai; Philbert S,1,0,30,29
1746606263510,PHYS 1CL,003,886450,Tsai; Philbert S,16,0,30,14
1746606263510,PHYS 1CL,004,886451,Tsai; Philbert S,15,0,30,15
1746606264539,PHYS 2B,A01,886457,Staff,67,0,115,48
1746606265567,PHYS 2C,A01,886460,Shotwell; Brian,0,9,65,65
1746606266596,PHYS 2CL,A01,886467,Staff,0,4,28,28
1746606266596,PHYS 2CL,A02,886468,Staff,0,3,28,28
1746606267626,PHYS 2D,A01,886470,Staff,10,0,50,40
1746606268653,PHYS 4B,A01,886475,Grinstein; Benjamin,22,0,40,18
1746606269679,POLI 5,A00,891173,Desposato; Scott,7,0,25,18
1746606270705,POLI 5D,A01,891175,Staff,5,0,5,0
1746606270705,POLI 5D,B01,891178,Staff,5,0,5,0
1746606271737,POLI 11,A00,891179,Ferree; Karen E,0,0,35,35
1746606272762,POLI 12,A00,891180,Staff,15,0,30,15
1746606273790,POLI 27,A01,891182,Staff,11,0,75,64
1746606274815,POLI 30,A00,891183,Staff,8,0,50,42
1746606275842,POLI 100B,A00,891244,Staff,5,1,35,30
1746606276867,POLI 100I,A00,891247,Staff,7,0,30,23
1746606277899,POLI 104J,A00,891248,Nichter; Maysa,14,0,30,16
1746606278928,POLI 104U,A00,891250,Nichter; Maysa,1,0,30,29
1746606280996,POLI 110B,A00,891255,Wiens; David,19,0,25,6
1746606282022,POLI 112A,A00,891256,Wiens; David,6,0,25,19
1746606283047,POLI 114BR,A00,891261,Staff,19,0,30,11
1746606284075,POLI 117R,A00,891262,Forman; Fonna,0,6,50,50
1746606285102,POLI 118,A00,891264,Ingham; Sean,17,0,25,8
1746606286128,POLI 124A,A00,891265,Staff,18,0,20,2
1746606287157,POLI 125D,A00,891266,Nichter; Simeon C,2,0,25,23
1746606288186,POLI 126,A00,891268,Nichter; Simeon C,7,0,25,18
1746606289216,POLI 126AA,A00,891272,Staff,15,0,25,10
1746606290255,POLI 130AA,A00,891273,Staff,15,0,20,5
1746606291283,POLI 134AA,A00,891274,Staff,4,0,20,16
1746606293336,POLI 138,A00,891278,Staff,21,0,25,4
1746606294365,POLI 142K,A00,891280,Staff,10,0,25,15
1746606295395,POLI 142M,A00,891281,Gartzke; Erik,16,0,30,14
1746606296422,POLI 142P,A00,891284,Staff,20,0,30,10
1746606297450,POLI 143,A00,891285,Gartzke; Erik,12,0,30,18
1746606298479,POLI 153,A00,891286,Staff,19,0,20,1
1746606300535,POLI 175,A00,891290,Staff,15,0,20,5
1746606301607,PSYC 1,A00,890674,Steiner; Eric Tomas,0,11,45,45
1746606302632,PSYC 2,A00,890676,Albright; Thomas D,20,0,35,15
1746606303659,PSYC 3,A00,890679,Staff,17,0,20,3
1746606304685,PSYC 6,A00,959858,Staff,19,0,20,1
1746606305711,PSYC 60,A01,890684,Rickard; Timothy C.,0,6,45,45
1746606306741,PSYC 70,A01,890689,Geller; Emma Harlan,6,0,30,24
1746606307767,PSYC 71,A01,959860,Staff,21,0,25,4
1746606308796,PSYC 100,A00,890690,Lacefield; Katharine I,0,50,180,180
1746606309820,PSYC 102,A00,890695,Staff,18,0,40,22
1746606310847,PSYC 105,A00,890699,Geller; Emma Harlan,70,0,100,30
1746606311877,PSYC 106,A00,890701,Gorman; Michael R.,5,0,30,25
1746606312908,PSYC 108,A00,890704,Adrian; Julia Anna,0,29,50,50
1746606313935,PSYC 118,A01,890712,Staff,11,0,30,19
1746606314961,PSYC 124,A00,890716,Chapman; Eddie Nathaniel,25,0,60,35
1746606315986,PSYC 131,A00,890717,Anagnostaras; Stephan,0,7,80,80
1746606317012,PSYC 137,A00,890719,Winkielman; Piotr,0,11,30,30
1746606318042,PSYC 144,A00,890721,Adrian; Julia Anna,0,9,45,45
1746606319068,PSYC 162,A00,890805,Staff,0,2,75,75
1746606320093,PSYC 169,A00,890810,Staff,0,15,30,30
1746606321121,PSYC 172,A00,890814,Gorman; Michael R.,9,0,30,21
1746606322148,PSYC 181,A00,890818,Anagnostaras; Stephan,6,0,200,194
1746606323175,PSYC 184,A00,959861,Staff,160,0,175,15
1746606324206,PSYC 189,A00,890823,Staff,0,2,30,30
1746606325232,PSYC 191,A00,890884,Rickard; Timothy C.,0,12,35,35
1746606326263,PSYC 193,A00,890913,Staff,19,0,30,11
1746606326263,PSYC 193,B00,890914,Chapman; Eddie Nathaniel,24,0,30,6
1746606327290,PSYC 193L,A01,890918,Lowe; Angela Beth,20,0,30,10
1746606327290,PSYC 193L,B01,890921,Hurwitz; Ethan Scott,20,0,30,10
1746606327290,PSYC 193L,C01,890928,Staff,30,0,30,0
1746606328316,RELI 149,A00,886806,Rahimi; Babak,23,0,40,17
1746606329342,SE 9,A01,886814,Staff,7,0,20,13
1746606330373,SE 101B,A01,886816,Chadha; Mayank,3,0,35,32
1746606331401,SE 110B,A00,886818,Zhu; Qiang,4,0,75,71
1746606332427,SE 125,A01,886830,Staff,10,0,30,20
1746606333453,SE 130B,A01,886835,Staff,14,0,40,26
1746606334483,SE 131A,A01,886838,Krysl; Petr,34,0,55,21
1746606335510,SE 154,A00,886840,Staff,28,0,50,22
1746606336536,SE 164GS,A01,886849,Staff,6,0,20,14
1746606337563,SE 167GS,A01,886853,Staff,6,0,20,14
1746606338594,SIO 25,A01,890107,Staff,19,0,30,11
1746606339624,SIO 45,A00,890109,Cook; Geoffrey W,115,0,200,85
1746606340652,SIO 109R,A00,890110,Forman; Fonna,0,16,20,20
1746606341679,SIO 187,A01,890114,Kacev; David,15,0,40,25
1746606342710,SOCI 1,A01,890431,Thorpe; Charles Robert,14,0,30,16
1746606342710,SOCI 1,A02,890518,Thorpe; Charles Robert,30,0,30,0
1746606343740,SOCI 2,A01,957978,Staff,25,0,25,0
1746606343740,SOCI 2,A02,957979,Staff,23,0,25,2
1746606344769,SOCI 20,A01,890523,Calderon-Zaks; Michael Aar,21,0,30,9
1746606344769,SOCI 20,A02,890526,Calderon-Zaks; Michael Aar,29,0,30,1
1746606345793,SOCI 30,A01,890533,Pardo Guerra; Juan Pablo,37,0,40,3
1746606346821,SOCI 40,A01,890535,Staff,27,0,45,18
1746606347849,SOCI 104Q,A00,890559,Staff,17,0,30,13
1746606348877,SOCI 106,A00,890560,Arnal; Maud Marie Leonie,20,0,30,10
1746606349904,SOCI 110,A00,890567,Holkenbrink-Monk; Charlene,19,0,30,11
1746606350931,SOCI 112,A00,890568,Victoria Torres; Pablo,2,0,55,53
1746606351961,SOCI 115,A00,890597,Arnal; Maud Marie Leonie,28,0,45,17
1746606354017,SOCI 121,A00,890604,Pardo Guerra; Juan Pablo,38,0,45,7
1746606355044,SOCI 126,A01,890608,Staff,8,0,10,2
1746606356070,SOCI 127,A00,890609,Staff,18,0,30,12
1746606357097,SOCI 131,A00,890610,Thorpe; Charles Robert,37,0,45,8
1746606358123,SOCI 135,A00,890615,Payne; Christine Anna,14,0,45,31
1746606359150,SOCI 139,A00,890620,Staff,38,0,45,7
1746606360177,SOCI 148E,A00,890622,Calderon-Zaks; Michael Aar,36,0,45,9
1746606361206,SOCI 150,A00,890623,Kohler; Kristopher M.,31,0,45,14
1746606362232,SOCI 157,A00,890625,Jules-Rosette; Bennetta W.,18,0,20,2
1746606363255,SOCI 160,A00,890627,Payne; Christine Anna,21,0,45,24
1746606364287,SYN 1,A00,886855,Fish; Gwendolyn Anne,0,1,0,0
1746606364287,SYN 1,B00,906086,Fish; Gwendolyn Anne,0,2,0,2
1746606365314,SYN 2R,A00,886860,Staff,0,17,15,15
1746606365314,SYN 2R,B00,906106,Atkinson; Arthur Laird,0,16,15,15
1746606366346,SYN 100,A01,886866,Browne; Emily,0,28,20,20
1746606366346,SYN 100,B01,906128,Rock; Martin,0,4,20,20
1746606366346,SYN 100,C01,906140,Deavenport; James Cary,0,4,20,20
1746606366346,SYN 100,D01,907816,Deavenport; James Cary,0,5,20,20
1746606367376,TDAC 1,A00,890286,Walsh; Kim C.,7,0,20,13
1746606368400,TDAC 101,A00,890296,Basso; Beatrice,15,0,20,5
1746606369431,TDDE 131,A00,890297,Staff,47,0,50,3
1746606370460,TDDM 1,A00,890287,Weinberg; Sadie,25,0,30,5
1746606371490,TDGE 11,A00,890288,Fulton; Julia,138,0,200,62
1746606371490,TDGE 11,B00,890289,Castro; Robert Jess,184,0,200,16
1746606372520,TDGE 25,B00,957359,Walsh; Kim C.,5,0,20,15
1746606373547,TDGE 40,A01,890292,Power; Jade Yukana,26,0,30,4
1746606374577,TDGE 124,A00,890298,Havis; Allan,0,2,50,50
1746606375606,TDGE 131R,A00,890299,Burelle; Julie Sara Veronique,15,0,42,27
1746606376630,TDHT 101,A00,890300,Staff,10,0,20,10
1746606377655,TDHT 109,A01,890302,Anderson; Mysia Anyse,31,0,40,9
1746606378681,TDMV 1,A00,890293,Arcidiacono; Kristin,18,0,30,12
1746606379709,TDMV 2,A00,890294,Weinberg; Sadie,23,0,30,7
1746606380733,TDMV 3,A00,957878,Arcidiacono; Kristin,28,0,30,2
1746606382788,TDMV 138,A00,890304,Jun; Grace Shin Hae,25,0,40,15
1746606383836,TDMV 140,A00,890305,Corrales; Joseph Bernales,25,0,30,5
1746606384859,TDMV 142,A00,890307,Caligagan; Tony,32,0,40,8
1746606385885,TDMV 144,A00,890308,Camaya; Michelle Ann,25,0,30,5
1746606386909,TDPW 1,A00,890295,Stein; Deborah Isobel,3,0,20,17
1746606388024,USP 2,A01,890272,Lerner; Amy M,7,0,20,13
1746606389048,USP 3,A01,890274,Staff,12,0,30,18
1746606390076,USP 15,A01,890276,Sun; Feiyang,16,0,30,14
1746606391100,USP 25,A00,890277,Shenkman; Michael Thomas,18,0,25,7
1746606392130,USP 138,A00,890278,Staff,13,0,25,12
1746606393236,USP 143,A00,890279,Staff,21,0,70,49
1746606394261,USP 144,A00,890280,Chowdhury; Muhammed Zohir,16,0,30,14
1746606395290,USP 150,A00,890281,Boomhower; Matthew Charles,4,0,30,26
1746606396317,USP 151,A00,890282,Staff,16,0,20,4
1746606397344,USP 162,A00,890283,Andrews; Abigail Leslie,16,0,20,4
1746606398374,USP 168,A00,920477,Kwak; Nancy,0,0,5,5
1746606399402,USP 181,A00,890284,Staff,3,0,20,17
1746606400431,USP 191A,A00,890285,Staff,12,0,20,8
1746606401457,VIS 101,A00,886512,Staff,26,0,75,49
1746606402486,VIS 103,A00,886513,Cruz; Edwin Teddy,61,0,75,14
1746606403513,VIS 108,A00,886514,Staff,4,0,15,11
1746606404540,VIS 127P,A00,886515,Shen; Kuiyi,80,0,146,66
1746606405567,VIS 149,A00,886516,Yoldas; Pinar,0,0,15,15
1746606406594,VIS 164,A00,886526,Erdmann; Dean,19,0,22,3
1746606407618,VIS 194S,A00,886527,Staff,61,0,75,14
1746606408645,WCWP 10A,C00,886484,Martiniuk; Jill,12,0,15,3
1746606409672,WCWP 10B,A00,886490,Uriarte; Emma,0,0,15,15
1746606409672,WCWP 10B,B00,886491,Dhir; Simrita,8,0,15,7
1746606409672,WCWP 10B,C00,886492,Ornelas; Tricia,0,0,15,15
1746606410703,WCWP 100,A00,886494,Young; Mark T,0,6,15,15
1746606412852,AAS 10,A01,886199,Childs; Dennis R.,0,3,0,0
1746606413878,ANAR 104,A01,886940,Shtienberg; Gilad,27,0,30,3
1746606414905,ANAR 120,A00,886953,Staff,13,0,20,7
1746606415930,ANBI 148,A01,886955,Wilder; Linnea Lorene,30,0,40,10
1746606417987,ANSC 122,A00,886957,Staff,24,0,30,6
1746606419017,ANSC 150,A00,886958,Sloane; Julia Kathryn,2,0,15,13
1746606420041,ANSC 156,A00,886959,Jenkins; Janis A.,0,1,15,15
1746606421066,ANSC 180,A00,886960,Staff,11,0,17,6
1746606422099,ANSC 188,A00,886961,Jassal; Aftab,9,0,25,16
1746606423127,ANSC 190,A00,886962,Jassal; Aftab,14,0,25,11
1746606424151,ANSC 191,A00,886963,Staff,18,0,20,2
1746606425180,ANTH 3,A01,891689,Staff,17,0,20,3
1746606426209,ANTH 5,A00,886933,Semendeferi; Ekaterini,16,0,20,4
1746606427234,ANTH 10,A00,886934,Staff,0,12,30,30
1746606428258,ANTH 21,A01,886936,Staff,41,0,60,19
1746606429284,ANTH 23,A01,886938,Staff,92,0,100,8
1746606430306,ANTH 105,A00,886964,Stewart; Alexander B,84,0,100,16
1746606431334,ANTH 108,A00,886965,Pedersen; David,9,0,20,11
1746606432369,AWP 10,001,886147,Staff,0,0,0,0
1746606432369,AWP 10,002,886148,Staff,0,0,0,0
1746606432369,AWP 10,003,886149,Staff,0,0,0,0
1746606432369,AWP 10,004,886150,Staff,0,0,0,0
1746606432369,AWP 10,005,886151,Staff,0,0,0,0
1746606432369,AWP 10,006,886152,Staff,0,0,0,0
1746606432369,AWP 10,007,886153,Staff,0,0,0,0
1746606432369,AWP 10,008,886154,Staff,0,0,0,0
1746606432369,AWP 10,009,886155,Staff,0,0,0,0
1746606432369,AWP 10,010,886156,Staff,0,0,0,0
1746606432369,AWP 10,011,886158,Staff,0,0,0,0
1746606432369,AWP 10,012,886160,Staff,0,0,0,0
1746606432369,AWP 10,013,886161,Staff,0,0,0,0
1746606432369,AWP 10,014,886162,Staff,0,0,0,0
1746606432369,AWP 10,015,886163,Staff,0,0,0,0
1746606432369,AWP 10,016,886164,Staff,0,0,0,0
1746606432369,AWP 10,017,886165,Staff,0,0,0,0
1746606432369,AWP 10,018,886166,Staff,0,0,0,0
1746606432369,AWP 10,019,886168,Staff,0,0,0,0
1746606432369,AWP 10,020,886170,Staff,0,0,0,0
1746606432369,AWP 10,021,886172,Staff,0,0,0,0
1746606433408,AWP 10R,001,886173,Staff,0,1,0,0
1746606433408,AWP 10R,002,886174,Staff,0,1,0,0
1746606433408,AWP 10R,003,886175,Staff,0,0,0,0
1746606433408,AWP 10R,004,886176,Staff,0,0,0,0
1746606433408,AWP 10R,005,886177,Staff,0,0,0,0
1746606433408,AWP 10R,006,886178,Staff,0,0,0,0
1746606433408,AWP 10R,007,886179,Staff,0,0,0,0
1746606433408,AWP 10R,008,886181,Staff,0,0,0,0
1746606433408,AWP 10R,009,886182,Staff,0,0,0,0
1746606433408,AWP 10R,010,886183,Staff,0,0,0,0
1746606433408,AWP 10R,011,886184,Staff,0,0,0,0
1746606433408,AWP 10R,012,886185,Staff,0,0,0,0
1746606433408,AWP 10R,013,886186,Staff,0,0,0,0
1746606433408,AWP 10R,014,886187,Staff,0,0,0,0
1746606433408,AWP 10R,015,886188,Staff,0,0,0,0
1746606433408,AWP 10R,016,886189,Staff,0,0,0,0
1746606433408,AWP 10R,017,960532,Staff,0,0,0,0
1746606433408,AWP 10R,018,960533,Staff,0,0,0,0
1746606433408,AWP 10R,019,960534,Staff,0,0,0,0
1746606433408,AWP 10R,020,960538,Staff,0,0,0,0
1746606433408,AWP 10R,021,960540,Staff,0,0,0,0
1746606433408,AWP 10R,022,960541,Staff,0,0,0,0
1746606433408,AWP 10R,023,960542,Staff,0,0,0,0
1746606433408,AWP 10R,024,960544,Staff,0,0,0,0
1746606433408,AWP 10R,025,960545,Staff,0,0,0,0
1746606433408,AWP 10R,026,960548,Staff,0,0,0,0
1746606434435,AWP 102R,A00,886190,Staff,0,0,0,0
1746606434435,AWP 102R,B00,886191,Staff,0,0,0,0
1746606435462,BENG 100,A01,886193,Staff,17,0,30,13
1746606436488,BENG 122A,A01,886195,Hasty; Jeff M,13,0,30,17
1746606437516,BENG 166A,A00,886196,Sah; Robert Lie-Yuan,0,3,30,30
1746606438543,BENG 190,A00,958050,Khojah; Reem I,17,0,25,8
1746606439570,BIBC 102,A01,894320,Staff,0,1,46,46
1746606439570,BIBC 102,A02,894321,Staff,0,0,46,46
1746606439570,BIBC 102,A03,894344,Staff,6,0,46,40
1746606439570,BIBC 102,A04,894345,Staff,27,0,47,20
1746606440596,BICD 100R,A01,894365,Smith; Laurie,0,2,58,58
1746606440596,BICD 100R,A02,894366,Smith; Laurie,0,4,58,58
1746606440596,BICD 100R,A03,894367,Smith; Laurie,0,0,59,59
1746606440596,BICD 100R,A04,959869,Smith; Laurie,38,0,59,21
1746606441626,BICD 136,A01,894383,Gustafson-Brown; Cindy,14,0,50,36
1746606442651,BIEB 102,A01,894494,Butler; Shannon Rhey,51,0,130,79
1746606444705,BIEB 150,A01,894617,Wills; Christopher,3,0,20,17
1746606444705,BIEB 150,A02,894631,Wills; Christopher,3,0,20,17
1746606444705,BIEB 150,A03,894937,Wills; Christopher,3,0,20,17
1746606444705,BIEB 150,A04,894946,Wills; Christopher,5,0,20,15
1746606445730,BIEB 194,A00,906141,Kurle; Carolyn M.,5,0,20,15
1746606446756,BILD 1,A01,894154,Staff,3,0,19,16
1746606446756,BILD 1,A02,894155,Staff,14,0,19,5
1746606446756,BILD 1,A03,894160,Staff,13,0,19,6
1746606446756,BILD 1,A04,894161,Staff,15,0,18,3
1746606447783,BILD 2,A01,894168,Staff,0,0,50,50
1746606447783,BILD 2,A02,894169,Staff,0,0,50,50
1746606447783,BILD 2,A03,894179,Staff,0,0,50,50
1746606447783,BILD 2,A04,894203,Staff,22,0,50,28
1746606448813,BILD 3,A01,894213,Staff,23,0,31,8
1746606448813,BILD 3,A02,894214,Staff,26,0,31,5
1746606448813,BILD 3,A03,894235,Staff,28,0,31,3
1746606448813,BILD 3,A04,894236,Staff,28,0,32,4
1746606449843,BILD 4,A01,894253,Reuther; Keefe,5,0,24,19
1746606449843,BILD 4,A02,894258,Reuther; Keefe,16,0,24,8
1746606450874,BILD 5,A01,894276,Reuther; Keefe,34,0,50,16
1746606450874,BILD 5,A02,894277,Reuther; Keefe,45,0,50,5
1746606450874,BILD 5,A03,894290,Reuther; Keefe,44,0,50,6
1746606450874,BILD 5,A04,894291,Reuther; Keefe,48,0,50,2
1746606451898,BILD 24,A01,894297,Pirino; Giorgia,40,0,60,20
1746606452924,BIMM 100,B01,958915,Staff,71,0,100,29
1746606453954,BIMM 101,A01,895017,McDonnell; Lisa Marie,0,5,24,24
1746606453954,BIMM 101,A02,895018,McDonnell; Lisa Marie,0,5,24,24
1746606453954,BIMM 101,B01,895020,McDonnell; Lisa Marie,0,5,24,24
1746606453954,BIMM 101,B02,895021,McDonnell; Lisa Marie,0,4,24,24
1746606454991,BIMM 110,A01,895023,Staff,1,0,25,24
1746606454991,BIMM 110,A02,895024,Staff,9,0,25,16
1746606454991,BIMM 110,A03,895025,Staff,18,0,25,7
1746606454991,BIMM 110,A04,895031,Staff,20,0,25,5
1746606456018,BIMM 120,A01,895114,Gustafson-Brown; Cindy,14,0,28,14
1746606456018,BIMM 120,A02,895126,Gustafson-Brown; Cindy,21,0,27,6
1746606457045,BIPN 100,A01,895130,Yang; Mingyu,0,0,38,38
1746606457045,BIPN 100,A02,895131,Yang; Mingyu,31,0,38,7
1746606457045,BIPN 100,A03,895132,Yang; Mingyu,32,0,38,6
1746606457045,BIPN 100,A04,895133,Yang; Mingyu,27,0,36,9
1746606458072,BIPN 120,A01,895135,Cooke; James Edward,0,3,13,13
1746606458072,BIPN 120,A02,895136,Cooke; James Edward,0,1,13,13
1746606458072,BIPN 120,A03,895137,Cooke; James Edward,0,3,13,13
1746606458072,BIPN 120,A04,895156,Cooke; James Edward,0,2,11,11
1746606459100,BIPN 134,A01,895235,Cooke; James Edward,0,1,25,25
1746606459100,BIPN 134,A02,895237,Cooke; James Edward,0,0,25,25
1746606459100,BIPN 134,A03,895240,Cooke; James Edward,1,0,25,24
1746606459100,BIPN 134,A04,895270,Cooke; James Edward,20,0,25,5
1746606460128,BIPN 189,A00,892103,Staff,0,14,14,14
1746606462203,BISP 194,A00,958008,Staff,0,2,0,0
1746606463229,CAT 124,A01,922009,Staff,0,5,20,20
1746606464259,CAT 125R,A00,886390,Morales; Celeste Georgianna,0,4,20,20
1746606464259,CAT 125R,B00,886391,Irwin; Matthew Joseph,0,4,20,20
1746606464259,CAT 125R,C00,886392,Smith; Lauryn Alissa,0,2,20,20
1746606464259,CAT 125R,D00,886393,Vanderschuit; Maya Alysia,0,3,20,20
1746606464259,CAT 125R,E00,886394,Marchisotto; Jennifer Anne,0,3,20,20
1746606465290,CENG 15,A01,886218,Drews; Aaron,3,0,8,5
1746606466315,CENG 113,A00,886219,Opatkiewicz; Justin Paul,15,0,25,10
1746606467342,CGS 101,A00,887044,Staff,7,0,20,13
1746606468370,CGS 105,A01,887046,Staff,14,0,25,11
1746606469397,CGS 112,A00,887047,Cuong; Marisol,12,0,15,3
1746606470425,CGS 113,A00,887048,Staff,23,0,30,7
1746606471454,CGS 120,A00,887049,Staff,9,0,17,8
1746606472485,CHEM 6A,A01,886336,Lam; Tin Yiu,38,0,50,12
1746606472485,CHEM 6A,A02,886338,Lam; Tin Yiu,37,0,50,13
1746606473514,CHEM 6B,A01,886341,Hopkins; Patrycja Anna,16,0,50,34
1746606473514,CHEM 6B,A02,886343,Hopkins; Patrycja Anna,42,0,50,8
1746606474550,CHEM 6C,A01,886346,Albizati; Kim F.,0,2,50,50
1746606474550,CHEM 6C,A02,886348,Albizati; Kim F.,24,0,50,26
1746606475576,CHEM 40A,A01,886352,Klosterman; Jeremy K,65,0,100,35
1746606476602,CHEM 40B,A01,886356,Klosterman; Jeremy K,0,24,100,100
1746606477634,CHEM 41B,A01,886360,Theodorakis; Emmanuel,25,0,50,25
1746606477634,CHEM 41B,A02,886362,Theodorakis; Emmanuel,47,0,50,3
1746606478662,CHIN 165A,A00,886382,Xu; Li,18,0,20,2
1746606479692,CLAS 120,A00,886387,Myerston Santana; Jacobo,33,0,40,7
1746606480720,COGS 9,A01,886967,Shannon; Kyle Michael,42,0,60,18
1746606481750,COGS 11,A01,886969,Staff,9,0,30,21
1746606482778,COGS 14A,A01,886971,Staff,5,0,60,55
1746606483832,COGS 14B,A01,886973,Hoffman; Drew Ellen,4,0,60,56
1746606484861,COGS 18,A01,886975,Morgan; Eric,34,0,60,26
1746606485887,COGS 20,A01,886977,Staff,3,0,8,5
1746606485887,COGS 20,A02,886978,Staff,5,0,7,2
1746606486913,COGS 100,A01,907783,Staff,0,1,30,30
1746606487938,COGS 101B,A01,886980,Staff,0,4,48,48
1746606488965,COGS 101C,A01,886982,Delgado; Tania,0,5,44,44
1746606489993,COGS 102A,A01,886984,Johnson; Christine M.,3,0,30,27
1746606491023,COGS 118B,A01,886986,Staff,0,4,88,88
1746606492048,COGS 150,A01,886988,Bergen; Benjamin,22,0,50,28
1746606493076,COGS 153,A00,886989,Delgado; Tania,1,3,41,40
1746606494103,COGS 186,A01,886991,Staff,0,0,32,32
1746606495131,COGS 187A,A01,886993,Boyle; Mary E. T.,7,0,30,23
1746606496155,COGS 189,A00,886994,Staff,0,1,30,30
1746606497182,COMM 10,A01,886996,Staff,0,0,20,21
1746606497182,COMM 10,A02,886997,Staff,10,0,20,10
1746606497182,COMM 10,A03,959845,Staff,19,0,20,1
1746606498212,COMM 20,A01,886999,Leuning; Grant Maurstad,24,0,40,16
1746606500262,COMM 100A,A01,887002,Staff,0,0,20,25
1746606500262,COMM 100A,A02,887003,Staff,5,0,20,15
1746606501287,COMM 100B,A01,887005,Staff,0,8,20,24
1746606502313,COMM 106D,A00,887006,Staff,14,0,40,26
1746606503396,COMM 110G,A00,887007,Whitworth-Smith; Andrew C,12,0,40,28
1746606504424,COMM 111B,A00,887008,Staff,31,0,40,9
1746606505450,COMM 113T,A00,887009,Abuelhiga; Soraya Jill,28,0,40,12
1746606505450,COMM 113T,B00,906733,Staff,39,0,40,1
1746606506475,COMM 145,A00,887010,Staff,13,0,40,27
1746606507506,COMM 146,A00,887054,Staff,32,0,40,8
1746606508530,COMM 190,A00,887012,Staff,8,0,23,15
1746606509557,CSE 8A,A50,887015,Cao; Yingjun,56,0,85,29
1746606510587,CSE 11,A01,887017,Cao; Yingjun,11,0,70,59
1746606511614,CSE 20,A01,887019,Staff,30,0,50,20
1746606512643,CSE 21,A01,887021,Staff,79,0,100,21
1746606512643,CSE 21,B01,892583,Braun; Oliver,45,0,50,5
1746606513678,CSE 30,A01,887025,Eldon; John,142,0,200,58
1746606514705,CSE 100,A01,887027,Staff,26,0,50,24
1746606514705,CSE 100,A02,887028,Staff,42,0,50,8
1746606515738,CSE 101,A01,887030,Braun; Oliver,74,0,100,26
1746606515738,CSE 101,B01,887032,Jones; Miles E,0,3,50,50
1746606515738,CSE 101,B02,887033,Jones; Miles E,0,2,50,50
1746606516766,CSE 105,A01,908084,Jones; Miles E,32,0,50,18
1746606516766,CSE 105,A02,908087,Jones; Miles E,31,0,50,19
1746606517791,CSE 135,A01,887035,Powell; Thomas Allan,0,5,50,50
1746606518816,CSE 142,A01,887037,Staff,7,0,60,53
1746606519847,CSE 142L,A01,887039,Staff,34,0,60,26
1746606520874,CSE 151A,A01,887041,Solares; Edwin A,47,0,100,53
1746606521902,CSE 175,A01,887043,Kumar; Rakesh,30,0,30,0
1746606522932,CSS 1,A01,886389,Staff,0,1,40,40
1746606523959,DSC 30,A01,908097,Liao; Soohyun Nam,47,0,75,28
1746606524985,DSC 40A,A01,908099,Shannon; Kyle Michael,30,0,50,20
1746606526012,DSC 40B,A01,908112,Staff,15,0,50,35
1746606527041,DSC 80,A01,908116,Staff,19,0,60,41
1746606528069,DSC 197,001,956863,Eldridge; Justin Matthew,9999,0,9999,0
1746606529100,ECE 5,A01,886400,Morris; Karcher William,1,0,6,5
1746606529100,ECE 5,A02,886401,Morris; Karcher William,3,0,6,3
1746606530129,ECE 148,A01,886403,Silberman; Jack,0,14,14,14
1746606531161,ECON 1,A01,887265,Crane; Meredith Helen,11,0,70,59
1746606531161,ECON 1,B01,887268,Staff,42,0,50,8
1746606532185,ECON 2,A01,887273,Crane; Meredith Helen,54,0,70,16
1746606533214,ECON 3,A01,887279,Rondina; Giacomo,31,0,70,39
1746606534243,ECON 4,A01,887282,Anderson; John Charles,0,2,10,10
1746606535274,ECON 5,A01,887285,Staff,34,0,45,11
1746606535274,ECON 5,B01,887292,Staff,41,0,45,4
1746606536310,ECON 100A,A01,887337,Newhouse; Herbert S,54,0,70,16
1746606536310,ECON 100A,B01,887349,Staff,45,0,50,5
1746606537339,ECON 100B,A01,887361,Du; Songzi,29,0,70,41
1746606538364,ECON 100C,A01,887445,Newhouse; Herbert S,59,0,70,11
1746606539393,ECON 105,A00,887488,Vespa; Emanuel Ignacio,23,0,35,12
1746606540428,ECON 109,A01,887506,Shishkin; Denis,28,0,35,7
1746606541479,ECON 110A,A01,887568,Alon; Titan Michael,0,2,35,35
1746606541479,ECON 110A,B01,907601,Alon; Titan Michael,20,0,35,15
1746606542505,ECON 110B,A01,887598,Levkoff; Steven B.,0,24,70,70
1746606543532,ECON 112,A00,887599,Rondina; Giacomo,19,0,35,16
1746606544619,ECON 120A,A01,887603,Dai; Yinlin,36,0,70,34
1746606545649,ECON 120C,A01,887608,Sun; Yixiao,0,1,35,35
1746606545649,ECON 120C,B01,887614,Sun; Yixiao,0,0,35,35
1746606546674,ECON 138,A00,887621,Bharadwaj; Prashant,0,21,20,20
1746606547701,ECON 144,A00,958007,Squires; Dale E,11,0,35,24
1746606548729,ECON 171,A01,907666,Staff,18,0,35,17
1746606549756,ECON 175,A00,887626,Wu; Pak Yeung,22,0,35,13
1746606550783,ECON 190,A00,887640,Vespa; Emanuel Ignacio,22,0,35,13
1746606551826,EDS 25,A01,888197,Staff,0,0,0,0
1746606551826,EDS 25,A02,888209,Staff,0,0,0,0
1746606551826,EDS 25,A03,888210,Staff,0,0,0,0
1746606551826,EDS 25,A04,888212,Staff,0,0,0,0
1746606551826,EDS 25,A05,888213,Staff,0,0,0,0
1746606551826,EDS 25,A06,888214,Staff,0,0,0,0
1746606551826,EDS 25,A07,888235,Staff,0,2,0,0
1746606551826,EDS 25,A08,888236,Staff,0,0,0,0
1746606551826,EDS 25,A09,888240,Staff,0,0,0,0
1746606551826,EDS 25,A10,888244,Staff,0,0,0,0
1746606551826,EDS 25,B01,888273,Staff,0,0,0,0
1746606551826,EDS 25,B02,888285,Staff,0,0,0,0
1746606551826,EDS 25,B03,888423,Staff,0,0,0,1
1746606551826,EDS 25,B04,888432,Staff,0,0,0,0
1746606551826,EDS 25,B05,888433,Staff,0,0,0,0
1746606551826,EDS 25,B06,888467,Staff,0,0,0,0
1746606551826,EDS 25,B07,888468,Staff,0,0,0,0
1746606551826,EDS 25,B08,888479,Staff,0,0,0,0
1746606551826,EDS 25,B09,888484,Staff,0,0,0,0
1746606551826,EDS 25,B10,888487,Staff,0,0,0,0
1746606552858,EDS 38,A01,907700,Choi; Bailey Miyeon,30,0,30,0
1746606553890,EDS 112,A01,888601,Chapman; Thandeka K,12,0,40,28
1746606554916,EDS 115,A00,888697,Mendez; Kathrina Mendoza,10,0,30,20
1746606555947,EDS 116,A01,888893,Staff,33,0,40,7
1746606558000,EDS 124AR,A00,889133,Staff,29,0,50,21
1746606558000,EDS 124AR,B00,907471,Simon; Elizabeth A,37,0,50,13
1746606559027,EDS 124BR,A00,889134,Simon; Elizabeth A,44,0,100,56
1746606560053,EDS 125,A00,889135,Staff,25,0,30,5
1746606561080,EDS 126,A01,889138,Staff,35,0,40,5
1746606562111,EDS 164R,A01,889142,Wishard Guerra; Alison G.,32,0,50,18
1746606563139,ENG 30,A01,886396,Staff,0,0,0,0
1746606563139,ENG 30,B01,886398,Staff,0,0,0,0
1746606564168,ENVR 102,A00,906150,Montejo; Carolina,23,0,25,2
1746606565199,ETHN 103A,A00,887236,Man; Simeon S,0,2,0,0
1746606566226,ETHN 113,A00,887239,Staff,16,0,30,14
1746606567254,ETHN 116,A00,887240,Staff,16,0,25,9
1746606568281,ETHN 117,A00,887241,Choi; Esther Min,28,0,30,2
1746606569309,ETHN 118,A00,887243,Staff,24,0,30,6
1746606570339,ETHN 127,A00,887248,Cuong; Marisol,11,0,15,4
1746606571364,ETHN 139,A00,887250,Staff,7,0,10,3
1746606572399,ETHN 142,A00,887252,Staff,9,0,30,21
1746606573431,ETHN 161,A00,887253,Browne; Errol Tsekani,24,0,30,6
1746606574456,ETHN 163FR,A00,887255,Burelle; Julie Sara Veronique,0,0,5,5
1746606575487,GLBH 20,A00,889149,Elwardani; Nile Regina,8,0,42,34
1746606577543,GLBH 111,A01,889152,Burgos; Jose L.,17,0,17,0
1746606578573,GLBH 150,A00,889181,Sloane; Julia Kathryn,0,5,15,15
1746606580631,HDS 60,A01,886406,Warstadt; Melissa Fawn,72,0,80,8
1746606581658,HIAF 111,A00,889324,Gyamfi; Bright,25,0,32,7
1746606582685,HIEA 131,A00,889328,Staff,15,0,32,17
1746606583717,HIEA 144,A00,889333,Henry; Todd A.,26,0,32,6
1746606584743,HIEA 154,A00,889336,Henry; Todd A.,24,0,32,8
1746606585771,HIEU 106,A00,889339,Staff,22,0,32,10
1746606587820,HIEU 114,A00,889340,Staff,4,0,32,28
1746606588847,HIEU 135GS,A00,889342,Patterson; Patrick H.,0,0,1,24
1746606589876,HIEU 137,A00,889343,Edington; Claire Ellen,10,0,25,15
1746606590905,HIEU 148,A00,889345,Staff,14,0,32,18
1746606591935,HIEU 154,A00,889346,Biess; Frank Peter,21,0,32,11
1746606592960,HILA 102,A00,889351,Staff,12,0,32,20
1746606593988,HILD 2A,A01,889221,Lewandoski; Julia Mavis,0,8,32,32
1746606595015,HILD 7B,A01,889225,Man; Simeon S,0,12,32,32
1746606596048,HILD 7C,A01,889288,Alvarez; Luis A,0,14,32,32
1746606597078,HILD 30,A01,889323,Staff,0,5,32,32
1746606599139,HISC 119,A00,889383,Golan; Tal,20,0,32,12
1746606600164,HIUS 103,A00,889384,Man; Simeon S,0,0,32,32
1746606601193,HIUS 117,A00,919797,Kwak; Nancy,18,0,32,14
1746606602221,HIUS 142A,A00,919788,Staff,22,0,32,10
1746606604277,HIUS 149,A00,889386,Gyamfi; Bright,26,0,32,6
1746606605304,HIUS 155,A00,889387,Alvarez; Luis A,15,0,32,17
1746606606331,HUM 3,A01,886499,Caldwell; Michael Alan,19,0,50,31
1746606607355,HUM 3GS,A00,886500,Rodriguez; Bretton Sigfred,0,0,0,28
1746606608381,HUM 3R,A01,886502,Markman; Kristina,0,36,50,50
1746606609409,HUM 4,A01,886504,Crum; Matthew Stephen,23,0,50,27
1746606609409,HUM 4,B01,886506,West; Geoffrey Scott,17,0,50,33
1746606610440,HUM 4GS,A00,886507,Staff,0,0,0,19
1746606611471,HUM 5,A01,886509,Staff,31,0,50,19
1746606612497,HUM 5R,A01,886511,Zavodny; Tatiana Sophia,0,39,50,50
1746606613527,JAPN 180,A00,886407,Staff,16,0,40,24
1746606614556,LATI 50,A01,886409,Martin-Cabrera; Luis,3,0,22,19
1746606614556,LATI 50,A02,886410,Martin-Cabrera; Luis,19,0,22,3
1746606614556,LATI 50,A03,886411,Martin-Cabrera; Luis,21,0,22,1
1746606614556,LATI 50,A04,886412,Martin-Cabrera; Luis,8,0,22,14
1746606615586,LAWS 101,A00,907664,Staff,28,0,60,32
1746606616612,LIAB 1A,A00,889388,Saab; Dima,17,0,20,3
1746606617639,LIAB 1AX,A00,889389,El Cheddadi; Youniss,18,0,20,2
1746606618669,LIFR 1C,A00,889391,Van Moer; Vinciane G,8,0,20,12
1746606619696,LIFR 1CX,A00,889392,Van Moer; Vinciane G,7,0,20,13
1746606620722,LIFR 1D,A00,889393,Van Moer; Vinciane G,7,0,20,13
1746606621751,LIFR 1DX,A00,889394,Van Moer; Vinciane G,8,0,20,12
1746606622777,LIGN 7,A00,886923,Staff,25,0,50,25
1746606623814,LIGN 17,A00,886924,Kehler; Andrew Scott,126,0,150,24
1746606624843,LTAM 110,A00,889395,Staff,15,0,30,15
1746606625869,LTAM 110GS,A00,958010,Rodriguez; Bretton Sigfred,0,0,0,28
1746606626895,LTCH 101,A00,889397,Staff,23,0,25,2
1746606627919,LTCS 130,A00,889398,Staff,23,0,25,2
1746606628947,LTEA 138,A00,889399,Staff,24,0,40,16
1746606629975,LTEN 149,A00,889400,Wesling; Megan E.,0,3,25,25
1746606631003,LTEN 169,A00,889401,Staff,20,0,25,5
1746606632029,LTEN 180,A00,889402,Staff,10,0,15,5
1746606633058,LTEN 181,A00,889403,Staff,21,0,25,4
1746606634085,LTWL 100,A00,889404,Myerston Santana; Jacobo,2,0,25,23
1746606635117,LTWL 180GS,A00,889405,Staff,0,0,20,20
1746606636144,LTWL 181,A00,889406,Staff,16,0,25,9
1746606637171,LTWL 184,A00,889475,Mukherjee; Silpa,22,0,25,3
1746606638198,LTWR 102C,A00,889486,Staff,29,0,30,1
1746606639227,LTWR 115W,A00,889491,Staff,0,2,15,15
1746606640285,MAE 8,A01,886905,Staff,0,2,0,0
1746606641318,MAE 11,A00,886906,Bandaru; Prabhakar,0,7,50,50
1746606642356,MAE 20,A00,886907,Evdokimenko; Ekaterina,43,0,70,27
1746606643380,MAE 30B,A00,886909,Ghazinejad; Maziar,25,0,45,20
1746606644408,MAE 101B,A00,886910,Saintillan; David,30,0,45,15
1746606645435,MAE 105,A00,886911,Bandaru; Prabhakar,18,0,50,32
1746606646462,MAE 107,B00,958024,Staff,7,0,50,43
1746606647493,MAE 143B,A00,886913,Bewley; Thomas R,2,0,40,38
1746606648524,MAE 148,A01,886915,Silberman; Jack,0,3,14,14
1746606649552,MAE 160,A00,886916,Evdokimenko; Ekaterina,30,0,60,30
1746606650592,MATH 3C,A01,889681,Staff,0,2,30,30
1746606650592,MATH 3C,A02,960048,Staff,23,0,30,7
1746606651625,MATH 10A,A01,889760,Staff,26,0,30,4
1746606651625,MATH 10A,A02,889783,Staff,29,0,30,1
1746606652656,MATH 10B,A01,889785,Verstraete; Jacques Allan,1,0,35,34
1746606652656,MATH 10B,A02,889795,Verstraete; Jacques Allan,4,0,35,31
1746606652656,MATH 10B,B01,889797,Verstraete; Jacques Allan,3,0,35,32
1746606652656,MATH 10B,B02,889828,Verstraete; Jacques Allan,3,0,35,32
1746606653688,MATH 10C,A01,889849,Habib; Yousaf,8,0,30,22
1746606653688,MATH 10C,A02,889852,Habib; Yousaf,14,0,30,16
1746606653688,MATH 10C,A03,889853,Habib; Yousaf,22,0,30,8
1746606653688,MATH 10C,A04,889858,Habib; Yousaf,20,0,30,10
1746606653688,MATH 10C,B01,889861,Staff,1,0,30,29
1746606653688,MATH 10C,B02,889862,Staff,24,0,30,6
1746606653688,MATH 10C,B03,889863,Staff,27,0,30,3
1746606653688,MATH 10C,B04,889967,Staff,23,0,30,7
1746606654716,MATH 18,A01,889974,Staff,6,0,30,24
1746606654716,MATH 18,A02,889977,Staff,20,0,30,10
1746606654716,MATH 18,B01,889984,Hardiman; Liam,20,0,30,10
1746606654716,MATH 18,B02,889985,Hardiman; Liam,25,0,30,5
1746606655747,MATH 20A,A01,889990,Suk; Andrew Hoon,30,0,35,5
1746606656775,MATH 20B,A01,889993,Ohm; Ko Woon,21,0,30,9
1746606656775,MATH 20B,A02,889994,Ohm; Ko Woon,30,0,30,0
1746606656775,MATH 20B,B01,889996,Ohm; Ko Woon,22,0,30,8
1746606656775,MATH 20B,B02,889997,Ohm; Ko Woon,23,0,30,7
1746606657809,MATH 20C,A01,889999,Hammock; Frances H,17,0,30,13
1746606657809,MATH 20C,A02,890003,Hammock; Frances H,23,0,30,7
1746606657809,MATH 20C,B01,890006,Hammock; Frances H,2,0,30,28
1746606657809,MATH 20C,B02,890007,Hammock; Frances H,11,0,30,19
1746606658844,MATH 20D,A01,890011,Cheng; Hsiao-Bing,1,0,30,29
1746606658844,MATH 20D,A02,890012,Cheng; Hsiao-Bing,14,0,30,16
1746606658844,MATH 20D,B01,890016,Cheng; Hsiao-Bing,13,0,30,17
1746606658844,MATH 20D,B02,890017,Cheng; Hsiao-Bing,13,0,30,17
1746606659882,MATH 20E,A01,890026,Harel; Guershon,1,0,30,29
1746606659882,MATH 20E,A02,890029,Harel; Guershon,22,0,30,8
1746606659882,MATH 20E,B01,890033,Harel; Guershon,7,0,30,23
1746606659882,MATH 20E,B02,890101,Harel; Guershon,21,0,30,9
1746606660910,MATH 102,A01,890104,Staff,18,0,30,12
1746606660910,MATH 102,A02,890105,Staff,27,0,30,3
1746606661939,MATH 103B,A01,890116,Salehi Golsefidy; Alireza,3,0,30,27
1746606661939,MATH 103B,B01,890118,Staff,0,3,34,34
1746606662969,MATH 109,A01,890121,Aliabadi Sr.; Mohsen,0,0,30,30
1746606662969,MATH 109,B01,890124,Upadrashta; Pranav Kumar,18,0,30,12
1746606663996,MATH 120A,A01,890126,Eggers; John Dietrich,13,0,30,17
1746606665052,MATH 142B,A01,890128,Ioana; Adrian,19,0,30,11
1746606665052,MATH 142B,A02,890129,Ioana; Adrian,12,0,30,18
1746606666080,MATH 154,A01,890174,Staff,0,1,30,30
1746606666080,MATH 154,A02,890182,Staff,0,0,30,30
1746606667108,MATH 168A,A01,890197,Dumitriu; Ioana,21,0,35,14
1746606668143,MATH 170A,A01,890240,Nie; Jiawang,1,0,30,29
1746606668143,MATH 170A,A02,890241,Nie; Jiawang,11,0,30,19
1746606668143,MATH 170A,A03,890249,Nie; Jiawang,23,0,30,7
1746606669169,MATH 170B,A01,957891,Nag; Panchali,13,0,35,22
1746606671226,MATH 181A,A01,908025,Staff,0,3,35,35
1746606671226,MATH 181A,A02,960115,Staff,26,0,35,9
1746606672256,MATH 181B,A01,959874,Staff,24,0,30,6
1746606673283,MATH 193B,A01,890265,Staff,0,4,35,35
1746606674317,MGT 4,A01,890311,Anderson; John Charles,42,0,88,46
1746606675348,MGT 5,A00,907740,Staff,12,0,98,86
1746606676391,MGT 12,A00,890312,Lindenberger; Wade Douglas,67,0,98,31
1746606677420,MGT 16,A00,957883,Staff,78,0,98,20
1746606679477,MGT 45,A00,890314,Pecore; Joseph P.,45,0,98,53
1746606680531,MGT 71,A00,890315,Staff,0,12,98,98
1746606681557,MGT 100,A00,890316,Yavorsky; Daniel Ryan,44,0,98,54
1746606682585,MGT 103,A00,890317,Ehrich; Kristine R,73,0,98,25
1746606683612,MGT 105,A00,890356,Bates; Kenneth Walter,0,8,98,98
1746606684638,MGT 112,A00,890360,Ehrich; Kristine R,55,0,98,43
1746606685666,MGT 127R,A00,907732,Zhu; Kevin Xiaoguo,23,0,98,75
1746606686700,MGT 131B,A00,890361,Anderson; John Charles,59,0,98,39
1746606687729,MGT 137,A00,890362,Lindenberger; Wade Douglas,65,0,98,33
1746606688755,MGT 160,A00,890369,Johnson; Erik Barry,9,0,98,89
1746606691329,MGT 164,A00,890372,Zimmermann; Carsten,0,40,98,98
1746606692356,MGT 180,A00,890374,Bliss; Barbara Ann,11,0,98,87
1746606693390,MMW 15,A01,886414,Chang; Edmond Yi-Teh,0,12,28,28
1746606693390,MMW 15,A02,886415,Chang; Edmond Yi-Teh,0,8,28,28
1746606693390,MMW 15,A03,886416,Chang; Edmond Yi-Teh,0,9,28,28
1746606693390,MMW 15,A04,886417,Chang; Edmond Yi-Teh,0,8,28,28
1746606693390,MMW 15,B01,886419,Chang; Edmond Yi-Teh,0,7,28,28
1746606693390,MMW 15,B02,886420,Chang; Edmond Yi-Teh,0,7,28,28
1746606693390,MMW 15,B03,886421,Chang; Edmond Yi-Teh,0,7,28,28
1746606693390,MMW 15,B04,886422,Chang; Edmond Yi-Teh,0,8,28,28
1746606693390,MMW 15,C01,886424,Staff,0,9,28,28
1746606693390,MMW 15,C02,886425,Staff,0,8,28,28
1746606693390,MMW 15,C03,886426,Staff,0,8,28,28
1746606693390,MMW 15,C04,886427,Staff,0,8,28,28
1746606693390,MMW 15,C05,958038,Staff,0,8,28,28
1746606693390,MMW 15,C06,958039,Staff,0,7,28,28
1746606694422,MMW 15GS,A00,906910,Patterson; Patrick H.,4,0,28,24
1746606695449,MMW 122R,A01,886429,Rahimi; Babak,0,13,28,28
1746606695449,MMW 122R,A02,886430,Rahimi; Babak,0,12,28,28
1746606695449,MMW 122R,A03,958040,Rahimi; Babak,0,11,28,28
1746606696476,MUS 1A,A01,890937,Staff,2,0,25,23
1746606696476,MUS 1A,A02,891035,Staff,6,0,25,19
1746606696476,MUS 1A,C01,958912,Staff,24,0,25,1
1746606696476,MUS 1A,C02,958913,Staff,25,0,25,0
1746606698536,MUS 2AK,A00,957092,Ohnishi; Takae,15,0,15,0
1746606699570,MUS 4,A01,891044,Staff,0,0,25,25
1746606699570,MUS 4,A02,891045,Staff,22,0,25,3
1746606699570,MUS 4,B01,891048,Staff,17,0,25,8
1746606699570,MUS 4,B02,891050,Staff,25,0,25,0
1746606700622,MUS 5,A01,957506,Dubnov; Shlomo,0,0,25,25
1746606700622,MUS 5,A02,957622,Dubnov; Shlomo,12,0,25,13
1746606700622,MUS 5,A03,957623,Dubnov; Shlomo,20,0,25,5
1746606701668,MUS 6,A01,891053,Freitas Caetano; Marcelo,24,0,25,1
1746606701668,MUS 6,A02,891054,Freitas Caetano; Marcelo,23,0,25,2
1746606702694,MUS 7,A01,891081,Staff,0,0,25,25
1746606702694,MUS 7,A02,891082,Staff,3,0,25,22
1746606703719,MUS 8GS,A00,891118,Borgo; David Garcia,1,0,25,24
1746606704753,MUS 11,A01,891140,Staff,8,0,25,17
1746606704753,MUS 11,A02,891141,Staff,21,0,25,4
1746606705778,MUS 13,A01,891143,Staff,8,0,25,17
1746606705778,MUS 13,A02,891144,Staff,24,0,25,1
1746606706811,MUS 15,A01,891146,Staff,9,0,25,16
1746606706811,MUS 15,A02,891148,Staff,21,0,25,4
1746606706811,MUS 15,B01,891150,Staff,18,0,25,7
1746606706811,MUS 15,B02,891151,Staff,25,0,25,0
1746606707840,MUS 20,A01,891153,Staff,5,0,20,15
1746606707840,MUS 20,A02,891155,Staff,14,0,20,6
1746606708868,MUS 80,A00,891156,Staff,19,0,25,6
1746606708868,MUS 80,B00,891157,Staff,23,0,25,2
1746606709899,MUS 130,A00,891158,Ohnishi; Takae,35,0,35,0
1746606710924,MUS 150GS,A01,891160,Borgo; David Garcia,1,0,25,24
1746606711949,MUS 170,A01,891162,Freitas Caetano; Marcelo,20,0,25,5
1746606711949,MUS 170,A02,891164,Freitas Caetano; Marcelo,21,0,25,4
1746606712978,NANO 11,A00,886220,Vazquez Mena; Oscar,13,0,15,2
1746606714004,NANO 15,A01,886222,Drews; Aaron,4,0,7,3
1746606715039,NANO 104,A00,886224,Sirbuly; Donald,17,0,25,8
1746606716065,PH 40,A00,886528,Staff,23,0,40,17
1746606717092,PH 45,A01,886799,Staff,35,0,40,5
1746606718138,PH 110,A00,886802,Staff,0,6,40,40
1746606719166,PH 172,A00,906716,Staff,19,0,35,16
1746606720192,PH 191,A00,886803,Staff,6,0,40,34
1746606721219,PHIL 1,A00,889500,Staff,20,0,30,10
1746606722247,PHIL 10,A01,889549,Grush; Rick Scott,16,0,22,6
1746606722247,PHIL 10,A02,889551,Grush; Rick Scott,22,0,22,0
1746606723274,PHIL 28,A01,889559,Lamey; Andy M.,0,2,31,31
1746606723274,PHIL 28,A02,889561,Lamey; Andy M.,0,1,30,30
1746606723274,PHIL 28,A03,889572,Lamey; Andy M.,0,1,30,30
1746606724299,PHIL 35,A00,907839,Staff,13,0,15,2
1746606725327,PHIL 60,A00,889574,Staff,73,0,90,17
1746606726353,PHIL 101,A00,958004,Staff,12,0,15,3
1746606728413,PHIL 136,A00,889582,Fulkerson; Matthew Todd,26,0,45,19
1746606729446,PHIL 163,A01,889601,Staff,21,0,30,9
1746606729446,PHIL 163,B01,889606,Brandt; Reuven A,0,3,0,0
1746606730475,PHIL 164,A00,889610,Staff,16,0,30,14
1746606731505,PHIL 165,A00,889613,Staff,22,0,30,8
1746606732533,PHYS 1A,A00,886431,Staff,30,0,70,40
1746606733559,PHYS 1AL,001,886432,Tsai; Philbert S,0,1,30,30
1746606733559,PHYS 1AL,002,886436,Tsai; Philbert S,13,0,30,17
1746606734588,PHYS 1B,A00,886439,Staff,184,0,240,56
1746606735616,PHYS 1BL,001,886441,Tsai; Philbert S,0,4,30,30
1746606735616,PHYS 1BL,002,886444,Tsai; Philbert S,2,0,30,28
1746606736643,PHYS 1C,A00,896092,Arnold; Kam S,78,0,146,68
1746606737671,PHYS 1CL,001,886448,Tsai; Philbert S,0,0,30,30
1746606737671,PHYS 1CL,002,886449,Tsai; Philbert S,1,0,30,29
1746606737671,PHYS 1CL,003,886450,Tsai; Philbert S,16,0,30,14
1746606737671,PHYS 1CL,004,886451,Tsai; Philbert S,15,0,30,15
1746606738699,PHYS 2B,A01,886457,Staff,67,0,115,48
1746606739726,PHYS 2C,A01,886460,Shotwell; Brian,0,9,65,65
1746606740752,PHYS 2CL,A01,886467,Staff,0,4,28,28
1746606740752,PHYS 2CL,A02,886468,Staff,0,3,28,28
1746606741780,PHYS 2D,A01,886470,Staff,10,0,50,40
1746606742813,PHYS 4B,A01,886475,Grinstein; Benjamin,22,0,40,18
1746606743842,POLI 5,A00,891173,Desposato; Scott,7,0,25,18
1746606744871,POLI 5D,A01,891175,Staff,5,0,5,0
1746606744871,POLI 5D,B01,891178,Staff,5,0,5,0
1746606745905,POLI 11,A00,891179,Ferree; Karen E,0,0,35,35
1746606746936,POLI 12,A00,891180,Staff,15,0,30,15
1746606747966,POLI 27,A01,891182,Staff,11,0,75,64
1746606748995,POLI 30,A00,891183,Staff,8,0,50,42
1746606750022,POLI 100B,A00,891244,Staff,5,1,35,30
1746606751052,POLI 100I,A00,891247,Staff,7,0,30,23
1746606752080,POLI 104J,A00,891248,Nichter; Maysa,14,0,30,16
1746606753106,POLI 104U,A00,891250,Nichter; Maysa,1,0,30,29
1746606755162,POLI 110B,A00,891255,Wiens; David,19,0,25,6
1746606756189,POLI 112A,A00,891256,Wiens; David,6,0,25,19
1746606757218,POLI 114BR,A00,891261,Staff,19,0,30,11
1746606758246,POLI 117R,A00,891262,Forman; Fonna,0,6,50,50
1746606759274,POLI 118,A00,891264,Ingham; Sean,17,0,25,8
1746606760303,POLI 124A,A00,891265,Staff,18,0,20,2
1746606761337,POLI 125D,A00,891266,Nichter; Simeon C,2,0,25,23
1746606762366,POLI 126,A00,891268,Nichter; Simeon C,7,0,25,18
1746606763396,POLI 126AA,A00,891272,Staff,15,0,25,10
1746606764424,POLI 130AA,A00,891273,Staff,15,0,20,5
1746606765452,POLI 134AA,A00,891274,Staff,4,0,20,16
1746606767505,POLI 138,A00,891278,Staff,21,0,25,4
1746606768536,POLI 142K,A00,891280,Staff,10,0,25,15
1746606769569,POLI 142M,A00,891281,Gartzke; Erik,16,0,30,14
1746606770608,POLI 142P,A00,891284,Staff,20,0,30,10
1746606771639,POLI 143,A00,891285,Gartzke; Erik,12,0,30,18
1746606772668,POLI 153,A00,891286,Staff,19,0,20,1
1746606774731,POLI 175,A00,891290,Staff,15,0,20,5
1746606775766,PSYC 1,A00,890674,Steiner; Eric Tomas,0,11,45,45
1746606776794,PSYC 2,A00,890676,Albright; Thomas D,20,0,35,15
1746606777821,PSYC 3,A00,890679,Staff,17,0,20,3
1746606778848,PSYC 6,A00,959858,Staff,19,0,20,1
1746606779875,PSYC 60,A01,890684,Rickard; Timothy C.,0,6,45,45
1746606780901,PSYC 70,A01,890689,Geller; Emma Harlan,6,0,30,24
1746606781927,PSYC 71,A01,959860,Staff,21,0,25,4
1746606782954,PSYC 100,A00,890690,Lacefield; Katharine I,0,50,180,180
1746606783980,PSYC 102,A00,890695,Staff,18,0,40,22
1746606785018,PSYC 105,A00,890699,Geller; Emma Harlan,70,0,100,30
1746606786051,PSYC 106,A00,890701,Gorman; Michael R.,5,0,30,25
1746606787078,PSYC 108,A00,890704,Adrian; Julia Anna,0,29,50,50
1746606788105,PSYC 118,A01,890712,Staff,11,0,30,19
1746606789135,PSYC 124,A00,890716,Chapman; Eddie Nathaniel,25,0,60,35
1746606790164,PSYC 131,A00,890717,Anagnostaras; Stephan,0,7,80,80
1746606791193,PSYC 137,A00,890719,Winkielman; Piotr,0,11,30,30
1746606792219,PSYC 144,A00,890721,Adrian; Julia Anna,0,9,45,45
1746606793245,PSYC 162,A00,890805,Staff,0,2,75,75
1746606794276,PSYC 169,A00,890810,Staff,0,15,30,30
1746606795307,PSYC 172,A00,890814,Gorman; Michael R.,9,0,30,21
1746606796332,PSYC 181,A00,890818,Anagnostaras; Stephan,6,0,200,194
1746606797366,PSYC 184,A00,959861,Staff,160,0,175,15
1746606798395,PSYC 189,A00,890823,Staff,0,2,30,30
1746606799422,PSYC 191,A00,890884,Rickard; Timothy C.,0,12,35,35
1746606800449,PSYC 193,A00,890913,Staff,19,0,30,11
1746606800449,PSYC 193,B00,890914,Chapman; Eddie Nathaniel,24,0,30,6
1746606801475,PSYC 193L,A01,890918,Lowe; Angela Beth,20,0,30,10
1746606801475,PSYC 193L,B01,890921,Hurwitz; Ethan Scott,20,0,30,10
1746606801475,PSYC 193L,C01,890928,Staff,30,0,30,0
1746606802501,RELI 149,A00,886806,Rahimi; Babak,23,0,40,17
1746606803528,SE 9,A01,886814,Staff,7,0,20,13
1746606804555,SE 101B,A01,886816,Chadha; Mayank,3,0,35,32
1746606805582,SE 110B,A00,886818,Zhu; Qiang,4,0,75,71
1746606806609,SE 125,A01,886830,Staff,10,0,30,20
1746606807690,SE 130B,A01,886835,Staff,14,0,40,26
1746606808719,SE 131A,A01,886838,Krysl; Petr,34,0,55,21
1746606809753,SE 154,A00,886840,Staff,28,0,50,22
1746606810782,SE 164GS,A01,886849,Staff,6,0,20,14
1746606811812,SE 167GS,A01,886853,Staff,6,0,20,14
1746606812842,SIO 25,A01,890107,Staff,19,0,30,11
1746606813869,SIO 45,A00,890109,Cook; Geoffrey W,115,0,200,85
1746606814898,SIO 109R,A00,890110,Forman; Fonna,0,16,20,20
1746606815931,SIO 187,A01,890114,Kacev; David,15,0,40,25
1746606816959,SOCI 1,A01,890431,Thorpe; Charles Robert,14,0,30,16
1746606816959,SOCI 1,A02,890518,Thorpe; Charles Robert,30,0,30,0
1746606817990,SOCI 2,A01,957978,Staff,25,0,25,0
1746606817990,SOCI 2,A02,957979,Staff,23,0,25,2
1746606819018,SOCI 20,A01,890523,Calderon-Zaks; Michael Aar,21,0,30,9
1746606819018,SOCI 20,A02,890526,Calderon-Zaks; Michael Aar,29,0,30,1
1746606820046,SOCI 30,A01,890533,Pardo Guerra; Juan Pablo,37,0,40,3
1746606821073,SOCI 40,A01,890535,Staff,27,0,45,18
1746606822098,SOCI 104Q,A00,890559,Staff,17,0,30,13
1746606823126,SOCI 106,A00,890560,Arnal; Maud Marie Leonie,20,0,30,10
1746606824158,SOCI 110,A00,890567,Holkenbrink-Monk; Charlene,19,0,30,11
1746606825185,SOCI 112,A00,890568,Victoria Torres; Pablo,2,0,55,53
1746606826214,SOCI 115,A00,890597,Arnal; Maud Marie Leonie,28,0,45,17
1746606828269,SOCI 121,A00,890604,Pardo Guerra; Juan Pablo,38,0,45,7
1746606829299,SOCI 126,A01,890608,Staff,8,0,10,2
1746606830327,SOCI 127,A00,890609,Staff,18,0,30,12
1746606831357,SOCI 131,A00,890610,Thorpe; Charles Robert,37,0,45,8
1746606832383,SOCI 135,A00,890615,Payne; Christine Anna,14,0,45,31
1746606833412,SOCI 139,A00,890620,Staff,38,0,45,7
1746606834440,SOCI 148E,A00,890622,Calderon-Zaks; Michael Aar,36,0,45,9
1746606835470,SOCI 150,A00,890623,Kohler; Kristopher M.,31,0,45,14
1746606836497,SOCI 157,A00,890625,Jules-Rosette; Bennetta W.,18,0,20,2
1746606837523,SOCI 160,A00,890627,Payne; Christine Anna,21,0,45,24
1746606838560,SYN 1,A00,886855,Fish; Gwendolyn Anne,0,1,0,0
1746606838560,SYN 1,B00,906086,Fish; Gwendolyn Anne,0,2,0,2
1746606839588,SYN 2R,A00,886860,Staff,0,17,15,15
1746606839588,SYN 2R,B00,906106,Atkinson; Arthur Laird,0,16,15,15
1746606840622,SYN 100,A01,886866,Browne; Emily,0,28,20,20
1746606840622,SYN 100,B01,906128,Rock; Martin,0,4,20,20
1746606840622,SYN 100,C01,906140,Deavenport; James Cary,0,4,20,20
1746606840622,SYN 100,D01,907816,Deavenport; James Cary,0,5,20,20
1746606841657,TDAC 1,A00,890286,Walsh; Kim C.,7,0,20,13
1746606842685,TDAC 101,A00,890296,Basso; Beatrice,15,0,20,5
1746606843710,TDDE 131,A00,890297,Staff,47,0,50,3
1746606844738,TDDM 1,A00,890287,Weinberg; Sadie,25,0,30,5
1746606845800,TDGE 11,A00,890288,Fulton; Julia,138,0,200,62
1746606845800,TDGE 11,B00,890289,Castro; Robert Jess,184,0,200,16
1746606846831,TDGE 25,B00,957359,Walsh; Kim C.,5,0,20,15
1746606847858,TDGE 40,A01,890292,Power; Jade Yukana,26,0,30,4
1746606848886,TDGE 124,A00,890298,Havis; Allan,0,2,50,50
1746606849912,TDGE 131R,A00,890299,Burelle; Julie Sara Veronique,15,0,42,27
1746606850942,TDHT 101,A00,890300,Staff,10,0,20,10
1746606851973,TDHT 109,A01,890302,Anderson; Mysia Anyse,31,0,40,9
1746606853004,TDMV 1,A00,890293,Arcidiacono; Kristin,18,0,30,12
1746606854028,TDMV 2,A00,890294,Weinberg; Sadie,23,0,30,7
1746606855054,TDMV 3,A00,957878,Arcidiacono; Kristin,28,0,30,2
1746606857111,TDMV 138,A00,890304,Jun; Grace Shin Hae,25,0,40,15
1746606858138,TDMV 140,A00,890305,Corrales; Joseph Bernales,25,0,30,5
1746606859167,TDMV 142,A00,890307,Caligagan; Tony,32,0,40,8
1746606860200,TDMV 144,A00,890308,Camaya; Michelle Ann,25,0,30,5
1746606861224,TDPW 1,A00,890295,Stein; Deborah Isobel,3,0,20,17
1746606862253,USP 2,A01,890272,Lerner; Amy M,7,0,20,13
1746606863284,USP 3,A01,890274,Staff,12,0,30,18
1746606864310,USP 15,A01,890276,Sun; Feiyang,16,0,30,14
1746606865336,USP 25,A00,890277,Shenkman; Michael Thomas,18,0,25,7
1746606866363,USP 138,A00,890278,Staff,13,0,25,12
1746606867389,USP 143,A00,890279,Staff,21,0,70,49
1746606868417,USP 144,A00,890280,Chowdhury; Muhammed Zohir,16,0,30,14
1746606869445,USP 150,A00,890281,Boomhower; Matthew Charles,4,0,30,26
1746606870471,USP 151,A00,890282,Staff,16,0,20,4
1746606871496,USP 162,A00,890283,Andrews; Abigail Leslie,16,0,20,4
1746606872529,USP 168,A00,920477,Kwak; Nancy,0,0,5,5
1746606873558,USP 181,A00,890284,Staff,3,0,20,17
1746606874585,USP 191A,A00,890285,Staff,12,0,20,8
1746606875618,VIS 101,A00,886512,Staff,26,0,75,49
1746606876645,VIS 103,A00,886513,Cruz; Edwin Teddy,61,0,75,14
1746606877672,VIS 108,A00,886514,Staff,4,0,15,11
1746606878701,VIS 127P,A00,886515,Shen; Kuiyi,80,0,146,66
1746606879733,VIS 149,A00,886516,Yoldas; Pinar,0,0,15,15
1746606880763,VIS 164,A00,886526,Erdmann; Dean,19,0,22,3
1746606881791,VIS 194S,A00,886527,Staff,61,0,75,14
1746606882826,WCWP 10A,C00,886484,Martiniuk; Jill,12,0,15,3
1746606883853,WCWP 10B,A00,886490,Uriarte; Emma,0,0,15,15
1746606883853,WCWP 10B,B00,886491,Dhir; Simrita,8,0,15,7
1746606883853,WCWP 10B,C00,886492,Ornelas; Tricia,0,0,15,15
1746606884881,WCWP 100,A00,886494,Young; Mark T,0,6,15,15
1746606887032,AAS 10,A01,886199,Childs; Dennis R.,0,3,0,0
1746606888061,ANAR 104,A01,886940,Shtienberg; Gilad,27,0,30,3
1746606889089,ANAR 120,A00,886953,Staff,13,0,20,7
1746606890116,ANBI 148,A01,886955,Wilder; Linnea Lorene,30,0,40,10
1746606892171,ANSC 122,A00,886957,Staff,24,0,30,6
1746606893199,ANSC 150,A00,886958,Sloane; Julia Kathryn,2,0,15,13
1746606894232,ANSC 156,A00,886959,Jenkins; Janis A.,0,1,15,15
1746606895257,ANSC 180,A00,886960,Staff,11,0,17,6
1746606896291,ANSC 188,A00,886961,Jassal; Aftab,9,0,25,16
1746606897318,ANSC 190,A00,886962,Jassal; Aftab,14,0,25,11
1746606898346,ANSC 191,A00,886963,Staff,18,0,20,2
1746606899373,ANTH 3,A01,891689,Staff,17,0,20,3
1746606900408,ANTH 5,A00,886933,Semendeferi; Ekaterini,16,0,20,4
1746606901436,ANTH 10,A00,886934,Staff,0,12,30,30
1746606902468,ANTH 21,A01,886936,Staff,41,0,60,19
1746606903497,ANTH 23,A01,886938,Staff,92,0,100,8
1746606904529,ANTH 105,A00,886964,Stewart; Alexander B,84,0,100,16
1746606905557,ANTH 108,A00,886965,Pedersen; David,9,0,20,11
1746606906584,AWP 10,001,886147,Staff,0,0,0,0
1746606906584,AWP 10,002,886148,Staff,0,0,0,0
1746606906584,AWP 10,003,886149,Staff,0,0,0,0
1746606906584,AWP 10,004,886150,Staff,0,0,0,0
1746606906584,AWP 10,005,886151,Staff,0,0,0,0
1746606906584,AWP 10,006,886152,Staff,0,0,0,0
1746606906584,AWP 10,007,886153,Staff,0,0,0,0
1746606906584,AWP 10,008,886154,Staff,0,0,0,0
1746606906584,AWP 10,009,886155,Staff,0,0,0,0
1746606906584,AWP 10,010,886156,Staff,0,0,0,0
1746606906584,AWP 10,011,886158,Staff,0,0,0,0
1746606906584,AWP 10,012,886160,Staff,0,0,0,0
1746606906584,AWP 10,013,886161,Staff,0,0,0,0
1746606906584,AWP 10,014,886162,Staff,0,0,0,0
1746606906584,AWP 10,015,886163,Staff,0,0,0,0
1746606906584,AWP 10,016,886164,Staff,0,0,0,0
1746606906584,AWP 10,017,886165,Staff,0,0,0,0
1746606906584,AWP 10,018,886166,Staff,0,0,0,0
1746606906584,AWP 10,019,886168,Staff,0,0,0,0
1746606906584,AWP 10,020,886170,Staff,0,0,0,0
1746606906584,AWP 10,021,886172,Staff,0,0,0,0
1746606907618,AWP 10R,001,886173,Staff,0,1,0,0
1746606907618,AWP 10R,002,886174,Staff,0,1,0,0
1746606907618,AWP 10R,003,886175,Staff,0,0,0,0
1746606907618,AWP 10R,004,886176,Staff,0,0,0,0
1746606907618,AWP 10R,005,886177,Staff,0,0,0,0
1746606907618,AWP 10R,006,886178,Staff,0,0,0,0
1746606907618,AWP 10R,007,886179,Staff,0,0,0,0
1746606907618,AWP 10R,008,886181,Staff,0,0,0,0
1746606907618,AWP 10R,009,886182,Staff,0,0,0,0
1746606907618,AWP 10R,010,886183,Staff,0,0,0,0
1746606907618,AWP 10R,011,886184,Staff,0,0,0,0
1746606907618,AWP 10R,012,886185,Staff,0,0,0,0
1746606907618,AWP 10R,013,886186,Staff,0,0,0,0
1746606907618,AWP 10R,014,886187,Staff,0,0,0,0
1746606907618,AWP 10R,015,886188,Staff,0,0,0,0
1746606907618,AWP 10R,016,886189,Staff,0,0,0,0
1746606907618,AWP 10R,017,960532,Staff,0,0,0,0
1746606907618,AWP 10R,018,960533,Staff,0,0,0,0
1746606907618,AWP 10R,019,960534,Staff,0,0,0,0
1746606907618,AWP 10R,020,960538,Staff,0,0,0,0
1746606907618,AWP 10R,021,960540,Staff,0,0,0,0
1746606907618,AWP 10R,022,960541,Staff,0,0,0,0
1746606907618,AWP 10R,023,960542,Staff,0,0,0,0
1746606907618,AWP 10R,024,960544,Staff,0,0,0,0
1746606907618,AWP 10R,025,960545,Staff,0,0,0,0
1746606907618,AWP 10R,026,960548,Staff,0,0,0,0
1746606908647,AWP 102R,A00,886190,Staff,0,0,0,0
1746606908647,AWP 102R,B00,886191,Staff,0,0,0,0
1746606909675,BENG 100,A01,886193,Staff,17,0,30,13
1746606910705,BENG 122A,A01,886195,Hasty; Jeff M,13,0,30,17
1746606911771,BENG 166A,A00,886196,Sah; Robert Lie-Yuan,0,3,30,30
1746606912803,BENG 190,A00,958050,Khojah; Reem I,17,0,25,8
1746606913831,BIBC 102,A01,894320,Staff,0,1,46,46
1746606913831,BIBC 102,A02,894321,Staff,0,0,46,46
1746606913831,BIBC 102,A03,894344,Staff,6,0,46,40
1746606913831,BIBC 102,A04,894345,Staff,27,0,47,20
1746606914859,BICD 100R,A01,894365,Smith; Laurie,0,2,58,58
1746606914859,BICD 100R,A02,894366,Smith; Laurie,0,4,58,58
1746606914859,BICD 100R,A03,894367,Smith; Laurie,0,0,59,59
1746606914859,BICD 100R,A04,959869,Smith; Laurie,38,0,59,21
1746606915892,BICD 136,A01,894383,Gustafson-Brown; Cindy,14,0,50,36
1746606916930,BIEB 102,A01,894494,Butler; Shannon Rhey,51,0,130,79
1746606918998,BIEB 150,A01,894617,Wills; Christopher,3,0,20,17
1746606918998,BIEB 150,A02,894631,Wills; Christopher,3,0,20,17
1746606918998,BIEB 150,A03,894937,Wills; Christopher,3,0,20,17
1746606918998,BIEB 150,A04,894946,Wills; Christopher,5,0,20,15
1746606920031,BIEB 194,A00,906141,Kurle; Carolyn M.,5,0,20,15
1746606921059,BILD 1,A01,894154,Staff,3,0,19,16
1746606921059,BILD 1,A02,894155,Staff,14,0,19,5
1746606921059,BILD 1,A03,894160,Staff,13,0,19,6
1746606921059,BILD 1,A04,894161,Staff,15,0,18,3
1746606922090,BILD 2,A01,894168,Staff,0,0,50,50
1746606922090,BILD 2,A02,894169,Staff,0,0,50,50
1746606922090,BILD 2,A03,894179,Staff,0,0,50,50
1746606922090,BILD 2,A04,894203,Staff,22,0,50,28
1746606923117,BILD 3,A01,894213,Staff,23,0,31,8
1746606923117,BILD 3,A02,894214,Staff,26,0,31,5
1746606923117,BILD 3,A03,894235,Staff,28,0,31,3
1746606923117,BILD 3,A04,894236,Staff,28,0,32,4
1746606924143,BILD 4,A01,894253,Reuther; Keefe,5,0,24,19
1746606924143,BILD 4,A02,894258,Reuther; Keefe,16,0,24,8
1746606925170,BILD 5,A01,894276,Reuther; Keefe,34,0,50,16
1746606925170,BILD 5,A02,894277,Reuther; Keefe,45,0,50,5
1746606925170,BILD 5,A03,894290,Reuther; Keefe,44,0,50,6
1746606925170,BILD 5,A04,894291,Reuther; Keefe,48,0,50,2
1746606926201,BILD 24,A01,894297,Pirino; Giorgia,40,0,60,20
1746606927235,BIMM 100,B01,958915,Staff,71,0,100,29
1746606928269,BIMM 101,A01,895017,McDonnell; Lisa Marie,0,5,24,24
1746606928269,BIMM 101,A02,895018,McDonnell; Lisa Marie,0,5,24,24
1746606928269,BIMM 101,B01,895020,McDonnell; Lisa Marie,0,5,24,24
1746606928269,BIMM 101,B02,895021,McDonnell; Lisa Marie,0,4,24,24
1746606929299,BIMM 110,A01,895023,Staff,1,0,25,24
1746606929299,BIMM 110,A02,895024,Staff,9,0,25,16
1746606929299,BIMM 110,A03,895025,Staff,18,0,25,7
1746606929299,BIMM 110,A04,895031,Staff,20,0,25,5
1746606930325,BIMM 120,A01,895114,Gustafson-Brown; Cindy,14,0,28,14
1746606930325,BIMM 120,A02,895126,Gustafson-Brown; Cindy,21,0,27,6
1746606931360,BIPN 100,A01,895130,Yang; Mingyu,0,0,38,38
1746606931360,BIPN 100,A02,895131,Yang; Mingyu,31,0,38,7
1746606931360,BIPN 100,A03,895132,Yang; Mingyu,32,0,38,6
1746606931360,BIPN 100,A04,895133,Yang; Mingyu,27,0,36,9
1746606932400,BIPN 120,A01,895135,Cooke; James Edward,0,3,13,13
1746606932400,BIPN 120,A02,895136,Cooke; James Edward,0,1,13,13
1746606932400,BIPN 120,A03,895137,Cooke; James Edward,0,3,13,13
1746606932400,BIPN 120,A04,895156,Cooke; James Edward,0,2,11,11
1746606933427,BIPN 134,A01,895235,Cooke; James Edward,0,1,25,25
1746606933427,BIPN 134,A02,895237,Cooke; James Edward,0,0,25,25
1746606933427,BIPN 134,A03,895240,Cooke; James Edward,1,0,25,24
1746606933427,BIPN 134,A04,895270,Cooke; James Edward,20,0,25,5
1746606934458,BIPN 189,A00,892103,Staff,0,14,14,14
1746606936516,BISP 194,A00,958008,Staff,0,2,0,0
1746606937543,CAT 124,A01,922009,Staff,0,5,20,20
1746606938574,CAT 125R,A00,886390,Morales; Celeste Georgianna,0,4,20,20
1746606938574,CAT 125R,B00,886391,Irwin; Matthew Joseph,0,4,20,20
1746606938574,CAT 125R,C00,886392,Smith; Lauryn Alissa,0,2,20,20
1746606938574,CAT 125R,D00,886393,Vanderschuit; Maya Alysia,0,3,20,20
1746606938574,CAT 125R,E00,886394,Marchisotto; Jennifer Anne,0,3,20,20
1746606939601,CENG 15,A01,886218,Drews; Aaron,3,0,8,5
1746606940627,CENG 113,A00,886219,Opatkiewicz; Justin Paul,15,0,25,10
1746606941655,CGS 101,A00,887044,Staff,7,0,20,13
1746606942681,CGS 105,A01,887046,Staff,14,0,25,11
1746606943711,CGS 112,A00,887047,Cuong; Marisol,12,0,15,3
1746606944737,CGS 113,A00,887048,Staff,23,0,30,7
1746606945761,CGS 120,A00,887049,Staff,9,0,17,8
1746606946789,CHEM 6A,A01,886336,Lam; Tin Yiu,38,0,50,12
1746606946789,CHEM 6A,A02,886338,Lam; Tin Yiu,37,0,50,13
1746606947816,CHEM 6B,A01,886341,Hopkins; Patrycja Anna,16,0,50,34
1746606947816,CHEM 6B,A02,886343,Hopkins; Patrycja Anna,42,0,50,8
1746606948853,CHEM 6C,A01,886346,Albizati; Kim F.,0,2,50,50
1746606948853,CHEM 6C,A02,886348,Albizati; Kim F.,24,0,50,26
1746606949877,CHEM 40A,A01,886352,Klosterman; Jeremy K,65,0,100,35
1746606950902,CHEM 40B,A01,886356,Klosterman; Jeremy K,0,24,100,100
1746606951932,CHEM 41B,A01,886360,Theodorakis; Emmanuel,25,0,50,25
1746606951932,CHEM 41B,A02,886362,Theodorakis; Emmanuel,47,0,50,3
1746606952960,CHIN 165A,A00,886382,Xu; Li,18,0,20,2
1746606953988,CLAS 120,A00,886387,Myerston Santana; Jacobo,33,0,40,7
1746606955017,COGS 9,A01,886967,Shannon; Kyle Michael,42,0,60,18
1746606956047,COGS 11,A01,886969,Staff,9,0,30,21
1746606957073,COGS 14A,A01,886971,Staff,5,0,60,55
1746606958101,COGS 14B,A01,886973,Hoffman; Drew Ellen,4,0,60,56
1746606959132,COGS 18,A01,886975,Morgan; Eric,34,0,60,26
1746606960163,COGS 20,A01,886977,Staff,3,0,8,5
1746606960163,COGS 20,A02,886978,Staff,5,0,7,2
1746606961189,COGS 100,A01,907783,Staff,0,1,30,30
1746606962219,COGS 101B,A01,886980,Staff,0,4,48,48
1746606963248,COGS 101C,A01,886982,Delgado; Tania,0,5,44,44
1746606964273,COGS 102A,A01,886984,Johnson; Christine M.,3,0,30,27
1746606965302,COGS 118B,A01,886986,Staff,0,4,88,88
1746606966388,COGS 150,A01,886988,Bergen; Benjamin,22,0,50,28
1746606967452,COGS 153,A00,886989,Delgado; Tania,1,3,41,40
1746606968478,COGS 186,A01,886991,Staff,0,0,32,32
1746606969503,COGS 187A,A01,886993,Boyle; Mary E. T.,7,0,30,23
1746606970532,COGS 189,A00,886994,Staff,0,1,30,30
1746606971558,COMM 10,A01,886996,Staff,0,0,20,21
1746606971558,COMM 10,A02,886997,Staff,10,0,20,10
1746606971558,COMM 10,A03,959845,Staff,19,0,20,1
1746606972583,COMM 20,A01,886999,Leuning; Grant Maurstad,24,0,40,16
1746606974640,COMM 100A,A01,887002,Staff,0,0,20,25
1746606974640,COMM 100A,A02,887003,Staff,5,0,20,15
1746606975686,COMM 100B,A01,887005,Staff,0,8,20,24
1746606976711,COMM 106D,A00,887006,Staff,14,0,40,26
1746606977737,COMM 110G,A00,887007,Whitworth-Smith; Andrew C,12,0,40,28
1746606978763,COMM 111B,A00,887008,Staff,31,0,40,9
1746606979790,COMM 113T,A00,887009,Abuelhiga; Soraya Jill,28,0,40,12
1746606979790,COMM 113T,B00,906733,Staff,39,0,40,1
1746606980819,COMM 145,A00,887010,Staff,13,0,40,27
1746606981847,COMM 146,A00,887054,Staff,32,0,40,8
1746606982871,COMM 190,A00,887012,Staff,8,0,23,15
1746606983897,CSE 8A,A50,887015,Cao; Yingjun,56,0,85,29
1746606984921,CSE 11,A01,887017,Cao; Yingjun,11,0,70,59
1746606985945,CSE 20,A01,887019,Staff,30,0,50,20
1746606986973,CSE 21,A01,887021,Staff,79,0,100,21
1746606986973,CSE 21,B01,892583,Braun; Oliver,45,0,50,5
1746606988002,CSE 30,A01,887025,Eldon; John,142,0,200,58
1746606989028,CSE 100,A01,887027,Staff,26,0,50,24
1746606989028,CSE 100,A02,887028,Staff,42,0,50,8
1746606990106,CSE 101,A01,887030,Braun; Oliver,74,0,100,26
1746606990106,CSE 101,B01,887032,Jones; Miles E,0,3,50,50
1746606990106,CSE 101,B02,887033,Jones; Miles E,0,2,50,50
1746606991135,CSE 105,A01,908084,Jones; Miles E,32,0,50,18
1746606991135,CSE 105,A02,908087,Jones; Miles E,31,0,50,19
1746606992163,CSE 135,A01,887035,Powell; Thomas Allan,0,5,50,50
1746606993198,CSE 142,A01,887037,Staff,7,0,60,53
1746606994223,CSE 142L,A01,887039,Staff,34,0,60,26
1746606995252,CSE 151A,A01,887041,Solares; Edwin A,47,0,100,53
1746606996276,CSE 175,A01,887043,Kumar; Rakesh,30,0,30,0
1746606997301,CSS 1,A01,886389,Staff,0,1,40,40
1746606998333,DSC 30,A01,908097,Liao; Soohyun Nam,47,0,75,28
1746606999376,DSC 40A,A01,908099,Shannon; Kyle Michael,30,0,50,20
1746607000401,DSC 40B,A01,908112,Staff,15,0,50,35
1746607001424,DSC 80,A01,908116,Staff,19,0,60,41
1746607002449,DSC 197,001,956863,Eldridge; Justin Matthew,9999,0,9999,0
1746607003478,ECE 5,A01,886400,Morris; Karcher William,1,0,6,5
1746607003478,ECE 5,A02,886401,Morris; Karcher William,3,0,6,3
1746607004508,ECE 148,A01,886403,Silberman; Jack,0,14,14,14
1746607005539,ECON 1,A01,887265,Crane; Meredith Helen,11,0,70,59
1746607005539,ECON 1,B01,887268,Staff,42,0,50,8
1746607006566,ECON 2,A01,887273,Crane; Meredith Helen,54,0,70,16
1746607007595,ECON 3,A01,887279,Rondina; Giacomo,31,0,70,39
1746607008625,ECON 4,A01,887282,Anderson; John Charles,0,2,10,10
1746607009651,ECON 5,A01,887285,Staff,34,0,45,11
1746607009651,ECON 5,B01,887292,Staff,41,0,45,4
1746607010683,ECON 100A,A01,887337,Newhouse; Herbert S,54,0,70,16
1746607010683,ECON 100A,B01,887349,Staff,45,0,50,5
1746607011711,ECON 100B,A01,887361,Du; Songzi,29,0,70,41
1746607012738,ECON 100C,A01,887445,Newhouse; Herbert S,59,0,70,11
1746607013765,ECON 105,A00,887488,Vespa; Emanuel Ignacio,23,0,35,12
1746607014793,ECON 109,A01,887506,Shishkin; Denis,28,0,35,7
1746607015822,ECON 110A,A01,887568,Alon; Titan Michael,0,2,35,35
1746607015822,ECON 110A,B01,907601,Alon; Titan Michael,20,0,35,15
1746607016852,ECON 110B,A01,887598,Levkoff; Steven B.,0,24,70,70
1746607017879,ECON 112,A00,887599,Rondina; Giacomo,19,0,35,16
1746607018911,ECON 120A,A01,887603,Dai; Yinlin,36,0,70,34
1746607019949,ECON 120C,A01,887608,Sun; Yixiao,0,1,35,35
1746607019949,ECON 120C,B01,887614,Sun; Yixiao,0,0,35,35
1746607020975,ECON 138,A00,887621,Bharadwaj; Prashant,0,21,20,20
1746607022005,ECON 144,A00,958007,Squires; Dale E,11,0,35,24
1746607023032,ECON 171,A01,907666,Staff,18,0,35,17
1746607024058,ECON 175,A00,887626,Wu; Pak Yeung,22,0,35,13
1746607025084,ECON 190,A00,887640,Vespa; Emanuel Ignacio,22,0,35,13
1746607026121,EDS 25,A01,888197,Staff,0,0,0,0
1746607026121,EDS 25,A02,888209,Staff,0,0,0,0
1746607026121,EDS 25,A03,888210,Staff,0,0,0,0
1746607026121,EDS 25,A04,888212,Staff,0,0,0,0
1746607026121,EDS 25,A05,888213,Staff,0,0,0,0
1746607026121,EDS 25,A06,888214,Staff,0,0,0,0
1746607026121,EDS 25,A07,888235,Staff,0,2,0,0
1746607026121,EDS 25,A08,888236,Staff,0,0,0,0
1746607026121,EDS 25,A09,888240,Staff,0,0,0,0
1746607026121,EDS 25,A10,888244,Staff,0,0,0,0
1746607026121,EDS 25,B01,888273,Staff,0,0,0,0
1746607026121,EDS 25,B02,888285,Staff,0,0,0,0
1746607026121,EDS 25,B03,888423,Staff,0,0,0,1
1746607026121,EDS 25,B04,888432,Staff,0,0,0,0
1746607026121,EDS 25,B05,888433,Staff,0,0,0,0
1746607026121,EDS 25,B06,888467,Staff,0,0,0,0
1746607026121,EDS 25,B07,888468,Staff,0,0,0,0
1746607026121,EDS 25,B08,888479,Staff,0,0,0,0
1746607026121,EDS 25,B09,888484,Staff,0,0,0,0
1746607026121,EDS 25,B10,888487,Staff,0,0,0,0
1746607027148,EDS 38,A01,907700,Choi; Bailey Miyeon,30,0,30,0
1746607028173,EDS 112,A01,888601,Chapman; Thandeka K,12,0,40,28
1746607029204,EDS 115,A00,888697,Mendez; Kathrina Mendoza,10,0,30,20
1746607030234,EDS 116,A01,888893,Staff,33,0,40,7
1746607032286,EDS 124AR,A00,889133,Staff,29,0,50,21
1746607032286,EDS 124AR,B00,907471,Simon; Elizabeth A,37,0,50,13
1746607033315,EDS 124BR,A00,889134,Simon; Elizabeth A,44,0,100,56
1746607034341,EDS 125,A00,889135,Staff,25,0,30,5
1746607035368,EDS 126,A01,889138,Staff,35,0,40,5
1746607036394,EDS 164R,A01,889142,Wishard Guerra; Alison G.,32,0,50,18
1746607037423,ENG 30,A01,886396,Staff,0,0,0,0
1746607037423,ENG 30,B01,886398,Staff,0,0,0,0
1746607038449,ENVR 102,A00,906150,Montejo; Carolina,23,0,25,2
1746607039482,ETHN 103A,A00,887236,Man; Simeon S,0,2,0,0
1746607040506,ETHN 113,A00,887239,Staff,16,0,30,14
1746607041533,ETHN 116,A00,887240,Staff,16,0,25,9
1746607042564,ETHN 117,A00,887241,Choi; Esther Min,28,0,30,2
1746607043593,ETHN 118,A00,887243,Staff,24,0,30,6
1746607044622,ETHN 127,A00,887248,Cuong; Marisol,11,0,15,4
1746607045652,ETHN 139,A00,887250,Staff,7,0,10,3
1746607046678,ETHN 142,A00,887252,Staff,9,0,30,21
1746607047704,ETHN 161,A00,887253,Browne; Errol Tsekani,24,0,30,6
1746607048729,ETHN 163FR,A00,887255,Burelle; Julie Sara Veronique,0,0,5,5
1746607049756,GLBH 20,A00,889149,Elwardani; Nile Regina,8,0,42,34
1746607051835,GLBH 111,A01,889152,Burgos; Jose L.,17,0,17,0
1746607052865,GLBH 150,A00,889181,Sloane; Julia Kathryn,0,5,15,15
1746607054918,HDS 60,A01,886406,Warstadt; Melissa Fawn,72,0,80,8
1746607055943,HIAF 111,A00,889324,Gyamfi; Bright,25,0,32,7
1746607056972,HIEA 131,A00,889328,Staff,15,0,32,17
1746607058002,HIEA 144,A00,889333,Henry; Todd A.,26,0,32,6
1746607059030,HIEA 154,A00,889336,Henry; Todd A.,24,0,32,8
1746607060057,HIEU 106,A00,889339,Staff,22,0,32,10
1746607062109,HIEU 114,A00,889340,Staff,4,0,32,28
1746607063134,HIEU 135GS,A00,889342,Patterson; Patrick H.,0,0,1,24
1746607064161,HIEU 137,A00,889343,Edington; Claire Ellen,10,0,25,15
1746607065186,HIEU 148,A00,889345,Staff,14,0,32,18
1746607066211,HIEU 154,A00,889346,Biess; Frank Peter,21,0,32,11
1746607067242,HILA 102,A00,889351,Staff,12,0,32,20
1746607068268,HILD 2A,A01,889221,Lewandoski; Julia Mavis,0,8,32,32
1746607069297,HILD 7B,A01,889225,Man; Simeon S,0,12,32,32
1746607070324,HILD 7C,A01,889288,Alvarez; Luis A,0,14,32,32
1746607071391,HILD 30,A01,889323,Staff,0,5,32,32
1746607073449,HISC 119,A00,889383,Golan; Tal,20,0,32,12
1746607074474,HIUS 103,A00,889384,Man; Simeon S,0,0,32,32
1746607075502,HIUS 117,A00,919797,Kwak; Nancy,18,0,32,14
1746607076529,HIUS 142A,A00,919788,Staff,22,0,32,10
1746607078582,HIUS 149,A00,889386,Gyamfi; Bright,26,0,32,6
1746607079612,HIUS 155,A00,889387,Alvarez; Luis A,15,0,32,17
1746607080645,HUM 3,A01,886499,Caldwell; Michael Alan,19,0,50,31
1746607081672,HUM 3GS,A00,886500,Rodriguez; Bretton Sigfred,0,0,0,28
1746607082700,HUM 3R,A01,886502,Markman; Kristina,0,36,50,50
1746607083731,HUM 4,A01,886504,Crum; Matthew Stephen,23,0,50,27
1746607083731,HUM 4,B01,886506,West; Geoffrey Scott,17,0,50,33
1746607084757,HUM 4GS,A00,886507,Staff,0,0,0,19
1746607085786,HUM 5,A01,886509,Staff,31,0,50,19
1746607086814,HUM 5R,A01,886511,Zavodny; Tatiana Sophia,0,39,50,50
1746607087842,JAPN 180,A00,886407,Staff,16,0,40,24
1746607088874,LATI 50,A01,886409,Martin-Cabrera; Luis,3,0,22,19
1746607088874,LATI 50,A02,886410,Martin-Cabrera; Luis,19,0,22,3
1746607088874,LATI 50,A03,886411,Martin-Cabrera; Luis,21,0,22,1
1746607088874,LATI 50,A04,886412,Martin-Cabrera; Luis,8,0,22,14
1746607089904,LAWS 101,A00,907664,Staff,28,0,60,32
1746607090932,LIAB 1A,A00,889388,Saab; Dima,17,0,20,3
1746607091963,LIAB 1AX,A00,889389,El Cheddadi; Youniss,18,0,20,2
1746607092989,LIFR 1C,A00,889391,Van Moer; Vinciane G,8,0,20,12
1746607094015,LIFR 1CX,A00,889392,Van Moer; Vinciane G,7,0,20,13
1746607095046,LIFR 1D,A00,889393,Van Moer; Vinciane G,7,0,20,13
1746607096071,LIFR 1DX,A00,889394,Van Moer; Vinciane G,8,0,20,12
1746607097101,LIGN 7,A00,886923,Staff,25,0,50,25
1746607098131,LIGN 17,A00,886924,Kehler; Andrew Scott,126,0,150,24
1746607099160,LTAM 110,A00,889395,Staff,15,0,30,15
1746607100184,LTAM 110GS,A00,958010,Rodriguez; Bretton Sigfred,0,0,0,28
1746607101208,LTCH 101,A00,889397,Staff,23,0,25,2
1746607102235,LTCS 130,A00,889398,Staff,23,0,25,2
1746607103262,LTEA 138,A00,889399,Staff,24,0,40,16
1746607104287,LTEN 149,A00,889400,Wesling; Megan E.,0,3,25,25
1746607105315,LTEN 169,A00,889401,Staff,20,0,25,5
1746607106344,LTEN 180,A00,889402,Staff,10,0,15,5
1746607107374,LTEN 181,A00,889403,Staff,21,0,25,4
1746607108402,LTWL 100,A00,889404,Myerston Santana; Jacobo,2,0,25,23
1746607109430,LTWL 180GS,A00,889405,Staff,0,0,20,20
1746607110456,LTWL 181,A00,889406,Staff,16,0,25,9
1746607111485,LTWL 184,A00,889475,Mukherjee; Silpa,22,0,25,3
1746607112514,LTWR 102C,A00,889486,Staff,29,0,30,1
1746607113542,LTWR 115W,A00,889491,Staff,0,2,15,15
1746607114569,MAE 8,A01,886905,Staff,0,2,0,0
1746607115597,MAE 11,A00,886906,Bandaru; Prabhakar,0,7,50,50
1746607116624,MAE 20,A00,886907,Evdokimenko; Ekaterina,43,0,70,27
1746607117654,MAE 30B,A00,886909,Ghazinejad; Maziar,25,0,45,20
1746607118681,MAE 101B,A00,886910,Saintillan; David,30,0,45,15
1746607119706,MAE 105,A00,886911,Bandaru; Prabhakar,18,0,50,32
1746607120732,MAE 107,B00,958024,Staff,7,0,50,43
1746607121764,MAE 143B,A00,886913,Bewley; Thomas R,2,0,40,38
1746607122788,MAE 148,A01,886915,Silberman; Jack,0,3,14,14
1746607123815,MAE 160,A00,886916,Evdokimenko; Ekaterina,30,0,60,30
1746607124846,MATH 3C,A01,889681,Staff,0,2,30,30
1746607124846,MATH 3C,A02,960048,Staff,23,0,30,7
1746607125877,MATH 10A,A01,889760,Staff,26,0,30,4
1746607125877,MATH 10A,A02,889783,Staff,29,0,30,1
1746607126905,MATH 10B,A01,889785,Verstraete; Jacques Allan,1,0,35,34
1746607126905,MATH 10B,A02,889795,Verstraete; Jacques Allan,4,0,35,31
1746607126905,MATH 10B,B01,889797,Verstraete; Jacques Allan,3,0,35,32
1746607126905,MATH 10B,B02,889828,Verstraete; Jacques Allan,3,0,35,32
1746607127932,MATH 10C,A01,889849,Habib; Yousaf,8,0,30,22
1746607127932,MATH 10C,A02,889852,Habib; Yousaf,14,0,30,16
1746607127932,MATH 10C,A03,889853,Habib; Yousaf,22,0,30,8
1746607127932,MATH 10C,A04,889858,Habib; Yousaf,20,0,30,10
1746607127932,MATH 10C,B01,889861,Staff,1,0,30,29
1746607127932,MATH 10C,B02,889862,Staff,24,0,30,6
1746607127932,MATH 10C,B03,889863,Staff,27,0,30,3
1746607127932,MATH 10C,B04,889967,Staff,23,0,30,7
1746607128958,MATH 18,A01,889974,Staff,6,0,30,24
1746607128958,MATH 18,A02,889977,Staff,20,0,30,10
1746607128958,MATH 18,B01,889984,Hardiman; Liam,20,0,30,10
1746607128958,MATH 18,B02,889985,Hardiman; Liam,25,0,30,5
1746607129990,MATH 20A,A01,889990,Suk; Andrew Hoon,30,0,35,5
1746607131017,MATH 20B,A01,889993,Ohm; Ko Woon,21,0,30,9
1746607131017,MATH 20B,A02,889994,Ohm; Ko Woon,30,0,30,0
1746607131017,MATH 20B,B01,889996,Ohm; Ko Woon,22,0,30,8
1746607131017,MATH 20B,B02,889997,Ohm; Ko Woon,23,0,30,7
1746607132045,MATH 20C,A01,889999,Hammock; Frances H,17,0,30,13
1746607132045,MATH 20C,A02,890003,Hammock; Frances H,23,0,30,7
1746607132045,MATH 20C,B01,890006,Hammock; Frances H,2,0,30,28
1746607132045,MATH 20C,B02,890007,Hammock; Frances H,11,0,30,19
1746607133077,MATH 20D,A01,890011,Cheng; Hsiao-Bing,1,0,30,29
1746607133077,MATH 20D,A02,890012,Cheng; Hsiao-Bing,14,0,30,16
1746607133077,MATH 20D,B01,890016,Cheng; Hsiao-Bing,13,0,30,17
1746607133077,MATH 20D,B02,890017,Cheng; Hsiao-Bing,13,0,30,17
1746607134105,MATH 20E,A01,890026,Harel; Guershon,1,0,30,29
1746607134105,MATH 20E,A02,890029,Harel; Guershon,22,0,30,8
1746607134105,MATH 20E,B01,890033,Harel; Guershon,7,0,30,23
1746607134105,MATH 20E,B02,890101,Harel; Guershon,21,0,30,9
1746607135129,MATH 102,A01,890104,Staff,18,0,30,12
1746607135129,MATH 102,A02,890105,Staff,27,0,30,3
1746607136161,MATH 103B,A01,890116,Salehi Golsefidy; Alireza,3,0,30,27
1746607136161,MATH 103B,B01,890118,Staff,0,3,34,34
1746607137198,MATH 109,A01,890121,Aliabadi Sr.; Mohsen,0,0,30,30
1746607137198,MATH 109,B01,890124,Upadrashta; Pranav Kumar,18,0,30,12
1746607138234,MATH 120A,A01,890126,Eggers; John Dietrich,13,0,30,17
1746607139264,MATH 142B,A01,890128,Ioana; Adrian,19,0,30,11
1746607139264,MATH 142B,A02,890129,Ioana; Adrian,12,0,30,18
1746607140290,MATH 154,A01,890174,Staff,0,1,30,30
1746607140290,MATH 154,A02,890182,Staff,0,0,30,30
1746607141319,MATH 168A,A01,890197,Dumitriu; Ioana,21,0,35,14
1746607142348,MATH 170A,A01,890240,Nie; Jiawang,1,0,30,29
1746607142348,MATH 170A,A02,890241,Nie; Jiawang,11,0,30,19
1746607142348,MATH 170A,A03,890249,Nie; Jiawang,23,0,30,7
1746607143379,MATH 170B,A01,957891,Nag; Panchali,13,0,35,22
1746607145434,MATH 181A,A01,908025,Staff,0,3,35,35
1746607145434,MATH 181A,A02,960115,Staff,26,0,35,9
1746607146460,MATH 181B,A01,959874,Staff,24,0,30,6
1746607147487,MATH 193B,A01,890265,Staff,0,4,35,35
1746607148517,MGT 4,A01,890311,Anderson; John Charles,42,0,88,46
1746607149543,MGT 5,A00,907740,Staff,12,0,98,86
1746607150572,MGT 12,A00,890312,Lindenberger; Wade Douglas,67,0,98,31
1746607151601,MGT 16,A00,957883,Staff,78,0,98,20
1746607153655,MGT 45,A00,890314,Pecore; Joseph P.,45,0,98,53
1746607154684,MGT 71,A00,890315,Staff,0,12,98,98
1746607155711,MGT 100,A00,890316,Yavorsky; Daniel Ryan,44,0,98,54
1746607156742,MGT 103,A00,890317,Ehrich; Kristine R,73,0,98,25
1746607157767,MGT 105,A00,890356,Bates; Kenneth Walter,0,8,98,98
1746607158791,MGT 112,A00,890360,Ehrich; Kristine R,55,0,98,43
1746607159821,MGT 127R,A00,907732,Zhu; Kevin Xiaoguo,23,0,98,75
1746607160855,MGT 131B,A00,890361,Anderson; John Charles,59,0,98,39
1746607161881,MGT 137,A00,890362,Lindenberger; Wade Douglas,65,0,98,33
1746607162910,MGT 160,A00,890369,Johnson; Erik Barry,9,0,98,89
1746607164963,MGT 164,A00,890372,Zimmermann; Carsten,0,40,98,98
1746607165990,MGT 180,A00,890374,Bliss; Barbara Ann,11,0,98,87
1746607167015,MMW 15,A01,886414,Chang; Edmond Yi-Teh,0,12,28,28
1746607167015,MMW 15,A02,886415,Chang; Edmond Yi-Teh,0,8,28,28
1746607167015,MMW 15,A03,886416,Chang; Edmond Yi-Teh,0,9,28,28
1746607167015,MMW 15,A04,886417,Chang; Edmond Yi-Teh,0,8,28,28
1746607167015,MMW 15,B01,886419,Chang; Edmond Yi-Teh,0,7,28,28
1746607167015,MMW 15,B02,886420,Chang; Edmond Yi-Teh,0,7,28,28
1746607167015,MMW 15,B03,886421,Chang; Edmond Yi-Teh,0,7,28,28
1746607167015,MMW 15,B04,886422,Chang; Edmond Yi-Teh,0,8,28,28
1746607167015,MMW 15,C01,886424,Staff,0,9,28,28
1746607167015,MMW 15,C02,886425,Staff,0,8,28,28
1746607167015,MMW 15,C03,886426,Staff,0,8,28,28
1746607167015,MMW 15,C04,886427,Staff,0,8,28,28
1746607167015,MMW 15,C05,958038,Staff,0,8,28,28
1746607167015,MMW 15,C06,958039,Staff,0,7,28,28
1746607168042,MMW 15GS,A00,906910,Patterson; Patrick H.,4,0,28,24
1746607169073,MMW 122R,A01,886429,Rahimi; Babak,0,13,28,28
1746607169073,MMW 122R,A02,886430,Rahimi; Babak,0,12,28,28
1746607169073,MMW 122R,A03,958040,Rahimi; Babak,0,11,28,28
1746607170103,MUS 1A,A01,890937,Staff,2,0,25,23
1746607170103,MUS 1A,A02,891035,Staff,6,0,25,19
1746607170103,MUS 1A,C01,958912,Staff,24,0,25,1
1746607170103,MUS 1A,C02,958913,Staff,25,0,25,0
1746607172157,MUS 2AK,A00,957092,Ohnishi; Takae,15,0,15,0
1746607173187,MUS 4,A01,891044,Staff,0,0,25,25
1746607173187,MUS 4,A02,891045,Staff,22,0,25,3
1746607173187,MUS 4,B01,891048,Staff,17,0,25,8
1746607173187,MUS 4,B02,891050,Staff,25,0,25,0
1746607174212,MUS 5,A01,957506,Dubnov; Shlomo,0,0,25,25
1746607174212,MUS 5,A02,957622,Dubnov; Shlomo,12,0,25,13
1746607174212,MUS 5,A03,957623,Dubnov; Shlomo,20,0,25,5
1746607175279,MUS 6,A01,891053,Freitas Caetano; Marcelo,24,0,25,1
1746607175279,MUS 6,A02,891054,Freitas Caetano; Marcelo,23,0,25,2
1746607176306,MUS 7,A01,891081,Staff,0,0,25,25
1746607176306,MUS 7,A02,891082,Staff,3,0,25,22
1746607177332,MUS 8GS,A00,891118,Borgo; David Garcia,1,0,25,24
1746607178359,MUS 11,A01,891140,Staff,8,0,25,17
1746607178359,MUS 11,A02,891141,Staff,21,0,25,4
1746607179385,MUS 13,A01,891143,Staff,8,0,25,17
1746607179385,MUS 13,A02,891144,Staff,24,0,25,1
1746607180415,MUS 15,A01,891146,Staff,9,0,25,16
1746607180415,MUS 15,A02,891148,Staff,21,0,25,4
1746607180415,MUS 15,B01,891150,Staff,18,0,25,7
1746607180415,MUS 15,B02,891151,Staff,25,0,25,0
1746607181442,MUS 20,A01,891153,Staff,5,0,20,15
1746607181442,MUS 20,A02,891155,Staff,14,0,20,6
1746607182470,MUS 80,A00,891156,Staff,19,0,25,6
1746607182470,MUS 80,B00,891157,Staff,23,0,25,2
1746607183498,MUS 130,A00,891158,Ohnishi; Takae,35,0,35,0
1746607184525,MUS 150GS,A01,891160,Borgo; David Garcia,1,0,25,24
1746607185551,MUS 170,A01,891162,Freitas Caetano; Marcelo,20,0,25,5
1746607185551,MUS 170,A02,891164,Freitas Caetano; Marcelo,21,0,25,4
1746607186578,NANO 11,A00,886220,Vazquez Mena; Oscar,13,0,15,2
1746607187609,NANO 15,A01,886222,Drews; Aaron,4,0,7,3
1746607188635,NANO 104,A00,886224,Sirbuly; Donald,17,0,25,8
1746607189664,PH 40,A00,886528,Staff,23,0,40,17
1746607190692,PH 45,A01,886799,Staff,35,0,40,5
1746607191718,PH 110,A00,886802,Staff,0,6,40,40
1746607192746,PH 172,A00,906716,Staff,19,0,35,16
1746607193773,PH 191,A00,886803,Staff,6,0,40,34
1746607194803,PHIL 1,A00,889500,Staff,20,0,30,10
1746607195833,PHIL 10,A01,889549,Grush; Rick Scott,16,0,22,6
1746607195833,PHIL 10,A02,889551,Grush; Rick Scott,22,0,22,0
1746607196864,PHIL 28,A01,889559,Lamey; Andy M.,0,2,31,31
1746607196864,PHIL 28,A02,889561,Lamey; Andy M.,0,1,30,30
1746607196864,PHIL 28,A03,889572,Lamey; Andy M.,0,1,30,30
1746607197895,PHIL 35,A00,907839,Staff,13,0,15,2
1746607198923,PHIL 60,A00,889574,Staff,73,0,90,17
1746607199951,PHIL 101,A00,958004,Staff,12,0,15,3
1746607202005,PHIL 136,A00,889582,Fulkerson; Matthew Todd,26,0,45,19
1746607203036,PHIL 163,A01,889601,Staff,21,0,30,9
1746607203036,PHIL 163,B01,889606,Brandt; Reuven A,0,3,0,0
1746607204067,PHIL 164,A00,889610,Staff,16,0,30,14
1746607205092,PHIL 165,A00,889613,Staff,22,0,30,8
1746607206123,PHYS 1A,A00,886431,Staff,30,0,70,40
1746607207150,PHYS 1AL,001,886432,Tsai; Philbert S,0,1,30,30
1746607207150,PHYS 1AL,002,886436,Tsai; Philbert S,13,0,30,17
1746607208175,PHYS 1B,A00,886439,Staff,184,0,240,56
1746607209202,PHYS 1BL,001,886441,Tsai; Philbert S,0,4,30,30
1746607209202,PHYS 1BL,002,886444,Tsai; Philbert S,2,0,30,28
1746607210227,PHYS 1C,A00,896092,Arnold; Kam S,78,0,146,68
1746607211258,PHYS 1CL,001,886448,Tsai; Philbert S,0,0,30,30
1746607211258,PHYS 1CL,002,886449,Tsai; Philbert S,1,0,30,29
1746607211258,PHYS 1CL,003,886450,Tsai; Philbert S,16,0,30,14
1746607211258,PHYS 1CL,004,886451,Tsai; Philbert S,15,0,30,15
1746607212286,PHYS 2B,A01,886457,Staff,67,0,115,48
1746607213311,PHYS 2C,A01,886460,Shotwell; Brian,0,9,65,65
1746607214340,PHYS 2CL,A01,886467,Staff,0,4,28,28
1746607214340,PHYS 2CL,A02,886468,Staff,0,3,28,28
1746607215366,PHYS 2D,A01,886470,Staff,10,0,50,40
1746607216393,PHYS 4B,A01,886475,Grinstein; Benjamin,22,0,40,18
1746607217423,POLI 5,A00,891173,Desposato; Scott,7,0,25,18
1746607218449,POLI 5D,A01,891175,Staff,5,0,5,0
1746607218449,POLI 5D,B01,891178,Staff,5,0,5,0
1746607219475,POLI 11,A00,891179,Ferree; Karen E,0,0,35,35
1746607220502,POLI 12,A00,891180,Staff,15,0,30,15
1746607221528,POLI 27,A01,891182,Staff,11,0,75,64
1746607222556,POLI 30,A00,891183,Staff,8,0,50,42
1746607223585,POLI 100B,A00,891244,Staff,5,1,35,30
1746607224611,POLI 100I,A00,891247,Staff,7,0,30,23
1746607225638,POLI 104J,A00,891248,Nichter; Maysa,14,0,30,16
1746607226665,POLI 104U,A00,891250,Nichter; Maysa,1,0,30,29
1746607228719,POLI 110B,A00,891255,Wiens; David,19,0,25,6
1746607229748,POLI 112A,A00,891256,Wiens; David,6,0,25,19
1746607230774,POLI 114BR,A00,891261,Staff,19,0,30,11
1746607231800,POLI 117R,A00,891262,Forman; Fonna,0,6,50,50
1746607232829,POLI 118,A00,891264,Ingham; Sean,17,0,25,8
1746607233857,POLI 124A,A00,891265,Staff,18,0,20,2
1746607234887,POLI 125D,A00,891266,Nichter; Simeon C,2,0,25,23
1746607235916,POLI 126,A00,891268,Nichter; Simeon C,7,0,25,18
1746607236941,POLI 126AA,A00,891272,Staff,15,0,25,10
1746607237967,POLI 130AA,A00,891273,Staff,15,0,20,5
1746607238994,POLI 134AA,A00,891274,Staff,4,0,20,16
1746607241050,POLI 138,A00,891278,Staff,21,0,25,4
1746607242080,POLI 142K,A00,891280,Staff,10,0,25,15
1746607243110,POLI 142M,A00,891281,Gartzke; Erik,16,0,30,14
1746607244138,POLI 142P,A00,891284,Staff,20,0,30,10
1746607245166,POLI 143,A00,891285,Gartzke; Erik,12,0,30,18
1746607246191,POLI 153,A00,891286,Staff,19,0,20,1
1746607248247,POLI 175,A00,891290,Staff,15,0,20,5
1746607249276,PSYC 1,A00,890674,Steiner; Eric Tomas,0,11,45,45
1746607250306,PSYC 2,A00,890676,Albright; Thomas D,20,0,35,15
1746607251331,PSYC 3,A00,890679,Staff,17,0,20,3
1746607252361,PSYC 6,A00,959858,Staff,19,0,20,1
1746607253392,PSYC 60,A01,890684,Rickard; Timothy C.,0,6,45,45
1746607254419,PSYC 70,A01,890689,Geller; Emma Harlan,6,0,30,24
1746607255447,PSYC 71,A01,959860,Staff,21,0,25,4
1746607256476,PSYC 100,A00,890690,Lacefield; Katharine I,0,50,180,180
1746607257505,PSYC 102,A00,890695,Staff,18,0,40,22
1746607258535,PSYC 105,A00,890699,Geller; Emma Harlan,70,0,100,30
1746607259563,PSYC 106,A00,890701,Gorman; Michael R.,5,0,30,25
1746607260589,PSYC 108,A00,890704,Adrian; Julia Anna,0,29,50,50
1746607261617,PSYC 118,A01,890712,Staff,11,0,30,19
1746607262649,PSYC 124,A00,890716,Chapman; Eddie Nathaniel,25,0,60,35
1746607263676,PSYC 131,A00,890717,Anagnostaras; Stephan,0,7,80,80
1746607264704,PSYC 137,A00,890719,Winkielman; Piotr,0,11,30,30
1746607265729,PSYC 144,A00,890721,Adrian; Julia Anna,0,9,45,45
1746607266755,PSYC 162,A00,890805,Staff,0,2,75,75
1746607267784,PSYC 169,A00,890810,Staff,0,15,30,30
1746607268814,PSYC 172,A00,890814,Gorman; Michael R.,9,0,30,21
1746607269845,PSYC 181,A00,890818,Anagnostaras; Stephan,6,0,200,194
1746607270871,PSYC 184,A00,959861,Staff,160,0,175,15
1746607271897,PSYC 189,A00,890823,Staff,0,2,30,30
1746607272930,PSYC 191,A00,890884,Rickard; Timothy C.,0,12,35,35
1746607273964,PSYC 193,A00,890913,Staff,19,0,30,11
1746607273964,PSYC 193,B00,890914,Chapman; Eddie Nathaniel,24,0,30,6
1746607275045,PSYC 193L,A01,890918,Lowe; Angela Beth,20,0,30,10
1746607275045,PSYC 193L,B01,890921,Hurwitz; Ethan Scott,20,0,30,10
1746607275045,PSYC 193L,C01,890928,Staff,30,0,30,0
1746607276089,RELI 149,A00,886806,Rahimi; Babak,23,0,40,17
1746607277126,SE 9,A01,886814,Staff,7,0,20,13
1746607278156,SE 101B,A01,886816,Chadha; Mayank,3,0,35,32
1746607279221,SE 110B,A00,886818,Zhu; Qiang,4,0,75,71
1746607280248,SE 125,A01,886830,Staff,10,0,30,20
1746607281276,SE 130B,A01,886835,Staff,14,0,40,26
1746607282306,SE 131A,A01,886838,Krysl; Petr,34,0,55,21
1746607283332,SE 154,A00,886840,Staff,28,0,50,22
1746607284358,SE 164GS,A01,886849,Staff,6,0,20,14
1746607285388,SE 167GS,A01,886853,Staff,6,0,20,14
1746607286414,SIO 25,A01,890107,Staff,19,0,30,11
1746607287442,SIO 45,A00,890109,Cook; Geoffrey W,114,0,200,86
1746607288468,SIO 109R,A00,890110,Forman; Fonna,0,16,20,20
1746607289501,SIO 187,A01,890114,Kacev; David,15,0,40,25
1746607290536,SOCI 1,A01,890431,Thorpe; Charles Robert,14,0,30,16
1746607290536,SOCI 1,A02,890518,Thorpe; Charles Robert,30,0,30,0
1746607291563,SOCI 2,A01,957978,Staff,25,0,25,0
1746607291563,SOCI 2,A02,957979,Staff,23,0,25,2
1746607292589,SOCI 20,A01,890523,Calderon-Zaks; Michael Aar,21,0,30,9
1746607292589,SOCI 20,A02,890526,Calderon-Zaks; Michael Aar,29,0,30,1
1746607293615,SOCI 30,A01,890533,Pardo Guerra; Juan Pablo,37,0,40,3
1746607294643,SOCI 40,A01,890535,Staff,27,0,45,18
1746607295673,SOCI 104Q,A00,890559,Staff,17,0,30,13
1746607296701,SOCI 106,A00,890560,Arnal; Maud Marie Leonie,20,0,30,10
1746607297732,SOCI 110,A00,890567,Holkenbrink-Monk; Charlene,19,0,30,11
1746607298761,SOCI 112,A00,890568,Victoria Torres; Pablo,2,0,55,53
1746607299788,SOCI 115,A00,890597,Arnal; Maud Marie Leonie,28,0,45,17
1746607301849,SOCI 121,A00,890604,Pardo Guerra; Juan Pablo,38,0,45,7
1746607302875,SOCI 126,A01,890608,Staff,8,0,10,2
1746607303901,SOCI 127,A00,890609,Staff,18,0,30,12
1746607304927,SOCI 131,A00,890610,Thorpe; Charles Robert,37,0,45,8
1746607305953,SOCI 135,A00,890615,Payne; Christine Anna,14,0,45,31
1746607306982,SOCI 139,A00,890620,Staff,38,0,45,7
1746607308009,SOCI 148E,A00,890622,Calderon-Zaks; Michael Aar,36,0,45,9
1746607309036,SOCI 150,A00,890623,Kohler; Kristopher M.,31,0,45,14
1746607310063,SOCI 157,A00,890625,Jules-Rosette; Bennetta W.,18,0,20,2
1746607311092,SOCI 160,A00,890627,Payne; Christine Anna,21,0,45,24
1746607312122,SYN 1,A00,886855,Fish; Gwendolyn Anne,0,1,0,0
1746607312122,SYN 1,B00,906086,Fish; Gwendolyn Anne,0,2,0,2
1746607313150,SYN 2R,A00,886860,Staff,0,17,15,15
1746607313150,SYN 2R,B00,906106,Atkinson; Arthur Laird,0,16,15,15
1746607314185,SYN 100,A01,886866,Browne; Emily,0,28,20,20
1746607314185,SYN 100,B01,906128,Rock; Martin,0,4,20,20
1746607314185,SYN 100,C01,906140,Deavenport; James Cary,0,4,20,20
1746607314185,SYN 100,D01,907816,Deavenport; James Cary,0,5,20,20
1746607315213,TDAC 1,A00,890286,Walsh; Kim C.,7,0,20,13
1746607316239,TDAC 101,A00,890296,Basso; Beatrice,15,0,20,5
1746607317269,TDDE 131,A00,890297,Staff,47,0,50,3
1746607318299,TDDM 1,A00,890287,Weinberg; Sadie,25,0,30,5
1746607319327,TDGE 11,A00,890288,Fulton; Julia,138,0,200,62
1746607319327,TDGE 11,B00,890289,Castro; Robert Jess,184,0,200,16
1746607320353,TDGE 25,B00,957359,Walsh; Kim C.,5,0,20,15
1746607321381,TDGE 40,A01,890292,Power; Jade Yukana,26,0,30,4
1746607322410,TDGE 124,A00,890298,Havis; Allan,0,2,50,50
1746607323437,TDGE 131R,A00,890299,Burelle; Julie Sara Veronique,15,0,42,27
1746607324465,TDHT 101,A00,890300,Staff,10,0,20,10
1746607325496,TDHT 109,A01,890302,Anderson; Mysia Anyse,31,0,40,9
1746607326523,TDMV 1,A00,890293,Arcidiacono; Kristin,18,0,30,12
1746607327552,TDMV 2,A00,890294,Weinberg; Sadie,23,0,30,7
1746607328578,TDMV 3,A00,957878,Arcidiacono; Kristin,28,0,30,2
1746607330633,TDMV 138,A00,890304,Jun; Grace Shin Hae,25,0,40,15
1746607331663,TDMV 140,A00,890305,Corrales; Joseph Bernales,25,0,30,5
1746607332693,TDMV 142,A00,890307,Caligagan; Tony,32,0,40,8
1746607333720,TDMV 144,A00,890308,Camaya; Michelle Ann,25,0,30,5
1746607334747,TDPW 1,A00,890295,Stein; Deborah Isobel,3,0,20,17
1746607335774,USP 2,A01,890272,Lerner; Amy M,7,0,20,13
1746607336800,USP 3,A01,890274,Staff,12,0,30,18
1746607337827,USP 15,A01,890276,Sun; Feiyang,16,0,30,14
1746607338855,USP 25,A00,890277,Shenkman; Michael Thomas,18,0,25,7
1746607339880,USP 138,A00,890278,Staff,13,0,25,12
1746607340910,USP 143,A00,890279,Staff,21,0,70,49
1746607341940,USP 144,A00,890280,Chowdhury; Muhammed Zohir,16,0,30,14
1746607342966,USP 150,A00,890281,Boomhower; Matthew Charles,4,0,30,26
1746607343992,USP 151,A00,890282,Staff,16,0,20,4
1746607345026,USP 162,A00,890283,Andrews; Abigail Leslie,16,0,20,4
1746607346052,USP 168,A00,920477,Kwak; Nancy,0,0,5,5
1746607347079,USP 181,A00,890284,Staff,3,0,20,17
1746607348103,USP 191A,A00,890285,Staff,12,0,20,8
1746607349128,VIS 101,A00,886512,Staff,26,0,75,49
1746607350155,VIS 103,A00,886513,Cruz; Edwin Teddy,61,0,75,14
1746607351180,VIS 108,A00,886514,Staff,4,0,15,11
1746607352221,VIS 127P,A00,886515,Shen; Kuiyi,80,0,146,66
1746607353249,VIS 149,A00,886516,Yoldas; Pinar,0,0,15,15
1746607354275,VIS 164,A00,886526,Erdmann; Dean,19,0,22,3
1746607355304,VIS 194S,A00,886527,Staff,61,0,75,14
1746607356334,WCWP 10A,C00,886484,Martiniuk; Jill,12,0,15,3
1746607357361,WCWP 10B,A00,886490,Uriarte; Emma,0,0,15,15
1746607357361,WCWP 10B,B00,886491,Dhir; Simrita,8,0,15,7
1746607357361,WCWP 10B,C00,886492,Ornelas; Tricia,0,0,15,15
1746607358392,WCWP 100,A00,886494,Young; Mark T,0,6,15,15
1746607360571,AAS 10,A01,886199,Childs; Dennis R.,0,3,0,0
1746607361599,ANAR 104,A01,886940,Shtienberg; Gilad,27,0,30,3
1746607362626,ANAR 120,A00,886953,Staff,13,0,20,7
1746607363652,ANBI 148,A01,886955,Wilder; Linnea Lorene,30,0,40,10
1746607365813,ANSC 122,A00,886957,Staff,24,0,30,6
1746607366846,ANSC 150,A00,886958,Sloane; Julia Kathryn,2,0,15,13
1746607367878,ANSC 156,A00,886959,Jenkins; Janis A.,0,1,15,15
1746607368907,ANSC 180,A00,886960,Staff,11,0,17,6
1746607369933,ANSC 188,A00,886961,Jassal; Aftab,9,0,25,16
1746607370961,ANSC 190,A00,886962,Jassal; Aftab,14,0,25,11
1746607371987,ANSC 191,A00,886963,Staff,18,0,20,2
1746607373018,ANTH 3,A01,891689,Staff,17,0,20,3
1746607374049,ANTH 5,A00,886933,Semendeferi; Ekaterini,16,0,20,4
1746607375077,ANTH 10,A00,886934,Staff,0,12,30,30
1746607376105,ANTH 21,A01,886936,Staff,41,0,60,19
1746607377134,ANTH 23,A01,886938,Staff,92,0,100,8
1746607378165,ANTH 105,A00,886964,Stewart; Alexander B,84,0,100,16
1746607379193,ANTH 108,A00,886965,Pedersen; David,9,0,20,11
1746607380225,AWP 10,001,886147,Staff,0,0,0,0
1746607380225,AWP 10,002,886148,Staff,0,0,0,0
1746607380225,AWP 10,003,886149,Staff,0,0,0,0
1746607380225,AWP 10,004,886150,Staff,0,0,0,0
1746607380225,AWP 10,005,886151,Staff,0,0,0,0
1746607380225,AWP 10,006,886152,Staff,0,0,0,0
1746607380225,AWP 10,007,886153,Staff,0,0,0,0
1746607380225,AWP 10,008,886154,Staff,0,0,0,0
1746607380225,AWP 10,009,886155,Staff,0,0,0,0
1746607380225,AWP 10,010,886156,Staff,0,0,0,0
1746607380225,AWP 10,011,886158,Staff,0,0,0,0
1746607380225,AWP 10,012,886160,Staff,0,0,0,0
1746607380225,AWP 10,013,886161,Staff,0,0,0,0
1746607380225,AWP 10,014,886162,Staff,0,0,0,0
1746607380225,AWP 10,015,886163,Staff,0,0,0,0
1746607380225,AWP 10,016,886164,Staff,0,0,0,0
1746607380225,AWP 10,017,886165,Staff,0,0,0,0
1746607380225,AWP 10,018,886166,Staff,0,0,0,0
1746607380225,AWP 10,019,886168,Staff,0,0,0,0
1746607380225,AWP 10,020,886170,Staff,0,0,0,0
1746607380225,AWP 10,021,886172,Staff,0,0,0,0
1746607381257,AWP 10R,001,886173,Staff,0,1,0,0
1746607381257,AWP 10R,002,886174,Staff,0,1,0,0
1746607381257,AWP 10R,003,886175,Staff,0,0,0,0
1746607381257,AWP 10R,004,886176,Staff,0,0,0,0
1746607381257,AWP 10R,005,886177,Staff,0,0,0,0
1746607381257,AWP 10R,006,886178,Staff,0,0,0,0
1746607381257,AWP 10R,007,886179,Staff,0,0,0,0
1746607381257,AWP 10R,008,886181,Staff,0,0,0,0
1746607381257,AWP 10R,009,886182,Staff,0,0,0,0
1746607381257,AWP 10R,010,886183,Staff,0,0,0,0
1746607381257,AWP 10R,011,886184,Staff,0,0,0,0
1746607381257,AWP 10R,012,886185,Staff,0,0,0,0
1746607381257,AWP 10R,013,886186,Staff,0,0,0,0
1746607381257,AWP 10R,014,886187,Staff,0,0,0,0
1746607381257,AWP 10R,015,886188,Staff,0,0,0,0
1746607381257,AWP 10R,016,886189,Staff,0,0,0,0
1746607381257,AWP 10R,017,960532,Staff,0,0,0,0
1746607381257,AWP 10R,018,960533,Staff,0,0,0,0
1746607381257,AWP 10R,019,960534,Staff,0,0,0,0
1746607381257,AWP 10R,020,960538,Staff,0,0,0,0
1746607381257,AWP 10R,021,960540,Staff,0,0,0,0
1746607381257,AWP 10R,022,960541,Staff,0,0,0,0
1746607381257,AWP 10R,023,960542,Staff,0,0,0,0
1746607381257,AWP 10R,024,960544,Staff,0,0,0,0
1746607381257,AWP 10R,025,960545,Staff,0,0,0,0
1746607381257,AWP 10R,026,960548,Staff,0,0,0,0
1746607382287,AWP 102R,A00,886190,Staff,0,0,0,0
1746607382287,AWP 102R,B00,886191,Staff,0,0,0,0
1746607383315,BENG 100,A01,886193,Staff,17,0,30,13
1746607384344,BENG 122A,A01,886195,Hasty; Jeff M,13,0,30,17
1746607385372,BENG 166A,A00,886196,Sah; Robert Lie-Yuan,0,3,30,30
1746607386405,BENG 190,A00,958050,Khojah; Reem I,17,0,25,8
1746607387440,BIBC 102,A01,894320,Staff,0,1,46,46
1746607387440,BIBC 102,A02,894321,Staff,0,0,46,46
1746607387440,BIBC 102,A03,894344,Staff,6,0,46,40
1746607387440,BIBC 102,A04,894345,Staff,27,0,47,20
1746607388469,BICD 100R,A01,894365,Smith; Laurie,0,2,58,58
1746607388469,BICD 100R,A02,894366,Smith; Laurie,0,4,58,58
1746607388469,BICD 100R,A03,894367,Smith; Laurie,0,0,59,59
1746607388469,BICD 100R,A04,959869,Smith; Laurie,38,0,59,21
1746607389496,BICD 136,A01,894383,Gustafson-Brown; Cindy,14,0,50,36
1746607390525,BIEB 102,A01,894494,Butler; Shannon Rhey,51,0,130,79
1746607392586,BIEB 150,A01,894617,Wills; Christopher,3,0,20,17
1746607392586,BIEB 150,A02,894631,Wills; Christopher,3,0,20,17
1746607392586,BIEB 150,A03,894937,Wills; Christopher,3,0,20,17
1746607392586,BIEB 150,A04,894946,Wills; Christopher,5,0,20,15
1746607393615,BIEB 194,A00,906141,Kurle; Carolyn M.,5,0,20,15
1746607394644,BILD 1,A01,894154,Staff,3,0,19,16
1746607394644,BILD 1,A02,894155,Staff,14,0,19,5
1746607394644,BILD 1,A03,894160,Staff,13,0,19,6
1746607394644,BILD 1,A04,894161,Staff,15,0,18,3
1746607395669,BILD 2,A01,894168,Staff,0,0,50,50
1746607395669,BILD 2,A02,894169,Staff,0,0,50,50
1746607395669,BILD 2,A03,894179,Staff,0,0,50,50
1746607395669,BILD 2,A04,894203,Staff,22,0,50,28
1746607396696,BILD 3,A01,894213,Staff,23,0,31,8
1746607396696,BILD 3,A02,894214,Staff,26,0,31,5
1746607396696,BILD 3,A03,894235,Staff,28,0,31,3
1746607396696,BILD 3,A04,894236,Staff,28,0,32,4
1746607397726,BILD 4,A01,894253,Reuther; Keefe,5,0,24,19
1746607397726,BILD 4,A02,894258,Reuther; Keefe,16,0,24,8
1746607398753,BILD 5,A01,894276,Reuther; Keefe,33,0,50,17
1746607398753,BILD 5,A02,894277,Reuther; Keefe,45,0,50,5
1746607398753,BILD 5,A03,894290,Reuther; Keefe,44,0,50,6
1746607398753,BILD 5,A04,894291,Reuther; Keefe,48,0,50,2
1746607399780,BILD 24,A01,894297,Pirino; Giorgia,40,0,60,20
1746607400809,BIMM 100,B01,958915,Staff,71,0,100,29
1746607401842,BIMM 101,A01,895017,McDonnell; Lisa Marie,0,5,24,24
1746607401842,BIMM 101,A02,895018,McDonnell; Lisa Marie,0,5,24,24
1746607401842,BIMM 101,B01,895020,McDonnell; Lisa Marie,0,5,24,24
1746607401842,BIMM 101,B02,895021,McDonnell; Lisa Marie,0,4,24,24
1746607402867,BIMM 110,A01,895023,Staff,1,0,25,24
1746607402867,BIMM 110,A02,895024,Staff,9,0,25,16
1746607402867,BIMM 110,A03,895025,Staff,18,0,25,7
1746607402867,BIMM 110,A04,895031,Staff,20,0,25,5
1746607403896,BIMM 120,A01,895114,Gustafson-Brown; Cindy,14,0,28,14
1746607403896,BIMM 120,A02,895126,Gustafson-Brown; Cindy,21,0,27,6
1746607404923,BIPN 100,A01,895130,Yang; Mingyu,0,0,38,38
1746607404923,BIPN 100,A02,895131,Yang; Mingyu,31,0,38,7
1746607404923,BIPN 100,A03,895132,Yang; Mingyu,32,0,38,6
1746607404923,BIPN 100,A04,895133,Yang; Mingyu,27,0,36,9
1746607405949,BIPN 120,A01,895135,Cooke; James Edward,0,3,13,13
1746607405949,BIPN 120,A02,895136,Cooke; James Edward,0,1,13,13
1746607405949,BIPN 120,A03,895137,Cooke; James Edward,0,3,13,13
1746607405949,BIPN 120,A04,895156,Cooke; James Edward,0,2,11,11
1746607406982,BIPN 134,A01,895235,Cooke; James Edward,0,1,25,25
1746607406982,BIPN 134,A02,895237,Cooke; James Edward,0,0,25,25
1746607406982,BIPN 134,A03,895240,Cooke; James Edward,1,0,25,24
1746607406982,BIPN 134,A04,895270,Cooke; James Edward,20,0,25,5
1746607408007,BIPN 189,A00,892103,Staff,0,14,14,14
1746607410063,BISP 194,A00,958008,Staff,0,2,0,0
1746607411092,CAT 124,A01,922009,Staff,0,5,20,20
1746607412123,CAT 125R,A00,886390,Morales; Celeste Georgianna,0,4,20,20
1746607412123,CAT 125R,B00,886391,Irwin; Matthew Joseph,0,4,20,20
1746607412123,CAT 125R,C00,886392,Smith; Lauryn Alissa,0,2,20,20
1746607412123,CAT 125R,D00,886393,Vanderschuit; Maya Alysia,0,3,20,20
1746607412123,CAT 125R,E00,886394,Marchisotto; Jennifer Anne,0,3,20,20
1746607413152,CENG 15,A01,886218,Drews; Aaron,3,0,8,5
1746607414177,CENG 113,A00,886219,Opatkiewicz; Justin Paul,15,0,25,10
1746607415205,CGS 101,A00,887044,Staff,7,0,20,13
1746607416231,CGS 105,A01,887046,Staff,14,0,25,11
1746607417263,CGS 112,A00,887047,Cuong; Marisol,12,0,15,3
1746607418292,CGS 113,A00,887048,Staff,23,0,30,7
1746607419324,CGS 120,A00,887049,Staff,9,0,17,8
1746607420355,CHEM 6A,A01,886336,Lam; Tin Yiu,38,0,50,12
1746607420355,CHEM 6A,A02,886338,Lam; Tin Yiu,37,0,50,13
1746607421388,CHEM 6B,A01,886341,Hopkins; Patrycja Anna,16,0,50,34
1746607421388,CHEM 6B,A02,886343,Hopkins; Patrycja Anna,42,0,50,8
1746607422433,CHEM 6C,A01,886346,Albizati; Kim F.,0,2,50,50
1746607422433,CHEM 6C,A02,886348,Albizati; Kim F.,24,0,50,26
1746607423464,CHEM 40A,A01,886352,Klosterman; Jeremy K,65,0,100,35
1746607424490,CHEM 40B,A01,886356,Klosterman; Jeremy K,0,24,100,100
1746607425523,CHEM 41B,A01,886360,Theodorakis; Emmanuel,25,0,50,25
1746607425523,CHEM 41B,A02,886362,Theodorakis; Emmanuel,47,0,50,3
1746607426555,CHIN 165A,A00,886382,Xu; Li,18,0,20,2
1746607427583,CLAS 120,A00,886387,Myerston Santana; Jacobo,33,0,40,7
1746607428610,COGS 9,A01,886967,Shannon; Kyle Michael,42,0,60,18
1746607429641,COGS 11,A01,886969,Staff,9,0,30,21
1746607430666,COGS 14A,A01,886971,Staff,5,0,60,55
1746607431697,COGS 14B,A01,886973,Hoffman; Drew Ellen,4,0,60,56
1746607432728,COGS 18,A01,886975,Morgan; Eric,34,0,60,26
1746607433756,COGS 20,A01,886977,Staff,3,0,8,5
1746607433756,COGS 20,A02,886978,Staff,5,0,7,2
1746607434788,COGS 100,A01,907783,Staff,0,1,30,30
1746607435815,COGS 101B,A01,886980,Staff,0,4,48,48
1746607436842,COGS 101C,A01,886982,Delgado; Tania,0,5,44,44
1746607437874,COGS 102A,A01,886984,Johnson; Christine M.,3,0,30,27
1746607438909,COGS 118B,A01,886986,Staff,0,4,88,88
1746607439940,COGS 150,A01,886988,Bergen; Benjamin,22,0,50,28
1746607440966,COGS 153,A00,886989,Delgado; Tania,1,3,41,40
1746607441992,COGS 186,A01,886991,Staff,0,0,32,32
1746607443022,COGS 187A,A01,886993,Boyle; Mary E. T.,7,0,30,23
1746607444048,COGS 189,A00,886994,Staff,0,1,30,30
1746607445077,COMM 10,A01,886996,Staff,0,0,20,21
1746607445077,COMM 10,A02,886997,Staff,10,0,20,10
1746607445077,COMM 10,A03,959845,Staff,19,0,20,1
1746607446107,COMM 20,A01,886999,Leuning; Grant Maurstad,24,0,40,16
1746607448161,COMM 100A,A01,887002,Staff,0,0,20,25
1746607448161,COMM 100A,A02,887003,Staff,5,0,20,15
1746607449186,COMM 100B,A01,887005,Staff,0,8,20,24
1746607450215,COMM 106D,A00,887006,Staff,14,0,40,26
1746607451241,COMM 110G,A00,887007,Whitworth-Smith; Andrew C,12,0,40,28
1746607452268,COMM 111B,A00,887008,Staff,31,0,40,9
1746607453294,COMM 113T,A00,887009,Abuelhiga; Soraya Jill,28,0,40,12
1746607453294,COMM 113T,B00,906733,Staff,39,0,40,1
1746607454323,COMM 145,A00,887010,Staff,13,0,40,27
1746607455351,COMM 146,A00,887054,Staff,32,0,40,8
1746607456376,COMM 190,A00,887012,Staff,8,0,23,15
1746607457405,CSE 8A,A50,887015,Cao; Yingjun,56,0,85,29
1746607458431,CSE 11,A01,887017,Cao; Yingjun,11,0,70,59
1746607459458,CSE 20,A01,887019,Staff,30,0,50,20
1746607460486,CSE 21,A01,887021,Staff,79,0,100,21
1746607460486,CSE 21,B01,892583,Braun; Oliver,45,0,50,5
1746607461519,CSE 30,A01,887025,Eldon; John,142,0,200,58
1746607462551,CSE 100,A01,887027,Staff,26,0,50,24
1746607462551,CSE 100,A02,887028,Staff,42,0,50,8
1746607463580,CSE 101,A01,887030,Braun; Oliver,74,0,100,26
1746607463580,CSE 101,B01,887032,Jones; Miles E,0,3,50,50
1746607463580,CSE 101,B02,887033,Jones; Miles E,0,2,50,50
1746607464607,CSE 105,A01,908084,Jones; Miles E,32,0,50,18
1746607464607,CSE 105,A02,908087,Jones; Miles E,31,0,50,19
1746607465634,CSE 135,A01,887035,Powell; Thomas Allan,0,5,50,50
1746607466662,CSE 142,A01,887037,Staff,7,0,60,53
1746607467689,CSE 142L,A01,887039,Staff,34,0,60,26
1746607468714,CSE 151A,A01,887041,Solares; Edwin A,47,0,100,53
1746607469740,CSE 175,A01,887043,Kumar; Rakesh,30,0,30,0
1746607470769,CSS 1,A01,886389,Staff,0,1,40,40
1746607471838,DSC 30,A01,908097,Liao; Soohyun Nam,47,0,75,28
1746607472865,DSC 40A,A01,908099,Shannon; Kyle Michael,30,0,50,20
1746607473893,DSC 40B,A01,908112,Staff,15,0,50,35
1746607474918,DSC 80,A01,908116,Staff,19,0,60,41
1746607475945,DSC 197,001,956863,Eldridge; Justin Matthew,9999,0,9999,0
1746607476971,ECE 5,A01,886400,Morris; Karcher William,1,0,6,5
1746607476971,ECE 5,A02,886401,Morris; Karcher William,3,0,6,3
1746607477998,ECE 148,A01,886403,Silberman; Jack,0,14,14,14
1746607479025,ECON 1,A01,887265,Crane; Meredith Helen,11,0,70,59
1746607479025,ECON 1,B01,887268,Staff,42,0,50,8
1746607480052,ECON 2,A01,887273,Crane; Meredith Helen,54,0,70,16
1746607481079,ECON 3,A01,887279,Rondina; Giacomo,31,0,70,39
1746607482106,ECON 4,A01,887282,Anderson; John Charles,0,2,10,10
1746607483132,ECON 5,A01,887285,Staff,34,0,45,11
1746607483132,ECON 5,B01,887292,Staff,41,0,45,4
1746607484160,ECON 100A,A01,887337,Newhouse; Herbert S,54,0,70,16
1746607484160,ECON 100A,B01,887349,Staff,45,0,50,5
1746607485186,ECON 100B,A01,887361,Du; Songzi,29,0,70,41
1746607486213,ECON 100C,A01,887445,Newhouse; Herbert S,59,0,70,11
1746607487239,ECON 105,A00,887488,Vespa; Emanuel Ignacio,23,0,35,12
1746607488267,ECON 109,A01,887506,Shishkin; Denis,28,0,35,7
1746607489295,ECON 110A,A01,887568,Alon; Titan Michael,0,2,35,35
1746607489295,ECON 110A,B01,907601,Alon; Titan Michael,20,0,35,15
1746607490322,ECON 110B,A01,887598,Levkoff; Steven B.,0,24,70,70
1746607491349,ECON 112,A00,887599,Rondina; Giacomo,19,0,35,16
1746607492378,ECON 120A,A01,887603,Dai; Yinlin,36,0,70,34
1746607493406,ECON 120C,A01,887608,Sun; Yixiao,0,1,35,35
1746607493406,ECON 120C,B01,887614,Sun; Yixiao,0,0,35,35
1746607494434,ECON 138,A00,887621,Bharadwaj; Prashant,0,21,20,20
1746607495462,ECON 144,A00,958007,Squires; Dale E,11,0,35,24
1746607496491,ECON 171,A01,907666,Staff,18,0,35,17
1746607497521,ECON 175,A00,887626,Wu; Pak Yeung,22,0,35,13
1746607498550,ECON 190,A00,887640,Vespa; Emanuel Ignacio,22,0,35,13
1746607499581,EDS 25,A01,888197,Staff,0,0,0,0
1746607499581,EDS 25,A02,888209,Staff,0,0,0,0
1746607499581,EDS 25,A03,888210,Staff,0,0,0,0
1746607499581,EDS 25,A04,888212,Staff,0,0,0,0
1746607499581,EDS 25,A05,888213,Staff,0,0,0,0
1746607499581,EDS 25,A06,888214,Staff,0,0,0,0
1746607499581,EDS 25,A07,888235,Staff,0,2,0,0
1746607499581,EDS 25,A08,888236,Staff,0,0,0,0
1746607499581,EDS 25,A09,888240,Staff,0,0,0,0
1746607499581,EDS 25,A10,888244,Staff,0,0,0,0
1746607499581,EDS 25,B01,888273,Staff,0,0,0,0
1746607499581,EDS 25,B02,888285,Staff,0,0,0,0
1746607499581,EDS 25,B03,888423,Staff,0,0,0,1
1746607499581,EDS 25,B04,888432,Staff,0,0,0,0
1746607499581,EDS 25,B05,888433,Staff,0,0,0,0
1746607499581,EDS 25,B06,888467,Staff,0,0,0,0
1746607499581,EDS 25,B07,888468,Staff,0,0,0,0
1746607499581,EDS 25,B08,888479,Staff,0,0,0,0
1746607499581,EDS 25,B09,888484,Staff,0,0,0,0
1746607499581,EDS 25,B10,888487,Staff,0,0,0,0
1746607500608,EDS 38,A01,907700,Choi; Bailey Miyeon,30,0,30,0
1746607501639,EDS 112,A01,888601,Chapman; Thandeka K,12,0,40,28
1746607502667,EDS 115,A00,888697,Mendez; Kathrina Mendoza,10,0,30,20
1746607503693,EDS 116,A01,888893,Staff,33,0,40,7
1746607505750,EDS 124AR,A00,889133,Staff,29,0,50,21
1746607505750,EDS 124AR,B00,907471,Simon; Elizabeth A,37,0,50,13
1746607506779,EDS 124BR,A00,889134,Simon; Elizabeth A,44,0,100,56
1746607507806,EDS 125,A00,889135,Staff,25,0,30,5
1746607508832,EDS 126,A01,889138,Staff,35,0,40,5
1746607509858,EDS 164R,A01,889142,Wishard Guerra; Alison G.,32,0,50,18
1746607510884,ENG 30,A01,886396,Staff,0,0,0,0
1746607510884,ENG 30,B01,886398,Staff,0,0,0,0
1746607511912,ENVR 102,A00,906150,Montejo; Carolina,23,0,25,2
1746607512937,ETHN 103A,A00,887236,Man; Simeon S,0,2,0,0
1746607513963,ETHN 113,A00,887239,Staff,16,0,30,14
1746607514992,ETHN 116,A00,887240,Staff,16,0,25,9
1746607516019,ETHN 117,A00,887241,Choi; Esther Min,28,0,30,2
1746607517045,ETHN 118,A00,887243,Staff,24,0,30,6
1746607518071,ETHN 127,A00,887248,Cuong; Marisol,11,0,15,4
1746607519103,ETHN 139,A00,887250,Staff,7,0,10,3
1746607520132,ETHN 142,A00,887252,Staff,9,0,30,21
1746607521163,ETHN 161,A00,887253,Browne; Errol Tsekani,24,0,30,6
1746607522189,ETHN 163FR,A00,887255,Burelle; Julie Sara Veronique,0,0,5,5
1746607523224,GLBH 20,A00,889149,Elwardani; Nile Regina,8,0,42,34
1746607525281,GLBH 111,A01,889152,Burgos; Jose L.,17,0,17,0
1746607526308,GLBH 150,A00,889181,Sloane; Julia Kathryn,0,5,15,15
1746607528359,HDS 60,A01,886406,Warstadt; Melissa Fawn,72,0,80,8
1746607529389,HIAF 111,A00,889324,Gyamfi; Bright,25,0,32,7
1746607530414,HIEA 131,A00,889328,Staff,15,0,32,17
1746607531440,HIEA 144,A00,889333,Henry; Todd A.,26,0,32,6
1746607532468,HIEA 154,A00,889336,Henry; Todd A.,24,0,32,8
1746607533496,HIEU 106,A00,889339,Staff,22,0,32,10
1746607535548,HIEU 114,A00,889340,Staff,4,0,32,28
1746607536580,HIEU 135GS,A00,889342,Patterson; Patrick H.,0,0,1,24
1746607537605,HIEU 137,A00,889343,Edington; Claire Ellen,10,0,25,15
1746607538633,HIEU 148,A00,889345,Staff,14,0,32,18
1746607539660,HIEU 154,A00,889346,Biess; Frank Peter,21,0,32,11
1746607540688,HILA 102,A00,889351,Staff,12,0,32,20
1746607541713,HILD 2A,A01,889221,Lewandoski; Julia Mavis,0,8,32,32
1746607542778,HILD 7B,A01,889225,Man; Simeon S,0,12,32,32
1746607543810,HILD 7C,A01,889288,Alvarez; Luis A,0,14,32,32
1746607544835,HILD 30,A01,889323,Staff,0,5,32,32
1746607546894,HISC 119,A00,889383,Golan; Tal,20,0,32,12
1746607547923,HIUS 103,A00,889384,Man; Simeon S,0,0,32,32
1746607548950,HIUS 117,A00,919797,Kwak; Nancy,18,0,32,14
1746607549981,HIUS 142A,A00,919788,Staff,22,0,32,10
1746607552033,HIUS 149,A00,889386,Gyamfi; Bright,26,0,32,6
1746607553060,HIUS 155,A00,889387,Alvarez; Luis A,15,0,32,17
1746607554087,HUM 3,A01,886499,Caldwell; Michael Alan,19,0,50,31
1746607555114,HUM 3GS,A00,886500,Rodriguez; Bretton Sigfred,0,0,0,28
1746607556139,HUM 3R,A01,886502,Markman; Kristina,0,36,50,50
1746607557193,HUM 4,A01,886504,Crum; Matthew Stephen,23,0,50,27
1746607557193,HUM 4,B01,886506,West; Geoffrey Scott,17,0,50,33
1746607558218,HUM 4GS,A00,886507,Staff,0,0,0,19
1746607559246,HUM 5,A01,886509,Staff,31,0,50,19
1746607560271,HUM 5R,A01,886511,Zavodny; Tatiana Sophia,0,39,50,50
1746607561295,JAPN 180,A00,886407,Staff,16,0,40,24
1746607562325,LATI 50,A01,886409,Martin-Cabrera; Luis,3,0,22,19
1746607562325,LATI 50,A02,886410,Martin-Cabrera; Luis,19,0,22,3
1746607562325,LATI 50,A03,886411,Martin-Cabrera; Luis,21,0,22,1
1746607562325,LATI 50,A04,886412,Martin-Cabrera; Luis,8,0,22,14
1746607563352,LAWS 101,A00,907664,Staff,28,0,60,32
1746607564382,LIAB 1A,A00,889388,Saab; Dima,17,0,20,3
1746607565410,LIAB 1AX,A00,889389,El Cheddadi; Youniss,18,0,20,2
1746607566439,LIFR 1C,A00,889391,Van Moer; Vinciane G,8,0,20,12
1746607567465,LIFR 1CX,A00,889392,Van Moer; Vinciane G,7,0,20,13
1746607568495,LIFR 1D,A00,889393,Van Moer; Vinciane G,7,0,20,13
1746607569520,LIFR 1DX,A00,889394,Van Moer; Vinciane G,8,0,20,12
1746607570554,LIGN 7,A00,886923,Staff,25,0,50,25
1746607571579,LIGN 17,A00,886924,Kehler; Andrew Scott,126,0,150,24
1746607572604,LTAM 110,A00,889395,Staff,15,0,30,15
1746607573628,LTAM 110GS,A00,958010,Rodriguez; Bretton Sigfred,0,0,0,28
1746607574658,LTCH 101,A00,889397,Staff,23,0,25,2
1746607575682,LTCS 130,A00,889398,Staff,23,0,25,2
1746607576716,LTEA 138,A00,889399,Staff,24,0,40,16
1746607577744,LTEN 149,A00,889400,Wesling; Megan E.,0,3,25,25
1746607578772,LTEN 169,A00,889401,Staff,20,0,25,5
1746607579797,LTEN 180,A00,889402,Staff,10,0,15,5
1746607580825,LTEN 181,A00,889403,Staff,21,0,25,4
1746607581854,LTWL 100,A00,889404,Myerston Santana; Jacobo,2,0,25,23
1746607582887,LTWL 180GS,A00,889405,Staff,0,0,20,20
1746607583912,LTWL 181,A00,889406,Staff,16,0,25,9
1746607584945,LTWL 184,A00,889475,Mukherjee; Silpa,22,0,25,3
1746607585983,LTWR 102C,A00,889486,Staff,29,0,30,1
1746607587011,LTWR 115W,A00,889491,Staff,0,2,15,15
1746607588041,MAE 8,A01,886905,Staff,0,2,0,0
1746607589070,MAE 11,A00,886906,Bandaru; Prabhakar,0,7,50,50
1746607590095,MAE 20,A00,886907,Evdokimenko; Ekaterina,43,0,70,27
1746607591155,MAE 30B,A00,886909,Ghazinejad; Maziar,25,0,45,20
1746607592184,MAE 101B,A00,886910,Saintillan; David,30,0,45,15
1746607593212,MAE 105,A00,886911,Bandaru; Prabhakar,18,0,50,32
1746607594239,MAE 107,B00,958024,Staff,7,0,50,43
1746607595267,MAE 143B,A00,886913,Bewley; Thomas R,2,0,40,38
1746607596293,MAE 148,A01,886915,Silberman; Jack,0,3,14,14
1746607597318,MAE 160,A00,886916,Evdokimenko; Ekaterina,30,0,60,30
1746607598345,MATH 3C,A01,889681,Staff,0,2,30,30
1746607598345,MATH 3C,A02,960048,Staff,23,0,30,7
1746607599375,MATH 10A,A01,889760,Staff,26,0,30,4
1746607599375,MATH 10A,A02,889783,Staff,29,0,30,1
1746607600402,MATH 10B,A01,889785,Verstraete; Jacques Allan,1,0,35,34
1746607600402,MATH 10B,A02,889795,Verstraete; Jacques Allan,4,0,35,31
1746607600402,MATH 10B,B01,889797,Verstraete; Jacques Allan,3,0,35,32
1746607600402,MATH 10B,B02,889828,Verstraete; Jacques Allan,3,0,35,32
1746607601432,MATH 10C,A01,889849,Habib; Yousaf,8,0,30,22
1746607601432,MATH 10C,A02,889852,Habib; Yousaf,14,0,30,16
1746607601432,MATH 10C,A03,889853,Habib; Yousaf,22,0,30,8
1746607601432,MATH 10C,A04,889858,Habib; Yousaf,20,0,30,10
1746607601432,MATH 10C,B01,889861,Staff,1,0,30,29
1746607601432,MATH 10C,B02,889862,Staff,24,0,30,6
1746607601432,MATH 10C,B03,889863,Staff,27,0,30,3
1746607601432,MATH 10C,B04,889967,Staff,23,0,30,7
1746607602462,MATH 18,A01,889974,Staff,6,0,30,24
1746607602462,MATH 18,A02,889977,Staff,20,0,30,10
1746607602462,MATH 18,B01,889984,Hardiman; Liam,20,0,30,10
1746607602462,MATH 18,B02,889985,Hardiman; Liam,25,0,30,5
1746607603487,MATH 20A,A01,889990,Suk; Andrew Hoon,30,0,35,5
1746607604513,MATH 20B,A01,889993,Ohm; Ko Woon,21,0,30,9
1746607604513,MATH 20B,A02,889994,Ohm; Ko Woon,30,0,30,0
1746607604513,MATH 20B,B01,889996,Ohm; Ko Woon,22,0,30,8
1746607604513,MATH 20B,B02,889997,Ohm; Ko Woon,23,0,30,7
1746607605543,MATH 20C,A01,889999,Hammock; Frances H,17,0,30,13
1746607605543,MATH 20C,A02,890003,Hammock; Frances H,23,0,30,7
1746607605543,MATH 20C,B01,890006,Hammock; Frances H,2,0,30,28
1746607605543,MATH 20C,B02,890007,Hammock; Frances H,11,0,30,19
1746607606577,MATH 20D,A01,890011,Cheng; Hsiao-Bing,1,0,30,29
1746607606577,MATH 20D,A02,890012,Cheng; Hsiao-Bing,14,0,30,16
1746607606577,MATH 20D,B01,890016,Cheng; Hsiao-Bing,13,0,30,17
1746607606577,MATH 20D,B02,890017,Cheng; Hsiao-Bing,13,0,30,17
1746607607610,MATH 20E,A01,890026,Harel; Guershon,1,0,30,29
1746607607610,MATH 20E,A02,890029,Harel; Guershon,22,0,30,8
1746607607610,MATH 20E,B01,890033,Harel; Guershon,7,0,30,23
1746607607610,MATH 20E,B02,890101,Harel; Guershon,21,0,30,9
1746607608638,MATH 102,A01,890104,Staff,18,0,30,12
1746607608638,MATH 102,A02,890105,Staff,27,0,30,3
1746607609670,MATH 103B,A01,890116,Salehi Golsefidy; Alireza,3,0,30,27
1746607609670,MATH 103B,B01,890118,Staff,0,3,34,34
1746607610702,MATH 109,A01,890121,Aliabadi Sr.; Mohsen,0,0,30,30
1746607610702,MATH 109,B01,890124,Upadrashta; Pranav Kumar,18,0,30,12
1746607611735,MATH 120A,A01,890126,Eggers; John Dietrich,13,0,30,17
1746607612766,MATH 142B,A01,890128,Ioana; Adrian,19,0,30,11
1746607612766,MATH 142B,A02,890129,Ioana; Adrian,12,0,30,18
1746607613793,MATH 154,A01,890174,Staff,0,1,30,30
1746607613793,MATH 154,A02,890182,Staff,0,0,30,30
1746607614825,MATH 168A,A01,890197,Dumitriu; Ioana,21,0,35,14
1746607615851,MATH 170A,A01,890240,Nie; Jiawang,1,0,30,29
1746607615851,MATH 170A,A02,890241,Nie; Jiawang,11,0,30,19
1746607615851,MATH 170A,A03,890249,Nie; Jiawang,23,0,30,7
1746607616876,MATH 170B,A01,957891,Nag; Panchali,13,0,35,22
1746607618933,MATH 181A,A01,908025,Staff,0,3,35,35
1746607618933,MATH 181A,A02,960115,Staff,26,0,35,9
1746607619961,MATH 181B,A01,959874,Staff,24,0,30,6
1746607620986,MATH 193B,A01,890265,Staff,0,4,35,35
1746607622015,MGT 4,A01,890311,Anderson; John Charles,42,0,88,46
1746607623042,MGT 5,A00,907740,Staff,12,0,98,86
1746607624069,MGT 12,A00,890312,Lindenberger; Wade Douglas,67,0,98,31
1746607625097,MGT 16,A00,957883,Staff,78,0,98,20
1746607627147,MGT 45,A00,890314,Pecore; Joseph P.,45,0,98,53
1746607628177,MGT 71,A00,890315,Staff,0,12,98,98
1746607629202,MGT 100,A00,890316,Yavorsky; Daniel Ryan,44,0,98,54
1746607630230,MGT 103,A00,890317,Ehrich; Kristine R,73,0,98,25
1746607631262,MGT 105,A00,890356,Bates; Kenneth Walter,0,8,98,98
1746607632292,MGT 112,A00,890360,Ehrich; Kristine R,55,0,98,43
1746607633318,MGT 127R,A00,907732,Zhu; Kevin Xiaoguo,23,0,98,75
1746607634347,MGT 131B,A00,890361,Anderson; John Charles,59,0,98,39
1746607635376,MGT 137,A00,890362,Lindenberger; Wade Douglas,65,0,98,33
1746607636403,MGT 160,A00,890369,Johnson; Erik Barry,9,0,98,89
1746607638462,MGT 164,A00,890372,Zimmermann; Carsten,0,40,98,98
1746607639491,MGT 180,A00,890374,Bliss; Barbara Ann,11,0,98,87
1746607640519,MMW 15,A01,886414,Chang; Edmond Yi-Teh,0,12,28,28
1746607640519,MMW 15,A02,886415,Chang; Edmond Yi-Teh,0,8,28,28
1746607640519,MMW 15,A03,886416,Chang; Edmond Yi-Teh,0,9,28,28
1746607640519,MMW 15,A04,886417,Chang; Edmond Yi-Teh,0,8,28,28
1746607640519,MMW 15,B01,886419,Chang; Edmond Yi-Teh,0,7,28,28
1746607640519,MMW 15,B02,886420,Chang; Edmond Yi-Teh,0,7,28,28
1746607640519,MMW 15,B03,886421,Chang; Edmond Yi-Teh,0,7,28,28
1746607640519,MMW 15,B04,886422,Chang; Edmond Yi-Teh,0,8,28,28
1746607640519,MMW 15,C01,886424,Staff,0,9,28,28
1746607640519,MMW 15,C02,886425,Staff,0,8,28,28
1746607640519,MMW 15,C03,886426,Staff,0,8,28,28
1746607640519,MMW 15,C04,886427,Staff,0,8,28,28
1746607640519,MMW 15,C05,958038,Staff,0,8,28,28
1746607640519,MMW 15,C06,958039,Staff,0,7,28,28
1746607641545,MMW 15GS,A00,906910,Patterson; Patrick H.,4,0,28,24
1746607642573,MMW 122R,A01,886429,Rahimi; Babak,0,13,28,28
1746607642573,MMW 122R,A02,886430,Rahimi; Babak,0,12,28,28
1746607642573,MMW 122R,A03,958040,Rahimi; Babak,0,11,28,28
1746607643620,MUS 1A,A01,890937,Staff,2,0,25,23
1746607643620,MUS 1A,A02,891035,Staff,6,0,25,19
1746607643620,MUS 1A,C01,958912,Staff,24,0,25,1
1746607643620,MUS 1A,C02,958913,Staff,25,0,25,0
1746607645672,MUS 2AK,A00,957092,Ohnishi; Takae,15,0,15,0
1746607646698,MUS 4,A01,891044,Staff,0,0,25,25
1746607646698,MUS 4,A02,891045,Staff,22,0,25,3
1746607646698,MUS 4,B01,891048,Staff,17,0,25,8
1746607646698,MUS 4,B02,891050,Staff,25,0,25,0
1746607647724,MUS 5,A01,957506,Dubnov; Shlomo,0,0,25,25
1746607647724,MUS 5,A02,957622,Dubnov; Shlomo,12,0,25,13
1746607647724,MUS 5,A03,957623,Dubnov; Shlomo,20,0,25,5
1746607648750,MUS 6,A01,891053,Freitas Caetano; Marcelo,24,0,25,1
1746607648750,MUS 6,A02,891054,Freitas Caetano; Marcelo,23,0,25,2
1746607649779,MUS 7,A01,891081,Staff,0,0,25,25
1746607649779,MUS 7,A02,891082,Staff,3,0,25,22
1746607650807,MUS 8GS,A00,891118,Borgo; David Garcia,1,0,25,24
1746607651837,MUS 11,A01,891140,Staff,8,0,25,17
1746607651837,MUS 11,A02,891141,Staff,21,0,25,4
1746607652863,MUS 13,A01,891143,Staff,8,0,25,17
1746607652863,MUS 13,A02,891144,Staff,24,0,25,1
1746607653893,MUS 15,A01,891146,Staff,9,0,25,16
1746607653893,MUS 15,A02,891148,Staff,21,0,25,4
1746607653893,MUS 15,B01,891150,Staff,18,0,25,7
1746607653893,MUS 15,B02,891151,Staff,25,0,25,0
1746607654918,MUS 20,A01,891153,Staff,5,0,20,15
1746607654918,MUS 20,A02,891155,Staff,14,0,20,6
1746607655945,MUS 80,A00,891156,Staff,19,0,25,6
1746607655945,MUS 80,B00,891157,Staff,23,0,25,2
1746607656973,MUS 130,A00,891158,Ohnishi; Takae,35,0,35,0
1746607658000,MUS 150GS,A01,891160,Borgo; David Garcia,1,0,25,24
1746607659026,MUS 170,A01,891162,Freitas Caetano; Marcelo,20,0,25,5
1746607659026,MUS 170,A02,891164,Freitas Caetano; Marcelo,21,0,25,4
1746607660064,NANO 11,A00,886220,Vazquez Mena; Oscar,13,0,15,2
1746607661091,NANO 15,A01,886222,Drews; Aaron,4,0,7,3
1746607662122,NANO 104,A00,886224,Sirbuly; Donald,17,0,25,8
1746607663150,PH 40,A00,886528,Staff,23,0,40,17
1746607664181,PH 45,A01,886799,Staff,35,0,40,5
1746607665208,PH 110,A00,886802,Staff,0,6,40,40
1746607666234,PH 172,A00,906716,Staff,19,0,35,16
1746607667261,PH 191,A00,886803,Staff,6,0,40,34
1746607668292,PHIL 1,A00,889500,Staff,20,0,30,10
1746607669323,PHIL 10,A01,889549,Grush; Rick Scott,16,0,22,6
1746607669323,PHIL 10,A02,889551,Grush; Rick Scott,22,0,22,0
1746607670357,PHIL 28,A01,889559,Lamey; Andy M.,0,2,31,31
1746607670357,PHIL 28,A02,889561,Lamey; Andy M.,0,1,30,30
1746607670357,PHIL 28,A03,889572,Lamey; Andy M.,0,1,30,30
1746607671383,PHIL 35,A00,907839,Staff,13,0,15,2
1746607672418,PHIL 60,A00,889574,Staff,73,0,90,17
1746607673445,PHIL 101,A00,958004,Staff,12,0,15,3
1746607675500,PHIL 136,A00,889582,Fulkerson; Matthew Todd,26,0,45,19
1746607676526,PHIL 163,A01,889601,Staff,21,0,30,9
1746607676526,PHIL 163,B01,889606,Brandt; Reuven A,0,3,0,0
1746607677553,PHIL 164,A00,889610,Staff,16,0,30,14
1746607678581,PHIL 165,A00,889613,Staff,22,0,30,8
1746607679607,PHYS 1A,A00,886431,Staff,30,0,70,40
1746607680632,PHYS 1AL,001,886432,Tsai; Philbert S,0,1,30,30
1746607680632,PHYS 1AL,002,886436,Tsai; Philbert S,13,0,30,17
1746607681701,PHYS 1B,A00,886439,Staff,184,0,240,56
1746607682729,PHYS 1BL,001,886441,Tsai; Philbert S,0,4,30,30
1746607682729,PHYS 1BL,002,886444,Tsai; Philbert S,2,0,30,28
1746607683754,PHYS 1C,A00,896092,Arnold; Kam S,78,0,146,68
1746607684781,PHYS 1CL,001,886448,Tsai; Philbert S,0,0,30,30
1746607684781,PHYS 1CL,002,886449,Tsai; Philbert S,1,0,30,29
1746607684781,PHYS 1CL,003,886450,Tsai; Philbert S,16,0,30,14
1746607684781,PHYS 1CL,004,886451,Tsai; Philbert S,15,0,30,15
1746607685821,PHYS 2B,A01,886457,Staff,67,0,115,48
1746607686847,PHYS 2C,A01,886460,Shotwell; Brian,0,9,65,65
1746607687872,PHYS 2CL,A01,886467,Staff,0,4,28,28
1746607687872,PHYS 2CL,A02,886468,Staff,0,3,28,28
1746607688897,PHYS 2D,A01,886470,Staff,10,0,50,40
1746607689926,PHYS 4B,A01,886475,Grinstein; Benjamin,22,0,40,18
1746607690952,POLI 5,A00,891173,Desposato; Scott,7,0,25,18
1746607691977,POLI 5D,A01,891175,Staff,5,0,5,0
1746607691977,POLI 5D,B01,891178,Staff,5,0,5,0
1746607693002,POLI 11,A00,891179,Ferree; Karen E,0,0,35,35
1746607694030,POLI 12,A00,891180,Staff,15,0,30,15
1746607695056,POLI 27,A01,891182,Staff,11,0,75,64
1746607696085,POLI 30,A00,891183,Staff,8,0,50,42
1746607697115,POLI 100B,A00,891244,Staff,5,1,35,30
1746607698145,POLI 100I,A00,891247,Staff,7,0,30,23
1746607699174,POLI 104J,A00,891248,Nichter; Maysa,14,0,30,16
1746607700200,POLI 104U,A00,891250,Nichter; Maysa,1,0,30,29
1746607702256,POLI 110B,A00,891255,Wiens; David,19,0,25,6
1746607703282,POLI 112A,A00,891256,Wiens; David,6,0,25,19
1746607704308,POLI 114BR,A00,891261,Staff,19,0,30,11
1746607705334,POLI 117R,A00,891262,Forman; Fonna,0,6,50,50
1746607706361,POLI 118,A00,891264,Ingham; Sean,17,0,25,8
1746607707388,POLI 124A,A00,891265,Staff,18,0,20,2
1746607708413,POLI 125D,A00,891266,Nichter; Simeon C,2,0,25,23
1746607709437,POLI 126,A00,891268,Nichter; Simeon C,7,0,25,18
1746607710462,POLI 126AA,A00,891272,Staff,15,0,25,10
1746607711488,POLI 130AA,A00,891273,Staff,15,0,20,5
1746607712516,POLI 134AA,A00,891274,Staff,4,0,20,16
1746607714573,POLI 138,A00,891278,Staff,21,0,25,4
1746607715599,POLI 142K,A00,891280,Staff,10,0,25,15
1746607716631,POLI 142M,A00,891281,Gartzke; Erik,16,0,30,14
1746607717660,POLI 142P,A00,891284,Staff,20,0,30,10
1746607718690,POLI 143,A00,891285,Gartzke; Erik,12,0,30,18
1746607719716,POLI 153,A00,891286,Staff,19,0,20,1
1746607721769,POLI 175,A00,891290,Staff,15,0,20,5
1746607722796,PSYC 1,A00,890674,Steiner; Eric Tomas,0,11,45,45
1746607723824,PSYC 2,A00,890676,Albright; Thomas D,20,0,35,15
1746607724851,PSYC 3,A00,890679,Staff,17,0,20,3
1746607725877,PSYC 6,A00,959858,Staff,19,0,20,1
1746607726907,PSYC 60,A01,890684,Rickard; Timothy C.,0,6,45,45
1746607727935,PSYC 70,A01,890689,Geller; Emma Harlan,6,0,30,24
1746607728963,PSYC 71,A01,959860,Staff,21,0,25,4
1746607729989,PSYC 100,A00,890690,Lacefield; Katharine I,0,50,180,180
1746607731019,PSYC 102,A00,890695,Staff,18,0,40,22
1746607732045,PSYC 105,A00,890699,Geller; Emma Harlan,70,0,100,30
1746607733086,PSYC 106,A00,890701,Gorman; Michael R.,5,0,30,25
1746607734117,PSYC 108,A00,890704,Adrian; Julia Anna,0,29,50,50
1746607735142,PSYC 118,A01,890712,Staff,11,0,30,19
1746607736168,PSYC 124,A00,890716,Chapman; Eddie Nathaniel,25,0,60,35
1746607737195,PSYC 131,A00,890717,Anagnostaras; Stephan,0,7,80,80
1746607738222,PSYC 137,A00,890719,Winkielman; Piotr,0,11,30,30
1746607739252,PSYC 144,A00,890721,Adrian; Julia Anna,0,9,45,45
1746607740282,PSYC 162,A00,890805,Staff,0,2,75,75
1746607741308,PSYC 169,A00,890810,Staff,0,15,30,30
1746607742340,PSYC 172,A00,890814,Gorman; Michael R.,9,0,30,21
1746607743368,PSYC 181,A00,890818,Anagnostaras; Stephan,6,0,200,194
1746607744393,PSYC 184,A00,959861,Staff,160,0,175,15
1746607745421,PSYC 189,A00,890823,Staff,0,2,30,30
1746607746448,PSYC 191,A00,890884,Rickard; Timothy C.,0,12,35,35
1746607747475,PSYC 193,A00,890913,Staff,19,0,30,11
1746607747475,PSYC 193,B00,890914,Chapman; Eddie Nathaniel,24,0,30,6
1746607748505,PSYC 193L,A01,890918,Lowe; Angela Beth,20,0,30,10
1746607748505,PSYC 193L,B01,890921,Hurwitz; Ethan Scott,20,0,30,10
1746607748505,PSYC 193L,C01,890928,Staff,30,0,30,0
1746607749535,RELI 149,A00,886806,Rahimi; Babak,23,0,40,17
1746607750563,SE 9,A01,886814,Staff,7,0,20,13
1746607751594,SE 101B,A01,886816,Chadha; Mayank,3,0,35,32
1746607752620,SE 110B,A00,886818,Zhu; Qiang,4,0,75,71
1746607753647,SE 125,A01,886830,Staff,10,0,30,20
1746607754676,SE 130B,A01,886835,Staff,14,0,40,26
1746607755708,SE 131A,A01,886838,Krysl; Petr,34,0,55,21
1746607756736,SE 154,A00,886840,Staff,28,0,50,22
1746607757764,SE 164GS,A01,886849,Staff,6,0,20,14
1746607758791,SE 167GS,A01,886853,Staff,6,0,20,14
1746607759818,SIO 25,A01,890107,Staff,19,0,30,11
1746607760845,SIO 45,A00,890109,Cook; Geoffrey W,114,0,200,86
1746607761877,SIO 109R,A00,890110,Forman; Fonna,0,16,20,20
1746607762902,SIO 187,A01,890114,Kacev; David,15,0,40,25
1746607763939,SOCI 1,A01,890431,Thorpe; Charles Robert,14,0,30,16
1746607763939,SOCI 1,A02,890518,Thorpe; Charles Robert,30,0,30,0
1746607764965,SOCI 2,A01,957978,Staff,25,0,25,0
1746607764965,SOCI 2,A02,957979,Staff,23,0,25,2
1746607765994,SOCI 20,A01,890523,Calderon-Zaks; Michael Aar,21,0,30,9
1746607765994,SOCI 20,A02,890526,Calderon-Zaks; Michael Aar,29,0,30,1
1746607767023,SOCI 30,A01,890533,Pardo Guerra; Juan Pablo,37,0,40,3
1746607768050,SOCI 40,A01,890535,Staff,27,0,45,18
1746607769077,SOCI 104Q,A00,890559,Staff,17,0,30,13
1746607770105,SOCI 106,A00,890560,Arnal; Maud Marie Leonie,20,0,30,10
1746607771133,SOCI 110,A00,890567,Holkenbrink-Monk; Charlene,19,0,30,11
1746607772163,SOCI 112,A00,890568,Victoria Torres; Pablo,2,0,55,53
1746607773190,SOCI 115,A00,890597,Arnal; Maud Marie Leonie,28,0,45,17
1746607775247,SOCI 121,A00,890604,Pardo Guerra; Juan Pablo,38,0,45,7
1746607776274,SOCI 126,A01,890608,Staff,8,0,10,2
1746607777299,SOCI 127,A00,890609,Staff,18,0,30,12
1746607778329,SOCI 131,A00,890610,Thorpe; Charles Robert,37,0,45,8
1746607779353,SOCI 135,A00,890615,Payne; Christine Anna,14,0,45,31
1746607780378,SOCI 139,A00,890620,Staff,38,0,45,7
1746607781407,SOCI 148E,A00,890622,Calderon-Zaks; Michael Aar,36,0,45,9
1746607782434,SOCI 150,A00,890623,Kohler; Kristopher M.,31,0,45,14
1746607783461,SOCI 157,A00,890625,Jules-Rosette; Bennetta W.,18,0,20,2
1746607784486,SOCI 160,A00,890627,Payne; Christine Anna,21,0,45,24
1746607785554,SYN 1,A00,886855,Fish; Gwendolyn Anne,0,1,0,0
1746607785554,SYN 1,B00,906086,Fish; Gwendolyn Anne,0,2,0,2
1746607786585,SYN 2R,A00,886860,Staff,0,17,15,15
1746607786585,SYN 2R,B00,906106,Atkinson; Arthur Laird,0,16,15,15
1746607787616,SYN 100,A01,886866,Browne; Emily,0,28,20,20
1746607787616,SYN 100,B01,906128,Rock; Martin,0,4,20,20
1746607787616,SYN 100,C01,906140,Deavenport; James Cary,0,4,20,20
1746607787616,SYN 100,D01,907816,Deavenport; James Cary,0,5,20,20
1746607788646,TDAC 1,A00,890286,Walsh; Kim C.,7,0,20,13
1746607789673,TDAC 101,A00,890296,Basso; Beatrice,15,0,20,5
1746607790699,TDDE 131,A00,890297,Staff,47,0,50,3
1746607791729,TDDM 1,A00,890287,Weinberg; Sadie,25,0,30,5
1746607792760,TDGE 11,A00,890288,Fulton; Julia,138,0,200,62
1746607792760,TDGE 11,B00,890289,Castro; Robert Jess,184,0,200,16
1746607793788,TDGE 25,B00,957359,Walsh; Kim C.,5,0,20,15
1746607794816,TDGE 40,A01,890292,Power; Jade Yukana,26,0,30,4
1746607795842,TDGE 124,A00,890298,Havis; Allan,0,2,50,50
1746607796871,TDGE 131R,A00,890299,Burelle; Julie Sara Veronique,15,0,42,27
1746607797900,TDHT 101,A00,890300,Staff,10,0,20,10
1746607798933,TDHT 109,A01,890302,Anderson; Mysia Anyse,31,0,40,9
1746607799958,TDMV 1,A00,890293,Arcidiacono; Kristin,18,0,30,12
1746607800988,TDMV 2,A00,890294,Weinberg; Sadie,23,0,30,7
1746607802014,TDMV 3,A00,957878,Arcidiacono; Kristin,28,0,30,2
1746607804068,TDMV 138,A00,890304,Jun; Grace Shin Hae,25,0,40,15
1746607805094,TDMV 140,A00,890305,Corrales; Joseph Bernales,25,0,30,5
1746607806121,TDMV 142,A00,890307,Caligagan; Tony,32,0,40,8
1746607807151,TDMV 144,A00,890308,Camaya; Michelle Ann,25,0,30,5
1746607808181,TDPW 1,A00,890295,Stein; Deborah Isobel,3,0,20,17
1746607809212,USP 2,A01,890272,Lerner; Amy M,7,0,20,13
1746607810237,USP 3,A01,890274,Staff,12,0,30,18
1746607811262,USP 15,A01,890276,Sun; Feiyang,16,0,30,14
1746607812288,USP 25,A00,890277,Shenkman; Michael Thomas,18,0,25,7
1746607813317,USP 138,A00,890278,Staff,13,0,25,12
1746607814346,USP 143,A00,890279,Staff,21,0,70,49
1746607815377,USP 144,A00,890280,Chowdhury; Muhammed Zohir,16,0,30,14
1746607816408,USP 150,A00,890281,Boomhower; Matthew Charles,4,0,30,26
1746607817437,USP 151,A00,890282,Staff,16,0,20,4
1746607818466,USP 162,A00,890283,Andrews; Abigail Leslie,16,0,20,4
1746607819494,USP 168,A00,920477,Kwak; Nancy,0,0,5,5
1746607820518,USP 181,A00,890284,Staff,3,0,20,17
1746607821546,USP 191A,A00,890285,Staff,12,0,20,8
1746607822574,VIS 101,A00,886512,Staff,26,0,75,49
1746607823602,VIS 103,A00,886513,Cruz; Edwin Teddy,61,0,75,14
1746607824630,VIS 108,A00,886514,Staff,4,0,15,11
1746607825658,VIS 127P,A00,886515,Shen; Kuiyi,80,0,146,66
1746607826685,VIS 149,A00,886516,Yoldas; Pinar,0,0,15,15
1746607827710,VIS 164,A00,886526,Erdmann; Dean,19,0,22,3
1746607828739,VIS 194S,A00,886527,Staff,61,0,75,14
1746607829772,WCWP 10A,C00,886484,Martiniuk; Jill,12,0,15,3
1746607830806,WCWP 10B,A00,886490,Uriarte; Emma,0,0,15,15
1746607830806,WCWP 10B,B00,886491,Dhir; Simrita,8,0,15,7
1746607830806,WCWP 10B,C00,886492,Ornelas; Tricia,0,0,15,15
1746607831832,WCWP 100,A00,886494,Young; Mark T,0,6,15,15
1746607833945,AAS 10,A01,886199,Childs; Dennis R.,0,3,0,0
1746607834980,ANAR 104,A01,886940,Shtienberg; Gilad,27,0,30,3
1746607836009,ANAR 120,A00,886953,Staff,13,0,20,7
1746607837039,ANBI 148,A01,886955,Wilder; Linnea Lorene,30,0,40,10
1746607839092,ANSC 122,A00,886957,Staff,24,0,30,6
1746607840120,ANSC 150,A00,886958,Sloane; Julia Kathryn,2,0,15,13
1746607841147,ANSC 156,A00,886959,Jenkins; Janis A.,0,1,15,15
1746607842175,ANSC 180,A00,886960,Staff,11,0,17,6
1746607843205,ANSC 188,A00,886961,Jassal; Aftab,9,0,25,16
1746607844233,ANSC 190,A00,886962,Jassal; Aftab,14,0,25,11
1746607845258,ANSC 191,A00,886963,Staff,18,0,20,2
1746607846288,ANTH 3,A01,891689,Staff,17,0,20,3
1746607847317,ANTH 5,A00,886933,Semendeferi; Ekaterini,16,0,20,4
1746607848345,ANTH 10,A00,886934,Staff,0,12,30,30
1746607849372,ANTH 21,A01,886936,Staff,41,0,60,19
1746607850397,ANTH 23,A01,886938,Staff,92,0,100,8
1746607851425,ANTH 105,A00,886964,Stewart; Alexander B,84,0,100,16
1746607852453,ANTH 108,A00,886965,Pedersen; David,9,0,20,11
1746607853493,AWP 10,001,886147,Staff,0,0,0,0
1746607853493,AWP 10,002,886148,Staff,0,0,0,0
1746607853493,AWP 10,003,886149,Staff,0,0,0,0
1746607853493,AWP 10,004,886150,Staff,0,0,0,0
1746607853493,AWP 10,005,886151,Staff,0,0,0,0
1746607853493,AWP 10,006,886152,Staff,0,0,0,0
1746607853493,AWP 10,007,886153,Staff,0,0,0,0
1746607853493,AWP 10,008,886154,Staff,0,0,0,0
1746607853493,AWP 10,009,886155,Staff,0,0,0,0
1746607853493,AWP 10,010,886156,Staff,0,0,0,0
1746607853493,AWP 10,011,886158,Staff,0,0,0,0
1746607853493,AWP 10,012,886160,Staff,0,0,0,0
1746607853493,AWP 10,013,886161,Staff,0,0,0,0
1746607853493,AWP 10,014,886162,Staff,0,0,0,0
1746607853493,AWP 10,015,886163,Staff,0,0,0,0
1746607853493,AWP 10,016,886164,Staff,0,0,0,0
1746607853493,AWP 10,017,886165,Staff,0,0,0,0
1746607853493,AWP 10,018,886166,Staff,0,0,0,0
1746607853493,AWP 10,019,886168,Staff,0,0,0,0
1746607853493,AWP 10,020,886170,Staff,0,0,0,0
1746607853493,AWP 10,021,886172,Staff,0,0,0,0
1746607854523,AWP 10R,001,886173,Staff,0,1,0,0
1746607854523,AWP 10R,002,886174,Staff,0,1,0,0
1746607854523,AWP 10R,003,886175,Staff,0,0,0,0
1746607854523,AWP 10R,004,886176,Staff,0,0,0,0
1746607854523,AWP 10R,005,886177,Staff,0,0,0,0
1746607854523,AWP 10R,006,886178,Staff,0,0,0,0
1746607854523,AWP 10R,007,886179,Staff,0,0,0,0
1746607854523,AWP 10R,008,886181,Staff,0,0,0,0
1746607854523,AWP 10R,009,886182,Staff,0,0,0,0
1746607854523,AWP 10R,010,886183,Staff,0,0,0,0
1746607854523,AWP 10R,011,886184,Staff,0,0,0,0
1746607854523,AWP 10R,012,886185,Staff,0,0,0,0
1746607854523,AWP 10R,013,886186,Staff,0,0,0,0
1746607854523,AWP 10R,014,886187,Staff,0,0,0,0
1746607854523,AWP 10R,015,886188,Staff,0,0,0,0
1746607854523,AWP 10R,016,886189,Staff,0,0,0,0
1746607854523,AWP 10R,017,960532,Staff,0,0,0,0
1746607854523,AWP 10R,018,960533,Staff,0,0,0,0
1746607854523,AWP 10R,019,960534,Staff,0,0,0,0
1746607854523,AWP 10R,020,960538,Staff,0,0,0,0
1746607854523,AWP 10R,021,960540,Staff,0,0,0,0
1746607854523,AWP 10R,022,960541,Staff,0,0,0,0
1746607854523,AWP 10R,023,960542,Staff,0,0,0,0
1746607854523,AWP 10R,024,960544,Staff,0,0,0,0
1746607854523,AWP 10R,025,960545,Staff,0,0,0,0
1746607854523,AWP 10R,026,960548,Staff,0,0,0,0
1746607855551,AWP 102R,A00,886190,Staff,0,0,0,0
1746607855551,AWP 102R,B00,886191,Staff,0,0,0,0
1746607856582,BENG 100,A01,886193,Staff,17,0,30,13
1746607857610,BENG 122A,A01,886195,Hasty; Jeff M,13,0,30,17
1746607858637,BENG 166A,A00,886196,Sah; Robert Lie-Yuan,0,3,30,30
1746607859664,BENG 190,A00,958050,Khojah; Reem I,17,0,25,8
1746607860692,BIBC 102,A01,894320,Staff,0,1,46,46
1746607860692,BIBC 102,A02,894321,Staff,0,0,46,46
1746607860692,BIBC 102,A03,894344,Staff,6,0,46,40
1746607860692,BIBC 102,A04,894345,Staff,27,0,47,20
1746607861729,BICD 100R,A01,894365,Smith; Laurie,0,2,58,58
1746607861729,BICD 100R,A02,894366,Smith; Laurie,0,4,58,58
1746607861729,BICD 100R,A03,894367,Smith; Laurie,0,0,59,59
1746607861729,BICD 100R,A04,959869,Smith; Laurie,38,0,59,21
1746607862757,BICD 136,A01,894383,Gustafson-Brown; Cindy,14,0,50,36
1746607863991,BIEB 102,A01,894494,Butler; Shannon Rhey,51,0,130,79
1746607866058,BIEB 150,A01,894617,Wills; Christopher,3,0,20,17
1746607866058,BIEB 150,A02,894631,Wills; Christopher,3,0,20,17
1746607866058,BIEB 150,A03,894937,Wills; Christopher,3,0,20,17
1746607866058,BIEB 150,A04,894946,Wills; Christopher,5,0,20,15
1746607867088,BIEB 194,A00,906141,Kurle; Carolyn M.,5,0,20,15
1746607868122,BILD 1,A01,894154,Staff,3,0,19,16
1746607868122,BILD 1,A02,894155,Staff,14,0,19,5
1746607868122,BILD 1,A03,894160,Staff,13,0,19,6
1746607868122,BILD 1,A04,894161,Staff,15,0,18,3
1746607869149,BILD 2,A01,894168,Staff,0,0,50,50
1746607869149,BILD 2,A02,894169,Staff,0,0,50,50
1746607869149,BILD 2,A03,894179,Staff,0,0,50,50
1746607869149,BILD 2,A04,894203,Staff,22,0,50,28
1746607870175,BILD 3,A01,894213,Staff,23,0,31,8
1746607870175,BILD 3,A02,894214,Staff,26,0,31,5
1746607870175,BILD 3,A03,894235,Staff,28,0,31,3
1746607870175,BILD 3,A04,894236,Staff,28,0,32,4
1746607871204,BILD 4,A01,894253,Reuther; Keefe,5,0,24,19
1746607871204,BILD 4,A02,894258,Reuther; Keefe,16,0,24,8
1746607872235,BILD 5,A01,894276,Reuther; Keefe,33,0,50,17
1746607872235,BILD 5,A02,894277,Reuther; Keefe,45,0,50,5
1746607872235,BILD 5,A03,894290,Reuther; Keefe,44,0,50,6
1746607872235,BILD 5,A04,894291,Reuther; Keefe,48,0,50,2
1746607873263,BILD 24,A01,894297,Pirino; Giorgia,40,0,60,20
1746607874287,BIMM 100,B01,958915,Staff,71,0,100,29
1746607875315,BIMM 101,A01,895017,McDonnell; Lisa Marie,0,5,24,24
1746607875315,BIMM 101,A02,895018,McDonnell; Lisa Marie,0,5,24,24
1746607875315,BIMM 101,B01,895020,McDonnell; Lisa Marie,0,5,24,24
1746607875315,BIMM 101,B02,895021,McDonnell; Lisa Marie,0,4,24,24
1746607876341,BIMM 110,A01,895023,Staff,1,0,25,24
1746607876341,BIMM 110,A02,895024,Staff,9,0,25,16
1746607876341,BIMM 110,A03,895025,Staff,18,0,25,7
1746607876341,BIMM 110,A04,895031,Staff,20,0,25,5
1746607877368,BIMM 120,A01,895114,Gustafson-Brown; Cindy,14,0,28,14
1746607877368,BIMM 120,A02,895126,Gustafson-Brown; Cindy,21,0,27,6
1746607878402,BIPN 100,A01,895130,Yang; Mingyu,0,0,38,38
1746607878402,BIPN 100,A02,895131,Yang; Mingyu,31,0,38,7
1746607878402,BIPN 100,A03,895132,Yang; Mingyu,32,0,38,6
1746607878402,BIPN 100,A04,895133,Yang; Mingyu,27,0,36,9
1746607879428,BIPN 120,A01,895135,Cooke; James Edward,0,3,13,13
1746607879428,BIPN 120,A02,895136,Cooke; James Edward,0,1,13,13
1746607879428,BIPN 120,A03,895137,Cooke; James Edward,0,3,13,13
1746607879428,BIPN 120,A04,895156,Cooke; James Edward,0,2,11,11
1746607880456,BIPN 134,A01,895235,Cooke; James Edward,0,1,25,25
1746607880456,BIPN 134,A02,895237,Cooke; James Edward,0,0,25,25
1746607880456,BIPN 134,A03,895240,Cooke; James Edward,1,0,25,24
1746607880456,BIPN 134,A04,895270,Cooke; James Edward,20,0,25,5
1746607881482,BIPN 189,A00,892103,Staff,0,14,14,14
1746607883536,BISP 194,A00,958008,Staff,0,2,0,0
1746607884564,CAT 124,A01,922009,Staff,0,5,20,20
1746607885594,CAT 125R,A00,886390,Morales; Celeste Georgianna,0,4,20,20
1746607885594,CAT 125R,B00,886391,Irwin; Matthew Joseph,0,4,20,20
1746607885594,CAT 125R,C00,886392,Smith; Lauryn Alissa,0,2,20,20
1746607885594,CAT 125R,D00,886393,Vanderschuit; Maya Alysia,0,3,20,20
1746607885594,CAT 125R,E00,886394,Marchisotto; Jennifer Anne,0,3,20,20
1746607886627,CENG 15,A01,886218,Drews; Aaron,3,0,8,5
1746607887659,CENG 113,A00,886219,Opatkiewicz; Justin Paul,15,0,25,10
1746607888685,CGS 101,A00,887044,Staff,7,0,20,13
1746607889716,CGS 105,A01,887046,Staff,14,0,25,11
1746607890743,CGS 112,A00,887047,Cuong; Marisol,12,0,15,3
1746607891775,CGS 113,A00,887048,Staff,23,0,30,7
1746607892801,CGS 120,A00,887049,Staff,9,0,17,8
1746607893828,CHEM 6A,A01,886336,Lam; Tin Yiu,38,0,50,12
1746607893828,CHEM 6A,A02,886338,Lam; Tin Yiu,37,0,50,13
1746607894861,CHEM 6B,A01,886341,Hopkins; Patrycja Anna,16,0,50,34
1746607894861,CHEM 6B,A02,886343,Hopkins; Patrycja Anna,42,0,50,8
1746607895889,CHEM 6C,A01,886346,Albizati; Kim F.,0,2,50,50
1746607895889,CHEM 6C,A02,886348,Albizati; Kim F.,24,0,50,26
1746607897129,CHEM 40A,A01,886352,Klosterman; Jeremy K,65,0,100,35
1746607898156,CHEM 40B,A01,886356,Klosterman; Jeremy K,0,24,100,100
1746607899185,CHEM 41B,A01,886360,Theodorakis; Emmanuel,25,0,50,25
1746607899185,CHEM 41B,A02,886362,Theodorakis; Emmanuel,47,0,50,3
1746607900214,CHIN 165A,A00,886382,Xu; Li,18,0,20,2
1746607901241,CLAS 120,A00,886387,Myerston Santana; Jacobo,33,0,40,7
1746607902273,COGS 9,A01,886967,Shannon; Kyle Michael,42,0,60,18
1746607903304,COGS 11,A01,886969,Staff,9,0,30,21
1746607904335,COGS 14A,A01,886971,Staff,5,0,60,55
1746607905362,COGS 14B,A01,886973,Hoffman; Drew Ellen,4,0,60,56
1746607906394,COGS 18,A01,886975,Morgan; Eric,34,0,60,26
1746607907421,COGS 20,A01,886977,Staff,3,0,8,5
1746607907421,COGS 20,A02,886978,Staff,5,0,7,2
1746607908450,COGS 100,A01,907783,Staff,0,1,30,30
1746607909476,COGS 101B,A01,886980,Staff,0,4,48,48
1746607910512,COGS 101C,A01,886982,Delgado; Tania,0,5,44,44
1746607911540,COGS 102A,A01,886984,Johnson; Christine M.,3,0,30,27
1746607912570,COGS 118B,A01,886986,Staff,0,4,88,88
1746607913602,COGS 150,A01,886988,Bergen; Benjamin,22,0,50,28
1746607914628,COGS 153,A00,886989,Delgado; Tania,1,3,41,40
1746607915654,COGS 186,A01,886991,Staff,0,0,32,32
1746607916680,COGS 187A,A01,886993,Boyle; Mary E. T.,7,0,30,23
1746607917711,COGS 189,A00,886994,Staff,0,1,30,30
1746607918740,COMM 10,A01,886996,Staff,0,0,20,21
1746607918740,COMM 10,A02,886997,Staff,10,0,20,10
1746607918740,COMM 10,A03,959845,Staff,19,0,20,1
1746607919768,COMM 20,A01,886999,Leuning; Grant Maurstad,24,0,40,16
1746607921824,COMM 100A,A01,887002,Staff,0,0,20,25
1746607921824,COMM 100A,A02,887003,Staff,5,0,20,15
1746607922851,COMM 100B,A01,887005,Staff,0,8,20,24
1746607923880,COMM 106D,A00,887006,Staff,14,0,40,26
1746607924906,COMM 110G,A00,887007,Whitworth-Smith; Andrew C,12,0,40,28
1746607925933,COMM 111B,A00,887008,Staff,31,0,40,9
1746607926960,COMM 113T,A00,887009,Abuelhiga; Soraya Jill,28,0,40,12
1746607926960,COMM 113T,B00,906733,Staff,39,0,40,1
1746607927988,COMM 145,A00,887010,Staff,13,0,40,27
1746607929015,COMM 146,A00,887054,Staff,32,0,40,8
1746607930041,COMM 190,A00,887012,Staff,8,0,23,15
1746607931067,CSE 8A,A50,887015,Cao; Yingjun,56,0,85,29
1746607932099,CSE 11,A01,887017,Cao; Yingjun,11,0,70,59
1746607933125,CSE 20,A01,887019,Staff,30,0,50,20
1746607934157,CSE 21,A01,887021,Staff,79,0,100,21
1746607934157,CSE 21,B01,892583,Braun; Oliver,45,0,50,5
1746607935186,CSE 30,A01,887025,Eldon; John,142,0,200,58
1746607936214,CSE 100,A01,887027,Staff,26,0,50,24
1746607936214,CSE 100,A02,887028,Staff,42,0,50,8
1746607937241,CSE 101,A01,887030,Braun; Oliver,74,0,100,26
1746607937241,CSE 101,B01,887032,Jones; Miles E,0,3,50,50
1746607937241,CSE 101,B02,887033,Jones; Miles E,0,2,50,50
1746607938270,CSE 105,A01,908084,Jones; Miles E,32,0,50,18
1746607938270,CSE 105,A02,908087,Jones; Miles E,31,0,50,19
1746607939300,CSE 135,A01,887035,Powell; Thomas Allan,0,5,50,50
1746607940332,CSE 142,A01,887037,Staff,7,0,60,53
1746607941359,CSE 142L,A01,887039,Staff,34,0,60,26
1746607942387,CSE 151A,A01,887041,Solares; Edwin A,47,0,100,53
1746607943414,CSE 175,A01,887043,Kumar; Rakesh,30,0,30,0
1746607944446,CSS 1,A01,886389,Staff,0,1,40,40
1746607945471,DSC 30,A01,908097,Liao; Soohyun Nam,47,0,75,28
1746607946499,DSC 40A,A01,908099,Shannon; Kyle Michael,30,0,50,20
1746607947527,DSC 40B,A01,908112,Staff,15,0,50,35
1746607948559,DSC 80,A01,908116,Staff,19,0,60,41
1746607949589,DSC 197,001,956863,Eldridge; Justin Matthew,9999,0,9999,0
1746607950616,ECE 5,A01,886400,Morris; Karcher William,1,0,6,5
1746607950616,ECE 5,A02,886401,Morris; Karcher William,3,0,6,3
1746607951647,ECE 148,A01,886403,Silberman; Jack,0,14,14,14
1746607952674,ECON 1,A01,887265,Crane; Meredith Helen,11,0,70,59
1746607952674,ECON 1,B01,887268,Staff,42,0,50,8
1746607953700,ECON 2,A01,887273,Crane; Meredith Helen,54,0,70,16
1746607954727,ECON 3,A01,887279,Rondina; Giacomo,31,0,70,39
1746607955756,ECON 4,A01,887282,Anderson; John Charles,0,2,10,10
1746607956783,ECON 5,A01,887285,Staff,34,0,45,11
1746607956783,ECON 5,B01,887292,Staff,41,0,45,4
1746607957815,ECON 100A,A01,887337,Newhouse; Herbert S,54,0,70,16
1746607957815,ECON 100A,B01,887349,Staff,45,0,50,5
1746607958841,ECON 100B,A01,887361,Du; Songzi,29,0,70,41
1746607959909,ECON 100C,A01,887445,Newhouse; Herbert S,59,0,70,11
1746607960940,ECON 105,A00,887488,Vespa; Emanuel Ignacio,23,0,35,12
1746607961973,ECON 109,A01,887506,Shishkin; Denis,28,0,35,7
1746607963001,ECON 110A,A01,887568,Alon; Titan Michael,0,2,35,35
1746607963001,ECON 110A,B01,907601,Alon; Titan Michael,20,0,35,15
1746607964030,ECON 110B,A01,887598,Levkoff; Steven B.,0,24,70,70
1746607965081,ECON 112,A00,887599,Rondina; Giacomo,19,0,35,16
1746607966112,ECON 120A,A01,887603,Dai; Yinlin,36,0,70,34
1746607967138,ECON 120C,A01,887608,Sun; Yixiao,0,1,35,35
1746607967138,ECON 120C,B01,887614,Sun; Yixiao,0,0,35,35
1746607968167,ECON 138,A00,887621,Bharadwaj; Prashant,0,21,20,20
1746607969194,ECON 144,A00,958007,Squires; Dale E,11,0,35,24
1746607970224,ECON 171,A01,907666,Staff,18,0,35,17
1746607971254,ECON 175,A00,887626,Wu; Pak Yeung,22,0,35,13
1746607972281,ECON 190,A00,887640,Vespa; Emanuel Ignacio,22,0,35,13
1746607973310,EDS 25,A01,888197,Staff,0,0,0,0
1746607973310,EDS 25,A02,888209,Staff,0,0,0,0
1746607973310,EDS 25,A03,888210,Staff,0,0,0,0
1746607973310,EDS 25,A04,888212,Staff,0,0,0,0
1746607973310,EDS 25,A05,888213,Staff,0,0,0,0
1746607973310,EDS 25,A06,888214,Staff,0,0,0,0
1746607973310,EDS 25,A07,888235,Staff,0,2,0,0
1746607973310,EDS 25,A08,888236,Staff,0,0,0,0
1746607973310,EDS 25,A09,888240,Staff,0,0,0,0
1746607973310,EDS 25,A10,888244,Staff,0,0,0,0
1746607973310,EDS 25,B01,888273,Staff,0,0,0,0
1746607973310,EDS 25,B02,888285,Staff,0,0,0,0
1746607973310,EDS 25,B03,888423,Staff,0,0,0,1
1746607973310,EDS 25,B04,888432,Staff,0,0,0,0
1746607973310,EDS 25,B05,888433,Staff,0,0,0,0
1746607973310,EDS 25,B06,888467,Staff,0,0,0,0
1746607973310,EDS 25,B07,888468,Staff,0,0,0,0
1746607973310,EDS 25,B08,888479,Staff,0,0,0,0
1746607973310,EDS 25,B09,888484,Staff,0,0,0,0
1746607973310,EDS 25,B10,888487,Staff,0,0,0,0
1746607974338,EDS 38,A01,907700,Choi; Bailey Miyeon,30,0,30,0
1746607975367,EDS 112,A01,888601,Chapman; Thandeka K,12,0,40,28
1746607976397,EDS 115,A00,888697,Mendez; Kathrina Mendoza,10,0,30,20
1746607977423,EDS 116,A01,888893,Staff,33,0,40,7
1746607979477,EDS 124AR,A00,889133,Staff,29,0,50,21
1746607979477,EDS 124AR,B00,907471,Simon; Elizabeth A,37,0,50,13
1746607980503,EDS 124BR,A00,889134,Simon; Elizabeth A,44,0,100,56
1746607981531,EDS 125,A00,889135,Staff,25,0,30,5
1746607982573,EDS 126,A01,889138,Staff,35,0,40,5
1746607983600,EDS 164R,A01,889142,Wishard Guerra; Alison G.,32,0,50,18
1746607984625,ENG 30,A01,886396,Staff,0,0,0,0
1746607984625,ENG 30,B01,886398,Staff,0,0,0,0
1746607985655,ENVR 102,A00,906150,Montejo; Carolina,23,0,25,2
1746607986685,ETHN 103A,A00,887236,Man; Simeon S,0,2,0,0
1746607987710,ETHN 113,A00,887239,Staff,16,0,30,14
1746607988737,ETHN 116,A00,887240,Staff,16,0,25,9
1746607989764,ETHN 117,A00,887241,Choi; Esther Min,28,0,30,2
1746607990791,ETHN 118,A00,887243,Staff,24,0,30,6
1746607991817,ETHN 127,A00,887248,Cuong; Marisol,11,0,15,4
1746607992845,ETHN 139,A00,887250,Staff,7,0,10,3
1746607993869,ETHN 142,A00,887252,Staff,9,0,30,21
1746607994895,ETHN 161,A00,887253,Browne; Errol Tsekani,24,0,30,6
1746607995924,ETHN 163FR,A00,887255,Burelle; Julie Sara Veronique,0,0,5,5
1746607996951,GLBH 20,A00,889149,Elwardani; Nile Regina,8,0,42,34
1746607999004,GLBH 111,A01,889152,Burgos; Jose L.,17,0,17,0
1746608000031,GLBH 150,A00,889181,Sloane; Julia Kathryn,0,5,15,15
1746608002087,HDS 60,A01,886406,Warstadt; Melissa Fawn,72,0,80,8
1746608003113,HIAF 111,A00,889324,Gyamfi; Bright,25,0,32,7
1746608004141,HIEA 131,A00,889328,Staff,15,0,32,17
1746608005170,HIEA 144,A00,889333,Henry; Todd A.,26,0,32,6
1746608006195,HIEA 154,A00,889336,Henry; Todd A.,24,0,32,8
1746608007220,HIEU 106,A00,889339,Staff,22,0,32,10
1746608009273,HIEU 114,A00,889340,Staff,4,0,32,28
1746608010301,HIEU 135GS,A00,889342,Patterson; Patrick H.,0,0,1,24
1746608011326,HIEU 137,A00,889343,Edington; Claire Ellen,10,0,25,15
1746608012357,HIEU 148,A00,889345,Staff,14,0,32,18
1746608013385,HIEU 154,A00,889346,Biess; Frank Peter,21,0,32,11
1746608014413,HILA 102,A00,889351,Staff,12,0,32,20
1746608015439,HILD 2A,A01,889221,Lewandoski; Julia Mavis,0,8,32,32
1746608016466,HILD 7B,A01,889225,Man; Simeon S,0,12,32,32
1746608017493,HILD 7C,A01,889288,Alvarez; Luis A,0,14,32,32
1746608018518,HILD 30,A01,889323,Staff,0,5,32,32
1746608020573,HISC 119,A00,889383,Golan; Tal,20,0,32,12
1746608021600,HIUS 103,A00,889384,Man; Simeon S,0,0,32,32
1746608022634,HIUS 117,A00,919797,Kwak; Nancy,18,0,32,14
1746608023663,HIUS 142A,A00,919788,Staff,22,0,32,10
1746608025720,HIUS 149,A00,889386,Gyamfi; Bright,26,0,32,6
1746608026749,HIUS 155,A00,889387,Alvarez; Luis A,15,0,32,17
1746608027777,HUM 3,A01,886499,Caldwell; Michael Alan,19,0,50,31
1746608028804,HUM 3GS,A00,886500,Rodriguez; Bretton Sigfred,0,0,0,28
1746608029832,HUM 3R,A01,886502,Markman; Kristina,0,36,50,50
1746608030862,HUM 4,A01,886504,Crum; Matthew Stephen,23,0,50,27
1746608030862,HUM 4,B01,886506,West; Geoffrey Scott,17,0,50,33
1746608031891,HUM 4GS,A00,886507,Staff,0,0,0,19
1746608032920,HUM 5,A01,886509,Staff,31,0,50,19
1746608033950,HUM 5R,A01,886511,Zavodny; Tatiana Sophia,0,39,50,50
1746608034980,JAPN 180,A00,886407,Staff,16,0,40,24
1746608036009,LATI 50,A01,886409,Martin-Cabrera; Luis,3,0,22,19
1746608036009,LATI 50,A02,886410,Martin-Cabrera; Luis,19,0,22,3
1746608036009,LATI 50,A03,886411,Martin-Cabrera; Luis,21,0,22,1
1746608036009,LATI 50,A04,886412,Martin-Cabrera; Luis,8,0,22,14
1746608037040,LAWS 101,A00,907664,Staff,28,0,60,32
1746608038069,LIAB 1A,A00,889388,Saab; Dima,17,0,20,3
1746608039095,LIAB 1AX,A00,889389,El Cheddadi; Youniss,18,0,20,2
1746608040125,LIFR 1C,A00,889391,Van Moer; Vinciane G,8,0,20,12
1746608041154,LIFR 1CX,A00,889392,Van Moer; Vinciane G,7,0,20,13
1746608042186,LIFR 1D,A00,889393,Van Moer; Vinciane G,7,0,20,13
1746608043217,LIFR 1DX,A00,889394,Van Moer; Vinciane G,8,0,20,12
1746608044241,LIGN 7,A00,886923,Staff,25,0,50,25
1746608045265,LIGN 17,A00,886924,Kehler; Andrew Scott,126,0,150,24
1746608046293,LTAM 110,A00,889395,Staff,15,0,30,15
1746608047320,LTAM 110GS,A00,958010,Rodriguez; Bretton Sigfred,0,0,0,28
1746608048345,LTCH 101,A00,889397,Staff,23,0,25,2
1746608049369,LTCS 130,A00,889398,Staff,23,0,25,2
1746608050394,LTEA 138,A00,889399,Staff,24,0,40,16
1746608051421,LTEN 149,A00,889400,Wesling; Megan E.,0,3,25,25
1746608052449,LTEN 169,A00,889401,Staff,20,0,25,5
1746608053474,LTEN 180,A00,889402,Staff,10,0,15,5
1746608054503,LTEN 181,A00,889403,Staff,21,0,25,4
1746608055532,LTWL 100,A00,889404,Myerston Santana; Jacobo,2,0,25,23
1746608056562,LTWL 180GS,A00,889405,Staff,0,0,20,20
1746608057591,LTWL 181,A00,889406,Staff,16,0,25,9
1746608058621,LTWL 184,A00,889475,Mukherjee; Silpa,22,0,25,3
1746608059647,LTWR 102C,A00,889486,Staff,29,0,30,1
1746608060673,LTWR 115W,A00,889491,Staff,0,2,15,15
1746608061702,MAE 8,A01,886905,Staff,0,2,0,0
1746608062767,MAE 11,A00,886906,Bandaru; Prabhakar,0,7,50,50
1746608063794,MAE 20,A00,886907,Evdokimenko; Ekaterina,43,0,70,27
1746608064822,MAE 30B,A00,886909,Ghazinejad; Maziar,25,0,45,20
1746608065847,MAE 101B,A00,886910,Saintillan; David,30,0,45,15
1746608066872,MAE 105,A00,886911,Bandaru; Prabhakar,18,0,50,32
1746608067897,MAE 107,B00,958024,Staff,7,0,50,43
1746608068922,MAE 143B,A00,886913,Bewley; Thomas R,2,0,40,38
1746608069950,MAE 148,A01,886915,Silberman; Jack,0,3,14,14
1746608070981,MAE 160,A00,886916,Evdokimenko; Ekaterina,30,0,60,30
1746608072011,MATH 3C,A01,889681,Staff,0,2,30,30
1746608072011,MATH 3C,A02,960048,Staff,23,0,30,7
1746608073041,MATH 10A,A01,889760,Staff,26,0,30,4
1746608073041,MATH 10A,A02,889783,Staff,29,0,30,1
1746608074068,MATH 10B,A01,889785,Verstraete; Jacques Allan,1,0,35,34
1746608074068,MATH 10B,A02,889795,Verstraete; Jacques Allan,4,0,35,31
1746608074068,MATH 10B,B01,889797,Verstraete; Jacques Allan,3,0,35,32
1746608074068,MATH 10B,B02,889828,Verstraete; Jacques Allan,3,0,35,32
1746608075098,MATH 10C,A01,889849,Habib; Yousaf,8,0,30,22
1746608075098,MATH 10C,A02,889852,Habib; Yousaf,14,0,30,16
1746608075098,MATH 10C,A03,889853,Habib; Yousaf,22,0,30,8
1746608075098,MATH 10C,A04,889858,Habib; Yousaf,20,0,30,10
1746608075098,MATH 10C,B01,889861,Staff,1,0,30,29
1746608075098,MATH 10C,B02,889862,Staff,24,0,30,6
1746608075098,MATH 10C,B03,889863,Staff,27,0,30,3
1746608075098,MATH 10C,B04,889967,Staff,23,0,30,7
1746608076125,MATH 18,A01,889974,Staff,6,0,30,24
1746608076125,MATH 18,A02,889977,Staff,20,0,30,10
1746608076125,MATH 18,B01,889984,Hardiman; Liam,20,0,30,10
1746608076125,MATH 18,B02,889985,Hardiman; Liam,25,0,30,5
1746608077151,MATH 20A,A01,889990,Suk; Andrew Hoon,30,0,35,5
1746608078185,MATH 20B,A01,889993,Ohm; Ko Woon,21,0,30,9
1746608078185,MATH 20B,A02,889994,Ohm; Ko Woon,30,0,30,0
1746608078185,MATH 20B,B01,889996,Ohm; Ko Woon,22,0,30,8
1746608078185,MATH 20B,B02,889997,Ohm; Ko Woon,23,0,30,7
1746608079214,MATH 20C,A01,889999,Hammock; Frances H,17,0,30,13
1746608079214,MATH 20C,A02,890003,Hammock; Frances H,23,0,30,7
1746608079214,MATH 20C,B01,890006,Hammock; Frances H,2,0,30,28
1746608079214,MATH 20C,B02,890007,Hammock; Frances H,11,0,30,19
1746608080246,MATH 20D,A01,890011,Cheng; Hsiao-Bing,1,0,30,29
1746608080246,MATH 20D,A02,890012,Cheng; Hsiao-Bing,14,0,30,16
1746608080246,MATH 20D,B01,890016,Cheng; Hsiao-Bing,13,0,30,17
1746608080246,MATH 20D,B02,890017,Cheng; Hsiao-Bing,13,0,30,17
1746608081272,MATH 20E,A01,890026,Harel; Guershon,1,0,30,29
1746608081272,MATH 20E,A02,890029,Harel; Guershon,22,0,30,8
1746608081272,MATH 20E,B01,890033,Harel; Guershon,7,0,30,23
1746608081272,MATH 20E,B02,890101,Harel; Guershon,21,0,30,9
1746608082296,MATH 102,A01,890104,Staff,18,0,30,12
1746608082296,MATH 102,A02,890105,Staff,27,0,30,3
1746608083321,MATH 103B,A01,890116,Salehi Golsefidy; Alireza,3,0,30,27
1746608083321,MATH 103B,B01,890118,Staff,0,3,34,34
1746608084354,MATH 109,A01,890121,Aliabadi Sr.; Mohsen,0,0,30,30
1746608084354,MATH 109,B01,890124,Upadrashta; Pranav Kumar,18,0,30,12
1746608085380,MATH 120A,A01,890126,Eggers; John Dietrich,13,0,30,17
1746608086411,MATH 142B,A01,890128,Ioana; Adrian,19,0,30,11
1746608086411,MATH 142B,A02,890129,Ioana; Adrian,12,0,30,18
1746608087438,MATH 154,A01,890174,Staff,0,1,30,30
1746608087438,MATH 154,A02,890182,Staff,0,0,30,30
1746608088469,MATH 168A,A01,890197,Dumitriu; Ioana,21,0,35,14
1746608089496,MATH 170A,A01,890240,Nie; Jiawang,1,0,30,29
1746608089496,MATH 170A,A02,890241,Nie; Jiawang,11,0,30,19
1746608089496,MATH 170A,A03,890249,Nie; Jiawang,23,0,30,7
1746608090524,MATH 170B,A01,957891,Nag; Panchali,13,0,35,22
1746608092578,MATH 181A,A01,908025,Staff,0,3,35,35
1746608092578,MATH 181A,A02,960115,Staff,26,0,35,9
1746608093606,MATH 181B,A01,959874,Staff,24,0,30,6
1746608094633,MATH 193B,A01,890265,Staff,0,4,35,35
1746608095668,MGT 4,A01,890311,Anderson; John Charles,42,0,88,46
1746608096697,MGT 5,A00,907740,Staff,12,0,98,86
1746608097727,MGT 12,A00,890312,Lindenberger; Wade Douglas,67,0,98,31
1746608098755,MGT 16,A00,957883,Staff,78,0,98,20
1746608100809,MGT 45,A00,890314,Pecore; Joseph P.,45,0,98,53
1746608101838,MGT 71,A00,890315,Staff,0,12,98,98
1746608102865,MGT 100,A00,890316,Yavorsky; Daniel Ryan,44,0,98,54
1746608103894,MGT 103,A00,890317,Ehrich; Kristine R,73,0,98,25
1746608104922,MGT 105,A00,890356,Bates; Kenneth Walter,0,8,98,98
1746608105948,MGT 112,A00,890360,Ehrich; Kristine R,55,0,98,43
1746608106976,MGT 127R,A00,907732,Zhu; Kevin Xiaoguo,23,0,98,75
1746608108004,MGT 131B,A00,890361,Anderson; John Charles,59,0,98,39
1746608109034,MGT 137,A00,890362,Lindenberger; Wade Douglas,65,0,98,33
1746608110073,MGT 160,A00,890369,Johnson; Erik Barry,9,0,98,89
1746608112140,MGT 164,A00,890372,Zimmermann; Carsten,0,40,98,98
1746608113166,MGT 180,A00,890374,Bliss; Barbara Ann,11,0,98,87
1746608114192,MMW 15,A01,886414,Chang; Edmond Yi-Teh,0,12,28,28
1746608114192,MMW 15,A02,886415,Chang; Edmond Yi-Teh,0,8,28,28
1746608114192,MMW 15,A03,886416,Chang; Edmond Yi-Teh,0,9,28,28
1746608114192,MMW 15,A04,886417,Chang; Edmond Yi-Teh,0,8,28,28
1746608114192,MMW 15,B01,886419,Chang; Edmond Yi-Teh,0,7,28,28
1746608114192,MMW 15,B02,886420,Chang; Edmond Yi-Teh,0,7,28,28
1746608114192,MMW 15,B03,886421,Chang; Edmond Yi-Teh,0,7,28,28
1746608114192,MMW 15,B04,886422,Chang; Edmond Yi-Teh,0,8,28,28
1746608114192,MMW 15,C01,886424,Staff,0,9,28,28
1746608114192,MMW 15,C02,886425,Staff,0,8,28,28
1746608114192,MMW 15,C03,886426,Staff,0,8,28,28
1746608114192,MMW 15,C04,886427,Staff,0,8,28,28
1746608114192,MMW 15,C05,958038,Staff,0,8,28,28
1746608114192,MMW 15,C06,958039,Staff,0,7,28,28
1746608115222,MMW 15GS,A00,906910,Patterson; Patrick H.,4,0,28,24
1746608116249,MMW 122R,A01,886429,Rahimi; Babak,0,13,28,28
1746608116249,MMW 122R,A02,886430,Rahimi; Babak,0,12,28,28
1746608116249,MMW 122R,A03,958040,Rahimi; Babak,0,11,28,28
1746608117277,MUS 1A,A01,890937,Staff,2,0,25,23
1746608117277,MUS 1A,A02,891035,Staff,6,0,25,19
1746608117277,MUS 1A,C01,958912,Staff,24,0,25,1
1746608117277,MUS 1A,C02,958913,Staff,25,0,25,0
1746608119333,MUS 2AK,A00,957092,Ohnishi; Takae,15,0,15,0
1746608120364,MUS 4,A01,891044,Staff,0,0,25,25
1746608120364,MUS 4,A02,891045,Staff,22,0,25,3
1746608120364,MUS 4,B01,891048,Staff,17,0,25,8
1746608120364,MUS 4,B02,891050,Staff,25,0,25,0
1746608121399,MUS 5,A01,957506,Dubnov; Shlomo,0,0,25,25
1746608121399,MUS 5,A02,957622,Dubnov; Shlomo,12,0,25,13
1746608121399,MUS 5,A03,957623,Dubnov; Shlomo,20,0,25,5
1746608122432,MUS 6,A01,891053,Freitas Caetano; Marcelo,24,0,25,1
1746608122432,MUS 6,A02,891054,Freitas Caetano; Marcelo,23,0,25,2
1746608123458,MUS 7,A01,891081,Staff,0,0,25,25
1746608123458,MUS 7,A02,891082,Staff,3,0,25,22
1746608124491,MUS 8GS,A00,891118,Borgo; David Garcia,1,0,25,24
1746608125516,MUS 11,A01,891140,Staff,8,0,25,17
1746608125516,MUS 11,A02,891141,Staff,21,0,25,4
1746608126544,MUS 13,A01,891143,Staff,8,0,25,17
1746608126544,MUS 13,A02,891144,Staff,24,0,25,1
1746608127573,MUS 15,A01,891146,Staff,9,0,25,16
1746608127573,MUS 15,A02,891148,Staff,21,0,25,4
1746608127573,MUS 15,B01,891150,Staff,18,0,25,7
1746608127573,MUS 15,B02,891151,Staff,25,0,25,0
1746608128599,MUS 20,A01,891153,Staff,5,0,20,15
1746608128599,MUS 20,A02,891155,Staff,14,0,20,6
1746608129626,MUS 80,A00,891156,Staff,19,0,25,6
1746608129626,MUS 80,B00,891157,Staff,23,0,25,2
1746608130654,MUS 130,A00,891158,Ohnishi; Takae,35,0,35,0
1746608131720,MUS 150GS,A01,891160,Borgo; David Garcia,1,0,25,24
1746608132746,MUS 170,A01,891162,Freitas Caetano; Marcelo,20,0,25,5
1746608132746,MUS 170,A02,891164,Freitas Caetano; Marcelo,21,0,25,4
1746608133771,NANO 11,A00,886220,Vazquez Mena; Oscar,13,0,15,2
1746608134796,NANO 15,A01,886222,Drews; Aaron,4,0,7,3
1746608135824,NANO 104,A00,886224,Sirbuly; Donald,17,0,25,8
1746608136852,PH 40,A00,886528,Staff,23,0,40,17
1746608137881,PH 45,A01,886799,Staff,35,0,40,5
1746608138908,PH 110,A00,886802,Staff,0,6,40,40
1746608139933,PH 172,A00,906716,Staff,19,0,35,16
1746608140960,PH 191,A00,886803,Staff,6,0,40,34
1746608141986,PHIL 1,A00,889500,Staff,20,0,30,10
1746608143013,PHIL 10,A01,889549,Grush; Rick Scott,16,0,22,6
1746608143013,PHIL 10,A02,889551,Grush; Rick Scott,22,0,22,0
1746608144041,PHIL 28,A01,889559,Lamey; Andy M.,0,2,31,31
1746608144041,PHIL 28,A02,889561,Lamey; Andy M.,0,1,30,30
1746608144041,PHIL 28,A03,889572,Lamey; Andy M.,0,1,30,30
1746608145073,PHIL 35,A00,907839,Staff,13,0,15,2
1746608146099,PHIL 60,A00,889574,Staff,73,0,90,17
1746608147125,PHIL 101,A00,958004,Staff,12,0,15,3
1746608149178,PHIL 136,A00,889582,Fulkerson; Matthew Todd,26,0,45,19
1746608150209,PHIL 163,A01,889601,Staff,21,0,30,9
1746608150209,PHIL 163,B01,889606,Brandt; Reuven A,0,3,0,0
1746608151236,PHIL 164,A00,889610,Staff,16,0,30,14
1746608152265,PHIL 165,A00,889613,Staff,22,0,30,8
1746608153292,PHYS 1A,A00,886431,Staff,30,0,70,40
1746608154321,PHYS 1AL,001,886432,Tsai; Philbert S,0,1,30,30
1746608154321,PHYS 1AL,002,886436,Tsai; Philbert S,13,0,30,17
1746608155349,PHYS 1B,A00,886439,Staff,184,0,240,56
1746608156379,PHYS 1BL,001,886441,Tsai; Philbert S,0,4,30,30
1746608156379,PHYS 1BL,002,886444,Tsai; Philbert S,2,0,30,28
1746608157408,PHYS 1C,A00,896092,Arnold; Kam S,78,0,146,68
1746608158433,PHYS 1CL,001,886448,Tsai; Philbert S,0,0,30,30
1746608158433,PHYS 1CL,002,886449,Tsai; Philbert S,1,0,30,29
1746608158433,PHYS 1CL,003,886450,Tsai; Philbert S,16,0,30,14
1746608158433,PHYS 1CL,004,886451,Tsai; Philbert S,15,0,30,15
1746608159461,PHYS 2B,A01,886457,Staff,67,0,115,48
1746608160487,PHYS 2C,A01,886460,Shotwell; Brian,0,9,65,65
1746608161513,PHYS 2CL,A01,886467,Staff,0,4,28,28
1746608161513,PHYS 2CL,A02,886468,Staff,0,3,28,28
1746608162544,PHYS 2D,A01,886470,Staff,10,0,50,40
1746608163571,PHYS 4B,A01,886475,Grinstein; Benjamin,22,0,40,18
1746608164597,POLI 5,A00,891173,Desposato; Scott,7,0,25,18
1746608165624,POLI 5D,A01,891175,Staff,5,0,5,0
1746608165624,POLI 5D,B01,891178,Staff,5,0,5,0
1746608166650,POLI 11,A00,891179,Ferree; Karen E,0,0,35,35
1746608167678,POLI 12,A00,891180,Staff,15,0,30,15
1746608168705,POLI 27,A01,891182,Staff,11,0,75,64
1746608169734,POLI 30,A00,891183,Staff,8,0,50,42
1746608170760,POLI 100B,A00,891244,Staff,5,1,35,30
1746608171789,POLI 100I,A00,891247,Staff,7,0,30,23
1746608172814,POLI 104J,A00,891248,Nichter; Maysa,14,0,30,16
1746608173846,POLI 104U,A00,891250,Nichter; Maysa,1,0,30,29
1746608175905,POLI 110B,A00,891255,Wiens; David,19,0,25,6
1746608176933,POLI 112A,A00,891256,Wiens; David,6,0,25,19
1746608177961,POLI 114BR,A00,891261,Staff,19,0,30,11
1746608178992,POLI 117R,A00,891262,Forman; Fonna,0,6,50,50
1746608180019,POLI 118,A00,891264,Ingham; Sean,17,0,25,8
1746608181045,POLI 124A,A00,891265,Staff,18,0,20,2
1746608182074,POLI 125D,A00,891266,Nichter; Simeon C,2,0,25,23
1746608183100,POLI 126,A00,891268,Nichter; Simeon C,7,0,25,18
1746608184128,POLI 126AA,A00,891272,Staff,15,0,25,10
1746608185153,POLI 130AA,A00,891273,Staff,15,0,20,5
1746608186182,POLI 134AA,A00,891274,Staff,4,0,20,16
1746608188238,POLI 138,A00,891278,Staff,21,0,25,4
1746608189267,POLI 142K,A00,891280,Staff,10,0,25,15
1746608190293,POLI 142M,A00,891281,Gartzke; Erik,16,0,30,14
1746608191319,POLI 142P,A00,891284,Staff,20,0,30,10
1746608192347,POLI 143,A00,891285,Gartzke; Erik,12,0,30,18
1746608193373,POLI 153,A00,891286,Staff,19,0,20,1
1746608195428,POLI 175,A00,891290,Staff,15,0,20,5
1746608196453,PSYC 1,A00,890674,Steiner; Eric Tomas,0,11,45,45
1746608197479,PSYC 2,A00,890676,Albright; Thomas D,20,0,35,15
1746608198529,PSYC 3,A00,890679,Staff,17,0,20,3
1746608199560,PSYC 6,A00,959858,Staff,19,0,20,1
1746608200589,PSYC 60,A01,890684,Rickard; Timothy C.,0,6,45,45
1746608201614,PSYC 70,A01,890689,Geller; Emma Harlan,6,0,30,24
1746608202643,PSYC 71,A01,959860,Staff,21,0,25,4
1746608203672,PSYC 100,A00,890690,Lacefield; Katharine I,0,50,180,180
1746608204698,PSYC 102,A00,890695,Staff,18,0,40,22
1746608205728,PSYC 105,A00,890699,Geller; Emma Harlan,70,0,100,30
1746608206754,PSYC 106,A00,890701,Gorman; Michael R.,5,0,30,25
1746608207788,PSYC 108,A00,890704,Adrian; Julia Anna,0,29,50,50
1746608208815,PSYC 118,A01,890712,Staff,11,0,30,19
1746608209840,PSYC 124,A00,890716,Chapman; Eddie Nathaniel,25,0,60,35
1746608210865,PSYC 131,A00,890717,Anagnostaras; Stephan,0,7,80,80
1746608211890,PSYC 137,A00,890719,Winkielman; Piotr,0,11,30,30
1746608212924,PSYC 144,A00,890721,Adrian; Julia Anna,0,9,45,45
1746608213951,PSYC 162,A00,890805,Staff,0,2,75,75
1746608215012,PSYC 169,A00,890810,Staff,0,15,30,30
1746608216039,PSYC 172,A00,890814,Gorman; Michael R.,9,0,30,21
1746608217063,PSYC 181,A00,890818,Anagnostaras; Stephan,6,0,200,194
1746608218087,PSYC 184,A00,959861,Staff,160,0,175,15
1746608219113,PSYC 189,A00,890823,Staff,0,2,30,30
1746608220142,PSYC 191,A00,890884,Rickard; Timothy C.,0,12,35,35
1746608221180,PSYC 193,A00,890913,Staff,19,0,30,11
1746608221180,PSYC 193,B00,890914,Chapman; Eddie Nathaniel,24,0,30,6
1746608222242,PSYC 193L,A01,890918,Lowe; Angela Beth,20,0,30,10
1746608222242,PSYC 193L,B01,890921,Hurwitz; Ethan Scott,20,0,30,10
1746608222242,PSYC 193L,C01,890928,Staff,30,0,30,0
1746608223270,RELI 149,A00,886806,Rahimi; Babak,23,0,40,17
1746608224297,SE 9,A01,886814,Staff,7,0,20,13
1746608225322,SE 101B,A01,886816,Chadha; Mayank,3,0,35,32
1746608226361,SE 110B,A00,886818,Zhu; Qiang,4,0,75,71
1746608227387,SE 125,A01,886830,Staff,10,0,30,20
1746608228414,SE 130B,A01,886835,Staff,14,0,40,26
1746608229454,SE 131A,A01,886838,Krysl; Petr,34,0,55,21
1746608230506,SE 154,A00,886840,Staff,28,0,50,22
1746608231538,SE 164GS,A01,886849,Staff,6,0,20,14
1746608232566,SE 167GS,A01,886853,Staff,6,0,20,14
1746608233590,SIO 25,A01,890107,Staff,19,0,30,11
1746608234617,SIO 45,A00,890109,Cook; Geoffrey W,114,0,200,86
1746608235641,SIO 109R,A00,890110,Forman; Fonna,0,16,20,20
1746608236669,SIO 187,A01,890114,Kacev; David,15,0,40,25
1746608237695,SOCI 1,A01,890431,Thorpe; Charles Robert,14,0,30,16
1746608237695,SOCI 1,A02,890518,Thorpe; Charles Robert,30,0,30,0
1746608238723,SOCI 2,A01,957978,Staff,25,0,25,0
1746608238723,SOCI 2,A02,957979,Staff,23,0,25,2
1746608239754,SOCI 20,A01,890523,Calderon-Zaks; Michael Aar,21,0,30,9
1746608239754,SOCI 20,A02,890526,Calderon-Zaks; Michael Aar,29,0,30,1
1746608240782,SOCI 30,A01,890533,Pardo Guerra; Juan Pablo,37,0,40,3
1746608241811,SOCI 40,A01,890535,Staff,27,0,45,18
1746608242837,SOCI 104Q,A00,890559,Staff,17,0,30,13
1746608243869,SOCI 106,A00,890560,Arnal; Maud Marie Leonie,20,0,30,10
1746608244895,SOCI 110,A00,890567,Holkenbrink-Monk; Charlene,19,0,30,11
1746608245924,SOCI 112,A00,890568,Victoria Torres; Pablo,2,0,55,53
1746608246951,SOCI 115,A00,890597,Arnal; Maud Marie Leonie,28,0,45,17
1746608249007,SOCI 121,A00,890604,Pardo Guerra; Juan Pablo,38,0,45,7
1746608250070,SOCI 126,A01,890608,Staff,8,0,10,2
1746608251095,SOCI 127,A00,890609,Staff,18,0,30,12
1746608252124,SOCI 131,A00,890610,Thorpe; Charles Robert,37,0,45,8
1746608253148,SOCI 135,A00,890615,Payne; Christine Anna,14,0,45,31
1746608254175,SOCI 139,A00,890620,Staff,38,0,45,7
1746608255200,SOCI 148E,A00,890622,Calderon-Zaks; Michael Aar,36,0,45,9
1746608256226,SOCI 150,A00,890623,Kohler; Kristopher M.,31,0,45,14
1746608257252,SOCI 157,A00,890625,Jules-Rosette; Bennetta W.,18,0,20,2
1746608258280,SOCI 160,A00,890627,Payne; Christine Anna,21,0,45,24
1746608259308,SYN 1,A00,886855,Fish; Gwendolyn Anne,0,1,0,0
1746608259308,SYN 1,B00,906086,Fish; Gwendolyn Anne,0,2,0,2
1746608260335,SYN 2R,A00,886860,Staff,0,17,15,15
1746608260335,SYN 2R,B00,906106,Atkinson; Arthur Laird,0,16,15,15
1746608261371,SYN 100,A01,886866,Browne; Emily,0,28,20,20
1746608261371,SYN 100,B01,906128,Rock; Martin,0,4,20,20
1746608261371,SYN 100,C01,906140,Deavenport; James Cary,0,4,20,20
1746608261371,SYN 100,D01,907816,Deavenport; James Cary,0,5,20,20
1746608262396,TDAC 1,A00,890286,Walsh; Kim C.,7,0,20,13
1746608263426,TDAC 101,A00,890296,Basso; Beatrice,15,0,20,5
1746608264454,TDDE 131,A00,890297,Staff,47,0,50,3
1746608265484,TDDM 1,A00,890287,Weinberg; Sadie,25,0,30,5
1746608266512,TDGE 11,A00,890288,Fulton; Julia,138,0,200,62
1746608266512,TDGE 11,B00,890289,Castro; Robert Jess,184,0,200,16
1746608267538,TDGE 25,B00,957359,Walsh; Kim C.,5,0,20,15
1746608268563,TDGE 40,A01,890292,Power; Jade Yukana,26,0,30,4
1746608269592,TDGE 124,A00,890298,Havis; Allan,0,2,50,50
1746608270618,TDGE 131R,A00,890299,Burelle; Julie Sara Veronique,15,0,42,27
1746608271644,TDHT 101,A00,890300,Staff,10,0,20,10
1746608272672,TDHT 109,A01,890302,Anderson; Mysia Anyse,31,0,40,9
1746608273703,TDMV 1,A00,890293,Arcidiacono; Kristin,18,0,30,12
1746608274728,TDMV 2,A00,890294,Weinberg; Sadie,23,0,30,7
1746608275754,TDMV 3,A00,957878,Arcidiacono; Kristin,28,0,30,2
1746608277812,TDMV 138,A00,890304,Jun; Grace Shin Hae,25,0,40,15
1746608278840,TDMV 140,A00,890305,Corrales; Joseph Bernales,25,0,30,5
1746608279866,TDMV 142,A00,890307,Caligagan; Tony,32,0,40,8
1746608280892,TDMV 144,A00,890308,Camaya; Michelle Ann,25,0,30,5
1746608281919,TDPW 1,A00,890295,Stein; Deborah Isobel,3,0,20,17
1746608282949,USP 2,A01,890272,Lerner; Amy M,7,0,20,13
1746608283975,USP 3,A01,890274,Staff,12,0,30,18
1746608285003,USP 15,A01,890276,Sun; Feiyang,16,0,30,14
1746608286029,USP 25,A00,890277,Shenkman; Michael Thomas,18,0,25,7
1746608287056,USP 138,A00,890278,Staff,13,0,25,12
1746608288082,USP 143,A00,890279,Staff,21,0,70,49
1746608289112,USP 144,A00,890280,Chowdhury; Muhammed Zohir,16,0,30,14
1746608290143,USP 150,A00,890281,Boomhower; Matthew Charles,4,0,30,26
1746608291168,USP 151,A00,890282,Staff,16,0,20,4
1746608292195,USP 162,A00,890283,Andrews; Abigail Leslie,16,0,20,4
1746608293224,USP 168,A00,920477,Kwak; Nancy,0,0,5,5
1746608294252,USP 181,A00,890284,Staff,3,0,20,17
1746608295278,USP 191A,A00,890285,Staff,12,0,20,8
1746608296304,VIS 101,A00,886512,Staff,26,0,75,49
1746608297333,VIS 103,A00,886513,Cruz; Edwin Teddy,61,0,75,14
1746608298360,VIS 108,A00,886514,Staff,4,0,15,11
1746608299385,VIS 127P,A00,886515,Shen; Kuiyi,80,0,146,66
1746608300412,VIS 149,A00,886516,Yoldas; Pinar,0,0,15,15
1746608301437,VIS 164,A00,886526,Erdmann; Dean,19,0,22,3
1746608302463,VIS 194S,A00,886527,Staff,61,0,75,14
1746608303492,WCWP 10A,C00,886484,Martiniuk; Jill,12,0,15,3
1746608304518,WCWP 10B,A00,886490,Uriarte; Emma,0,0,15,15
1746608304518,WCWP 10B,B00,886491,Dhir; Simrita,8,0,15,7
1746608304518,WCWP 10B,C00,886492,Ornelas; Tricia,0,0,15,15
1746608305549,WCWP 100,A00,886494,Young; Mark T,0,6,15,15
1746608307710,AAS 10,A01,886199,Childs; Dennis R.,0,3,0,0
1746608308737,ANAR 104,A01,886940,Shtienberg; Gilad,27,0,30,3
1746608309767,ANAR 120,A00,886953,Staff,13,0,20,7
1746608310792,ANBI 148,A01,886955,Wilder; Linnea Lorene,30,0,40,10
1746608312849,ANSC 122,A00,886957,Staff,24,0,30,6
1746608313878,ANSC 150,A00,886958,Sloane; Julia Kathryn,2,0,15,13
1746608314932,ANSC 156,A00,886959,Jenkins; Janis A.,0,1,15,15
1746608315958,ANSC 180,A00,886960,Staff,11,0,17,6
1746608316990,ANSC 188,A00,886961,Jassal; Aftab,9,0,25,16
1746608318015,ANSC 190,A00,886962,Jassal; Aftab,14,0,25,11
1746608319043,ANSC 191,A00,886963,Staff,18,0,20,2
1746608320072,ANTH 3,A01,891689,Staff,17,0,20,3
1746608321097,ANTH 5,A00,886933,Semendeferi; Ekaterini,16,0,20,4
1746608322125,ANTH 10,A00,886934,Staff,0,12,30,30
1746608323155,ANTH 21,A01,886936,Staff,41,0,60,19
1746608324182,ANTH 23,A01,886938,Staff,92,0,100,8
1746608325209,ANTH 105,A00,886964,Stewart; Alexander B,84,0,100,16
1746608326239,ANTH 108,A00,886965,Pedersen; David,9,0,20,11
1746608327274,AWP 10,001,886147,Staff,0,0,0,0
1746608327274,AWP 10,002,886148,Staff,0,0,0,0
1746608327274,AWP 10,003,886149,Staff,0,0,0,0
1746608327274,AWP 10,004,886150,Staff,0,0,0,0
1746608327274,AWP 10,005,886151,Staff,0,0,0,0
1746608327274,AWP 10,006,886152,Staff,0,0,0,0
1746608327274,AWP 10,007,886153,Staff,0,0,0,0
1746608327274,AWP 10,008,886154,Staff,0,0,0,0
1746608327274,AWP 10,009,886155,Staff,0,0,0,0
1746608327274,AWP 10,010,886156,Staff,0,0,0,0
1746608327274,AWP 10,011,886158,Staff,0,0,0,0
1746608327274,AWP 10,012,886160,Staff,0,0,0,0
1746608327274,AWP 10,013,886161,Staff,0,0,0,0
1746608327274,AWP 10,014,886162,Staff,0,0,0,0
1746608327274,AWP 10,015,886163,Staff,0,0,0,0
1746608327274,AWP 10,016,886164,Staff,0,0,0,0
1746608327274,AWP 10,017,886165,Staff,0,0,0,0
1746608327274,AWP 10,018,886166,Staff,0,0,0,0
1746608327274,AWP 10,019,886168,Staff,0,0,0,0
1746608327274,AWP 10,020,886170,Staff,0,0,0,0
1746608327274,AWP 10,021,886172,Staff,0,0,0,0
1746608328307,AWP 10R,001,886173,Staff,0,1,0,0
1746608328307,AWP 10R,002,886174,Staff,0,1,0,0
1746608328307,AWP 10R,003,886175,Staff,0,0,0,0
1746608328307,AWP 10R,004,886176,Staff,0,0,0,0
1746608328307,AWP 10R,005,886177,Staff,0,0,0,0
1746608328307,AWP 10R,006,886178,Staff,0,0,0,0
1746608328307,AWP 10R,007,886179,Staff,0,0,0,0
1746608328307,AWP 10R,008,886181,Staff,0,0,0,0
1746608328307,AWP 10R,009,886182,Staff,0,0,0,0
1746608328307,AWP 10R,010,886183,Staff,0,0,0,0
1746608328307,AWP 10R,011,886184,Staff,0,0,0,0
1746608328307,AWP 10R,012,886185,Staff,0,0,0,0
1746608328307,AWP 10R,013,886186,Staff,0,0,0,0
1746608328307,AWP 10R,014,886187,Staff,0,0,0,0
1746608328307,AWP 10R,015,886188,Staff,0,0,0,0
1746608328307,AWP 10R,016,886189,Staff,0,0,0,0
1746608328307,AWP 10R,017,960532,Staff,0,0,0,0
1746608328307,AWP 10R,018,960533,Staff,0,0,0,0
1746608328307,AWP 10R,019,960534,Staff,0,0,0,0
1746608328307,AWP 10R,020,960538,Staff,0,0,0,0
1746608328307,AWP 10R,021,960540,Staff,0,0,0,0
1746608328307,AWP 10R,022,960541,Staff,0,0,0,0
1746608328307,AWP 10R,023,960542,Staff,0,0,0,0
1746608328307,AWP 10R,024,960544,Staff,0,0,0,0
1746608328307,AWP 10R,025,960545,Staff,0,0,0,0
1746608328307,AWP 10R,026,960548,Staff,0,0,0,0
1746608329334,AWP 102R,A00,886190,Staff,0,0,0,0
1746608329334,AWP 102R,B00,886191,Staff,0,0,0,0
1746608330361,BENG 100,A01,886193,Staff,17,0,30,13
1746608331391,BENG 122A,A01,886195,Hasty; Jeff M,13,0,30,17
1746608332427,BENG 166A,A00,886196,Sah; Robert Lie-Yuan,0,3,30,30
1746608333453,BENG 190,A00,958050,Khojah; Reem I,17,0,25,8
1746608334483,BIBC 102,A01,894320,Staff,0,1,46,46
1746608334483,BIBC 102,A02,894321,Staff,0,0,46,46
1746608334483,BIBC 102,A03,894344,Staff,6,0,46,40
1746608334483,BIBC 102,A04,894345,Staff,27,0,47,20
1746608335509,BICD 100R,A01,894365,Smith; Laurie,0,2,58,58
1746608335509,BICD 100R,A02,894366,Smith; Laurie,0,4,58,58
1746608335509,BICD 100R,A03,894367,Smith; Laurie,0,0,59,59
1746608335509,BICD 100R,A04,959869,Smith; Laurie,38,0,59,21
1746608336535,BICD 136,A01,894383,Gustafson-Brown; Cindy,14,0,50,36
1746608337564,BIEB 102,A01,894494,Butler; Shannon Rhey,51,0,130,79
1746608339625,BIEB 150,A01,894617,Wills; Christopher,3,0,20,17
1746608339625,BIEB 150,A02,894631,Wills; Christopher,3,0,20,17
1746608339625,BIEB 150,A03,894937,Wills; Christopher,3,0,20,17
1746608339625,BIEB 150,A04,894946,Wills; Christopher,5,0,20,15
1746608340652,BIEB 194,A00,906141,Kurle; Carolyn M.,5,0,20,15
1746608341680,BILD 1,A01,894154,Staff,3,0,19,16
1746608341680,BILD 1,A02,894155,Staff,14,0,19,5
1746608341680,BILD 1,A03,894160,Staff,13,0,19,6
1746608341680,BILD 1,A04,894161,Staff,15,0,18,3
1746608342707,BILD 2,A01,894168,Staff,0,0,50,50
1746608342707,BILD 2,A02,894169,Staff,0,0,50,50
1746608342707,BILD 2,A03,894179,Staff,0,0,50,50
1746608342707,BILD 2,A04,894203,Staff,22,0,50,28
1746608343736,BILD 3,A01,894213,Staff,23,0,31,8
1746608343736,BILD 3,A02,894214,Staff,26,0,31,5
1746608343736,BILD 3,A03,894235,Staff,28,0,31,3
1746608343736,BILD 3,A04,894236,Staff,28,0,32,4
1746608344767,BILD 4,A01,894253,Reuther; Keefe,5,0,24,19
1746608344767,BILD 4,A02,894258,Reuther; Keefe,16,0,24,8
1746608345797,BILD 5,A01,894276,Reuther; Keefe,33,0,50,17
1746608345797,BILD 5,A02,894277,Reuther; Keefe,45,0,50,5
1746608345797,BILD 5,A03,894290,Reuther; Keefe,44,0,50,6
1746608345797,BILD 5,A04,894291,Reuther; Keefe,48,0,50,2
1746608346826,BILD 24,A01,894297,Pirino; Giorgia,40,0,60,20
1746608347853,BIMM 100,B01,958915,Staff,71,0,100,29
1746608348881,BIMM 101,A01,895017,McDonnell; Lisa Marie,0,5,24,24
1746608348881,BIMM 101,A02,895018,McDonnell; Lisa Marie,0,5,24,24
1746608348881,BIMM 101,B01,895020,McDonnell; Lisa Marie,0,5,24,24
1746608348881,BIMM 101,B02,895021,McDonnell; Lisa Marie,0,4,24,24
1746608349916,BIMM 110,A01,895023,Staff,1,0,25,24
1746608349916,BIMM 110,A02,895024,Staff,9,0,25,16
1746608349916,BIMM 110,A03,895025,Staff,18,0,25,7
1746608349916,BIMM 110,A04,895031,Staff,20,0,25,5
1746608350948,BIMM 120,A01,895114,Gustafson-Brown; Cindy,14,0,28,14
1746608350948,BIMM 120,A02,895126,Gustafson-Brown; Cindy,21,0,27,6
1746608351977,BIPN 100,A01,895130,Yang; Mingyu,0,0,38,38
1746608351977,BIPN 100,A02,895131,Yang; Mingyu,31,0,38,7
1746608351977,BIPN 100,A03,895132,Yang; Mingyu,32,0,38,6
1746608351977,BIPN 100,A04,895133,Yang; Mingyu,27,0,36,9
1746608353008,BIPN 120,A01,895135,Cooke; James Edward,0,3,13,13
1746608353008,BIPN 120,A02,895136,Cooke; James Edward,0,1,13,13
1746608353008,BIPN 120,A03,895137,Cooke; James Edward,0,3,13,13
1746608353008,BIPN 120,A04,895156,Cooke; James Edward,0,2,11,11
1746608354075,BIPN 134,A01,895235,Cooke; James Edward,0,1,25,25
1746608354075,BIPN 134,A02,895237,Cooke; James Edward,0,0,25,25
1746608354075,BIPN 134,A03,895240,Cooke; James Edward,1,0,25,24
1746608354075,BIPN 134,A04,895270,Cooke; James Edward,20,0,25,5
1746608355106,BIPN 189,A00,892103,Staff,0,14,14,14
1746608357160,BISP 194,A00,958008,Staff,0,2,0,0
1746608358190,CAT 124,A01,922009,Staff,0,5,20,20
1746608359228,CAT 125R,A00,886390,Morales; Celeste Georgianna,0,4,20,20
1746608359228,CAT 125R,B00,886391,Irwin; Matthew Joseph,0,4,20,20
1746608359228,CAT 125R,C00,886392,Smith; Lauryn Alissa,0,2,20,20
1746608359228,CAT 125R,D00,886393,Vanderschuit; Maya Alysia,0,3,20,20
1746608359228,CAT 125R,E00,886394,Marchisotto; Jennifer Anne,0,3,20,20
1746608360255,CENG 15,A01,886218,Drews; Aaron,3,0,8,5
1746608361281,CENG 113,A00,886219,Opatkiewicz; Justin Paul,15,0,25,10
1746608362310,CGS 101,A00,887044,Staff,7,0,20,13
1746608363338,CGS 105,A01,887046,Staff,14,0,25,11
1746608364374,CGS 112,A00,887047,Cuong; Marisol,12,0,15,3
1746608365398,CGS 113,A00,887048,Staff,23,0,30,7
1746608366423,CGS 120,A00,887049,Staff,9,0,17,8
1746608367449,CHEM 6A,A01,886336,Lam; Tin Yiu,38,0,50,12
1746608367449,CHEM 6A,A02,886338,Lam; Tin Yiu,37,0,50,13
1746608368476,CHEM 6B,A01,886341,Hopkins; Patrycja Anna,16,0,50,34
1746608368476,CHEM 6B,A02,886343,Hopkins; Patrycja Anna,42,0,50,8
1746608369506,CHEM 6C,A01,886346,Albizati; Kim F.,0,2,50,50
1746608369506,CHEM 6C,A02,886348,Albizati; Kim F.,24,0,50,26
1746608370533,CHEM 40A,A01,886352,Klosterman; Jeremy K,65,0,100,35
1746608371559,CHEM 40B,A01,886356,Klosterman; Jeremy K,0,24,100,100
1746608372589,CHEM 41B,A01,886360,Theodorakis; Emmanuel,25,0,50,25
1746608372589,CHEM 41B,A02,886362,Theodorakis; Emmanuel,47,0,50,3
1746608373621,CHIN 165A,A00,886382,Xu; Li,18,0,20,2
1746608374652,CLAS 120,A00,886387,Myerston Santana; Jacobo,33,0,40,7
1746608375679,COGS 9,A01,886967,Shannon; Kyle Michael,42,0,60,18
1746608376705,COGS 11,A01,886969,Staff,9,0,30,21
1746608377731,COGS 14A,A01,886971,Staff,5,0,60,55
1746608378758,COGS 14B,A01,886973,Hoffman; Drew Ellen,4,0,60,56
1746608379786,COGS 18,A01,886975,Morgan; Eric,34,0,60,26
1746608380813,COGS 20,A01,886977,Staff,3,0,8,5
1746608380813,COGS 20,A02,886978,Staff,5,0,7,2
1746608381840,COGS 100,A01,907783,Staff,0,1,30,30
1746608382869,COGS 101B,A01,886980,Staff,0,4,48,48
1746608383898,COGS 101C,A01,886982,Delgado; Tania,0,5,44,44
1746608384931,COGS 102A,A01,886984,Johnson; Christine M.,3,0,30,27
1746608385961,COGS 118B,A01,886986,Staff,0,4,88,88
1746608386992,COGS 150,A01,886988,Bergen; Benjamin,22,0,50,28
1746608388023,COGS 153,A00,886989,Delgado; Tania,1,3,41,40
1746608389048,COGS 186,A01,886991,Staff,0,0,32,32
1746608390078,COGS 187A,A01,886993,Boyle; Mary E. T.,7,0,30,23
1746608391104,COGS 189,A00,886994,Staff,0,1,30,30
1746608392130,COMM 10,A01,886996,Staff,0,0,20,21
1746608392130,COMM 10,A02,886997,Staff,10,0,20,10
1746608392130,COMM 10,A03,959845,Staff,19,0,20,1
1746608393161,COMM 20,A01,886999,Leuning; Grant Maurstad,24,0,40,16
1746608395214,COMM 100A,A01,887002,Staff,0,0,20,25
1746608395214,COMM 100A,A02,887003,Staff,5,0,20,15
1746608396243,COMM 100B,A01,887005,Staff,0,8,20,24
1746608397268,COMM 106D,A00,887006,Staff,14,0,40,26
1746608398293,COMM 110G,A00,887007,Whitworth-Smith; Andrew C,12,0,40,28
1746608399319,COMM 111B,A00,887008,Staff,31,0,40,9
1746608400349,COMM 113T,A00,887009,Abuelhiga; Soraya Jill,28,0,40,12
1746608400349,COMM 113T,B00,906733,Staff,39,0,40,1
1746608401378,COMM 145,A00,887010,Staff,13,0,40,27
1746608402409,COMM 146,A00,887054,Staff,32,0,40,8
1746608403436,COMM 190,A00,887012,Staff,8,0,23,15
1746608404463,CSE 8A,A50,887015,Cao; Yingjun,56,0,85,29
1746608405490,CSE 11,A01,887017,Cao; Yingjun,11,0,70,59
1746608406517,CSE 20,A01,887019,Staff,30,0,50,20
1746608407545,CSE 21,A01,887021,Staff,79,0,100,21
1746608407545,CSE 21,B01,892583,Braun; Oliver,45,0,50,5
1746608408575,CSE 30,A01,887025,Eldon; John,142,0,200,58
1746608409602,CSE 100,A01,887027,Staff,26,0,50,24
1746608409602,CSE 100,A02,887028,Staff,42,0,50,8
1746608410629,CSE 101,A01,887030,Braun; Oliver,74,0,100,26
1746608410629,CSE 101,B01,887032,Jones; Miles E,0,3,50,50
1746608410629,CSE 101,B02,887033,Jones; Miles E,0,2,50,50
1746608411696,CSE 105,A01,908084,Jones; Miles E,32,0,50,18
1746608411696,CSE 105,A02,908087,Jones; Miles E,31,0,50,19
1746608412727,CSE 135,A01,887035,Powell; Thomas Allan,0,5,50,50
1746608413752,CSE 142,A01,887037,Staff,7,0,60,53
1746608414781,CSE 142L,A01,887039,Staff,34,0,60,26
1746608415810,CSE 151A,A01,887041,Solares; Edwin A,47,0,100,53
1746608416837,CSE 175,A01,887043,Kumar; Rakesh,30,0,30,0
1746608417865,CSS 1,A01,886389,Staff,0,1,40,40
1746608418894,DSC 30,A01,908097,Liao; Soohyun Nam,47,0,75,28
1746608419924,DSC 40A,A01,908099,Shannon; Kyle Michael,30,0,50,20
1746608420957,DSC 40B,A01,908112,Staff,15,0,50,35
1746608421982,DSC 80,A01,908116,Staff,19,0,60,41
1746608423013,DSC 197,001,956863,Eldridge; Justin Matthew,9999,0,9999,0
1746608424044,ECE 5,A01,886400,Morris; Karcher William,1,0,6,5
1746608424044,ECE 5,A02,886401,Morris; Karcher William,3,0,6,3
1746608425070,ECE 148,A01,886403,Silberman; Jack,0,14,14,14
1746608426104,ECON 1,A01,887265,Crane; Meredith Helen,11,0,70,59
1746608426104,ECON 1,B01,887268,Staff,42,0,50,8
1746608427131,ECON 2,A01,887273,Crane; Meredith Helen,54,0,70,16
1746608428158,ECON 3,A01,887279,Rondina; Giacomo,31,0,70,39
1746608429188,ECON 4,A01,887282,Anderson; John Charles,0,2,10,10
1746608430219,ECON 5,A01,887285,Staff,34,0,45,11
1746608430219,ECON 5,B01,887292,Staff,41,0,45,4
1746608431247,ECON 100A,A01,887337,Newhouse; Herbert S,54,0,70,16
1746608431247,ECON 100A,B01,887349,Staff,45,0,50,5
1746608432273,ECON 100B,A01,887361,Du; Songzi,29,0,70,41
1746608433301,ECON 100C,A01,887445,Newhouse; Herbert S,59,0,70,11
1746608434328,ECON 105,A00,887488,Vespa; Emanuel Ignacio,23,0,35,12
1746608435357,ECON 109,A01,887506,Shishkin; Denis,28,0,35,7
1746608436385,ECON 110A,A01,887568,Alon; Titan Michael,0,2,35,35
1746608436385,ECON 110A,B01,907601,Alon; Titan Michael,20,0,35,15
1746608437428,ECON 110B,A01,887598,Levkoff; Steven B.,0,24,70,70
1746608438457,ECON 112,A00,887599,Rondina; Giacomo,19,0,35,16
1746608439484,ECON 120A,A01,887603,Dai; Yinlin,36,0,70,34
1746608440512,ECON 120C,A01,887608,Sun; Yixiao,0,1,35,35
1746608440512,ECON 120C,B01,887614,Sun; Yixiao,0,0,35,35
1746608441545,ECON 138,A00,887621,Bharadwaj; Prashant,0,21,20,20
1746608442572,ECON 144,A00,958007,Squires; Dale E,11,0,35,24
1746608443605,ECON 171,A01,907666,Staff,18,0,35,17
1746608444632,ECON 175,A00,887626,Wu; Pak Yeung,22,0,35,13
1746608445661,ECON 190,A00,887640,Vespa; Emanuel Ignacio,22,0,35,13
1746608446695,EDS 25,A01,888197,Staff,0,0,0,0
1746608446695,EDS 25,A02,888209,Staff,0,0,0,0
1746608446695,EDS 25,A03,888210,Staff,0,0,0,0
1746608446695,EDS 25,A04,888212,Staff,0,0,0,0
1746608446695,EDS 25,A05,888213,Staff,0,0,0,0
1746608446695,EDS 25,A06,888214,Staff,0,0,0,0
1746608446695,EDS 25,A07,888235,Staff,0,2,0,0
1746608446695,EDS 25,A08,888236,Staff,0,0,0,0
1746608446695,EDS 25,A09,888240,Staff,0,0,0,0
1746608446695,EDS 25,A10,888244,Staff,0,0,0,0
1746608446695,EDS 25,B01,888273,Staff,0,0,0,0
1746608446695,EDS 25,B02,888285,Staff,0,0,0,0
1746608446695,EDS 25,B03,888423,Staff,0,0,0,1
1746608446695,EDS 25,B04,888432,Staff,0,0,0,0
1746608446695,EDS 25,B05,888433,Staff,0,0,0,0
1746608446695,EDS 25,B06,888467,Staff,0,0,0,0
1746608446695,EDS 25,B07,888468,Staff,0,0,0,0
1746608446695,EDS 25,B08,888479,Staff,0,0,0,0
1746608446695,EDS 25,B09,888484,Staff,0,0,0,0
1746608446695,EDS 25,B10,888487,Staff,0,0,0,0
1746608447722,EDS 38,A01,907700,Choi; Bailey Miyeon,30,0,30,0
1746608448748,EDS 112,A01,888601,Chapman; Thandeka K,12,0,40,28
1746608449783,EDS 115,A00,888697,Mendez; Kathrina Mendoza,10,0,30,20
1746608450812,EDS 116,A01,888893,Staff,33,0,40,7
1746608452868,EDS 124AR,A00,889133,Staff,29,0,50,21
1746608452868,EDS 124AR,B00,907471,Simon; Elizabeth A,37,0,50,13
1746608453897,EDS 124BR,A00,889134,Simon; Elizabeth A,44,0,100,56
1746608454923,EDS 125,A00,889135,Staff,25,0,30,5
1746608455953,EDS 126,A01,889138,Staff,35,0,40,5
1746608456979,EDS 164R,A01,889142,Wishard Guerra; Alison G.,32,0,50,18
1746608458006,ENG 30,A01,886396,Staff,0,0,0,0
1746608458006,ENG 30,B01,886398,Staff,0,0,0,0
1746608459032,ENVR 102,A00,906150,Montejo; Carolina,23,0,25,2
1746608460058,ETHN 103A,A00,887236,Man; Simeon S,0,2,0,0
1746608461084,ETHN 113,A00,887239,Staff,16,0,30,14
1746608462114,ETHN 116,A00,887240,Staff,16,0,25,9
1746608463142,ETHN 117,A00,887241,Choi; Esther Min,28,0,30,2
1746608464167,ETHN 118,A00,887243,Staff,24,0,30,6
1746608465198,ETHN 127,A00,887248,Cuong; Marisol,11,0,15,4
1746608466225,ETHN 139,A00,887250,Staff,7,0,10,3
1746608467250,ETHN 142,A00,887252,Staff,9,0,30,21
1746608468281,ETHN 161,A00,887253,Browne; Errol Tsekani,24,0,30,6
1746608469308,ETHN 163FR,A00,887255,Burelle; Julie Sara Veronique,0,0,5,5
1746608470338,GLBH 20,A00,889149,Elwardani; Nile Regina,8,0,42,34
1746608472402,GLBH 111,A01,889152,Burgos; Jose L.,17,0,17,0
1746608473430,GLBH 150,A00,889181,Sloane; Julia Kathryn,0,5,15,15
1746608475495,HDS 60,A01,886406,Warstadt; Melissa Fawn,72,0,80,8
1746608476523,HIAF 111,A00,889324,Gyamfi; Bright,25,0,32,7
1746608477551,HIEA 131,A00,889328,Staff,15,0,32,17
1746608478579,HIEA 144,A00,889333,Henry; Todd A.,26,0,32,6
1746608479606,HIEA 154,A00,889336,Henry; Todd A.,24,0,32,8
1746608480633,HIEU 106,A00,889339,Staff,22,0,32,10
1746608482695,HIEU 114,A00,889340,Staff,4,0,32,28
1746608483721,HIEU 135GS,A00,889342,Patterson; Patrick H.,0,0,1,24
1746608484752,HIEU 137,A00,889343,Edington; Claire Ellen,10,0,25,15
1746608485778,HIEU 148,A00,889345,Staff,14,0,32,18
1746608486808,HIEU 154,A00,889346,Biess; Frank Peter,21,0,32,11
1746608487838,HILA 102,A00,889351,Staff,12,0,32,20
1746608488869,HILD 2A,A01,889221,Lewandoski; Julia Mavis,0,8,32,32
1746608489895,HILD 7B,A01,889225,Man; Simeon S,0,12,32,32
1746608490926,HILD 7C,A01,889288,Alvarez; Luis A,0,14,32,32
1746608491956,HILD 30,A01,889323,Staff,0,5,32,32
1746608494050,HISC 119,A00,889383,Golan; Tal,20,0,32,12
1746608495078,HIUS 103,A00,889384,Man; Simeon S,0,0,32,32
1746608496109,HIUS 117,A00,919797,Kwak; Nancy,18,0,32,14
1746608497135,HIUS 142A,A00,919788,Staff,22,0,32,10
1746608499187,HIUS 149,A00,889386,Gyamfi; Bright,26,0,32,6
1746608500217,HIUS 155,A00,889387,Alvarez; Luis A,15,0,32,17
1746608501246,HUM 3,A01,886499,Caldwell; Michael Alan,19,0,50,31
1746608502272,HUM 3GS,A00,886500,Rodriguez; Bretton Sigfred,0,0,0,28
1746608503304,HUM 3R,A01,886502,Markman; Kristina,0,36,50,50
1746608504330,HUM 4,A01,886504,Crum; Matthew Stephen,23,0,50,27
1746608504330,HUM 4,B01,886506,West; Geoffrey Scott,17,0,50,33
1746608505360,HUM 4GS,A00,886507,Staff,0,0,0,19
1746608506391,HUM 5,A01,886509,Staff,31,0,50,19
1746608507419,HUM 5R,A01,886511,Zavodny; Tatiana Sophia,0,39,50,50
1746608508447,JAPN 180,A00,886407,Staff,16,0,40,24
1746608509477,LATI 50,A01,886409,Martin-Cabrera; Luis,3,0,22,19
1746608509477,LATI 50,A02,886410,Martin-Cabrera; Luis,19,0,22,3
1746608509477,LATI 50,A03,886411,Martin-Cabrera; Luis,21,0,22,1
1746608509477,LATI 50,A04,886412,Martin-Cabrera; Luis,8,0,22,14
1746608510508,LAWS 101,A00,907664,Staff,28,0,60,32
1746608511536,LIAB 1A,A00,889388,Saab; Dima,17,0,20,3
1746608512562,LIAB 1AX,A00,889389,El Cheddadi; Youniss,18,0,20,2
1746608513593,LIFR 1C,A00,889391,Van Moer; Vinciane G,8,0,20,12
1746608514620,LIFR 1CX,A00,889392,Van Moer; Vinciane G,7,0,20,13
1746608515651,LIFR 1D,A00,889393,Van Moer; Vinciane G,7,0,20,13
1746608516680,LIFR 1DX,A00,889394,Van Moer; Vinciane G,8,0,20,12
1746608517708,LIGN 7,A00,886923,Staff,25,0,50,25
1746608518741,LIGN 17,A00,886924,Kehler; Andrew Scott,126,0,150,24
1746608519775,LTAM 110,A00,889395,Staff,15,0,30,15
1746608520803,LTAM 110GS,A00,958010,Rodriguez; Bretton Sigfred,0,0,0,28
1746608521829,LTCH 101,A00,889397,Staff,23,0,25,2
1746608522858,LTCS 130,A00,889398,Staff,23,0,25,2
1746608523890,LTEA 138,A00,889399,Staff,24,0,40,16
1746608524922,LTEN 149,A00,889400,Wesling; Megan E.,0,3,25,25
1746608525949,LTEN 169,A00,889401,Staff,20,0,25,5
1746608526976,LTEN 180,A00,889402,Staff,10,0,15,5
1746608528002,LTEN 181,A00,889403,Staff,21,0,25,4
1746608529032,LTWL 100,A00,889404,Myerston Santana; Jacobo,2,0,25,23
1746608530061,LTWL 180GS,A00,889405,Staff,0,0,20,20
1746608531085,LTWL 181,A00,889406,Staff,16,0,25,9
1746608532117,LTWL 184,A00,889475,Mukherjee; Silpa,22,0,25,3
1746608533147,LTWR 102C,A00,889486,Staff,29,0,30,1
1746608534173,LTWR 115W,A00,889491,Staff,0,2,15,15
1746608535200,MAE 8,A01,886905,Staff,0,2,0,0
1746608536231,MAE 11,A00,886906,Bandaru; Prabhakar,0,7,50,50
1746608537261,MAE 20,A00,886907,Evdokimenko; Ekaterina,43,0,70,27
1746608538288,MAE 30B,A00,886909,Ghazinejad; Maziar,25,0,45,20
1746608539319,MAE 101B,A00,886910,Saintillan; David,30,0,45,15
1746608540350,MAE 105,A00,886911,Bandaru; Prabhakar,18,0,50,32
1746608541376,MAE 107,B00,958024,Staff,7,0,50,43
1746608542409,MAE 143B,A00,886913,Bewley; Thomas R,2,0,40,38
1746608543437,MAE 148,A01,886915,Silberman; Jack,0,3,14,14
1746608544462,MAE 160,A00,886916,Evdokimenko; Ekaterina,30,0,60,30
1746608545490,MATH 3C,A01,889681,Staff,0,2,30,30
1746608545490,MATH 3C,A02,960048,Staff,23,0,30,7
1746608546524,MATH 10A,A01,889760,Staff,26,0,30,4
1746608546524,MATH 10A,A02,889783,Staff,29,0,30,1
1746608547561,MATH 10B,A01,889785,Verstraete; Jacques Allan,1,0,35,34
1746608547561,MATH 10B,A02,889795,Verstraete; Jacques Allan,4,0,35,31
1746608547561,MATH 10B,B01,889797,Verstraete; Jacques Allan,3,0,35,32
1746608547561,MATH 10B,B02,889828,Verstraete; Jacques Allan,3,0,35,32
1746608548596,MATH 10C,A01,889849,Habib; Yousaf,8,0,30,22
1746608548596,MATH 10C,A02,889852,Habib; Yousaf,14,0,30,16
1746608548596,MATH 10C,A03,889853,Habib; Yousaf,22,0,30,8
1746608548596,MATH 10C,A04,889858,Habib; Yousaf,20,0,30,10
1746608548596,MATH 10C,B01,889861,Staff,1,0,30,29
1746608548596,MATH 10C,B02,889862,Staff,24,0,30,6
1746608548596,MATH 10C,B03,889863,Staff,27,0,30,3
1746608548596,MATH 10C,B04,889967,Staff,23,0,30,7
1746608549626,MATH 18,A01,889974,Staff,6,0,30,24
1746608549626,MATH 18,A02,889977,Staff,20,0,30,10
1746608549626,MATH 18,B01,889984,Hardiman; Liam,20,0,30,10
1746608549626,MATH 18,B02,889985,Hardiman; Liam,25,0,30,5
1746608550654,MATH 20A,A01,889990,Suk; Andrew Hoon,30,0,35,5
1746608551682,MATH 20B,A01,889993,Ohm; Ko Woon,21,0,30,9
1746608551682,MATH 20B,A02,889994,Ohm; Ko Woon,30,0,30,0
1746608551682,MATH 20B,B01,889996,Ohm; Ko Woon,22,0,30,8
1746608551682,MATH 20B,B02,889997,Ohm; Ko Woon,23,0,30,7
1746608552709,MATH 20C,A01,889999,Hammock; Frances H,17,0,30,13
1746608552709,MATH 20C,A02,890003,Hammock; Frances H,23,0,30,7
1746608552709,MATH 20C,B01,890006,Hammock; Frances H,2,0,30,28
1746608552709,MATH 20C,B02,890007,Hammock; Frances H,11,0,30,19
1746608553742,MATH 20D,A01,890011,Cheng; Hsiao-Bing,1,0,30,29
1746608553742,MATH 20D,A02,890012,Cheng; Hsiao-Bing,14,0,30,16
1746608553742,MATH 20D,B01,890016,Cheng; Hsiao-Bing,13,0,30,17
1746608553742,MATH 20D,B02,890017,Cheng; Hsiao-Bing,13,0,30,17
1746608554771,MATH 20E,A01,890026,Harel; Guershon,1,0,30,29
1746608554771,MATH 20E,A02,890029,Harel; Guershon,22,0,30,8
1746608554771,MATH 20E,B01,890033,Harel; Guershon,7,0,30,23
1746608554771,MATH 20E,B02,890101,Harel; Guershon,21,0,30,9
1746608555800,MATH 102,A01,890104,Staff,18,0,30,12
1746608555800,MATH 102,A02,890105,Staff,27,0,30,3
1746608556834,MATH 103B,A01,890116,Salehi Golsefidy; Alireza,3,0,30,27
1746608556834,MATH 103B,B01,890118,Staff,0,3,34,34
1746608557864,MATH 109,A01,890121,Aliabadi Sr.; Mohsen,0,0,30,30
1746608557864,MATH 109,B01,890124,Upadrashta; Pranav Kumar,18,0,30,12
1746608558894,MATH 120A,A01,890126,Eggers; John Dietrich,13,0,30,17
1746608559925,MATH 142B,A01,890128,Ioana; Adrian,19,0,30,11
1746608559925,MATH 142B,A02,890129,Ioana; Adrian,12,0,30,18
1746608560951,MATH 154,A01,890174,Staff,0,1,30,30
1746608560951,MATH 154,A02,890182,Staff,0,0,30,30
1746608561983,MATH 168A,A01,890197,Dumitriu; Ioana,21,0,35,14
1746608563012,MATH 170A,A01,890240,Nie; Jiawang,1,0,30,29
1746608563012,MATH 170A,A02,890241,Nie; Jiawang,11,0,30,19
1746608563012,MATH 170A,A03,890249,Nie; Jiawang,23,0,30,7
1746608564041,MATH 170B,A01,957891,Nag; Panchali,13,0,35,22
1746608566102,MATH 181A,A01,908025,Staff,0,3,35,35
1746608566102,MATH 181A,A02,960115,Staff,26,0,35,9
1746608567130,MATH 181B,A01,959874,Staff,24,0,30,6
1746608568158,MATH 193B,A01,890265,Staff,0,4,35,35
1746608569186,MGT 4,A01,890311,Anderson; John Charles,42,0,88,46
1746608570214,MGT 5,A00,907740,Staff,12,0,98,86
1746608571241,MGT 12,A00,890312,Lindenberger; Wade Douglas,67,0,98,31
1746608572266,MGT 16,A00,957883,Staff,78,0,98,20
1746608574324,MGT 45,A00,890314,Pecore; Joseph P.,45,0,98,53
1746608575350,MGT 71,A00,890315,Staff,0,12,98,98
1746608576379,MGT 100,A00,890316,Yavorsky; Daniel Ryan,44,0,98,54
1746608577405,MGT 103,A00,890317,Ehrich; Kristine R,73,0,98,25
1746608578432,MGT 105,A00,890356,Bates; Kenneth Walter,0,8,98,98
1746608579459,MGT 112,A00,890360,Ehrich; Kristine R,55,0,98,43
1746608580493,MGT 127R,A00,907732,Zhu; Kevin Xiaoguo,23,0,98,75
1746608581520,MGT 131B,A00,890361,Anderson; John Charles,59,0,98,39
1746608582549,MGT 137,A00,890362,Lindenberger; Wade Douglas,65,0,98,33
1746608583580,MGT 160,A00,890369,Johnson; Erik Barry,9,0,98,89
1746608585641,MGT 164,A00,890372,Zimmermann; Carsten,0,40,98,98
1746608586669,MGT 180,A00,890374,Bliss; Barbara Ann,11,0,98,87
1746608587703,MMW 15,A01,886414,Chang; Edmond Yi-Teh,0,12,28,28
1746608587703,MMW 15,A02,886415,Chang; Edmond Yi-Teh,0,8,28,28
1746608587703,MMW 15,A03,886416,Chang; Edmond Yi-Teh,0,9,28,28
1746608587703,MMW 15,A04,886417,Chang; Edmond Yi-Teh,0,8,28,28
1746608587703,MMW 15,B01,886419,Chang; Edmond Yi-Teh,0,7,28,28
1746608587703,MMW 15,B02,886420,Chang; Edmond Yi-Teh,0,7,28,28
1746608587703,MMW 15,B03,886421,Chang; Edmond Yi-Teh,0,7,28,28
1746608587703,MMW 15,B04,886422,Chang; Edmond Yi-Teh,0,8,28,28
1746608587703,MMW 15,C01,886424,Staff,0,9,28,28
1746608587703,MMW 15,C02,886425,Staff,0,8,28,28
1746608587703,MMW 15,C03,886426,Staff,0,8,28,28
1746608587703,MMW 15,C04,886427,Staff,0,8,28,28
1746608587703,MMW 15,C05,958038,Staff,0,8,28,28
1746608587703,MMW 15,C06,958039,Staff,0,7,28,28
1746608588731,MMW 15GS,A00,906910,Patterson; Patrick H.,4,0,28,24
1746608589761,MMW 122R,A01,886429,Rahimi; Babak,0,13,28,28
1746608589761,MMW 122R,A02,886430,Rahimi; Babak,0,12,28,28
1746608589761,MMW 122R,A03,958040,Rahimi; Babak,0,11,28,28
1746608590802,MUS 1A,A01,890937,Staff,2,0,25,23
1746608590802,MUS 1A,A02,891035,Staff,6,0,25,19
1746608590802,MUS 1A,C01,958912,Staff,24,0,25,1
1746608590802,MUS 1A,C02,958913,Staff,25,0,25,0
1746608592858,MUS 2AK,A00,957092,Ohnishi; Takae,15,0,15,0
1746608593885,MUS 4,A01,891044,Staff,0,0,25,25
1746608593885,MUS 4,A02,891045,Staff,22,0,25,3
1746608593885,MUS 4,B01,891048,Staff,17,0,25,8
1746608593885,MUS 4,B02,891050,Staff,25,0,25,0
1746608594913,MUS 5,A01,957506,Dubnov; Shlomo,0,0,25,25
1746608594913,MUS 5,A02,957622,Dubnov; Shlomo,12,0,25,13
1746608594913,MUS 5,A03,957623,Dubnov; Shlomo,20,0,25,5
1746608595940,MUS 6,A01,891053,Freitas Caetano; Marcelo,24,0,25,1
1746608595940,MUS 6,A02,891054,Freitas Caetano; Marcelo,23,0,25,2
1746608597023,MUS 7,A01,891081,Staff,0,0,25,25
1746608597023,MUS 7,A02,891082,Staff,3,0,25,22
1746608598055,MUS 8GS,A00,891118,Borgo; David Garcia,1,0,25,24
1746608599082,MUS 11,A01,891140,Staff,8,0,25,17
1746608599082,MUS 11,A02,891141,Staff,21,0,25,4
1746608600107,MUS 13,A01,891143,Staff,8,0,25,17
1746608600107,MUS 13,A02,891144,Staff,24,0,25,1
1746608601139,MUS 15,A01,891146,Staff,9,0,25,16
1746608601139,MUS 15,A02,891148,Staff,21,0,25,4
1746608601139,MUS 15,B01,891150,Staff,18,0,25,7
1746608601139,MUS 15,B02,891151,Staff,25,0,25,0
1746608602170,MUS 20,A01,891153,Staff,5,0,20,15
1746608602170,MUS 20,A02,891155,Staff,14,0,20,6
1746608603195,MUS 80,A00,891156,Staff,19,0,25,6
1746608603195,MUS 80,B00,891157,Staff,23,0,25,2
1746608604222,MUS 130,A00,891158,Ohnishi; Takae,35,0,35,0
1746608605248,MUS 150GS,A01,891160,Borgo; David Garcia,1,0,25,24
1746608606277,MUS 170,A01,891162,Freitas Caetano; Marcelo,20,0,25,5
1746608606277,MUS 170,A02,891164,Freitas Caetano; Marcelo,21,0,25,4
1746608607304,NANO 11,A00,886220,Vazquez Mena; Oscar,13,0,15,2
1746608608331,NANO 15,A01,886222,Drews; Aaron,4,0,7,3
1746608609358,NANO 104,A00,886224,Sirbuly; Donald,17,0,25,8
1746608610387,PH 40,A00,886528,Staff,23,0,40,17
1746608611419,PH 45,A01,886799,Staff,35,0,40,5
1746608612450,PH 110,A00,886802,Staff,0,6,40,40
1746608613477,PH 172,A00,906716,Staff,19,0,35,16
1746608614511,PH 191,A00,886803,Staff,6,0,40,34
1746608615540,PHIL 1,A00,889500,Staff,20,0,30,10
1746608616570,PHIL 10,A01,889549,Grush; Rick Scott,16,0,22,6
1746608616570,PHIL 10,A02,889551,Grush; Rick Scott,22,0,22,0
1746608617606,PHIL 28,A01,889559,Lamey; Andy M.,0,2,31,31
1746608617606,PHIL 28,A02,889561,Lamey; Andy M.,0,1,30,30
1746608617606,PHIL 28,A03,889572,Lamey; Andy M.,0,1,30,30
1746608618636,PHIL 35,A00,907839,Staff,13,0,15,2
1746608619662,PHIL 60,A00,889574,Staff,73,0,90,17
1746608620689,PHIL 101,A00,958004,Staff,12,0,15,3
1746608622750,PHIL 136,A00,889582,Fulkerson; Matthew Todd,26,0,45,19
1746608623778,PHIL 163,A01,889601,Staff,21,0,30,9
1746608623778,PHIL 163,B01,889606,Brandt; Reuven A,0,3,0,0
1746608624805,PHIL 164,A00,889610,Staff,16,0,30,14
1746608625832,PHIL 165,A00,889613,Staff,22,0,30,8
1746608626859,PHYS 1A,A00,886431,Staff,30,0,70,40
1746608627888,PHYS 1AL,001,886432,Tsai; Philbert S,0,1,30,30
1746608627888,PHYS 1AL,002,886436,Tsai; Philbert S,13,0,30,17
1746608628917,PHYS 1B,A00,886439,Staff,184,0,240,56
1746608629944,PHYS 1BL,001,886441,Tsai; Philbert S,0,4,30,30
1746608629944,PHYS 1BL,002,886444,Tsai; Philbert S,2,0,30,28
1746608630973,PHYS 1C,A00,896092,Arnold; Kam S,78,0,146,68
1746608632005,PHYS 1CL,001,886448,Tsai; Philbert S,0,0,30,30
1746608632005,PHYS 1CL,002,886449,Tsai; Philbert S,1,0,30,29
1746608632005,PHYS 1CL,003,886450,Tsai; Philbert S,16,0,30,14
1746608632005,PHYS 1CL,004,886451,Tsai; Philbert S,15,0,30,15
1746608633037,PHYS 2B,A01,886457,Staff,67,0,115,48
1746608634068,PHYS 2C,A01,886460,Shotwell; Brian,0,9,65,65
1746608635100,PHYS 2CL,A01,886467,Staff,0,4,28,28
1746608635100,PHYS 2CL,A02,886468,Staff,0,3,28,28
1746608636130,PHYS 2D,A01,886470,Staff,10,0,50,40
1746608637158,PHYS 4B,A01,886475,Grinstein; Benjamin,22,0,40,18
1746608638194,POLI 5,A00,891173,Desposato; Scott,7,0,25,18
1746608639222,POLI 5D,A01,891175,Staff,5,0,5,0
1746608639222,POLI 5D,B01,891178,Staff,5,0,5,0
1746608640253,POLI 11,A00,891179,Ferree; Karen E,0,0,35,35
1746608641279,POLI 12,A00,891180,Staff,15,0,30,15
1746608642307,POLI 27,A01,891182,Staff,11,0,75,64
1746608643335,POLI 30,A00,891183,Staff,8,0,50,42
1746608644360,POLI 100B,A00,891244,Staff,5,1,35,30
1746608645387,POLI 100I,A00,891247,Staff,7,0,30,23
1746608646412,POLI 104J,A00,891248,Nichter; Maysa,14,0,30,16
1746608647442,POLI 104U,A00,891250,Nichter; Maysa,1,0,30,29
1746608649499,POLI 110B,A00,891255,Wiens; David,19,0,25,6
1746608650525,POLI 112A,A00,891256,Wiens; David,6,0,25,19
1746608651554,POLI 114BR,A00,891261,Staff,19,0,30,11
1746608652580,POLI 117R,A00,891262,Forman; Fonna,0,6,50,50
1746608653611,POLI 118,A00,891264,Ingham; Sean,17,0,25,8
1746608654637,POLI 124A,A00,891265,Staff,18,0,20,2
1746608655667,POLI 125D,A00,891266,Nichter; Simeon C,2,0,25,23
1746608656693,POLI 126,A00,891268,Nichter; Simeon C,7,0,25,18
1746608657722,POLI 126AA,A00,891272,Staff,15,0,25,10
1746608658751,POLI 130AA,A00,891273,Staff,15,0,20,5
1746608659778,POLI 134AA,A00,891274,Staff,4,0,20,16
1746608661834,POLI 138,A00,891278,Staff,21,0,25,4
1746608662860,POLI 142K,A00,891280,Staff,10,0,25,15
1746608663888,POLI 142M,A00,891281,Gartzke; Erik,16,0,30,14
1746608664916,POLI 142P,A00,891284,Staff,20,0,30,10
1746608665943,POLI 143,A00,891285,Gartzke; Erik,12,0,30,18
1746608666973,POLI 153,A00,891286,Staff,19,0,20,1
1746608669027,POLI 175,A00,891290,Staff,15,0,20,5
1746608670054,PSYC 1,A00,890674,Steiner; Eric Tomas,0,11,45,45
1746608671086,PSYC 2,A00,890676,Albright; Thomas D,20,0,35,15
1746608672118,PSYC 3,A00,890679,Staff,17,0,20,3
1746608673145,PSYC 6,A00,959858,Staff,19,0,20,1
1746608674174,PSYC 60,A01,890684,Rickard; Timothy C.,0,6,45,45
1746608675200,PSYC 70,A01,890689,Geller; Emma Harlan,6,0,30,24
1746608676228,PSYC 71,A01,959860,Staff,21,0,25,4
1746608677253,PSYC 100,A00,890690,Lacefield; Katharine I,0,50,180,180
1746608678279,PSYC 102,A00,890695,Staff,18,0,40,22
1746608679306,PSYC 105,A00,890699,Geller; Emma Harlan,70,0,100,30
1746608680338,PSYC 106,A00,890701,Gorman; Michael R.,5,0,30,25
1746608681365,PSYC 108,A00,890704,Adrian; Julia Anna,0,29,50,50
1746608682391,PSYC 118,A01,890712,Staff,11,0,30,19
1746608683418,PSYC 124,A00,890716,Chapman; Eddie Nathaniel,25,0,60,35
1746608684444,PSYC 131,A00,890717,Anagnostaras; Stephan,0,7,80,80
1746608685476,PSYC 137,A00,890719,Winkielman; Piotr,0,11,30,30
1746608686502,PSYC 144,A00,890721,Adrian; Julia Anna,0,9,45,45
1746608687531,PSYC 162,A00,890805,Staff,0,2,75,75
1746608688560,PSYC 169,A00,890810,Staff,0,15,30,30
1746608689586,PSYC 172,A00,890814,Gorman; Michael R.,9,0,30,21
1746608690612,PSYC 181,A00,890818,Anagnostaras; Stephan,6,0,200,194
1746608691638,PSYC 184,A00,959861,Staff,160,0,175,15
1746608692669,PSYC 189,A00,890823,Staff,0,2,30,30
1746608693696,PSYC 191,A00,890884,Rickard; Timothy C.,0,12,35,35
1746608694723,PSYC 193,A00,890913,Staff,19,0,30,11
1746608694723,PSYC 193,B00,890914,Chapman; Eddie Nathaniel,24,0,30,6
1746608695755,PSYC 193L,A01,890918,Lowe; Angela Beth,20,0,30,10
1746608695755,PSYC 193L,B01,890921,Hurwitz; Ethan Scott,20,0,30,10
1746608695755,PSYC 193L,C01,890928,Staff,30,0,30,0
1746608696787,RELI 149,A00,886806,Rahimi; Babak,23,0,40,17
1746608697812,SE 9,A01,886814,Staff,7,0,20,13
1746608698840,SE 101B,A01,886816,Chadha; Mayank,3,0,35,32
1746608699867,SE 110B,A00,886818,Zhu; Qiang,4,0,75,71
1746608700937,SE 125,A01,886830,Staff,10,0,30,20
1746608701964,SE 130B,A01,886835,Staff,14,0,40,26
1746608703003,SE 131A,A01,886838,Krysl; Petr,34,0,55,21
1746608704031,SE 154,A00,886840,Staff,28,0,50,22
1746608705059,SE 164GS,A01,886849,Staff,6,0,20,14
1746608706087,SE 167GS,A01,886853,Staff,6,0,20,14
1746608707115,SIO 25,A01,890107,Staff,19,0,30,11
1746608708143,SIO 45,A00,890109,Cook; Geoffrey W,114,0,200,86
1746608709175,SIO 109R,A00,890110,Forman; Fonna,0,16,20,20
1746608710205,SIO 187,A01,890114,Kacev; David,15,0,40,25
1746608711234,SOCI 1,A01,890431,Thorpe; Charles Robert,14,0,30,16
1746608711234,SOCI 1,A02,890518,Thorpe; Charles Robert,30,0,30,0
1746608712262,SOCI 2,A01,957978,Staff,25,0,25,0
1746608712262,SOCI 2,A02,957979,Staff,23,0,25,2
1746608713290,SOCI 20,A01,890523,Calderon-Zaks; Michael Aar,21,0,30,9
1746608713290,SOCI 20,A02,890526,Calderon-Zaks; Michael Aar,29,0,30,1
1746608714321,SOCI 30,A01,890533,Pardo Guerra; Juan Pablo,37,0,40,3
1746608715348,SOCI 40,A01,890535,Staff,27,0,45,18
1746608716374,SOCI 104Q,A00,890559,Staff,17,0,30,13
1746608717404,SOCI 106,A00,890560,Arnal; Maud Marie Leonie,20,0,30,10
1746608718429,SOCI 110,A00,890567,Holkenbrink-Monk; Charlene,19,0,30,11
1746608719455,SOCI 112,A00,890568,Victoria Torres; Pablo,2,0,55,53
1746608720484,SOCI 115,A00,890597,Arnal; Maud Marie Leonie,28,0,45,17
1746608722540,SOCI 121,A00,890604,Pardo Guerra; Juan Pablo,38,0,45,7
1746608723566,SOCI 126,A01,890608,Staff,8,0,10,2
1746608724597,SOCI 127,A00,890609,Staff,18,0,30,12
1746608725625,SOCI 131,A00,890610,Thorpe; Charles Robert,37,0,45,8
1746608726651,SOCI 135,A00,890615,Payne; Christine Anna,14,0,45,31
1746608727680,SOCI 139,A00,890620,Staff,38,0,45,7
1746608728706,SOCI 148E,A00,890622,Calderon-Zaks; Michael Aar,36,0,45,9
1746608729738,SOCI 150,A00,890623,Kohler; Kristopher M.,31,0,45,14
1746608730769,SOCI 157,A00,890625,Jules-Rosette; Bennetta W.,18,0,20,2
1746608731795,SOCI 160,A00,890627,Payne; Christine Anna,21,0,45,24
1746608732829,SYN 1,A00,886855,Fish; Gwendolyn Anne,0,1,0,0
1746608732829,SYN 1,B00,906086,Fish; Gwendolyn Anne,0,2,0,2
1746608733862,SYN 2R,A00,886860,Staff,0,17,15,15
1746608733862,SYN 2R,B00,906106,Atkinson; Arthur Laird,0,16,15,15
1746608734897,SYN 100,A01,886866,Browne; Emily,0,28,20,20
1746608734897,SYN 100,B01,906128,Rock; Martin,0,4,20,20
1746608734897,SYN 100,C01,906140,Deavenport; James Cary,0,4,20,20
1746608734897,SYN 100,D01,907816,Deavenport; James Cary,0,5,20,20
1746608735926,TDAC 1,A00,890286,Walsh; Kim C.,7,0,20,13
1746608736953,TDAC 101,A00,890296,Basso; Beatrice,15,0,20,5
1746608737983,TDDE 131,A00,890297,Staff,47,0,50,3
1746608739013,TDDM 1,A00,890287,Weinberg; Sadie,25,0,30,5
1746608740039,TDGE 11,A00,890288,Fulton; Julia,138,0,200,62
1746608740039,TDGE 11,B00,890289,Castro; Robert Jess,184,0,200,16
1746608741066,TDGE 25,B00,957359,Walsh; Kim C.,5,0,20,15
1746608742096,TDGE 40,A01,890292,Power; Jade Yukana,26,0,30,4
1746608743121,TDGE 124,A00,890298,Havis; Allan,0,2,50,50
1746608744149,TDGE 131R,A00,890299,Burelle; Julie Sara Veronique,15,0,42,27
1746608745175,TDHT 101,A00,890300,Staff,10,0,20,10
1746608746204,TDHT 109,A01,890302,Anderson; Mysia Anyse,31,0,40,9
1746608747236,TDMV 1,A00,890293,Arcidiacono; Kristin,18,0,30,12
1746608748262,TDMV 2,A00,890294,Weinberg; Sadie,23,0,30,7
1746608749290,TDMV 3,A00,957878,Arcidiacono; Kristin,28,0,30,2
1746608751341,TDMV 138,A00,890304,Jun; Grace Shin Hae,25,0,40,15
1746608752367,TDMV 140,A00,890305,Corrales; Joseph Bernales,25,0,30,5
1746608753396,TDMV 142,A00,890307,Caligagan; Tony,32,0,40,8
1746608754423,TDMV 144,A00,890308,Camaya; Michelle Ann,25,0,30,5
1746608755449,TDPW 1,A00,890295,Stein; Deborah Isobel,3,0,20,17
1746608756477,USP 2,A01,890272,Lerner; Amy M,7,0,20,13
1746608757504,USP 3,A01,890274,Staff,12,0,30,18
1746608758535,USP 15,A01,890276,Sun; Feiyang,16,0,30,14
1746608759562,USP 25,A00,890277,Shenkman; Michael Thomas,18,0,25,7
1746608760589,USP 138,A00,890278,Staff,13,0,25,12
1746608761617,USP 143,A00,890279,Staff,21,0,70,49
1746608762650,USP 144,A00,890280,Chowdhury; Muhammed Zohir,16,0,30,14
1746608763675,USP 150,A00,890281,Boomhower; Matthew Charles,4,0,30,26
1746608764701,USP 151,A00,890282,Staff,16,0,20,4
1746608765728,USP 162,A00,890283,Andrews; Abigail Leslie,16,0,20,4
1746608766757,USP 168,A00,920477,Kwak; Nancy,0,0,5,5
1746608767784,USP 181,A00,890284,Staff,3,0,20,17
1746608768810,USP 191A,A00,890285,Staff,12,0,20,8
1746608769837,VIS 101,A00,886512,Staff,26,0,75,49
1746608770869,VIS 103,A00,886513,Cruz; Edwin Teddy,61,0,75,14
1746608771899,VIS 108,A00,886514,Staff,4,0,15,11
1746608772931,VIS 127P,A00,886515,Shen; Kuiyi,80,0,146,66
1746608773968,VIS 149,A00,886516,Yoldas; Pinar,0,0,15,15
1746608775002,VIS 164,A00,886526,Erdmann; Dean,19,0,22,3
1746608776032,VIS 194S,A00,886527,Staff,61,0,75,14
1746608777064,WCWP 10A,C00,886484,Martiniuk; Jill,12,0,15,3
1746608778097,WCWP 10B,A00,886490,Uriarte; Emma,0,0,15,15
1746608778097,WCWP 10B,B00,886491,Dhir; Simrita,8,0,15,7
1746608778097,WCWP 10B,C00,886492,Ornelas; Tricia,0,0,15,15
1746608779125,WCWP 100,A00,886494,Young; Mark T,0,6,15,15
1746608781229,AAS 10,A01,886199,Childs; Dennis R.,0,3,0,0
1746608782256,ANAR 104,A01,886940,Shtienberg; Gilad,27,0,30,3
1746608783283,ANAR 120,A00,886953,Staff,13,0,20,7
1746608784311,ANBI 148,A01,886955,Wilder; Linnea Lorene,30,0,40,10
1746608786367,ANSC 122,A00,886957,Staff,24,0,30,6
1746608787397,ANSC 150,A00,886958,Sloane; Julia Kathryn,2,0,15,13
1746608788428,ANSC 156,A00,886959,Jenkins; Janis A.,0,1,15,15
1746608789454,ANSC 180,A00,886960,Staff,11,0,17,6
1746608790481,ANSC 188,A00,886961,Jassal; Aftab,9,0,25,16
1746608791505,ANSC 190,A00,886962,Jassal; Aftab,14,0,25,11
1746608792531,ANSC 191,A00,886963,Staff,18,0,20,2
1746608793557,ANTH 3,A01,891689,Staff,17,0,20,3
1746608794586,ANTH 5,A00,886933,Semendeferi; Ekaterini,16,0,20,4
1746608795614,ANTH 10,A00,886934,Staff,0,12,30,30
1746608796643,ANTH 21,A01,886936,Staff,41,0,60,19
1746608797672,ANTH 23,A01,886938,Staff,92,0,100,8
1746608798701,ANTH 105,A00,886964,Stewart; Alexander B,84,0,100,16
1746608799728,ANTH 108,A00,886965,Pedersen; David,9,0,20,11
1746608800758,AWP 10,001,886147,Staff,0,0,0,0
1746608800758,AWP 10,002,886148,Staff,0,0,0,0
1746608800758,AWP 10,003,886149,Staff,0,0,0,0
1746608800758,AWP 10,004,886150,Staff,0,0,0,0
1746608800758,AWP 10,005,886151,Staff,0,0,0,0
1746608800758,AWP 10,006,886152,Staff,0,0,0,0
1746608800758,AWP 10,007,886153,Staff,0,0,0,0
1746608800758,AWP 10,008,886154,Staff,0,0,0,0
1746608800758,AWP 10,009,886155,Staff,0,0,0,0
1746608800758,AWP 10,010,886156,Staff,0,0,0,0
1746608800758,AWP 10,011,886158,Staff,0,0,0,0
1746608800758,AWP 10,012,886160,Staff,0,0,0,0
1746608800758,AWP 10,013,886161,Staff,0,0,0,0
1746608800758,AWP 10,014,886162,Staff,0,0,0,0
1746608800758,AWP 10,015,886163,Staff,0,0,0,0
1746608800758,AWP 10,016,886164,Staff,0,0,0,0
1746608800758,AWP 10,017,886165,Staff,0,0,0,0
1746608800758,AWP 10,018,886166,Staff,0,0,0,0
1746608800758,AWP 10,019,886168,Staff,0,0,0,0
1746608800758,AWP 10,020,886170,Staff,0,0,0,0
1746608800758,AWP 10,021,886172,Staff,0,0,0,0
1746608801801,AWP 10R,001,886173,Staff,0,1,0,0
1746608801801,AWP 10R,002,886174,Staff,0,1,0,0
1746608801801,AWP 10R,003,886175,Staff,0,0,0,0
1746608801801,AWP 10R,004,886176,Staff,0,0,0,0
1746608801801,AWP 10R,005,886177,Staff,0,0,0,0
1746608801801,AWP 10R,006,886178,Staff,0,0,0,0
1746608801801,AWP 10R,007,886179,Staff,0,0,0,0
1746608801801,AWP 10R,008,886181,Staff,0,0,0,0
1746608801801,AWP 10R,009,886182,Staff,0,0,0,0
1746608801801,AWP 10R,010,886183,Staff,0,0,0,0
1746608801801,AWP 10R,011,886184,Staff,0,0,0,0
1746608801801,AWP 10R,012,886185,Staff,0,0,0,0
1746608801801,AWP 10R,013,886186,Staff,0,0,0,0
1746608801801,AWP 10R,014,886187,Staff,0,0,0,0
1746608801801,AWP 10R,015,886188,Staff,0,0,0,0
1746608801801,AWP 10R,016,886189,Staff,0,0,0,0
1746608801801,AWP 10R,017,960532,Staff,0,0,0,0
1746608801801,AWP 10R,018,960533,Staff,0,0,0,0
1746608801801,AWP 10R,019,960534,Staff,0,0,0,0
1746608801801,AWP 10R,020,960538,Staff,0,0,0,0
1746608801801,AWP 10R,021,960540,Staff,0,0,0,0
1746608801801,AWP 10R,022,960541,Staff,0,0,0,0
1746608801801,AWP 10R,023,960542,Staff,0,0,0,0
1746608801801,AWP 10R,024,960544,Staff,0,0,0,0
1746608801801,AWP 10R,025,960545,Staff,0,0,0,0
1746608801801,AWP 10R,026,960548,Staff,0,0,0,0
1746608802830,AWP 102R,A00,886190,Staff,0,0,0,0
1746608802830,AWP 102R,B00,886191,Staff,0,0,0,0
1746608803859,BENG 100,A01,886193,Staff,17,0,30,13
1746608804929,BENG 122A,A01,886195,Hasty; Jeff M,13,0,30,17
1746608805957,BENG 166A,A00,886196,Sah; Robert Lie-Yuan,0,3,30,30
1746608806984,BENG 190,A00,958050,Khojah; Reem I,17,0,25,8
1746608808011,BIBC 102,A01,894320,Staff,0,1,46,46
1746608808011,BIBC 102,A02,894321,Staff,0,0,46,46
1746608808011,BIBC 102,A03,894344,Staff,6,0,46,40
1746608808011,BIBC 102,A04,894345,Staff,27,0,47,20
1746608809046,BICD 100R,A01,894365,Smith; Laurie,0,2,58,58
1746608809046,BICD 100R,A02,894366,Smith; Laurie,0,4,58,58
1746608809046,BICD 100R,A03,894367,Smith; Laurie,0,0,59,59
1746608809046,BICD 100R,A04,959869,Smith; Laurie,38,0,59,21
1746608810082,BICD 136,A01,894383,Gustafson-Brown; Cindy,14,0,50,36
1746608811111,BIEB 102,A01,894494,Butler; Shannon Rhey,51,0,130,79
1746608813176,BIEB 150,A01,894617,Wills; Christopher,3,0,20,17
1746608813176,BIEB 150,A02,894631,Wills; Christopher,3,0,20,17
1746608813176,BIEB 150,A03,894937,Wills; Christopher,3,0,20,17
1746608813176,BIEB 150,A04,894946,Wills; Christopher,5,0,20,15
1746608814205,BIEB 194,A00,906141,Kurle; Carolyn M.,5,0,20,15
1746608815232,BILD 1,A01,894154,Staff,3,0,19,16
1746608815232,BILD 1,A02,894155,Staff,14,0,19,5
1746608815232,BILD 1,A03,894160,Staff,13,0,19,6
1746608815232,BILD 1,A04,894161,Staff,15,0,18,3
1746608816258,BILD 2,A01,894168,Staff,0,0,50,50
1746608816258,BILD 2,A02,894169,Staff,0,0,50,50
1746608816258,BILD 2,A03,894179,Staff,0,0,50,50
1746608816258,BILD 2,A04,894203,Staff,22,0,50,28
1746608817285,BILD 3,A01,894213,Staff,23,0,31,8
1746608817285,BILD 3,A02,894214,Staff,26,0,31,5
1746608817285,BILD 3,A03,894235,Staff,28,0,31,3
1746608817285,BILD 3,A04,894236,Staff,28,0,32,4
1746608818314,BILD 4,A01,894253,Reuther; Keefe,5,0,24,19
1746608818314,BILD 4,A02,894258,Reuther; Keefe,16,0,24,8
1746608819346,BILD 5,A01,894276,Reuther; Keefe,33,0,50,17
1746608819346,BILD 5,A02,894277,Reuther; Keefe,45,0,50,5
1746608819346,BILD 5,A03,894290,Reuther; Keefe,44,0,50,6
1746608819346,BILD 5,A04,894291,Reuther; Keefe,48,0,50,2
1746608820376,BILD 24,A01,894297,Pirino; Giorgia,40,0,60,20
1746608821401,BIMM 100,B01,958915,Staff,71,0,100,29
1746608822429,BIMM 101,A01,895017,McDonnell; Lisa Marie,0,5,24,24
1746608822429,BIMM 101,A02,895018,McDonnell; Lisa Marie,0,5,24,24
1746608822429,BIMM 101,B01,895020,McDonnell; Lisa Marie,0,5,24,24
1746608822429,BIMM 101,B02,895021,McDonnell; Lisa Marie,0,4,24,24
1746608823455,BIMM 110,A01,895023,Staff,1,0,25,24
1746608823455,BIMM 110,A02,895024,Staff,9,0,25,16
1746608823455,BIMM 110,A03,895025,Staff,18,0,25,7
1746608823455,BIMM 110,A04,895031,Staff,20,0,25,5
1746608824480,BIMM 120,A01,895114,Gustafson-Brown; Cindy,14,0,28,14
1746608824480,BIMM 120,A02,895126,Gustafson-Brown; Cindy,21,0,27,6
1746608825507,BIPN 100,A01,895130,Yang; Mingyu,0,0,38,38
1746608825507,BIPN 100,A02,895131,Yang; Mingyu,31,0,38,7
1746608825507,BIPN 100,A03,895132,Yang; Mingyu,32,0,38,6
1746608825507,BIPN 100,A04,895133,Yang; Mingyu,27,0,36,9
1746608826535,BIPN 120,A01,895135,Cooke; James Edward,0,3,13,13
1746608826535,BIPN 120,A02,895136,Cooke; James Edward,0,1,13,13
1746608826535,BIPN 120,A03,895137,Cooke; James Edward,0,3,13,13
1746608826535,BIPN 120,A04,895156,Cooke; James Edward,0,2,11,11
1746608827562,BIPN 134,A01,895235,Cooke; James Edward,0,1,25,25
1746608827562,BIPN 134,A02,895237,Cooke; James Edward,0,0,25,25
1746608827562,BIPN 134,A03,895240,Cooke; James Edward,1,0,25,24
1746608827562,BIPN 134,A04,895270,Cooke; James Edward,20,0,25,5
1746608828589,BIPN 189,A00,892103,Staff,0,14,14,14
1746608830647,BISP 194,A00,958008,Staff,0,2,0,0
1746608831673,CAT 124,A01,922009,Staff,0,5,20,20
1746608832703,CAT 125R,A00,886390,Morales; Celeste Georgianna,0,4,20,20
1746608832703,CAT 125R,B00,886391,Irwin; Matthew Joseph,0,4,20,20
1746608832703,CAT 125R,C00,886392,Smith; Lauryn Alissa,0,2,20,20
1746608832703,CAT 125R,D00,886393,Vanderschuit; Maya Alysia,0,3,20,20
1746608832703,CAT 125R,E00,886394,Marchisotto; Jennifer Anne,0,3,20,20
1746608833731,CENG 15,A01,886218,Drews; Aaron,3,0,8,5
1746608834757,CENG 113,A00,886219,Opatkiewicz; Justin Paul,15,0,25,10
1746608835785,CGS 101,A00,887044,Staff,7,0,20,13
1746608836809,CGS 105,A01,887046,Staff,14,0,25,11
1746608837837,CGS 112,A00,887047,Cuong; Marisol,12,0,15,3
1746608838862,CGS 113,A00,887048,Staff,23,0,30,7
1746608839889,CGS 120,A00,887049,Staff,9,0,17,8
1746608840920,CHEM 6A,A01,886336,Lam; Tin Yiu,38,0,50,12
1746608840920,CHEM 6A,A02,886338,Lam; Tin Yiu,37,0,50,13
1746608841952,CHEM 6B,A01,886341,Hopkins; Patrycja Anna,16,0,50,34
1746608841952,CHEM 6B,A02,886343,Hopkins; Patrycja Anna,42,0,50,8
1746608842984,CHEM 6C,A01,886346,Albizati; Kim F.,0,2,50,50
1746608842984,CHEM 6C,A02,886348,Albizati; Kim F.,24,0,50,26
1746608844014,CHEM 40A,A01,886352,Klosterman; Jeremy K,65,0,100,35
1746608845041,CHEM 40B,A01,886356,Klosterman; Jeremy K,0,24,100,100
1746608846072,CHEM 41B,A01,886360,Theodorakis; Emmanuel,25,0,50,25
1746608846072,CHEM 41B,A02,886362,Theodorakis; Emmanuel,47,0,50,3
1746608847099,CHIN 165A,A00,886382,Xu; Li,18,0,20,2
1746608848129,CLAS 120,A00,886387,Myerston Santana; Jacobo,33,0,40,7
1746608849161,COGS 9,A01,886967,Shannon; Kyle Michael,42,0,60,18
1746608850185,COGS 11,A01,886969,Staff,9,0,30,21
1746608851210,COGS 14A,A01,886971,Staff,5,0,60,55
1746608852235,COGS 14B,A01,886973,Hoffman; Drew Ellen,4,0,60,56
1746608853260,COGS 18,A01,886975,Morgan; Eric,34,0,60,26
1746608854286,COGS 20,A01,886977,Staff,3,0,8,5
1746608854286,COGS 20,A02,886978,Staff,5,0,7,2
1746608855315,COGS 100,A01,907783,Staff,0,1,30,30
1746608856341,COGS 101B,A01,886980,Staff,0,4,48,48
1746608857374,COGS 101C,A01,886982,Delgado; Tania,0,5,44,44
1746608858405,COGS 102A,A01,886984,Johnson; Christine M.,3,0,30,27
1746608859434,COGS 118B,A01,886986,Staff,0,4,88,88
1746608860459,COGS 150,A01,886988,Bergen; Benjamin,22,0,50,28
1746608861487,COGS 153,A00,886989,Delgado; Tania,1,3,41,40
1746608862513,COGS 186,A01,886991,Staff,0,0,32,32
1746608863539,COGS 187A,A01,886993,Boyle; Mary E. T.,7,0,30,23
1746608864565,COGS 189,A00,886994,Staff,0,1,30,30
1746608865594,COMM 10,A01,886996,Staff,0,0,20,21
1746608865594,COMM 10,A02,886997,Staff,10,0,20,10
1746608865594,COMM 10,A03,959845,Staff,19,0,20,1
1746608866621,COMM 20,A01,886999,Leuning; Grant Maurstad,24,0,40,16
1746608868679,COMM 100A,A01,887002,Staff,0,0,20,25
1746608868679,COMM 100A,A02,887003,Staff,5,0,20,15
1746608869705,COMM 100B,A01,887005,Staff,0,8,20,24
1746608870734,COMM 106D,A00,887006,Staff,14,0,40,26
1746608871762,COMM 110G,A00,887007,Whitworth-Smith; Andrew C,12,0,40,28
1746608872787,COMM 111B,A00,887008,Staff,31,0,40,9
1746608873817,COMM 113T,A00,887009,Abuelhiga; Soraya Jill,28,0,40,12
1746608873817,COMM 113T,B00,906733,Staff,39,0,40,1
1746608874844,COMM 145,A00,887010,Staff,13,0,40,27
1746608875872,COMM 146,A00,887054,Staff,32,0,40,8
1746608876928,COMM 190,A00,887012,Staff,8,0,23,15
1746608877955,CSE 8A,A50,887015,Cao; Yingjun,56,0,85,29
1746608878986,CSE 11,A01,887017,Cao; Yingjun,11,0,70,59
1746608880013,CSE 20,A01,887019,Staff,30,0,50,20
1746608881040,CSE 21,A01,887021,Staff,79,0,100,21
1746608881040,CSE 21,B01,892583,Braun; Oliver,45,0,50,5
1746608882069,CSE 30,A01,887025,Eldon; John,142,0,200,58
1746608883095,CSE 100,A01,887027,Staff,26,0,50,24
1746608883095,CSE 100,A02,887028,Staff,42,0,50,8
1746608884119,CSE 101,A01,887030,Braun; Oliver,74,0,100,26
1746608884119,CSE 101,B01,887032,Jones; Miles E,0,3,50,50
1746608884119,CSE 101,B02,887033,Jones; Miles E,0,2,50,50
1746608885148,CSE 105,A01,908084,Jones; Miles E,32,0,50,18
1746608885148,CSE 105,A02,908087,Jones; Miles E,31,0,50,19
1746608886178,CSE 135,A01,887035,Powell; Thomas Allan,0,5,50,50
1746608887205,CSE 142,A01,887037,Staff,7,0,60,53
1746608888232,CSE 142L,A01,887039,Staff,34,0,60,26
1746608889260,CSE 151A,A01,887041,Solares; Edwin A,47,0,100,53
1746608890290,CSE 175,A01,887043,Kumar; Rakesh,30,0,30,0
1746608891316,CSS 1,A01,886389,Staff,0,1,40,40
1746608892341,DSC 30,A01,908097,Liao; Soohyun Nam,47,0,75,28
1746608893372,DSC 40A,A01,908099,Shannon; Kyle Michael,30,0,50,20
1746608894401,DSC 40B,A01,908112,Staff,15,0,50,35
1746608895429,DSC 80,A01,908116,Staff,19,0,60,41
1746608896456,DSC 197,001,956863,Eldridge; Justin Matthew,9999,0,9999,0
1746608897483,ECE 5,A01,886400,Morris; Karcher William,1,0,6,5
1746608897483,ECE 5,A02,886401,Morris; Karcher William,3,0,6,3
1746608898508,ECE 148,A01,886403,Silberman; Jack,0,14,14,14
1746608899533,ECON 1,A01,887265,Crane; Meredith Helen,11,0,70,59
1746608899533,ECON 1,B01,887268,Staff,42,0,50,8
1746608900559,ECON 2,A01,887273,Crane; Meredith Helen,54,0,70,16
1746608901587,ECON 3,A01,887279,Rondina; Giacomo,31,0,70,39
1746608902613,ECON 4,A01,887282,Anderson; John Charles,0,2,10,10
1746608903637,ECON 5,A01,887285,Staff,34,0,45,11
1746608903637,ECON 5,B01,887292,Staff,41,0,45,4
1746608904665,ECON 100A,A01,887337,Newhouse; Herbert S,54,0,70,16
1746608904665,ECON 100A,B01,887349,Staff,45,0,50,5
1746608905692,ECON 100B,A01,887361,Du; Songzi,29,0,70,41
1746608906723,ECON 100C,A01,887445,Newhouse; Herbert S,59,0,70,11
1746608907747,ECON 105,A00,887488,Vespa; Emanuel Ignacio,23,0,35,12
1746608908813,ECON 109,A01,887506,Shishkin; Denis,28,0,35,7
1746608909841,ECON 110A,A01,887568,Alon; Titan Michael,0,2,35,35
1746608909841,ECON 110A,B01,907601,Alon; Titan Michael,20,0,35,15
1746608910868,ECON 110B,A01,887598,Levkoff; Steven B.,0,24,70,70
1746608911894,ECON 112,A00,887599,Rondina; Giacomo,19,0,35,16
1746608912919,ECON 120A,A01,887603,Dai; Yinlin,36,0,70,34
1746608913947,ECON 120C,A01,887608,Sun; Yixiao,0,1,35,35
1746608913947,ECON 120C,B01,887614,Sun; Yixiao,0,0,35,35
1746608914973,ECON 138,A00,887621,Bharadwaj; Prashant,0,21,20,20
1746608915999,ECON 144,A00,958007,Squires; Dale E,11,0,35,24
1746608917028,ECON 171,A01,907666,Staff,18,0,35,17
1746608918058,ECON 175,A00,887626,Wu; Pak Yeung,22,0,35,13
1746608919088,ECON 190,A00,887640,Vespa; Emanuel Ignacio,22,0,35,13
1746608920120,EDS 25,A01,888197,Staff,0,0,0,0
1746608920120,EDS 25,A02,888209,Staff,0,0,0,0
1746608920120,EDS 25,A03,888210,Staff,0,0,0,0
1746608920120,EDS 25,A04,888212,Staff,0,0,0,0
1746608920120,EDS 25,A05,888213,Staff,0,0,0,0
1746608920120,EDS 25,A06,888214,Staff,0,0,0,0
1746608920120,EDS 25,A07,888235,Staff,0,2,0,0
1746608920120,EDS 25,A08,888236,Staff,0,0,0,0
1746608920120,EDS 25,A09,888240,Staff,0,0,0,0
1746608920120,EDS 25,A10,888244,Staff,0,0,0,0
1746608920120,EDS 25,B01,888273,Staff,0,0,0,0
1746608920120,EDS 25,B02,888285,Staff,0,0,0,0
1746608920120,EDS 25,B03,888423,Staff,0,0,0,1
1746608920120,EDS 25,B04,888432,Staff,0,0,0,0
1746608920120,EDS 25,B05,888433,Staff,0,0,0,0
1746608920120,EDS 25,B06,888467,Staff,0,0,0,0
1746608920120,EDS 25,B07,888468,Staff,0,0,0,0
1746608920120,EDS 25,B08,888479,Staff,0,0,0,0
1746608920120,EDS 25,B09,888484,Staff,0,0,0,0
1746608920120,EDS 25,B10,888487,Staff,0,0,0,0
1746608921149,EDS 38,A01,907700,Choi; Bailey Miyeon,30,0,30,0
1746608922175,EDS 112,A01,888601,Chapman; Thandeka K,12,0,40,28
1746608923199,EDS 115,A00,888697,Mendez; Kathrina Mendoza,10,0,30,20
1746608924224,EDS 116,A01,888893,Staff,33,0,40,7
1746608926276,EDS 124AR,A00,889133,Staff,29,0,50,21
1746608926276,EDS 124AR,B00,907471,Simon; Elizabeth A,37,0,50,13
1746608927305,EDS 124BR,A00,889134,Simon; Elizabeth A,44,0,100,56
1746608928335,EDS 125,A00,889135,Staff,25,0,30,5
1746608929361,EDS 126,A01,889138,Staff,35,0,40,5
1746608930392,EDS 164R,A01,889142,Wishard Guerra; Alison G.,32,0,50,18
1746608931418,ENG 30,A01,886396,Staff,0,0,0,0
1746608931418,ENG 30,B01,886398,Staff,0,0,0,0
1746608932442,ENVR 102,A00,906150,Montejo; Carolina,23,0,25,2
1746608933470,ETHN 103A,A00,887236,Man; Simeon S,0,2,0,0
1746608934499,ETHN 113,A00,887239,Staff,16,0,30,14
1746608935525,ETHN 116,A00,887240,Staff,16,0,25,9
1746608936554,ETHN 117,A00,887241,Choi; Esther Min,28,0,30,2
1746608937582,ETHN 118,A00,887243,Staff,24,0,30,6
1746608938608,ETHN 127,A00,887248,Cuong; Marisol,11,0,15,4
1746608939636,ETHN 139,A00,887250,Staff,7,0,10,3
1746608940661,ETHN 142,A00,887252,Staff,9,0,30,21
1746608941688,ETHN 161,A00,887253,Browne; Errol Tsekani,24,0,30,6
1746608942714,ETHN 163FR,A00,887255,Burelle; Julie Sara Veronique,0,0,5,5
1746608943739,GLBH 20,A00,889149,Elwardani; Nile Regina,8,0,42,34
1746608945790,GLBH 111,A01,889152,Burgos; Jose L.,17,0,17,0
1746608946819,GLBH 150,A00,889181,Sloane; Julia Kathryn,0,5,15,15
1746608948890,HDS 60,A01,886406,Warstadt; Melissa Fawn,72,0,80,8
1746608949915,HIAF 111,A00,889324,Gyamfi; Bright,25,0,32,7
1746608950940,HIEA 131,A00,889328,Staff,15,0,32,17
1746608951966,HIEA 144,A00,889333,Henry; Todd A.,26,0,32,6
1746608952993,HIEA 154,A00,889336,Henry; Todd A.,24,0,32,8
1746608954021,HIEU 106,A00,889339,Staff,22,0,32,10
1746608956072,HIEU 114,A00,889340,Staff,4,0,32,28
1746608957098,HIEU 135GS,A00,889342,Patterson; Patrick H.,0,0,1,24
1746608958128,HIEU 137,A00,889343,Edington; Claire Ellen,10,0,25,15
1746608959155,HIEU 148,A00,889345,Staff,14,0,32,18
1746608960184,HIEU 154,A00,889346,Biess; Frank Peter,21,0,32,11
1746608961211,HILA 102,A00,889351,Staff,12,0,32,20
1746608962237,HILD 2A,A01,889221,Lewandoski; Julia Mavis,0,8,32,32
1746608963265,HILD 7B,A01,889225,Man; Simeon S,0,12,32,32
1746608964293,HILD 7C,A01,889288,Alvarez; Luis A,0,14,32,32
1746608965320,HILD 30,A01,889323,Staff,0,5,32,32
1746608967372,HISC 119,A00,889383,Golan; Tal,20,0,32,12
1746608968399,HIUS 103,A00,889384,Man; Simeon S,0,0,32,32
1746608969425,HIUS 117,A00,919797,Kwak; Nancy,18,0,32,14
1746608970452,HIUS 142A,A00,919788,Staff,22,0,32,10
1746608972505,HIUS 149,A00,889386,Gyamfi; Bright,26,0,32,6
1746608973533,HIUS 155,A00,889387,Alvarez; Luis A,15,0,32,17
1746608974561,HUM 3,A01,886499,Caldwell; Michael Alan,19,0,50,31
1746608975591,HUM 3GS,A00,886500,Rodriguez; Bretton Sigfred,0,0,0,28
1746608976622,HUM 3R,A01,886502,Markman; Kristina,0,36,50,50
1746608977649,HUM 4,A01,886504,Crum; Matthew Stephen,23,0,50,27
1746608977649,HUM 4,B01,886506,West; Geoffrey Scott,17,0,50,33
1746608978674,HUM 4GS,A00,886507,Staff,0,0,0,19
1746608979704,HUM 5,A01,886509,Staff,31,0,50,19
1746608980730,HUM 5R,A01,886511,Zavodny; Tatiana Sophia,0,39,50,50
1746608981756,JAPN 180,A00,886407,Staff,16,0,40,24
1746608982783,LATI 50,A01,886409,Martin-Cabrera; Luis,3,0,22,19
1746608982783,LATI 50,A02,886410,Martin-Cabrera; Luis,19,0,22,3
1746608982783,LATI 50,A03,886411,Martin-Cabrera; Luis,21,0,22,1
1746608982783,LATI 50,A04,886412,Martin-Cabrera; Luis,8,0,22,14
1746608983809,LAWS 101,A00,907664,Staff,28,0,60,32
1746608984839,LIAB 1A,A00,889388,Saab; Dima,17,0,20,3
1746608985865,LIAB 1AX,A00,889389,El Cheddadi; Youniss,18,0,20,2
1746608986893,LIFR 1C,A00,889391,Van Moer; Vinciane G,8,0,20,12
1746608987921,LIFR 1CX,A00,889392,Van Moer; Vinciane G,7,0,20,13
1746608988949,LIFR 1D,A00,889393,Van Moer; Vinciane G,7,0,20,13
1746608989978,LIFR 1DX,A00,889394,Van Moer; Vinciane G,8,0,20,12
1746608991005,LIGN 7,A00,886923,Staff,25,0,50,25
1746608992037,LIGN 17,A00,886924,Kehler; Andrew Scott,126,0,150,24
1746608993062,LTAM 110,A00,889395,Staff,15,0,30,15
1746608994088,LTAM 110GS,A00,958010,Rodriguez; Bretton Sigfred,0,0,0,28
1746608995115,LTCH 101,A00,889397,Staff,23,0,25,2
1746608996143,LTCS 130,A00,889398,Staff,23,0,25,2
1746608997168,LTEA 138,A00,889399,Staff,24,0,40,16
1746608998198,LTEN 149,A00,889400,Wesling; Megan E.,0,3,25,25
1746608999223,LTEN 169,A00,889401,Staff,20,0,25,5
1746609000251,LTEN 180,A00,889402,Staff,10,0,15,5
1746609001279,LTEN 181,A00,889403,Staff,21,0,25,4
1746609002312,LTWL 100,A00,889404,Myerston Santana; Jacobo,2,0,25,23
1746609003338,LTWL 180GS,A00,889405,Staff,0,0,20,20
1746609004365,LTWL 181,A00,889406,Staff,16,0,25,9
1746609005397,LTWL 184,A00,889475,Mukherjee; Silpa,22,0,25,3
1746609006425,LTWR 102C,A00,889486,Staff,29,0,30,1
1746609007451,LTWR 115W,A00,889491,Staff,0,2,15,15
1746609008478,MAE 8,A01,886905,Staff,0,2,0,0
1746609009506,MAE 11,A00,886906,Bandaru; Prabhakar,0,7,50,50
1746609010534,MAE 20,A00,886907,Evdokimenko; Ekaterina,43,0,70,27
1746609011563,MAE 30B,A00,886909,Ghazinejad; Maziar,25,0,45,20
1746609012630,MAE 101B,A00,886910,Saintillan; David,30,0,45,15
1746609013659,MAE 105,A00,886911,Bandaru; Prabhakar,18,0,50,32
1746609014686,MAE 107,B00,958024,Staff,7,0,50,43
1746609015717,MAE 143B,A00,886913,Bewley; Thomas R,2,0,40,38
1746609016747,MAE 148,A01,886915,Silberman; Jack,0,3,14,14
1746609017776,MAE 160,A00,886916,Evdokimenko; Ekaterina,30,0,60,30
1746609018803,MATH 3C,A01,889681,Staff,0,2,30,30
1746609018803,MATH 3C,A02,960048,Staff,23,0,30,7
1746609019831,MATH 10A,A01,889760,Staff,26,0,30,4
1746609019831,MATH 10A,A02,889783,Staff,29,0,30,1
1746609020864,MATH 10B,A01,889785,Verstraete; Jacques Allan,1,0,35,34
1746609020864,MATH 10B,A02,889795,Verstraete; Jacques Allan,4,0,35,31
1746609020864,MATH 10B,B01,889797,Verstraete; Jacques Allan,3,0,35,32
1746609020864,MATH 10B,B02,889828,Verstraete; Jacques Allan,3,0,35,32
1746609021893,MATH 10C,A01,889849,Habib; Yousaf,8,0,30,22
1746609021893,MATH 10C,A02,889852,Habib; Yousaf,14,0,30,16
1746609021893,MATH 10C,A03,889853,Habib; Yousaf,22,0,30,8
1746609021893,MATH 10C,A04,889858,Habib; Yousaf,20,0,30,10
1746609021893,MATH 10C,B01,889861,Staff,1,0,30,29
1746609021893,MATH 10C,B02,889862,Staff,24,0,30,6
1746609021893,MATH 10C,B03,889863,Staff,27,0,30,3
1746609021893,MATH 10C,B04,889967,Staff,23,0,30,7
1746609022927,MATH 18,A01,889974,Staff,6,0,30,24
1746609022927,MATH 18,A02,889977,Staff,20,0,30,10
1746609022927,MATH 18,B01,889984,Hardiman; Liam,20,0,30,10
1746609022927,MATH 18,B02,889985,Hardiman; Liam,25,0,30,5
1746609023955,MATH 20A,A01,889990,Suk; Andrew Hoon,30,0,35,5
1746609024990,MATH 20B,A01,889993,Ohm; Ko Woon,21,0,30,9
1746609024990,MATH 20B,A02,889994,Ohm; Ko Woon,30,0,30,0
1746609024990,MATH 20B,B01,889996,Ohm; Ko Woon,22,0,30,8
1746609024990,MATH 20B,B02,889997,Ohm; Ko Woon,23,0,30,7
1746609026024,MATH 20C,A01,889999,Hammock; Frances H,17,0,30,13
1746609026024,MATH 20C,A02,890003,Hammock; Frances H,23,0,30,7
1746609026024,MATH 20C,B01,890006,Hammock; Frances H,2,0,30,28
1746609026024,MATH 20C,B02,890007,Hammock; Frances H,11,0,30,19
1746609027055,MATH 20D,A01,890011,Cheng; Hsiao-Bing,1,0,30,29
1746609027055,MATH 20D,A02,890012,Cheng; Hsiao-Bing,14,0,30,16
1746609027055,MATH 20D,B01,890016,Cheng; Hsiao-Bing,13,0,30,17
1746609027055,MATH 20D,B02,890017,Cheng; Hsiao-Bing,13,0,30,17
1746609028082,MATH 20E,A01,890026,Harel; Guershon,1,0,30,29
1746609028082,MATH 20E,A02,890029,Harel; Guershon,22,0,30,8
1746609028082,MATH 20E,B01,890033,Harel; Guershon,7,0,30,23
1746609028082,MATH 20E,B02,890101,Harel; Guershon,21,0,30,9
1746609029108,MATH 102,A01,890104,Staff,18,0,30,12
1746609029108,MATH 102,A02,890105,Staff,27,0,30,3
1746609030134,MATH 103B,A01,890116,Salehi Golsefidy; Alireza,3,0,30,27
1746609030134,MATH 103B,B01,890118,Staff,0,3,34,34
1746609031159,MATH 109,A01,890121,Aliabadi Sr.; Mohsen,0,0,30,30
1746609031159,MATH 109,B01,890124,Upadrashta; Pranav Kumar,18,0,30,12
1746609032186,MATH 120A,A01,890126,Eggers; John Dietrich,13,0,30,17
1746609033217,MATH 142B,A01,890128,Ioana; Adrian,19,0,30,11
1746609033217,MATH 142B,A02,890129,Ioana; Adrian,12,0,30,18
1746609034241,MATH 154,A01,890174,Staff,0,1,30,30
1746609034241,MATH 154,A02,890182,Staff,0,0,30,30
1746609035266,MATH 168A,A01,890197,Dumitriu; Ioana,21,0,35,14
1746609036292,MATH 170A,A01,890240,Nie; Jiawang,1,0,30,29
1746609036292,MATH 170A,A02,890241,Nie; Jiawang,11,0,30,19
1746609036292,MATH 170A,A03,890249,Nie; Jiawang,23,0,30,7
1746609037318,MATH 170B,A01,957891,Nag; Panchali,13,0,35,22
1746609039376,MATH 181A,A01,908025,Staff,0,3,35,35
1746609039376,MATH 181A,A02,960115,Staff,26,0,35,9
1746609040405,MATH 181B,A01,959874,Staff,24,0,30,6
1746609041434,MATH 193B,A01,890265,Staff,0,4,35,35
1746609042460,MGT 4,A01,890311,Anderson; John Charles,42,0,88,46
1746609043485,MGT 5,A00,907740,Staff,12,0,98,86
1746609044512,MGT 12,A00,890312,Lindenberger; Wade Douglas,67,0,98,31
1746609045538,MGT 16,A00,957883,Staff,78,0,98,20
1746609047591,MGT 45,A00,890314,Pecore; Joseph P.,45,0,98,53
1746609048618,MGT 71,A00,890315,Staff,0,12,98,98
1746609049646,MGT 100,A00,890316,Yavorsky; Daniel Ryan,44,0,98,54
1746609050672,MGT 103,A00,890317,Ehrich; Kristine R,73,0,98,25
1746609051699,MGT 105,A00,890356,Bates; Kenneth Walter,0,8,98,98
1746609052732,MGT 112,A00,890360,Ehrich; Kristine R,55,0,98,43
1746609053759,MGT 127R,A00,907732,Zhu; Kevin Xiaoguo,23,0,98,75
1746609054784,MGT 131B,A00,890361,Anderson; John Charles,59,0,98,39
1746609055814,MGT 137,A00,890362,Lindenberger; Wade Douglas,65,0,98,33
1746609056840,MGT 160,A00,890369,Johnson; Erik Barry,9,0,98,89
1746609058898,MGT 164,A00,890372,Zimmermann; Carsten,0,40,98,98
1746609059929,MGT 180,A00,890374,Bliss; Barbara Ann,11,0,98,87
1746609060958,MMW 15,A01,886414,Chang; Edmond Yi-Teh,0,12,28,28
1746609060958,MMW 15,A02,886415,Chang; Edmond Yi-Teh,0,8,28,28
1746609060958,MMW 15,A03,886416,Chang; Edmond Yi-Teh,0,9,28,28
1746609060958,MMW 15,A04,886417,Chang; Edmond Yi-Teh,0,8,28,28
1746609060958,MMW 15,B01,886419,Chang; Edmond Yi-Teh,0,7,28,28
1746609060958,MMW 15,B02,886420,Chang; Edmond Yi-Teh,0,7,28,28
1746609060958,MMW 15,B03,886421,Chang; Edmond Yi-Teh,0,7,28,28
1746609060958,MMW 15,B04,886422,Chang; Edmond Yi-Teh,0,8,28,28
1746609060958,MMW 15,C01,886424,Staff,0,9,28,28
1746609060958,MMW 15,C02,886425,Staff,0,8,28,28
1746609060958,MMW 15,C03,886426,Staff,0,8,28,28
1746609060958,MMW 15,C04,886427,Staff,0,8,28,28
1746609060958,MMW 15,C05,958038,Staff,0,8,28,28
1746609060958,MMW 15,C06,958039,Staff,0,7,28,28
1746609061983,MMW 15GS,A00,906910,Patterson; Patrick H.,4,0,28,24
1746609063013,MMW 122R,A01,886429,Rahimi; Babak,0,13,28,28
1746609063013,MMW 122R,A02,886430,Rahimi; Babak,0,12,28,28
1746609063013,MMW 122R,A03,958040,Rahimi; Babak,0,11,28,28
1746609064040,MUS 1A,A01,890937,Staff,2,0,25,23
1746609064040,MUS 1A,A02,891035,Staff,6,0,25,19
1746609064040,MUS 1A,C01,958912,Staff,24,0,25,1
1746609064040,MUS 1A,C02,958913,Staff,25,0,25,0
1746609066098,MUS 2AK,A00,957092,Ohnishi; Takae,15,0,15,0
1746609067131,MUS 4,A01,891044,Staff,0,0,25,25
1746609067131,MUS 4,A02,891045,Staff,22,0,25,3
1746609067131,MUS 4,B01,891048,Staff,17,0,25,8
1746609067131,MUS 4,B02,891050,Staff,25,0,25,0
1746609068165,MUS 5,A01,957506,Dubnov; Shlomo,0,0,25,25
1746609068165,MUS 5,A02,957622,Dubnov; Shlomo,12,0,25,13
1746609068165,MUS 5,A03,957623,Dubnov; Shlomo,20,0,25,5
1746609069191,MUS 6,A01,891053,Freitas Caetano; Marcelo,24,0,25,1
1746609069191,MUS 6,A02,891054,Freitas Caetano; Marcelo,23,0,25,2
1746609070221,MUS 7,A01,891081,Staff,0,0,25,25
1746609070221,MUS 7,A02,891082,Staff,3,0,25,22
1746609071246,MUS 8GS,A00,891118,Borgo; David Garcia,1,0,25,24
1746609072273,MUS 11,A01,891140,Staff,8,0,25,17
1746609072273,MUS 11,A02,891141,Staff,21,0,25,4
1746609073301,MUS 13,A01,891143,Staff,8,0,25,17
1746609073301,MUS 13,A02,891144,Staff,24,0,25,1
1746609074332,MUS 15,A01,891146,Staff,9,0,25,16
1746609074332,MUS 15,A02,891148,Staff,21,0,25,4
1746609074332,MUS 15,B01,891150,Staff,18,0,25,7
1746609074332,MUS 15,B02,891151,Staff,25,0,25,0
1746609075359,MUS 20,A01,891153,Staff,5,0,20,15
1746609075359,MUS 20,A02,891155,Staff,14,0,20,6
1746609076391,MUS 80,A00,891156,Staff,19,0,25,6
1746609076391,MUS 80,B00,891157,Staff,23,0,25,2
1746609077421,MUS 130,A00,891158,Ohnishi; Takae,35,0,35,0
1746609078449,MUS 150GS,A01,891160,Borgo; David Garcia,1,0,25,24
1746609079481,MUS 170,A01,891162,Freitas Caetano; Marcelo,20,0,25,5
1746609079481,MUS 170,A02,891164,Freitas Caetano; Marcelo,21,0,25,4
1746609080510,NANO 11,A00,886220,Vazquez Mena; Oscar,13,0,15,2
1746609081538,NANO 15,A01,886222,Drews; Aaron,4,0,7,3
1746609082577,NANO 104,A00,886224,Sirbuly; Donald,17,0,25,8
1746609083606,PH 40,A00,886528,Staff,23,0,40,17
1746609084636,PH 45,A01,886799,Staff,35,0,40,5
1746609085663,PH 110,A00,886802,Staff,0,6,40,40
1746609086689,PH 172,A00,906716,Staff,19,0,35,16
1746609087720,PH 191,A00,886803,Staff,6,0,40,34
1746609088746,PHIL 1,A00,889500,Staff,20,0,30,10
1746609089775,PHIL 10,A01,889549,Grush; Rick Scott,16,0,22,6
1746609089775,PHIL 10,A02,889551,Grush; Rick Scott,22,0,22,0
1746609090804,PHIL 28,A01,889559,Lamey; Andy M.,0,2,31,31
1746609090804,PHIL 28,A02,889561,Lamey; Andy M.,0,1,30,30
1746609090804,PHIL 28,A03,889572,Lamey; Andy M.,0,1,30,30
1746609091834,PHIL 35,A00,907839,Staff,13,0,15,2
1746609092860,PHIL 60,A00,889574,Staff,73,0,90,17
1746609093887,PHIL 101,A00,958004,Staff,12,0,15,3
1746609095942,PHIL 136,A00,889582,Fulkerson; Matthew Todd,26,0,45,19
1746609096969,PHIL 163,A01,889601,Staff,21,0,30,9
1746609096969,PHIL 163,B01,889606,Brandt; Reuven A,0,3,0,0
1746609097997,PHIL 164,A00,889610,Staff,16,0,30,14
1746609099028,PHIL 165,A00,889613,Staff,22,0,30,8
1746609100054,PHYS 1A,A00,886431,Staff,30,0,70,40
1746609101080,PHYS 1AL,001,886432,Tsai; Philbert S,0,1,30,30
1746609101080,PHYS 1AL,002,886436,Tsai; Philbert S,13,0,30,17
1746609102125,PHYS 1B,A00,886439,Staff,184,0,240,56
1746609103155,PHYS 1BL,001,886441,Tsai; Philbert S,0,4,30,30
1746609103155,PHYS 1BL,002,886444,Tsai; Philbert S,2,0,30,28
1746609104183,PHYS 1C,A00,896092,Arnold; Kam S,78,0,146,68
1746609105214,PHYS 1CL,001,886448,Tsai; Philbert S,0,0,30,30
1746609105214,PHYS 1CL,002,886449,Tsai; Philbert S,1,0,30,29
1746609105214,PHYS 1CL,003,886450,Tsai; Philbert S,16,0,30,14
1746609105214,PHYS 1CL,004,886451,Tsai; Philbert S,15,0,30,15
1746609106245,PHYS 2B,A01,886457,Staff,67,0,115,48
1746609107273,PHYS 2C,A01,886460,Shotwell; Brian,0,9,65,65
1746609108306,PHYS 2CL,A01,886467,Staff,0,4,28,28
1746609108306,PHYS 2CL,A02,886468,Staff,0,3,28,28
1746609109332,PHYS 2D,A01,886470,Staff,10,0,50,40
1746609110365,PHYS 4B,A01,886475,Grinstein; Benjamin,22,0,40,18
1746609111390,POLI 5,A00,891173,Desposato; Scott,7,0,25,18
1746609112420,POLI 5D,A01,891175,Staff,5,0,5,0
1746609112420,POLI 5D,B01,891178,Staff,5,0,5,0
1746609113451,POLI 11,A00,891179,Ferree; Karen E,0,0,35,35
1746609114476,POLI 12,A00,891180,Staff,15,0,30,15
1746609115501,POLI 27,A01,891182,Staff,11,0,75,64
1746609116565,POLI 30,A00,891183,Staff,8,0,50,42
1746609117595,POLI 100B,A00,891244,Staff,5,1,35,30
1746609118623,POLI 100I,A00,891247,Staff,7,0,30,23
1746609119653,POLI 104J,A00,891248,Nichter; Maysa,14,0,30,16
1746609120682,POLI 104U,A00,891250,Nichter; Maysa,1,0,30,29
1746609122736,POLI 110B,A00,891255,Wiens; David,19,0,25,6
1746609123766,POLI 112A,A00,891256,Wiens; David,6,0,25,19
1746609124796,POLI 114BR,A00,891261,Staff,19,0,30,11
1746609125823,POLI 117R,A00,891262,Forman; Fonna,0,6,50,50
1746609126853,POLI 118,A00,891264,Ingham; Sean,17,0,25,8
1746609127879,POLI 124A,A00,891265,Staff,18,0,20,2
1746609128908,POLI 125D,A00,891266,Nichter; Simeon C,2,0,25,23
1746609129937,POLI 126,A00,891268,Nichter; Simeon C,7,0,25,18
1746609130964,POLI 126AA,A00,891272,Staff,15,0,25,10
1746609131991,POLI 130AA,A00,891273,Staff,15,0,20,5
1746609133017,POLI 134AA,A00,891274,Staff,4,0,20,16
1746609135070,POLI 138,A00,891278,Staff,21,0,25,4
1746609136097,POLI 142K,A00,891280,Staff,10,0,25,15
1746609137123,POLI 142M,A00,891281,Gartzke; Erik,16,0,30,14
1746609138152,POLI 142P,A00,891284,Staff,20,0,30,10
1746609139181,POLI 143,A00,891285,Gartzke; Erik,12,0,30,18
1746609140208,POLI 153,A00,891286,Staff,19,0,20,1
1746609142267,POLI 175,A00,891290,Staff,15,0,20,5
1746609143293,PSYC 1,A00,890674,Steiner; Eric Tomas,0,11,45,45
1746609144324,PSYC 2,A00,890676,Albright; Thomas D,20,0,35,15
1746609145353,PSYC 3,A00,890679,Staff,17,0,20,3
1746609146383,PSYC 6,A00,959858,Staff,19,0,20,1
1746609147409,PSYC 60,A01,890684,Rickard; Timothy C.,0,6,45,45
1746609148437,PSYC 70,A01,890689,Geller; Emma Harlan,6,0,30,24
1746609149467,PSYC 71,A01,959860,Staff,21,0,25,4
1746609150491,PSYC 100,A00,890690,Lacefield; Katharine I,0,50,180,180
1746609151517,PSYC 102,A00,890695,Staff,18,0,40,22
1746609152547,PSYC 105,A00,890699,Geller; Emma Harlan,70,0,100,30
1746609153576,PSYC 106,A00,890701,Gorman; Michael R.,5,0,30,25
1746609154601,PSYC 108,A00,890704,Adrian; Julia Anna,0,29,50,50
1746609155626,PSYC 118,A01,890712,Staff,11,0,30,19
1746609156655,PSYC 124,A00,890716,Chapman; Eddie Nathaniel,25,0,60,35
1746609157683,PSYC 131,A00,890717,Anagnostaras; Stephan,0,7,80,80
1746609158709,PSYC 137,A00,890719,Winkielman; Piotr,0,11,30,30
1746609159738,PSYC 144,A00,890721,Adrian; Julia Anna,0,9,45,45
1746609160770,PSYC 162,A00,890805,Staff,0,2,75,75
1746609161799,PSYC 169,A00,890810,Staff,0,15,30,30
1746609162824,PSYC 172,A00,890814,Gorman; Michael R.,9,0,30,21
1746609163855,PSYC 181,A00,890818,Anagnostaras; Stephan,6,0,200,194
1746609164882,PSYC 184,A00,959861,Staff,160,0,175,15
1746609165912,PSYC 189,A00,890823,Staff,0,2,30,30
1746609166939,PSYC 191,A00,890884,Rickard; Timothy C.,0,12,35,35
1746609167971,PSYC 193,A00,890913,Staff,19,0,30,11
1746609167971,PSYC 193,B00,890914,Chapman; Eddie Nathaniel,24,0,30,6
1746609169004,PSYC 193L,A01,890918,Lowe; Angela Beth,20,0,30,10
1746609169004,PSYC 193L,B01,890921,Hurwitz; Ethan Scott,20,0,30,10
1746609169004,PSYC 193L,C01,890928,Staff,30,0,30,0
1746609170030,RELI 149,A00,886806,Rahimi; Babak,23,0,40,17
1746609171059,SE 9,A01,886814,Staff,7,0,20,13
1746609172086,SE 101B,A01,886816,Chadha; Mayank,3,0,35,32
1746609173116,SE 110B,A00,886818,Zhu; Qiang,4,0,75,71
1746609174145,SE 125,A01,886830,Staff,10,0,30,20
1746609175176,SE 130B,A01,886835,Staff,14,0,40,26
1746609176207,SE 131A,A01,886838,Krysl; Petr,34,0,55,21
1746609177237,SE 154,A00,886840,Staff,28,0,50,22
1746609178290,SE 164GS,A01,886849,Staff,6,0,20,14
1746609179322,SE 167GS,A01,886853,Staff,6,0,20,14
1746609180348,SIO 25,A01,890107,Staff,19,0,30,11
1746609181373,SIO 45,A00,890109,Cook; Geoffrey W,114,0,200,86
1746609182403,SIO 109R,A00,890110,Forman; Fonna,0,16,20,20
1746609183429,SIO 187,A01,890114,Kacev; David,15,0,40,25
1746609184462,SOCI 1,A01,890431,Thorpe; Charles Robert,14,0,30,16
1746609184462,SOCI 1,A02,890518,Thorpe; Charles Robert,30,0,30,0
1746609185488,SOCI 2,A01,957978,Staff,25,0,25,0
1746609185488,SOCI 2,A02,957979,Staff,23,0,25,2
1746609186515,SOCI 20,A01,890523,Calderon-Zaks; Michael Aar,21,0,30,9
1746609186515,SOCI 20,A02,890526,Calderon-Zaks; Michael Aar,29,0,30,1
1746609187544,SOCI 30,A01,890533,Pardo Guerra; Juan Pablo,37,0,40,3
1746609188570,SOCI 40,A01,890535,Staff,27,0,45,18
1746609189598,SOCI 104Q,A00,890559,Staff,17,0,30,13
1746609190628,SOCI 106,A00,890560,Arnal; Maud Marie Leonie,20,0,30,10
1746609191656,SOCI 110,A00,890567,Holkenbrink-Monk; Charlene,19,0,30,11
1746609192706,SOCI 112,A00,890568,Victoria Torres; Pablo,2,0,55,53
1746609193735,SOCI 115,A00,890597,Arnal; Maud Marie Leonie,28,0,45,17
1746609195789,SOCI 121,A00,890604,Pardo Guerra; Juan Pablo,38,0,45,7
1746609196815,SOCI 126,A01,890608,Staff,8,0,10,2
1746609197840,SOCI 127,A00,890609,Staff,18,0,30,12
1746609198868,SOCI 131,A00,890610,Thorpe; Charles Robert,37,0,45,8
1746609199898,SOCI 135,A00,890615,Payne; Christine Anna,14,0,45,31
1746609200922,SOCI 139,A00,890620,Staff,38,0,45,7
1746609201947,SOCI 148E,A00,890622,Calderon-Zaks; Michael Aar,36,0,45,9
1746609202976,SOCI 150,A00,890623,Kohler; Kristopher M.,31,0,45,14
1746609204001,SOCI 157,A00,890625,Jules-Rosette; Bennetta W.,18,0,20,2
1746609205027,SOCI 160,A00,890627,Payne; Christine Anna,21,0,45,24
1746609206056,SYN 1,A00,886855,Fish; Gwendolyn Anne,0,1,0,0
1746609206056,SYN 1,B00,906086,Fish; Gwendolyn Anne,0,2,0,2
1746609207085,SYN 2R,A00,886860,Staff,0,17,15,15
1746609207085,SYN 2R,B00,906106,Atkinson; Arthur Laird,0,16,15,15
1746609208113,SYN 100,A01,886866,Browne; Emily,0,28,20,20
1746609208113,SYN 100,B01,906128,Rock; Martin,0,4,20,20
1746609208113,SYN 100,C01,906140,Deavenport; James Cary,0,4,20,20
1746609208113,SYN 100,D01,907816,Deavenport; James Cary,0,5,20,20
1746609209146,TDAC 1,A00,890286,Walsh; Kim C.,7,0,20,13
1746609210175,TDAC 101,A00,890296,Basso; Beatrice,15,0,20,5
1746609211202,TDDE 131,A00,890297,Staff,47,0,50,3
1746609212230,TDDM 1,A00,890287,Weinberg; Sadie,25,0,30,5
1746609213259,TDGE 11,A00,890288,Fulton; Julia,138,0,200,62
1746609213259,TDGE 11,B00,890289,Castro; Robert Jess,184,0,200,16
1746609214283,TDGE 25,B00,957359,Walsh; Kim C.,5,0,20,15
1746609215312,TDGE 40,A01,890292,Power; Jade Yukana,26,0,30,4
1746609216337,TDGE 124,A00,890298,Havis; Allan,0,2,50,50
1746609217361,TDGE 131R,A00,890299,Burelle; Julie Sara Veronique,15,0,42,27
1746609218389,TDHT 101,A00,890300,Staff,10,0,20,10
1746609219415,TDHT 109,A01,890302,Anderson; Mysia Anyse,31,0,40,9
1746609220440,TDMV 1,A00,890293,Arcidiacono; Kristin,18,0,30,12
1746609221467,TDMV 2,A00,890294,Weinberg; Sadie,23,0,30,7
1746609222493,TDMV 3,A00,957878,Arcidiacono; Kristin,28,0,30,2
1746609224546,TDMV 138,A00,890304,Jun; Grace Shin Hae,25,0,40,15
1746609225570,TDMV 140,A00,890305,Corrales; Joseph Bernales,25,0,30,5
1746609226598,TDMV 142,A00,890307,Caligagan; Tony,32,0,40,8
1746609227625,TDMV 144,A00,890308,Camaya; Michelle Ann,25,0,30,5
1746609228652,TDPW 1,A00,890295,Stein; Deborah Isobel,3,0,20,17
1746609229677,USP 2,A01,890272,Lerner; Amy M,7,0,20,13
1746609230704,USP 3,A01,890274,Staff,12,0,30,18
1746609231734,USP 15,A01,890276,Sun; Feiyang,16,0,30,14
1746609232757,USP 25,A00,890277,Shenkman; Michael Thomas,18,0,25,7
1746609233786,USP 138,A00,890278,Staff,13,0,25,12
1746609234813,USP 143,A00,890279,Staff,21,0,70,49
1746609235840,USP 144,A00,890280,Chowdhury; Muhammed Zohir,16,0,30,14
1746609236871,USP 150,A00,890281,Boomhower; Matthew Charles,4,0,30,26
1746609237901,USP 151,A00,890282,Staff,16,0,20,4
1746609238930,USP 162,A00,890283,Andrews; Abigail Leslie,16,0,20,4
1746609239957,USP 168,A00,920477,Kwak; Nancy,0,0,5,5
1746609240986,USP 181,A00,890284,Staff,3,0,20,17
1746609242010,USP 191A,A00,890285,Staff,12,0,20,8
1746609243037,VIS 101,A00,886512,Staff,26,0,75,49
1746609244064,VIS 103,A00,886513,Cruz; Edwin Teddy,61,0,75,14
1746609245100,VIS 108,A00,886514,Staff,4,0,15,11
1746609246127,VIS 127P,A00,886515,Shen; Kuiyi,80,0,146,66
1746609247154,VIS 149,A00,886516,Yoldas; Pinar,0,0,15,15
1746609248181,VIS 164,A00,886526,Erdmann; Dean,19,0,22,3
1746609249206,VIS 194S,A00,886527,Staff,61,0,75,14
1746609250230,WCWP 10A,C00,886484,Martiniuk; Jill,12,0,15,3
1746609251256,WCWP 10B,A00,886490,Uriarte; Emma,0,0,15,15
1746609251256,WCWP 10B,B00,886491,Dhir; Simrita,8,0,15,7
1746609251256,WCWP 10B,C00,886492,Ornelas; Tricia,0,0,15,15
1746609252280,WCWP 100,A00,886494,Young; Mark T,0,6,15,15
1746609254377,AAS 10,A01,886199,Childs; Dennis R.,0,3,0,0
1746609255409,ANAR 104,A01,886940,Shtienberg; Gilad,27,0,30,3
1746609256437,ANAR 120,A00,886953,Staff,13,0,20,7
1746609257467,ANBI 148,A01,886955,Wilder; Linnea Lorene,30,0,40,10
1746609259518,ANSC 122,A00,886957,Staff,24,0,30,6
1746609260547,ANSC 150,A00,886958,Sloane; Julia Kathryn,2,0,15,13
1746609261581,ANSC 156,A00,886959,Jenkins; Janis A.,0,1,15,15
1746609262608,ANSC 180,A00,886960,Staff,11,0,17,6
1746609263632,ANSC 188,A00,886961,Jassal; Aftab,9,0,25,16
1746609264658,ANSC 190,A00,886962,Jassal; Aftab,14,0,25,11
1746609265706,ANSC 191,A00,886963,Staff,18,0,20,2
1746609266732,ANTH 3,A01,891689,Staff,17,0,20,3
1746609267761,ANTH 5,A00,886933,Semendeferi; Ekaterini,16,0,20,4
1746609268785,ANTH 10,A00,886934,Staff,0,12,30,30
1746609269813,ANTH 21,A01,886936,Staff,41,0,60,19
1746609270839,ANTH 23,A01,886938,Staff,92,0,100,8
1746609271868,ANTH 105,A00,886964,Stewart; Alexander B,84,0,100,16
1746609272896,ANTH 108,A00,886965,Pedersen; David,9,0,20,11
1746609273928,AWP 10,001,886147,Staff,0,0,0,0
1746609273928,AWP 10,002,886148,Staff,0,0,0,0
1746609273928,AWP 10,003,886149,Staff,0,0,0,0
1746609273928,AWP 10,004,886150,Staff,0,0,0,0
1746609273928,AWP 10,005,886151,Staff,0,0,0,0
1746609273928,AWP 10,006,886152,Staff,0,0,0,0
1746609273928,AWP 10,007,886153,Staff,0,0,0,0
1746609273928,AWP 10,008,886154,Staff,0,0,0,0
1746609273928,AWP 10,009,886155,Staff,0,0,0,0
1746609273928,AWP 10,010,886156,Staff,0,0,0,0
1746609273928,AWP 10,011,886158,Staff,0,0,0,0
1746609273928,AWP 10,012,886160,Staff,0,0,0,0
1746609273928,AWP 10,013,886161,Staff,0,0,0,0
1746609273928,AWP 10,014,886162,Staff,0,0,0,0
1746609273928,AWP 10,015,886163,Staff,0,0,0,0
1746609273928,AWP 10,016,886164,Staff,0,0,0,0
1746609273928,AWP 10,017,886165,Staff,0,0,0,0
1746609273928,AWP 10,018,886166,Staff,0,0,0,0
1746609273928,AWP 10,019,886168,Staff,0,0,0,0
1746609273928,AWP 10,020,886170,Staff,0,0,0,0
1746609273928,AWP 10,021,886172,Staff,0,0,0,0
1746609274968,AWP 10R,001,886173,Staff,0,1,0,0
1746609274968,AWP 10R,002,886174,Staff,0,1,0,0
1746609274968,AWP 10R,003,886175,Staff,0,0,0,0
1746609274968,AWP 10R,004,886176,Staff,0,0,0,0
1746609274968,AWP 10R,005,886177,Staff,0,0,0,0
1746609274968,AWP 10R,006,886178,Staff,0,0,0,0
1746609274968,AWP 10R,007,886179,Staff,0,0,0,0
1746609274968,AWP 10R,008,886181,Staff,0,0,0,0
1746609274968,AWP 10R,009,886182,Staff,0,0,0,0
1746609274968,AWP 10R,010,886183,Staff,0,0,0,0
1746609274968,AWP 10R,011,886184,Staff,0,0,0,0
1746609274968,AWP 10R,012,886185,Staff,0,0,0,0
1746609274968,AWP 10R,013,886186,Staff,0,0,0,0
1746609274968,AWP 10R,014,886187,Staff,0,0,0,0
1746609274968,AWP 10R,015,886188,Staff,0,0,0,0
1746609274968,AWP 10R,016,886189,Staff,0,0,0,0
1746609274968,AWP 10R,017,960532,Staff,0,0,0,0
1746609274968,AWP 10R,018,960533,Staff,0,0,0,0
1746609274968,AWP 10R,019,960534,Staff,0,0,0,0
1746609274968,AWP 10R,020,960538,Staff,0,0,0,0
1746609274968,AWP 10R,021,960540,Staff,0,0,0,0
1746609274968,AWP 10R,022,960541,Staff,0,0,0,0
1746609274968,AWP 10R,023,960542,Staff,0,0,0,0
1746609274968,AWP 10R,024,960544,Staff,0,0,0,0
1746609274968,AWP 10R,025,960545,Staff,0,0,0,0
1746609274968,AWP 10R,026,960548,Staff,0,0,0,0
1746609275996,AWP 102R,A00,886190,Staff,0,0,0,0
1746609275996,AWP 102R,B00,886191,Staff,0,0,0,0
1746609277025,BENG 100,A01,886193,Staff,17,0,30,13
1746609278049,BENG 122A,A01,886195,Hasty; Jeff M,13,0,30,17
1746609279077,BENG 166A,A00,886196,Sah; Robert Lie-Yuan,0,3,30,30
1746609280106,BENG 190,A00,958050,Khojah; Reem I,17,0,25,8
1746609281132,BIBC 102,A01,894320,Staff,0,1,46,46
1746609281132,BIBC 102,A02,894321,Staff,0,0,46,46
1746609281132,BIBC 102,A03,894344,Staff,6,0,46,40
1746609281132,BIBC 102,A04,894345,Staff,27,0,47,20
1746609282159,BICD 100R,A01,894365,Smith; Laurie,0,2,58,58
1746609282159,BICD 100R,A02,894366,Smith; Laurie,0,4,58,58
1746609282159,BICD 100R,A03,894367,Smith; Laurie,0,0,59,59
1746609282159,BICD 100R,A04,959869,Smith; Laurie,38,0,59,21
1746609283189,BICD 136,A01,894383,Gustafson-Brown; Cindy,14,0,50,36
1746609284216,BIEB 102,A01,894494,Butler; Shannon Rhey,51,0,130,79
1746609286272,BIEB 150,A01,894617,Wills; Christopher,3,0,20,17
1746609286272,BIEB 150,A02,894631,Wills; Christopher,3,0,20,17
1746609286272,BIEB 150,A03,894937,Wills; Christopher,3,0,20,17
1746609286272,BIEB 150,A04,894946,Wills; Christopher,5,0,20,15
1746609287298,BIEB 194,A00,906141,Kurle; Carolyn M.,5,0,20,15
1746609288325,BILD 1,A01,894154,Staff,3,0,19,16
1746609288325,BILD 1,A02,894155,Staff,14,0,19,5
1746609288325,BILD 1,A03,894160,Staff,13,0,19,6
1746609288325,BILD 1,A04,894161,Staff,15,0,18,3
1746609289353,BILD 2,A01,894168,Staff,0,0,50,50
1746609289353,BILD 2,A02,894169,Staff,0,0,50,50
1746609289353,BILD 2,A03,894179,Staff,0,0,50,50
1746609289353,BILD 2,A04,894203,Staff,22,0,50,28
1746609290384,BILD 3,A01,894213,Staff,23,0,31,8
1746609290384,BILD 3,A02,894214,Staff,26,0,31,5
1746609290384,BILD 3,A03,894235,Staff,28,0,31,3
1746609290384,BILD 3,A04,894236,Staff,28,0,32,4
1746609291413,BILD 4,A01,894253,Reuther; Keefe,5,0,24,19
1746609291413,BILD 4,A02,894258,Reuther; Keefe,16,0,24,8
1746609292443,BILD 5,A01,894276,Reuther; Keefe,33,0,50,17
1746609292443,BILD 5,A02,894277,Reuther; Keefe,45,0,50,5
1746609292443,BILD 5,A03,894290,Reuther; Keefe,44,0,50,6
1746609292443,BILD 5,A04,894291,Reuther; Keefe,48,0,50,2
1746609293473,BILD 24,A01,894297,Pirino; Giorgia,40,0,60,20
1746609294501,BIMM 100,B01,958915,Staff,71,0,100,29
1746609295528,BIMM 101,A01,895017,McDonnell; Lisa Marie,0,5,24,24
1746609295528,BIMM 101,A02,895018,McDonnell; Lisa Marie,0,5,24,24
1746609295528,BIMM 101,B01,895020,McDonnell; Lisa Marie,0,5,24,24
1746609295528,BIMM 101,B02,895021,McDonnell; Lisa Marie,0,4,24,24
1746609296558,BIMM 110,A01,895023,Staff,1,0,25,24
1746609296558,BIMM 110,A02,895024,Staff,9,0,25,16
1746609296558,BIMM 110,A03,895025,Staff,18,0,25,7
1746609296558,BIMM 110,A04,895031,Staff,20,0,25,5
1746609297583,BIMM 120,A01,895114,Gustafson-Brown; Cindy,14,0,28,14
1746609297583,BIMM 120,A02,895126,Gustafson-Brown; Cindy,21,0,27,6
1746609298613,BIPN 100,A01,895130,Yang; Mingyu,0,0,38,38
1746609298613,BIPN 100,A02,895131,Yang; Mingyu,31,0,38,7
1746609298613,BIPN 100,A03,895132,Yang; Mingyu,32,0,38,6
1746609298613,BIPN 100,A04,895133,Yang; Mingyu,27,0,36,9
1746609299640,BIPN 120,A01,895135,Cooke; James Edward,0,3,13,13
1746609299640,BIPN 120,A02,895136,Cooke; James Edward,0,1,13,13
1746609299640,BIPN 120,A03,895137,Cooke; James Edward,0,3,13,13
1746609299640,BIPN 120,A04,895156,Cooke; James Edward,0,2,11,11
1746609300671,BIPN 134,A01,895235,Cooke; James Edward,0,1,25,25
1746609300671,BIPN 134,A02,895237,Cooke; James Edward,0,0,25,25
1746609300671,BIPN 134,A03,895240,Cooke; James Edward,1,0,25,24
1746609300671,BIPN 134,A04,895270,Cooke; James Edward,20,0,25,5
1746609301701,BIPN 189,A00,892103,Staff,0,14,14,14
1746609303754,BISP 194,A00,958008,Staff,0,2,0,0
1746609304780,CAT 124,A01,922009,Staff,0,5,20,20
1746609305830,CAT 125R,A00,886390,Morales; Celeste Georgianna,0,4,20,20
1746609305830,CAT 125R,B00,886391,Irwin; Matthew Joseph,0,4,20,20
1746609305830,CAT 125R,C00,886392,Smith; Lauryn Alissa,0,2,20,20
1746609305830,CAT 125R,D00,886393,Vanderschuit; Maya Alysia,0,3,20,20
1746609305830,CAT 125R,E00,886394,Marchisotto; Jennifer Anne,0,3,20,20
1746609306858,CENG 15,A01,886218,Drews; Aaron,3,0,8,5
1746609307887,CENG 113,A00,886219,Opatkiewicz; Justin Paul,15,0,25,10
1746609308916,CGS 101,A00,887044,Staff,7,0,20,13
1746609309947,CGS 105,A01,887046,Staff,14,0,25,11
1746609310972,CGS 112,A00,887047,Cuong; Marisol,12,0,15,3
1746609312001,CGS 113,A00,887048,Staff,23,0,30,7
1746609313030,CGS 120,A00,887049,Staff,9,0,17,8
1746609314056,CHEM 6A,A01,886336,Lam; Tin Yiu,38,0,50,12
1746609314056,CHEM 6A,A02,886338,Lam; Tin Yiu,37,0,50,13
1746609315087,CHEM 6B,A01,886341,Hopkins; Patrycja Anna,16,0,50,34
1746609315087,CHEM 6B,A02,886343,Hopkins; Patrycja Anna,42,0,50,8
1746609316119,CHEM 6C,A01,886346,Albizati; Kim F.,0,2,50,50
1746609316119,CHEM 6C,A02,886348,Albizati; Kim F.,24,0,50,26
1746609317147,CHEM 40A,A01,886352,Klosterman; Jeremy K,65,0,100,35
1746609318174,CHEM 40B,A01,886356,Klosterman; Jeremy K,0,24,100,100
1746609319205,CHEM 41B,A01,886360,Theodorakis; Emmanuel,25,0,50,25
1746609319205,CHEM 41B,A02,886362,Theodorakis; Emmanuel,47,0,50,3
1746609320232,CHIN 165A,A00,886382,Xu; Li,18,0,20,2
1746609321260,CLAS 120,A00,886387,Myerston Santana; Jacobo,33,0,40,7
1746609322285,COGS 9,A01,886967,Shannon; Kyle Michael,42,0,60,18
1746609323311,COGS 11,A01,886969,Staff,9,0,30,21
1746609324337,COGS 14A,A01,886971,Staff,5,0,60,55
1746609325364,COGS 14B,A01,886973,Hoffman; Drew Ellen,4,0,60,56
1746609326392,COGS 18,A01,886975,Morgan; Eric,34,0,60,26
1746609327418,COGS 20,A01,886977,Staff,3,0,8,5
1746609327418,COGS 20,A02,886978,Staff,5,0,7,2
1746609328444,COGS 100,A01,907783,Staff,0,1,30,30
1746609329472,COGS 101B,A01,886980,Staff,0,4,48,48
1746609330502,COGS 101C,A01,886982,Delgado; Tania,0,5,44,44
1746609331529,COGS 102A,A01,886984,Johnson; Christine M.,3,0,30,27
1746609332558,COGS 118B,A01,886986,Staff,0,4,88,88
1746609333587,COGS 150,A01,886988,Bergen; Benjamin,22,0,50,28
1746609334613,COGS 153,A00,886989,Delgado; Tania,1,3,41,40
1746609335640,COGS 186,A01,886991,Staff,0,0,32,32
1746609336665,COGS 187A,A01,886993,Boyle; Mary E. T.,7,0,30,23
1746609337691,COGS 189,A00,886994,Staff,0,1,30,30
1746609338719,COMM 10,A01,886996,Staff,0,0,20,21
1746609338719,COMM 10,A02,886997,Staff,10,0,20,10
1746609338719,COMM 10,A03,959845,Staff,19,0,20,1
1746609339744,COMM 20,A01,886999,Leuning; Grant Maurstad,24,0,40,16
1746609341798,COMM 100A,A01,887002,Staff,0,0,20,25
1746609341798,COMM 100A,A02,887003,Staff,5,0,20,15
1746609342827,COMM 100B,A01,887005,Staff,0,8,20,24
1746609343853,COMM 106D,A00,887006,Staff,14,0,40,26
1746609344880,COMM 110G,A00,887007,Whitworth-Smith; Andrew C,12,0,40,28
1746609345909,COMM 111B,A00,887008,Staff,31,0,40,9
1746609346936,COMM 113T,A00,887009,Abuelhiga; Soraya Jill,28,0,40,12
1746609346936,COMM 113T,B00,906733,Staff,39,0,40,1
1746609347963,COMM 145,A00,887010,Staff,13,0,40,27
1746609348989,COMM 146,A00,887054,Staff,32,0,40,8
1746609350016,COMM 190,A00,887012,Staff,8,0,23,15
1746609351043,CSE 8A,A50,887015,Cao; Yingjun,56,0,85,29
1746609352068,CSE 11,A01,887017,Cao; Yingjun,11,0,70,59
1746609353097,CSE 20,A01,887019,Staff,30,0,50,20
1746609354122,CSE 21,A01,887021,Staff,79,0,100,21
1746609354122,CSE 21,B01,892583,Braun; Oliver,45,0,50,5
1746609355149,CSE 30,A01,887025,Eldon; John,142,0,200,58
1746609356178,CSE 100,A01,887027,Staff,26,0,50,24
1746609356178,CSE 100,A02,887028,Staff,42,0,50,8
1746609357227,CSE 101,A01,887030,Braun; Oliver,74,0,100,26
1746609357227,CSE 101,B01,887032,Jones; Miles E,0,3,50,50
1746609357227,CSE 101,B02,887033,Jones; Miles E,0,2,50,50
1746609358252,CSE 105,A01,908084,Jones; Miles E,32,0,50,18
1746609358252,CSE 105,A02,908087,Jones; Miles E,31,0,50,19
1746609359280,CSE 135,A01,887035,Powell; Thomas Allan,0,5,50,50
1746609360328,CSE 142,A01,887037,Staff,7,0,60,53
1746609361356,CSE 142L,A01,887039,Staff,34,0,60,26
1746609362385,CSE 151A,A01,887041,Solares; Edwin A,47,0,100,53
1746609363413,CSE 175,A01,887043,Kumar; Rakesh,30,0,30,0
1746609364437,CSS 1,A01,886389,Staff,0,1,40,40
1746609365466,DSC 30,A01,908097,Liao; Soohyun Nam,47,0,75,28
1746609366492,DSC 40A,A01,908099,Shannon; Kyle Michael,30,0,50,20
1746609367517,DSC 40B,A01,908112,Staff,15,0,50,35
1746609368543,DSC 80,A01,908116,Staff,19,0,60,41
1746609369569,DSC 197,001,956863,Eldridge; Justin Matthew,9999,0,9999,0
1746609370594,ECE 5,A01,886400,Morris; Karcher William,1,0,6,5
1746609370594,ECE 5,A02,886401,Morris; Karcher William,3,0,6,3
1746609371623,ECE 148,A01,886403,Silberman; Jack,0,14,14,14
1746609372652,ECON 1,A01,887265,Crane; Meredith Helen,11,0,70,59
1746609372652,ECON 1,B01,887268,Staff,42,0,50,8
1746609373679,ECON 2,A01,887273,Crane; Meredith Helen,54,0,70,16
1746609374707,ECON 3,A01,887279,Rondina; Giacomo,31,0,70,39
1746609375732,ECON 4,A01,887282,Anderson; John Charles,0,2,10,10
1746609376758,ECON 5,A01,887285,Staff,34,0,45,11
1746609376758,ECON 5,B01,887292,Staff,41,0,45,4
1746609377785,ECON 100A,A01,887337,Newhouse; Herbert S,54,0,70,16
1746609377785,ECON 100A,B01,887349,Staff,45,0,50,5
1746609378809,ECON 100B,A01,887361,Du; Songzi,29,0,70,41
1746609379835,ECON 100C,A01,887445,Newhouse; Herbert S,59,0,70,11
1746609380863,ECON 105,A00,887488,Vespa; Emanuel Ignacio,23,0,35,12
1746609381889,ECON 109,A01,887506,Shishkin; Denis,28,0,35,7
1746609382923,ECON 110A,A01,887568,Alon; Titan Michael,0,2,35,35
1746609382923,ECON 110A,B01,907601,Alon; Titan Michael,20,0,35,15
1746609383950,ECON 110B,A01,887598,Levkoff; Steven B.,0,24,70,70
1746609384979,ECON 112,A00,887599,Rondina; Giacomo,19,0,35,16
1746609386010,ECON 120A,A01,887603,Dai; Yinlin,36,0,70,34
1746609387038,ECON 120C,A01,887608,Sun; Yixiao,0,1,35,35
1746609387038,ECON 120C,B01,887614,Sun; Yixiao,0,0,35,35
1746609388063,ECON 138,A00,887621,Bharadwaj; Prashant,0,21,20,20
1746609389087,ECON 144,A00,958007,Squires; Dale E,11,0,35,24
1746609390117,ECON 171,A01,907666,Staff,18,0,35,17
1746609391147,ECON 175,A00,887626,Wu; Pak Yeung,22,0,35,13
1746609392173,ECON 190,A00,887640,Vespa; Emanuel Ignacio,22,0,35,13
1746609393202,EDS 25,A01,888197,Staff,0,0,0,0
1746609393202,EDS 25,A02,888209,Staff,0,0,0,0
1746609393202,EDS 25,A03,888210,Staff,0,0,0,0
1746609393202,EDS 25,A04,888212,Staff,0,0,0,0
1746609393202,EDS 25,A05,888213,Staff,0,0,0,0
1746609393202,EDS 25,A06,888214,Staff,0,0,0,0
1746609393202,EDS 25,A07,888235,Staff,0,2,0,0
1746609393202,EDS 25,A08,888236,Staff,0,0,0,0
1746609393202,EDS 25,A09,888240,Staff,0,0,0,0
1746609393202,EDS 25,A10,888244,Staff,0,0,0,0
1746609393202,EDS 25,B01,888273,Staff,0,0,0,0
1746609393202,EDS 25,B02,888285,Staff,0,0,0,0
1746609393202,EDS 25,B03,888423,Staff,0,0,0,1
1746609393202,EDS 25,B04,888432,Staff,0,0,0,0
1746609393202,EDS 25,B05,888433,Staff,0,0,0,0
1746609393202,EDS 25,B06,888467,Staff,0,0,0,0
1746609393202,EDS 25,B07,888468,Staff,0,0,0,0
1746609393202,EDS 25,B08,888479,Staff,0,0,0,0
1746609393202,EDS 25,B09,888484,Staff,0,0,0,0
1746609393202,EDS 25,B10,888487,Staff,0,0,0,0
1746609394225,EDS 38,A01,907700,Choi; Bailey Miyeon,30,0,30,0
1746609395254,EDS 112,A01,888601,Chapman; Thandeka K,12,0,40,28
1746609396284,EDS 115,A00,888697,Mendez; Kathrina Mendoza,10,0,30,20
1746609397310,EDS 116,A01,888893,Staff,33,0,40,7
1746609399359,EDS 124AR,A00,889133,Staff,29,0,50,21
1746609399359,EDS 124AR,B00,907471,Simon; Elizabeth A,37,0,50,13
1746609400383,EDS 124BR,A00,889134,Simon; Elizabeth A,44,0,100,56
1746609401410,EDS 125,A00,889135,Staff,25,0,30,5
1746609402437,EDS 126,A01,889138,Staff,35,0,40,5
1746609403461,EDS 164R,A01,889142,Wishard Guerra; Alison G.,32,0,50,18
1746609404490,ENG 30,A01,886396,Staff,0,0,0,0
1746609404490,ENG 30,B01,886398,Staff,0,0,0,0
1746609405516,ENVR 102,A00,906150,Montejo; Carolina,23,0,25,2
1746609406540,ETHN 103A,A00,887236,Man; Simeon S,0,2,0,0
1746609407566,ETHN 113,A00,887239,Staff,16,0,30,14
1746609408607,ETHN 116,A00,887240,Staff,16,0,25,9
1746609409635,ETHN 117,A00,887241,Choi; Esther Min,28,0,30,2
1746609410663,ETHN 118,A00,887243,Staff,24,0,30,6
1746609411693,ETHN 127,A00,887248,Cuong; Marisol,11,0,15,4
1746609412717,ETHN 139,A00,887250,Staff,7,0,10,3
1746609413742,ETHN 142,A00,887252,Staff,9,0,30,21
1746609414770,ETHN 161,A00,887253,Browne; Errol Tsekani,24,0,30,6
1746609415797,ETHN 163FR,A00,887255,Burelle; Julie Sara Veronique,0,0,5,5
1746609416824,GLBH 20,A00,889149,Elwardani; Nile Regina,8,0,42,34
1746609418883,GLBH 111,A01,889152,Burgos; Jose L.,17,0,17,0
1746609419910,GLBH 150,A00,889181,Sloane; Julia Kathryn,0,5,15,15
1746609421961,HDS 60,A01,886406,Warstadt; Melissa Fawn,72,0,80,8
1746609422989,HIAF 111,A00,889324,Gyamfi; Bright,25,0,32,7
1746609424014,HIEA 131,A00,889328,Staff,15,0,32,17
1746609425041,HIEA 144,A00,889333,Henry; Todd A.,26,0,32,6
1746609426068,HIEA 154,A00,889336,Henry; Todd A.,24,0,32,8
1746609427094,HIEU 106,A00,889339,Staff,22,0,32,10
1746609429144,HIEU 114,A00,889340,Staff,4,0,32,28
1746609430171,HIEU 135GS,A00,889342,Patterson; Patrick H.,0,0,1,24
1746609431196,HIEU 137,A00,889343,Edington; Claire Ellen,10,0,25,15
1746609432224,HIEU 148,A00,889345,Staff,14,0,32,18
1746609433250,HIEU 154,A00,889346,Biess; Frank Peter,21,0,32,11
1746609434276,HILA 102,A00,889351,Staff,12,0,32,20
1746609435305,HILD 2A,A01,889221,Lewandoski; Julia Mavis,0,8,32,32
1746609436329,HILD 7B,A01,889225,Man; Simeon S,0,12,32,32
1746609437361,HILD 7C,A01,889288,Alvarez; Luis A,0,14,32,32
1746609438389,HILD 30,A01,889323,Staff,0,5,32,32
1746609440444,HISC 119,A00,889383,Golan; Tal,20,0,32,12
1746609441473,HIUS 103,A00,889384,Man; Simeon S,0,0,32,32
1746609442498,HIUS 117,A00,919797,Kwak; Nancy,18,0,32,14
1746609443525,HIUS 142A,A00,919788,Staff,22,0,32,10
1746609445581,HIUS 149,A00,889386,Gyamfi; Bright,26,0,32,6
1746609446607,HIUS 155,A00,889387,Alvarez; Luis A,15,0,32,17
1746609447633,HUM 3,A01,886499,Caldwell; Michael Alan,19,0,50,31
1746609448658,HUM 3GS,A00,886500,Rodriguez; Bretton Sigfred,0,0,0,28
1746609449687,HUM 3R,A01,886502,Markman; Kristina,0,36,50,50
1746609450714,HUM 4,A01,886504,Crum; Matthew Stephen,23,0,50,27
1746609450714,HUM 4,B01,886506,West; Geoffrey Scott,17,0,50,33
1746609451739,HUM 4GS,A00,886507,Staff,0,0,0,19
1746609452767,HUM 5,A01,886509,Staff,31,0,50,19
1746609453797,HUM 5R,A01,886511,Zavodny; Tatiana Sophia,0,39,50,50
1746609454822,JAPN 180,A00,886407,Staff,16,0,40,24
1746609455850,LATI 50,A01,886409,Martin-Cabrera; Luis,3,0,22,19
1746609455850,LATI 50,A02,886410,Martin-Cabrera; Luis,19,0,22,3
1746609455850,LATI 50,A03,886411,Martin-Cabrera; Luis,21,0,22,1
1746609455850,LATI 50,A04,886412,Martin-Cabrera; Luis,8,0,22,14
1746609456875,LAWS 101,A00,907664,Staff,28,0,60,32
1746609457904,LIAB 1A,A00,889388,Saab; Dima,17,0,20,3
1746609458929,LIAB 1AX,A00,889389,El Cheddadi; Youniss,18,0,20,2
1746609459955,LIFR 1C,A00,889391,Van Moer; Vinciane G,8,0,20,12
1746609460981,LIFR 1CX,A00,889392,Van Moer; Vinciane G,7,0,20,13
1746609462005,LIFR 1D,A00,889393,Van Moer; Vinciane G,7,0,20,13
1746609463031,LIFR 1DX,A00,889394,Van Moer; Vinciane G,8,0,20,12
1746609464055,LIGN 7,A00,886923,Staff,25,0,50,25
1746609465082,LIGN 17,A00,886924,Kehler; Andrew Scott,126,0,150,24
1746609466109,LTAM 110,A00,889395,Staff,15,0,30,15
1746609467136,LTAM 110GS,A00,958010,Rodriguez; Bretton Sigfred,0,0,0,28
1746609468165,LTCH 101,A00,889397,Staff,23,0,25,2
1746609469192,LTCS 130,A00,889398,Staff,23,0,25,2
1746609470237,LTEA 138,A00,889399,Staff,24,0,40,16
1746609471264,LTEN 149,A00,889400,Wesling; Megan E.,0,3,25,25
1746609472292,LTEN 169,A00,889401,Staff,20,0,25,5
1746609473316,LTEN 180,A00,889402,Staff,10,0,15,5
1746609474345,LTEN 181,A00,889403,Staff,21,0,25,4
1746609475375,LTWL 100,A00,889404,Myerston Santana; Jacobo,2,0,25,23
1746609476400,LTWL 180GS,A00,889405,Staff,0,0,20,20
1746609477425,LTWL 181,A00,889406,Staff,16,0,25,9
1746609478450,LTWL 184,A00,889475,Mukherjee; Silpa,22,0,25,3
1746609479479,LTWR 102C,A00,889486,Staff,29,0,30,1
1746609480508,LTWR 115W,A00,889491,Staff,0,2,15,15
1746609481532,MAE 8,A01,886905,Staff,0,2,0,0
1746609482559,MAE 11,A00,886906,Bandaru; Prabhakar,0,7,50,50
1746609483589,MAE 20,A00,886907,Evdokimenko; Ekaterina,43,0,70,27
1746609484615,MAE 30B,A00,886909,Ghazinejad; Maziar,25,0,45,20
1746609485641,MAE 101B,A00,886910,Saintillan; David,30,0,45,15
1746609486668,MAE 105,A00,886911,Bandaru; Prabhakar,18,0,50,32
1746609487694,MAE 107,B00,958024,Staff,7,0,50,43
1746609488718,MAE 143B,A00,886913,Bewley; Thomas R,2,0,40,38
1746609489746,MAE 148,A01,886915,Silberman; Jack,0,3,14,14
1746609490775,MAE 160,A00,886916,Evdokimenko; Ekaterina,30,0,60,30
1746609491801,MATH 3C,A01,889681,Staff,0,2,30,30
1746609491801,MATH 3C,A02,960048,Staff,23,0,30,7
1746609492828,MATH 10A,A01,889760,Staff,26,0,30,4
1746609492828,MATH 10A,A02,889783,Staff,29,0,30,1
1746609493857,MATH 10B,A01,889785,Verstraete; Jacques Allan,1,0,35,34
1746609493857,MATH 10B,A02,889795,Verstraete; Jacques Allan,4,0,35,31
1746609493857,MATH 10B,B01,889797,Verstraete; Jacques Allan,3,0,35,32
1746609493857,MATH 10B,B02,889828,Verstraete; Jacques Allan,3,0,35,32
1746609494890,MATH 10C,A01,889849,Habib; Yousaf,8,0,30,22
1746609494890,MATH 10C,A02,889852,Habib; Yousaf,14,0,30,16
1746609494890,MATH 10C,A03,889853,Habib; Yousaf,22,0,30,8
1746609494890,MATH 10C,A04,889858,Habib; Yousaf,20,0,30,10
1746609494890,MATH 10C,B01,889861,Staff,1,0,30,29
1746609494890,MATH 10C,B02,889862,Staff,24,0,30,6
1746609494890,MATH 10C,B03,889863,Staff,27,0,30,3
1746609494890,MATH 10C,B04,889967,Staff,23,0,30,7
1746609495917,MATH 18,A01,889974,Staff,6,0,30,24
1746609495917,MATH 18,A02,889977,Staff,20,0,30,10
1746609495917,MATH 18,B01,889984,Hardiman; Liam,20,0,30,10
1746609495917,MATH 18,B02,889985,Hardiman; Liam,25,0,30,5
1746609496944,MATH 20A,A01,889990,Suk; Andrew Hoon,30,0,35,5
1746609497976,MATH 20B,A01,889993,Ohm; Ko Woon,21,0,30,9
1746609497976,MATH 20B,A02,889994,Ohm; Ko Woon,30,0,30,0
1746609497976,MATH 20B,B01,889996,Ohm; Ko Woon,22,0,30,8
1746609497976,MATH 20B,B02,889997,Ohm; Ko Woon,23,0,30,7
1746609499003,MATH 20C,A01,889999,Hammock; Frances H,17,0,30,13
1746609499003,MATH 20C,A02,890003,Hammock; Frances H,23,0,30,7
1746609499003,MATH 20C,B01,890006,Hammock; Frances H,2,0,30,28
1746609499003,MATH 20C,B02,890007,Hammock; Frances H,11,0,30,19
1746609500034,MATH 20D,A01,890011,Cheng; Hsiao-Bing,1,0,30,29
1746609500034,MATH 20D,A02,890012,Cheng; Hsiao-Bing,14,0,30,16
1746609500034,MATH 20D,B01,890016,Cheng; Hsiao-Bing,13,0,30,17
1746609500034,MATH 20D,B02,890017,Cheng; Hsiao-Bing,13,0,30,17
1746609501067,MATH 20E,A01,890026,Harel; Guershon,1,0,30,29
1746609501067,MATH 20E,A02,890029,Harel; Guershon,22,0,30,8
1746609501067,MATH 20E,B01,890033,Harel; Guershon,7,0,30,23
1746609501067,MATH 20E,B02,890101,Harel; Guershon,21,0,30,9
1746609502093,MATH 102,A01,890104,Staff,18,0,30,12
1746609502093,MATH 102,A02,890105,Staff,27,0,30,3
1746609503117,MATH 103B,A01,890116,Salehi Golsefidy; Alireza,3,0,30,27
1746609503117,MATH 103B,B01,890118,Staff,0,3,34,34
1746609504149,MATH 109,A01,890121,Aliabadi Sr.; Mohsen,0,0,30,30
1746609504149,MATH 109,B01,890124,Upadrashta; Pranav Kumar,18,0,30,12
1746609505176,MATH 120A,A01,890126,Eggers; John Dietrich,13,0,30,17
1746609506203,MATH 142B,A01,890128,Ioana; Adrian,19,0,30,11
1746609506203,MATH 142B,A02,890129,Ioana; Adrian,12,0,30,18
1746609507228,MATH 154,A01,890174,Staff,0,1,30,30
1746609507228,MATH 154,A02,890182,Staff,0,0,30,30
1746609508255,MATH 168A,A01,890197,Dumitriu; Ioana,21,0,35,14
1746609509284,MATH 170A,A01,890240,Nie; Jiawang,1,0,30,29
1746609509284,MATH 170A,A02,890241,Nie; Jiawang,11,0,30,19
1746609509284,MATH 170A,A03,890249,Nie; Jiawang,23,0,30,7
1746609510310,MATH 170B,A01,957891,Nag; Panchali,13,0,35,22
1746609512375,MATH 181A,A01,908025,Staff,0,3,35,35
1746609512375,MATH 181A,A02,960115,Staff,26,0,35,9
1746609513404,MATH 181B,A01,959874,Staff,24,0,30,6
1746609514428,MATH 193B,A01,890265,Staff,0,4,35,35
1746609515457,MGT 4,A01,890311,Anderson; John Charles,42,0,88,46
1746609516484,MGT 5,A00,907740,Staff,12,0,98,86
1746609517509,MGT 12,A00,890312,Lindenberger; Wade Douglas,67,0,98,31
1746609518535,MGT 16,A00,957883,Staff,78,0,98,20
1746609520586,MGT 45,A00,890314,Pecore; Joseph P.,45,0,98,53
1746609521653,MGT 71,A00,890315,Staff,0,12,98,98
1746609522684,MGT 100,A00,890316,Yavorsky; Daniel Ryan,44,0,98,54
1746609523710,MGT 103,A00,890317,Ehrich; Kristine R,73,0,98,25
1746609524739,MGT 105,A00,890356,Bates; Kenneth Walter,0,8,98,98
1746609525764,MGT 112,A00,890360,Ehrich; Kristine R,55,0,98,43
1746609526794,MGT 127R,A00,907732,Zhu; Kevin Xiaoguo,23,0,98,75
1746609527822,MGT 131B,A00,890361,Anderson; John Charles,59,0,98,39
1746609528849,MGT 137,A00,890362,Lindenberger; Wade Douglas,65,0,98,33
1746609529878,MGT 160,A00,890369,Johnson; Erik Barry,9,0,98,89
1746609531934,MGT 164,A00,890372,Zimmermann; Carsten,0,40,98,98
1746609532958,MGT 180,A00,890374,Bliss; Barbara Ann,11,0,98,87
1746609533987,MMW 15,A01,886414,Chang; Edmond Yi-Teh,0,12,28,28
1746609533987,MMW 15,A02,886415,Chang; Edmond Yi-Teh,0,8,28,28
1746609533987,MMW 15,A03,886416,Chang; Edmond Yi-Teh,0,9,28,28
1746609533987,MMW 15,A04,886417,Chang; Edmond Yi-Teh,0,8,28,28
1746609533987,MMW 15,B01,886419,Chang; Edmond Yi-Teh,0,7,28,28
1746609533987,MMW 15,B02,886420,Chang; Edmond Yi-Teh,0,7,28,28
1746609533987,MMW 15,B03,886421,Chang; Edmond Yi-Teh,0,7,28,28
1746609533987,MMW 15,B04,886422,Chang; Edmond Yi-Teh,0,8,28,28
1746609533987,MMW 15,C01,886424,Staff,0,9,28,28
1746609533987,MMW 15,C02,886425,Staff,0,8,28,28
1746609533987,MMW 15,C03,886426,Staff,0,8,28,28
1746609533987,MMW 15,C04,886427,Staff,0,8,28,28
1746609533987,MMW 15,C05,958038,Staff,0,8,28,28
1746609533987,MMW 15,C06,958039,Staff,0,7,28,28
1746609535018,MMW 15GS,A00,906910,Patterson; Patrick H.,4,0,28,24
1746609536043,MMW 122R,A01,886429,Rahimi; Babak,0,13,28,28
1746609536043,MMW 122R,A02,886430,Rahimi; Babak,0,12,28,28
1746609536043,MMW 122R,A03,958040,Rahimi; Babak,0,11,28,28
1746609537072,MUS 1A,A01,890937,Staff,2,0,25,23
1746609537072,MUS 1A,A02,891035,Staff,6,0,25,19
1746609537072,MUS 1A,C01,958912,Staff,24,0,25,1
1746609537072,MUS 1A,C02,958913,Staff,25,0,25,0
1746609539129,MUS 2AK,A00,957092,Ohnishi; Takae,15,0,15,0
1746609540156,MUS 4,A01,891044,Staff,0,0,25,25
1746609540156,MUS 4,A02,891045,Staff,22,0,25,3
1746609540156,MUS 4,B01,891048,Staff,17,0,25,8
1746609540156,MUS 4,B02,891050,Staff,25,0,25,0
1746609541185,MUS 5,A01,957506,Dubnov; Shlomo,0,0,25,25
1746609541185,MUS 5,A02,957622,Dubnov; Shlomo,12,0,25,13
1746609541185,MUS 5,A03,957623,Dubnov; Shlomo,20,0,25,5
1746609542212,MUS 6,A01,891053,Freitas Caetano; Marcelo,24,0,25,1
1746609542212,MUS 6,A02,891054,Freitas Caetano; Marcelo,23,0,25,2
1746609543241,MUS 7,A01,891081,Staff,0,0,25,25
1746609543241,MUS 7,A02,891082,Staff,3,0,25,22
1746609544266,MUS 8GS,A00,891118,Borgo; David Garcia,1,0,25,24
1746609545296,MUS 11,A01,891140,Staff,8,0,25,17
1746609545296,MUS 11,A02,891141,Staff,21,0,25,4
1746609546323,MUS 13,A01,891143,Staff,8,0,25,17
1746609546323,MUS 13,A02,891144,Staff,24,0,25,1
1746609547352,MUS 15,A01,891146,Staff,9,0,25,16
1746609547352,MUS 15,A02,891148,Staff,21,0,25,4
1746609547352,MUS 15,B01,891150,Staff,18,0,25,7
1746609547352,MUS 15,B02,891151,Staff,25,0,25,0
1746609548377,MUS 20,A01,891153,Staff,5,0,20,15
1746609548377,MUS 20,A02,891155,Staff,14,0,20,6
1746609549403,MUS 80,A00,891156,Staff,19,0,25,6
1746609549403,MUS 80,B00,891157,Staff,23,0,25,2
1746609550428,MUS 130,A00,891158,Ohnishi; Takae,35,0,35,0
1746609551454,MUS 150GS,A01,891160,Borgo; David Garcia,1,0,25,24
1746609552481,MUS 170,A01,891162,Freitas Caetano; Marcelo,20,0,25,5
1746609552481,MUS 170,A02,891164,Freitas Caetano; Marcelo,21,0,25,4
1746609553505,NANO 11,A00,886220,Vazquez Mena; Oscar,13,0,15,2
1746609554533,NANO 15,A01,886222,Drews; Aaron,4,0,7,3
1746609555558,NANO 104,A00,886224,Sirbuly; Donald,17,0,25,8
1746609556614,PH 40,A00,886528,Staff,23,0,40,17
1746609557643,PH 45,A01,886799,Staff,35,0,40,5
1746609558669,PH 110,A00,886802,Staff,0,6,40,40
1746609559693,PH 172,A00,906716,Staff,19,0,35,16
1746609560718,PH 191,A00,886803,Staff,6,0,40,34
1746609561744,PHIL 1,A00,889500,Staff,20,0,30,10
1746609562768,PHIL 10,A01,889549,Grush; Rick Scott,16,0,22,6
1746609562768,PHIL 10,A02,889551,Grush; Rick Scott,22,0,22,0
1746609563797,PHIL 28,A01,889559,Lamey; Andy M.,0,2,31,31
1746609563797,PHIL 28,A02,889561,Lamey; Andy M.,0,1,30,30
1746609563797,PHIL 28,A03,889572,Lamey; Andy M.,0,1,30,30
1746609564822,PHIL 35,A00,907839,Staff,13,0,15,2
1746609565850,PHIL 60,A00,889574,Staff,73,0,90,17
1746609566875,PHIL 101,A00,958004,Staff,12,0,15,3
1746609568931,PHIL 136,A00,889582,Fulkerson; Matthew Todd,26,0,45,19
1746609569958,PHIL 163,A01,889601,Staff,21,0,30,9
1746609569958,PHIL 163,B01,889606,Brandt; Reuven A,0,3,0,0
1746609570985,PHIL 164,A00,889610,Staff,16,0,30,14
1746609572014,PHIL 165,A00,889613,Staff,22,0,30,8
1746609573041,PHYS 1A,A00,886431,Staff,30,0,70,40
1746609574067,PHYS 1AL,001,886432,Tsai; Philbert S,0,1,30,30
1746609574067,PHYS 1AL,002,886436,Tsai; Philbert S,13,0,30,17
1746609575093,PHYS 1B,A00,886439,Staff,184,0,240,56
1746609576119,PHYS 1BL,001,886441,Tsai; Philbert S,0,4,30,30
1746609576119,PHYS 1BL,002,886444,Tsai; Philbert S,2,0,30,28
1746609577146,PHYS 1C,A00,896092,Arnold; Kam S,78,0,146,68
1746609578171,PHYS 1CL,001,886448,Tsai; Philbert S,0,0,30,30
1746609578171,PHYS 1CL,002,886449,Tsai; Philbert S,1,0,30,29
1746609578171,PHYS 1CL,003,886450,Tsai; Philbert S,16,0,30,14
1746609578171,PHYS 1CL,004,886451,Tsai; Philbert S,15,0,30,15
1746609579196,PHYS 2B,A01,886457,Staff,67,0,115,48
1746609580221,PHYS 2C,A01,886460,Shotwell; Brian,0,9,65,65
1746609581251,PHYS 2CL,A01,886467,Staff,0,4,28,28
1746609581251,PHYS 2CL,A02,886468,Staff,0,3,28,28
1746609582282,PHYS 2D,A01,886470,Staff,10,0,50,40
1746609583308,PHYS 4B,A01,886475,Grinstein; Benjamin,22,0,40,18
1746609584333,POLI 5,A00,891173,Desposato; Scott,7,0,25,18
1746609585363,POLI 5D,A01,891175,Staff,5,0,5,0
1746609585363,POLI 5D,B01,891178,Staff,5,0,5,0
1746609586389,POLI 11,A00,891179,Ferree; Karen E,0,0,35,35
1746609587414,POLI 12,A00,891180,Staff,15,0,30,15
1746609588440,POLI 27,A01,891182,Staff,11,0,75,64
1746609589466,POLI 30,A00,891183,Staff,8,0,50,42
1746609590495,POLI 100B,A00,891244,Staff,5,1,35,30
1746609591524,POLI 100I,A00,891247,Staff,7,0,30,23
1746609592552,POLI 104J,A00,891248,Nichter; Maysa,14,0,30,16
1746609593579,POLI 104U,A00,891250,Nichter; Maysa,1,0,30,29
1746609595640,POLI 110B,A00,891255,Wiens; David,19,0,25,6
1746609596669,POLI 112A,A00,891256,Wiens; David,6,0,25,19
1746609597695,POLI 114BR,A00,891261,Staff,19,0,30,11
1746609598722,POLI 117R,A00,891262,Forman; Fonna,0,6,50,50
1746609599754,POLI 118,A00,891264,Ingham; Sean,17,0,25,8
1746609600784,POLI 124A,A00,891265,Staff,18,0,20,2
1746609601815,POLI 125D,A00,891266,Nichter; Simeon C,2,0,25,23
1746609602846,POLI 126,A00,891268,Nichter; Simeon C,7,0,25,18
1746609603873,POLI 126AA,A00,891272,Staff,15,0,25,10
1746609604902,POLI 130AA,A00,891273,Staff,15,0,20,5
1746609605927,POLI 134AA,A00,891274,Staff,4,0,20,16
1746609607985,POLI 138,A00,891278,Staff,21,0,25,4
1746609609015,POLI 142K,A00,891280,Staff,10,0,25,15
1746609610044,POLI 142M,A00,891281,Gartzke; Erik,16,0,30,14
1746609611071,POLI 142P,A00,891284,Staff,20,0,30,10
1746609612101,POLI 143,A00,891285,Gartzke; Erik,12,0,30,18
1746609613128,POLI 153,A00,891286,Staff,19,0,20,1
1746609615185,POLI 175,A00,891290,Staff,15,0,20,5
1746609616212,PSYC 1,A00,890674,Steiner; Eric Tomas,0,11,45,45
1746609617238,PSYC 2,A00,890676,Albright; Thomas D,20,0,35,15
1746609618264,PSYC 3,A00,890679,Staff,17,0,20,3
1746609619289,PSYC 6,A00,959858,Staff,19,0,20,1
1746609620315,PSYC 60,A01,890684,Rickard; Timothy C.,0,6,45,45
1746609621341,PSYC 70,A01,890689,Geller; Emma Harlan,6,0,30,24
1746609622368,PSYC 71,A01,959860,Staff,21,0,25,4
1746609623398,PSYC 100,A00,890690,Lacefield; Katharine I,0,50,180,180
1746609624448,PSYC 102,A00,890695,Staff,18,0,40,22
1746609625474,PSYC 105,A00,890699,Geller; Emma Harlan,70,0,100,30
1746609626500,PSYC 106,A00,890701,Gorman; Michael R.,5,0,30,25
1746609627531,PSYC 108,A00,890704,Adrian; Julia Anna,0,29,50,50
1746609628556,PSYC 118,A01,890712,Staff,11,0,30,19
1746609629582,PSYC 124,A00,890716,Chapman; Eddie Nathaniel,25,0,60,35
1746609630613,PSYC 131,A00,890717,Anagnostaras; Stephan,0,7,80,80
1746609631642,PSYC 137,A00,890719,Winkielman; Piotr,0,11,30,30
1746609632667,PSYC 144,A00,890721,Adrian; Julia Anna,0,9,45,45
1746609633694,PSYC 162,A00,890805,Staff,0,2,75,75
1746609634721,PSYC 169,A00,890810,Staff,0,15,30,30
1746609635752,PSYC 172,A00,890814,Gorman; Michael R.,9,0,30,21
1746609636779,PSYC 181,A00,890818,Anagnostaras; Stephan,6,0,200,194
1746609637806,PSYC 184,A00,959861,Staff,160,0,175,15
1746609638834,PSYC 189,A00,890823,Staff,0,2,30,30
1746609639864,PSYC 191,A00,890884,Rickard; Timothy C.,0,12,35,35
1746609640894,PSYC 193,A00,890913,Staff,19,0,30,11
1746609640894,PSYC 193,B00,890914,Chapman; Eddie Nathaniel,24,0,30,6
1746609641920,PSYC 193L,A01,890918,Lowe; Angela Beth,20,0,30,10
1746609641920,PSYC 193L,B01,890921,Hurwitz; Ethan Scott,20,0,30,10
1746609641920,PSYC 193L,C01,890928,Staff,30,0,30,0
1746609642946,RELI 149,A00,886806,Rahimi; Babak,23,0,40,17
1746609643969,SE 9,A01,886814,Staff,7,0,20,13
1746609644998,SE 101B,A01,886816,Chadha; Mayank,3,0,35,32
1746609646029,SE 110B,A00,886818,Zhu; Qiang,4,0,75,71
1746609647053,SE 125,A01,886830,Staff,10,0,30,20
1746609648081,SE 130B,A01,886835,Staff,14,0,40,26
1746609649109,SE 131A,A01,886838,Krysl; Petr,34,0,55,21
1746609650137,SE 154,A00,886840,Staff,28,0,50,22
1746609651164,SE 164GS,A01,886849,Staff,6,0,20,14
1746609652193,SE 167GS,A01,886853,Staff,6,0,20,14
1746609653222,SIO 25,A01,890107,Staff,19,0,30,11
1746609654248,SIO 45,A00,890109,Cook; Geoffrey W,114,0,200,86
1746609655275,SIO 109R,A00,890110,Forman; Fonna,0,16,20,20
1746609656304,SIO 187,A01,890114,Kacev; David,15,0,40,25
1746609657328,SOCI 1,A01,890431,Thorpe; Charles Robert,14,0,30,16
1746609657328,SOCI 1,A02,890518,Thorpe; Charles Robert,30,0,30,0
1746609658354,SOCI 2,A01,957978,Staff,25,0,25,0
1746609658354,SOCI 2,A02,957979,Staff,23,0,25,2
1746609659381,SOCI 20,A01,890523,Calderon-Zaks; Michael Aar,21,0,30,9
1746609659381,SOCI 20,A02,890526,Calderon-Zaks; Michael Aar,29,0,30,1
1746609660411,SOCI 30,A01,890533,Pardo Guerra; Juan Pablo,37,0,40,3
1746609661437,SOCI 40,A01,890535,Staff,27,0,45,18
1746609662471,SOCI 104Q,A00,890559,Staff,17,0,30,13
1746609663501,SOCI 106,A00,890560,Arnal; Maud Marie Leonie,20,0,30,10
1746609664530,SOCI 110,A00,890567,Holkenbrink-Monk; Charlene,19,0,30,11
1746609665558,SOCI 112,A00,890568,Victoria Torres; Pablo,2,0,55,53
1746609666585,SOCI 115,A00,890597,Arnal; Maud Marie Leonie,28,0,45,17
1746609668637,SOCI 121,A00,890604,Pardo Guerra; Juan Pablo,38,0,45,7
1746609669663,SOCI 126,A01,890608,Staff,8,0,10,2
1746609670690,SOCI 127,A00,890609,Staff,18,0,30,12
1746609671719,SOCI 131,A00,890610,Thorpe; Charles Robert,37,0,45,8
1746609672746,SOCI 135,A00,890615,Payne; Christine Anna,14,0,45,31
1746609673772,SOCI 139,A00,890620,Staff,38,0,45,7
1746609674800,SOCI 148E,A00,890622,Calderon-Zaks; Michael Aar,36,0,45,9
1746609675829,SOCI 150,A00,890623,Kohler; Kristopher M.,31,0,45,14
1746609676854,SOCI 157,A00,890625,Jules-Rosette; Bennetta W.,18,0,20,2
1746609677879,SOCI 160,A00,890627,Payne; Christine Anna,21,0,45,24
1746609678907,SYN 1,A00,886855,Fish; Gwendolyn Anne,0,1,0,0
1746609678907,SYN 1,B00,906086,Fish; Gwendolyn Anne,0,2,0,2
1746609679937,SYN 2R,A00,886860,Staff,0,17,15,15
1746609679937,SYN 2R,B00,906106,Atkinson; Arthur Laird,0,16,15,15
1746609680971,SYN 100,A01,886866,Browne; Emily,0,28,20,20
1746609680971,SYN 100,B01,906128,Rock; Martin,0,4,20,20
1746609680971,SYN 100,C01,906140,Deavenport; James Cary,0,4,20,20
1746609680971,SYN 100,D01,907816,Deavenport; James Cary,0,5,20,20
1746609682000,TDAC 1,A00,890286,Walsh; Kim C.,7,0,20,13
1746609683027,TDAC 101,A00,890296,Basso; Beatrice,15,0,20,5
1746609684115,TDDE 131,A00,890297,Staff,47,0,50,3
1746609685142,TDDM 1,A00,890287,Weinberg; Sadie,25,0,30,5
1746609686167,TDGE 11,A00,890288,Fulton; Julia,138,0,200,62
1746609686167,TDGE 11,B00,890289,Castro; Robert Jess,184,0,200,16
1746609687197,TDGE 25,B00,957359,Walsh; Kim C.,5,0,20,15
1746609688228,TDGE 40,A01,890292,Power; Jade Yukana,26,0,30,4
1746609689253,TDGE 124,A00,890298,Havis; Allan,0,2,50,50
1746609690283,TDGE 131R,A00,890299,Burelle; Julie Sara Veronique,15,0,42,27
1746609691310,TDHT 101,A00,890300,Staff,10,0,20,10
1746609692341,TDHT 109,A01,890302,Anderson; Mysia Anyse,31,0,40,9
1746609693368,TDMV 1,A00,890293,Arcidiacono; Kristin,18,0,30,12
1746609694395,TDMV 2,A00,890294,Weinberg; Sadie,23,0,30,7
1746609695421,TDMV 3,A00,957878,Arcidiacono; Kristin,28,0,30,2
1746609697475,TDMV 138,A00,890304,Jun; Grace Shin Hae,25,0,40,15
1746609698499,TDMV 140,A00,890305,Corrales; Joseph Bernales,25,0,30,5
1746609699525,TDMV 142,A00,890307,Caligagan; Tony,32,0,40,8
1746609700551,TDMV 144,A00,890308,Camaya; Michelle Ann,25,0,30,5
1746609701575,TDPW 1,A00,890295,Stein; Deborah Isobel,3,0,20,17
1746609702602,USP 2,A01,890272,Lerner; Amy M,7,0,20,13
1746609703631,USP 3,A01,890274,Staff,12,0,30,18
1746609704659,USP 15,A01,890276,Sun; Feiyang,16,0,30,14
1746609705682,USP 25,A00,890277,Shenkman; Michael Thomas,18,0,25,7
1746609706706,USP 138,A00,890278,Staff,13,0,25,12
1746609707731,USP 143,A00,890279,Staff,21,0,70,49
1746609708757,USP 144,A00,890280,Chowdhury; Muhammed Zohir,16,0,30,14
1746609709784,USP 150,A00,890281,Boomhower; Matthew Charles,4,0,30,26
1746609710809,USP 151,A00,890282,Staff,16,0,20,4
1746609711837,USP 162,A00,890283,Andrews; Abigail Leslie,16,0,20,4
1746609712862,USP 168,A00,920477,Kwak; Nancy,0,0,5,5
1746609713886,USP 181,A00,890284,Staff,3,0,20,17
1746609714911,USP 191A,A00,890285,Staff,12,0,20,8
1746609715936,VIS 101,A00,886512,Staff,26,0,75,49
1746609716964,VIS 103,A00,886513,Cruz; Edwin Teddy,61,0,75,14
1746609717993,VIS 108,A00,886514,Staff,4,0,15,11
1746609719025,VIS 127P,A00,886515,Shen; Kuiyi,80,0,146,66
1746609720055,VIS 149,A00,886516,Yoldas; Pinar,0,0,15,15
1746609721082,VIS 164,A00,886526,Erdmann; Dean,19,0,22,3
1746609722107,VIS 194S,A00,886527,Staff,61,0,75,14
1746609723134,WCWP 10A,C00,886484,Martiniuk; Jill,12,0,15,3
1746609724164,WCWP 10B,A00,886490,Uriarte; Emma,0,0,15,15
1746609724164,WCWP 10B,B00,886491,Dhir; Simrita,8,0,15,7
1746609724164,WCWP 10B,C00,886492,Ornelas; Tricia,0,0,15,15
1746609725195,WCWP 100,A00,886494,Young; Mark T,0,6,15,15
1746609727317,AAS 10,A01,886199,Childs; Dennis R.,0,3,0,0
1746609728347,ANAR 104,A01,886940,Shtienberg; Gilad,27,0,30,3
1746609729377,ANAR 120,A00,886953,Staff,13,0,20,7
1746609730403,ANBI 148,A01,886955,Wilder; Linnea Lorene,30,0,40,10
1746609732457,ANSC 122,A00,886957,Staff,24,0,30,6
1746609733482,ANSC 150,A00,886958,Sloane; Julia Kathryn,2,0,15,13
1746609734549,ANSC 156,A00,886959,Jenkins; Janis A.,0,1,15,15
1746609735579,ANSC 180,A00,886960,Staff,11,0,17,6
1746609736609,ANSC 188,A00,886961,Jassal; Aftab,9,0,25,16
1746609737638,ANSC 190,A00,886962,Jassal; Aftab,14,0,25,11
1746609738663,ANSC 191,A00,886963,Staff,18,0,20,2
1746609739690,ANTH 3,A01,891689,Staff,17,0,20,3
1746609740715,ANTH 5,A00,886933,Semendeferi; Ekaterini,16,0,20,4
1746609741740,ANTH 10,A00,886934,Staff,0,12,30,30
1746609742766,ANTH 21,A01,886936,Staff,41,0,60,19
1746609743793,ANTH 23,A01,886938,Staff,92,0,100,8
1746609744818,ANTH 105,A00,886964,Stewart; Alexander B,84,0,100,16
1746609745845,ANTH 108,A00,886965,Pedersen; David,9,0,20,11
1746609746877,AWP 10,001,886147,Staff,0,0,0,0
1746609746877,AWP 10,002,886148,Staff,0,0,0,0
1746609746877,AWP 10,003,886149,Staff,0,0,0,0
1746609746877,AWP 10,004,886150,Staff,0,0,0,0
1746609746877,AWP 10,005,886151,Staff,0,0,0,0
1746609746877,AWP 10,006,886152,Staff,0,0,0,0
1746609746877,AWP 10,007,886153,Staff,0,0,0,0
1746609746877,AWP 10,008,886154,Staff,0,0,0,0
1746609746877,AWP 10,009,886155,Staff,0,0,0,0
1746609746877,AWP 10,010,886156,Staff,0,0,0,0
1746609746877,AWP 10,011,886158,Staff,0,0,0,0
1746609746877,AWP 10,012,886160,Staff,0,0,0,0
1746609746877,AWP 10,013,886161,Staff,0,0,0,0
1746609746877,AWP 10,014,886162,Staff,0,0,0,0
1746609746877,AWP 10,015,886163,Staff,0,0,0,0
1746609746877,AWP 10,016,886164,Staff,0,0,0,0
1746609746877,AWP 10,017,886165,Staff,0,0,0,0
1746609746877,AWP 10,018,886166,Staff,0,0,0,0
1746609746877,AWP 10,019,886168,Staff,0,0,0,0
1746609746877,AWP 10,020,886170,Staff,0,0,0,0
1746609746877,AWP 10,021,886172,Staff,0,0,0,0
1746609747916,AWP 10R,001,886173,Staff,0,1,0,0
1746609747916,AWP 10R,002,886174,Staff,0,1,0,0
1746609747916,AWP 10R,003,886175,Staff,0,0,0,0
1746609747916,AWP 10R,004,886176,Staff,0,0,0,0
1746609747916,AWP 10R,005,886177,Staff,0,0,0,0
1746609747916,AWP 10R,006,886178,Staff,0,0,0,0
1746609747916,AWP 10R,007,886179,Staff,0,0,0,0
1746609747916,AWP 10R,008,886181,Staff,0,0,0,0
1746609747916,AWP 10R,009,886182,Staff,0,0,0,0
1746609747916,AWP 10R,010,886183,Staff,0,0,0,0
1746609747916,AWP 10R,011,886184,Staff,0,0,0,0
1746609747916,AWP 10R,012,886185,Staff,0,0,0,0
1746609747916,AWP 10R,013,886186,Staff,0,0,0,0
1746609747916,AWP 10R,014,886187,Staff,0,0,0,0
1746609747916,AWP 10R,015,886188,Staff,0,0,0,0
1746609747916,AWP 10R,016,886189,Staff,0,0,0,0
1746609747916,AWP 10R,017,960532,Staff,0,0,0,0
1746609747916,AWP 10R,018,960533,Staff,0,0,0,0
1746609747916,AWP 10R,019,960534,Staff,0,0,0,0
1746609747916,AWP 10R,020,960538,Staff,0,0,0,0
1746609747916,AWP 10R,021,960540,Staff,0,0,0,0
1746609747916,AWP 10R,022,960541,Staff,0,0,0,0
1746609747916,AWP 10R,023,960542,Staff,0,0,0,0
1746609747916,AWP 10R,024,960544,Staff,0,0,0,0
1746609747916,AWP 10R,025,960545,Staff,0,0,0,0
1746609747916,AWP 10R,026,960548,Staff,0,0,0,0
1746609748946,AWP 102R,A00,886190,Staff,0,0,0,0
1746609748946,AWP 102R,B00,886191,Staff,0,0,0,0
1746609749973,BENG 100,A01,886193,Staff,17,0,30,13
1746609751001,BENG 122A,A01,886195,Hasty; Jeff M,13,0,30,17
1746609752028,BENG 166A,A00,886196,Sah; Robert Lie-Yuan,0,3,30,30
1746609753058,BENG 190,A00,958050,Khojah; Reem I,17,0,25,8
1746609754087,BIBC 102,A01,894320,Staff,0,1,46,46
1746609754087,BIBC 102,A02,894321,Staff,0,0,46,46
1746609754087,BIBC 102,A03,894344,Staff,6,0,46,40
1746609754087,BIBC 102,A04,894345,Staff,27,0,47,20
1746609755120,BICD 100R,A01,894365,Smith; Laurie,0,2,58,58
1746609755120,BICD 100R,A02,894366,Smith; Laurie,0,4,58,58
1746609755120,BICD 100R,A03,894367,Smith; Laurie,0,0,59,59
1746609755120,BICD 100R,A04,959869,Smith; Laurie,38,0,59,21
1746609756151,BICD 136,A01,894383,Gustafson-Brown; Cindy,14,0,50,36
1746609757178,BIEB 102,A01,894494,Butler; Shannon Rhey,51,0,130,79
1746609759231,BIEB 150,A01,894617,Wills; Christopher,3,0,20,17
1746609759231,BIEB 150,A02,894631,Wills; Christopher,3,0,20,17
1746609759231,BIEB 150,A03,894937,Wills; Christopher,3,0,20,17
1746609759231,BIEB 150,A04,894946,Wills; Christopher,5,0,20,15
1746609760259,BIEB 194,A00,906141,Kurle; Carolyn M.,5,0,20,15
1746609761291,BILD 1,A01,894154,Staff,3,0,19,16
1746609761291,BILD 1,A02,894155,Staff,14,0,19,5
1746609761291,BILD 1,A03,894160,Staff,13,0,19,6
1746609761291,BILD 1,A04,894161,Staff,15,0,18,3
1746609762317,BILD 2,A01,894168,Staff,0,0,50,50
1746609762317,BILD 2,A02,894169,Staff,0,0,50,50
1746609762317,BILD 2,A03,894179,Staff,0,0,50,50
1746609762317,BILD 2,A04,894203,Staff,22,0,50,28
1746609763342,BILD 3,A01,894213,Staff,23,0,31,8
1746609763342,BILD 3,A02,894214,Staff,26,0,31,5
1746609763342,BILD 3,A03,894235,Staff,28,0,31,3
1746609763342,BILD 3,A04,894236,Staff,28,0,32,4
1746609764374,BILD 4,A01,894253,Reuther; Keefe,5,0,24,19
1746609764374,BILD 4,A02,894258,Reuther; Keefe,16,0,24,8
1746609765400,BILD 5,A01,894276,Reuther; Keefe,33,0,50,17
1746609765400,BILD 5,A02,894277,Reuther; Keefe,45,0,50,5
1746609765400,BILD 5,A03,894290,Reuther; Keefe,44,0,50,6
1746609765400,BILD 5,A04,894291,Reuther; Keefe,48,0,50,2
1746609766426,BILD 24,A01,894297,Pirino; Giorgia,40,0,60,20
1746609767456,BIMM 100,B01,958915,Staff,71,0,100,29
1746609768490,BIMM 101,A01,895017,McDonnell; Lisa Marie,0,5,24,24
1746609768490,BIMM 101,A02,895018,McDonnell; Lisa Marie,0,5,24,24
1746609768490,BIMM 101,B01,895020,McDonnell; Lisa Marie,0,5,24,24
1746609768490,BIMM 101,B02,895021,McDonnell; Lisa Marie,0,4,24,24
1746609769519,BIMM 110,A01,895023,Staff,1,0,25,24
1746609769519,BIMM 110,A02,895024,Staff,9,0,25,16
1746609769519,BIMM 110,A03,895025,Staff,18,0,25,7
1746609769519,BIMM 110,A04,895031,Staff,20,0,25,5
1746609770550,BIMM 120,A01,895114,Gustafson-Brown; Cindy,14,0,28,14
1746609770550,BIMM 120,A02,895126,Gustafson-Brown; Cindy,21,0,27,6
1746609771578,BIPN 100,A01,895130,Yang; Mingyu,0,0,38,38
1746609771578,BIPN 100,A02,895131,Yang; Mingyu,31,0,38,7
1746609771578,BIPN 100,A03,895132,Yang; Mingyu,32,0,38,6
1746609771578,BIPN 100,A04,895133,Yang; Mingyu,27,0,36,9
1746609772610,BIPN 120,A01,895135,Cooke; James Edward,0,3,13,13
1746609772610,BIPN 120,A02,895136,Cooke; James Edward,0,1,13,13
1746609772610,BIPN 120,A03,895137,Cooke; James Edward,0,3,13,13
1746609772610,BIPN 120,A04,895156,Cooke; James Edward,0,2,11,11
1746609773637,BIPN 134,A01,895235,Cooke; James Edward,0,1,25,25
1746609773637,BIPN 134,A02,895237,Cooke; James Edward,0,0,25,25
1746609773637,BIPN 134,A03,895240,Cooke; James Edward,1,0,25,24
1746609773637,BIPN 134,A04,895270,Cooke; James Edward,20,0,25,5
1746609774663,BIPN 189,A00,892103,Staff,0,14,14,14
1746609776715,BISP 194,A00,958008,Staff,0,2,0,0
1746609777743,CAT 124,A01,922009,Staff,0,5,20,20
1746609778776,CAT 125R,A00,886390,Morales; Celeste Georgianna,0,4,20,20
1746609778776,CAT 125R,B00,886391,Irwin; Matthew Joseph,0,4,20,20
1746609778776,CAT 125R,C00,886392,Smith; Lauryn Alissa,0,2,20,20
1746609778776,CAT 125R,D00,886393,Vanderschuit; Maya Alysia,0,3,20,20
1746609778776,CAT 125R,E00,886394,Marchisotto; Jennifer Anne,0,3,20,20
1746609779802,CENG 15,A01,886218,Drews; Aaron,3,0,8,5
1746609780828,CENG 113,A00,886219,Opatkiewicz; Justin Paul,15,0,25,10
1746609781853,CGS 101,A00,887044,Staff,7,0,20,13
1746609782882,CGS 105,A01,887046,Staff,14,0,25,11
1746609783911,CGS 112,A00,887047,Cuong; Marisol,12,0,15,3
1746609784939,CGS 113,A00,887048,Staff,23,0,30,7
1746609785966,CGS 120,A00,887049,Staff,9,0,17,8
1746609786993,CHEM 6A,A01,886336,Lam; Tin Yiu,38,0,50,12
1746609786993,CHEM 6A,A02,886338,Lam; Tin Yiu,37,0,50,13
1746609788025,CHEM 6B,A01,886341,Hopkins; Patrycja Anna,16,0,50,34
1746609788025,CHEM 6B,A02,886343,Hopkins; Patrycja Anna,42,0,50,8
1746609789057,CHEM 6C,A01,886346,Albizati; Kim F.,0,2,50,50
1746609789057,CHEM 6C,A02,886348,Albizati; Kim F.,24,0,50,26
1746609790084,CHEM 40A,A01,886352,Klosterman; Jeremy K,65,0,100,35
1746609791113,CHEM 40B,A01,886356,Klosterman; Jeremy K,0,24,100,100
1746609792141,CHEM 41B,A01,886360,Theodorakis; Emmanuel,25,0,50,25
1746609792141,CHEM 41B,A02,886362,Theodorakis; Emmanuel,47,0,50,3
1746609793173,CHIN 165A,A00,886382,Xu; Li,18,0,20,2
1746609794203,CLAS 120,A00,886387,Myerston Santana; Jacobo,33,0,40,7
1746609795232,COGS 9,A01,886967,Shannon; Kyle Michael,42,0,60,18
1746609796258,COGS 11,A01,886969,Staff,9,0,30,21
1746609797283,COGS 14A,A01,886971,Staff,5,0,60,55
1746609798314,COGS 14B,A01,886973,Hoffman; Drew Ellen,4,0,60,56
1746609799343,COGS 18,A01,886975,Morgan; Eric,34,0,60,26
1746609800370,COGS 20,A01,886977,Staff,3,0,8,5
1746609800370,COGS 20,A02,886978,Staff,5,0,7,2
1746609801397,COGS 100,A01,907783,Staff,0,1,30,30
1746609802430,COGS 101B,A01,886980,Staff,0,4,48,48
1746609803455,COGS 101C,A01,886982,Delgado; Tania,0,5,44,44
1746609804481,COGS 102A,A01,886984,Johnson; Christine M.,3,0,30,27
1746609805509,COGS 118B,A01,886986,Staff,0,4,88,88
1746609806538,COGS 150,A01,886988,Bergen; Benjamin,22,0,50,28
1746609807566,COGS 153,A00,886989,Delgado; Tania,1,3,41,40
1746609808596,COGS 186,A01,886991,Staff,0,0,32,32
1746609809625,COGS 187A,A01,886993,Boyle; Mary E. T.,7,0,30,23
1746609810656,COGS 189,A00,886994,Staff,0,1,30,30
1746609811681,COMM 10,A01,886996,Staff,0,0,20,21
1746609811681,COMM 10,A02,886997,Staff,10,0,20,10
1746609811681,COMM 10,A03,959845,Staff,19,0,20,1
1746609812707,COMM 20,A01,886999,Leuning; Grant Maurstad,24,0,40,16
1746609814758,COMM 100A,A01,887002,Staff,0,0,20,25
1746609814758,COMM 100A,A02,887003,Staff,5,0,20,15
1746609815787,COMM 100B,A01,887005,Staff,0,8,20,24
1746609816817,COMM 106D,A00,887006,Staff,14,0,40,26
1746609817846,COMM 110G,A00,887007,Whitworth-Smith; Andrew C,12,0,40,28
1746609818873,COMM 111B,A00,887008,Staff,31,0,40,9
1746609819900,COMM 113T,A00,887009,Abuelhiga; Soraya Jill,28,0,40,12
1746609819900,COMM 113T,B00,906733,Staff,39,0,40,1
1746609820930,COMM 145,A00,887010,Staff,13,0,40,27
1746609821960,COMM 146,A00,887054,Staff,32,0,40,8
1746609822985,COMM 190,A00,887012,Staff,8,0,23,15
1746609824013,CSE 8A,A50,887015,Cao; Yingjun,56,0,85,29
1746609825045,CSE 11,A01,887017,Cao; Yingjun,11,0,70,59
1746609826071,CSE 20,A01,887019,Staff,30,0,50,20
1746609827097,CSE 21,A01,887021,Staff,79,0,100,21
1746609827097,CSE 21,B01,892583,Braun; Oliver,45,0,50,5
1746609828124,CSE 30,A01,887025,Eldon; John,142,0,200,58
1746609829151,CSE 100,A01,887027,Staff,26,0,50,24
1746609829151,CSE 100,A02,887028,Staff,42,0,50,8
1746609830179,CSE 101,A01,887030,Braun; Oliver,74,0,100,26
1746609830179,CSE 101,B01,887032,Jones; Miles E,0,3,50,50
1746609830179,CSE 101,B02,887033,Jones; Miles E,0,2,50,50
1746609831206,CSE 105,A01,908084,Jones; Miles E,32,0,50,18
1746609831206,CSE 105,A02,908087,Jones; Miles E,31,0,50,19
1746609832231,CSE 135,A01,887035,Powell; Thomas Allan,0,5,50,50
1746609833256,CSE 142,A01,887037,Staff,7,0,60,53
1746609834281,CSE 142L,A01,887039,Staff,34,0,60,26
1746609835307,CSE 151A,A01,887041,Solares; Edwin A,47,0,100,53
1746609836336,CSE 175,A01,887043,Kumar; Rakesh,30,0,30,0
1746609837362,CSS 1,A01,886389,Staff,0,1,40,40
1746609838388,DSC 30,A01,908097,Liao; Soohyun Nam,47,0,75,28
1746609839418,DSC 40A,A01,908099,Shannon; Kyle Michael,30,0,50,20
1746609840446,DSC 40B,A01,908112,Staff,15,0,50,35
1746609841471,DSC 80,A01,908116,Staff,19,0,60,41
1746609842499,DSC 197,001,956863,Eldridge; Justin Matthew,9999,0,9999,0
1746609843523,ECE 5,A01,886400,Morris; Karcher William,1,0,6,5
1746609843523,ECE 5,A02,886401,Morris; Karcher William,3,0,6,3
1746609844547,ECE 148,A01,886403,Silberman; Jack,0,14,14,14
1746609845576,ECON 1,A01,887265,Crane; Meredith Helen,11,0,70,59
1746609845576,ECON 1,B01,887268,Staff,42,0,50,8
1746609846602,ECON 2,A01,887273,Crane; Meredith Helen,54,0,70,16
1746609847627,ECON 3,A01,887279,Rondina; Giacomo,31,0,70,39
1746609848654,ECON 4,A01,887282,Anderson; John Charles,0,2,10,10
1746609849684,ECON 5,A01,887285,Staff,34,0,45,11
1746609849684,ECON 5,B01,887292,Staff,41,0,45,4
1746609850715,ECON 100A,A01,887337,Newhouse; Herbert S,54,0,70,16
1746609850715,ECON 100A,B01,887349,Staff,45,0,50,5
1746609851740,ECON 100B,A01,887361,Du; Songzi,29,0,70,41
1746609852768,ECON 100C,A01,887445,Newhouse; Herbert S,59,0,70,11
1746609853796,ECON 105,A00,887488,Vespa; Emanuel Ignacio,23,0,35,12
1746609854826,ECON 109,A01,887506,Shishkin; Denis,28,0,35,7
1746609855857,ECON 110A,A01,887568,Alon; Titan Michael,0,2,35,35
1746609855857,ECON 110A,B01,907601,Alon; Titan Michael,20,0,35,15
1746609856884,ECON 110B,A01,887598,Levkoff; Steven B.,0,24,70,70
1746609857913,ECON 112,A00,887599,Rondina; Giacomo,19,0,35,16
1746609858943,ECON 120A,A01,887603,Dai; Yinlin,36,0,70,34
1746609859973,ECON 120C,A01,887608,Sun; Yixiao,0,1,35,35
1746609859973,ECON 120C,B01,887614,Sun; Yixiao,0,0,35,35
1746609861002,ECON 138,A00,887621,Bharadwaj; Prashant,0,21,20,20
1746609862028,ECON 144,A00,958007,Squires; Dale E,11,0,35,24
1746609863053,ECON 171,A01,907666,Staff,18,0,35,17
1746609864080,ECON 175,A00,887626,Wu; Pak Yeung,22,0,35,13
1746609865105,ECON 190,A00,887640,Vespa; Emanuel Ignacio,22,0,35,13
1746609866133,EDS 25,A01,888197,Staff,0,0,0,0
1746609866133,EDS 25,A02,888209,Staff,0,0,0,0
1746609866133,EDS 25,A03,888210,Staff,0,0,0,0
1746609866133,EDS 25,A04,888212,Staff,0,0,0,0
1746609866133,EDS 25,A05,888213,Staff,0,0,0,0
1746609866133,EDS 25,A06,888214,Staff,0,0,0,0
1746609866133,EDS 25,A07,888235,Staff,0,2,0,0
1746609866133,EDS 25,A08,888236,Staff,0,0,0,0
1746609866133,EDS 25,A09,888240,Staff,0,0,0,0
1746609866133,EDS 25,A10,888244,Staff,0,0,0,0
1746609866133,EDS 25,B01,888273,Staff,0,0,0,0
1746609866133,EDS 25,B02,888285,Staff,0,0,0,0
1746609866133,EDS 25,B03,888423,Staff,0,0,0,1
1746609866133,EDS 25,B04,888432,Staff,0,0,0,0
1746609866133,EDS 25,B05,888433,Staff,0,0,0,0
1746609866133,EDS 25,B06,888467,Staff,0,0,0,0
1746609866133,EDS 25,B07,888468,Staff,0,0,0,0
1746609866133,EDS 25,B08,888479,Staff,0,0,0,0
1746609866133,EDS 25,B09,888484,Staff,0,0,0,0
1746609866133,EDS 25,B10,888487,Staff,0,0,0,0
1746609867160,EDS 38,A01,907700,Choi; Bailey Miyeon,30,0,30,0
1746609868187,EDS 112,A01,888601,Chapman; Thandeka K,12,0,40,28
1746609869214,EDS 115,A00,888697,Mendez; Kathrina Mendoza,10,0,30,20
1746609870241,EDS 116,A01,888893,Staff,33,0,40,7
1746609872297,EDS 124AR,A00,889133,Staff,29,0,50,21
1746609872297,EDS 124AR,B00,907471,Simon; Elizabeth A,37,0,50,13
1746609873325,EDS 124BR,A00,889134,Simon; Elizabeth A,44,0,100,56
1746609874351,EDS 125,A00,889135,Staff,25,0,30,5
1746609875379,EDS 126,A01,889138,Staff,35,0,40,5
1746609876407,EDS 164R,A01,889142,Wishard Guerra; Alison G.,32,0,50,18
1746609877435,ENG 30,A01,886396,Staff,0,0,0,0
1746609877435,ENG 30,B01,886398,Staff,0,0,0,0
1746609878465,ENVR 102,A00,906150,Montejo; Carolina,23,0,25,2
1746609879490,ETHN 103A,A00,887236,Man; Simeon S,0,2,0,0
1746609880517,ETHN 113,A00,887239,Staff,16,0,30,14
1746609881543,ETHN 116,A00,887240,Staff,16,0,25,9
1746609882568,ETHN 117,A00,887241,Choi; Esther Min,28,0,30,2
1746609883593,ETHN 118,A00,887243,Staff,24,0,30,6
1746609884624,ETHN 127,A00,887248,Cuong; Marisol,11,0,15,4
1746609885650,ETHN 139,A00,887250,Staff,7,0,10,3
1746609886675,ETHN 142,A00,887252,Staff,9,0,30,21
1746609887704,ETHN 161,A00,887253,Browne; Errol Tsekani,24,0,30,6
1746609888734,ETHN 163FR,A00,887255,Burelle; Julie Sara Veronique,0,0,5,5
1746609889760,GLBH 20,A00,889149,Elwardani; Nile Regina,8,0,42,34
1746609891814,GLBH 111,A01,889152,Burgos; Jose L.,17,0,17,0
1746609892839,GLBH 150,A00,889181,Sloane; Julia Kathryn,0,5,15,15
1746609894892,HDS 60,A01,886406,Warstadt; Melissa Fawn,72,0,80,8
1746609895918,HIAF 111,A00,889324,Gyamfi; Bright,25,0,32,7
1746609896945,HIEA 131,A00,889328,Staff,15,0,32,17
1746609897971,HIEA 144,A00,889333,Henry; Todd A.,26,0,32,6
1746609898997,HIEA 154,A00,889336,Henry; Todd A.,24,0,32,8
1746609900023,HIEU 106,A00,889339,Staff,22,0,32,10
1746609902078,HIEU 114,A00,889340,Staff,4,0,32,28
1746609903107,HIEU 135GS,A00,889342,Patterson; Patrick H.,0,0,1,24
1746609904133,HIEU 137,A00,889343,Edington; Claire Ellen,10,0,25,15
1746609905161,HIEU 148,A00,889345,Staff,14,0,32,18
1746609906189,HIEU 154,A00,889346,Biess; Frank Peter,21,0,32,11
1746609907216,HILA 102,A00,889351,Staff,12,0,32,20
1746609908242,HILD 2A,A01,889221,Lewandoski; Julia Mavis,0,8,32,32
1746609909269,HILD 7B,A01,889225,Man; Simeon S,0,12,32,32
1746609910296,HILD 7C,A01,889288,Alvarez; Luis A,0,14,32,32
1746609911322,HILD 30,A01,889323,Staff,0,5,32,32
1746609913375,HISC 119,A00,889383,Golan; Tal,20,0,32,12
1746609914404,HIUS 103,A00,889384,Man; Simeon S,0,0,32,32
1746609915434,HIUS 117,A00,919797,Kwak; Nancy,18,0,32,14
1746609916464,HIUS 142A,A00,919788,Staff,22,0,32,10
1746609918522,HIUS 149,A00,889386,Gyamfi; Bright,26,0,32,6
1746609919548,HIUS 155,A00,889387,Alvarez; Luis A,15,0,32,17
1746609920580,HUM 3,A01,886499,Caldwell; Michael Alan,19,0,50,31
1746609921606,HUM 3GS,A00,886500,Rodriguez; Bretton Sigfred,0,0,0,28
1746609922631,HUM 3R,A01,886502,Markman; Kristina,0,36,50,50
1746609923660,HUM 4,A01,886504,Crum; Matthew Stephen,23,0,50,27
1746609923660,HUM 4,B01,886506,West; Geoffrey Scott,17,0,50,33
1746609924686,HUM 4GS,A00,886507,Staff,0,0,0,19
1746609925713,HUM 5,A01,886509,Staff,31,0,50,19
1746609926741,HUM 5R,A01,886511,Zavodny; Tatiana Sophia,0,39,50,50
1746609927768,JAPN 180,A00,886407,Staff,16,0,40,24
1746609928801,LATI 50,A01,886409,Martin-Cabrera; Luis,3,0,22,19
1746609928801,LATI 50,A02,886410,Martin-Cabrera; Luis,19,0,22,3
1746609928801,LATI 50,A03,886411,Martin-Cabrera; Luis,21,0,22,1
1746609928801,LATI 50,A04,886412,Martin-Cabrera; Luis,8,0,22,14
1746609929827,LAWS 101,A00,907664,Staff,28,0,60,32
1746609930856,LIAB 1A,A00,889388,Saab; Dima,17,0,20,3
1746609931882,LIAB 1AX,A00,889389,El Cheddadi; Youniss,18,0,20,2
1746609932910,LIFR 1C,A00,889391,Van Moer; Vinciane G,8,0,20,12
1746609933938,LIFR 1CX,A00,889392,Van Moer; Vinciane G,7,0,20,13
1746609934964,LIFR 1D,A00,889393,Van Moer; Vinciane G,7,0,20,13
1746609935990,LIFR 1DX,A00,889394,Van Moer; Vinciane G,8,0,20,12
1746609937018,LIGN 7,A00,886923,Staff,25,0,50,25
1746609938046,LIGN 17,A00,886924,Kehler; Andrew Scott,126,0,150,24
1746609939073,LTAM 110,A00,889395,Staff,15,0,30,15
1746609940099,LTAM 110GS,A00,958010,Rodriguez; Bretton Sigfred,0,0,0,28
1746609941127,LTCH 101,A00,889397,Staff,23,0,25,2
1746609942154,LTCS 130,A00,889398,Staff,23,0,25,2
1746609943178,LTEA 138,A00,889399,Staff,24,0,40,16
1746609944208,LTEN 149,A00,889400,Wesling; Megan E.,0,3,25,25
1746609945237,LTEN 169,A00,889401,Staff,20,0,25,5
1746609946264,LTEN 180,A00,889402,Staff,10,0,15,5
1746609947289,LTEN 181,A00,889403,Staff,21,0,25,4
1746609948319,LTWL 100,A00,889404,Myerston Santana; Jacobo,2,0,25,23
1746609949348,LTWL 180GS,A00,889405,Staff,0,0,20,20
1746609950376,LTWL 181,A00,889406,Staff,16,0,25,9
1746609951403,LTWL 184,A00,889475,Mukherjee; Silpa,22,0,25,3
1746609952430,LTWR 102C,A00,889486,Staff,29,0,30,1
1746609953461,LTWR 115W,A00,889491,Staff,0,2,15,15
1746609954492,MAE 8,A01,886905,Staff,0,2,0,0
1746609955520,MAE 11,A00,886906,Bandaru; Prabhakar,0,7,50,50
1746609956587,MAE 20,A00,886907,Evdokimenko; Ekaterina,43,0,70,27
1746609957616,MAE 30B,A00,886909,Ghazinejad; Maziar,25,0,45,20
1746609958646,MAE 101B,A00,886910,Saintillan; David,30,0,45,15
1746609959675,MAE 105,A00,886911,Bandaru; Prabhakar,18,0,50,32
1746609960708,MAE 107,B00,958024,Staff,7,0,50,43
1746609961735,MAE 143B,A00,886913,Bewley; Thomas R,2,0,40,38
1746609962765,MAE 148,A01,886915,Silberman; Jack,0,3,14,14
1746609963790,MAE 160,A00,886916,Evdokimenko; Ekaterina,30,0,60,30
1746609964821,MATH 3C,A01,889681,Staff,0,2,30,30
1746609964821,MATH 3C,A02,960048,Staff,23,0,30,7
1746609965848,MATH 10A,A01,889760,Staff,26,0,30,4
1746609965848,MATH 10A,A02,889783,Staff,29,0,30,1
1746609966877,MATH 10B,A01,889785,Verstraete; Jacques Allan,1,0,35,34
1746609966877,MATH 10B,A02,889795,Verstraete; Jacques Allan,4,0,35,31
1746609966877,MATH 10B,B01,889797,Verstraete; Jacques Allan,3,0,35,32
1746609966877,MATH 10B,B02,889828,Verstraete; Jacques Allan,3,0,35,32
1746609967904,MATH 10C,A01,889849,Habib; Yousaf,8,0,30,22
1746609967904,MATH 10C,A02,889852,Habib; Yousaf,14,0,30,16
1746609967904,MATH 10C,A03,889853,Habib; Yousaf,22,0,30,8
1746609967904,MATH 10C,A04,889858,Habib; Yousaf,20,0,30,10
1746609967904,MATH 10C,B01,889861,Staff,1,0,30,29
1746609967904,MATH 10C,B02,889862,Staff,24,0,30,6
1746609967904,MATH 10C,B03,889863,Staff,27,0,30,3
1746609967904,MATH 10C,B04,889967,Staff,23,0,30,7
1746609968936,MATH 18,A01,889974,Staff,6,0,30,24
1746609968936,MATH 18,A02,889977,Staff,20,0,30,10
1746609968936,MATH 18,B01,889984,Hardiman; Liam,20,0,30,10
1746609968936,MATH 18,B02,889985,Hardiman; Liam,25,0,30,5
1746609969961,MATH 20A,A01,889990,Suk; Andrew Hoon,30,0,35,5
1746609970992,MATH 20B,A01,889993,Ohm; Ko Woon,21,0,30,9
1746609970992,MATH 20B,A02,889994,Ohm; Ko Woon,30,0,30,0
1746609970992,MATH 20B,B01,889996,Ohm; Ko Woon,22,0,30,8
1746609970992,MATH 20B,B02,889997,Ohm; Ko Woon,23,0,30,7
1746609972020,MATH 20C,A01,889999,Hammock; Frances H,17,0,30,13
1746609972020,MATH 20C,A02,890003,Hammock; Frances H,23,0,30,7
1746609972020,MATH 20C,B01,890006,Hammock; Frances H,2,0,30,28
1746609972020,MATH 20C,B02,890007,Hammock; Frances H,11,0,30,19
1746609973046,MATH 20D,A01,890011,Cheng; Hsiao-Bing,1,0,30,29
1746609973046,MATH 20D,A02,890012,Cheng; Hsiao-Bing,14,0,30,16
1746609973046,MATH 20D,B01,890016,Cheng; Hsiao-Bing,13,0,30,17
1746609973046,MATH 20D,B02,890017,Cheng; Hsiao-Bing,13,0,30,17
1746609974074,MATH 20E,A01,890026,Harel; Guershon,1,0,30,29
1746609974074,MATH 20E,A02,890029,Harel; Guershon,22,0,30,8
1746609974074,MATH 20E,B01,890033,Harel; Guershon,7,0,30,23
1746609974074,MATH 20E,B02,890101,Harel; Guershon,21,0,30,9
1746609975100,MATH 102,A01,890104,Staff,18,0,30,12
1746609975100,MATH 102,A02,890105,Staff,27,0,30,3
1746609976128,MATH 103B,A01,890116,Salehi Golsefidy; Alireza,3,0,30,27
1746609976128,MATH 103B,B01,890118,Staff,0,3,34,34
1746609977158,MATH 109,A01,890121,Aliabadi Sr.; Mohsen,0,0,30,30
1746609977158,MATH 109,B01,890124,Upadrashta; Pranav Kumar,18,0,30,12
1746609978185,MATH 120A,A01,890126,Eggers; John Dietrich,13,0,30,17
1746609979215,MATH 142B,A01,890128,Ioana; Adrian,19,0,30,11
1746609979215,MATH 142B,A02,890129,Ioana; Adrian,12,0,30,18
1746609980245,MATH 154,A01,890174,Staff,0,1,30,30
1746609980245,MATH 154,A02,890182,Staff,0,0,30,30
1746609981272,MATH 168A,A01,890197,Dumitriu; Ioana,21,0,35,14
1746609982300,MATH 170A,A01,890240,Nie; Jiawang,1,0,30,29
1746609982300,MATH 170A,A02,890241,Nie; Jiawang,11,0,30,19
1746609982300,MATH 170A,A03,890249,Nie; Jiawang,23,0,30,7
1746609983326,MATH 170B,A01,957891,Nag; Panchali,13,0,35,22
1746609985377,MATH 181A,A01,908025,Staff,0,3,35,35
1746609985377,MATH 181A,A02,960115,Staff,26,0,35,9
1746609986406,MATH 181B,A01,959874,Staff,24,0,30,6
1746609987432,MATH 193B,A01,890265,Staff,0,4,35,35
1746609988461,MGT 4,A01,890311,Anderson; John Charles,42,0,88,46
1746609989488,MGT 5,A00,907740,Staff,12,0,98,86
1746609990515,MGT 12,A00,890312,Lindenberger; Wade Douglas,67,0,98,31
1746609991539,MGT 16,A00,957883,Staff,78,0,98,20
1746609993590,MGT 45,A00,890314,Pecore; Joseph P.,45,0,98,53
1746609994618,MGT 71,A00,890315,Staff,0,12,98,98
1746609995643,MGT 100,A00,890316,Yavorsky; Daniel Ryan,44,0,98,54
1746609996669,MGT 103,A00,890317,Ehrich; Kristine R,73,0,98,25
1746609997695,MGT 105,A00,890356,Bates; Kenneth Walter,0,8,98,98
1746609998724,MGT 112,A00,890360,Ehrich; Kristine R,55,0,98,43
1746609999754,MGT 127R,A00,907732,Zhu; Kevin Xiaoguo,23,0,98,75
1746610000780,MGT 131B,A00,890361,Anderson; John Charles,59,0,98,39
1746610001807,MGT 137,A00,890362,Lindenberger; Wade Douglas,65,0,98,33
1746610002831,MGT 160,A00,890369,Johnson; Erik Barry,9,0,98,89
1746610004885,MGT 164,A00,890372,Zimmermann; Carsten,0,40,98,98
1746610005918,MGT 180,A00,890374,Bliss; Barbara Ann,11,0,98,87
1746610006949,MMW 15,A01,886414,Chang; Edmond Yi-Teh,0,12,28,28
1746610006949,MMW 15,A02,886415,Chang; Edmond Yi-Teh,0,8,28,28
1746610006949,MMW 15,A03,886416,Chang; Edmond Yi-Teh,0,9,28,28
1746610006949,MMW 15,A04,886417,Chang; Edmond Yi-Teh,0,8,28,28
1746610006949,MMW 15,B01,886419,Chang; Edmond Yi-Teh,0,7,28,28
1746610006949,MMW 15,B02,886420,Chang; Edmond Yi-Teh,0,7,28,28
1746610006949,MMW 15,B03,886421,Chang; Edmond Yi-Teh,0,7,28,28
1746610006949,MMW 15,B04,886422,Chang; Edmond Yi-Teh,0,8,28,28
1746610006949,MMW 15,C01,886424,Staff,0,9,28,28
1746610006949,MMW 15,C02,886425,Staff,0,8,28,28
1746610006949,MMW 15,C03,886426,Staff,0,8,28,28
1746610006949,MMW 15,C04,886427,Staff,0,8,28,28
1746610006949,MMW 15,C05,958038,Staff,0,8,28,28
1746610006949,MMW 15,C06,958039,Staff,0,7,28,28
1746610007980,MMW 15GS,A00,906910,Patterson; Patrick H.,4,0,28,24
1746610009008,MMW 122R,A01,886429,Rahimi; Babak,0,13,28,28
1746610009008,MMW 122R,A02,886430,Rahimi; Babak,0,12,28,28
1746610009008,MMW 122R,A03,958040,Rahimi; Babak,0,11,28,28
1746610010040,MUS 1A,A01,890937,Staff,2,0,25,23
1746610010040,MUS 1A,A02,891035,Staff,6,0,25,19
1746610010040,MUS 1A,C01,958912,Staff,24,0,25,1
1746610010040,MUS 1A,C02,958913,Staff,25,0,25,0
1746610012134,MUS 2AK,A00,957092,Ohnishi; Takae,15,0,15,0
1746610013162,MUS 4,A01,891044,Staff,0,0,25,25
1746610013162,MUS 4,A02,891045,Staff,22,0,25,3
1746610013162,MUS 4,B01,891048,Staff,17,0,25,8
1746610013162,MUS 4,B02,891050,Staff,25,0,25,0
1746610014195,MUS 5,A01,957506,Dubnov; Shlomo,0,0,25,25
1746610014195,MUS 5,A02,957622,Dubnov; Shlomo,12,0,25,13
1746610014195,MUS 5,A03,957623,Dubnov; Shlomo,20,0,25,5
1746610015225,MUS 6,A01,891053,Freitas Caetano; Marcelo,24,0,25,1
1746610015225,MUS 6,A02,891054,Freitas Caetano; Marcelo,23,0,25,2
1746610016250,MUS 7,A01,891081,Staff,0,0,25,25
1746610016250,MUS 7,A02,891082,Staff,3,0,25,22
1746610017278,MUS 8GS,A00,891118,Borgo; David Garcia,1,0,25,24
1746610018306,MUS 11,A01,891140,Staff,8,0,25,17
1746610018306,MUS 11,A02,891141,Staff,21,0,25,4
1746610019331,MUS 13,A01,891143,Staff,8,0,25,17
1746610019331,MUS 13,A02,891144,Staff,24,0,25,1
1746610020356,MUS 15,A01,891146,Staff,9,0,25,16
1746610020356,MUS 15,A02,891148,Staff,21,0,25,4
1746610020356,MUS 15,B01,891150,Staff,18,0,25,7
1746610020356,MUS 15,B02,891151,Staff,25,0,25,0
1746610021385,MUS 20,A01,891153,Staff,5,0,20,15
1746610021385,MUS 20,A02,891155,Staff,14,0,20,6
1746610022415,MUS 80,A00,891156,Staff,19,0,25,6
1746610022415,MUS 80,B00,891157,Staff,23,0,25,2
1746610023447,MUS 130,A00,891158,Ohnishi; Takae,35,0,35,0
1746610024473,MUS 150GS,A01,891160,Borgo; David Garcia,1,0,25,24
1746610025501,MUS 170,A01,891162,Freitas Caetano; Marcelo,20,0,25,5
1746610025501,MUS 170,A02,891164,Freitas Caetano; Marcelo,21,0,25,4
1746610026567,NANO 11,A00,886220,Vazquez Mena; Oscar,13,0,15,2
1746610027595,NANO 15,A01,886222,Drews; Aaron,4,0,7,3
1746610028624,NANO 104,A00,886224,Sirbuly; Donald,17,0,25,8
1746610029650,PH 40,A00,886528,Staff,23,0,40,17
1746610030679,PH 45,A01,886799,Staff,35,0,40,5
1746610031706,PH 110,A00,886802,Staff,0,6,40,40
1746610032750,PH 172,A00,906716,Staff,19,0,35,16
1746610033781,PH 191,A00,886803,Staff,6,0,40,34
1746610034806,PHIL 1,A00,889500,Staff,20,0,30,10
1746610035835,PHIL 10,A01,889549,Grush; Rick Scott,16,0,22,6
1746610035835,PHIL 10,A02,889551,Grush; Rick Scott,22,0,22,0
1746610036865,PHIL 28,A01,889559,Lamey; Andy M.,0,2,31,31
1746610036865,PHIL 28,A02,889561,Lamey; Andy M.,0,1,30,30
1746610036865,PHIL 28,A03,889572,Lamey; Andy M.,0,1,30,30
1746610037891,PHIL 35,A00,907839,Staff,13,0,15,2
1746610038918,PHIL 60,A00,889574,Staff,73,0,90,17
1746610039943,PHIL 101,A00,958004,Staff,12,0,15,3
1746610041998,PHIL 136,A00,889582,Fulkerson; Matthew Todd,26,0,45,19
1746610043025,PHIL 163,A01,889601,Staff,21,0,30,9
1746610043025,PHIL 163,B01,889606,Brandt; Reuven A,0,3,0,0
1746610044052,PHIL 164,A00,889610,Staff,16,0,30,14
1746610045078,PHIL 165,A00,889613,Staff,22,0,30,8
1746610046102,PHYS 1A,A00,886431,Staff,30,0,70,40
1746610047134,PHYS 1AL,001,886432,Tsai; Philbert S,0,1,30,30
1746610047134,PHYS 1AL,002,886436,Tsai; Philbert S,13,0,30,17
1746610048161,PHYS 1B,A00,886439,Staff,184,0,240,56
1746610049189,PHYS 1BL,001,886441,Tsai; Philbert S,0,4,30,30
1746610049189,PHYS 1BL,002,886444,Tsai; Philbert S,2,0,30,28
1746610050215,PHYS 1C,A00,896092,Arnold; Kam S,78,0,146,68
1746610051240,PHYS 1CL,001,886448,Tsai; Philbert S,0,0,30,30
1746610051240,PHYS 1CL,002,886449,Tsai; Philbert S,1,0,30,29
1746610051240,PHYS 1CL,003,886450,Tsai; Philbert S,16,0,30,14
1746610051240,PHYS 1CL,004,886451,Tsai; Philbert S,15,0,30,15
1746610052272,PHYS 2B,A01,886457,Staff,67,0,115,48
1746610053303,PHYS 2C,A01,886460,Shotwell; Brian,0,9,65,65
1746610054327,PHYS 2CL,A01,886467,Staff,0,4,28,28
1746610054327,PHYS 2CL,A02,886468,Staff,0,3,28,28
1746610055358,PHYS 2D,A01,886470,Staff,10,0,50,40
1746610056385,PHYS 4B,A01,886475,Grinstein; Benjamin,22,0,40,18
1746610057412,POLI 5,A00,891173,Desposato; Scott,7,0,25,18
1746610058442,POLI 5D,A01,891175,Staff,5,0,5,0
1746610058442,POLI 5D,B01,891178,Staff,5,0,5,0
1746610059472,POLI 11,A00,891179,Ferree; Karen E,0,0,35,35
1746610060499,POLI 12,A00,891180,Staff,15,0,30,15
1746610061528,POLI 27,A01,891182,Staff,11,0,75,64
1746610062556,POLI 30,A00,891183,Staff,8,0,50,42
1746610063586,POLI 100B,A00,891244,Staff,5,1,35,30
1746610064612,POLI 100I,A00,891247,Staff,7,0,30,23
1746610065639,POLI 104J,A00,891248,Nichter; Maysa,14,0,30,16
1746610066664,POLI 104U,A00,891250,Nichter; Maysa,1,0,30,29
1746610068717,POLI 110B,A00,891255,Wiens; David,19,0,25,6
1746610069743,POLI 112A,A00,891256,Wiens; David,6,0,25,19
1746610070769,POLI 114BR,A00,891261,Staff,19,0,30,11
1746610071795,POLI 117R,A00,891262,Forman; Fonna,0,6,50,50
1746610072821,POLI 118,A00,891264,Ingham; Sean,17,0,25,8
1746610073853,POLI 124A,A00,891265,Staff,18,0,20,2
1746610074879,POLI 125D,A00,891266,Nichter; Simeon C,2,0,25,23
1746610075907,POLI 126,A00,891268,Nichter; Simeon C,7,0,25,18
1746610076935,POLI 126AA,A00,891272,Staff,15,0,25,10
1746610077961,POLI 130AA,A00,891273,Staff,15,0,20,5
1746610078991,POLI 134AA,A00,891274,Staff,4,0,20,16
1746610081045,POLI 138,A00,891278,Staff,21,0,25,4
1746610082071,POLI 142K,A00,891280,Staff,10,0,25,15
1746610083102,POLI 142M,A00,891281,Gartzke; Erik,16,0,30,14
1746610084129,POLI 142P,A00,891284,Staff,20,0,30,10
1746610085157,POLI 143,A00,891285,Gartzke; Erik,12,0,30,18
1746610086183,POLI 153,A00,891286,Staff,19,0,20,1
1746610088231,POLI 175,A00,891290,Staff,15,0,20,5
1746610089257,PSYC 1,A00,890674,Steiner; Eric Tomas,0,11,45,45
1746610090283,PSYC 2,A00,890676,Albright; Thomas D,20,0,35,15
1746610091311,PSYC 3,A00,890679,Staff,17,0,20,3
1746610092340,PSYC 6,A00,959858,Staff,19,0,20,1
1746610093365,PSYC 60,A01,890684,Rickard; Timothy C.,0,6,45,45
1746610094392,PSYC 70,A01,890689,Geller; Emma Harlan,6,0,30,24
1746610095419,PSYC 71,A01,959860,Staff,21,0,25,4
1746610096444,PSYC 100,A00,890690,Lacefield; Katharine I,0,50,180,180
1746610097470,PSYC 102,A00,890695,Staff,18,0,40,22
1746610098497,PSYC 105,A00,890699,Geller; Emma Harlan,70,0,100,30
1746610099523,PSYC 106,A00,890701,Gorman; Michael R.,5,0,30,25
1746610100551,PSYC 108,A00,890704,Adrian; Julia Anna,0,29,50,50
1746610101576,PSYC 118,A01,890712,Staff,11,0,30,19
1746610102602,PSYC 124,A00,890716,Chapman; Eddie Nathaniel,25,0,60,35
1746610103629,PSYC 131,A00,890717,Anagnostaras; Stephan,0,7,80,80
1746610104656,PSYC 137,A00,890719,Winkielman; Piotr,0,11,30,30
1746610105682,PSYC 144,A00,890721,Adrian; Julia Anna,0,9,45,45
1746610106709,PSYC 162,A00,890805,Staff,0,2,75,75
1746610107735,PSYC 169,A00,890810,Staff,0,15,30,30
1746610108761,PSYC 172,A00,890814,Gorman; Michael R.,9,0,30,21
1746610109787,PSYC 181,A00,890818,Anagnostaras; Stephan,6,0,200,194
1746610110813,PSYC 184,A00,959861,Staff,160,0,175,15
1746610111843,PSYC 189,A00,890823,Staff,0,2,30,30
1746610112870,PSYC 191,A00,890884,Rickard; Timothy C.,0,12,35,35
1746610113895,PSYC 193,A00,890913,Staff,19,0,30,11
1746610113895,PSYC 193,B00,890914,Chapman; Eddie Nathaniel,24,0,30,6
1746610114921,PSYC 193L,A01,890918,Lowe; Angela Beth,20,0,30,10
1746610114921,PSYC 193L,B01,890921,Hurwitz; Ethan Scott,20,0,30,10
1746610114921,PSYC 193L,C01,890928,Staff,30,0,30,0
1746610115946,RELI 149,A00,886806,Rahimi; Babak,23,0,40,17
1746610116975,SE 9,A01,886814,Staff,7,0,20,13
1746610118005,SE 101B,A01,886816,Chadha; Mayank,3,0,35,32
1746610119036,SE 110B,A00,886818,Zhu; Qiang,4,0,75,71
1746610120062,SE 125,A01,886830,Staff,10,0,30,20
1746610121088,SE 130B,A01,886835,Staff,14,0,40,26
1746610122114,SE 131A,A01,886838,Krysl; Petr,34,0,55,21
1746610123141,SE 154,A00,886840,Staff,28,0,50,22
1746610124166,SE 164GS,A01,886849,Staff,6,0,20,14
1746610125192,SE 167GS,A01,886853,Staff,6,0,20,14
1746610126218,SIO 25,A01,890107,Staff,19,0,30,11
1746610127243,SIO 45,A00,890109,Cook; Geoffrey W,114,0,200,86
1746610128269,SIO 109R,A00,890110,Forman; Fonna,0,16,20,20
1746610129295,SIO 187,A01,890114,Kacev; David,15,0,40,25
1746610130322,SOCI 1,A01,890431,Thorpe; Charles Robert,14,0,30,16
1746610130322,SOCI 1,A02,890518,Thorpe; Charles Robert,30,0,30,0
1746610131349,SOCI 2,A01,957978,Staff,25,0,25,0
1746610131349,SOCI 2,A02,957979,Staff,23,0,25,2
1746610132375,SOCI 20,A01,890523,Calderon-Zaks; Michael Aar,21,0,30,9
1746610132375,SOCI 20,A02,890526,Calderon-Zaks; Michael Aar,29,0,30,1
1746610133401,SOCI 30,A01,890533,Pardo Guerra; Juan Pablo,37,0,40,3
1746610134427,SOCI 40,A01,890535,Staff,27,0,45,18
1746610135451,SOCI 104Q,A00,890559,Staff,17,0,30,13
1746610136478,SOCI 106,A00,890560,Arnal; Maud Marie Leonie,20,0,30,10
1746610137504,SOCI 110,A00,890567,Holkenbrink-Monk; Charlene,19,0,30,11
1746610138531,SOCI 112,A00,890568,Victoria Torres; Pablo,2,0,55,53
1746610139556,SOCI 115,A00,890597,Arnal; Maud Marie Leonie,28,0,45,17
1746610141611,SOCI 121,A00,890604,Pardo Guerra; Juan Pablo,38,0,45,7
1746610142639,SOCI 126,A01,890608,Staff,8,0,10,2
1746610143664,SOCI 127,A00,890609,Staff,18,0,30,12
1746610144691,SOCI 131,A00,890610,Thorpe; Charles Robert,37,0,45,8
1746610145720,SOCI 135,A00,890615,Payne; Christine Anna,14,0,45,31
1746610146744,SOCI 139,A00,890620,Staff,38,0,45,7
1746610147774,SOCI 148E,A00,890622,Calderon-Zaks; Michael Aar,36,0,45,9
1746610148806,SOCI 150,A00,890623,Kohler; Kristopher M.,31,0,45,14
1746610149835,SOCI 157,A00,890625,Jules-Rosette; Bennetta W.,18,0,20,2
1746610150863,SOCI 160,A00,890627,Payne; Christine Anna,21,0,45,24
1746610151891,SYN 1,A00,886855,Fish; Gwendolyn Anne,0,1,0,0
1746610151891,SYN 1,B00,906086,Fish; Gwendolyn Anne,0,2,0,2
1746610152916,SYN 2R,A00,886860,Staff,0,17,15,15
1746610152916,SYN 2R,B00,906106,Atkinson; Arthur Laird,0,16,15,15
1746610153943,SYN 100,A01,886866,Browne; Emily,0,28,20,20
1746610153943,SYN 100,B01,906128,Rock; Martin,0,4,20,20
1746610153943,SYN 100,C01,906140,Deavenport; James Cary,0,4,20,20
1746610153943,SYN 100,D01,907816,Deavenport; James Cary,0,5,20,20
1746610154975,TDAC 1,A00,890286,Walsh; Kim C.,7,0,20,13
1746610156002,TDAC 101,A00,890296,Basso; Beatrice,15,0,20,5
1746610157029,TDDE 131,A00,890297,Staff,47,0,50,3
1746610158056,TDDM 1,A00,890287,Weinberg; Sadie,25,0,30,5
1746610159082,TDGE 11,A00,890288,Fulton; Julia,138,0,200,62
1746610159082,TDGE 11,B00,890289,Castro; Robert Jess,184,0,200,16
1746610160109,TDGE 25,B00,957359,Walsh; Kim C.,5,0,20,15
1746610161137,TDGE 40,A01,890292,Power; Jade Yukana,26,0,30,4
1746610162164,TDGE 124,A00,890298,Havis; Allan,0,2,50,50
1746610163191,TDGE 131R,A00,890299,Burelle; Julie Sara Veronique,15,0,42,27
1746610164216,TDHT 101,A00,890300,Staff,10,0,20,10
1746610165243,TDHT 109,A01,890302,Anderson; Mysia Anyse,31,0,40,9
1746610166272,TDMV 1,A00,890293,Arcidiacono; Kristin,18,0,30,12
1746610167301,TDMV 2,A00,890294,Weinberg; Sadie,23,0,30,7
1746610168326,TDMV 3,A00,957878,Arcidiacono; Kristin,28,0,30,2
1746610170378,TDMV 138,A00,890304,Jun; Grace Shin Hae,25,0,40,15
1746610171404,TDMV 140,A00,890305,Corrales; Joseph Bernales,25,0,30,5
1746610172429,TDMV 142,A00,890307,Caligagan; Tony,32,0,40,8
1746610173458,TDMV 144,A00,890308,Camaya; Michelle Ann,25,0,30,5
1746610174482,TDPW 1,A00,890295,Stein; Deborah Isobel,3,0,20,17
1746610175510,USP 2,A01,890272,Lerner; Amy M,7,0,20,13
1746610176537,USP 3,A01,890274,Staff,12,0,30,18
1746610177566,USP 15,A01,890276,Sun; Feiyang,16,0,30,14
1746610178591,USP 25,A00,890277,Shenkman; Michael Thomas,18,0,25,7
1746610179623,USP 138,A00,890278,Staff,13,0,25,12
1746610180647,USP 143,A00,890279,Staff,21,0,70,49
1746610181677,USP 144,A00,890280,Chowdhury; Muhammed Zohir,16,0,30,14
1746610182707,USP 150,A00,890281,Boomhower; Matthew Charles,4,0,30,26
1746610183731,USP 151,A00,890282,Staff,16,0,20,4
1746610184758,USP 162,A00,890283,Andrews; Abigail Leslie,16,0,20,4
1746610185786,USP 168,A00,920477,Kwak; Nancy,0,0,5,5
1746610186816,USP 181,A00,890284,Staff,3,0,20,17
1746610187842,USP 191A,A00,890285,Staff,12,0,20,8
1746610188867,VIS 101,A00,886512,Staff,26,0,75,49
1746610189897,VIS 103,A00,886513,Cruz; Edwin Teddy,61,0,75,14
1746610190922,VIS 108,A00,886514,Staff,4,0,15,11
1746610191949,VIS 127P,A00,886515,Shen; Kuiyi,80,0,146,66
1746610192979,VIS 149,A00,886516,Yoldas; Pinar,0,0,15,15
1746610194008,VIS 164,A00,886526,Erdmann; Dean,19,0,22,3
1746610195034,VIS 194S,A00,886527,Staff,61,0,75,14
1746610196060,WCWP 10A,C00,886484,Martiniuk; Jill,12,0,15,3
1746610197088,WCWP 10B,A00,886490,Uriarte; Emma,0,0,15,15
1746610197088,WCWP 10B,B00,886491,Dhir; Simrita,8,0,15,7
1746610197088,WCWP 10B,C00,886492,Ornelas; Tricia,0,0,15,15
1746610198117,WCWP 100,A00,886494,Young; Mark T,0,6,15,15
1746610200217,AAS 10,A01,886199,Childs; Dennis R.,0,3,0,0
1746610201247,ANAR 104,A01,886940,Shtienberg; Gilad,27,0,30,3
1746610202286,ANAR 120,A00,886953,Staff,13,0,20,7
1746610203311,ANBI 148,A01,886955,Wilder; Linnea Lorene,30,0,40,10
1746610205362,ANSC 122,A00,886957,Staff,24,0,30,6
1746610206388,ANSC 150,A00,886958,Sloane; Julia Kathryn,2,0,15,13
1746610207413,ANSC 156,A00,886959,Jenkins; Janis A.,0,1,15,15
1746610208439,ANSC 180,A00,886960,Staff,11,0,17,6
1746610209466,ANSC 188,A00,886961,Jassal; Aftab,9,0,25,16
1746610210491,ANSC 190,A00,886962,Jassal; Aftab,14,0,25,11
1746610211516,ANSC 191,A00,886963,Staff,18,0,20,2
1746610212543,ANTH 3,A01,891689,Staff,17,0,20,3
1746610213572,ANTH 5,A00,886933,Semendeferi; Ekaterini,16,0,20,4
1746610214596,ANTH 10,A00,886934,Staff,0,12,30,30
1746610215626,ANTH 21,A01,886936,Staff,41,0,60,19
1746610216656,ANTH 23,A01,886938,Staff,92,0,100,8
1746610217682,ANTH 105,A00,886964,Stewart; Alexander B,84,0,100,16
1746610218711,ANTH 108,A00,886965,Pedersen; David,9,0,20,11
1746610219743,AWP 10,001,886147,Staff,0,0,0,0
1746610219743,AWP 10,002,886148,Staff,0,0,0,0
1746610219743,AWP 10,003,886149,Staff,0,0,0,0
1746610219743,AWP 10,004,886150,Staff,0,0,0,0
1746610219743,AWP 10,005,886151,Staff,0,0,0,0
1746610219743,AWP 10,006,886152,Staff,0,0,0,0
1746610219743,AWP 10,007,886153,Staff,0,0,0,0
1746610219743,AWP 10,008,886154,Staff,0,0,0,0
1746610219743,AWP 10,009,886155,Staff,0,0,0,0
1746610219743,AWP 10,010,886156,Staff,0,0,0,0
1746610219743,AWP 10,011,886158,Staff,0,0,0,0
1746610219743,AWP 10,012,886160,Staff,0,0,0,0
1746610219743,AWP 10,013,886161,Staff,0,0,0,0
1746610219743,AWP 10,014,886162,Staff,0,0,0,0
1746610219743,AWP 10,015,886163,Staff,0,0,0,0
1746610219743,AWP 10,016,886164,Staff,0,0,0,0
1746610219743,AWP 10,017,886165,Staff,0,0,0,0
1746610219743,AWP 10,018,886166,Staff,0,0,0,0
1746610219743,AWP 10,019,886168,Staff,0,0,0,0
1746610219743,AWP 10,020,886170,Staff,0,0,0,0
1746610219743,AWP 10,021,886172,Staff,0,0,0,0
1746610220773,AWP 10R,001,886173,Staff,0,1,0,0
1746610220773,AWP 10R,002,886174,Staff,0,1,0,0
1746610220773,AWP 10R,003,886175,Staff,0,0,0,0
1746610220773,AWP 10R,004,886176,Staff,0,0,0,0
1746610220773,AWP 10R,005,886177,Staff,0,0,0,0
1746610220773,AWP 10R,006,886178,Staff,0,0,0,0
1746610220773,AWP 10R,007,886179,Staff,0,0,0,0
1746610220773,AWP 10R,008,886181,Staff,0,0,0,0
1746610220773,AWP 10R,009,886182,Staff,0,0,0,0
1746610220773,AWP 10R,010,886183,Staff,0,0,0,0
1746610220773,AWP 10R,011,886184,Staff,0,0,0,0
1746610220773,AWP 10R,012,886185,Staff,0,0,0,0
1746610220773,AWP 10R,013,886186,Staff,0,0,0,0
1746610220773,AWP 10R,014,886187,Staff,0,0,0,0
1746610220773,AWP 10R,015,886188,Staff,0,0,0,0
1746610220773,AWP 10R,016,886189,Staff,0,0,0,0
1746610220773,AWP 10R,017,960532,Staff,0,0,0,0
1746610220773,AWP 10R,018,960533,Staff,0,0,0,0
1746610220773,AWP 10R,019,960534,Staff,0,0,0,0
1746610220773,AWP 10R,020,960538,Staff,0,0,0,0
1746610220773,AWP 10R,021,960540,Staff,0,0,0,0
1746610220773,AWP 10R,022,960541,Staff,0,0,0,0
1746610220773,AWP 10R,023,960542,Staff,0,0,0,0
1746610220773,AWP 10R,024,960544,Staff,0,0,0,0
1746610220773,AWP 10R,025,960545,Staff,0,0,0,0
1746610220773,AWP 10R,026,960548,Staff,0,0,0,0
1746610221799,AWP 102R,A00,886190,Staff,0,0,0,0
1746610221799,AWP 102R,B00,886191,Staff,0,0,0,0
1746610222842,BENG 100,A01,886193,Staff,17,0,30,13
1746610223867,BENG 122A,A01,886195,Hasty; Jeff M,13,0,30,17
1746610224897,BENG 166A,A00,886196,Sah; Robert Lie-Yuan,0,3,30,30
1746610225925,BENG 190,A00,958050,Khojah; Reem I,17,0,25,8
1746610226954,BIBC 102,A01,894320,Staff,0,1,46,46
1746610226954,BIBC 102,A02,894321,Staff,0,0,46,46
1746610226954,BIBC 102,A03,894344,Staff,6,0,46,40
1746610226954,BIBC 102,A04,894345,Staff,27,0,47,20
1746610227980,BICD 100R,A01,894365,Smith; Laurie,0,2,58,58
1746610227980,BICD 100R,A02,894366,Smith; Laurie,0,4,58,58
1746610227980,BICD 100R,A03,894367,Smith; Laurie,0,0,59,59
1746610227980,BICD 100R,A04,959869,Smith; Laurie,38,0,59,21
1746610229008,BICD 136,A01,894383,Gustafson-Brown; Cindy,14,0,50,36
1746610230035,BIEB 102,A01,894494,Butler; Shannon Rhey,51,0,130,79
1746610232102,BIEB 150,A01,894617,Wills; Christopher,3,0,20,17
1746610232102,BIEB 150,A02,894631,Wills; Christopher,3,0,20,17
1746610232102,BIEB 150,A03,894937,Wills; Christopher,3,0,20,17
1746610232102,BIEB 150,A04,894946,Wills; Christopher,5,0,20,15
1746610233131,BIEB 194,A00,906141,Kurle; Carolyn M.,5,0,20,15
1746610234196,BILD 1,A01,894154,Staff,3,0,19,16
1746610234196,BILD 1,A02,894155,Staff,14,0,19,5
1746610234196,BILD 1,A03,894160,Staff,13,0,19,6
1746610234196,BILD 1,A04,894161,Staff,15,0,18,3
1746610235221,BILD 2,A01,894168,Staff,0,0,50,50
1746610235221,BILD 2,A02,894169,Staff,0,0,50,50
1746610235221,BILD 2,A03,894179,Staff,0,0,50,50
1746610235221,BILD 2,A04,894203,Staff,22,0,50,28
1746610236249,BILD 3,A01,894213,Staff,23,0,31,8
1746610236249,BILD 3,A02,894214,Staff,26,0,31,5
1746610236249,BILD 3,A03,894235,Staff,28,0,31,3
1746610236249,BILD 3,A04,894236,Staff,28,0,32,4
1746610237277,BILD 4,A01,894253,Reuther; Keefe,5,0,24,19
1746610237277,BILD 4,A02,894258,Reuther; Keefe,16,0,24,8
1746610238307,BILD 5,A01,894276,Reuther; Keefe,33,0,50,17
1746610238307,BILD 5,A02,894277,Reuther; Keefe,45,0,50,5
1746610238307,BILD 5,A03,894290,Reuther; Keefe,44,0,50,6
1746610238307,BILD 5,A04,894291,Reuther; Keefe,48,0,50,2
1746610239335,BILD 24,A01,894297,Pirino; Giorgia,40,0,60,20
1746610240361,BIMM 100,B01,958915,Staff,71,0,100,29
1746610241387,BIMM 101,A01,895017,McDonnell; Lisa Marie,0,5,24,24
1746610241387,BIMM 101,A02,895018,McDonnell; Lisa Marie,0,5,24,24
1746610241387,BIMM 101,B01,895020,McDonnell; Lisa Marie,0,5,24,24
1746610241387,BIMM 101,B02,895021,McDonnell; Lisa Marie,0,4,24,24
1746610242420,BIMM 110,A01,895023,Staff,1,0,25,24
1746610242420,BIMM 110,A02,895024,Staff,9,0,25,16
1746610242420,BIMM 110,A03,895025,Staff,18,0,25,7
1746610242420,BIMM 110,A04,895031,Staff,20,0,25,5
1746610243446,BIMM 120,A01,895114,Gustafson-Brown; Cindy,14,0,28,14
1746610243446,BIMM 120,A02,895126,Gustafson-Brown; Cindy,21,0,27,6
1746610244471,BIPN 100,A01,895130,Yang; Mingyu,0,0,38,38
1746610244471,BIPN 100,A02,895131,Yang; Mingyu,31,0,38,7
1746610244471,BIPN 100,A03,895132,Yang; Mingyu,32,0,38,6
1746610244471,BIPN 100,A04,895133,Yang; Mingyu,27,0,36,9
1746610245499,BIPN 120,A01,895135,Cooke; James Edward,0,3,13,13
1746610245499,BIPN 120,A02,895136,Cooke; James Edward,0,1,13,13
1746610245499,BIPN 120,A03,895137,Cooke; James Edward,0,3,13,13
1746610245499,BIPN 120,A04,895156,Cooke; James Edward,0,2,11,11
1746610246528,BIPN 134,A01,895235,Cooke; James Edward,0,1,25,25
1746610246528,BIPN 134,A02,895237,Cooke; James Edward,0,0,25,25
1746610246528,BIPN 134,A03,895240,Cooke; James Edward,1,0,25,24
1746610246528,BIPN 134,A04,895270,Cooke; James Edward,20,0,25,5
1746610247556,BIPN 189,A00,892103,Staff,0,14,14,14
1746610249614,BISP 194,A00,958008,Staff,0,2,0,0
1746610250640,CAT 124,A01,922009,Staff,0,5,20,20
1746610251673,CAT 125R,A00,886390,Morales; Celeste Georgianna,0,4,20,20
1746610251673,CAT 125R,B00,886391,Irwin; Matthew Joseph,0,4,20,20
1746610251673,CAT 125R,C00,886392,Smith; Lauryn Alissa,0,2,20,20
1746610251673,CAT 125R,D00,886393,Vanderschuit; Maya Alysia,0,3,20,20
1746610251673,CAT 125R,E00,886394,Marchisotto; Jennifer Anne,0,3,20,20
1746610252699,CENG 15,A01,886218,Drews; Aaron,3,0,8,5
1746610253725,CENG 113,A00,886219,Opatkiewicz; Justin Paul,15,0,25,10
1746610254753,CGS 101,A00,887044,Staff,7,0,20,13
1746610255782,CGS 105,A01,887046,Staff,14,0,25,11
1746610256809,CGS 112,A00,887047,Cuong; Marisol,12,0,15,3
1746610257836,CGS 113,A00,887048,Staff,23,0,30,7
1746610258862,CGS 120,A00,887049,Staff,9,0,17,8
1746610259893,CHEM 6A,A01,886336,Lam; Tin Yiu,38,0,50,12
1746610259893,CHEM 6A,A02,886338,Lam; Tin Yiu,37,0,50,13
1746610260924,CHEM 6B,A01,886341,Hopkins; Patrycja Anna,16,0,50,34
1746610260924,CHEM 6B,A02,886343,Hopkins; Patrycja Anna,42,0,50,8
1746610261951,CHEM 6C,A01,886346,Albizati; Kim F.,0,2,50,50
1746610261951,CHEM 6C,A02,886348,Albizati; Kim F.,24,0,50,26
1746610262977,CHEM 40A,A01,886352,Klosterman; Jeremy K,65,0,100,35
1746610264007,CHEM 40B,A01,886356,Klosterman; Jeremy K,0,24,100,100
1746610265035,CHEM 41B,A01,886360,Theodorakis; Emmanuel,25,0,50,25
1746610265035,CHEM 41B,A02,886362,Theodorakis; Emmanuel,47,0,50,3
1746610266060,CHIN 165A,A00,886382,Xu; Li,18,0,20,2
1746610267090,CLAS 120,A00,886387,Myerston Santana; Jacobo,33,0,40,7
1746610268118,COGS 9,A01,886967,Shannon; Kyle Michael,42,0,60,18
1746610269144,COGS 11,A01,886969,Staff,9,0,30,21
1746610270170,COGS 14A,A01,886971,Staff,5,0,60,55
1746610271197,COGS 14B,A01,886973,Hoffman; Drew Ellen,4,0,60,56
1746610272224,COGS 18,A01,886975,Morgan; Eric,34,0,60,26
1746610273251,COGS 20,A01,886977,Staff,3,0,8,5
1746610273251,COGS 20,A02,886978,Staff,5,0,7,2
1746610274277,COGS 100,A01,907783,Staff,0,1,30,30
1746610275308,COGS 101B,A01,886980,Staff,0,4,48,48
1746610276338,COGS 101C,A01,886982,Delgado; Tania,0,5,44,44
1746610277364,COGS 102A,A01,886984,Johnson; Christine M.,3,0,30,27
1746610278390,COGS 118B,A01,886986,Staff,0,4,88,88
1746610279416,COGS 150,A01,886988,Bergen; Benjamin,22,0,50,28
1746610280441,COGS 153,A00,886989,Delgado; Tania,1,3,41,40
1746610281466,COGS 186,A01,886991,Staff,0,0,32,32
1746610282495,COGS 187A,A01,886993,Boyle; Mary E. T.,7,0,30,23
1746610283520,COGS 189,A00,886994,Staff,0,1,30,30
1746610284549,COMM 10,A01,886996,Staff,0,0,20,21
1746610284549,COMM 10,A02,886997,Staff,10,0,20,10
1746610284549,COMM 10,A03,959845,Staff,19,0,20,1
1746610285577,COMM 20,A01,886999,Leuning; Grant Maurstad,24,0,40,16
1746610287631,COMM 100A,A01,887002,Staff,0,0,20,25
1746610287631,COMM 100A,A02,887003,Staff,5,0,20,15
1746610288657,COMM 100B,A01,887005,Staff,0,8,20,24
1746610289684,COMM 106D,A00,887006,Staff,14,0,40,26
1746610290712,COMM 110G,A00,887007,Whitworth-Smith; Andrew C,12,0,40,28
1746610291739,COMM 111B,A00,887008,Staff,31,0,40,9
1746610292767,COMM 113T,A00,887009,Abuelhiga; Soraya Jill,28,0,40,12
1746610292767,COMM 113T,B00,906733,Staff,39,0,40,1
1746610293795,COMM 145,A00,887010,Staff,13,0,40,27
1746610294824,COMM 146,A00,887054,Staff,32,0,40,8
1746610295850,COMM 190,A00,887012,Staff,8,0,23,15
1746610296876,CSE 8A,A50,887015,Cao; Yingjun,56,0,85,29
1746610297903,CSE 11,A01,887017,Cao; Yingjun,11,0,70,59
1746610298928,CSE 20,A01,887019,Staff,30,0,50,20
1746610299955,CSE 21,A01,887021,Staff,79,0,100,21
1746610299955,CSE 21,B01,892583,Braun; Oliver,45,0,50,5
1746610300981,CSE 30,A01,887025,Eldon; John,142,0,200,58
1746610302010,CSE 100,A01,887027,Staff,26,0,50,24
1746610302010,CSE 100,A02,887028,Staff,42,0,50,8
1746610303035,CSE 101,A01,887030,Braun; Oliver,74,0,100,26
1746610303035,CSE 101,B01,887032,Jones; Miles E,0,3,50,50
1746610303035,CSE 101,B02,887033,Jones; Miles E,0,2,50,50
1746610304062,CSE 105,A01,908084,Jones; Miles E,32,0,50,18
1746610304062,CSE 105,A02,908087,Jones; Miles E,31,0,50,19
1746610305092,CSE 135,A01,887035,Powell; Thomas Allan,0,5,50,50
1746610306119,CSE 142,A01,887037,Staff,7,0,60,53
1746610307146,CSE 142L,A01,887039,Staff,34,0,60,26
1746610308172,CSE 151A,A01,887041,Solares; Edwin A,47,0,100,53
1746610309196,CSE 175,A01,887043,Kumar; Rakesh,30,0,30,0
1746610310222,CSS 1,A01,886389,Staff,0,1,40,40
1746610311253,DSC 30,A01,908097,Liao; Soohyun Nam,47,0,75,28
1746610312278,DSC 40A,A01,908099,Shannon; Kyle Michael,30,0,50,20
1746610313304,DSC 40B,A01,908112,Staff,15,0,50,35
1746610314330,DSC 80,A01,908116,Staff,19,0,60,41
1746610315355,DSC 197,001,956863,Eldridge; Justin Matthew,9999,0,9999,0
1746610316381,ECE 5,A01,886400,Morris; Karcher William,1,0,6,5
1746610316381,ECE 5,A02,886401,Morris; Karcher William,3,0,6,3
1746610317407,ECE 148,A01,886403,Silberman; Jack,0,14,14,14
1746610318431,ECON 1,A01,887265,Crane; Meredith Helen,11,0,70,59
1746610318431,ECON 1,B01,887268,Staff,42,0,50,8
1746610319458,ECON 2,A01,887273,Crane; Meredith Helen,54,0,70,16
1746610320484,ECON 3,A01,887279,Rondina; Giacomo,31,0,70,39
1746610321510,ECON 4,A01,887282,Anderson; John Charles,0,2,10,10
1746610322538,ECON 5,A01,887285,Staff,34,0,45,11
1746610322538,ECON 5,B01,887292,Staff,41,0,45,4
1746610323569,ECON 100A,A01,887337,Newhouse; Herbert S,54,0,70,16
1746610323569,ECON 100A,B01,887349,Staff,45,0,50,5
1746610324596,ECON 100B,A01,887361,Du; Songzi,29,0,70,41
1746610325622,ECON 100C,A01,887445,Newhouse; Herbert S,59,0,70,11
1746610326650,ECON 105,A00,887488,Vespa; Emanuel Ignacio,23,0,35,12
1746610327679,ECON 109,A01,887506,Shishkin; Denis,28,0,35,7
1746610328706,ECON 110A,A01,887568,Alon; Titan Michael,0,2,35,35
1746610328706,ECON 110A,B01,907601,Alon; Titan Michael,20,0,35,15
1746610329732,ECON 110B,A01,887598,Levkoff; Steven B.,0,24,70,70
1746610330760,ECON 112,A00,887599,Rondina; Giacomo,19,0,35,16
1746610331786,ECON 120A,A01,887603,Dai; Yinlin,36,0,70,34
1746610332812,ECON 120C,A01,887608,Sun; Yixiao,0,1,35,35
1746610332812,ECON 120C,B01,887614,Sun; Yixiao,0,0,35,35
1746610333838,ECON 138,A00,887621,Bharadwaj; Prashant,0,21,20,20
1746610334863,ECON 144,A00,958007,Squires; Dale E,11,0,35,24
1746610335889,ECON 171,A01,907666,Staff,18,0,35,17
1746610336915,ECON 175,A00,887626,Wu; Pak Yeung,22,0,35,13
1746610337979,ECON 190,A00,887640,Vespa; Emanuel Ignacio,22,0,35,13
1746610339018,EDS 25,A01,888197,Staff,0,0,0,0
1746610339018,EDS 25,A02,888209,Staff,0,0,0,0
1746610339018,EDS 25,A03,888210,Staff,0,0,0,0
1746610339018,EDS 25,A04,888212,Staff,0,0,0,0
1746610339018,EDS 25,A05,888213,Staff,0,0,0,0
1746610339018,EDS 25,A06,888214,Staff,0,0,0,0
1746610339018,EDS 25,A07,888235,Staff,0,2,0,0
1746610339018,EDS 25,A08,888236,Staff,0,0,0,0
1746610339018,EDS 25,A09,888240,Staff,0,0,0,0
1746610339018,EDS 25,A10,888244,Staff,0,0,0,0
1746610339018,EDS 25,B01,888273,Staff,0,0,0,0
1746610339018,EDS 25,B02,888285,Staff,0,0,0,0
1746610339018,EDS 25,B03,888423,Staff,0,0,0,1
1746610339018,EDS 25,B04,888432,Staff,0,0,0,0
1746610339018,EDS 25,B05,888433,Staff,0,0,0,0
1746610339018,EDS 25,B06,888467,Staff,0,0,0,0
1746610339018,EDS 25,B07,888468,Staff,0,0,0,0
1746610339018,EDS 25,B08,888479,Staff,0,0,0,0
1746610339018,EDS 25,B09,888484,Staff,0,0,0,0
1746610339018,EDS 25,B10,888487,Staff,0,0,0,0
1746610340046,EDS 38,A01,907700,Choi; Bailey Miyeon,30,0,30,0
1746610341073,EDS 112,A01,888601,Chapman; Thandeka K,12,0,40,28
1746610342100,EDS 115,A00,888697,Mendez; Kathrina Mendoza,10,0,30,20
1746610343127,EDS 116,A01,888893,Staff,33,0,40,7
1746610345180,EDS 124AR,A00,889133,Staff,29,0,50,21
1746610345180,EDS 124AR,B00,907471,Simon; Elizabeth A,37,0,50,13
1746610346208,EDS 124BR,A00,889134,Simon; Elizabeth A,44,0,100,56
1746610347239,EDS 125,A00,889135,Staff,25,0,30,5
1746610348266,EDS 126,A01,889138,Staff,35,0,40,5
1746610349294,EDS 164R,A01,889142,Wishard Guerra; Alison G.,32,0,50,18
1746610350320,ENG 30,A01,886396,Staff,0,0,0,0
1746610350320,ENG 30,B01,886398,Staff,0,0,0,0
1746610351348,ENVR 102,A00,906150,Montejo; Carolina,23,0,25,2
1746610352374,ETHN 103A,A00,887236,Man; Simeon S,0,2,0,0
1746610353402,ETHN 113,A00,887239,Staff,16,0,30,14
1746610354427,ETHN 116,A00,887240,Staff,16,0,25,9
1746610355454,ETHN 117,A00,887241,Choi; Esther Min,28,0,30,2
1746610356480,ETHN 118,A00,887243,Staff,24,0,30,6
1746610357506,ETHN 127,A00,887248,Cuong; Marisol,11,0,15,4
1746610358534,ETHN 139,A00,887250,Staff,7,0,10,3
1746610359563,ETHN 142,A00,887252,Staff,9,0,30,21
1746610360592,ETHN 161,A00,887253,Browne; Errol Tsekani,24,0,30,6
1746610361617,ETHN 163FR,A00,887255,Burelle; Julie Sara Veronique,0,0,5,5
1746610362648,GLBH 20,A00,889149,Elwardani; Nile Regina,8,0,42,34
1746610364702,GLBH 111,A01,889152,Burgos; Jose L.,17,0,17,0
1746610365728,GLBH 150,A00,889181,Sloane; Julia Kathryn,0,5,15,15
1746610367780,HDS 60,A01,886406,Warstadt; Melissa Fawn,72,0,80,8
1746610368806,HIAF 111,A00,889324,Gyamfi; Bright,25,0,32,7
1746610369833,HIEA 131,A00,889328,Staff,15,0,32,17
1746610370857,HIEA 144,A00,889333,Henry; Todd A.,26,0,32,6
1746610371887,HIEA 154,A00,889336,Henry; Todd A.,24,0,32,8
1746610372913,HIEU 106,A00,889339,Staff,22,0,32,10
1746610374966,HIEU 114,A00,889340,Staff,4,0,32,28
1746610375992,HIEU 135GS,A00,889342,Patterson; Patrick H.,0,0,1,24
1746610377020,HIEU 137,A00,889343,Edington; Claire Ellen,10,0,25,15
1746610378045,HIEU 148,A00,889345,Staff,14,0,32,18
1746610379071,HIEU 154,A00,889346,Biess; Frank Peter,21,0,32,11
1746610380098,HILA 102,A00,889351,Staff,12,0,32,20
1746610381123,HILD 2A,A01,889221,Lewandoski; Julia Mavis,0,8,32,32
1746610382149,HILD 7B,A01,889225,Man; Simeon S,0,12,32,32
1746610383174,HILD 7C,A01,889288,Alvarez; Luis A,0,14,32,32
1746610384199,HILD 30,A01,889323,Staff,0,5,32,32
1746610386250,HISC 119,A00,889383,Golan; Tal,20,0,32,12
1746610387275,HIUS 103,A00,889384,Man; Simeon S,0,0,32,32
1746610388301,HIUS 117,A00,919797,Kwak; Nancy,18,0,32,14
1746610389328,HIUS 142A,A00,919788,Staff,22,0,32,10
1746610391379,HIUS 149,A00,889386,Gyamfi; Bright,26,0,32,6
1746610392410,HIUS 155,A00,889387,Alvarez; Luis A,15,0,32,17
1746610393438,HUM 3,A01,886499,Caldwell; Michael Alan,19,0,50,31
1746610394468,HUM 3GS,A00,886500,Rodriguez; Bretton Sigfred,0,0,0,28
1746610395495,HUM 3R,A01,886502,Markman; Kristina,0,36,50,50
1746610396525,HUM 4,A01,886504,Crum; Matthew Stephen,23,0,50,27
1746610396525,HUM 4,B01,886506,West; Geoffrey Scott,17,0,50,33
1746610397551,HUM 4GS,A00,886507,Staff,0,0,0,19
1746610398579,HUM 5,A01,886509,Staff,31,0,50,19
1746610399608,HUM 5R,A01,886511,Zavodny; Tatiana Sophia,0,39,50,50
1746610400632,JAPN 180,A00,886407,Staff,16,0,40,24
1746610401661,LATI 50,A01,886409,Martin-Cabrera; Luis,3,0,22,19
1746610401661,LATI 50,A02,886410,Martin-Cabrera; Luis,19,0,22,3
1746610401661,LATI 50,A03,886411,Martin-Cabrera; Luis,21,0,22,1
1746610401661,LATI 50,A04,886412,Martin-Cabrera; Luis,8,0,22,14
1746610402689,LAWS 101,A00,907664,Staff,28,0,60,32
1746610403714,LIAB 1A,A00,889388,Saab; Dima,17,0,20,3
1746610404743,LIAB 1AX,A00,889389,El Cheddadi; Youniss,18,0,20,2
1746610405773,LIFR 1C,A00,889391,Van Moer; Vinciane G,8,0,20,12
1746610406800,LIFR 1CX,A00,889392,Van Moer; Vinciane G,7,0,20,13
1746610407827,LIFR 1D,A00,889393,Van Moer; Vinciane G,7,0,20,13
1746610408857,LIFR 1DX,A00,889394,Van Moer; Vinciane G,8,0,20,12
1746610409882,LIGN 7,A00,886923,Staff,25,0,50,25
1746610410909,LIGN 17,A00,886924,Kehler; Andrew Scott,126,0,150,24
1746610411934,LTAM 110,A00,889395,Staff,15,0,30,15
1746610412966,LTAM 110GS,A00,958010,Rodriguez; Bretton Sigfred,0,0,0,28
1746610413995,LTCH 101,A00,889397,Staff,23,0,25,2
1746610415021,LTCS 130,A00,889398,Staff,23,0,25,2
1746610416050,LTEA 138,A00,889399,Staff,24,0,40,16
1746610417079,LTEN 149,A00,889400,Wesling; Megan E.,0,3,25,25
1746610418107,LTEN 169,A00,889401,Staff,20,0,25,5
1746610419133,LTEN 180,A00,889402,Staff,10,0,15,5
1746610420159,LTEN 181,A00,889403,Staff,21,0,25,4
1746610421188,LTWL 100,A00,889404,Myerston Santana; Jacobo,2,0,25,23
1746610422214,LTWL 180GS,A00,889405,Staff,0,0,20,20
1746610423240,LTWL 181,A00,889406,Staff,16,0,25,9
1746610424269,LTWL 184,A00,889475,Mukherjee; Silpa,22,0,25,3
1746610425294,LTWR 102C,A00,889486,Staff,29,0,30,1
1746610426320,LTWR 115W,A00,889491,Staff,0,2,15,15
1746610427347,MAE 8,A01,886905,Staff,0,2,0,0
1746610428377,MAE 11,A00,886906,Bandaru; Prabhakar,0,7,50,50
1746610429404,MAE 20,A00,886907,Evdokimenko; Ekaterina,43,0,70,27
1746610430433,MAE 30B,A00,886909,Ghazinejad; Maziar,25,0,45,20
1746610431460,MAE 101B,A00,886910,Saintillan; David,30,0,45,15
1746610432486,MAE 105,A00,886911,Bandaru; Prabhakar,18,0,50,32
1746610433516,MAE 107,B00,958024,Staff,7,0,50,43
1746610434545,MAE 143B,A00,886913,Bewley; Thomas R,2,0,40,38
1746610435571,MAE 148,A01,886915,Silberman; Jack,0,3,14,14
1746610436600,MAE 160,A00,886916,Evdokimenko; Ekaterina,30,0,60,30
1746610437631,MATH 3C,A01,889681,Staff,0,2,30,30
1746610437631,MATH 3C,A02,960048,Staff,23,0,30,7
1746610438658,MATH 10A,A01,889760,Staff,26,0,30,4
1746610438658,MATH 10A,A02,889783,Staff,29,0,30,1
1746610439684,MATH 10B,A01,889785,Verstraete; Jacques Allan,1,0,35,34
1746610439684,MATH 10B,A02,889795,Verstraete; Jacques Allan,4,0,35,31
1746610439684,MATH 10B,B01,889797,Verstraete; Jacques Allan,3,0,35,32
1746610439684,MATH 10B,B02,889828,Verstraete; Jacques Allan,3,0,35,32
1746610440715,MATH 10C,A01,889849,Habib; Yousaf,8,0,30,22
1746610440715,MATH 10C,A02,889852,Habib; Yousaf,14,0,30,16
1746610440715,MATH 10C,A03,889853,Habib; Yousaf,22,0,30,8
1746610440715,MATH 10C,A04,889858,Habib; Yousaf,20,0,30,10
1746610440715,MATH 10C,B01,889861,Staff,1,0,30,29
1746610440715,MATH 10C,B02,889862,Staff,24,0,30,6
1746610440715,MATH 10C,B03,889863,Staff,27,0,30,3
1746610440715,MATH 10C,B04,889967,Staff,23,0,30,7
1746610441781,MATH 18,A01,889974,Staff,6,0,30,24
1746610441781,MATH 18,A02,889977,Staff,20,0,30,10
1746610441781,MATH 18,B01,889984,Hardiman; Liam,20,0,30,10
1746610441781,MATH 18,B02,889985,Hardiman; Liam,25,0,30,5
1746610442808,MATH 20A,A01,889990,Suk; Andrew Hoon,30,0,35,5
1746610443842,MATH 20B,A01,889993,Ohm; Ko Woon,21,0,30,9
1746610443842,MATH 20B,A02,889994,Ohm; Ko Woon,30,0,30,0
1746610443842,MATH 20B,B01,889996,Ohm; Ko Woon,22,0,30,8
1746610443842,MATH 20B,B02,889997,Ohm; Ko Woon,23,0,30,7
1746610444870,MATH 20C,A01,889999,Hammock; Frances H,17,0,30,13
1746610444870,MATH 20C,A02,890003,Hammock; Frances H,23,0,30,7
1746610444870,MATH 20C,B01,890006,Hammock; Frances H,2,0,30,28
1746610444870,MATH 20C,B02,890007,Hammock; Frances H,11,0,30,19
1746610445897,MATH 20D,A01,890011,Cheng; Hsiao-Bing,1,0,30,29
1746610445897,MATH 20D,A02,890012,Cheng; Hsiao-Bing,14,0,30,16
1746610445897,MATH 20D,B01,890016,Cheng; Hsiao-Bing,13,0,30,17
1746610445897,MATH 20D,B02,890017,Cheng; Hsiao-Bing,13,0,30,17
1746610446928,MATH 20E,A01,890026,Harel; Guershon,1,0,30,29
1746610446928,MATH 20E,A02,890029,Harel; Guershon,22,0,30,8
1746610446928,MATH 20E,B01,890033,Harel; Guershon,7,0,30,23
1746610446928,MATH 20E,B02,890101,Harel; Guershon,21,0,30,9
1746610447957,MATH 102,A01,890104,Staff,18,0,30,12
1746610447957,MATH 102,A02,890105,Staff,27,0,30,3
1746610448987,MATH 103B,A01,890116,Salehi Golsefidy; Alireza,3,0,30,27
1746610448987,MATH 103B,B01,890118,Staff,0,3,34,34
1746610450013,MATH 109,A01,890121,Aliabadi Sr.; Mohsen,0,0,30,30
1746610450013,MATH 109,B01,890124,Upadrashta; Pranav Kumar,18,0,30,12
1746610451041,MATH 120A,A01,890126,Eggers; John Dietrich,13,0,30,17
1746610452071,MATH 142B,A01,890128,Ioana; Adrian,19,0,30,11
1746610452071,MATH 142B,A02,890129,Ioana; Adrian,12,0,30,18
1746610453101,MATH 154,A01,890174,Staff,0,1,30,30
1746610453101,MATH 154,A02,890182,Staff,0,0,30,30
1746610454127,MATH 168A,A01,890197,Dumitriu; Ioana,21,0,35,14
1746610455156,MATH 170A,A01,890240,Nie; Jiawang,1,0,30,29
1746610455156,MATH 170A,A02,890241,Nie; Jiawang,11,0,30,19
1746610455156,MATH 170A,A03,890249,Nie; Jiawang,23,0,30,7
1746610456184,MATH 170B,A01,957891,Nag; Panchali,13,0,35,22
1746610458241,MATH 181A,A01,908025,Staff,0,3,35,35
1746610458241,MATH 181A,A02,960115,Staff,26,0,35,9
1746610459267,MATH 181B,A01,959874,Staff,24,0,30,6
1746610460294,MATH 193B,A01,890265,Staff,0,4,35,35
1746610461323,MGT 4,A01,890311,Anderson; John Charles,42,0,88,46
1746610462347,MGT 5,A00,907740,Staff,12,0,98,86
1746610463375,MGT 12,A00,890312,Lindenberger; Wade Douglas,67,0,98,31
1746610464403,MGT 16,A00,957883,Staff,78,0,98,20
1746610466455,MGT 45,A00,890314,Pecore; Joseph P.,45,0,98,53
1746610467481,MGT 71,A00,890315,Staff,0,12,98,98
1746610468512,MGT 100,A00,890316,Yavorsky; Daniel Ryan,44,0,98,54
1746610469539,MGT 103,A00,890317,Ehrich; Kristine R,73,0,98,25
1746610470567,MGT 105,A00,890356,Bates; Kenneth Walter,0,8,98,98
1746610471598,MGT 112,A00,890360,Ehrich; Kristine R,55,0,98,43
1746610472624,MGT 127R,A00,907732,Zhu; Kevin Xiaoguo,23,0,98,75
1746610473654,MGT 131B,A00,890361,Anderson; John Charles,59,0,98,39
1746610474680,MGT 137,A00,890362,Lindenberger; Wade Douglas,65,0,98,33
1746610475706,MGT 160,A00,890369,Johnson; Erik Barry,9,0,98,89
1746610477756,MGT 164,A00,890372,Zimmermann; Carsten,0,40,98,98
1746610478788,MGT 180,A00,890374,Bliss; Barbara Ann,11,0,98,87
1746610479815,MMW 15,A01,886414,Chang; Edmond Yi-Teh,0,12,28,28
1746610479815,MMW 15,A02,886415,Chang; Edmond Yi-Teh,0,8,28,28
1746610479815,MMW 15,A03,886416,Chang; Edmond Yi-Teh,0,9,28,28
1746610479815,MMW 15,A04,886417,Chang; Edmond Yi-Teh,0,8,28,28
1746610479815,MMW 15,B01,886419,Chang; Edmond Yi-Teh,0,7,28,28
1746610479815,MMW 15,B02,886420,Chang; Edmond Yi-Teh,0,7,28,28
1746610479815,MMW 15,B03,886421,Chang; Edmond Yi-Teh,0,7,28,28
1746610479815,MMW 15,B04,886422,Chang; Edmond Yi-Teh,0,8,28,28
1746610479815,MMW 15,C01,886424,Staff,0,9,28,28
1746610479815,MMW 15,C02,886425,Staff,0,8,28,28
1746610479815,MMW 15,C03,886426,Staff,0,8,28,28
1746610479815,MMW 15,C04,886427,Staff,0,8,28,28
1746610479815,MMW 15,C05,958038,Staff,0,8,28,28
1746610479815,MMW 15,C06,958039,Staff,0,7,28,28
1746610480844,MMW 15GS,A00,906910,Patterson; Patrick H.,4,0,28,24
1746610481869,MMW 122R,A01,886429,Rahimi; Babak,0,13,28,28
1746610481869,MMW 122R,A02,886430,Rahimi; Babak,0,12,28,28
1746610481869,MMW 122R,A03,958040,Rahimi; Babak,0,11,28,28
1746610482899,MUS 1A,A01,890937,Staff,2,0,25,23
1746610482899,MUS 1A,A02,891035,Staff,6,0,25,19
1746610482899,MUS 1A,C01,958912,Staff,24,0,25,1
1746610482899,MUS 1A,C02,958913,Staff,25,0,25,0
1746610484954,MUS 2AK,A00,957092,Ohnishi; Takae,15,0,15,0
1746610485982,MUS 4,A01,891044,Staff,0,0,25,25
1746610485982,MUS 4,A02,891045,Staff,22,0,25,3
1746610485982,MUS 4,B01,891048,Staff,17,0,25,8
1746610485982,MUS 4,B02,891050,Staff,25,0,25,0
1746610487013,MUS 5,A01,957506,Dubnov; Shlomo,0,0,25,25
1746610487013,MUS 5,A02,957622,Dubnov; Shlomo,12,0,25,13
1746610487013,MUS 5,A03,957623,Dubnov; Shlomo,20,0,25,5
1746610488040,MUS 6,A01,891053,Freitas Caetano; Marcelo,24,0,25,1
1746610488040,MUS 6,A02,891054,Freitas Caetano; Marcelo,23,0,25,2
1746610489069,MUS 7,A01,891081,Staff,0,0,25,25
1746610489069,MUS 7,A02,891082,Staff,3,0,25,22
1746610490096,MUS 8GS,A00,891118,Borgo; David Garcia,1,0,25,24
1746610491124,MUS 11,A01,891140,Staff,8,0,25,17
1746610491124,MUS 11,A02,891141,Staff,21,0,25,4
1746610492154,MUS 13,A01,891143,Staff,8,0,25,17
1746610492154,MUS 13,A02,891144,Staff,24,0,25,1
1746610493179,MUS 15,A01,891146,Staff,9,0,25,16
1746610493179,MUS 15,A02,891148,Staff,21,0,25,4
1746610493179,MUS 15,B01,891150,Staff,18,0,25,7
1746610493179,MUS 15,B02,891151,Staff,25,0,25,0
1746610494206,MUS 20,A01,891153,Staff,5,0,20,15
1746610494206,MUS 20,A02,891155,Staff,14,0,20,6
1746610495233,MUS 80,A00,891156,Staff,19,0,25,6
1746610495233,MUS 80,B00,891157,Staff,23,0,25,2
1746610496260,MUS 130,A00,891158,Ohnishi; Takae,35,0,35,0
1746610497287,MUS 150GS,A01,891160,Borgo; David Garcia,1,0,25,24
1746610498313,MUS 170,A01,891162,Freitas Caetano; Marcelo,20,0,25,5
1746610498313,MUS 170,A02,891164,Freitas Caetano; Marcelo,21,0,25,4
1746610499344,NANO 11,A00,886220,Vazquez Mena; Oscar,13,0,15,2
1746610500372,NANO 15,A01,886222,Drews; Aaron,4,0,7,3
1746610501397,NANO 104,A00,886224,Sirbuly; Donald,17,0,25,8
1746610502428,PH 40,A00,886528,Staff,23,0,40,17
1746610503456,PH 45,A01,886799,Staff,35,0,40,5
1746610504483,PH 110,A00,886802,Staff,0,6,40,40
1746610505511,PH 172,A00,906716,Staff,19,0,35,16
1746610506538,PH 191,A00,886803,Staff,6,0,40,34
1746610507568,PHIL 1,A00,889500,Staff,20,0,30,10
1746610508602,PHIL 10,A01,889549,Grush; Rick Scott,16,0,22,6
1746610508602,PHIL 10,A02,889551,Grush; Rick Scott,22,0,22,0
1746610509633,PHIL 28,A01,889559,Lamey; Andy M.,0,2,31,31
1746610509633,PHIL 28,A02,889561,Lamey; Andy M.,0,1,30,30
1746610509633,PHIL 28,A03,889572,Lamey; Andy M.,0,1,30,30
1746610510660,PHIL 35,A00,907839,Staff,13,0,15,2
1746610511724,PHIL 60,A00,889574,Staff,73,0,90,17
1746610512752,PHIL 101,A00,958004,Staff,12,0,15,3
1746610514808,PHIL 136,A00,889582,Fulkerson; Matthew Todd,26,0,45,19
1746610515834,PHIL 163,A01,889601,Staff,21,0,30,9
1746610515834,PHIL 163,B01,889606,Brandt; Reuven A,0,3,0,0
1746610516862,PHIL 164,A00,889610,Staff,16,0,30,14
1746610517889,PHIL 165,A00,889613,Staff,22,0,30,8
1746610518915,PHYS 1A,A00,886431,Staff,30,0,70,40
1746610519942,PHYS 1AL,001,886432,Tsai; Philbert S,0,1,30,30
1746610519942,PHYS 1AL,002,886436,Tsai; Philbert S,13,0,30,17
1746610520972,PHYS 1B,A00,886439,Staff,184,0,240,56
1746610522001,PHYS 1BL,001,886441,Tsai; Philbert S,0,4,30,30
1746610522001,PHYS 1BL,002,886444,Tsai; Philbert S,2,0,30,28
1746610523026,PHYS 1C,A00,896092,Arnold; Kam S,78,0,146,68
1746610524055,PHYS 1CL,001,886448,Tsai; Philbert S,0,0,30,30
1746610524055,PHYS 1CL,002,886449,Tsai; Philbert S,1,0,30,29
1746610524055,PHYS 1CL,003,886450,Tsai; Philbert S,16,0,30,14
1746610524055,PHYS 1CL,004,886451,Tsai; Philbert S,15,0,30,15
1746610525084,PHYS 2B,A01,886457,Staff,67,0,115,48
1746610526116,PHYS 2C,A01,886460,Shotwell; Brian,0,9,65,65
1746610527144,PHYS 2CL,A01,886467,Staff,0,4,28,28
1746610527144,PHYS 2CL,A02,886468,Staff,0,3,28,28
1746610528172,PHYS 2D,A01,886470,Staff,10,0,50,40
1746610529199,PHYS 4B,A01,886475,Grinstein; Benjamin,22,0,40,18
1746610530230,POLI 5,A00,891173,Desposato; Scott,7,0,25,18
1746610531256,POLI 5D,A01,891175,Staff,5,0,5,0
1746610531256,POLI 5D,B01,891178,Staff,5,0,5,0
1746610532286,POLI 11,A00,891179,Ferree; Karen E,0,0,35,35
1746610533311,POLI 12,A00,891180,Staff,15,0,30,15
1746610534340,POLI 27,A01,891182,Staff,11,0,75,64
1746610535366,POLI 30,A00,891183,Staff,8,0,50,42
1746610536392,POLI 100B,A00,891244,Staff,5,1,35,30
1746610537417,POLI 100I,A00,891247,Staff,7,0,30,23
1746610538447,POLI 104J,A00,891248,Nichter; Maysa,14,0,30,16
1746610539474,POLI 104U,A00,891250,Nichter; Maysa,1,0,30,29
1746610541528,POLI 110B,A00,891255,Wiens; David,19,0,25,6
1746610542558,POLI 112A,A00,891256,Wiens; David,6,0,25,19
1746610543583,POLI 114BR,A00,891261,Staff,19,0,30,11
1746610544611,POLI 117R,A00,891262,Forman; Fonna,0,6,50,50
1746610545639,POLI 118,A00,891264,Ingham; Sean,17,0,25,8
1746610546668,POLI 124A,A00,891265,Staff,18,0,20,2
1746610547698,POLI 125D,A00,891266,Nichter; Simeon C,2,0,25,23
1746610548724,POLI 126,A00,891268,Nichter; Simeon C,7,0,25,18
1746610549752,POLI 126AA,A00,891272,Staff,15,0,25,10
1746610550778,POLI 130AA,A00,891273,Staff,15,0,20,5
1746610551803,POLI 134AA,A00,891274,Staff,4,0,20,16
1746610553860,POLI 138,A00,891278,Staff,21,0,25,4
1746610554886,POLI 142K,A00,891280,Staff,10,0,25,15
1746610555914,POLI 142M,A00,891281,Gartzke; Erik,16,0,30,14
1746610556942,POLI 142P,A00,891284,Staff,20,0,30,10
1746610557970,POLI 143,A00,891285,Gartzke; Erik,12,0,30,18
1746610559000,POLI 153,A00,891286,Staff,19,0,20,1
1746610561059,POLI 175,A00,891290,Staff,15,0,20,5
1746610562089,PSYC 1,A00,890674,Steiner; Eric Tomas,0,11,45,45
1746610563119,PSYC 2,A00,890676,Albright; Thomas D,20,0,35,15
1746610564145,PSYC 3,A00,890679,Staff,17,0,20,3
1746610565169,PSYC 6,A00,959858,Staff,19,0,20,1
1746610566196,PSYC 60,A01,890684,Rickard; Timothy C.,0,6,45,45
1746610567223,PSYC 70,A01,890689,Geller; Emma Harlan,6,0,30,24
1746610568251,PSYC 71,A01,959860,Staff,21,0,25,4
1746610569277,PSYC 100,A00,890690,Lacefield; Katharine I,0,50,180,180
1746610570305,PSYC 102,A00,890695,Staff,18,0,40,22
1746610571331,PSYC 105,A00,890699,Geller; Emma Harlan,70,0,100,30
1746610572359,PSYC 106,A00,890701,Gorman; Michael R.,5,0,30,25
1746610573387,PSYC 108,A00,890704,Adrian; Julia Anna,0,29,50,50
1746610574415,PSYC 118,A01,890712,Staff,11,0,30,19
1746610575443,PSYC 124,A00,890716,Chapman; Eddie Nathaniel,25,0,60,35
1746610576468,PSYC 131,A00,890717,Anagnostaras; Stephan,0,7,80,80
1746610577556,PSYC 137,A00,890719,Winkielman; Piotr,0,11,30,30
1746610578586,PSYC 144,A00,890721,Adrian; Julia Anna,0,9,45,45
1746610579615,PSYC 162,A00,890805,Staff,0,2,75,75
1746610580642,PSYC 169,A00,890810,Staff,0,15,30,30
1746610581689,PSYC 172,A00,890814,Gorman; Michael R.,9,0,30,21
1746610582717,PSYC 181,A00,890818,Anagnostaras; Stephan,6,0,200,194
1746610583743,PSYC 184,A00,959861,Staff,160,0,175,15
1746610584769,PSYC 189,A00,890823,Staff,0,2,30,30
1746610585797,PSYC 191,A00,890884,Rickard; Timothy C.,0,12,35,35
1746610586825,PSYC 193,A00,890913,Staff,19,0,30,11
1746610586825,PSYC 193,B00,890914,Chapman; Eddie Nathaniel,24,0,30,6
1746610587850,PSYC 193L,A01,890918,Lowe; Angela Beth,20,0,30,10
1746610587850,PSYC 193L,B01,890921,Hurwitz; Ethan Scott,20,0,30,10
1746610587850,PSYC 193L,C01,890928,Staff,30,0,30,0
1746610588880,RELI 149,A00,886806,Rahimi; Babak,23,0,40,17
1746610589905,SE 9,A01,886814,Staff,7,0,20,13
1746610590934,SE 101B,A01,886816,Chadha; Mayank,3,0,35,32
1746610591963,SE 110B,A00,886818,Zhu; Qiang,4,0,75,71
1746610592990,SE 125,A01,886830,Staff,10,0,30,20
1746610594020,SE 130B,A01,886835,Staff,14,0,40,26
1746610595050,SE 131A,A01,886838,Krysl; Petr,34,0,55,21
1746610596075,SE 154,A00,886840,Staff,28,0,50,22
1746610597104,SE 164GS,A01,886849,Staff,6,0,20,14
1746610598134,SE 167GS,A01,886853,Staff,6,0,20,14
1746610599162,SIO 25,A01,890107,Staff,19,0,30,11
1746610600188,SIO 45,A00,890109,Cook; Geoffrey W,114,0,200,86
1746610601215,SIO 109R,A00,890110,Forman; Fonna,0,16,20,20
1746610602246,SIO 187,A01,890114,Kacev; David,15,0,40,25
1746610603275,SOCI 1,A01,890431,Thorpe; Charles Robert,14,0,30,16
1746610603275,SOCI 1,A02,890518,Thorpe; Charles Robert,30,0,30,0
1746610604301,SOCI 2,A01,957978,Staff,25,0,25,0
1746610604301,SOCI 2,A02,957979,Staff,23,0,25,2
1746610605329,SOCI 20,A01,890523,Calderon-Zaks; Michael Aar,21,0,30,9
1746610605329,SOCI 20,A02,890526,Calderon-Zaks; Michael Aar,29,0,30,1
1746610606356,SOCI 30,A01,890533,Pardo Guerra; Juan Pablo,37,0,40,3
1746610607382,SOCI 40,A01,890535,Staff,27,0,45,18
1746610608409,SOCI 104Q,A00,890559,Staff,17,0,30,13
1746610609435,SOCI 106,A00,890560,Arnal; Maud Marie Leonie,20,0,30,10
1746610610460,SOCI 110,A00,890567,Holkenbrink-Monk; Charlene,19,0,30,11
1746610611489,SOCI 112,A00,890568,Victoria Torres; Pablo,2,0,55,53
1746610612515,SOCI 115,A00,890597,Arnal; Maud Marie Leonie,28,0,45,17
1746610614567,SOCI 121,A00,890604,Pardo Guerra; Juan Pablo,38,0,45,7
1746610615596,SOCI 126,A01,890608,Staff,8,0,10,2
1746610616622,SOCI 127,A00,890609,Staff,18,0,30,12
1746610617647,SOCI 131,A00,890610,Thorpe; Charles Robert,37,0,45,8
1746610618672,SOCI 135,A00,890615,Payne; Christine Anna,14,0,45,31
1746610619699,SOCI 139,A00,890620,Staff,38,0,45,7
1746610620725,SOCI 148E,A00,890622,Calderon-Zaks; Michael Aar,36,0,45,9
1746610621754,SOCI 150,A00,890623,Kohler; Kristopher M.,31,0,45,14
1746610622784,SOCI 157,A00,890625,Jules-Rosette; Bennetta W.,18,0,20,2
1746610623813,SOCI 160,A00,890627,Payne; Christine Anna,21,0,45,24
1746610624839,SYN 1,A00,886855,Fish; Gwendolyn Anne,0,1,0,0
1746610624839,SYN 1,B00,906086,Fish; Gwendolyn Anne,0,2,0,2
1746610625866,SYN 2R,A00,886860,Staff,0,17,15,15
1746610625866,SYN 2R,B00,906106,Atkinson; Arthur Laird,0,16,15,15
1746610626898,SYN 100,A01,886866,Browne; Emily,0,28,20,20
1746610626898,SYN 100,B01,906128,Rock; Martin,0,4,20,20
1746610626898,SYN 100,C01,906140,Deavenport; James Cary,0,4,20,20
1746610626898,SYN 100,D01,907816,Deavenport; James Cary,0,5,20,20
1746610627925,TDAC 1,A00,890286,Walsh; Kim C.,7,0,20,13
1746610628951,TDAC 101,A00,890296,Basso; Beatrice,15,0,20,5
1746610629976,TDDE 131,A00,890297,Staff,47,0,50,3
1746610631003,TDDM 1,A00,890287,Weinberg; Sadie,25,0,30,5
1746610632032,TDGE 11,A00,890288,Fulton; Julia,138,0,200,62
1746610632032,TDGE 11,B00,890289,Castro; Robert Jess,184,0,200,16
1746610633062,TDGE 25,B00,957359,Walsh; Kim C.,5,0,20,15
1746610634092,TDGE 40,A01,890292,Power; Jade Yukana,26,0,30,4
1746610635118,TDGE 124,A00,890298,Havis; Allan,0,2,50,50
1746610636147,TDGE 131R,A00,890299,Burelle; Julie Sara Veronique,15,0,42,27
1746610637172,TDHT 101,A00,890300,Staff,10,0,20,10
1746610638199,TDHT 109,A01,890302,Anderson; Mysia Anyse,31,0,40,9
1746610639227,TDMV 1,A00,890293,Arcidiacono; Kristin,18,0,30,12
1746610640252,TDMV 2,A00,890294,Weinberg; Sadie,23,0,30,7
1746610641279,TDMV 3,A00,957878,Arcidiacono; Kristin,28,0,30,2
1746610643330,TDMV 138,A00,890304,Jun; Grace Shin Hae,25,0,40,15
1746610644357,TDMV 140,A00,890305,Corrales; Joseph Bernales,25,0,30,5
1746610645383,TDMV 142,A00,890307,Caligagan; Tony,32,0,40,8
1746610646409,TDMV 144,A00,890308,Camaya; Michelle Ann,25,0,30,5
1746610647437,TDPW 1,A00,890295,Stein; Deborah Isobel,3,0,20,17
1746610648466,USP 2,A01,890272,Lerner; Amy M,7,0,20,13
1746610649492,USP 3,A01,890274,Staff,12,0,30,18
1746610650520,USP 15,A01,890276,Sun; Feiyang,16,0,30,14
1746610651545,USP 25,A00,890277,Shenkman; Michael Thomas,18,0,25,7
1746610652575,USP 138,A00,890278,Staff,13,0,25,12
1746610653603,USP 143,A00,890279,Staff,21,0,70,49
1746610654632,USP 144,A00,890280,Chowdhury; Muhammed Zohir,16,0,30,14
1746610655656,USP 150,A00,890281,Boomhower; Matthew Charles,4,0,30,26
1746610656684,USP 151,A00,890282,Staff,16,0,20,4
1746610657711,USP 162,A00,890283,Andrews; Abigail Leslie,16,0,20,4
1746610658750,USP 168,A00,920477,Kwak; Nancy,0,0,5,5
1746610659776,USP 181,A00,890284,Staff,3,0,20,17
1746610660803,USP 191A,A00,890285,Staff,12,0,20,8
1746610661830,VIS 101,A00,886512,Staff,26,0,75,49
1746610662859,VIS 103,A00,886513,Cruz; Edwin Teddy,61,0,75,14
1746610663888,VIS 108,A00,886514,Staff,4,0,15,11
1746610664920,VIS 127P,A00,886515,Shen; Kuiyi,80,0,146,66
1746610665945,VIS 149,A00,886516,Yoldas; Pinar,0,0,15,15
1746610666969,VIS 164,A00,886526,Erdmann; Dean,19,0,22,3
1746610667996,VIS 194S,A00,886527,Staff,61,0,75,14
1746610669022,WCWP 10A,C00,886484,Martiniuk; Jill,12,0,15,3
1746610670050,WCWP 10B,A00,886490,Uriarte; Emma,0,0,15,15
1746610670050,WCWP 10B,B00,886491,Dhir; Simrita,8,0,15,7
1746610670050,WCWP 10B,C00,886492,Ornelas; Tricia,0,0,15,15
1746610671078,WCWP 100,A00,886494,Young; Mark T,0,6,15,15
1746610673156,AAS 10,A01,886199,Childs; Dennis R.,0,3,0,0
1746610674182,ANAR 104,A01,886940,Shtienberg; Gilad,27,0,30,3
1746610675207,ANAR 120,A00,886953,Staff,13,0,20,7
1746610676233,ANBI 148,A01,886955,Wilder; Linnea Lorene,30,0,40,10
1746610678285,ANSC 122,A00,886957,Staff,24,0,30,6
1746610679311,ANSC 150,A00,886958,Sloane; Julia Kathryn,2,0,15,13
1746610680340,ANSC 156,A00,886959,Jenkins; Janis A.,0,1,15,15
1746610681365,ANSC 180,A00,886960,Staff,11,0,17,6
1746610682403,ANSC 188,A00,886961,Jassal; Aftab,9,0,25,16
1746610683431,ANSC 190,A00,886962,Jassal; Aftab,14,0,25,11
1746610684458,ANSC 191,A00,886963,Staff,18,0,20,2
1746610685485,ANTH 3,A01,891689,Staff,17,0,20,3
1746610686513,ANTH 5,A00,886933,Semendeferi; Ekaterini,16,0,20,4
1746610687542,ANTH 10,A00,886934,Staff,0,12,30,30
1746610688571,ANTH 21,A01,886936,Staff,41,0,60,19
1746610689598,ANTH 23,A01,886938,Staff,92,0,100,8
1746610690625,ANTH 105,A00,886964,Stewart; Alexander B,84,0,100,16
1746610691653,ANTH 108,A00,886965,Pedersen; David,9,0,20,11
1746610692681,AWP 10,001,886147,Staff,0,0,0,0
1746610692681,AWP 10,002,886148,Staff,0,0,0,0
1746610692681,AWP 10,003,886149,Staff,0,0,0,0
1746610692681,AWP 10,004,886150,Staff,0,0,0,0
1746610692681,AWP 10,005,886151,Staff,0,0,0,0
1746610692681,AWP 10,006,886152,Staff,0,0,0,0
1746610692681,AWP 10,007,886153,Staff,0,0,0,0
1746610692681,AWP 10,008,886154,Staff,0,0,0,0
1746610692681,AWP 10,009,886155,Staff,0,0,0,0
1746610692681,AWP 10,010,886156,Staff,0,0,0,0
1746610692681,AWP 10,011,886158,Staff,0,0,0,0
1746610692681,AWP 10,012,886160,Staff,0,0,0,0
1746610692681,AWP 10,013,886161,Staff,0,0,0,0
1746610692681,AWP 10,014,886162,Staff,0,0,0,0
1746610692681,AWP 10,015,886163,Staff,0,0,0,0
1746610692681,AWP 10,016,886164,Staff,0,0,0,0
1746610692681,AWP 10,017,886165,Staff,0,0,0,0
1746610692681,AWP 10,018,886166,Staff,0,0,0,0
1746610692681,AWP 10,019,886168,Staff,0,0,0,0
1746610692681,AWP 10,020,886170,Staff,0,0,0,0
1746610692681,AWP 10,021,886172,Staff,0,0,0,0
1746610693712,AWP 10R,001,886173,Staff,0,1,0,0
1746610693712,AWP 10R,002,886174,Staff,0,1,0,0
1746610693712,AWP 10R,003,886175,Staff,0,0,0,0
1746610693712,AWP 10R,004,886176,Staff,0,0,0,0
1746610693712,AWP 10R,005,886177,Staff,0,0,0,0
1746610693712,AWP 10R,006,886178,Staff,0,0,0,0
1746610693712,AWP 10R,007,886179,Staff,0,0,0,0
1746610693712,AWP 10R,008,886181,Staff,0,0,0,0
1746610693712,AWP 10R,009,886182,Staff,0,0,0,0
1746610693712,AWP 10R,010,886183,Staff,0,0,0,0
1746610693712,AWP 10R,011,886184,Staff,0,0,0,0
1746610693712,AWP 10R,012,886185,Staff,0,0,0,0
1746610693712,AWP 10R,013,886186,Staff,0,0,0,0
1746610693712,AWP 10R,014,886187,Staff,0,0,0,0
1746610693712,AWP 10R,015,886188,Staff,0,0,0,0
1746610693712,AWP 10R,016,886189,Staff,0,0,0,0
1746610693712,AWP 10R,017,960532,Staff,0,0,0,0
1746610693712,AWP 10R,018,960533,Staff,0,0,0,0
1746610693712,AWP 10R,019,960534,Staff,0,0,0,0
1746610693712,AWP 10R,020,960538,Staff,0,0,0,0
1746610693712,AWP 10R,021,960540,Staff,0,0,0,0
1746610693712,AWP 10R,022,960541,Staff,0,0,0,0
1746610693712,AWP 10R,023,960542,Staff,0,0,0,0
1746610693712,AWP 10R,024,960544,Staff,0,0,0,0
1746610693712,AWP 10R,025,960545,Staff,0,0,0,0
1746610693712,AWP 10R,026,960548,Staff,0,0,0,0
1746610694742,AWP 102R,A00,886190,Staff,0,0,0,0
1746610694742,AWP 102R,B00,886191,Staff,0,0,0,0
1746610695769,BENG 100,A01,886193,Staff,17,0,30,13
1746610696795,BENG 122A,A01,886195,Hasty; Jeff M,13,0,30,17
1746610697861,BENG 166A,A00,886196,Sah; Robert Lie-Yuan,0,3,30,30
1746610698888,BENG 190,A00,958050,Khojah; Reem I,17,0,25,8
1746610699917,BIBC 102,A01,894320,Staff,0,1,46,46
1746610699917,BIBC 102,A02,894321,Staff,0,0,46,46
1746610699917,BIBC 102,A03,894344,Staff,6,0,46,40
1746610699917,BIBC 102,A04,894345,Staff,27,0,47,20
1746610700948,BICD 100R,A01,894365,Smith; Laurie,0,2,58,58
1746610700948,BICD 100R,A02,894366,Smith; Laurie,0,4,58,58
1746610700948,BICD 100R,A03,894367,Smith; Laurie,0,0,59,59
1746610700948,BICD 100R,A04,959869,Smith; Laurie,38,0,59,21
1746610701975,BICD 136,A01,894383,Gustafson-Brown; Cindy,14,0,50,36
1746610703001,BIEB 102,A01,894494,Butler; Shannon Rhey,51,0,130,79
1746610705054,BIEB 150,A01,894617,Wills; Christopher,3,0,20,17
1746610705054,BIEB 150,A02,894631,Wills; Christopher,3,0,20,17
1746610705054,BIEB 150,A03,894937,Wills; Christopher,3,0,20,17
1746610705054,BIEB 150,A04,894946,Wills; Christopher,5,0,20,15
1746610706287,BIEB 194,A00,906141,Kurle; Carolyn M.,5,0,20,15
1746610707318,BILD 1,A01,894154,Staff,3,0,19,16
1746610707318,BILD 1,A02,894155,Staff,14,0,19,5
1746610707318,BILD 1,A03,894160,Staff,13,0,19,6
1746610707318,BILD 1,A04,894161,Staff,15,0,18,3
1746610708344,BILD 2,A01,894168,Staff,0,0,50,50
1746610708344,BILD 2,A02,894169,Staff,0,0,50,50
1746610708344,BILD 2,A03,894179,Staff,0,0,50,50
1746610708344,BILD 2,A04,894203,Staff,22,0,50,28
1746610709374,BILD 3,A01,894213,Staff,23,0,31,8
1746610709374,BILD 3,A02,894214,Staff,26,0,31,5
1746610709374,BILD 3,A03,894235,Staff,28,0,31,3
1746610709374,BILD 3,A04,894236,Staff,28,0,32,4
1746610710400,BILD 4,A01,894253,Reuther; Keefe,5,0,24,19
1746610710400,BILD 4,A02,894258,Reuther; Keefe,16,0,24,8
1746610711426,BILD 5,A01,894276,Reuther; Keefe,33,0,50,17
1746610711426,BILD 5,A02,894277,Reuther; Keefe,45,0,50,5
1746610711426,BILD 5,A03,894290,Reuther; Keefe,44,0,50,6
1746610711426,BILD 5,A04,894291,Reuther; Keefe,48,0,50,2
1746610712452,BILD 24,A01,894297,Pirino; Giorgia,40,0,60,20
1746610713477,BIMM 100,B01,958915,Staff,71,0,100,29
1746610714510,BIMM 101,A01,895017,McDonnell; Lisa Marie,0,5,24,24
1746610714510,BIMM 101,A02,895018,McDonnell; Lisa Marie,0,5,24,24
1746610714510,BIMM 101,B01,895020,McDonnell; Lisa Marie,0,5,24,24
1746610714510,BIMM 101,B02,895021,McDonnell; Lisa Marie,0,4,24,24
1746610715535,BIMM 110,A01,895023,Staff,1,0,25,24
1746610715535,BIMM 110,A02,895024,Staff,9,0,25,16
1746610715535,BIMM 110,A03,895025,Staff,18,0,25,7
1746610715535,BIMM 110,A04,895031,Staff,20,0,25,5
1746610716562,BIMM 120,A01,895114,Gustafson-Brown; Cindy,14,0,28,14
1746610716562,BIMM 120,A02,895126,Gustafson-Brown; Cindy,21,0,27,6
1746610717595,BIPN 100,A01,895130,Yang; Mingyu,0,0,38,38
1746610717595,BIPN 100,A02,895131,Yang; Mingyu,31,0,38,7
1746610717595,BIPN 100,A03,895132,Yang; Mingyu,32,0,38,6
1746610717595,BIPN 100,A04,895133,Yang; Mingyu,27,0,36,9
1746610718624,BIPN 120,A01,895135,Cooke; James Edward,0,3,13,13
1746610718624,BIPN 120,A02,895136,Cooke; James Edward,0,1,13,13
1746610718624,BIPN 120,A03,895137,Cooke; James Edward,0,3,13,13
1746610718624,BIPN 120,A04,895156,Cooke; James Edward,0,2,11,11
1746610719655,BIPN 134,A01,895235,Cooke; James Edward,0,1,25,25
1746610719655,BIPN 134,A02,895237,Cooke; James Edward,0,0,25,25
1746610719655,BIPN 134,A03,895240,Cooke; James Edward,1,0,25,24
1746610719655,BIPN 134,A04,895270,Cooke; James Edward,20,0,25,5
1746610720685,BIPN 189,A00,892103,Staff,0,14,14,14
1746610722752,BISP 194,A00,958008,Staff,0,2,0,0
1746610723780,CAT 124,A01,922009,Staff,0,5,20,20
1746610724808,CAT 125R,A00,886390,Morales; Celeste Georgianna,0,4,20,20
1746610724808,CAT 125R,B00,886391,Irwin; Matthew Joseph,0,4,20,20
1746610724808,CAT 125R,C00,886392,Smith; Lauryn Alissa,0,2,20,20
1746610724808,CAT 125R,D00,886393,Vanderschuit; Maya Alysia,0,3,20,20
1746610724808,CAT 125R,E00,886394,Marchisotto; Jennifer Anne,0,3,20,20
1746610725835,CENG 15,A01,886218,Drews; Aaron,3,0,8,5
1746610726861,CENG 113,A00,886219,Opatkiewicz; Justin Paul,15,0,25,10
1746610727888,CGS 101,A00,887044,Staff,7,0,20,13
1746610728915,CGS 105,A01,887046,Staff,14,0,25,11
1746610729941,CGS 112,A00,887047,Cuong; Marisol,12,0,15,3
1746610730969,CGS 113,A00,887048,Staff,23,0,30,7
1746610731995,CGS 120,A00,887049,Staff,9,0,17,8
1746610733021,CHEM 6A,A01,886336,Lam; Tin Yiu,38,0,50,12
1746610733021,CHEM 6A,A02,886338,Lam; Tin Yiu,37,0,50,13
1746610734046,CHEM 6B,A01,886341,Hopkins; Patrycja Anna,16,0,50,34
1746610734046,CHEM 6B,A02,886343,Hopkins; Patrycja Anna,42,0,50,8
1746610735076,CHEM 6C,A01,886346,Albizati; Kim F.,0,2,50,50
1746610735076,CHEM 6C,A02,886348,Albizati; Kim F.,24,0,50,26
1746610736107,CHEM 40A,A01,886352,Klosterman; Jeremy K,65,0,100,35
1746610737136,CHEM 40B,A01,886356,Klosterman; Jeremy K,0,24,100,100
1746610738165,CHEM 41B,A01,886360,Theodorakis; Emmanuel,25,0,50,25
1746610738165,CHEM 41B,A02,886362,Theodorakis; Emmanuel,47,0,50,3
1746610739195,CHIN 165A,A00,886382,Xu; Li,18,0,20,2
1746610740222,CLAS 120,A00,886387,Myerston Santana; Jacobo,33,0,40,7
1746610741248,COGS 9,A01,886967,Shannon; Kyle Michael,42,0,60,18
1746610742281,COGS 11,A01,886969,Staff,9,0,30,21
1746610743309,COGS 14A,A01,886971,Staff,5,0,60,55
1746610744333,COGS 14B,A01,886973,Hoffman; Drew Ellen,4,0,60,56
1746610745360,COGS 18,A01,886975,Morgan; Eric,34,0,60,26
1746610746389,COGS 20,A01,886977,Staff,3,0,8,5
1746610746389,COGS 20,A02,886978,Staff,5,0,7,2
1746610747414,COGS 100,A01,907783,Staff,0,1,30,30
1746610748446,COGS 101B,A01,886980,Staff,0,4,48,48
1746610749474,COGS 101C,A01,886982,Delgado; Tania,0,5,44,44
1746610750504,COGS 102A,A01,886984,Johnson; Christine M.,3,0,30,27
1746610751532,COGS 118B,A01,886986,Staff,0,4,88,88
1746610752561,COGS 150,A01,886988,Bergen; Benjamin,22,0,50,28
1746610753588,COGS 153,A00,886989,Delgado; Tania,1,3,41,40
1746610754615,COGS 186,A01,886991,Staff,0,0,32,32
1746610755640,COGS 187A,A01,886993,Boyle; Mary E. T.,7,0,30,23
1746610756668,COGS 189,A00,886994,Staff,0,1,30,30
1746610757697,COMM 10,A01,886996,Staff,0,0,20,21
1746610757697,COMM 10,A02,886997,Staff,10,0,20,10
1746610757697,COMM 10,A03,959845,Staff,19,0,20,1
1746610758722,COMM 20,A01,886999,Leuning; Grant Maurstad,24,0,40,16
1746610760772,COMM 100A,A01,887002,Staff,0,0,20,25
1746610760772,COMM 100A,A02,887003,Staff,5,0,20,15
1746610761798,COMM 100B,A01,887005,Staff,0,8,20,24
1746610762825,COMM 106D,A00,887006,Staff,14,0,40,26
1746610763853,COMM 110G,A00,887007,Whitworth-Smith; Andrew C,12,0,40,28
1746610764877,COMM 111B,A00,887008,Staff,31,0,40,9
1746610765902,COMM 113T,A00,887009,Abuelhiga; Soraya Jill,28,0,40,12
1746610765902,COMM 113T,B00,906733,Staff,39,0,40,1
1746610766927,COMM 145,A00,887010,Staff,13,0,40,27
1746610767953,COMM 146,A00,887054,Staff,32,0,40,8
1746610768977,COMM 190,A00,887012,Staff,8,0,23,15
1746610770004,CSE 8A,A50,887015,Cao; Yingjun,56,0,85,29
1746610771031,CSE 11,A01,887017,Cao; Yingjun,11,0,70,59
1746610772057,CSE 20,A01,887019,Staff,30,0,50,20
1746610773085,CSE 21,A01,887021,Staff,79,0,100,21
1746610773085,CSE 21,B01,892583,Braun; Oliver,45,0,50,5
1746610774116,CSE 30,A01,887025,Eldon; John,142,0,200,58
1746610775144,CSE 100,A01,887027,Staff,26,0,50,24
1746610775144,CSE 100,A02,887028,Staff,42,0,50,8
1746610776172,CSE 101,A01,887030,Braun; Oliver,74,0,100,26
1746610776172,CSE 101,B01,887032,Jones; Miles E,0,3,50,50
1746610776172,CSE 101,B02,887033,Jones; Miles E,0,2,50,50
1746610777201,CSE 105,A01,908084,Jones; Miles E,32,0,50,18
1746610777201,CSE 105,A02,908087,Jones; Miles E,31,0,50,19
1746610778227,CSE 135,A01,887035,Powell; Thomas Allan,0,5,50,50
1746610779254,CSE 142,A01,887037,Staff,7,0,60,53
1746610780279,CSE 142L,A01,887039,Staff,34,0,60,26
1746610781306,CSE 151A,A01,887041,Solares; Edwin A,47,0,100,53
1746610782336,CSE 175,A01,887043,Kumar; Rakesh,30,0,30,0
1746610783364,CSS 1,A01,886389,Staff,0,1,40,40
1746610784391,DSC 30,A01,908097,Liao; Soohyun Nam,47,0,75,28
1746610785421,DSC 40A,A01,908099,Shannon; Kyle Michael,30,0,50,20
1746610786448,DSC 40B,A01,908112,Staff,15,0,50,35
1746610787474,DSC 80,A01,908116,Staff,19,0,60,41
1746610788501,DSC 197,001,956863,Eldridge; Justin Matthew,9999,0,9999,0
1746610789527,ECE 5,A01,886400,Morris; Karcher William,1,0,6,5
1746610789527,ECE 5,A02,886401,Morris; Karcher William,3,0,6,3
1746610790555,ECE 148,A01,886403,Silberman; Jack,0,14,14,14
1746610791587,ECON 1,A01,887265,Crane; Meredith Helen,11,0,70,59
1746610791587,ECON 1,B01,887268,Staff,42,0,50,8
1746610792614,ECON 2,A01,887273,Crane; Meredith Helen,54,0,70,16
1746610793641,ECON 3,A01,887279,Rondina; Giacomo,31,0,70,39
1746610794667,ECON 4,A01,887282,Anderson; John Charles,0,2,10,10
1746610795695,ECON 5,A01,887285,Staff,34,0,45,11
1746610795695,ECON 5,B01,887292,Staff,41,0,45,4
1746610796723,ECON 100A,A01,887337,Newhouse; Herbert S,54,0,70,16
1746610796723,ECON 100A,B01,887349,Staff,45,0,50,5
1746610797751,ECON 100B,A01,887361,Du; Songzi,29,0,70,41
1746610798776,ECON 100C,A01,887445,Newhouse; Herbert S,59,0,70,11
1746610799808,ECON 105,A00,887488,Vespa; Emanuel Ignacio,23,0,35,12
1746610800839,ECON 109,A01,887506,Shishkin; Denis,28,0,35,7
1746610801866,ECON 110A,A01,887568,Alon; Titan Michael,0,2,35,35
1746610801866,ECON 110A,B01,907601,Alon; Titan Michael,20,0,35,15
1746610802893,ECON 110B,A01,887598,Levkoff; Steven B.,0,24,70,70
1746610803919,ECON 112,A00,887599,Rondina; Giacomo,19,0,35,16
1746610804952,ECON 120A,A01,887603,Dai; Yinlin,36,0,70,34
1746610805982,ECON 120C,A01,887608,Sun; Yixiao,0,1,35,35
1746610805982,ECON 120C,B01,887614,Sun; Yixiao,0,0,35,35
1746610807008,ECON 138,A00,887621,Bharadwaj; Prashant,0,21,20,20
1746610808035,ECON 144,A00,958007,Squires; Dale E,11,0,35,24
1746610809062,ECON 171,A01,907666,Staff,18,0,35,17
1746610810095,ECON 175,A00,887626,Wu; Pak Yeung,22,0,35,13
1746610811123,ECON 190,A00,887640,Vespa; Emanuel Ignacio,22,0,35,13
1746610812164,EDS 25,A01,888197,Staff,0,0,0,0
1746610812164,EDS 25,A02,888209,Staff,0,0,0,0
1746610812164,EDS 25,A03,888210,Staff,0,0,0,0
1746610812164,EDS 25,A04,888212,Staff,0,0,0,0
1746610812164,EDS 25,A05,888213,Staff,0,0,0,0
1746610812164,EDS 25,A06,888214,Staff,0,0,0,0
1746610812164,EDS 25,A07,888235,Staff,0,2,0,0
1746610812164,EDS 25,A08,888236,Staff,0,0,0,0
1746610812164,EDS 25,A09,888240,Staff,0,0,0,0
1746610812164,EDS 25,A10,888244,Staff,0,0,0,0
1746610812164,EDS 25,B01,888273,Staff,0,0,0,0
1746610812164,EDS 25,B02,888285,Staff,0,0,0,0
1746610812164,EDS 25,B03,888423,Staff,0,0,0,1
1746610812164,EDS 25,B04,888432,Staff,0,0,0,0
1746610812164,EDS 25,B05,888433,Staff,0,0,0,0
1746610812164,EDS 25,B06,888467,Staff,0,0,0,0
1746610812164,EDS 25,B07,888468,Staff,0,0,0,0
1746610812164,EDS 25,B08,888479,Staff,0,0,0,0
1746610812164,EDS 25,B09,888484,Staff,0,0,0,0
1746610812164,EDS 25,B10,888487,Staff,0,0,0,0
1746610813217,EDS 38,A01,907700,Choi; Bailey Miyeon,30,0,30,0
1746610814243,EDS 112,A01,888601,Chapman; Thandeka K,12,0,40,28
1746610815272,EDS 115,A00,888697,Mendez; Kathrina Mendoza,10,0,30,20
1746610816299,EDS 116,A01,888893,Staff,33,0,40,7
1746610818357,EDS 124AR,A00,889133,Staff,29,0,50,21
1746610818357,EDS 124AR,B00,907471,Simon; Elizabeth A,37,0,50,13
1746610819380,EDS 124BR,A00,889134,Simon; Elizabeth A,44,0,100,56
1746610820409,EDS 125,A00,889135,Staff,25,0,30,5
1746610821437,EDS 126,A01,889138,Staff,35,0,40,5
1746610822464,EDS 164R,A01,889142,Wishard Guerra; Alison G.,32,0,50,18
1746610823490,ENG 30,A01,886396,Staff,0,0,0,0
1746610823490,ENG 30,B01,886398,Staff,0,0,0,0
1746610824516,ENVR 102,A00,906150,Montejo; Carolina,23,0,25,2
1746610825540,ETHN 103A,A00,887236,Man; Simeon S,0,2,0,0
1746610826566,ETHN 113,A00,887239,Staff,16,0,30,14
1746610827594,ETHN 116,A00,887240,Staff,16,0,25,9
1746610828620,ETHN 117,A00,887241,Choi; Esther Min,28,0,30,2
1746610829646,ETHN 118,A00,887243,Staff,24,0,30,6
1746610830672,ETHN 127,A00,887248,Cuong; Marisol,11,0,15,4
1746610831697,ETHN 139,A00,887250,Staff,7,0,10,3
1746610832725,ETHN 142,A00,887252,Staff,9,0,30,21
1746610833755,ETHN 161,A00,887253,Browne; Errol Tsekani,24,0,30,6
1746610834782,ETHN 163FR,A00,887255,Burelle; Julie Sara Veronique,0,0,5,5
1746610835809,GLBH 20,A00,889149,Elwardani; Nile Regina,8,0,42,34
1746610837861,GLBH 111,A01,889152,Burgos; Jose L.,17,0,17,0
1746610838888,GLBH 150,A00,889181,Sloane; Julia Kathryn,0,5,15,15
1746610840938,HDS 60,A01,886406,Warstadt; Melissa Fawn,72,0,80,8
1746610841967,HIAF 111,A00,889324,Gyamfi; Bright,25,0,32,7
1746610842993,HIEA 131,A00,889328,Staff,15,0,32,17
1746610844025,HIEA 144,A00,889333,Henry; Todd A.,26,0,32,6
1746610845051,HIEA 154,A00,889336,Henry; Todd A.,24,0,32,8
1746610846080,HIEU 106,A00,889339,Staff,22,0,32,10
1746610848133,HIEU 114,A00,889340,Staff,4,0,32,28
1746610849162,HIEU 135GS,A00,889342,Patterson; Patrick H.,0,0,1,24
1746610850189,HIEU 137,A00,889343,Edington; Claire Ellen,10,0,25,15
1746610851215,HIEU 148,A00,889345,Staff,14,0,32,18
1746610852243,HIEU 154,A00,889346,Biess; Frank Peter,21,0,32,11
1746610853281,HILA 102,A00,889351,Staff,12,0,32,20
1746610854307,HILD 2A,A01,889221,Lewandoski; Julia Mavis,0,8,32,32
1746610855333,HILD 7B,A01,889225,Man; Simeon S,0,12,32,32
1746610856363,HILD 7C,A01,889288,Alvarez; Luis A,0,14,32,32
1746610857393,HILD 30,A01,889323,Staff,0,5,32,32
1746610859448,HISC 119,A00,889383,Golan; Tal,20,0,32,12
1746610860475,HIUS 103,A00,889384,Man; Simeon S,0,0,32,32
1746610861500,HIUS 117,A00,919797,Kwak; Nancy,18,0,32,14
1746610862529,HIUS 142A,A00,919788,Staff,22,0,32,10
1746610864585,HIUS 149,A00,889386,Gyamfi; Bright,26,0,32,6
1746610865612,HIUS 155,A00,889387,Alvarez; Luis A,15,0,32,17
1746610866644,HUM 3,A01,886499,Caldwell; Michael Alan,19,0,50,31
1746610867672,HUM 3GS,A00,886500,Rodriguez; Bretton Sigfred,0,0,0,28
1746610868699,HUM 3R,A01,886502,Markman; Kristina,0,36,50,50
1746610869726,HUM 4,A01,886504,Crum; Matthew Stephen,23,0,50,27
1746610869726,HUM 4,B01,886506,West; Geoffrey Scott,17,0,50,33
1746610870753,HUM 4GS,A00,886507,Staff,0,0,0,19
1746610871779,HUM 5,A01,886509,Staff,31,0,50,19
1746610872805,HUM 5R,A01,886511,Zavodny; Tatiana Sophia,0,39,50,50
1746610873836,JAPN 180,A00,886407,Staff,16,0,40,24
1746610874863,LATI 50,A01,886409,Martin-Cabrera; Luis,3,0,22,19
1746610874863,LATI 50,A02,886410,Martin-Cabrera; Luis,19,0,22,3
1746610874863,LATI 50,A03,886411,Martin-Cabrera; Luis,21,0,22,1
1746610874863,LATI 50,A04,886412,Martin-Cabrera; Luis,8,0,22,14
1746610875887,LAWS 101,A00,907664,Staff,28,0,60,32
1746610876915,LIAB 1A,A00,889388,Saab; Dima,17,0,20,3
1746610877947,LIAB 1AX,A00,889389,El Cheddadi; Youniss,18,0,20,2
1746610878972,LIFR 1C,A00,889391,Van Moer; Vinciane G,8,0,20,12
1746610879998,LIFR 1CX,A00,889392,Van Moer; Vinciane G,7,0,20,13
1746610881029,LIFR 1D,A00,889393,Van Moer; Vinciane G,7,0,20,13
1746610882058,LIFR 1DX,A00,889394,Van Moer; Vinciane G,8,0,20,12
1746610883086,LIGN 7,A00,886923,Staff,25,0,50,25
1746610884114,LIGN 17,A00,886924,Kehler; Andrew Scott,126,0,150,24
1746610885143,LTAM 110,A00,889395,Staff,15,0,30,15
1746610886170,LTAM 110GS,A00,958010,Rodriguez; Bretton Sigfred,0,0,0,28
1746610887197,LTCH 101,A00,889397,Staff,23,0,25,2
1746610888226,LTCS 130,A00,889398,Staff,23,0,25,2
1746610889253,LTEA 138,A00,889399,Staff,24,0,40,16
1746610890277,LTEN 149,A00,889400,Wesling; Megan E.,0,3,25,25
1746610891304,LTEN 169,A00,889401,Staff,20,0,25,5
1746610892331,LTEN 180,A00,889402,Staff,10,0,15,5
1746610893357,LTEN 181,A00,889403,Staff,21,0,25,4
1746610894385,LTWL 100,A00,889404,Myerston Santana; Jacobo,2,0,25,23
1746610895411,LTWL 180GS,A00,889405,Staff,0,0,20,20
1746610896437,LTWL 181,A00,889406,Staff,16,0,25,9
1746610897467,LTWL 184,A00,889475,Mukherjee; Silpa,22,0,25,3
1746610898495,LTWR 102C,A00,889486,Staff,29,0,30,1
1746610899524,LTWR 115W,A00,889491,Staff,0,2,15,15
1746610900551,MAE 8,A01,886905,Staff,0,2,0,0
1746610901577,MAE 11,A00,886906,Bandaru; Prabhakar,0,7,50,50
1746610902604,MAE 20,A00,886907,Evdokimenko; Ekaterina,43,0,70,27
1746610903630,MAE 30B,A00,886909,Ghazinejad; Maziar,25,0,45,20
1746610904656,MAE 101B,A00,886910,Saintillan; David,30,0,45,15
1746610905681,MAE 105,A00,886911,Bandaru; Prabhakar,18,0,50,32
1746610906707,MAE 107,B00,958024,Staff,7,0,50,43
1746610907732,MAE 143B,A00,886913,Bewley; Thomas R,2,0,40,38
1746610908759,MAE 148,A01,886915,Silberman; Jack,0,3,14,14
1746610909790,MAE 160,A00,886916,Evdokimenko; Ekaterina,30,0,60,30
1746610910820,MATH 3C,A01,889681,Staff,0,2,30,30
1746610910820,MATH 3C,A02,960048,Staff,23,0,30,7
1746610911846,MATH 10A,A01,889760,Staff,26,0,30,4
1746610911846,MATH 10A,A02,889783,Staff,29,0,30,1
1746610912873,MATH 10B,A01,889785,Verstraete; Jacques Allan,1,0,35,34
1746610912873,MATH 10B,A02,889795,Verstraete; Jacques Allan,4,0,35,31
1746610912873,MATH 10B,B01,889797,Verstraete; Jacques Allan,3,0,35,32
1746610912873,MATH 10B,B02,889828,Verstraete; Jacques Allan,3,0,35,32
1746610913905,MATH 10C,A01,889849,Habib; Yousaf,8,0,30,22
1746610913905,MATH 10C,A02,889852,Habib; Yousaf,14,0,30,16
1746610913905,MATH 10C,A03,889853,Habib; Yousaf,22,0,30,8
1746610913905,MATH 10C,A04,889858,Habib; Yousaf,20,0,30,10
1746610913905,MATH 10C,B01,889861,Staff,1,0,30,29
1746610913905,MATH 10C,B02,889862,Staff,24,0,30,6
1746610913905,MATH 10C,B03,889863,Staff,27,0,30,3
1746610913905,MATH 10C,B04,889967,Staff,23,0,30,7
1746610914933,MATH 18,A01,889974,Staff,6,0,30,24
1746610914933,MATH 18,A02,889977,Staff,20,0,30,10
1746610914933,MATH 18,B01,889984,Hardiman; Liam,20,0,30,10
1746610914933,MATH 18,B02,889985,Hardiman; Liam,25,0,30,5
1746610915959,MATH 20A,A01,889990,Suk; Andrew Hoon,30,0,35,5
1746610916995,MATH 20B,A01,889993,Ohm; Ko Woon,21,0,30,9
1746610916995,MATH 20B,A02,889994,Ohm; Ko Woon,30,0,30,0
1746610916995,MATH 20B,B01,889996,Ohm; Ko Woon,22,0,30,8
1746610916995,MATH 20B,B02,889997,Ohm; Ko Woon,23,0,30,7
1746610918038,MATH 20C,A01,889999,Hammock; Frances H,17,0,30,13
1746610918038,MATH 20C,A02,890003,Hammock; Frances H,23,0,30,7
1746610918038,MATH 20C,B01,890006,Hammock; Frances H,2,0,30,28
1746610918038,MATH 20C,B02,890007,Hammock; Frances H,11,0,30,19
1746610919070,MATH 20D,A01,890011,Cheng; Hsiao-Bing,1,0,30,29
1746610919070,MATH 20D,A02,890012,Cheng; Hsiao-Bing,14,0,30,16
1746610919070,MATH 20D,B01,890016,Cheng; Hsiao-Bing,13,0,30,17
1746610919070,MATH 20D,B02,890017,Cheng; Hsiao-Bing,13,0,30,17
1746610920097,MATH 20E,A01,890026,Harel; Guershon,1,0,30,29
1746610920097,MATH 20E,A02,890029,Harel; Guershon,22,0,30,8
1746610920097,MATH 20E,B01,890033,Harel; Guershon,7,0,30,23
1746610920097,MATH 20E,B02,890101,Harel; Guershon,21,0,30,9
1746610921125,MATH 102,A01,890104,Staff,18,0,30,12
1746610921125,MATH 102,A02,890105,Staff,27,0,30,3
1746610922153,MATH 103B,A01,890116,Salehi Golsefidy; Alireza,3,0,30,27
1746610922153,MATH 103B,B01,890118,Staff,0,3,34,34
1746610923182,MATH 109,A01,890121,Aliabadi Sr.; Mohsen,0,0,30,30
1746610923182,MATH 109,B01,890124,Upadrashta; Pranav Kumar,18,0,30,12
1746610924208,MATH 120A,A01,890126,Eggers; John Dietrich,13,0,30,17
1746610925234,MATH 142B,A01,890128,Ioana; Adrian,19,0,30,11
1746610925234,MATH 142B,A02,890129,Ioana; Adrian,12,0,30,18
1746610926261,MATH 154,A01,890174,Staff,0,1,30,30
1746610926261,MATH 154,A02,890182,Staff,0,0,30,30
1746610927287,MATH 168A,A01,890197,Dumitriu; Ioana,21,0,35,14
1746610928314,MATH 170A,A01,890240,Nie; Jiawang,1,0,30,29
1746610928314,MATH 170A,A02,890241,Nie; Jiawang,11,0,30,19
1746610928314,MATH 170A,A03,890249,Nie; Jiawang,23,0,30,7
1746610929340,MATH 170B,A01,957891,Nag; Panchali,13,0,35,22
1746610931393,MATH 181A,A01,908025,Staff,0,3,35,35
1746610931393,MATH 181A,A02,960115,Staff,26,0,35,9
1746610932419,MATH 181B,A01,959874,Staff,24,0,30,6
1746610933443,MATH 193B,A01,890265,Staff,0,4,35,35
1746610934468,MGT 4,A01,890311,Anderson; John Charles,42,0,88,46
1746610935497,MGT 5,A00,907740,Staff,12,0,98,86
1746610936523,MGT 12,A00,890312,Lindenberger; Wade Douglas,67,0,98,31
1746610937549,MGT 16,A00,957883,Staff,78,0,98,20
1746610939606,MGT 45,A00,890314,Pecore; Joseph P.,45,0,98,53
1746610940632,MGT 71,A00,890315,Staff,0,12,98,98
1746610941657,MGT 100,A00,890316,Yavorsky; Daniel Ryan,44,0,98,54
1746610942684,MGT 103,A00,890317,Ehrich; Kristine R,73,0,98,25
1746610943715,MGT 105,A00,890356,Bates; Kenneth Walter,0,8,98,98
1746610944740,MGT 112,A00,890360,Ehrich; Kristine R,55,0,98,43
1746610945769,MGT 127R,A00,907732,Zhu; Kevin Xiaoguo,23,0,98,75
1746610946795,MGT 131B,A00,890361,Anderson; John Charles,59,0,98,39
1746610947824,MGT 137,A00,890362,Lindenberger; Wade Douglas,65,0,98,33
1746610948851,MGT 160,A00,890369,Johnson; Erik Barry,9,0,98,89
1746610950903,MGT 164,A00,890372,Zimmermann; Carsten,0,40,98,98
1746610951929,MGT 180,A00,890374,Bliss; Barbara Ann,11,0,98,87
1746610952957,MMW 15,A01,886414,Chang; Edmond Yi-Teh,0,12,28,28
1746610952957,MMW 15,A02,886415,Chang; Edmond Yi-Teh,0,8,28,28
1746610952957,MMW 15,A03,886416,Chang; Edmond Yi-Teh,0,9,28,28
1746610952957,MMW 15,A04,886417,Chang; Edmond Yi-Teh,0,8,28,28
1746610952957,MMW 15,B01,886419,Chang; Edmond Yi-Teh,0,7,28,28
1746610952957,MMW 15,B02,886420,Chang; Edmond Yi-Teh,0,7,28,28
1746610952957,MMW 15,B03,886421,Chang; Edmond Yi-Teh,0,7,28,28
1746610952957,MMW 15,B04,886422,Chang; Edmond Yi-Teh,0,8,28,28
1746610952957,MMW 15,C01,886424,Staff,0,9,28,28
1746610952957,MMW 15,C02,886425,Staff,0,8,28,28
1746610952957,MMW 15,C03,886426,Staff,0,8,28,28
1746610952957,MMW 15,C04,886427,Staff,0,8,28,28
1746610952957,MMW 15,C05,958038,Staff,0,8,28,28
1746610952957,MMW 15,C06,958039,Staff,0,7,28,28
1746610953984,MMW 15GS,A00,906910,Patterson; Patrick H.,4,0,28,24
1746610955011,MMW 122R,A01,886429,Rahimi; Babak,0,13,28,28
1746610955011,MMW 122R,A02,886430,Rahimi; Babak,0,12,28,28
1746610955011,MMW 122R,A03,958040,Rahimi; Babak,0,11,28,28
1746610956041,MUS 1A,A01,890937,Staff,2,0,25,23
1746610956041,MUS 1A,A02,891035,Staff,6,0,25,19
1746610956041,MUS 1A,C01,958912,Staff,24,0,25,1
1746610956041,MUS 1A,C02,958913,Staff,25,0,25,0
1746610958097,MUS 2AK,A00,957092,Ohnishi; Takae,15,0,15,0
1746610959131,MUS 4,A01,891044,Staff,0,0,25,25
1746610959131,MUS 4,A02,891045,Staff,22,0,25,3
1746610959131,MUS 4,B01,891048,Staff,17,0,25,8
1746610959131,MUS 4,B02,891050,Staff,25,0,25,0
1746610960158,MUS 5,A01,957506,Dubnov; Shlomo,0,0,25,25
1746610960158,MUS 5,A02,957622,Dubnov; Shlomo,12,0,25,13
1746610960158,MUS 5,A03,957623,Dubnov; Shlomo,20,0,25,5
1746610961184,MUS 6,A01,891053,Freitas Caetano; Marcelo,24,0,25,1
1746610961184,MUS 6,A02,891054,Freitas Caetano; Marcelo,23,0,25,2
1746610962212,MUS 7,A01,891081,Staff,0,0,25,25
1746610962212,MUS 7,A02,891082,Staff,3,0,25,22
1746610963239,MUS 8GS,A00,891118,Borgo; David Garcia,1,0,25,24
1746610964264,MUS 11,A01,891140,Staff,8,0,25,17
1746610964264,MUS 11,A02,891141,Staff,21,0,25,4
1746610965296,MUS 13,A01,891143,Staff,8,0,25,17
1746610965296,MUS 13,A02,891144,Staff,24,0,25,1
1746610966328,MUS 15,A01,891146,Staff,9,0,25,16
1746610966328,MUS 15,A02,891148,Staff,21,0,25,4
1746610966328,MUS 15,B01,891150,Staff,18,0,25,7
1746610966328,MUS 15,B02,891151,Staff,25,0,25,0
1746610967360,MUS 20,A01,891153,Staff,5,0,20,15
1746610967360,MUS 20,A02,891155,Staff,14,0,20,6
1746610968386,MUS 80,A00,891156,Staff,19,0,25,6
1746610968386,MUS 80,B00,891157,Staff,23,0,25,2
1746610969412,MUS 130,A00,891158,Ohnishi; Takae,35,0,35,0
1746610970439,MUS 150GS,A01,891160,Borgo; David Garcia,1,0,25,24
1746610971466,MUS 170,A01,891162,Freitas Caetano; Marcelo,20,0,25,5
1746610971466,MUS 170,A02,891164,Freitas Caetano; Marcelo,21,0,25,4
1746610972491,NANO 11,A00,886220,Vazquez Mena; Oscar,13,0,15,2
1746610973517,NANO 15,A01,886222,Drews; Aaron,4,0,7,3
1746610974546,NANO 104,A00,886224,Sirbuly; Donald,17,0,25,8
1746610975571,PH 40,A00,886528,Staff,23,0,40,17
1746610976598,PH 45,A01,886799,Staff,35,0,40,5
1746610977625,PH 110,A00,886802,Staff,0,6,40,40
1746610978654,PH 172,A00,906716,Staff,19,0,35,16
1746610979686,PH 191,A00,886803,Staff,6,0,40,34
1746610980713,PHIL 1,A00,889500,Staff,20,0,30,10
1746610981744,PHIL 10,A01,889549,Grush; Rick Scott,16,0,22,6
1746610981744,PHIL 10,A02,889551,Grush; Rick Scott,22,0,22,0
1746610982776,PHIL 28,A01,889559,Lamey; Andy M.,0,2,31,31
1746610982776,PHIL 28,A02,889561,Lamey; Andy M.,0,1,30,30
1746610982776,PHIL 28,A03,889572,Lamey; Andy M.,0,1,30,30
1746610983800,PHIL 35,A00,907839,Staff,13,0,15,2
1746610984828,PHIL 60,A00,889574,Staff,73,0,90,17
1746610985855,PHIL 101,A00,958004,Staff,12,0,15,3
1746610987911,PHIL 136,A00,889582,Fulkerson; Matthew Todd,26,0,45,19
1746610988937,PHIL 163,A01,889601,Staff,21,0,30,9
1746610988937,PHIL 163,B01,889606,Brandt; Reuven A,0,3,0,0
1746610989964,PHIL 164,A00,889610,Staff,16,0,30,14
1746610990989,PHIL 165,A00,889613,Staff,22,0,30,8
1746610992015,PHYS 1A,A00,886431,Staff,30,0,70,40
1746610993044,PHYS 1AL,001,886432,Tsai; Philbert S,0,1,30,30
1746610993044,PHYS 1AL,002,886436,Tsai; Philbert S,13,0,30,17
1746610994070,PHYS 1B,A00,886439,Staff,184,0,240,56
1746610995094,PHYS 1BL,001,886441,Tsai; Philbert S,0,4,30,30
1746610995094,PHYS 1BL,002,886444,Tsai; Philbert S,2,0,30,28
1746610996120,PHYS 1C,A00,896092,Arnold; Kam S,78,0,146,68
1746610997147,PHYS 1CL,001,886448,Tsai; Philbert S,0,0,30,30
1746610997147,PHYS 1CL,002,886449,Tsai; Philbert S,1,0,30,29
1746610997147,PHYS 1CL,003,886450,Tsai; Philbert S,16,0,30,14
1746610997147,PHYS 1CL,004,886451,Tsai; Philbert S,15,0,30,15
1746611008933,PHYS 2B,A01,886457,Staff,67,0,115,48
1746611009957,PHYS 2C,A01,886460,Shotwell; Brian,0,9,65,65
1746611010988,PHYS 2CL,A01,886467,Staff,0,4,28,28
1746611010988,PHYS 2CL,A02,886468,Staff,0,3,28,28
1746611012013,PHYS 2D,A01,886470,Staff,10,0,50,40
1746611013039,PHYS 4B,A01,886475,Grinstein; Benjamin,22,0,40,18
1746611014064,POLI 5,A00,891173,Desposato; Scott,7,0,25,18
1746611015092,POLI 5D,A01,891175,Staff,5,0,5,0
1746611015092,POLI 5D,B01,891178,Staff,5,0,5,0
1746611016125,POLI 11,A00,891179,Ferree; Karen E,0,0,35,35
1746611017152,POLI 12,A00,891180,Staff,15,0,30,15
1746611018181,POLI 27,A01,891182,Staff,11,0,75,64
1746611019208,POLI 30,A00,891183,Staff,8,0,50,42
1746611020235,POLI 100B,A00,891244,Staff,5,1,35,30
1746611021264,POLI 100I,A00,891247,Staff,7,0,30,23
1746611022291,POLI 104J,A00,891248,Nichter; Maysa,14,0,30,16
1746611023318,POLI 104U,A00,891250,Nichter; Maysa,1,0,30,29
1746611025379,POLI 110B,A00,891255,Wiens; David,19,0,25,6
1746611026405,POLI 112A,A00,891256,Wiens; David,6,0,25,19
1746611027433,POLI 114BR,A00,891261,Staff,19,0,30,11
1746611028459,POLI 117R,A00,891262,Forman; Fonna,0,6,50,50
1746611029489,POLI 118,A00,891264,Ingham; Sean,17,0,25,8
1746611030515,POLI 124A,A00,891265,Staff,18,0,20,2
1746611031544,POLI 125D,A00,891266,Nichter; Simeon C,2,0,25,23
1746611032572,POLI 126,A00,891268,Nichter; Simeon C,7,0,25,18
1746611033597,POLI 126AA,A00,891272,Staff,15,0,25,10
1746611034626,POLI 130AA,A00,891273,Staff,15,0,20,5
1746611035654,POLI 134AA,A00,891274,Staff,4,0,20,16
1746611037704,POLI 138,A00,891278,Staff,21,0,25,4
1746611038729,POLI 142K,A00,891280,Staff,10,0,25,15
1746611039754,POLI 142M,A00,891281,Gartzke; Erik,16,0,30,14
1746611040778,POLI 142P,A00,891284,Staff,20,0,30,10
1746611041802,POLI 143,A00,891285,Gartzke; Erik,12,0,30,18
1746611042828,POLI 153,A00,891286,Staff,19,0,20,1
1746611044883,POLI 175,A00,891290,Staff,15,0,20,5
1746611045913,PSYC 1,A00,890674,Steiner; Eric Tomas,0,11,45,45
1746611046941,PSYC 2,A00,890676,Albright; Thomas D,20,0,35,15
1746611047964,PSYC 3,A00,890679,Staff,17,0,20,3
1746611048989,PSYC 6,A00,959858,Staff,19,0,20,1
1746611050020,PSYC 60,A01,890684,Rickard; Timothy C.,0,6,45,45
1746611051043,PSYC 70,A01,890689,Geller; Emma Harlan,6,0,30,24
1746611052068,PSYC 71,A01,959860,Staff,21,0,25,4
1746611053093,PSYC 100,A00,890690,Lacefield; Katharine I,0,50,180,180
1746611054122,PSYC 102,A00,890695,Staff,18,0,40,22
1746611055146,PSYC 105,A00,890699,Geller; Emma Harlan,70,0,100,30
1746611056172,PSYC 106,A00,890701,Gorman; Michael R.,5,0,30,25
1746611057196,PSYC 108,A00,890704,Adrian; Julia Anna,0,29,50,50
1746611058225,PSYC 118,A01,890712,Staff,11,0,30,19
1746611059249,PSYC 124,A00,890716,Chapman; Eddie Nathaniel,25,0,60,35
1746611060276,PSYC 131,A00,890717,Anagnostaras; Stephan,0,7,80,80
1746611061306,PSYC 137,A00,890719,Winkielman; Piotr,0,11,30,30
1746611062331,PSYC 144,A00,890721,Adrian; Julia Anna,0,9,45,45
1746611063358,PSYC 162,A00,890805,Staff,0,2,75,75
1746611064386,PSYC 169,A00,890810,Staff,0,15,30,30
1746611065410,PSYC 172,A00,890814,Gorman; Michael R.,9,0,30,21
1746611066434,PSYC 181,A00,890818,Anagnostaras; Stephan,6,0,200,194
1746611067460,PSYC 184,A00,959861,Staff,160,0,175,15
1746611068486,PSYC 189,A00,890823,Staff,0,2,30,30
1746611069513,PSYC 191,A00,890884,Rickard; Timothy C.,0,12,35,35
1746611070543,PSYC 193,A00,890913,Staff,19,0,30,11
1746611070543,PSYC 193,B00,890914,Chapman; Eddie Nathaniel,24,0,30,6
1746611071571,PSYC 193L,A01,890918,Lowe; Angela Beth,20,0,30,10
1746611071571,PSYC 193L,B01,890921,Hurwitz; Ethan Scott,20,0,30,10
1746611071571,PSYC 193L,C01,890928,Staff,30,0,30,0
1746611072597,RELI 149,A00,886806,Rahimi; Babak,23,0,40,17
1746611073627,SE 9,A01,886814,Staff,7,0,20,13
1746611074656,SE 101B,A01,886816,Chadha; Mayank,3,0,35,32
1746611075681,SE 110B,A00,886818,Zhu; Qiang,4,0,75,71
1746611076708,SE 125,A01,886830,Staff,10,0,30,20
1746611077737,SE 130B,A01,886835,Staff,14,0,40,26
1746611078766,SE 131A,A01,886838,Krysl; Petr,34,0,55,21
1746611079792,SE 154,A00,886840,Staff,28,0,50,22
1746611080818,SE 164GS,A01,886849,Staff,6,0,20,14
1746611081847,SE 167GS,A01,886853,Staff,6,0,20,14
1746611082872,SIO 25,A01,890107,Staff,19,0,30,11
1746611083902,SIO 45,A00,890109,Cook; Geoffrey W,114,0,200,86
1746611084931,SIO 109R,A00,890110,Forman; Fonna,0,16,20,20
1746611085957,SIO 187,A01,890114,Kacev; David,15,0,40,25
1746611086987,SOCI 1,A01,890431,Thorpe; Charles Robert,14,0,30,16
1746611086987,SOCI 1,A02,890518,Thorpe; Charles Robert,30,0,30,0
1746611088016,SOCI 2,A01,957978,Staff,25,0,25,0
1746611088016,SOCI 2,A02,957979,Staff,23,0,25,2
1746611089046,SOCI 20,A01,890523,Calderon-Zaks; Michael Aar,21,0,30,9
1746611089046,SOCI 20,A02,890526,Calderon-Zaks; Michael Aar,29,0,30,1
1746611090073,SOCI 30,A01,890533,Pardo Guerra; Juan Pablo,37,0,40,3
1746611091104,SOCI 40,A01,890535,Staff,27,0,45,18
1746611092129,SOCI 104Q,A00,890559,Staff,17,0,30,13
1746611093158,SOCI 106,A00,890560,Arnal; Maud Marie Leonie,20,0,30,10
1746611094185,SOCI 110,A00,890567,Holkenbrink-Monk; Charlene,19,0,30,11
1746611095215,SOCI 112,A00,890568,Victoria Torres; Pablo,2,0,55,53
1746611096240,SOCI 115,A00,890597,Arnal; Maud Marie Leonie,28,0,45,17
1746611098297,SOCI 121,A00,890604,Pardo Guerra; Juan Pablo,38,0,45,7
1746611099324,SOCI 126,A01,890608,Staff,8,0,10,2
1746611100353,SOCI 127,A00,890609,Staff,18,0,30,12
1746611101378,SOCI 131,A00,890610,Thorpe; Charles Robert,37,0,45,8
1746611102422,SOCI 135,A00,890615,Payne; Christine Anna,14,0,45,31
1746611103449,SOCI 139,A00,890620,Staff,38,0,45,7
1746611104476,SOCI 148E,A00,890622,Calderon-Zaks; Michael Aar,36,0,45,9
1746611105504,SOCI 150,A00,890623,Kohler; Kristopher M.,31,0,45,14
1746611106534,SOCI 157,A00,890625,Jules-Rosette; Bennetta W.,18,0,20,2
1746611107562,SOCI 160,A00,890627,Payne; Christine Anna,21,0,45,24
1746611108590,SYN 1,A00,886855,Fish; Gwendolyn Anne,0,1,0,0
1746611108590,SYN 1,B00,906086,Fish; Gwendolyn Anne,0,2,0,2
1746611109621,SYN 2R,A00,886860,Staff,0,17,15,15
1746611109621,SYN 2R,B00,906106,Atkinson; Arthur Laird,0,16,15,15
1746611110649,SYN 100,A01,886866,Browne; Emily,0,28,20,20
1746611110649,SYN 100,B01,906128,Rock; Martin,0,4,20,20
1746611110649,SYN 100,C01,906140,Deavenport; James Cary,0,4,20,20
1746611110649,SYN 100,D01,907816,Deavenport; James Cary,0,5,20,20
1746611111674,TDAC 1,A00,890286,Walsh; Kim C.,7,0,20,13
1746611112701,TDAC 101,A00,890296,Basso; Beatrice,15,0,20,5
1746611113727,TDDE 131,A00,890297,Staff,47,0,50,3
1746611114756,TDDM 1,A00,890287,Weinberg; Sadie,25,0,30,5
1746611115782,TDGE 11,A00,890288,Fulton; Julia,138,0,200,62
1746611115782,TDGE 11,B00,890289,Castro; Robert Jess,184,0,200,16
1746611116813,TDGE 25,B00,957359,Walsh; Kim C.,5,0,20,15
1746611117837,TDGE 40,A01,890292,Power; Jade Yukana,26,0,30,4
1746611118865,TDGE 124,A00,890298,Havis; Allan,0,2,50,50
1746611119895,TDGE 131R,A00,890299,Burelle; Julie Sara Veronique,15,0,42,27
1746611120924,TDHT 101,A00,890300,Staff,10,0,20,10
1746611121949,TDHT 109,A01,890302,Anderson; Mysia Anyse,31,0,40,9
1746611122980,TDMV 1,A00,890293,Arcidiacono; Kristin,18,0,30,12
1746611124007,TDMV 2,A00,890294,Weinberg; Sadie,23,0,30,7
1746611125036,TDMV 3,A00,957878,Arcidiacono; Kristin,28,0,30,2
1746611127091,TDMV 138,A00,890304,Jun; Grace Shin Hae,25,0,40,15
1746611128117,TDMV 140,A00,890305,Corrales; Joseph Bernales,25,0,30,5
1746611129156,TDMV 142,A00,890307,Caligagan; Tony,32,0,40,8
1746611130180,TDMV 144,A00,890308,Camaya; Michelle Ann,25,0,30,5
1746611131204,TDPW 1,A00,890295,Stein; Deborah Isobel,3,0,20,17
1746611132232,USP 2,A01,890272,Lerner; Amy M,7,0,20,13
1746611133258,USP 3,A01,890274,Staff,12,0,30,18
1746611134283,USP 15,A01,890276,Sun; Feiyang,16,0,30,14
1746611135311,USP 25,A00,890277,Shenkman; Michael Thomas,18,0,25,7
1746611136340,USP 138,A00,890278,Staff,13,0,25,12
1746611137366,USP 143,A00,890279,Staff,21,0,70,49
1746611138393,USP 144,A00,890280,Chowdhury; Muhammed Zohir,16,0,30,14
1746611139420,USP 150,A00,890281,Boomhower; Matthew Charles,4,0,30,26
1746611140449,USP 151,A00,890282,Staff,16,0,20,4
1746611141479,USP 162,A00,890283,Andrews; Abigail Leslie,16,0,20,4
1746611142504,USP 168,A00,920477,Kwak; Nancy,0,0,5,5
1746611143531,USP 181,A00,890284,Staff,3,0,20,17
1746611144559,USP 191A,A00,890285,Staff,12,0,20,8
1746611145586,VIS 101,A00,886512,Staff,26,0,75,49
1746611146616,VIS 103,A00,886513,Cruz; Edwin Teddy,61,0,75,14
1746611147643,VIS 108,A00,886514,Staff,4,0,15,11
1746611148670,VIS 127P,A00,886515,Shen; Kuiyi,80,0,146,66
1746611149700,VIS 149,A00,886516,Yoldas; Pinar,0,0,15,15
1746611150725,VIS 164,A00,886526,Erdmann; Dean,19,0,22,3
1746611151752,VIS 194S,A00,886527,Staff,61,0,75,14
1746611152778,WCWP 10A,C00,886484,Martiniuk; Jill,12,0,15,3
1746611153805,WCWP 10B,A00,886490,Uriarte; Emma,0,0,15,15
1746611153805,WCWP 10B,B00,886491,Dhir; Simrita,8,0,15,7
1746611153805,WCWP 10B,C00,886492,Ornelas; Tricia,0,0,15,15
1746611154834,WCWP 100,A00,886494,Young; Mark T,0,6,15,15
1746611156910,AAS 10,A01,886199,Childs; Dennis R.,0,3,0,0
1746611157939,ANAR 104,A01,886940,Shtienberg; Gilad,27,0,30,3
1746611158964,ANAR 120,A00,886953,Staff,13,0,20,7
1746611159993,ANBI 148,A01,886955,Wilder; Linnea Lorene,30,0,40,10
1746611162048,ANSC 122,A00,886957,Staff,24,0,30,6
1746611163078,ANSC 150,A00,886958,Sloane; Julia Kathryn,2,0,15,13
1746611164104,ANSC 156,A00,886959,Jenkins; Janis A.,0,1,15,15
1746611165128,ANSC 180,A00,886960,Staff,11,0,17,6
1746611166154,ANSC 188,A00,886961,Jassal; Aftab,9,0,25,16
1746611167179,ANSC 190,A00,886962,Jassal; Aftab,14,0,25,11
1746611168207,ANSC 191,A00,886963,Staff,18,0,20,2
1746611169231,ANTH 3,A01,891689,Staff,17,0,20,3
1746611170257,ANTH 5,A00,886933,Semendeferi; Ekaterini,16,0,20,4
1746611171282,ANTH 10,A00,886934,Staff,0,12,30,30
1746611172307,ANTH 21,A01,886936,Staff,41,0,60,19
1746611173332,ANTH 23,A01,886938,Staff,92,0,100,8
1746611174358,ANTH 105,A00,886964,Stewart; Alexander B,84,0,100,16
1746611175385,ANTH 108,A00,886965,Pedersen; David,9,0,20,11
1746611176412,AWP 10,001,886147,Staff,0,0,0,0
1746611176412,AWP 10,002,886148,Staff,0,0,0,0
1746611176412,AWP 10,003,886149,Staff,0,0,0,0
1746611176412,AWP 10,004,886150,Staff,0,0,0,0
1746611176412,AWP 10,005,886151,Staff,0,0,0,0
1746611176412,AWP 10,006,886152,Staff,0,0,0,0
1746611176412,AWP 10,007,886153,Staff,0,0,0,0
1746611176412,AWP 10,008,886154,Staff,0,0,0,0
1746611176412,AWP 10,009,886155,Staff,0,0,0,0
1746611176412,AWP 10,010,886156,Staff,0,0,0,0
1746611176412,AWP 10,011,886158,Staff,0,0,0,0
1746611176412,AWP 10,012,886160,Staff,0,0,0,0
1746611176412,AWP 10,013,886161,Staff,0,0,0,0
1746611176412,AWP 10,014,886162,Staff,0,0,0,0
1746611176412,AWP 10,015,886163,Staff,0,0,0,0
1746611176412,AWP 10,016,886164,Staff,0,0,0,0
1746611176412,AWP 10,017,886165,Staff,0,0,0,0
1746611176412,AWP 10,018,886166,Staff,0,0,0,0
1746611176412,AWP 10,019,886168,Staff,0,0,0,0
1746611176412,AWP 10,020,886170,Staff,0,0,0,0
1746611176412,AWP 10,021,886172,Staff,0,0,0,0
1746611177442,AWP 10R,001,886173,Staff,0,1,0,0
1746611177442,AWP 10R,002,886174,Staff,0,1,0,0
1746611177442,AWP 10R,003,886175,Staff,0,0,0,0
1746611177442,AWP 10R,004,886176,Staff,0,0,0,0
1746611177442,AWP 10R,005,886177,Staff,0,0,0,0
1746611177442,AWP 10R,006,886178,Staff,0,0,0,0
1746611177442,AWP 10R,007,886179,Staff,0,0,0,0
1746611177442,AWP 10R,008,886181,Staff,0,0,0,0
1746611177442,AWP 10R,009,886182,Staff,0,0,0,0
1746611177442,AWP 10R,010,886183,Staff,0,0,0,0
1746611177442,AWP 10R,011,886184,Staff,0,0,0,0
1746611177442,AWP 10R,012,886185,Staff,0,0,0,0
1746611177442,AWP 10R,013,886186,Staff,0,0,0,0
1746611177442,AWP 10R,014,886187,Staff,0,0,0,0
1746611177442,AWP 10R,015,886188,Staff,0,0,0,0
1746611177442,AWP 10R,016,886189,Staff,0,0,0,0
1746611177442,AWP 10R,017,960532,Staff,0,0,0,0
1746611177442,AWP 10R,018,960533,Staff,0,0,0,0
1746611177442,AWP 10R,019,960534,Staff,0,0,0,0
1746611177442,AWP 10R,020,960538,Staff,0,0,0,0
1746611177442,AWP 10R,021,960540,Staff,0,0,0,0
1746611177442,AWP 10R,022,960541,Staff,0,0,0,0
1746611177442,AWP 10R,023,960542,Staff,0,0,0,0
1746611177442,AWP 10R,024,960544,Staff,0,0,0,0
1746611177442,AWP 10R,025,960545,Staff,0,0,0,0
1746611177442,AWP 10R,026,960548,Staff,0,0,0,0
1746611178470,AWP 102R,A00,886190,Staff,0,0,0,0
1746611178470,AWP 102R,B00,886191,Staff,0,0,0,0
1746611179500,BENG 100,A01,886193,Staff,17,0,30,13
1746611180530,BENG 122A,A01,886195,Hasty; Jeff M,13,0,30,17
1746611181559,BENG 166A,A00,886196,Sah; Robert Lie-Yuan,0,3,30,30
1746611182586,BENG 190,A00,958050,Khojah; Reem I,17,0,25,8
1746611183614,BIBC 102,A01,894320,Staff,0,1,46,46
1746611183614,BIBC 102,A02,894321,Staff,0,0,46,46
1746611183614,BIBC 102,A03,894344,Staff,6,0,46,40
1746611183614,BIBC 102,A04,894345,Staff,27,0,47,20
1746611184646,BICD 100R,A01,894365,Smith; Laurie,0,2,58,58
1746611184646,BICD 100R,A02,894366,Smith; Laurie,0,4,58,58
1746611184646,BICD 100R,A03,894367,Smith; Laurie,0,0,59,59
1746611184646,BICD 100R,A04,959869,Smith; Laurie,38,0,59,21
1746611185672,BICD 136,A01,894383,Gustafson-Brown; Cindy,14,0,50,36
1746611186698,BIEB 102,A01,894494,Butler; Shannon Rhey,51,0,130,79
1746611188754,BIEB 150,A01,894617,Wills; Christopher,3,0,20,17
1746611188754,BIEB 150,A02,894631,Wills; Christopher,3,0,20,17
1746611188754,BIEB 150,A03,894937,Wills; Christopher,3,0,20,17
1746611188754,BIEB 150,A04,894946,Wills; Christopher,5,0,20,15
1746611189778,BIEB 194,A00,906141,Kurle; Carolyn M.,5,0,20,15
1746611190806,BILD 1,A01,894154,Staff,3,0,19,16
1746611190806,BILD 1,A02,894155,Staff,14,0,19,5
1746611190806,BILD 1,A03,894160,Staff,13,0,19,6
1746611190806,BILD 1,A04,894161,Staff,15,0,18,3
1746611191834,BILD 2,A01,894168,Staff,0,0,50,50
1746611191834,BILD 2,A02,894169,Staff,0,0,50,50
1746611191834,BILD 2,A03,894179,Staff,0,0,50,50
1746611191834,BILD 2,A04,894203,Staff,22,0,50,28
1746611192860,BILD 3,A01,894213,Staff,23,0,31,8
1746611192860,BILD 3,A02,894214,Staff,26,0,31,5
1746611192860,BILD 3,A03,894235,Staff,28,0,31,3
1746611192860,BILD 3,A04,894236,Staff,28,0,32,4
1746611193890,BILD 4,A01,894253,Reuther; Keefe,5,0,24,19
1746611193890,BILD 4,A02,894258,Reuther; Keefe,16,0,24,8
1746611194921,BILD 5,A01,894276,Reuther; Keefe,33,0,50,17
1746611194921,BILD 5,A02,894277,Reuther; Keefe,45,0,50,5
1746611194921,BILD 5,A03,894290,Reuther; Keefe,44,0,50,6
1746611194921,BILD 5,A04,894291,Reuther; Keefe,48,0,50,2
1746611195948,BILD 24,A01,894297,Pirino; Giorgia,40,0,60,20
1746611196974,BIMM 100,B01,958915,Staff,71,0,100,29
1746611198002,BIMM 101,A01,895017,McDonnell; Lisa Marie,0,5,24,24
1746611198002,BIMM 101,A02,895018,McDonnell; Lisa Marie,0,5,24,24
1746611198002,BIMM 101,B01,895020,McDonnell; Lisa Marie,0,5,24,24
1746611198002,BIMM 101,B02,895021,McDonnell; Lisa Marie,0,4,24,24
1746611199032,BIMM 110,A01,895023,Staff,1,0,25,24
1746611199032,BIMM 110,A02,895024,Staff,9,0,25,16
1746611199032,BIMM 110,A03,895025,Staff,18,0,25,7
1746611199032,BIMM 110,A04,895031,Staff,20,0,25,5
1746611200062,BIMM 120,A01,895114,Gustafson-Brown; Cindy,14,0,28,14
1746611200062,BIMM 120,A02,895126,Gustafson-Brown; Cindy,21,0,27,6
1746611201091,BIPN 100,A01,895130,Yang; Mingyu,0,0,38,38
1746611201091,BIPN 100,A02,895131,Yang; Mingyu,31,0,38,7
1746611201091,BIPN 100,A03,895132,Yang; Mingyu,32,0,38,6
1746611201091,BIPN 100,A04,895133,Yang; Mingyu,27,0,36,9
1746611202120,BIPN 120,A01,895135,Cooke; James Edward,0,3,13,13
1746611202120,BIPN 120,A02,895136,Cooke; James Edward,0,1,13,13
1746611202120,BIPN 120,A03,895137,Cooke; James Edward,0,3,13,13
1746611202120,BIPN 120,A04,895156,Cooke; James Edward,0,2,11,11
1746611203146,BIPN 134,A01,895235,Cooke; James Edward,0,1,25,25
1746611203146,BIPN 134,A02,895237,Cooke; James Edward,0,0,25,25
1746611203146,BIPN 134,A03,895240,Cooke; James Edward,1,0,25,24
1746611203146,BIPN 134,A04,895270,Cooke; James Edward,20,0,25,5
1746611204174,BIPN 189,A00,892103,Staff,0,14,14,14
1746611206229,BISP 194,A00,958008,Staff,0,2,0,0
1746611207256,CAT 124,A01,922009,Staff,0,5,20,20
1746611208288,CAT 125R,A00,886390,Morales; Celeste Georgianna,0,4,20,20
1746611208288,CAT 125R,B00,886391,Irwin; Matthew Joseph,0,4,20,20
1746611208288,CAT 125R,C00,886392,Smith; Lauryn Alissa,0,2,20,20
1746611208288,CAT 125R,D00,886393,Vanderschuit; Maya Alysia,0,3,20,20
1746611208288,CAT 125R,E00,886394,Marchisotto; Jennifer Anne,0,3,20,20
1746611209314,CENG 15,A01,886218,Drews; Aaron,3,0,8,5
1746611210342,CENG 113,A00,886219,Opatkiewicz; Justin Paul,15,0,25,10
1746611211367,CGS 101,A00,887044,Staff,7,0,20,13
1746611212395,CGS 105,A01,887046,Staff,14,0,25,11
1746611213424,CGS 112,A00,887047,Cuong; Marisol,12,0,15,3
1746611214449,CGS 113,A00,887048,Staff,23,0,30,7
1746611215475,CGS 120,A00,887049,Staff,9,0,17,8
1746611216503,CHEM 6A,A01,886336,Lam; Tin Yiu,38,0,50,12
1746611216503,CHEM 6A,A02,886338,Lam; Tin Yiu,37,0,50,13
1746611217527,CHEM 6B,A01,886341,Hopkins; Patrycja Anna,16,0,50,34
1746611217527,CHEM 6B,A02,886343,Hopkins; Patrycja Anna,42,0,50,8
1746611218553,CHEM 6C,A01,886346,Albizati; Kim F.,0,2,50,50
1746611218553,CHEM 6C,A02,886348,Albizati; Kim F.,24,0,50,26
1746611219582,CHEM 40A,A01,886352,Klosterman; Jeremy K,65,0,100,35
1746611220609,CHEM 40B,A01,886356,Klosterman; Jeremy K,0,24,100,100
1746611221635,CHEM 41B,A01,886360,Theodorakis; Emmanuel,25,0,50,25
1746611221635,CHEM 41B,A02,886362,Theodorakis; Emmanuel,47,0,50,3
1746611222660,CHIN 165A,A00,886382,Xu; Li,18,0,20,2
1746611223687,CLAS 120,A00,886387,Myerston Santana; Jacobo,33,0,40,7
1746611224714,COGS 9,A01,886967,Shannon; Kyle Michael,42,0,60,18
1746611225744,COGS 11,A01,886969,Staff,9,0,30,21
1746611226768,COGS 14A,A01,886971,Staff,5,0,60,55
1746611227794,COGS 14B,A01,886973,Hoffman; Drew Ellen,4,0,60,56
1746611228822,COGS 18,A01,886975,Morgan; Eric,34,0,60,26
1746611229848,COGS 20,A01,886977,Staff,3,0,8,5
1746611229848,COGS 20,A02,886978,Staff,5,0,7,2
1746611230877,COGS 100,A01,907783,Staff,0,1,30,30
1746611231906,COGS 101B,A01,886980,Staff,0,4,48,48
1746611232940,COGS 101C,A01,886982,Delgado; Tania,0,5,44,44
1746611233965,COGS 102A,A01,886984,Johnson; Christine M.,3,0,30,27
1746611234993,COGS 118B,A01,886986,Staff,0,4,88,88
1746611236023,COGS 150,A01,886988,Bergen; Benjamin,22,0,50,28
1746611237048,COGS 153,A00,886989,Delgado; Tania,1,3,41,40
1746611238074,COGS 186,A01,886991,Staff,0,0,32,32
1746611239110,COGS 187A,A01,886993,Boyle; Mary E. T.,7,0,30,23
1746611240135,COGS 189,A00,886994,Staff,0,1,30,30
1746611241162,COMM 10,A01,886996,Staff,0,0,20,21
1746611241162,COMM 10,A02,886997,Staff,10,0,20,10
1746611241162,COMM 10,A03,959845,Staff,19,0,20,1
1746611242187,COMM 20,A01,886999,Leuning; Grant Maurstad,24,0,40,16
1746611244239,COMM 100A,A01,887002,Staff,0,0,20,25
1746611244239,COMM 100A,A02,887003,Staff,5,0,20,15
1746611245263,COMM 100B,A01,887005,Staff,0,8,20,24
1746611246291,COMM 106D,A00,887006,Staff,14,0,40,26
1746611247317,COMM 110G,A00,887007,Whitworth-Smith; Andrew C,12,0,40,28
1746611248343,COMM 111B,A00,887008,Staff,31,0,40,9
1746611249372,COMM 113T,A00,887009,Abuelhiga; Soraya Jill,28,0,40,12
1746611249372,COMM 113T,B00,906733,Staff,39,0,40,1
1746611250401,COMM 145,A00,887010,Staff,13,0,40,27
1746611251426,COMM 146,A00,887054,Staff,32,0,40,8
1746611252451,COMM 190,A00,887012,Staff,8,0,23,15
1746611253480,CSE 8A,A50,887015,Cao; Yingjun,56,0,85,29
1746611254505,CSE 11,A01,887017,Cao; Yingjun,11,0,70,59
1746611255534,CSE 20,A01,887019,Staff,30,0,50,20
1746611256564,CSE 21,A01,887021,Staff,79,0,100,21
1746611256564,CSE 21,B01,892583,Braun; Oliver,45,0,50,5
1746611257591,CSE 30,A01,887025,Eldon; John,142,0,200,58
1746611258621,CSE 100,A01,887027,Staff,26,0,50,24
1746611258621,CSE 100,A02,887028,Staff,42,0,50,8
1746611259652,CSE 101,A01,887030,Braun; Oliver,74,0,100,26
1746611259652,CSE 101,B01,887032,Jones; Miles E,0,3,50,50
1746611259652,CSE 101,B02,887033,Jones; Miles E,0,2,50,50
1746611260679,CSE 105,A01,908084,Jones; Miles E,32,0,50,18
1746611260679,CSE 105,A02,908087,Jones; Miles E,31,0,50,19
1746611261705,CSE 135,A01,887035,Powell; Thomas Allan,0,5,50,50
1746611262731,CSE 142,A01,887037,Staff,7,0,60,53
1746611263761,CSE 142L,A01,887039,Staff,34,0,60,26
1746611264791,CSE 151A,A01,887041,Solares; Edwin A,47,0,100,53
1746611265818,CSE 175,A01,887043,Kumar; Rakesh,30,0,30,0
1746611266843,CSS 1,A01,886389,Staff,0,1,40,40
1746611267870,DSC 30,A01,908097,Liao; Soohyun Nam,47,0,75,28
1746611268899,DSC 40A,A01,908099,Shannon; Kyle Michael,30,0,50,20
1746611269929,DSC 40B,A01,908112,Staff,15,0,50,35
1746611270956,DSC 80,A01,908116,Staff,19,0,60,41
1746611271985,DSC 197,001,956863,Eldridge; Justin Matthew,9999,0,9999,0
1746611273014,ECE 5,A01,886400,Morris; Karcher William,1,0,6,5
1746611273014,ECE 5,A02,886401,Morris; Karcher William,3,0,6,3
1746611274042,ECE 148,A01,886403,Silberman; Jack,0,14,14,14
1746611275069,ECON 1,A01,887265,Crane; Meredith Helen,11,0,70,59
1746611275069,ECON 1,B01,887268,Staff,42,0,50,8
1746611276098,ECON 2,A01,887273,Crane; Meredith Helen,54,0,70,16
1746611277126,ECON 3,A01,887279,Rondina; Giacomo,31,0,70,39
1746611278153,ECON 4,A01,887282,Anderson; John Charles,0,2,10,10
1746611279182,ECON 5,A01,887285,Staff,34,0,45,11
1746611279182,ECON 5,B01,887292,Staff,41,0,45,4
1746611280215,ECON 100A,A01,887337,Newhouse; Herbert S,54,0,70,16
1746611280215,ECON 100A,B01,887349,Staff,45,0,50,5
1746611281242,ECON 100B,A01,887361,Du; Songzi,29,0,70,41
1746611282268,ECON 100C,A01,887445,Newhouse; Herbert S,59,0,70,11
1746611283293,ECON 105,A00,887488,Vespa; Emanuel Ignacio,23,0,35,12
1746611284318,ECON 109,A01,887506,Shishkin; Denis,28,0,35,7
1746611285345,ECON 110A,A01,887568,Alon; Titan Michael,0,2,35,35
1746611285345,ECON 110A,B01,907601,Alon; Titan Michael,20,0,35,15
1746611286374,ECON 110B,A01,887598,Levkoff; Steven B.,0,24,70,70
1746611287398,ECON 112,A00,887599,Rondina; Giacomo,19,0,35,16
1746611288425,ECON 120A,A01,887603,Dai; Yinlin,36,0,70,34
1746611289456,ECON 120C,A01,887608,Sun; Yixiao,0,1,35,35
1746611289456,ECON 120C,B01,887614,Sun; Yixiao,0,0,35,35
1746611290481,ECON 138,A00,887621,Bharadwaj; Prashant,0,21,20,20
1746611291508,ECON 144,A00,958007,Squires; Dale E,11,0,35,24
1746611292533,ECON 171,A01,907666,Staff,18,0,35,17
1746611293560,ECON 175,A00,887626,Wu; Pak Yeung,22,0,35,13
1746611294586,ECON 190,A00,887640,Vespa; Emanuel Ignacio,22,0,35,13
1746611295616,EDS 25,A01,888197,Staff,0,0,0,0
1746611295616,EDS 25,A02,888209,Staff,0,0,0,0
1746611295616,EDS 25,A03,888210,Staff,0,0,0,0
1746611295616,EDS 25,A04,888212,Staff,0,0,0,0
1746611295616,EDS 25,A05,888213,Staff,0,0,0,0
1746611295616,EDS 25,A06,888214,Staff,0,0,0,0
1746611295616,EDS 25,A07,888235,Staff,0,2,0,0
1746611295616,EDS 25,A08,888236,Staff,0,0,0,0
1746611295616,EDS 25,A09,888240,Staff,0,0,0,0
1746611295616,EDS 25,A10,888244,Staff,0,0,0,0
1746611295616,EDS 25,B01,888273,Staff,0,0,0,0
1746611295616,EDS 25,B02,888285,Staff,0,0,0,0
1746611295616,EDS 25,B03,888423,Staff,0,0,0,1
1746611295616,EDS 25,B04,888432,Staff,0,0,0,0
1746611295616,EDS 25,B05,888433,Staff,0,0,0,0
1746611295616,EDS 25,B06,888467,Staff,0,0,0,0
1746611295616,EDS 25,B07,888468,Staff,0,0,0,0
1746611295616,EDS 25,B08,888479,Staff,0,0,0,0
1746611295616,EDS 25,B09,888484,Staff,0,0,0,0
1746611295616,EDS 25,B10,888487,Staff,0,0,0,0
1746611296642,EDS 38,A01,907700,Choi; Bailey Miyeon,30,0,30,0
1746611297668,EDS 112,A01,888601,Chapman; Thandeka K,12,0,40,28
1746611298699,EDS 115,A00,888697,Mendez; Kathrina Mendoza,10,0,30,20
1746611299725,EDS 116,A01,888893,Staff,33,0,40,7
1746611301780,EDS 124AR,A00,889133,Staff,29,0,50,21
1746611301780,EDS 124AR,B00,907471,Simon; Elizabeth A,37,0,50,13
1746611302806,EDS 124BR,A00,889134,Simon; Elizabeth A,44,0,100,56
1746611303831,EDS 125,A00,889135,Staff,25,0,30,5
1746611304862,EDS 126,A01,889138,Staff,35,0,40,5
1746611305890,EDS 164R,A01,889142,Wishard Guerra; Alison G.,32,0,50,18
1746611306916,ENG 30,A01,886396,Staff,0,0,0,0
1746611306916,ENG 30,B01,886398,Staff,0,0,0,0
1746611307941,ENVR 102,A00,906150,Montejo; Carolina,23,0,25,2
1746611308969,ETHN 103A,A00,887236,Man; Simeon S,0,2,0,0
1746611309997,ETHN 113,A00,887239,Staff,16,0,30,14
1746611311021,ETHN 116,A00,887240,Staff,16,0,25,9
1746611312050,ETHN 117,A00,887241,Choi; Esther Min,28,0,30,2
1746611313077,ETHN 118,A00,887243,Staff,24,0,30,6
1746611314110,ETHN 127,A00,887248,Cuong; Marisol,11,0,15,4
1746611315139,ETHN 139,A00,887250,Staff,7,0,10,3
1746611316163,ETHN 142,A00,887252,Staff,9,0,30,21
1746611317188,ETHN 161,A00,887253,Browne; Errol Tsekani,24,0,30,6
1746611318214,ETHN 163FR,A00,887255,Burelle; Julie Sara Veronique,0,0,5,5
1746611319240,GLBH 20,A00,889149,Elwardani; Nile Regina,8,0,42,34
1746611321289,GLBH 111,A01,889152,Burgos; Jose L.,17,0,17,0
1746611322315,GLBH 150,A00,889181,Sloane; Julia Kathryn,0,5,15,15
1746611324368,HDS 60,A01,886406,Warstadt; Melissa Fawn,72,0,80,8
1746611325394,HIAF 111,A00,889324,Gyamfi; Bright,25,0,32,7
1746611326423,HIEA 131,A00,889328,Staff,15,0,32,17
1746611327449,HIEA 144,A00,889333,Henry; Todd A.,26,0,32,6
1746611328479,HIEA 154,A00,889336,Henry; Todd A.,24,0,32,8
1746611329506,HIEU 106,A00,889339,Staff,22,0,32,10
1746611331560,HIEU 114,A00,889340,Staff,4,0,32,28
1746611332587,HIEU 135GS,A00,889342,Patterson; Patrick H.,0,0,1,24
1746611333644,HIEU 137,A00,889343,Edington; Claire Ellen,10,0,25,15
1746611334671,HIEU 148,A00,889345,Staff,14,0,32,18
1746611335699,HIEU 154,A00,889346,Biess; Frank Peter,21,0,32,11
1746611336725,HILA 102,A00,889351,Staff,12,0,32,20
1746611337749,HILD 2A,A01,889221,Lewandoski; Julia Mavis,0,8,32,32
1746611338778,HILD 7B,A01,889225,Man; Simeon S,0,12,32,32
1746611339809,HILD 7C,A01,889288,Alvarez; Luis A,0,14,32,32
1746611340834,HILD 30,A01,889323,Staff,0,5,32,32
1746611342894,HISC 119,A00,889383,Golan; Tal,20,0,32,12
1746611343920,HIUS 103,A00,889384,Man; Simeon S,0,0,32,32
1746611344947,HIUS 117,A00,919797,Kwak; Nancy,18,0,32,14
1746611345975,HIUS 142A,A00,919788,Staff,22,0,32,10
1746611348028,HIUS 149,A00,889386,Gyamfi; Bright,26,0,32,6
1746611349054,HIUS 155,A00,889387,Alvarez; Luis A,15,0,32,17
1746611350080,HUM 3,A01,886499,Caldwell; Michael Alan,19,0,50,31
1746611351107,HUM 3GS,A00,886500,Rodriguez; Bretton Sigfred,0,0,0,28
1746611352135,HUM 3R,A01,886502,Markman; Kristina,0,36,50,50
1746611353162,HUM 4,A01,886504,Crum; Matthew Stephen,23,0,50,27
1746611353162,HUM 4,B01,886506,West; Geoffrey Scott,17,0,50,33
1746611354189,HUM 4GS,A00,886507,Staff,0,0,0,19
1746611355217,HUM 5,A01,886509,Staff,31,0,50,19
1746611356243,HUM 5R,A01,886511,Zavodny; Tatiana Sophia,0,39,50,50
1746611357269,JAPN 180,A00,886407,Staff,16,0,40,24
1746611358295,LATI 50,A01,886409,Martin-Cabrera; Luis,3,0,22,19
1746611358295,LATI 50,A02,886410,Martin-Cabrera; Luis,19,0,22,3
1746611358295,LATI 50,A03,886411,Martin-Cabrera; Luis,21,0,22,1
1746611358295,LATI 50,A04,886412,Martin-Cabrera; Luis,8,0,22,14
1746611359321,LAWS 101,A00,907664,Staff,28,0,60,32
1746611360345,LIAB 1A,A00,889388,Saab; Dima,17,0,20,3
1746611361370,LIAB 1AX,A00,889389,El Cheddadi; Youniss,18,0,20,2
1746611362395,LIFR 1C,A00,889391,Van Moer; Vinciane G,8,0,20,12
1746611363419,LIFR 1CX,A00,889392,Van Moer; Vinciane G,7,0,20,13
1746611364448,LIFR 1D,A00,889393,Van Moer; Vinciane G,7,0,20,13
1746611365476,LIFR 1DX,A00,889394,Van Moer; Vinciane G,8,0,20,12
1746611366500,LIGN 7,A00,886923,Staff,25,0,50,25
1746611367531,LIGN 17,A00,886924,Kehler; Andrew Scott,126,0,150,24
1746611368557,LTAM 110,A00,889395,Staff,15,0,30,15
1746611369582,LTAM 110GS,A00,958010,Rodriguez; Bretton Sigfred,0,0,0,28
1746611370610,LTCH 101,A00,889397,Staff,23,0,25,2
1746611371637,LTCS 130,A00,889398,Staff,23,0,25,2
1746611372664,LTEA 138,A00,889399,Staff,24,0,40,16
1746611373693,LTEN 149,A00,889400,Wesling; Megan E.,0,3,25,25
1746611374720,LTEN 169,A00,889401,Staff,20,0,25,5
1746611375749,LTEN 180,A00,889402,Staff,10,0,15,5
1746611376778,LTEN 181,A00,889403,Staff,21,0,25,4
1746611377805,LTWL 100,A00,889404,Myerston Santana; Jacobo,2,0,25,23
1746611378830,LTWL 180GS,A00,889405,Staff,0,0,20,20
1746611379858,LTWL 181,A00,889406,Staff,16,0,25,9
1746611380887,LTWL 184,A00,889475,Mukherjee; Silpa,22,0,25,3
1746611381917,LTWR 102C,A00,889486,Staff,29,0,30,1
1746611382942,LTWR 115W,A00,889491,Staff,0,2,15,15
1746611383971,MAE 8,A01,886905,Staff,0,2,0,0
1746611385001,MAE 11,A00,886906,Bandaru; Prabhakar,0,7,50,50
1746611386028,MAE 20,A00,886907,Evdokimenko; Ekaterina,43,0,70,27
1746611387058,MAE 30B,A00,886909,Ghazinejad; Maziar,25,0,45,20
1746611388084,MAE 101B,A00,886910,Saintillan; David,30,0,45,15
1746611389116,MAE 105,A00,886911,Bandaru; Prabhakar,18,0,50,32
1746611390143,MAE 107,B00,958024,Staff,7,0,50,43
1746611391170,MAE 143B,A00,886913,Bewley; Thomas R,2,0,40,38
1746611392201,MAE 148,A01,886915,Silberman; Jack,0,3,14,14
1746611393229,MAE 160,A00,886916,Evdokimenko; Ekaterina,30,0,60,30
1746611394256,MATH 3C,A01,889681,Staff,0,2,30,30
1746611394256,MATH 3C,A02,960048,Staff,23,0,30,7
1746611395286,MATH 10A,A01,889760,Staff,26,0,30,4
1746611395286,MATH 10A,A02,889783,Staff,29,0,30,1
1746611396318,MATH 10B,A01,889785,Verstraete; Jacques Allan,1,0,35,34
1746611396318,MATH 10B,A02,889795,Verstraete; Jacques Allan,4,0,35,31
1746611396318,MATH 10B,B01,889797,Verstraete; Jacques Allan,3,0,35,32
1746611396318,MATH 10B,B02,889828,Verstraete; Jacques Allan,3,0,35,32
1746611397352,MATH 10C,A01,889849,Habib; Yousaf,8,0,30,22
1746611397352,MATH 10C,A02,889852,Habib; Yousaf,14,0,30,16
1746611397352,MATH 10C,A03,889853,Habib; Yousaf,22,0,30,8
1746611397352,MATH 10C,A04,889858,Habib; Yousaf,20,0,30,10
1746611397352,MATH 10C,B01,889861,Staff,1,0,30,29
1746611397352,MATH 10C,B02,889862,Staff,24,0,30,6
1746611397352,MATH 10C,B03,889863,Staff,27,0,30,3
1746611397352,MATH 10C,B04,889967,Staff,23,0,30,7
1746611398383,MATH 18,A01,889974,Staff,6,0,30,24
1746611398383,MATH 18,A02,889977,Staff,20,0,30,10
1746611398383,MATH 18,B01,889984,Hardiman; Liam,20,0,30,10
1746611398383,MATH 18,B02,889985,Hardiman; Liam,25,0,30,5
1746611399413,MATH 20A,A01,889990,Suk; Andrew Hoon,30,0,35,5
1746611400444,MATH 20B,A01,889993,Ohm; Ko Woon,21,0,30,9
1746611400444,MATH 20B,A02,889994,Ohm; Ko Woon,30,0,30,0
1746611400444,MATH 20B,B01,889996,Ohm; Ko Woon,22,0,30,8
1746611400444,MATH 20B,B02,889997,Ohm; Ko Woon,23,0,30,7
1746611401473,MATH 20C,A01,889999,Hammock; Frances H,17,0,30,13
1746611401473,MATH 20C,A02,890003,Hammock; Frances H,23,0,30,7
1746611401473,MATH 20C,B01,890006,Hammock; Frances H,2,0,30,28
1746611401473,MATH 20C,B02,890007,Hammock; Frances H,11,0,30,19
1746611402506,MATH 20D,A01,890011,Cheng; Hsiao-Bing,1,0,30,29
1746611402506,MATH 20D,A02,890012,Cheng; Hsiao-Bing,14,0,30,16
1746611402506,MATH 20D,B01,890016,Cheng; Hsiao-Bing,13,0,30,17
1746611402506,MATH 20D,B02,890017,Cheng; Hsiao-Bing,13,0,30,17
1746611403538,MATH 20E,A01,890026,Harel; Guershon,1,0,30,29
1746611403538,MATH 20E,A02,890029,Harel; Guershon,22,0,30,8
1746611403538,MATH 20E,B01,890033,Harel; Guershon,7,0,30,23
1746611403538,MATH 20E,B02,890101,Harel; Guershon,21,0,30,9
1746611404567,MATH 102,A01,890104,Staff,18,0,30,12
1746611404567,MATH 102,A02,890105,Staff,27,0,30,3
1746611405593,MATH 103B,A01,890116,Salehi Golsefidy; Alireza,3,0,30,27
1746611405593,MATH 103B,B01,890118,Staff,0,3,34,34
1746611406623,MATH 109,A01,890121,Aliabadi Sr.; Mohsen,0,0,30,30
1746611406623,MATH 109,B01,890124,Upadrashta; Pranav Kumar,18,0,30,12
1746611407649,MATH 120A,A01,890126,Eggers; John Dietrich,13,0,30,17
1746611408676,MATH 142B,A01,890128,Ioana; Adrian,19,0,30,11
1746611408676,MATH 142B,A02,890129,Ioana; Adrian,12,0,30,18
1746611409703,MATH 154,A01,890174,Staff,0,1,30,30
1746611409703,MATH 154,A02,890182,Staff,0,0,30,30
1746611410730,MATH 168A,A01,890197,Dumitriu; Ioana,21,0,35,14
1746611411758,MATH 170A,A01,890240,Nie; Jiawang,1,0,30,29
1746611411758,MATH 170A,A02,890241,Nie; Jiawang,11,0,30,19
1746611411758,MATH 170A,A03,890249,Nie; Jiawang,23,0,30,7
1746611412787,MATH 170B,A01,957891,Nag; Panchali,13,0,35,22
1746611414841,MATH 181A,A01,908025,Staff,0,3,35,35
1746611414841,MATH 181A,A02,960115,Staff,26,0,35,9
1746611415867,MATH 181B,A01,959874,Staff,24,0,30,6
1746611416894,MATH 193B,A01,890265,Staff,0,4,35,35
1746611417921,MGT 4,A01,890311,Anderson; John Charles,42,0,88,46
1746611418947,MGT 5,A00,907740,Staff,12,0,98,86
1746611419973,MGT 12,A00,890312,Lindenberger; Wade Douglas,67,0,98,31
1746611420999,MGT 16,A00,957883,Staff,78,0,98,20
1746611423052,MGT 45,A00,890314,Pecore; Joseph P.,45,0,98,53
1746611424078,MGT 71,A00,890315,Staff,0,12,98,98
1746611425107,MGT 100,A00,890316,Yavorsky; Daniel Ryan,44,0,98,54
1746611426133,MGT 103,A00,890317,Ehrich; Kristine R,73,0,98,25
1746611427161,MGT 105,A00,890356,Bates; Kenneth Walter,0,8,98,98
1746611428186,MGT 112,A00,890360,Ehrich; Kristine R,55,0,98,43
1746611429216,MGT 127R,A00,907732,Zhu; Kevin Xiaoguo,23,0,98,75
1746611430240,MGT 131B,A00,890361,Anderson; John Charles,59,0,98,39
1746611431266,MGT 137,A00,890362,Lindenberger; Wade Douglas,65,0,98,33
1746611432295,MGT 160,A00,890369,Johnson; Erik Barry,9,0,98,89
1746611434375,MGT 164,A00,890372,Zimmermann; Carsten,0,40,98,98
1746611435403,MGT 180,A00,890374,Bliss; Barbara Ann,11,0,98,87
1746611436433,MMW 15,A01,886414,Chang; Edmond Yi-Teh,0,12,28,28
1746611436433,MMW 15,A02,886415,Chang; Edmond Yi-Teh,0,8,28,28
1746611436433,MMW 15,A03,886416,Chang; Edmond Yi-Teh,0,9,28,28
1746611436433,MMW 15,A04,886417,Chang; Edmond Yi-Teh,0,8,28,28
1746611436433,MMW 15,B01,886419,Chang; Edmond Yi-Teh,0,7,28,28
1746611436433,MMW 15,B02,886420,Chang; Edmond Yi-Teh,0,7,28,28
1746611436433,MMW 15,B03,886421,Chang; Edmond Yi-Teh,0,7,28,28
1746611436433,MMW 15,B04,886422,Chang; Edmond Yi-Teh,0,8,28,28
1746611436433,MMW 15,C01,886424,Staff,0,9,28,28
1746611436433,MMW 15,C02,886425,Staff,0,8,28,28
1746611436433,MMW 15,C03,886426,Staff,0,8,28,28
1746611436433,MMW 15,C04,886427,Staff,0,8,28,28
1746611436433,MMW 15,C05,958038,Staff,0,8,28,28
1746611436433,MMW 15,C06,958039,Staff,0,7,28,28
1746611437457,MMW 15GS,A00,906910,Patterson; Patrick H.,4,0,28,24
1746611438484,MMW 122R,A01,886429,Rahimi; Babak,0,13,28,28
1746611438484,MMW 122R,A02,886430,Rahimi; Babak,0,12,28,28
1746611438484,MMW 122R,A03,958040,Rahimi; Babak,0,11,28,28
1746611439510,MUS 1A,A01,890937,Staff,2,0,25,23
1746611439510,MUS 1A,A02,891035,Staff,6,0,25,19
1746611439510,MUS 1A,C01,958912,Staff,24,0,25,1
1746611439510,MUS 1A,C02,958913,Staff,25,0,25,0
1746611441565,MUS 2AK,A00,957092,Ohnishi; Takae,15,0,15,0
1746611442595,MUS 4,A01,891044,Staff,0,0,25,25
1746611442595,MUS 4,A02,891045,Staff,22,0,25,3
1746611442595,MUS 4,B01,891048,Staff,17,0,25,8
1746611442595,MUS 4,B02,891050,Staff,25,0,25,0
1746611443621,MUS 5,A01,957506,Dubnov; Shlomo,0,0,25,25
1746611443621,MUS 5,A02,957622,Dubnov; Shlomo,12,0,25,13
1746611443621,MUS 5,A03,957623,Dubnov; Shlomo,20,0,25,5
1746611444650,MUS 6,A01,891053,Freitas Caetano; Marcelo,24,0,25,1
1746611444650,MUS 6,A02,891054,Freitas Caetano; Marcelo,23,0,25,2
1746611445676,MUS 7,A01,891081,Staff,0,0,25,25
1746611445676,MUS 7,A02,891082,Staff,3,0,25,22
1746611446702,MUS 8GS,A00,891118,Borgo; David Garcia,1,0,25,24
1746611447733,MUS 11,A01,891140,Staff,8,0,25,17
1746611447733,MUS 11,A02,891141,Staff,21,0,25,4
1746611448763,MUS 13,A01,891143,Staff,8,0,25,17
1746611448763,MUS 13,A02,891144,Staff,24,0,25,1
1746611449794,MUS 15,A01,891146,Staff,9,0,25,16
1746611449794,MUS 15,A02,891148,Staff,21,0,25,4
1746611449794,MUS 15,B01,891150,Staff,18,0,25,7
1746611449794,MUS 15,B02,891151,Staff,25,0,25,0
1746611450820,MUS 20,A01,891153,Staff,5,0,20,15
1746611450820,MUS 20,A02,891155,Staff,14,0,20,6
1746611451849,MUS 80,A00,891156,Staff,19,0,25,6
1746611451849,MUS 80,B00,891157,Staff,23,0,25,2
1746611452875,MUS 130,A00,891158,Ohnishi; Takae,35,0,35,0
1746611453905,MUS 150GS,A01,891160,Borgo; David Garcia,1,0,25,24
1746611454934,MUS 170,A01,891162,Freitas Caetano; Marcelo,20,0,25,5
1746611454934,MUS 170,A02,891164,Freitas Caetano; Marcelo,21,0,25,4
1746611455963,NANO 11,A00,886220,Vazquez Mena; Oscar,13,0,15,2
1746611456992,NANO 15,A01,886222,Drews; Aaron,4,0,7,3
1746611458022,NANO 104,A00,886224,Sirbuly; Donald,17,0,25,8
1746611459047,PH 40,A00,886528,Staff,23,0,40,17
1746611460077,PH 45,A01,886799,Staff,35,0,40,5
1746611461102,PH 110,A00,886802,Staff,0,6,40,40
1746611462131,PH 172,A00,906716,Staff,19,0,35,16
1746611463157,PH 191,A00,886803,Staff,6,0,40,34
1746611464186,PHIL 1,A00,889500,Staff,20,0,30,10
1746611465212,PHIL 10,A01,889549,Grush; Rick Scott,16,0,22,6
1746611465212,PHIL 10,A02,889551,Grush; Rick Scott,22,0,22,0
1746611466239,PHIL 28,A01,889559,Lamey; Andy M.,0,2,31,31
1746611466239,PHIL 28,A02,889561,Lamey; Andy M.,0,1,30,30
1746611466239,PHIL 28,A03,889572,Lamey; Andy M.,0,1,30,30
1746611467267,PHIL 35,A00,907839,Staff,13,0,15,2
1746611468295,PHIL 60,A00,889574,Staff,73,0,90,17
1746611469322,PHIL 101,A00,958004,Staff,12,0,15,3
1746611471380,PHIL 136,A00,889582,Fulkerson; Matthew Todd,26,0,45,19
1746611472412,PHIL 163,A01,889601,Staff,21,0,30,9
1746611472412,PHIL 163,B01,889606,Brandt; Reuven A,0,3,0,0
1746611473442,PHIL 164,A00,889610,Staff,16,0,30,14
1746611474481,PHIL 165,A00,889613,Staff,22,0,30,8
1746611475507,PHYS 1A,A00,886431,Staff,30,0,70,40
1746611476533,PHYS 1AL,001,886432,Tsai; Philbert S,0,1,30,30
1746611476533,PHYS 1AL,002,886436,Tsai; Philbert S,13,0,30,17
1746611477561,PHYS 1B,A00,886439,Staff,184,0,240,56
1746611478587,PHYS 1BL,001,886441,Tsai; Philbert S,0,4,30,30
1746611478587,PHYS 1BL,002,886444,Tsai; Philbert S,2,0,30,28
1746611479613,PHYS 1C,A00,896092,Arnold; Kam S,78,0,146,68
1746611480644,PHYS 1CL,001,886448,Tsai; Philbert S,0,0,30,30
1746611480644,PHYS 1CL,002,886449,Tsai; Philbert S,1,0,30,29
1746611480644,PHYS 1CL,003,886450,Tsai; Philbert S,16,0,30,14
1746611480644,PHYS 1CL,004,886451,Tsai; Philbert S,15,0,30,15
1746611481669,PHYS 2B,A01,886457,Staff,67,0,115,48
1746611482735,PHYS 2C,A01,886460,Shotwell; Brian,0,9,65,65
1746611483763,PHYS 2CL,A01,886467,Staff,0,4,28,28
1746611483763,PHYS 2CL,A02,886468,Staff,0,3,28,28
1746611484793,PHYS 2D,A01,886470,Staff,10,0,50,40
1746611485823,PHYS 4B,A01,886475,Grinstein; Benjamin,22,0,40,18
1746611486849,POLI 5,A00,891173,Desposato; Scott,7,0,25,18
1746611487874,POLI 5D,A01,891175,Staff,5,0,5,0
1746611487874,POLI 5D,B01,891178,Staff,5,0,5,0
1746611488902,POLI 11,A00,891179,Ferree; Karen E,0,0,35,35
1746611489929,POLI 12,A00,891180,Staff,15,0,30,15
1746611490954,POLI 27,A01,891182,Staff,11,0,75,64
1746611491979,POLI 30,A00,891183,Staff,8,0,50,42
1746611493006,POLI 100B,A00,891244,Staff,5,1,35,30
1746611494030,POLI 100I,A00,891247,Staff,7,0,30,23
1746611495057,POLI 104J,A00,891248,Nichter; Maysa,14,0,30,16
1746611496082,POLI 104U,A00,891250,Nichter; Maysa,1,0,30,29
1746611498139,POLI 110B,A00,891255,Wiens; David,19,0,25,6
1746611499165,POLI 112A,A00,891256,Wiens; David,6,0,25,19
1746611500191,POLI 114BR,A00,891261,Staff,19,0,30,11
1746611501216,POLI 117R,A00,891262,Forman; Fonna,0,6,50,50
1746611502245,POLI 118,A00,891264,Ingham; Sean,17,0,25,8
1746611503274,POLI 124A,A00,891265,Staff,18,0,20,2
1746611504299,POLI 125D,A00,891266,Nichter; Simeon C,2,0,25,23
1746611505323,POLI 126,A00,891268,Nichter; Simeon C,7,0,25,18
1746611506351,POLI 126AA,A00,891272,Staff,15,0,25,10
1746611507379,POLI 130AA,A00,891273,Staff,15,0,20,5
1746611508404,POLI 134AA,A00,891274,Staff,4,0,20,16
1746611510460,POLI 138,A00,891278,Staff,21,0,25,4
1746611511487,POLI 142K,A00,891280,Staff,10,0,25,15
1746611512517,POLI 142M,A00,891281,Gartzke; Erik,16,0,30,14
1746611513543,POLI 142P,A00,891284,Staff,20,0,30,10
1746611514568,POLI 143,A00,891285,Gartzke; Erik,12,0,30,18
1746611515597,POLI 153,A00,891286,Staff,19,0,20,1
1746611517648,POLI 175,A00,891290,Staff,15,0,20,5
1746611518674,PSYC 1,A00,890674,Steiner; Eric Tomas,0,11,45,45
1746611519702,PSYC 2,A00,890676,Albright; Thomas D,20,0,35,15
1746611520727,PSYC 3,A00,890679,Staff,17,0,20,3
1746611521751,PSYC 6,A00,959858,Staff,19,0,20,1
1746611522782,PSYC 60,A01,890684,Rickard; Timothy C.,0,6,45,45
1746611523809,PSYC 70,A01,890689,Geller; Emma Harlan,6,0,30,24
1746611524833,PSYC 71,A01,959860,Staff,21,0,25,4
1746611525860,PSYC 100,A00,890690,Lacefield; Katharine I,0,50,180,180
1746611526888,PSYC 102,A00,890695,Staff,18,0,40,22
1746611527917,PSYC 105,A00,890699,Geller; Emma Harlan,70,0,100,30
1746611528943,PSYC 106,A00,890701,Gorman; Michael R.,5,0,30,25
1746611529968,PSYC 108,A00,890704,Adrian; Julia Anna,0,29,50,50
1746611530995,PSYC 118,A01,890712,Staff,11,0,30,19
1746611532021,PSYC 124,A00,890716,Chapman; Eddie Nathaniel,25,0,60,35
1746611533050,PSYC 131,A00,890717,Anagnostaras; Stephan,0,7,80,80
1746611534080,PSYC 137,A00,890719,Winkielman; Piotr,0,11,30,30
1746611535107,PSYC 144,A00,890721,Adrian; Julia Anna,0,9,45,45
1746611536135,PSYC 162,A00,890805,Staff,0,2,75,75
1746611537161,PSYC 169,A00,890810,Staff,0,15,30,30
1746611538187,PSYC 172,A00,890814,Gorman; Michael R.,9,0,30,21
1746611539214,PSYC 181,A00,890818,Anagnostaras; Stephan,6,0,200,194
1746611540240,PSYC 184,A00,959861,Staff,160,0,175,15
1746611541265,PSYC 189,A00,890823,Staff,0,2,30,30
1746611542289,PSYC 191,A00,890884,Rickard; Timothy C.,0,12,35,35
1746611543316,PSYC 193,A00,890913,Staff,19,0,30,11
1746611543316,PSYC 193,B00,890914,Chapman; Eddie Nathaniel,24,0,30,6
1746611544347,PSYC 193L,A01,890918,Lowe; Angela Beth,20,0,30,10
1746611544347,PSYC 193L,B01,890921,Hurwitz; Ethan Scott,20,0,30,10
1746611544347,PSYC 193L,C01,890928,Staff,30,0,30,0
1746611545375,RELI 149,A00,886806,Rahimi; Babak,23,0,40,17
1746611546402,SE 9,A01,886814,Staff,7,0,20,13
1746611547432,SE 101B,A01,886816,Chadha; Mayank,3,0,35,32
1746611548462,SE 110B,A00,886818,Zhu; Qiang,4,0,75,71
1746611549491,SE 125,A01,886830,Staff,10,0,30,20
1746611550517,SE 130B,A01,886835,Staff,14,0,40,26
1746611551543,SE 131A,A01,886838,Krysl; Petr,34,0,55,21
1746611552572,SE 154,A00,886840,Staff,28,0,50,22
1746611553598,SE 164GS,A01,886849,Staff,6,0,20,14
1746611554624,SE 167GS,A01,886853,Staff,6,0,20,14
1746611555651,SIO 25,A01,890107,Staff,19,0,30,11
1746611556675,SIO 45,A00,890109,Cook; Geoffrey W,114,0,200,86
1746611557699,SIO 109R,A00,890110,Forman; Fonna,0,16,20,20
1746611558725,SIO 187,A01,890114,Kacev; David,15,0,40,25
1746611559752,SOCI 1,A01,890431,Thorpe; Charles Robert,14,0,30,16
1746611559752,SOCI 1,A02,890518,Thorpe; Charles Robert,30,0,30,0
1746611560779,SOCI 2,A01,957978,Staff,25,0,25,0
1746611560779,SOCI 2,A02,957979,Staff,23,0,25,2
1746611561802,SOCI 20,A01,890523,Calderon-Zaks; Michael Aar,21,0,30,9
1746611561802,SOCI 20,A02,890526,Calderon-Zaks; Michael Aar,29,0,30,1
1746611562829,SOCI 30,A01,890533,Pardo Guerra; Juan Pablo,37,0,40,3
1746611563855,SOCI 40,A01,890535,Staff,27,0,45,18
1746611564885,SOCI 104Q,A00,890559,Staff,17,0,30,13
1746611565911,SOCI 106,A00,890560,Arnal; Maud Marie Leonie,20,0,30,10
1746611566935,SOCI 110,A00,890567,Holkenbrink-Monk; Charlene,19,0,30,11
1746611567966,SOCI 112,A00,890568,Victoria Torres; Pablo,2,0,55,53
1746611568994,SOCI 115,A00,890597,Arnal; Maud Marie Leonie,28,0,45,17
1746611571045,SOCI 121,A00,890604,Pardo Guerra; Juan Pablo,38,0,45,7
1746611572071,SOCI 126,A01,890608,Staff,8,0,10,2
1746611573097,SOCI 127,A00,890609,Staff,18,0,30,12
1746611574123,SOCI 131,A00,890610,Thorpe; Charles Robert,37,0,45,8
1746611575150,SOCI 135,A00,890615,Payne; Christine Anna,14,0,45,31
1746611576176,SOCI 139,A00,890620,Staff,38,0,45,7
1746611577202,SOCI 148E,A00,890622,Calderon-Zaks; Michael Aar,36,0,45,9
1746611578226,SOCI 150,A00,890623,Kohler; Kristopher M.,31,0,45,14
1746611579252,SOCI 157,A00,890625,Jules-Rosette; Bennetta W.,18,0,20,2
1746611580278,SOCI 160,A00,890627,Payne; Christine Anna,21,0,45,24
1746611581303,SYN 1,A00,886855,Fish; Gwendolyn Anne,0,1,0,0
1746611581303,SYN 1,B00,906086,Fish; Gwendolyn Anne,0,2,0,2
1746611582331,SYN 2R,A00,886860,Staff,0,17,15,15
1746611582331,SYN 2R,B00,906106,Atkinson; Arthur Laird,0,16,15,15
1746611583365,SYN 100,A01,886866,Browne; Emily,0,28,20,20
1746611583365,SYN 100,B01,906128,Rock; Martin,0,4,20,20
1746611583365,SYN 100,C01,906140,Deavenport; James Cary,0,4,20,20
1746611583365,SYN 100,D01,907816,Deavenport; James Cary,0,5,20,20
1746611584392,TDAC 1,A00,890286,Walsh; Kim C.,7,0,20,13
1746611585417,TDAC 101,A00,890296,Basso; Beatrice,15,0,20,5
1746611586484,TDDE 131,A00,890297,Staff,47,0,50,3
1746611587510,TDDM 1,A00,890287,Weinberg; Sadie,25,0,30,5
1746611588539,TDGE 11,A00,890288,Fulton; Julia,138,0,200,62
1746611588539,TDGE 11,B00,890289,Castro; Robert Jess,184,0,200,16
1746611589568,TDGE 25,B00,957359,Walsh; Kim C.,5,0,20,15
1746611590597,TDGE 40,A01,890292,Power; Jade Yukana,26,0,30,4
1746611591624,TDGE 124,A00,890298,Havis; Allan,0,2,50,50
1746611592650,TDGE 131R,A00,890299,Burelle; Julie Sara Veronique,15,0,42,27
1746611593678,TDHT 101,A00,890300,Staff,10,0,20,10
1746611594706,TDHT 109,A01,890302,Anderson; Mysia Anyse,31,0,40,9
1746611595736,TDMV 1,A00,890293,Arcidiacono; Kristin,18,0,30,12
1746611596762,TDMV 2,A00,890294,Weinberg; Sadie,23,0,30,7
1746611597789,TDMV 3,A00,957878,Arcidiacono; Kristin,28,0,30,2
1746611599844,TDMV 138,A00,890304,Jun; Grace Shin Hae,25,0,40,15
1746611600869,TDMV 140,A00,890305,Corrales; Joseph Bernales,25,0,30,5
1746611601897,TDMV 142,A00,890307,Caligagan; Tony,32,0,40,8
1746611602923,TDMV 144,A00,890308,Camaya; Michelle Ann,25,0,30,5
1746611603949,TDPW 1,A00,890295,Stein; Deborah Isobel,3,0,20,17
1746611604979,USP 2,A01,890272,Lerner; Amy M,7,0,20,13
1746611606006,USP 3,A01,890274,Staff,12,0,30,18
1746611607034,USP 15,A01,890276,Sun; Feiyang,16,0,30,14
1746611608060,USP 25,A00,890277,Shenkman; Michael Thomas,18,0,25,7
1746611609086,USP 138,A00,890278,Staff,13,0,25,12
1746611610115,USP 143,A00,890279,Staff,21,0,70,49
1746611611143,USP 144,A00,890280,Chowdhury; Muhammed Zohir,16,0,30,14
1746611612169,USP 150,A00,890281,Boomhower; Matthew Charles,4,0,30,26
1746611613198,USP 151,A00,890282,Staff,16,0,20,4
1746611614222,USP 162,A00,890283,Andrews; Abigail Leslie,16,0,20,4
1746611615251,USP 168,A00,920477,Kwak; Nancy,0,0,5,5
1746611616279,USP 181,A00,890284,Staff,3,0,20,17
1746611617305,USP 191A,A00,890285,Staff,12,0,20,8
1746611618330,VIS 101,A00,886512,Staff,26,0,75,49
1746611619358,VIS 103,A00,886513,Cruz; Edwin Teddy,61,0,75,14
1746611620386,VIS 108,A00,886514,Staff,4,0,15,11
1746611621416,VIS 127P,A00,886515,Shen; Kuiyi,80,0,146,66
1746611622443,VIS 149,A00,886516,Yoldas; Pinar,0,0,15,15
1746611623469,VIS 164,A00,886526,Erdmann; Dean,19,0,22,3
1746611624494,VIS 194S,A00,886527,Staff,61,0,75,14
1746611625521,WCWP 10A,C00,886484,Martiniuk; Jill,12,0,15,3
1746611626546,WCWP 10B,A00,886490,Uriarte; Emma,0,0,15,15
1746611626546,WCWP 10B,B00,886491,Dhir; Simrita,8,0,15,7
1746611626546,WCWP 10B,C00,886492,Ornelas; Tricia,0,0,15,15
1746611627572,WCWP 100,A00,886494,Young; Mark T,0,6,15,15
1746611629645,AAS 10,A01,886199,Childs; Dennis R.,0,3,0,0
1746611630674,ANAR 104,A01,886940,Shtienberg; Gilad,27,0,30,3
1746611631705,ANAR 120,A00,886953,Staff,13,0,20,7
1746611632731,ANBI 148,A01,886955,Wilder; Linnea Lorene,30,0,40,10
1746611634784,ANSC 122,A00,886957,Staff,24,0,30,6
1746611635810,ANSC 150,A00,886958,Sloane; Julia Kathryn,2,0,15,13
1746611636839,ANSC 156,A00,886959,Jenkins; Janis A.,0,1,15,15
1746611637868,ANSC 180,A00,886960,Staff,11,0,17,6
1746611638896,ANSC 188,A00,886961,Jassal; Aftab,9,0,25,16
1746611639923,ANSC 190,A00,886962,Jassal; Aftab,14,0,25,11
1746611640951,ANSC 191,A00,886963,Staff,18,0,20,2
1746611641978,ANTH 3,A01,891689,Staff,17,0,20,3
1746611643003,ANTH 5,A00,886933,Semendeferi; Ekaterini,16,0,20,4
1746611644029,ANTH 10,A00,886934,Staff,0,12,30,30
1746611645057,ANTH 21,A01,886936,Staff,41,0,60,19
1746611646086,ANTH 23,A01,886938,Staff,92,0,100,8
1746611647114,ANTH 105,A00,886964,Stewart; Alexander B,84,0,100,16
1746611648139,ANTH 108,A00,886965,Pedersen; David,9,0,20,11
1746611649172,AWP 10,001,886147,Staff,0,0,0,0
1746611649172,AWP 10,002,886148,Staff,0,0,0,0
1746611649172,AWP 10,003,886149,Staff,0,0,0,0
1746611649172,AWP 10,004,886150,Staff,0,0,0,0
1746611649172,AWP 10,005,886151,Staff,0,0,0,0
1746611649172,AWP 10,006,886152,Staff,0,0,0,0
1746611649172,AWP 10,007,886153,Staff,0,0,0,0
1746611649172,AWP 10,008,886154,Staff,0,0,0,0
1746611649172,AWP 10,009,886155,Staff,0,0,0,0
1746611649172,AWP 10,010,886156,Staff,0,0,0,0
1746611649172,AWP 10,011,886158,Staff,0,0,0,0
1746611649172,AWP 10,012,886160,Staff,0,0,0,0
1746611649172,AWP 10,013,886161,Staff,0,0,0,0
1746611649172,AWP 10,014,886162,Staff,0,0,0,0
1746611649172,AWP 10,015,886163,Staff,0,0,0,0
1746611649172,AWP 10,016,886164,Staff,0,0,0,0
1746611649172,AWP 10,017,886165,Staff,0,0,0,0
1746611649172,AWP 10,018,886166,Staff,0,0,0,0
1746611649172,AWP 10,019,886168,Staff,0,0,0,0
1746611649172,AWP 10,020,886170,Staff,0,0,0,0
1746611649172,AWP 10,021,886172,Staff,0,0,0,0
1746611650207,AWP 10R,001,886173,Staff,0,1,0,0
1746611650207,AWP 10R,002,886174,Staff,0,1,0,0
1746611650207,AWP 10R,003,886175,Staff,0,0,0,0
1746611650207,AWP 10R,004,886176,Staff,0,0,0,0
1746611650207,AWP 10R,005,886177,Staff,0,0,0,0
1746611650207,AWP 10R,006,886178,Staff,0,0,0,0
1746611650207,AWP 10R,007,886179,Staff,0,0,0,0
1746611650207,AWP 10R,008,886181,Staff,0,0,0,0
1746611650207,AWP 10R,009,886182,Staff,0,0,0,0
1746611650207,AWP 10R,010,886183,Staff,0,0,0,0
1746611650207,AWP 10R,011,886184,Staff,0,0,0,0
1746611650207,AWP 10R,012,886185,Staff,0,0,0,0
1746611650207,AWP 10R,013,886186,Staff,0,0,0,0
1746611650207,AWP 10R,014,886187,Staff,0,0,0,0
1746611650207,AWP 10R,015,886188,Staff,0,0,0,0
1746611650207,AWP 10R,016,886189,Staff,0,0,0,0
1746611650207,AWP 10R,017,960532,Staff,0,0,0,0
1746611650207,AWP 10R,018,960533,Staff,0,0,0,0
1746611650207,AWP 10R,019,960534,Staff,0,0,0,0
1746611650207,AWP 10R,020,960538,Staff,0,0,0,0
1746611650207,AWP 10R,021,960540,Staff,0,0,0,0
1746611650207,AWP 10R,022,960541,Staff,0,0,0,0
1746611650207,AWP 10R,023,960542,Staff,0,0,0,0
1746611650207,AWP 10R,024,960544,Staff,0,0,0,0
1746611650207,AWP 10R,025,960545,Staff,0,0,0,0
1746611650207,AWP 10R,026,960548,Staff,0,0,0,0
1746611651236,AWP 102R,A00,886190,Staff,0,0,0,0
1746611651236,AWP 102R,B00,886191,Staff,0,0,0,0
1746611652265,BENG 100,A01,886193,Staff,17,0,30,13
1746611653289,BENG 122A,A01,886195,Hasty; Jeff M,13,0,30,17
1746611654314,BENG 166A,A00,886196,Sah; Robert Lie-Yuan,0,3,30,30
1746611655341,BENG 190,A00,958050,Khojah; Reem I,17,0,25,8
1746611656365,BIBC 102,A01,894320,Staff,0,1,46,46
1746611656365,BIBC 102,A02,894321,Staff,0,0,46,46
1746611656365,BIBC 102,A03,894344,Staff,6,0,46,40
1746611656365,BIBC 102,A04,894345,Staff,27,0,47,20
1746611657392,BICD 100R,A01,894365,Smith; Laurie,0,2,58,58
1746611657392,BICD 100R,A02,894366,Smith; Laurie,0,4,58,58
1746611657392,BICD 100R,A03,894367,Smith; Laurie,0,0,59,59
1746611657392,BICD 100R,A04,959869,Smith; Laurie,38,0,59,21
1746611658422,BICD 136,A01,894383,Gustafson-Brown; Cindy,14,0,50,36
1746611659449,BIEB 102,A01,894494,Butler; Shannon Rhey,51,0,130,79
1746611661507,BIEB 150,A01,894617,Wills; Christopher,3,0,20,17
1746611661507,BIEB 150,A02,894631,Wills; Christopher,3,0,20,17
1746611661507,BIEB 150,A03,894937,Wills; Christopher,3,0,20,17
1746611661507,BIEB 150,A04,894946,Wills; Christopher,5,0,20,15
1746611662534,BIEB 194,A00,906141,Kurle; Carolyn M.,5,0,20,15
1746611663560,BILD 1,A01,894154,Staff,3,0,19,16
1746611663560,BILD 1,A02,894155,Staff,14,0,19,5
1746611663560,BILD 1,A03,894160,Staff,13,0,19,6
1746611663560,BILD 1,A04,894161,Staff,15,0,18,3
1746611664591,BILD 2,A01,894168,Staff,0,0,50,50
1746611664591,BILD 2,A02,894169,Staff,0,0,50,50
1746611664591,BILD 2,A03,894179,Staff,0,0,50,50
1746611664591,BILD 2,A04,894203,Staff,22,0,50,28
1746611665620,BILD 3,A01,894213,Staff,23,0,31,8
1746611665620,BILD 3,A02,894214,Staff,26,0,31,5
1746611665620,BILD 3,A03,894235,Staff,28,0,31,3
1746611665620,BILD 3,A04,894236,Staff,28,0,32,4
1746611666647,BILD 4,A01,894253,Reuther; Keefe,5,0,24,19
1746611666647,BILD 4,A02,894258,Reuther; Keefe,16,0,24,8
1746611667678,BILD 5,A01,894276,Reuther; Keefe,33,0,50,17
1746611667678,BILD 5,A02,894277,Reuther; Keefe,45,0,50,5
1746611667678,BILD 5,A03,894290,Reuther; Keefe,44,0,50,6
1746611667678,BILD 5,A04,894291,Reuther; Keefe,48,0,50,2
1746611668704,BILD 24,A01,894297,Pirino; Giorgia,40,0,60,20
1746611669729,BIMM 100,B01,958915,Staff,71,0,100,29
1746611670761,BIMM 101,A01,895017,McDonnell; Lisa Marie,0,5,24,24
1746611670761,BIMM 101,A02,895018,McDonnell; Lisa Marie,0,5,24,24
1746611670761,BIMM 101,B01,895020,McDonnell; Lisa Marie,0,5,24,24
1746611670761,BIMM 101,B02,895021,McDonnell; Lisa Marie,0,4,24,24
1746611671785,BIMM 110,A01,895023,Staff,1,0,25,24
1746611671785,BIMM 110,A02,895024,Staff,9,0,25,16
1746611671785,BIMM 110,A03,895025,Staff,18,0,25,7
1746611671785,BIMM 110,A04,895031,Staff,20,0,25,5
1746611672820,BIMM 120,A01,895114,Gustafson-Brown; Cindy,14,0,28,14
1746611672820,BIMM 120,A02,895126,Gustafson-Brown; Cindy,21,0,27,6
1746611673846,BIPN 100,A01,895130,Yang; Mingyu,0,0,38,38
1746611673846,BIPN 100,A02,895131,Yang; Mingyu,31,0,38,7
1746611673846,BIPN 100,A03,895132,Yang; Mingyu,32,0,38,6
1746611673846,BIPN 100,A04,895133,Yang; Mingyu,27,0,36,9
1746611674871,BIPN 120,A01,895135,Cooke; James Edward,0,3,13,13
1746611674871,BIPN 120,A02,895136,Cooke; James Edward,0,1,13,13
1746611674871,BIPN 120,A03,895137,Cooke; James Edward,0,3,13,13
1746611674871,BIPN 120,A04,895156,Cooke; James Edward,0,2,11,11
1746611675899,BIPN 134,A01,895235,Cooke; James Edward,0,1,25,25
1746611675899,BIPN 134,A02,895237,Cooke; James Edward,0,0,25,25
1746611675899,BIPN 134,A03,895240,Cooke; James Edward,1,0,25,24
1746611675899,BIPN 134,A04,895270,Cooke; James Edward,20,0,25,5
1746611676928,BIPN 189,A00,892103,Staff,0,14,14,14
1746611678980,BISP 194,A00,958008,Staff,0,2,0,0
1746611680007,CAT 124,A01,922009,Staff,0,5,20,20
1746611681038,CAT 125R,A00,886390,Morales; Celeste Georgianna,0,4,20,20
1746611681038,CAT 125R,B00,886391,Irwin; Matthew Joseph,0,4,20,20
1746611681038,CAT 125R,C00,886392,Smith; Lauryn Alissa,0,2,20,20
1746611681038,CAT 125R,D00,886393,Vanderschuit; Maya Alysia,0,3,20,20
1746611681038,CAT 125R,E00,886394,Marchisotto; Jennifer Anne,0,3,20,20
1746611682067,CENG 15,A01,886218,Drews; Aaron,3,0,8,5
1746611683096,CENG 113,A00,886219,Opatkiewicz; Justin Paul,15,0,25,10
1746611684123,CGS 101,A00,887044,Staff,7,0,20,13
1746611685152,CGS 105,A01,887046,Staff,14,0,25,11
1746611686181,CGS 112,A00,887047,Cuong; Marisol,12,0,15,3
1746611687207,CGS 113,A00,887048,Staff,23,0,30,7
1746611688233,CGS 120,A00,887049,Staff,9,0,17,8
1746611689259,CHEM 6A,A01,886336,Lam; Tin Yiu,38,0,50,12
1746611689259,CHEM 6A,A02,886338,Lam; Tin Yiu,37,0,50,13
1746611690328,CHEM 6B,A01,886341,Hopkins; Patrycja Anna,16,0,50,34
1746611690328,CHEM 6B,A02,886343,Hopkins; Patrycja Anna,42,0,50,8
1746611691354,CHEM 6C,A01,886346,Albizati; Kim F.,0,2,50,50
1746611691354,CHEM 6C,A02,886348,Albizati; Kim F.,24,0,50,26
1746611692383,CHEM 40A,A01,886352,Klosterman; Jeremy K,65,0,100,35
1746611693410,CHEM 40B,A01,886356,Klosterman; Jeremy K,0,24,100,100
1746611694440,CHEM 41B,A01,886360,Theodorakis; Emmanuel,25,0,50,25
1746611694440,CHEM 41B,A02,886362,Theodorakis; Emmanuel,47,0,50,3
1746611695466,CHIN 165A,A00,886382,Xu; Li,18,0,20,2
1746611696494,CLAS 120,A00,886387,Myerston Santana; Jacobo,33,0,40,7
1746611697519,COGS 9,A01,886967,Shannon; Kyle Michael,42,0,60,18
1746611698547,COGS 11,A01,886969,Staff,9,0,30,21
1746611699575,COGS 14A,A01,886971,Staff,5,0,60,55
1746611700602,COGS 14B,A01,886973,Hoffman; Drew Ellen,4,0,60,56
1746611701632,COGS 18,A01,886975,Morgan; Eric,34,0,60,26
1746611702659,COGS 20,A01,886977,Staff,3,0,8,5
1746611702659,COGS 20,A02,886978,Staff,5,0,7,2
1746611703687,COGS 100,A01,907783,Staff,0,1,30,30
1746611704716,COGS 101B,A01,886980,Staff,0,4,48,48
1746611705744,COGS 101C,A01,886982,Delgado; Tania,0,5,44,44
1746611706774,COGS 102A,A01,886984,Johnson; Christine M.,3,0,30,27
1746611707800,COGS 118B,A01,886986,Staff,0,4,88,88
1746611708827,COGS 150,A01,886988,Bergen; Benjamin,22,0,50,28
1746611709854,COGS 153,A00,886989,Delgado; Tania,1,3,41,40
1746611710879,COGS 186,A01,886991,Staff,0,0,32,32
1746611711908,COGS 187A,A01,886993,Boyle; Mary E. T.,7,0,30,23
1746611712935,COGS 189,A00,886994,Staff,0,1,30,30
1746611713960,COMM 10,A01,886996,Staff,0,0,20,21
1746611713960,COMM 10,A02,886997,Staff,10,0,20,10
1746611713960,COMM 10,A03,959845,Staff,19,0,20,1
1746611714988,COMM 20,A01,886999,Leuning; Grant Maurstad,24,0,40,16
1746611717045,COMM 100A,A01,887002,Staff,0,0,20,25
1746611717045,COMM 100A,A02,887003,Staff,5,0,20,15
1746611718072,COMM 100B,A01,887005,Staff,0,8,20,24
1746611719100,COMM 106D,A00,887006,Staff,14,0,40,26
1746611720128,COMM 110G,A00,887007,Whitworth-Smith; Andrew C,12,0,40,28
1746611721155,COMM 111B,A00,887008,Staff,31,0,40,9
1746611722183,COMM 113T,A00,887009,Abuelhiga; Soraya Jill,28,0,40,12
1746611722183,COMM 113T,B00,906733,Staff,39,0,40,1
1746611723209,COMM 145,A00,887010,Staff,13,0,40,27
1746611724235,COMM 146,A00,887054,Staff,32,0,40,8
1746611725259,COMM 190,A00,887012,Staff,8,0,23,15
1746611726286,CSE 8A,A50,887015,Cao; Yingjun,56,0,85,29
1746611727313,CSE 11,A01,887017,Cao; Yingjun,11,0,70,59
1746611728340,CSE 20,A01,887019,Staff,30,0,50,20
1746611729369,CSE 21,A01,887021,Staff,79,0,100,21
1746611729369,CSE 21,B01,892583,Braun; Oliver,45,0,50,5
1746611730396,CSE 30,A01,887025,Eldon; John,142,0,200,58
1746611731425,CSE 100,A01,887027,Staff,26,0,50,24
1746611731425,CSE 100,A02,887028,Staff,42,0,50,8
1746611732456,CSE 101,A01,887030,Braun; Oliver,74,0,100,26
1746611732456,CSE 101,B01,887032,Jones; Miles E,0,3,50,50
1746611732456,CSE 101,B02,887033,Jones; Miles E,0,2,50,50
1746611733484,CSE 105,A01,908084,Jones; Miles E,32,0,50,18
1746611733484,CSE 105,A02,908087,Jones; Miles E,31,0,50,19
1746611734510,CSE 135,A01,887035,Powell; Thomas Allan,0,5,50,50
1746611735536,CSE 142,A01,887037,Staff,7,0,60,53
1746611736566,CSE 142L,A01,887039,Staff,34,0,60,26
1746611737594,CSE 151A,A01,887041,Solares; Edwin A,47,0,100,53
1746611738621,CSE 175,A01,887043,Kumar; Rakesh,30,0,30,0
1746611739649,CSS 1,A01,886389,Staff,0,1,40,40
1746611740679,DSC 30,A01,908097,Liao; Soohyun Nam,47,0,75,28
1746611741705,DSC 40A,A01,908099,Shannon; Kyle Michael,30,0,50,20
1746611742733,DSC 40B,A01,908112,Staff,15,0,50,35
1746611743759,DSC 80,A01,908116,Staff,19,0,60,41
1746611744785,DSC 197,001,956863,Eldridge; Justin Matthew,9999,0,9999,0
1746611745811,ECE 5,A01,886400,Morris; Karcher William,1,0,6,5
1746611745811,ECE 5,A02,886401,Morris; Karcher William,3,0,6,3
1746611746842,ECE 148,A01,886403,Silberman; Jack,0,14,14,14
1746611747870,ECON 1,A01,887265,Crane; Meredith Helen,11,0,70,59
1746611747870,ECON 1,B01,887268,Staff,42,0,50,8
1746611748896,ECON 2,A01,887273,Crane; Meredith Helen,54,0,70,16
1746611749924,ECON 3,A01,887279,Rondina; Giacomo,31,0,70,39
1746611750954,ECON 4,A01,887282,Anderson; John Charles,0,2,10,10
1746611751980,ECON 5,A01,887285,Staff,34,0,45,11
1746611751980,ECON 5,B01,887292,Staff,41,0,45,4
1746611753004,ECON 100A,A01,887337,Newhouse; Herbert S,54,0,70,16
1746611753004,ECON 100A,B01,887349,Staff,45,0,50,5
1746611754034,ECON 100B,A01,887361,Du; Songzi,29,0,70,41
1746611755063,ECON 100C,A01,887445,Newhouse; Herbert S,59,0,70,11
1746611756091,ECON 105,A00,887488,Vespa; Emanuel Ignacio,23,0,35,12
1746611757117,ECON 109,A01,887506,Shishkin; Denis,28,0,35,7
1746611758148,ECON 110A,A01,887568,Alon; Titan Michael,0,2,35,35
1746611758148,ECON 110A,B01,907601,Alon; Titan Michael,20,0,35,15
1746611759175,ECON 110B,A01,887598,Levkoff; Steven B.,0,24,70,70
1746611760203,ECON 112,A00,887599,Rondina; Giacomo,19,0,35,16
1746611761228,ECON 120A,A01,887603,Dai; Yinlin,36,0,70,34
1746611762259,ECON 120C,A01,887608,Sun; Yixiao,0,1,35,35
1746611762259,ECON 120C,B01,887614,Sun; Yixiao,0,0,35,35
1746611763288,ECON 138,A00,887621,Bharadwaj; Prashant,0,21,20,20
1746611764314,ECON 144,A00,958007,Squires; Dale E,11,0,35,24
1746611765343,ECON 171,A01,907666,Staff,18,0,35,17
1746611766372,ECON 175,A00,887626,Wu; Pak Yeung,22,0,35,13
1746611767397,ECON 190,A00,887640,Vespa; Emanuel Ignacio,22,0,35,13
1746611768428,EDS 25,A01,888197,Staff,0,0,0,0
1746611768428,EDS 25,A02,888209,Staff,0,0,0,0
1746611768428,EDS 25,A03,888210,Staff,0,0,0,0
1746611768428,EDS 25,A04,888212,Staff,0,0,0,0
1746611768428,EDS 25,A05,888213,Staff,0,0,0,0
1746611768428,EDS 25,A06,888214,Staff,0,0,0,0
1746611768428,EDS 25,A07,888235,Staff,0,2,0,0
1746611768428,EDS 25,A08,888236,Staff,0,0,0,0
1746611768428,EDS 25,A09,888240,Staff,0,0,0,0
1746611768428,EDS 25,A10,888244,Staff,0,0,0,0
1746611768428,EDS 25,B01,888273,Staff,0,0,0,0
1746611768428,EDS 25,B02,888285,Staff,0,0,0,0
1746611768428,EDS 25,B03,888423,Staff,0,0,0,1
1746611768428,EDS 25,B04,888432,Staff,0,0,0,0
1746611768428,EDS 25,B05,888433,Staff,0,0,0,0
1746611768428,EDS 25,B06,888467,Staff,0,0,0,0
1746611768428,EDS 25,B07,888468,Staff,0,0,0,0
1746611768428,EDS 25,B08,888479,Staff,0,0,0,0
1746611768428,EDS 25,B09,888484,Staff,0,0,0,0
1746611768428,EDS 25,B10,888487,Staff,0,0,0,0
1746611769452,EDS 38,A01,907700,Choi; Bailey Miyeon,30,0,30,0
1746611770481,EDS 112,A01,888601,Chapman; Thandeka K,12,0,40,28
1746611771510,EDS 115,A00,888697,Mendez; Kathrina Mendoza,10,0,30,20
1746611772536,EDS 116,A01,888893,Staff,33,0,40,7
1746611774591,EDS 124AR,A00,889133,Staff,29,0,50,21
1746611774591,EDS 124AR,B00,907471,Simon; Elizabeth A,37,0,50,13
1746611775618,EDS 124BR,A00,889134,Simon; Elizabeth A,44,0,100,56
1746611776643,EDS 125,A00,889135,Staff,25,0,30,5
1746611777672,EDS 126,A01,889138,Staff,35,0,40,5
1746611778699,EDS 164R,A01,889142,Wishard Guerra; Alison G.,32,0,50,18
1746611779727,ENG 30,A01,886396,Staff,0,0,0,0
1746611779727,ENG 30,B01,886398,Staff,0,0,0,0
1746611780753,ENVR 102,A00,906150,Montejo; Carolina,23,0,25,2
1746611781783,ETHN 103A,A00,887236,Man; Simeon S,0,2,0,0
1746611782808,ETHN 113,A00,887239,Staff,16,0,30,14
1746611783839,ETHN 116,A00,887240,Staff,16,0,25,9
1746611784868,ETHN 117,A00,887241,Choi; Esther Min,28,0,30,2
1746611785897,ETHN 118,A00,887243,Staff,24,0,30,6
1746611786925,ETHN 127,A00,887248,Cuong; Marisol,11,0,15,4
1746611787950,ETHN 139,A00,887250,Staff,7,0,10,3
1746611788976,ETHN 142,A00,887252,Staff,9,0,30,21
1746611790005,ETHN 161,A00,887253,Browne; Errol Tsekani,24,0,30,6
1746611791031,ETHN 163FR,A00,887255,Burelle; Julie Sara Veronique,0,0,5,5
1746611792056,GLBH 20,A00,889149,Elwardani; Nile Regina,8,0,42,34
1746611794145,GLBH 111,A01,889152,Burgos; Jose L.,17,0,17,0
1746611795170,GLBH 150,A00,889181,Sloane; Julia Kathryn,0,5,15,15
1746611797225,HDS 60,A01,886406,Warstadt; Melissa Fawn,72,0,80,8
1746611798253,HIAF 111,A00,889324,Gyamfi; Bright,25,0,32,7
1746611799278,HIEA 131,A00,889328,Staff,15,0,32,17
1746611800306,HIEA 144,A00,889333,Henry; Todd A.,26,0,32,6
1746611801329,HIEA 154,A00,889336,Henry; Todd A.,24,0,32,8
1746611802357,HIEU 106,A00,889339,Staff,22,0,32,10
1746611804408,HIEU 114,A00,889340,Staff,4,0,32,28
1746611805434,HIEU 135GS,A00,889342,Patterson; Patrick H.,0,0,1,24
1746611806459,HIEU 137,A00,889343,Edington; Claire Ellen,10,0,25,15
1746611807484,HIEU 148,A00,889345,Staff,14,0,32,18
1746611808509,HIEU 154,A00,889346,Biess; Frank Peter,21,0,32,11
1746611809536,HILA 102,A00,889351,Staff,12,0,32,20
1746611810564,HILD 2A,A01,889221,Lewandoski; Julia Mavis,0,8,32,32
1746611811593,HILD 7B,A01,889225,Man; Simeon S,0,12,32,32
1746611812621,HILD 7C,A01,889288,Alvarez; Luis A,0,14,32,32
1746611813646,HILD 30,A01,889323,Staff,0,5,32,32
1746611815700,HISC 119,A00,889383,Golan; Tal,20,0,32,12
1746611816725,HIUS 103,A00,889384,Man; Simeon S,0,0,32,32
1746611817750,HIUS 117,A00,919797,Kwak; Nancy,18,0,32,14
1746611818777,HIUS 142A,A00,919788,Staff,22,0,32,10
1746611820828,HIUS 149,A00,889386,Gyamfi; Bright,26,0,32,6
1746611821854,HIUS 155,A00,889387,Alvarez; Luis A,15,0,32,17
1746611822882,HUM 3,A01,886499,Caldwell; Michael Alan,19,0,50,31
1746611823907,HUM 3GS,A00,886500,Rodriguez; Bretton Sigfred,0,0,0,28
1746611824933,HUM 3R,A01,886502,Markman; Kristina,0,36,50,50
1746611825958,HUM 4,A01,886504,Crum; Matthew Stephen,23,0,50,27
1746611825958,HUM 4,B01,886506,West; Geoffrey Scott,17,0,50,33
1746611826985,HUM 4GS,A00,886507,Staff,0,0,0,19
1746611828011,HUM 5,A01,886509,Staff,31,0,50,19
1746611829039,HUM 5R,A01,886511,Zavodny; Tatiana Sophia,0,39,50,50
1746611830062,JAPN 180,A00,886407,Staff,16,0,40,24
1746611831087,LATI 50,A01,886409,Martin-Cabrera; Luis,3,0,22,19
1746611831087,LATI 50,A02,886410,Martin-Cabrera; Luis,19,0,22,3
1746611831087,LATI 50,A03,886411,Martin-Cabrera; Luis,21,0,22,1
1746611831087,LATI 50,A04,886412,Martin-Cabrera; Luis,8,0,22,14
1746611832115,LAWS 101,A00,907664,Staff,28,0,60,32
1746611833143,LIAB 1A,A00,889388,Saab; Dima,17,0,20,3
1746611834168,LIAB 1AX,A00,889389,El Cheddadi; Youniss,18,0,20,2
1746611835193,LIFR 1C,A00,889391,Van Moer; Vinciane G,8,0,20,12
1746611836225,LIFR 1CX,A00,889392,Van Moer; Vinciane G,7,0,20,13
1746611837251,LIFR 1D,A00,889393,Van Moer; Vinciane G,7,0,20,13
1746611838279,LIFR 1DX,A00,889394,Van Moer; Vinciane G,8,0,20,12
1746611839305,LIGN 7,A00,886923,Staff,25,0,50,25
1746611840333,LIGN 17,A00,886924,Kehler; Andrew Scott,126,0,150,24
1746611841358,LTAM 110,A00,889395,Staff,15,0,30,15
1746611842383,LTAM 110GS,A00,958010,Rodriguez; Bretton Sigfred,0,0,0,28
1746611843412,LTCH 101,A00,889397,Staff,23,0,25,2
1746611844437,LTCS 130,A00,889398,Staff,23,0,25,2
1746611845465,LTEA 138,A00,889399,Staff,24,0,40,16
1746611846490,LTEN 149,A00,889400,Wesling; Megan E.,0,3,25,25
1746611847519,LTEN 169,A00,889401,Staff,20,0,25,5
1746611848545,LTEN 180,A00,889402,Staff,10,0,15,5
1746611849569,LTEN 181,A00,889403,Staff,21,0,25,4
1746611850596,LTWL 100,A00,889404,Myerston Santana; Jacobo,2,0,25,23
1746611851622,LTWL 180GS,A00,889405,Staff,0,0,20,20
1746611852647,LTWL 181,A00,889406,Staff,16,0,25,9
1746611853676,LTWL 184,A00,889475,Mukherjee; Silpa,22,0,25,3
1746611854701,LTWR 102C,A00,889486,Staff,29,0,30,1
1746611855730,LTWR 115W,A00,889491,Staff,0,2,15,15
1746611856756,MAE 8,A01,886905,Staff,0,2,0,0
1746611857782,MAE 11,A00,886906,Bandaru; Prabhakar,0,7,50,50
1746611858809,MAE 20,A00,886907,Evdokimenko; Ekaterina,43,0,70,27
1746611859834,MAE 30B,A00,886909,Ghazinejad; Maziar,25,0,45,20
1746611860862,MAE 101B,A00,886910,Saintillan; David,30,0,45,15
1746611861889,MAE 105,A00,886911,Bandaru; Prabhakar,18,0,50,32
1746611862916,MAE 107,B00,958024,Staff,7,0,50,43
1746611863943,MAE 143B,A00,886913,Bewley; Thomas R,2,0,40,38
1746611864975,MAE 148,A01,886915,Silberman; Jack,0,3,14,14
1746611866004,MAE 160,A00,886916,Evdokimenko; Ekaterina,30,0,60,30
1746611867029,MATH 3C,A01,889681,Staff,0,2,30,30
1746611867029,MATH 3C,A02,960048,Staff,23,0,30,7
1746611868056,MATH 10A,A01,889760,Staff,26,0,30,4
1746611868056,MATH 10A,A02,889783,Staff,29,0,30,1
1746611869089,MATH 10B,A01,889785,Verstraete; Jacques Allan,1,0,35,34
1746611869089,MATH 10B,A02,889795,Verstraete; Jacques Allan,4,0,35,31
1746611869089,MATH 10B,B01,889797,Verstraete; Jacques Allan,3,0,35,32
1746611869089,MATH 10B,B02,889828,Verstraete; Jacques Allan,3,0,35,32
1746611870117,MATH 10C,A01,889849,Habib; Yousaf,8,0,30,22
1746611870117,MATH 10C,A02,889852,Habib; Yousaf,14,0,30,16
1746611870117,MATH 10C,A03,889853,Habib; Yousaf,22,0,30,8
1746611870117,MATH 10C,A04,889858,Habib; Yousaf,20,0,30,10
1746611870117,MATH 10C,B01,889861,Staff,1,0,30,29
1746611870117,MATH 10C,B02,889862,Staff,24,0,30,6
1746611870117,MATH 10C,B03,889863,Staff,27,0,30,3
1746611870117,MATH 10C,B04,889967,Staff,23,0,30,7
1746611871143,MATH 18,A01,889974,Staff,6,0,30,24
1746611871143,MATH 18,A02,889977,Staff,20,0,30,10
1746611871143,MATH 18,B01,889984,Hardiman; Liam,20,0,30,10
1746611871143,MATH 18,B02,889985,Hardiman; Liam,25,0,30,5
1746611872168,MATH 20A,A01,889990,Suk; Andrew Hoon,30,0,35,5
1746611873197,MATH 20B,A01,889993,Ohm; Ko Woon,21,0,30,9
1746611873197,MATH 20B,A02,889994,Ohm; Ko Woon,30,0,30,0
1746611873197,MATH 20B,B01,889996,Ohm; Ko Woon,22,0,30,8
1746611873197,MATH 20B,B02,889997,Ohm; Ko Woon,23,0,30,7
1746611874225,MATH 20C,A01,889999,Hammock; Frances H,17,0,30,13
1746611874225,MATH 20C,A02,890003,Hammock; Frances H,23,0,30,7
1746611874225,MATH 20C,B01,890006,Hammock; Frances H,2,0,30,28
1746611874225,MATH 20C,B02,890007,Hammock; Frances H,11,0,30,19
1746611875251,MATH 20D,A01,890011,Cheng; Hsiao-Bing,1,0,30,29
1746611875251,MATH 20D,A02,890012,Cheng; Hsiao-Bing,14,0,30,16
1746611875251,MATH 20D,B01,890016,Cheng; Hsiao-Bing,13,0,30,17
1746611875251,MATH 20D,B02,890017,Cheng; Hsiao-Bing,13,0,30,17
1746611876278,MATH 20E,A01,890026,Harel; Guershon,1,0,30,29
1746611876278,MATH 20E,A02,890029,Harel; Guershon,22,0,30,8
1746611876278,MATH 20E,B01,890033,Harel; Guershon,7,0,30,23
1746611876278,MATH 20E,B02,890101,Harel; Guershon,21,0,30,9
1746611877306,MATH 102,A01,890104,Staff,18,0,30,12
1746611877306,MATH 102,A02,890105,Staff,27,0,30,3
1746611878332,MATH 103B,A01,890116,Salehi Golsefidy; Alireza,3,0,30,27
1746611878332,MATH 103B,B01,890118,Staff,0,3,34,34
1746611879365,MATH 109,A01,890121,Aliabadi Sr.; Mohsen,0,0,30,30
1746611879365,MATH 109,B01,890124,Upadrashta; Pranav Kumar,18,0,30,12
1746611880394,MATH 120A,A01,890126,Eggers; John Dietrich,13,0,30,17
1746611881424,MATH 142B,A01,890128,Ioana; Adrian,19,0,30,11
1746611881424,MATH 142B,A02,890129,Ioana; Adrian,12,0,30,18
1746611882455,MATH 154,A01,890174,Staff,0,1,30,30
1746611882455,MATH 154,A02,890182,Staff,0,0,30,30
1746611883483,MATH 168A,A01,890197,Dumitriu; Ioana,21,0,35,14
1746611884510,MATH 170A,A01,890240,Nie; Jiawang,1,0,30,29
1746611884510,MATH 170A,A02,890241,Nie; Jiawang,11,0,30,19
1746611884510,MATH 170A,A03,890249,Nie; Jiawang,23,0,30,7
1746611885539,MATH 170B,A01,957891,Nag; Panchali,13,0,35,22
1746611887596,MATH 181A,A01,908025,Staff,0,3,35,35
1746611887596,MATH 181A,A02,960115,Staff,26,0,35,9
1746611888625,MATH 181B,A01,959874,Staff,24,0,30,6
1746611889653,MATH 193B,A01,890265,Staff,0,4,35,35
1746611890678,MGT 4,A01,890311,Anderson; John Charles,42,0,88,46
1746611891703,MGT 5,A00,907740,Staff,12,0,98,86
1746611892729,MGT 12,A00,890312,Lindenberger; Wade Douglas,67,0,98,31
1746611893757,MGT 16,A00,957883,Staff,78,0,98,20
1746611895807,MGT 45,A00,890314,Pecore; Joseph P.,45,0,98,53
1746611896834,MGT 71,A00,890315,Staff,0,12,98,98
1746611897862,MGT 100,A00,890316,Yavorsky; Daniel Ryan,44,0,98,54
1746611898892,MGT 103,A00,890317,Ehrich; Kristine R,73,0,98,25
1746611899919,MGT 105,A00,890356,Bates; Kenneth Walter,0,8,98,98
1746611900944,MGT 112,A00,890360,Ehrich; Kristine R,55,0,98,43
1746611901971,MGT 127R,A00,907732,Zhu; Kevin Xiaoguo,23,0,98,75
1746611902997,MGT 131B,A00,890361,Anderson; John Charles,59,0,98,39
1746611904021,MGT 137,A00,890362,Lindenberger; Wade Douglas,65,0,98,33
1746611905051,MGT 160,A00,890369,Johnson; Erik Barry,9,0,98,89
1746611907105,MGT 164,A00,890372,Zimmermann; Carsten,0,40,98,98
1746611908132,MGT 180,A00,890374,Bliss; Barbara Ann,11,0,98,87
1746611909161,MMW 15,A01,886414,Chang; Edmond Yi-Teh,0,12,28,28
1746611909161,MMW 15,A02,886415,Chang; Edmond Yi-Teh,0,8,28,28
1746611909161,MMW 15,A03,886416,Chang; Edmond Yi-Teh,0,9,28,28
1746611909161,MMW 15,A04,886417,Chang; Edmond Yi-Teh,0,8,28,28
1746611909161,MMW 15,B01,886419,Chang; Edmond Yi-Teh,0,7,28,28
1746611909161,MMW 15,B02,886420,Chang; Edmond Yi-Teh,0,7,28,28
1746611909161,MMW 15,B03,886421,Chang; Edmond Yi-Teh,0,7,28,28
1746611909161,MMW 15,B04,886422,Chang; Edmond Yi-Teh,0,8,28,28
1746611909161,MMW 15,C01,886424,Staff,0,9,28,28
1746611909161,MMW 15,C02,886425,Staff,0,8,28,28
1746611909161,MMW 15,C03,886426,Staff,0,8,28,28
1746611909161,MMW 15,C04,886427,Staff,0,8,28,28
1746611909161,MMW 15,C05,958038,Staff,0,8,28,28
1746611909161,MMW 15,C06,958039,Staff,0,7,28,28
1746611910187,MMW 15GS,A00,906910,Patterson; Patrick H.,4,0,28,24
1746611911215,MMW 122R,A01,886429,Rahimi; Babak,0,13,28,28
1746611911215,MMW 122R,A02,886430,Rahimi; Babak,0,12,28,28
1746611911215,MMW 122R,A03,958040,Rahimi; Babak,0,11,28,28
1746611912241,MUS 1A,A01,890937,Staff,2,0,25,23
1746611912241,MUS 1A,A02,891035,Staff,6,0,25,19
1746611912241,MUS 1A,C01,958912,Staff,24,0,25,1
1746611912241,MUS 1A,C02,958913,Staff,25,0,25,0
1746611914296,MUS 2AK,A00,957092,Ohnishi; Takae,15,0,15,0
1746611915324,MUS 4,A01,891044,Staff,0,0,25,25
1746611915324,MUS 4,A02,891045,Staff,22,0,25,3
1746611915324,MUS 4,B01,891048,Staff,17,0,25,8
1746611915324,MUS 4,B02,891050,Staff,25,0,25,0
1746611916350,MUS 5,A01,957506,Dubnov; Shlomo,0,0,25,25
1746611916350,MUS 5,A02,957622,Dubnov; Shlomo,12,0,25,13
1746611916350,MUS 5,A03,957623,Dubnov; Shlomo,20,0,25,5
1746611917376,MUS 6,A01,891053,Freitas Caetano; Marcelo,24,0,25,1
1746611917376,MUS 6,A02,891054,Freitas Caetano; Marcelo,23,0,25,2
1746611918401,MUS 7,A01,891081,Staff,0,0,25,25
1746611918401,MUS 7,A02,891082,Staff,3,0,25,22
1746611919426,MUS 8GS,A00,891118,Borgo; David Garcia,1,0,25,24
1746611920457,MUS 11,A01,891140,Staff,8,0,25,17
1746611920457,MUS 11,A02,891141,Staff,21,0,25,4
1746611921486,MUS 13,A01,891143,Staff,8,0,25,17
1746611921486,MUS 13,A02,891144,Staff,24,0,25,1
1746611922516,MUS 15,A01,891146,Staff,9,0,25,16
1746611922516,MUS 15,A02,891148,Staff,21,0,25,4
1746611922516,MUS 15,B01,891150,Staff,18,0,25,7
1746611922516,MUS 15,B02,891151,Staff,25,0,25,0
1746611923559,MUS 20,A01,891153,Staff,5,0,20,15
1746611923559,MUS 20,A02,891155,Staff,14,0,20,6
1746611924584,MUS 80,A00,891156,Staff,19,0,25,6
1746611924584,MUS 80,B00,891157,Staff,23,0,25,2
1746611925609,MUS 130,A00,891158,Ohnishi; Takae,35,0,35,0
1746611926635,MUS 150GS,A01,891160,Borgo; David Garcia,1,0,25,24
1746611927660,MUS 170,A01,891162,Freitas Caetano; Marcelo,20,0,25,5
1746611927660,MUS 170,A02,891164,Freitas Caetano; Marcelo,21,0,25,4
1746611928686,NANO 11,A00,886220,Vazquez Mena; Oscar,13,0,15,2
1746611929710,NANO 15,A01,886222,Drews; Aaron,4,0,7,3
1746611930739,NANO 104,A00,886224,Sirbuly; Donald,17,0,25,8
1746611931765,PH 40,A00,886528,Staff,23,0,40,17
1746611932790,PH 45,A01,886799,Staff,35,0,40,5
1746611933815,PH 110,A00,886802,Staff,0,6,40,40
1746611934842,PH 172,A00,906716,Staff,19,0,35,16
1746611935868,PH 191,A00,886803,Staff,6,0,40,34
1746611936893,PHIL 1,A00,889500,Staff,20,0,30,10
1746611937918,PHIL 10,A01,889549,Grush; Rick Scott,16,0,22,6
1746611937918,PHIL 10,A02,889551,Grush; Rick Scott,22,0,22,0
1746611938948,PHIL 28,A01,889559,Lamey; Andy M.,0,2,31,31
1746611938948,PHIL 28,A02,889561,Lamey; Andy M.,0,1,30,30
1746611938948,PHIL 28,A03,889572,Lamey; Andy M.,0,1,30,30
1746611939974,PHIL 35,A00,907839,Staff,13,0,15,2
1746611941014,PHIL 60,A00,889574,Staff,73,0,90,17
1746611942042,PHIL 101,A00,958004,Staff,12,0,15,3
1746611944096,PHIL 136,A00,889582,Fulkerson; Matthew Todd,26,0,45,19
1746611945122,PHIL 163,A01,889601,Staff,21,0,30,9
1746611945122,PHIL 163,B01,889606,Brandt; Reuven A,0,3,0,0
1746611946149,PHIL 164,A00,889610,Staff,16,0,30,14
1746611947174,PHIL 165,A00,889613,Staff,22,0,30,8
1746611948199,PHYS 1A,A00,886431,Staff,30,0,70,40
1746611949228,PHYS 1AL,001,886432,Tsai; Philbert S,0,1,30,30
1746611949228,PHYS 1AL,002,886436,Tsai; Philbert S,13,0,30,17
1746611950258,PHYS 1B,A00,886439,Staff,184,0,240,56
1746611951286,PHYS 1BL,001,886441,Tsai; Philbert S,0,4,30,30
1746611951286,PHYS 1BL,002,886444,Tsai; Philbert S,2,0,30,28
1746611952311,PHYS 1C,A00,896092,Arnold; Kam S,78,0,146,68
1746611953337,PHYS 1CL,001,886448,Tsai; Philbert S,0,0,30,30
1746611953337,PHYS 1CL,002,886449,Tsai; Philbert S,1,0,30,29
1746611953337,PHYS 1CL,003,886450,Tsai; Philbert S,16,0,30,14
1746611953337,PHYS 1CL,004,886451,Tsai; Philbert S,15,0,30,15
1746611954365,PHYS 2B,A01,886457,Staff,67,0,115,48
1746611955391,PHYS 2C,A01,886460,Shotwell; Brian,0,9,65,65
1746611956418,PHYS 2CL,A01,886467,Staff,0,4,28,28
1746611956418,PHYS 2CL,A02,886468,Staff,0,3,28,28
1746611957443,PHYS 2D,A01,886470,Staff,10,0,50,40
1746611958470,PHYS 4B,A01,886475,Grinstein; Benjamin,22,0,40,18
1746611959495,POLI 5,A00,891173,Desposato; Scott,7,0,25,18
1746611960522,POLI 5D,A01,891175,Staff,5,0,5,0
1746611960522,POLI 5D,B01,891178,Staff,5,0,5,0
1746611961548,POLI 11,A00,891179,Ferree; Karen E,0,0,35,35
1746611962573,POLI 12,A00,891180,Staff,15,0,30,15
1746611963598,POLI 27,A01,891182,Staff,11,0,75,64
1746611964626,POLI 30,A00,891183,Staff,8,0,50,42
1746611965651,POLI 100B,A00,891244,Staff,5,1,35,30
1746611966676,POLI 100I,A00,891247,Staff,7,0,30,23
1746611967700,POLI 104J,A00,891248,Nichter; Maysa,14,0,30,16
1746611968724,POLI 104U,A00,891250,Nichter; Maysa,1,0,30,29
1746611970779,POLI 110B,A00,891255,Wiens; David,19,0,25,6
1746611971806,POLI 112A,A00,891256,Wiens; David,6,0,25,19
1746611972832,POLI 114BR,A00,891261,Staff,19,0,30,11
1746611973858,POLI 117R,A00,891262,Forman; Fonna,0,6,50,50
1746611974884,POLI 118,A00,891264,Ingham; Sean,17,0,25,8
1746611975909,POLI 124A,A00,891265,Staff,18,0,20,2
1746611976934,POLI 125D,A00,891266,Nichter; Simeon C,2,0,25,23
1746611977963,POLI 126,A00,891268,Nichter; Simeon C,7,0,25,18
1746611978987,POLI 126AA,A00,891272,Staff,15,0,25,10
1746611980016,POLI 130AA,A00,891273,Staff,15,0,20,5
1746611981044,POLI 134AA,A00,891274,Staff,4,0,20,16
1746611983095,POLI 138,A00,891278,Staff,21,0,25,4
1746611984130,POLI 142K,A00,891280,Staff,10,0,25,15
1746611985158,POLI 142M,A00,891281,Gartzke; Erik,16,0,30,14
1746611986185,POLI 142P,A00,891284,Staff,20,0,30,10
1746611987215,POLI 143,A00,891285,Gartzke; Erik,12,0,30,18
1746611988240,POLI 153,A00,891286,Staff,19,0,20,1
1746611990295,POLI 175,A00,891290,Staff,15,0,20,5
1746611991320,PSYC 1,A00,890674,Steiner; Eric Tomas,0,11,45,45
1746611992346,PSYC 2,A00,890676,Albright; Thomas D,20,0,35,15
1746611993376,PSYC 3,A00,890679,Staff,17,0,20,3
1746611994402,PSYC 6,A00,959858,Staff,19,0,20,1
1746611995432,PSYC 60,A01,890684,Rickard; Timothy C.,0,6,45,45
1746611996462,PSYC 70,A01,890689,Geller; Emma Harlan,6,0,30,24
1746611997491,PSYC 71,A01,959860,Staff,21,0,25,4
1746611998518,PSYC 100,A00,890690,Lacefield; Katharine I,0,50,180,180
1746611999543,PSYC 102,A00,890695,Staff,18,0,40,22
1746612000569,PSYC 105,A00,890699,Geller; Emma Harlan,70,0,100,30
1746612001595,PSYC 106,A00,890701,Gorman; Michael R.,5,0,30,25
1746612002624,PSYC 108,A00,890704,Adrian; Julia Anna,0,29,50,50
1746612003659,PSYC 118,A01,890712,Staff,11,0,30,19
1746612004689,PSYC 124,A00,890716,Chapman; Eddie Nathaniel,25,0,60,35
1746612005715,PSYC 131,A00,890717,Anagnostaras; Stephan,0,7,80,80
1746612006741,PSYC 137,A00,890719,Winkielman; Piotr,0,11,30,30
1746612007768,PSYC 144,A00,890721,Adrian; Julia Anna,0,9,45,45
1746612008795,PSYC 162,A00,890805,Staff,0,2,75,75
1746612009824,PSYC 169,A00,890810,Staff,0,15,30,30
1746612010850,PSYC 172,A00,890814,Gorman; Michael R.,9,0,30,21
1746612011879,PSYC 181,A00,890818,Anagnostaras; Stephan,6,0,200,194
1746612012904,PSYC 184,A00,959861,Staff,160,0,175,15
1746612013933,PSYC 189,A00,890823,Staff,0,2,30,30
1746612014960,PSYC 191,A00,890884,Rickard; Timothy C.,0,12,35,35
1746612016013,PSYC 193,A00,890913,Staff,19,0,30,11
1746612016013,PSYC 193,B00,890914,Chapman; Eddie Nathaniel,24,0,30,6
1746612017042,PSYC 193L,A01,890918,Lowe; Angela Beth,20,0,30,10
1746612017042,PSYC 193L,B01,890921,Hurwitz; Ethan Scott,20,0,30,10
1746612017042,PSYC 193L,C01,890928,Staff,30,0,30,0
1746612018068,RELI 149,A00,886806,Rahimi; Babak,23,0,40,17
1746612019097,SE 9,A01,886814,Staff,7,0,20,13
1746612020124,SE 101B,A01,886816,Chadha; Mayank,3,0,35,32
1746612021154,SE 110B,A00,886818,Zhu; Qiang,4,0,75,71
1746612022180,SE 125,A01,886830,Staff,10,0,30,20
1746612023206,SE 130B,A01,886835,Staff,14,0,40,26
1746612024235,SE 131A,A01,886838,Krysl; Petr,34,0,55,21
1746612025260,SE 154,A00,886840,Staff,28,0,50,22
1746612026285,SE 164GS,A01,886849,Staff,6,0,20,14
1746612027310,SE 167GS,A01,886853,Staff,6,0,20,14
1746612028335,SIO 25,A01,890107,Staff,19,0,30,11
1746612029360,SIO 45,A00,890109,Cook; Geoffrey W,114,0,200,86
1746612030389,SIO 109R,A00,890110,Forman; Fonna,0,16,20,20
1746612031415,SIO 187,A01,890114,Kacev; David,15,0,40,25
1746612032447,SOCI 1,A01,890431,Thorpe; Charles Robert,14,0,30,16
1746612032447,SOCI 1,A02,890518,Thorpe; Charles Robert,30,0,30,0
1746612033475,SOCI 2,A01,957978,Staff,25,0,25,0
1746612033475,SOCI 2,A02,957979,Staff,23,0,25,2
1746612034506,SOCI 20,A01,890523,Calderon-Zaks; Michael Aar,21,0,30,9
1746612034506,SOCI 20,A02,890526,Calderon-Zaks; Michael Aar,29,0,30,1
1746612035531,SOCI 30,A01,890533,Pardo Guerra; Juan Pablo,37,0,40,3
1746612036557,SOCI 40,A01,890535,Staff,27,0,45,18
1746612037586,SOCI 104Q,A00,890559,Staff,17,0,30,13
1746612038614,SOCI 106,A00,890560,Arnal; Maud Marie Leonie,20,0,30,10
1746612039643,SOCI 110,A00,890567,Holkenbrink-Monk; Charlene,19,0,30,11
1746612040673,SOCI 112,A00,890568,Victoria Torres; Pablo,2,0,55,53
1746612041701,SOCI 115,A00,890597,Arnal; Maud Marie Leonie,28,0,45,17
1746612043753,SOCI 121,A00,890604,Pardo Guerra; Juan Pablo,38,0,45,7
1746612044781,SOCI 126,A01,890608,Staff,8,0,10,2
1746612045805,SOCI 127,A00,890609,Staff,18,0,30,12
1746612046832,SOCI 131,A00,890610,Thorpe; Charles Robert,37,0,45,8
1746612047857,SOCI 135,A00,890615,Payne; Christine Anna,14,0,45,31
1746612048883,SOCI 139,A00,890620,Staff,38,0,45,7
1746612049909,SOCI 148E,A00,890622,Calderon-Zaks; Michael Aar,36,0,45,9
1746612050935,SOCI 150,A00,890623,Kohler; Kristopher M.,31,0,45,14
1746612051962,SOCI 157,A00,890625,Jules-Rosette; Bennetta W.,18,0,20,2
1746612052989,SOCI 160,A00,890627,Payne; Christine Anna,21,0,45,24
1746612054014,SYN 1,A00,886855,Fish; Gwendolyn Anne,0,1,0,0
1746612054014,SYN 1,B00,906086,Fish; Gwendolyn Anne,0,2,0,2
1746612055040,SYN 2R,A00,886860,Staff,0,17,15,15
1746612055040,SYN 2R,B00,906106,Atkinson; Arthur Laird,0,16,15,15
1746612056073,SYN 100,A01,886866,Browne; Emily,0,28,20,20
1746612056073,SYN 100,B01,906128,Rock; Martin,0,4,20,20
1746612056073,SYN 100,C01,906140,Deavenport; James Cary,0,4,20,20
1746612056073,SYN 100,D01,907816,Deavenport; James Cary,0,5,20,20
1746612057099,TDAC 1,A00,890286,Walsh; Kim C.,7,0,20,13
1746612058126,TDAC 101,A00,890296,Basso; Beatrice,15,0,20,5
1746612059152,TDDE 131,A00,890297,Staff,47,0,50,3
1746612060178,TDDM 1,A00,890287,Weinberg; Sadie,25,0,30,5
1746612061207,TDGE 11,A00,890288,Fulton; Julia,138,0,200,62
1746612061207,TDGE 11,B00,890289,Castro; Robert Jess,184,0,200,16
1746612062232,TDGE 25,B00,957359,Walsh; Kim C.,5,0,20,15
1746612063260,TDGE 40,A01,890292,Power; Jade Yukana,26,0,30,4
1746612064285,TDGE 124,A00,890298,Havis; Allan,0,2,50,50
1746612065310,TDGE 131R,A00,890299,Burelle; Julie Sara Veronique,15,0,42,27
1746612066339,TDHT 101,A00,890300,Staff,10,0,20,10
1746612067365,TDHT 109,A01,890302,Anderson; Mysia Anyse,31,0,40,9
1746612068391,TDMV 1,A00,890293,Arcidiacono; Kristin,18,0,30,12
1746612069419,TDMV 2,A00,890294,Weinberg; Sadie,23,0,30,7
1746612070446,TDMV 3,A00,957878,Arcidiacono; Kristin,28,0,30,2
1746612072502,TDMV 138,A00,890304,Jun; Grace Shin Hae,25,0,40,15
1746612073529,TDMV 140,A00,890305,Corrales; Joseph Bernales,25,0,30,5
1746612074554,TDMV 142,A00,890307,Caligagan; Tony,32,0,40,8
1746612075581,TDMV 144,A00,890308,Camaya; Michelle Ann,25,0,30,5
1746612076609,TDPW 1,A00,890295,Stein; Deborah Isobel,3,0,20,17
1746612077638,USP 2,A01,890272,Lerner; Amy M,7,0,20,13
1746612078666,USP 3,A01,890274,Staff,12,0,30,18
1746612079691,USP 15,A01,890276,Sun; Feiyang,16,0,30,14
1746612080717,USP 25,A00,890277,Shenkman; Michael Thomas,18,0,25,7
1746612081743,USP 138,A00,890278,Staff,13,0,25,12
1746612082767,USP 143,A00,890279,Staff,21,0,70,49
1746612083792,USP 144,A00,890280,Chowdhury; Muhammed Zohir,16,0,30,14
1746612084817,USP 150,A00,890281,Boomhower; Matthew Charles,4,0,30,26
1746612085843,USP 151,A00,890282,Staff,16,0,20,4
1746612086871,USP 162,A00,890283,Andrews; Abigail Leslie,16,0,20,4
1746612087900,USP 168,A00,920477,Kwak; Nancy,0,0,5,5
1746612088927,USP 181,A00,890284,Staff,3,0,20,17
1746612089952,USP 191A,A00,890285,Staff,12,0,20,8
1746612090978,VIS 101,A00,886512,Staff,26,0,75,49
1746612092004,VIS 103,A00,886513,Cruz; Edwin Teddy,61,0,75,14
1746612093031,VIS 108,A00,886514,Staff,4,0,15,11
1746612094059,VIS 127P,A00,886515,Shen; Kuiyi,80,0,146,66
1746612095086,VIS 149,A00,886516,Yoldas; Pinar,0,0,15,15
1746612096114,VIS 164,A00,886526,Erdmann; Dean,19,0,22,3
1746612097139,VIS 194S,A00,886527,Staff,61,0,75,14
1746612098165,WCWP 10A,C00,886484,Martiniuk; Jill,12,0,15,3
1746612099195,WCWP 10B,A00,886490,Uriarte; Emma,0,0,15,15
1746612099195,WCWP 10B,B00,886491,Dhir; Simrita,8,0,15,7
1746612099195,WCWP 10B,C00,886492,Ornelas; Tricia,0,0,15,15
1746612100222,WCWP 100,A00,886494,Young; Mark T,0,6,15,15
1746612102353,AAS 10,A01,886199,Childs; Dennis R.,0,3,0,0
1746612103381,ANAR 104,A01,886940,Shtienberg; Gilad,27,0,30,3
1746612104405,ANAR 120,A00,886953,Staff,13,0,20,7
1746612105437,ANBI 148,A01,886955,Wilder; Linnea Lorene,30,0,40,10
1746612107488,ANSC 122,A00,886957,Staff,24,0,30,6
1746612108517,ANSC 150,A00,886958,Sloane; Julia Kathryn,2,0,15,13
1746612109543,ANSC 156,A00,886959,Jenkins; Janis A.,0,1,15,15
1746612110568,ANSC 180,A00,886960,Staff,11,0,17,6
1746612111596,ANSC 188,A00,886961,Jassal; Aftab,9,0,25,16
1746612112622,ANSC 190,A00,886962,Jassal; Aftab,14,0,25,11
1746612113647,ANSC 191,A00,886963,Staff,18,0,20,2
1746612114675,ANTH 3,A01,891689,Staff,17,0,20,3
1746612115700,ANTH 5,A00,886933,Semendeferi; Ekaterini,16,0,20,4
1746612116724,ANTH 10,A00,886934,Staff,0,12,30,30
1746612117749,ANTH 21,A01,886936,Staff,41,0,60,19
1746612118773,ANTH 23,A01,886938,Staff,92,0,100,8
1746612119798,ANTH 105,A00,886964,Stewart; Alexander B,84,0,100,16
1746612120823,ANTH 108,A00,886965,Pedersen; David,9,0,20,11
1746612121857,AWP 10,001,886147,Staff,0,0,0,0
1746612121857,AWP 10,002,886148,Staff,0,0,0,0
1746612121857,AWP 10,003,886149,Staff,0,0,0,0
1746612121857,AWP 10,004,886150,Staff,0,0,0,0
1746612121857,AWP 10,005,886151,Staff,0,0,0,0
1746612121857,AWP 10,006,886152,Staff,0,0,0,0
1746612121857,AWP 10,007,886153,Staff,0,0,0,0
1746612121857,AWP 10,008,886154,Staff,0,0,0,0
1746612121857,AWP 10,009,886155,Staff,0,0,0,0
1746612121857,AWP 10,010,886156,Staff,0,0,0,0
1746612121857,AWP 10,011,886158,Staff,0,0,0,0
1746612121857,AWP 10,012,886160,Staff,0,0,0,0
1746612121857,AWP 10,013,886161,Staff,0,0,0,0
1746612121857,AWP 10,014,886162,Staff,0,0,0,0
1746612121857,AWP 10,015,886163,Staff,0,0,0,0
1746612121857,AWP 10,016,886164,Staff,0,0,0,0
1746612121857,AWP 10,017,886165,Staff,0,0,0,0
1746612121857,AWP 10,018,886166,Staff,0,0,0,0
1746612121857,AWP 10,019,886168,Staff,0,0,0,0
1746612121857,AWP 10,020,886170,Staff,0,0,0,0
1746612121857,AWP 10,021,886172,Staff,0,0,0,0
1746612122887,AWP 10R,001,886173,Staff,0,1,0,0
1746612122887,AWP 10R,002,886174,Staff,0,1,0,0
1746612122887,AWP 10R,003,886175,Staff,0,0,0,0
1746612122887,AWP 10R,004,886176,Staff,0,0,0,0
1746612122887,AWP 10R,005,886177,Staff,0,0,0,0
1746612122887,AWP 10R,006,886178,Staff,0,0,0,0
1746612122887,AWP 10R,007,886179,Staff,0,0,0,0
1746612122887,AWP 10R,008,886181,Staff,0,0,0,0
1746612122887,AWP 10R,009,886182,Staff,0,0,0,0
1746612122887,AWP 10R,010,886183,Staff,0,0,0,0
1746612122887,AWP 10R,011,886184,Staff,0,0,0,0
1746612122887,AWP 10R,012,886185,Staff,0,0,0,0
1746612122887,AWP 10R,013,886186,Staff,0,0,0,0
1746612122887,AWP 10R,014,886187,Staff,0,0,0,0
1746612122887,AWP 10R,015,886188,Staff,0,0,0,0
1746612122887,AWP 10R,016,886189,Staff,0,0,0,0
1746612122887,AWP 10R,017,960532,Staff,0,0,0,0
1746612122887,AWP 10R,018,960533,Staff,0,0,0,0
1746612122887,AWP 10R,019,960534,Staff,0,0,0,0
1746612122887,AWP 10R,020,960538,Staff,0,0,0,0
1746612122887,AWP 10R,021,960540,Staff,0,0,0,0
1746612122887,AWP 10R,022,960541,Staff,0,0,0,0
1746612122887,AWP 10R,023,960542,Staff,0,0,0,0
1746612122887,AWP 10R,024,960544,Staff,0,0,0,0
1746612122887,AWP 10R,025,960545,Staff,0,0,0,0
1746612122887,AWP 10R,026,960548,Staff,0,0,0,0
1746612123916,AWP 102R,A00,886190,Staff,0,0,0,0
1746612123916,AWP 102R,B00,886191,Staff,0,0,0,0
1746612124941,BENG 100,A01,886193,Staff,17,0,30,13
1746612125969,BENG 122A,A01,886195,Hasty; Jeff M,13,0,30,17
1746612126998,BENG 166A,A00,886196,Sah; Robert Lie-Yuan,0,3,30,30
1746612128027,BENG 190,A00,958050,Khojah; Reem I,17,0,25,8
1746612129052,BIBC 102,A01,894320,Staff,0,1,46,46
1746612129052,BIBC 102,A02,894321,Staff,0,0,46,46
1746612129052,BIBC 102,A03,894344,Staff,6,0,46,40
1746612129052,BIBC 102,A04,894345,Staff,27,0,47,20
1746612130082,BICD 100R,A01,894365,Smith; Laurie,0,2,58,58
1746612130082,BICD 100R,A02,894366,Smith; Laurie,0,4,58,58
1746612130082,BICD 100R,A03,894367,Smith; Laurie,0,0,59,59
1746612130082,BICD 100R,A04,959869,Smith; Laurie,38,0,59,21
1746612131113,BICD 136,A01,894383,Gustafson-Brown; Cindy,14,0,50,36
1746612132145,BIEB 102,A01,894494,Butler; Shannon Rhey,51,0,130,79
1746612134197,BIEB 150,A01,894617,Wills; Christopher,3,0,20,17
1746612134197,BIEB 150,A02,894631,Wills; Christopher,3,0,20,17
1746612134197,BIEB 150,A03,894937,Wills; Christopher,3,0,20,17
1746612134197,BIEB 150,A04,894946,Wills; Christopher,5,0,20,15
1746612135227,BIEB 194,A00,906141,Kurle; Carolyn M.,5,0,20,15
1746612136252,BILD 1,A01,894154,Staff,3,0,19,16
1746612136252,BILD 1,A02,894155,Staff,14,0,19,5
1746612136252,BILD 1,A03,894160,Staff,13,0,19,6
1746612136252,BILD 1,A04,894161,Staff,15,0,18,3
1746612137281,BILD 2,A01,894168,Staff,0,0,50,50
1746612137281,BILD 2,A02,894169,Staff,0,0,50,50
1746612137281,BILD 2,A03,894179,Staff,0,0,50,50
1746612137281,BILD 2,A04,894203,Staff,22,0,50,28
1746612138311,BILD 3,A01,894213,Staff,23,0,31,8
1746612138311,BILD 3,A02,894214,Staff,26,0,31,5
1746612138311,BILD 3,A03,894235,Staff,28,0,31,3
1746612138311,BILD 3,A04,894236,Staff,28,0,32,4
1746612139337,BILD 4,A01,894253,Reuther; Keefe,5,0,24,19
1746612139337,BILD 4,A02,894258,Reuther; Keefe,16,0,24,8
1746612140366,BILD 5,A01,894276,Reuther; Keefe,33,0,50,17
1746612140366,BILD 5,A02,894277,Reuther; Keefe,45,0,50,5
1746612140366,BILD 5,A03,894290,Reuther; Keefe,44,0,50,6
1746612140366,BILD 5,A04,894291,Reuther; Keefe,48,0,50,2
1746612141395,BILD 24,A01,894297,Pirino; Giorgia,40,0,60,20
1746612142422,BIMM 100,B01,958915,Staff,71,0,100,29
1746612143453,BIMM 101,A01,895017,McDonnell; Lisa Marie,0,5,24,24
1746612143453,BIMM 101,A02,895018,McDonnell; Lisa Marie,0,5,24,24
1746612143453,BIMM 101,B01,895020,McDonnell; Lisa Marie,0,5,24,24
1746612143453,BIMM 101,B02,895021,McDonnell; Lisa Marie,0,4,24,24
1746612144481,BIMM 110,A01,895023,Staff,1,0,25,24
1746612144481,BIMM 110,A02,895024,Staff,9,0,25,16
1746612144481,BIMM 110,A03,895025,Staff,18,0,25,7
1746612144481,BIMM 110,A04,895031,Staff,20,0,25,5
1746612145511,BIMM 120,A01,895114,Gustafson-Brown; Cindy,14,0,28,14
1746612145511,BIMM 120,A02,895126,Gustafson-Brown; Cindy,21,0,27,6
1746612146537,BIPN 100,A01,895130,Yang; Mingyu,0,0,38,38
1746612146537,BIPN 100,A02,895131,Yang; Mingyu,31,0,38,7
1746612146537,BIPN 100,A03,895132,Yang; Mingyu,32,0,38,6
1746612146537,BIPN 100,A04,895133,Yang; Mingyu,27,0,36,9
1746612147564,BIPN 120,A01,895135,Cooke; James Edward,0,3,13,13
1746612147564,BIPN 120,A02,895136,Cooke; James Edward,0,1,13,13
1746612147564,BIPN 120,A03,895137,Cooke; James Edward,0,3,13,13
1746612147564,BIPN 120,A04,895156,Cooke; James Edward,0,2,11,11
1746612148590,BIPN 134,A01,895235,Cooke; James Edward,0,1,25,25
1746612148590,BIPN 134,A02,895237,Cooke; James Edward,0,0,25,25
1746612148590,BIPN 134,A03,895240,Cooke; James Edward,1,0,25,24
1746612148590,BIPN 134,A04,895270,Cooke; James Edward,20,0,25,5
1746612149617,BIPN 189,A00,892103,Staff,0,14,14,14
1746612151669,BISP 194,A00,958008,Staff,0,2,0,0
1746612152696,CAT 124,A01,922009,Staff,0,5,20,20
1746612153721,CAT 125R,A00,886390,Morales; Celeste Georgianna,0,4,20,20
1746612153721,CAT 125R,B00,886391,Irwin; Matthew Joseph,0,4,20,20
1746612153721,CAT 125R,C00,886392,Smith; Lauryn Alissa,0,2,20,20
1746612153721,CAT 125R,D00,886393,Vanderschuit; Maya Alysia,0,3,20,20
1746612153721,CAT 125R,E00,886394,Marchisotto; Jennifer Anne,0,3,20,20
1746612154748,CENG 15,A01,886218,Drews; Aaron,3,0,8,5
1746612155779,CENG 113,A00,886219,Opatkiewicz; Justin Paul,15,0,25,10
1746612156804,CGS 101,A00,887044,Staff,7,0,20,13
1746612157833,CGS 105,A01,887046,Staff,14,0,25,11
1746612158859,CGS 112,A00,887047,Cuong; Marisol,12,0,15,3
1746612159886,CGS 113,A00,887048,Staff,23,0,30,7
1746612160914,CGS 120,A00,887049,Staff,9,0,17,8
1746612161945,CHEM 6A,A01,886336,Lam; Tin Yiu,38,0,50,12
1746612161945,CHEM 6A,A02,886338,Lam; Tin Yiu,37,0,50,13
1746612162971,CHEM 6B,A01,886341,Hopkins; Patrycja Anna,16,0,50,34
1746612162971,CHEM 6B,A02,886343,Hopkins; Patrycja Anna,42,0,50,8
1746612164002,CHEM 6C,A01,886346,Albizati; Kim F.,0,2,50,50
1746612164002,CHEM 6C,A02,886348,Albizati; Kim F.,24,0,50,26
1746612165084,CHEM 40A,A01,886352,Klosterman; Jeremy K,65,0,100,35
1746612166111,CHEM 40B,A01,886356,Klosterman; Jeremy K,0,24,100,100
1746612167137,CHEM 41B,A01,886360,Theodorakis; Emmanuel,25,0,50,25
1746612167137,CHEM 41B,A02,886362,Theodorakis; Emmanuel,47,0,50,3
1746612168164,CHIN 165A,A00,886382,Xu; Li,18,0,20,2
1746612169192,CLAS 120,A00,886387,Myerston Santana; Jacobo,33,0,40,7
1746612170219,COGS 9,A01,886967,Shannon; Kyle Michael,42,0,60,18
1746612171249,COGS 11,A01,886969,Staff,9,0,30,21
1746612172276,COGS 14A,A01,886971,Staff,5,0,60,55
1746612173301,COGS 14B,A01,886973,Hoffman; Drew Ellen,4,0,60,56
1746612174328,COGS 18,A01,886975,Morgan; Eric,34,0,60,26
1746612175353,COGS 20,A01,886977,Staff,3,0,8,5
1746612175353,COGS 20,A02,886978,Staff,5,0,7,2
1746612176377,COGS 100,A01,907783,Staff,0,1,30,30
1746612177404,COGS 101B,A01,886980,Staff,0,4,48,48
1746612178429,COGS 101C,A01,886982,Delgado; Tania,0,5,44,44
1746612179461,COGS 102A,A01,886984,Johnson; Christine M.,3,0,30,27
1746612180489,COGS 118B,A01,886986,Staff,0,4,88,88
1746612181515,COGS 150,A01,886988,Bergen; Benjamin,22,0,50,28
1746612182540,COGS 153,A00,886989,Delgado; Tania,1,3,41,40
1746612183572,COGS 186,A01,886991,Staff,0,0,32,32
1746612184598,COGS 187A,A01,886993,Boyle; Mary E. T.,7,0,30,23
1746612185627,COGS 189,A00,886994,Staff,0,1,30,30
1746612186653,COMM 10,A01,886996,Staff,0,0,20,21
1746612186653,COMM 10,A02,886997,Staff,10,0,20,10
1746612186653,COMM 10,A03,959845,Staff,19,0,20,1
1746612187679,COMM 20,A01,886999,Leuning; Grant Maurstad,24,0,40,16
1746612189732,COMM 100A,A01,887002,Staff,0,0,20,25
1746612189732,COMM 100A,A02,887003,Staff,5,0,20,15
1746612190758,COMM 100B,A01,887005,Staff,0,8,20,24
1746612191787,COMM 106D,A00,887006,Staff,14,0,40,26
1746612192814,COMM 110G,A00,887007,Whitworth-Smith; Andrew C,12,0,40,28
1746612193839,COMM 111B,A00,887008,Staff,31,0,40,9
1746612194873,COMM 113T,A00,887009,Abuelhiga; Soraya Jill,28,0,40,12
1746612194873,COMM 113T,B00,906733,Staff,39,0,40,1
1746612195897,COMM 145,A00,887010,Staff,13,0,40,27
1746612196924,COMM 146,A00,887054,Staff,32,0,40,8
1746612197953,COMM 190,A00,887012,Staff,8,0,23,15
1746612198978,CSE 8A,A50,887015,Cao; Yingjun,56,0,85,29
1746612200004,CSE 11,A01,887017,Cao; Yingjun,11,0,70,59
1746612201033,CSE 20,A01,887019,Staff,30,0,50,20
1746612202058,CSE 21,A01,887021,Staff,79,0,100,21
1746612202058,CSE 21,B01,892583,Braun; Oliver,45,0,50,5
1746612203086,CSE 30,A01,887025,Eldon; John,142,0,200,58
1746612204112,CSE 100,A01,887027,Staff,26,0,50,24
1746612204112,CSE 100,A02,887028,Staff,42,0,50,8
1746612205136,CSE 101,A01,887030,Braun; Oliver,74,0,100,26
1746612205136,CSE 101,B01,887032,Jones; Miles E,0,3,50,50
1746612205136,CSE 101,B02,887033,Jones; Miles E,0,2,50,50
1746612206162,CSE 105,A01,908084,Jones; Miles E,32,0,50,18
1746612206162,CSE 105,A02,908087,Jones; Miles E,31,0,50,19
1746612207192,CSE 135,A01,887035,Powell; Thomas Allan,0,5,50,50
1746612208216,CSE 142,A01,887037,Staff,7,0,60,53
1746612209241,CSE 142L,A01,887039,Staff,34,0,60,26
1746612210267,CSE 151A,A01,887041,Solares; Edwin A,47,0,100,53
1746612211292,CSE 175,A01,887043,Kumar; Rakesh,30,0,30,0
1746612212318,CSS 1,A01,886389,Staff,0,1,40,40
1746612213348,DSC 30,A01,908097,Liao; Soohyun Nam,47,0,75,28
1746612214374,DSC 40A,A01,908099,Shannon; Kyle Michael,30,0,50,20
1746612215400,DSC 40B,A01,908112,Staff,15,0,50,35
1746612216428,DSC 80,A01,908116,Staff,19,0,60,41
1746612217453,DSC 197,001,956863,Eldridge; Justin Matthew,9999,0,9999,0
1746612218481,ECE 5,A01,886400,Morris; Karcher William,1,0,6,5
1746612218481,ECE 5,A02,886401,Morris; Karcher William,3,0,6,3
1746612219509,ECE 148,A01,886403,Silberman; Jack,0,14,14,14
1746612220534,ECON 1,A01,887265,Crane; Meredith Helen,11,0,70,59
1746612220534,ECON 1,B01,887268,Staff,42,0,50,8
1746612221560,ECON 2,A01,887273,Crane; Meredith Helen,54,0,70,16
1746612222588,ECON 3,A01,887279,Rondina; Giacomo,31,0,70,39
1746612223614,ECON 4,A01,887282,Anderson; John Charles,0,2,10,10
1746612224660,ECON 5,A01,887285,Staff,34,0,45,11
1746612224660,ECON 5,B01,887292,Staff,41,0,45,4
1746612225686,ECON 100A,A01,887337,Newhouse; Herbert S,54,0,70,16
1746612225686,ECON 100A,B01,887349,Staff,45,0,50,5
1746612226713,ECON 100B,A01,887361,Du; Songzi,29,0,70,41
1746612227742,ECON 100C,A01,887445,Newhouse; Herbert S,59,0,70,11
1746612228767,ECON 105,A00,887488,Vespa; Emanuel Ignacio,23,0,35,12
1746612229792,ECON 109,A01,887506,Shishkin; Denis,28,0,35,7
1746612230820,ECON 110A,A01,887568,Alon; Titan Michael,0,2,35,35
1746612230820,ECON 110A,B01,907601,Alon; Titan Michael,20,0,35,15
1746612231849,ECON 110B,A01,887598,Levkoff; Steven B.,0,24,70,70
1746612232876,ECON 112,A00,887599,Rondina; Giacomo,19,0,35,16
1746612233902,ECON 120A,A01,887603,Dai; Yinlin,36,0,70,34
1746612234927,ECON 120C,A01,887608,Sun; Yixiao,0,1,35,35
1746612234927,ECON 120C,B01,887614,Sun; Yixiao,0,0,35,35
1746612235955,ECON 138,A00,887621,Bharadwaj; Prashant,0,21,20,20
1746612236983,ECON 144,A00,958007,Squires; Dale E,11,0,35,24
1746612238012,ECON 171,A01,907666,Staff,18,0,35,17
1746612239037,ECON 175,A00,887626,Wu; Pak Yeung,22,0,35,13
1746612240063,ECON 190,A00,887640,Vespa; Emanuel Ignacio,22,0,35,13
1746612241099,EDS 25,A01,888197,Staff,0,0,0,0
1746612241099,EDS 25,A02,888209,Staff,0,0,0,0
1746612241099,EDS 25,A03,888210,Staff,0,0,0,0
1746612241099,EDS 25,A04,888212,Staff,0,0,0,0
1746612241099,EDS 25,A05,888213,Staff,0,0,0,0
1746612241099,EDS 25,A06,888214,Staff,0,0,0,0
1746612241099,EDS 25,A07,888235,Staff,0,2,0,0
1746612241099,EDS 25,A08,888236,Staff,0,0,0,0
1746612241099,EDS 25,A09,888240,Staff,0,0,0,0
1746612241099,EDS 25,A10,888244,Staff,0,0,0,0
1746612241099,EDS 25,B01,888273,Staff,0,0,0,0
1746612241099,EDS 25,B02,888285,Staff,0,0,0,0
1746612241099,EDS 25,B03,888423,Staff,0,0,0,1
1746612241099,EDS 25,B04,888432,Staff,0,0,0,0
1746612241099,EDS 25,B05,888433,Staff,0,0,0,0
1746612241099,EDS 25,B06,888467,Staff,0,0,0,0
1746612241099,EDS 25,B07,888468,Staff,0,0,0,0
1746612241099,EDS 25,B08,888479,Staff,0,0,0,0
1746612241099,EDS 25,B09,888484,Staff,0,0,0,0
1746612241099,EDS 25,B10,888487,Staff,0,0,0,0
1746612242123,EDS 38,A01,907700,Choi; Bailey Miyeon,30,0,30,0
1746612243152,EDS 112,A01,888601,Chapman; Thandeka K,12,0,40,28
1746612244177,EDS 115,A00,888697,Mendez; Kathrina Mendoza,10,0,30,20
1746612245203,EDS 116,A01,888893,Staff,33,0,40,7
1746612247260,EDS 124AR,A00,889133,Staff,29,0,50,21
1746612247260,EDS 124AR,B00,907471,Simon; Elizabeth A,37,0,50,13
1746612248288,EDS 124BR,A00,889134,Simon; Elizabeth A,44,0,100,56
1746612249316,EDS 125,A00,889135,Staff,25,0,30,5
1746612250346,EDS 126,A01,889138,Staff,35,0,40,5
1746612251371,EDS 164R,A01,889142,Wishard Guerra; Alison G.,32,0,50,18
1746612252407,ENG 30,A01,886396,Staff,0,0,0,0
1746612252407,ENG 30,B01,886398,Staff,0,0,0,0
1746612253432,ENVR 102,A00,906150,Montejo; Carolina,23,0,25,2
1746612254461,ETHN 103A,A00,887236,Man; Simeon S,0,2,0,0
1746612255490,ETHN 113,A00,887239,Staff,16,0,30,14
1746612256515,ETHN 116,A00,887240,Staff,16,0,25,9
1746612257540,ETHN 117,A00,887241,Choi; Esther Min,28,0,30,2
1746612258565,ETHN 118,A00,887243,Staff,24,0,30,6
1746612259594,ETHN 127,A00,887248,Cuong; Marisol,11,0,15,4
1746612260619,ETHN 139,A00,887250,Staff,7,0,10,3
1746612261643,ETHN 142,A00,887252,Staff,9,0,30,21
1746612262674,ETHN 161,A00,887253,Browne; Errol Tsekani,24,0,30,6
1746612263699,ETHN 163FR,A00,887255,Burelle; Julie Sara Veronique,0,0,5,5
1746612264724,GLBH 20,A00,889149,Elwardani; Nile Regina,8,0,42,34
1746612266774,GLBH 111,A01,889152,Burgos; Jose L.,17,0,17,0
1746612267802,GLBH 150,A00,889181,Sloane; Julia Kathryn,0,5,15,15
1746612269858,HDS 60,A01,886406,Warstadt; Melissa Fawn,72,0,80,8
1746612270884,HIAF 111,A00,889324,Gyamfi; Bright,25,0,32,7
1746612271912,HIEA 131,A00,889328,Staff,15,0,32,17
1746612272937,HIEA 144,A00,889333,Henry; Todd A.,26,0,32,6
1746612273964,HIEA 154,A00,889336,Henry; Todd A.,24,0,32,8
1746612274993,HIEU 106,A00,889339,Staff,22,0,32,10
1746612277048,HIEU 114,A00,889340,Staff,4,0,32,28
1746612278075,HIEU 135GS,A00,889342,Patterson; Patrick H.,0,0,1,24
1746612279100,HIEU 137,A00,889343,Edington; Claire Ellen,10,0,25,15
1746612280125,HIEU 148,A00,889345,Staff,14,0,32,18
1746612281151,HIEU 154,A00,889346,Biess; Frank Peter,21,0,32,11
1746612282218,HILA 102,A00,889351,Staff,12,0,32,20
1746612283242,HILD 2A,A01,889221,Lewandoski; Julia Mavis,0,8,32,32
1746612284267,HILD 7B,A01,889225,Man; Simeon S,0,12,32,32
1746612285292,HILD 7C,A01,889288,Alvarez; Luis A,0,14,32,32
1746612286318,HILD 30,A01,889323,Staff,0,5,32,32
1746612288369,HISC 119,A00,889383,Golan; Tal,20,0,32,12
1746612289396,HIUS 103,A00,889384,Man; Simeon S,0,0,32,32
1746612290427,HIUS 117,A00,919797,Kwak; Nancy,18,0,32,14
1746612291452,HIUS 142A,A00,919788,Staff,22,0,32,10
1746612293504,HIUS 149,A00,889386,Gyamfi; Bright,26,0,32,6
1746612294532,HIUS 155,A00,889387,Alvarez; Luis A,15,0,32,17
1746612295559,HUM 3,A01,886499,Caldwell; Michael Alan,19,0,50,31
1746612296586,HUM 3GS,A00,886500,Rodriguez; Bretton Sigfred,0,0,0,28
1746612297613,HUM 3R,A01,886502,Markman; Kristina,0,36,50,50
1746612298641,HUM 4,A01,886504,Crum; Matthew Stephen,23,0,50,27
1746612298641,HUM 4,B01,886506,West; Geoffrey Scott,17,0,50,33
1746612299667,HUM 4GS,A00,886507,Staff,0,0,0,19
1746612300692,HUM 5,A01,886509,Staff,31,0,50,19
1746612301724,HUM 5R,A01,886511,Zavodny; Tatiana Sophia,0,39,50,50
1746612302750,JAPN 180,A00,886407,Staff,16,0,40,24
1746612303783,LATI 50,A01,886409,Martin-Cabrera; Luis,3,0,22,19
1746612303783,LATI 50,A02,886410,Martin-Cabrera; Luis,19,0,22,3
1746612303783,LATI 50,A03,886411,Martin-Cabrera; Luis,21,0,22,1
1746612303783,LATI 50,A04,886412,Martin-Cabrera; Luis,8,0,22,14
1746612304811,LAWS 101,A00,907664,Staff,28,0,60,32
1746612305835,LIAB 1A,A00,889388,Saab; Dima,17,0,20,3
1746612306860,LIAB 1AX,A00,889389,El Cheddadi; Youniss,18,0,20,2
1746612307888,LIFR 1C,A00,889391,Van Moer; Vinciane G,8,0,20,12
1746612308914,LIFR 1CX,A00,889392,Van Moer; Vinciane G,7,0,20,13
1746612309942,LIFR 1D,A00,889393,Van Moer; Vinciane G,7,0,20,13
1746612310971,LIFR 1DX,A00,889394,Van Moer; Vinciane G,8,0,20,12
1746612312000,LIGN 7,A00,886923,Staff,25,0,50,25
1746612313026,LIGN 17,A00,886924,Kehler; Andrew Scott,126,0,150,24
1746612314053,LTAM 110,A00,889395,Staff,15,0,30,15
1746612315078,LTAM 110GS,A00,958010,Rodriguez; Bretton Sigfred,0,0,0,28
1746612316105,LTCH 101,A00,889397,Staff,23,0,25,2
1746612317138,LTCS 130,A00,889398,Staff,23,0,25,2
1746612318162,LTEA 138,A00,889399,Staff,24,0,40,16
1746612319189,LTEN 149,A00,889400,Wesling; Megan E.,0,3,25,25
1746612320217,LTEN 169,A00,889401,Staff,20,0,25,5
1746612321245,LTEN 180,A00,889402,Staff,10,0,15,5
1746612322272,LTEN 181,A00,889403,Staff,21,0,25,4
1746612323295,LTWL 100,A00,889404,Myerston Santana; Jacobo,2,0,25,23
1746612324323,LTWL 180GS,A00,889405,Staff,0,0,20,20
1746612325347,LTWL 181,A00,889406,Staff,16,0,25,9
1746612326372,LTWL 184,A00,889475,Mukherjee; Silpa,22,0,25,3
1746612327397,LTWR 102C,A00,889486,Staff,29,0,30,1
1746612328421,LTWR 115W,A00,889491,Staff,0,2,15,15
1746612329451,MAE 8,A01,886905,Staff,0,2,0,0
1746612330481,MAE 11,A00,886906,Bandaru; Prabhakar,0,7,50,50
1746612331506,MAE 20,A00,886907,Evdokimenko; Ekaterina,43,0,70,27
1746612332533,MAE 30B,A00,886909,Ghazinejad; Maziar,25,0,45,20
1746612333558,MAE 101B,A00,886910,Saintillan; David,30,0,45,15
1746612334584,MAE 105,A00,886911,Bandaru; Prabhakar,18,0,50,32
1746612335610,MAE 107,B00,958024,Staff,7,0,50,43
1746612336639,MAE 143B,A00,886913,Bewley; Thomas R,2,0,40,38
1746612337667,MAE 148,A01,886915,Silberman; Jack,0,3,14,14
1746612338692,MAE 160,A00,886916,Evdokimenko; Ekaterina,30,0,60,30
1746612339717,MATH 3C,A01,889681,Staff,0,2,30,30
1746612339717,MATH 3C,A02,960048,Staff,23,0,30,7
1746612340743,MATH 10A,A01,889760,Staff,26,0,30,4
1746612340743,MATH 10A,A02,889783,Staff,29,0,30,1
1746612341770,MATH 10B,A01,889785,Verstraete; Jacques Allan,1,0,35,34
1746612341770,MATH 10B,A02,889795,Verstraete; Jacques Allan,4,0,35,31
1746612341770,MATH 10B,B01,889797,Verstraete; Jacques Allan,3,0,35,32
1746612341770,MATH 10B,B02,889828,Verstraete; Jacques Allan,3,0,35,32
1746612342798,MATH 10C,A01,889849,Habib; Yousaf,8,0,30,22
1746612342798,MATH 10C,A02,889852,Habib; Yousaf,14,0,30,16
1746612342798,MATH 10C,A03,889853,Habib; Yousaf,22,0,30,8
1746612342798,MATH 10C,A04,889858,Habib; Yousaf,20,0,30,10
1746612342798,MATH 10C,B01,889861,Staff,1,0,30,29
1746612342798,MATH 10C,B02,889862,Staff,24,0,30,6
1746612342798,MATH 10C,B03,889863,Staff,27,0,30,3
1746612342798,MATH 10C,B04,889967,Staff,23,0,30,7
1746612343823,MATH 18,A01,889974,Staff,6,0,30,24
1746612343823,MATH 18,A02,889977,Staff,20,0,30,10
1746612343823,MATH 18,B01,889984,Hardiman; Liam,20,0,30,10
1746612343823,MATH 18,B02,889985,Hardiman; Liam,25,0,30,5
1746612344853,MATH 20A,A01,889990,Suk; Andrew Hoon,30,0,35,5
1746612345879,MATH 20B,A01,889993,Ohm; Ko Woon,21,0,30,9
1746612345879,MATH 20B,A02,889994,Ohm; Ko Woon,30,0,30,0
1746612345879,MATH 20B,B01,889996,Ohm; Ko Woon,22,0,30,8
1746612345879,MATH 20B,B02,889997,Ohm; Ko Woon,23,0,30,7
1746612346904,MATH 20C,A01,889999,Hammock; Frances H,17,0,30,13
1746612346904,MATH 20C,A02,890003,Hammock; Frances H,23,0,30,7
1746612346904,MATH 20C,B01,890006,Hammock; Frances H,2,0,30,28
1746612346904,MATH 20C,B02,890007,Hammock; Frances H,11,0,30,19
1746612347930,MATH 20D,A01,890011,Cheng; Hsiao-Bing,1,0,30,29
1746612347930,MATH 20D,A02,890012,Cheng; Hsiao-Bing,14,0,30,16
1746612347930,MATH 20D,B01,890016,Cheng; Hsiao-Bing,13,0,30,17
1746612347930,MATH 20D,B02,890017,Cheng; Hsiao-Bing,13,0,30,17
1746612348956,MATH 20E,A01,890026,Harel; Guershon,1,0,30,29
1746612348956,MATH 20E,A02,890029,Harel; Guershon,22,0,30,8
1746612348956,MATH 20E,B01,890033,Harel; Guershon,7,0,30,23
1746612348956,MATH 20E,B02,890101,Harel; Guershon,21,0,30,9
1746612349983,MATH 102,A01,890104,Staff,18,0,30,12
1746612349983,MATH 102,A02,890105,Staff,27,0,30,3
1746612351010,MATH 103B,A01,890116,Salehi Golsefidy; Alireza,3,0,30,27
1746612351010,MATH 103B,B01,890118,Staff,0,3,34,34
1746612352039,MATH 109,A01,890121,Aliabadi Sr.; Mohsen,0,0,30,30
1746612352039,MATH 109,B01,890124,Upadrashta; Pranav Kumar,18,0,30,12
1746612353064,MATH 120A,A01,890126,Eggers; John Dietrich,13,0,30,17
1746612354088,MATH 142B,A01,890128,Ioana; Adrian,19,0,30,11
1746612354088,MATH 142B,A02,890129,Ioana; Adrian,12,0,30,18
1746612355114,MATH 154,A01,890174,Staff,0,1,30,30
1746612355114,MATH 154,A02,890182,Staff,0,0,30,30
1746612356140,MATH 168A,A01,890197,Dumitriu; Ioana,21,0,35,14
1746612357171,MATH 170A,A01,890240,Nie; Jiawang,1,0,30,29
1746612357171,MATH 170A,A02,890241,Nie; Jiawang,11,0,30,19
1746612357171,MATH 170A,A03,890249,Nie; Jiawang,23,0,30,7
1746612358199,MATH 170B,A01,957891,Nag; Panchali,13,0,35,22
1746612360258,MATH 181A,A01,908025,Staff,0,3,35,35
1746612360258,MATH 181A,A02,960115,Staff,26,0,35,9
1746612361285,MATH 181B,A01,959874,Staff,24,0,30,6
1746612362311,MATH 193B,A01,890265,Staff,0,4,35,35
1746612363337,MGT 4,A01,890311,Anderson; John Charles,42,0,88,46
1746612364362,MGT 5,A00,907740,Staff,12,0,98,86
1746612365389,MGT 12,A00,890312,Lindenberger; Wade Douglas,67,0,98,31
1746612366417,MGT 16,A00,957883,Staff,78,0,98,20
1746612368474,MGT 45,A00,890314,Pecore; Joseph P.,45,0,98,53
1746612369504,MGT 71,A00,890315,Staff,0,12,98,98
1746612370537,MGT 100,A00,890316,Yavorsky; Daniel Ryan,44,0,98,54
1746612371561,MGT 103,A00,890317,Ehrich; Kristine R,73,0,98,25
1746612372589,MGT 105,A00,890356,Bates; Kenneth Walter,0,8,98,98
1746612373614,MGT 112,A00,890360,Ehrich; Kristine R,55,0,98,43
1746612374642,MGT 127R,A00,907732,Zhu; Kevin Xiaoguo,23,0,98,75
1746612375667,MGT 131B,A00,890361,Anderson; John Charles,59,0,98,39
1746612376692,MGT 137,A00,890362,Lindenberger; Wade Douglas,65,0,98,33
1746612377719,MGT 160,A00,890369,Johnson; Erik Barry,9,0,98,89
1746612379772,MGT 164,A00,890372,Zimmermann; Carsten,0,40,98,98
1746612380799,MGT 180,A00,890374,Bliss; Barbara Ann,11,0,98,87
1746612381826,MMW 15,A01,886414,Chang; Edmond Yi-Teh,0,12,28,28
1746612381826,MMW 15,A02,886415,Chang; Edmond Yi-Teh,0,8,28,28
1746612381826,MMW 15,A03,886416,Chang; Edmond Yi-Teh,0,9,28,28
1746612381826,MMW 15,A04,886417,Chang; Edmond Yi-Teh,0,8,28,28
1746612381826,MMW 15,B01,886419,Chang; Edmond Yi-Teh,0,7,28,28
1746612381826,MMW 15,B02,886420,Chang; Edmond Yi-Teh,0,7,28,28
1746612381826,MMW 15,B03,886421,Chang; Edmond Yi-Teh,0,7,28,28
1746612381826,MMW 15,B04,886422,Chang; Edmond Yi-Teh,0,8,28,28
1746612381826,MMW 15,C01,886424,Staff,0,9,28,28
1746612381826,MMW 15,C02,886425,Staff,0,8,28,28
1746612381826,MMW 15,C03,886426,Staff,0,8,28,28
1746612381826,MMW 15,C04,886427,Staff,0,8,28,28
1746612381826,MMW 15,C05,958038,Staff,0,8,28,28
1746612381826,MMW 15,C06,958039,Staff,0,7,28,28
1746612382851,MMW 15GS,A00,906910,Patterson; Patrick H.,4,0,28,24
1746612383881,MMW 122R,A01,886429,Rahimi; Babak,0,13,28,28
1746612383881,MMW 122R,A02,886430,Rahimi; Babak,0,12,28,28
1746612383881,MMW 122R,A03,958040,Rahimi; Babak,0,11,28,28
1746612384907,MUS 1A,A01,890937,Staff,2,0,25,23
1746612384907,MUS 1A,A02,891035,Staff,6,0,25,19
1746612384907,MUS 1A,C01,958912,Staff,24,0,25,1
1746612384907,MUS 1A,C02,958913,Staff,25,0,25,0
1746612386960,MUS 2AK,A00,957092,Ohnishi; Takae,15,0,15,0
1746612387990,MUS 4,A01,891044,Staff,0,0,25,25
1746612387990,MUS 4,A02,891045,Staff,22,0,25,3
1746612387990,MUS 4,B01,891048,Staff,17,0,25,8
1746612387990,MUS 4,B02,891050,Staff,25,0,25,0
1746612389016,MUS 5,A01,957506,Dubnov; Shlomo,0,0,25,25
1746612389016,MUS 5,A02,957622,Dubnov; Shlomo,12,0,25,13
1746612389016,MUS 5,A03,957623,Dubnov; Shlomo,20,0,25,5
1746612390043,MUS 6,A01,891053,Freitas Caetano; Marcelo,24,0,25,1
1746612390043,MUS 6,A02,891054,Freitas Caetano; Marcelo,23,0,25,2
1746612391072,MUS 7,A01,891081,Staff,0,0,25,25
1746612391072,MUS 7,A02,891082,Staff,3,0,25,22
1746612392099,MUS 8GS,A00,891118,Borgo; David Garcia,1,0,25,24
1746612393125,MUS 11,A01,891140,Staff,8,0,25,17
1746612393125,MUS 11,A02,891141,Staff,21,0,25,4
1746612394154,MUS 13,A01,891143,Staff,8,0,25,17
1746612394154,MUS 13,A02,891144,Staff,24,0,25,1
1746612395183,MUS 15,A01,891146,Staff,9,0,25,16
1746612395183,MUS 15,A02,891148,Staff,21,0,25,4
1746612395183,MUS 15,B01,891150,Staff,18,0,25,7
1746612395183,MUS 15,B02,891151,Staff,25,0,25,0
1746612396208,MUS 20,A01,891153,Staff,5,0,20,15
1746612396208,MUS 20,A02,891155,Staff,14,0,20,6
1746612397234,MUS 80,A00,891156,Staff,19,0,25,6
1746612397234,MUS 80,B00,891157,Staff,23,0,25,2
1746612398259,MUS 130,A00,891158,Ohnishi; Takae,35,0,35,0
1746612399285,MUS 150GS,A01,891160,Borgo; David Garcia,1,0,25,24
1746612400310,MUS 170,A01,891162,Freitas Caetano; Marcelo,20,0,25,5
1746612400310,MUS 170,A02,891164,Freitas Caetano; Marcelo,21,0,25,4
1746612401338,NANO 11,A00,886220,Vazquez Mena; Oscar,13,0,15,2
1746612402367,NANO 15,A01,886222,Drews; Aaron,4,0,7,3
1746612403392,NANO 104,A00,886224,Sirbuly; Donald,17,0,25,8
1746612404418,PH 40,A00,886528,Staff,23,0,40,17
1746612405443,PH 45,A01,886799,Staff,35,0,40,5
1746612406471,PH 110,A00,886802,Staff,0,6,40,40
1746612407498,PH 172,A00,906716,Staff,19,0,35,16
1746612408523,PH 191,A00,886803,Staff,6,0,40,34
1746612409621,PHIL 1,A00,889500,Staff,20,0,30,10
1746612410646,PHIL 10,A01,889549,Grush; Rick Scott,16,0,22,6
1746612410646,PHIL 10,A02,889551,Grush; Rick Scott,22,0,22,0
1746612411672,PHIL 28,A01,889559,Lamey; Andy M.,0,2,31,31
1746612411672,PHIL 28,A02,889561,Lamey; Andy M.,0,1,30,30
1746612411672,PHIL 28,A03,889572,Lamey; Andy M.,0,1,30,30
1746612412700,PHIL 35,A00,907839,Staff,13,0,15,2
1746612413729,PHIL 60,A00,889574,Staff,73,0,90,17
1746612414754,PHIL 101,A00,958004,Staff,12,0,15,3
1746612416808,PHIL 136,A00,889582,Fulkerson; Matthew Todd,26,0,45,19
1746612417839,PHIL 163,A01,889601,Staff,21,0,30,9
1746612417839,PHIL 163,B01,889606,Brandt; Reuven A,0,3,0,0
1746612418868,PHIL 164,A00,889610,Staff,16,0,30,14
1746612419894,PHIL 165,A00,889613,Staff,22,0,30,8
1746612420923,PHYS 1A,A00,886431,Staff,30,0,70,40
1746612421949,PHYS 1AL,001,886432,Tsai; Philbert S,0,1,30,30
1746612421949,PHYS 1AL,002,886436,Tsai; Philbert S,13,0,30,17
1746612422975,PHYS 1B,A00,886439,Staff,184,0,240,56
1746612424004,PHYS 1BL,001,886441,Tsai; Philbert S,0,4,30,30
1746612424004,PHYS 1BL,002,886444,Tsai; Philbert S,2,0,30,28
1746612425032,PHYS 1C,A00,896092,Arnold; Kam S,78,0,146,68
1746612426060,PHYS 1CL,001,886448,Tsai; Philbert S,0,1,30,30
1746612426060,PHYS 1CL,002,886449,Tsai; Philbert S,1,0,30,29
1746612426060,PHYS 1CL,003,886450,Tsai; Philbert S,16,0,30,14
1746612426060,PHYS 1CL,004,886451,Tsai; Philbert S,15,0,30,15
1746612427086,PHYS 2B,A01,886457,Staff,67,0,115,48
1746612428111,PHYS 2C,A01,886460,Shotwell; Brian,0,9,65,65
1746612429142,PHYS 2CL,A01,886467,Staff,0,4,28,28
1746612429142,PHYS 2CL,A02,886468,Staff,0,3,28,28
1746612430169,PHYS 2D,A01,886470,Staff,10,0,50,40
1746612431198,PHYS 4B,A01,886475,Grinstein; Benjamin,22,0,40,18
1746612432223,POLI 5,A00,891173,Desposato; Scott,7,0,25,18
1746612433270,POLI 5D,A01,891175,Staff,5,0,5,0
1746612433270,POLI 5D,B01,891178,Staff,5,0,5,0
1746612434295,POLI 11,A00,891179,Ferree; Karen E,0,0,35,35
1746612435322,POLI 12,A00,891180,Staff,15,0,30,15
1746612436347,POLI 27,A01,891182,Staff,11,0,75,64
1746612437373,POLI 30,A00,891183,Staff,8,0,50,42
1746612438402,POLI 100B,A00,891244,Staff,5,1,35,30
1746612439427,POLI 100I,A00,891247,Staff,7,0,30,23
1746612440452,POLI 104J,A00,891248,Nichter; Maysa,14,0,30,16
1746612441478,POLI 104U,A00,891250,Nichter; Maysa,1,0,30,29
1746612443526,POLI 110B,A00,891255,Wiens; David,19,0,25,6
1746612444550,POLI 112A,A00,891256,Wiens; David,6,0,25,19
1746612445576,POLI 114BR,A00,891261,Staff,19,0,30,11
1746612446601,POLI 117R,A00,891262,Forman; Fonna,0,6,50,50
1746612447630,POLI 118,A00,891264,Ingham; Sean,17,0,25,8
1746612448655,POLI 124A,A00,891265,Staff,18,0,20,2
1746612449681,POLI 125D,A00,891266,Nichter; Simeon C,2,0,25,23
1746612450707,POLI 126,A00,891268,Nichter; Simeon C,7,0,25,18
1746612451732,POLI 126AA,A00,891272,Staff,15,0,25,10
1746612452761,POLI 130AA,A00,891273,Staff,15,0,20,5
1746612453792,POLI 134AA,A00,891274,Staff,4,0,20,16
1746612455851,POLI 138,A00,891278,Staff,21,0,25,4
1746612456879,POLI 142K,A00,891280,Staff,10,0,25,15
1746612457904,POLI 142M,A00,891281,Gartzke; Erik,16,0,30,14
1746612458932,POLI 142P,A00,891284,Staff,20,0,30,10
1746612459957,POLI 143,A00,891285,Gartzke; Erik,12,0,30,18
1746612460985,POLI 153,A00,891286,Staff,19,0,20,1
1746612463039,POLI 175,A00,891290,Staff,15,0,20,5
1746612464065,PSYC 1,A00,890674,Steiner; Eric Tomas,0,11,45,45
1746612465091,PSYC 2,A00,890676,Albright; Thomas D,20,0,35,15
1746612466120,PSYC 3,A00,890679,Staff,17,0,20,3
1746612467149,PSYC 6,A00,959858,Staff,19,0,20,1
1746612468174,PSYC 60,A01,890684,Rickard; Timothy C.,0,6,45,45
1746612469200,PSYC 70,A01,890689,Geller; Emma Harlan,6,0,30,24
1746612470225,PSYC 71,A01,959860,Staff,21,0,25,4
1746612471254,PSYC 100,A00,890690,Lacefield; Katharine I,0,50,180,180
1746612472278,PSYC 102,A00,890695,Staff,18,0,40,22
1746612473303,PSYC 105,A00,890699,Geller; Emma Harlan,70,0,100,30
1746612474331,PSYC 106,A00,890701,Gorman; Michael R.,5,0,30,25
1746612475356,PSYC 108,A00,890704,Adrian; Julia Anna,0,29,50,50
1746612476382,PSYC 118,A01,890712,Staff,11,0,30,19
1746612477409,PSYC 124,A00,890716,Chapman; Eddie Nathaniel,25,0,60,35
1746612478435,PSYC 131,A00,890717,Anagnostaras; Stephan,0,7,80,80
1746612479463,PSYC 137,A00,890719,Winkielman; Piotr,0,11,30,30
1746612480488,PSYC 144,A00,890721,Adrian; Julia Anna,0,9,45,45
1746612481517,PSYC 162,A00,890805,Staff,0,2,75,75
1746612482546,PSYC 169,A00,890810,Staff,0,15,30,30
1746612483572,PSYC 172,A00,890814,Gorman; Michael R.,9,0,30,21
1746612484600,PSYC 181,A00,890818,Anagnostaras; Stephan,6,0,200,194
1746612485630,PSYC 184,A00,959861,Staff,160,0,175,15
1746612486656,PSYC 189,A00,890823,Staff,0,2,30,30
1746612487683,PSYC 191,A00,890884,Rickard; Timothy C.,0,12,35,35
1746612488714,PSYC 193,A00,890913,Staff,19,0,30,11
1746612488714,PSYC 193,B00,890914,Chapman; Eddie Nathaniel,24,0,30,6
1746612489742,PSYC 193L,A01,890918,Lowe; Angela Beth,20,0,30,10
1746612489742,PSYC 193L,B01,890921,Hurwitz; Ethan Scott,20,0,30,10
1746612489742,PSYC 193L,C01,890928,Staff,30,0,30,0
1746612490771,RELI 149,A00,886806,Rahimi; Babak,23,0,40,17
1746612491796,SE 9,A01,886814,Staff,7,0,20,13
1746612492824,SE 101B,A01,886816,Chadha; Mayank,3,0,35,32
1746612493851,SE 110B,A00,886818,Zhu; Qiang,4,0,75,71
1746612494878,SE 125,A01,886830,Staff,10,0,30,20
1746612495908,SE 130B,A01,886835,Staff,14,0,40,26
1746612496936,SE 131A,A01,886838,Krysl; Petr,34,0,55,21
1746612497963,SE 154,A00,886840,Staff,28,0,50,22
1746612498993,SE 164GS,A01,886849,Staff,6,0,20,14
1746612500021,SE 167GS,A01,886853,Staff,6,0,20,14
1746612501049,SIO 25,A01,890107,Staff,19,0,30,11
1746612502074,SIO 45,A00,890109,Cook; Geoffrey W,114,0,200,86
1746612503101,SIO 109R,A00,890110,Forman; Fonna,0,16,20,20
1746612504127,SIO 187,A01,890114,Kacev; David,15,0,40,25
1746612505154,SOCI 1,A01,890431,Thorpe; Charles Robert,14,0,30,16
1746612505154,SOCI 1,A02,890518,Thorpe; Charles Robert,30,0,30,0
1746612506182,SOCI 2,A01,957978,Staff,25,0,25,0
1746612506182,SOCI 2,A02,957979,Staff,23,0,25,2
1746612507209,SOCI 20,A01,890523,Calderon-Zaks; Michael Aar,21,0,30,9
1746612507209,SOCI 20,A02,890526,Calderon-Zaks; Michael Aar,29,0,30,1
1746612508234,SOCI 30,A01,890533,Pardo Guerra; Juan Pablo,37,0,40,3
1746612509262,SOCI 40,A01,890535,Staff,27,0,45,18
1746612510293,SOCI 104Q,A00,890559,Staff,17,0,30,13
1746612511321,SOCI 106,A00,890560,Arnal; Maud Marie Leonie,20,0,30,10
1746612512348,SOCI 110,A00,890567,Holkenbrink-Monk; Charlene,19,0,30,11
1746612513380,SOCI 112,A00,890568,Victoria Torres; Pablo,2,0,55,53
1746612514405,SOCI 115,A00,890597,Arnal; Maud Marie Leonie,28,0,45,17
1746612516462,SOCI 121,A00,890604,Pardo Guerra; Juan Pablo,38,0,45,7
1746612517488,SOCI 126,A01,890608,Staff,8,0,10,2
1746612518515,SOCI 127,A00,890609,Staff,18,0,30,12
1746612519544,SOCI 131,A00,890610,Thorpe; Charles Robert,37,0,45,8
1746612520570,SOCI 135,A00,890615,Payne; Christine Anna,14,0,45,31
1746612521599,SOCI 139,A00,890620,Staff,38,0,45,7
1746612522628,SOCI 148E,A00,890622,Calderon-Zaks; Michael Aar,36,0,45,9
1746612523656,SOCI 150,A00,890623,Kohler; Kristopher M.,31,0,45,14
1746612524683,SOCI 157,A00,890625,Jules-Rosette; Bennetta W.,18,0,20,2
1746612525711,SOCI 160,A00,890627,Payne; Christine Anna,21,0,45,24
1746612526741,SYN 1,A00,886855,Fish; Gwendolyn Anne,0,1,0,0
1746612526741,SYN 1,B00,906086,Fish; Gwendolyn Anne,0,2,0,2
1746612527767,SYN 2R,A00,886860,Staff,0,17,15,15
1746612527767,SYN 2R,B00,906106,Atkinson; Arthur Laird,0,16,15,15
1746612528794,SYN 100,A01,886866,Browne; Emily,0,28,20,20
1746612528794,SYN 100,B01,906128,Rock; Martin,0,4,20,20
1746612528794,SYN 100,C01,906140,Deavenport; James Cary,0,4,20,20
1746612528794,SYN 100,D01,907816,Deavenport; James Cary,0,5,20,20
1746612529822,TDAC 1,A00,890286,Walsh; Kim C.,7,0,20,13
1746612530848,TDAC 101,A00,890296,Basso; Beatrice,15,0,20,5
1746612531873,TDDE 131,A00,890297,Staff,47,0,50,3
1746612532900,TDDM 1,A00,890287,Weinberg; Sadie,25,0,30,5
1746612533930,TDGE 11,A00,890288,Fulton; Julia,138,0,200,62
1746612533930,TDGE 11,B00,890289,Castro; Robert Jess,184,0,200,16
1746612534955,TDGE 25,B00,957359,Walsh; Kim C.,5,0,20,15
1746612535982,TDGE 40,A01,890292,Power; Jade Yukana,26,0,30,4
1746612537010,TDGE 124,A00,890298,Havis; Allan,0,2,50,50
1746612538035,TDGE 131R,A00,890299,Burelle; Julie Sara Veronique,15,0,42,27
1746612539061,TDHT 101,A00,890300,Staff,10,0,20,10
1746612540087,TDHT 109,A01,890302,Anderson; Mysia Anyse,31,0,40,9
1746612541112,TDMV 1,A00,890293,Arcidiacono; Kristin,18,0,30,12
1746612542137,TDMV 2,A00,890294,Weinberg; Sadie,23,0,30,7
1746612543173,TDMV 3,A00,957878,Arcidiacono; Kristin,28,0,30,2
1746612545237,TDMV 138,A00,890304,Jun; Grace Shin Hae,25,0,40,15
1746612546266,TDMV 140,A00,890305,Corrales; Joseph Bernales,25,0,30,5
1746612547317,TDMV 142,A00,890307,Caligagan; Tony,32,0,40,8
1746612548346,TDMV 144,A00,890308,Camaya; Michelle Ann,25,0,30,5
1746612549376,TDPW 1,A00,890295,Stein; Deborah Isobel,3,0,20,17
1746612550402,USP 2,A01,890272,Lerner; Amy M,7,0,20,13
1746612551430,USP 3,A01,890274,Staff,12,0,30,18
1746612552456,USP 15,A01,890276,Sun; Feiyang,16,0,30,14
1746612553481,USP 25,A00,890277,Shenkman; Michael Thomas,18,0,25,7
1746612554508,USP 138,A00,890278,Staff,13,0,25,12
1746612555539,USP 143,A00,890279,Staff,21,0,70,49
1746612556565,USP 144,A00,890280,Chowdhury; Muhammed Zohir,16,0,30,14
1746612557591,USP 150,A00,890281,Boomhower; Matthew Charles,4,0,30,26
1746612558618,USP 151,A00,890282,Staff,16,0,20,4
1746612559644,USP 162,A00,890283,Andrews; Abigail Leslie,16,0,20,4
1746612560672,USP 168,A00,920477,Kwak; Nancy,0,0,5,5
1746612561696,USP 181,A00,890284,Staff,3,0,20,17
1746612562722,USP 191A,A00,890285,Staff,12,0,20,8
1746612563746,VIS 101,A00,886512,Staff,26,0,75,49
1746612564772,VIS 103,A00,886513,Cruz; Edwin Teddy,61,0,75,14
1746612565801,VIS 108,A00,886514,Staff,4,0,15,11
1746612566826,VIS 127P,A00,886515,Shen; Kuiyi,80,0,146,66
1746612567852,VIS 149,A00,886516,Yoldas; Pinar,0,0,15,15
1746612568880,VIS 164,A00,886526,Erdmann; Dean,19,0,22,3
1746612569904,VIS 194S,A00,886527,Staff,61,0,75,14
1746612570932,WCWP 10A,C00,886484,Martiniuk; Jill,12,0,15,3
1746612571958,WCWP 10B,A00,886490,Uriarte; Emma,0,0,15,15
1746612571958,WCWP 10B,B00,886491,Dhir; Simrita,8,0,15,7
1746612571958,WCWP 10B,C00,886492,Ornelas; Tricia,0,0,15,15
1746612572985,WCWP 100,A00,886494,Young; Mark T,0,6,15,15
1746612575136,AAS 10,A01,886199,Childs; Dennis R.,0,3,0,0
1746612576165,ANAR 104,A01,886940,Shtienberg; Gilad,27,0,30,3
1746612577192,ANAR 120,A00,886953,Staff,13,0,20,7
1746612578221,ANBI 148,A01,886955,Wilder; Linnea Lorene,30,0,40,10
1746612580274,ANSC 122,A00,886957,Staff,24,0,30,6
1746612581299,ANSC 150,A00,886958,Sloane; Julia Kathryn,2,0,15,13
1746612582325,ANSC 156,A00,886959,Jenkins; Janis A.,0,1,15,15
1746612583352,ANSC 180,A00,886960,Staff,11,0,17,6
1746612584380,ANSC 188,A00,886961,Jassal; Aftab,9,0,25,16
1746612585407,ANSC 190,A00,886962,Jassal; Aftab,14,0,25,11
1746612586431,ANSC 191,A00,886963,Staff,18,0,20,2
1746612587458,ANTH 3,A01,891689,Staff,17,0,20,3
1746612588486,ANTH 5,A00,886933,Semendeferi; Ekaterini,16,0,20,4
1746612589512,ANTH 10,A00,886934,Staff,0,12,30,30
1746612590540,ANTH 21,A01,886936,Staff,41,0,60,19
1746612591569,ANTH 23,A01,886938,Staff,92,0,100,8
1746612592599,ANTH 105,A00,886964,Stewart; Alexander B,84,0,100,16
1746612593625,ANTH 108,A00,886965,Pedersen; David,9,0,20,11
1746612594653,AWP 10,001,886147,Staff,0,0,0,0
1746612594653,AWP 10,002,886148,Staff,0,0,0,0
1746612594653,AWP 10,003,886149,Staff,0,0,0,0
1746612594653,AWP 10,004,886150,Staff,0,0,0,0
1746612594653,AWP 10,005,886151,Staff,0,0,0,0
1746612594653,AWP 10,006,886152,Staff,0,0,0,0
1746612594653,AWP 10,007,886153,Staff,0,0,0,0
1746612594653,AWP 10,008,886154,Staff,0,0,0,0
1746612594653,AWP 10,009,886155,Staff,0,0,0,0
1746612594653,AWP 10,010,886156,Staff,0,0,0,0
1746612594653,AWP 10,011,886158,Staff,0,0,0,0
1746612594653,AWP 10,012,886160,Staff,0,0,0,0
1746612594653,AWP 10,013,886161,Staff,0,0,0,0
1746612594653,AWP 10,014,886162,Staff,0,0,0,0
1746612594653,AWP 10,015,886163,Staff,0,0,0,0
1746612594653,AWP 10,016,886164,Staff,0,0,0,0
1746612594653,AWP 10,017,886165,Staff,0,0,0,0
1746612594653,AWP 10,018,886166,Staff,0,0,0,0
1746612594653,AWP 10,019,886168,Staff,0,0,0,0
1746612594653,AWP 10,020,886170,Staff,0,0,0,0
1746612594653,AWP 10,021,886172,Staff,0,0,0,0
1746612595680,AWP 10R,001,886173,Staff,0,1,0,0
1746612595680,AWP 10R,002,886174,Staff,0,1,0,0
1746612595680,AWP 10R,003,886175,Staff,0,0,0,0
1746612595680,AWP 10R,004,886176,Staff,0,0,0,0
1746612595680,AWP 10R,005,886177,Staff,0,0,0,0
1746612595680,AWP 10R,006,886178,Staff,0,0,0,0
1746612595680,AWP 10R,007,886179,Staff,0,0,0,0
1746612595680,AWP 10R,008,886181,Staff,0,0,0,0
1746612595680,AWP 10R,009,886182,Staff,0,0,0,0
1746612595680,AWP 10R,010,886183,Staff,0,0,0,0
1746612595680,AWP 10R,011,886184,Staff,0,0,0,0
1746612595680,AWP 10R,012,886185,Staff,0,0,0,0
1746612595680,AWP 10R,013,886186,Staff,0,0,0,0
1746612595680,AWP 10R,014,886187,Staff,0,0,0,0
1746612595680,AWP 10R,015,886188,Staff,0,0,0,0
1746612595680,AWP 10R,016,886189,Staff,0,0,0,0
1746612595680,AWP 10R,017,960532,Staff,0,0,0,0
1746612595680,AWP 10R,018,960533,Staff,0,0,0,0
1746612595680,AWP 10R,019,960534,Staff,0,0,0,0
1746612595680,AWP 10R,020,960538,Staff,0,0,0,0
1746612595680,AWP 10R,021,960540,Staff,0,0,0,0
1746612595680,AWP 10R,022,960541,Staff,0,0,0,0
1746612595680,AWP 10R,023,960542,Staff,0,0,0,0
1746612595680,AWP 10R,024,960544,Staff,0,0,0,0
1746612595680,AWP 10R,025,960545,Staff,0,0,0,0
1746612595680,AWP 10R,026,960548,Staff,0,0,0,0
1746612596706,AWP 102R,A00,886190,Staff,0,0,0,0
1746612596706,AWP 102R,B00,886191,Staff,0,0,0,0
1746612597732,BENG 100,A01,886193,Staff,17,0,30,13
1746612598760,BENG 122A,A01,886195,Hasty; Jeff M,13,0,30,17
1746612599785,BENG 166A,A00,886196,Sah; Robert Lie-Yuan,0,3,30,30
1746612600811,BENG 190,A00,958050,Khojah; Reem I,17,0,25,8
1746612601837,BIBC 102,A01,894320,Staff,0,1,46,46
1746612601837,BIBC 102,A02,894321,Staff,0,0,46,46
1746612601837,BIBC 102,A03,894344,Staff,6,0,46,40
1746612601837,BIBC 102,A04,894345,Staff,27,0,47,20
1746612602865,BICD 100R,A01,894365,Smith; Laurie,0,2,58,58
1746612602865,BICD 100R,A02,894366,Smith; Laurie,0,4,58,58
1746612602865,BICD 100R,A03,894367,Smith; Laurie,0,0,59,59
1746612602865,BICD 100R,A04,959869,Smith; Laurie,38,0,59,21
1746612603891,BICD 136,A01,894383,Gustafson-Brown; Cindy,14,0,50,36
1746612604921,BIEB 102,A01,894494,Butler; Shannon Rhey,51,0,130,79
1746612606981,BIEB 150,A01,894617,Wills; Christopher,3,0,20,17
1746612606981,BIEB 150,A02,894631,Wills; Christopher,3,0,20,17
1746612606981,BIEB 150,A03,894937,Wills; Christopher,3,0,20,17
1746612606981,BIEB 150,A04,894946,Wills; Christopher,5,0,20,15
1746612608007,BIEB 194,A00,906141,Kurle; Carolyn M.,5,0,20,15
1746612609033,BILD 1,A01,894154,Staff,3,0,19,16
1746612609033,BILD 1,A02,894155,Staff,14,0,19,5
1746612609033,BILD 1,A03,894160,Staff,13,0,19,6
1746612609033,BILD 1,A04,894161,Staff,15,0,18,3
1746612610061,BILD 2,A01,894168,Staff,0,0,50,50
1746612610061,BILD 2,A02,894169,Staff,0,0,50,50
1746612610061,BILD 2,A03,894179,Staff,0,0,50,50
1746612610061,BILD 2,A04,894203,Staff,22,0,50,28
1746612611087,BILD 3,A01,894213,Staff,23,0,31,8
1746612611087,BILD 3,A02,894214,Staff,26,0,31,5
1746612611087,BILD 3,A03,894235,Staff,28,0,31,3
1746612611087,BILD 3,A04,894236,Staff,28,0,32,4
1746612612117,BILD 4,A01,894253,Reuther; Keefe,5,0,24,19
1746612612117,BILD 4,A02,894258,Reuther; Keefe,16,0,24,8
1746612613144,BILD 5,A01,894276,Reuther; Keefe,33,0,50,17
1746612613144,BILD 5,A02,894277,Reuther; Keefe,45,0,50,5
1746612613144,BILD 5,A03,894290,Reuther; Keefe,44,0,50,6
1746612613144,BILD 5,A04,894291,Reuther; Keefe,48,0,50,2
1746612614171,BILD 24,A01,894297,Pirino; Giorgia,40,0,60,20
1746612615202,BIMM 100,B01,958915,Staff,71,0,100,29
1746612616230,BIMM 101,A01,895017,McDonnell; Lisa Marie,0,5,24,24
1746612616230,BIMM 101,A02,895018,McDonnell; Lisa Marie,0,5,24,24
1746612616230,BIMM 101,B01,895020,McDonnell; Lisa Marie,0,5,24,24
1746612616230,BIMM 101,B02,895021,McDonnell; Lisa Marie,0,4,24,24
1746612617260,BIMM 110,A01,895023,Staff,1,0,25,24
1746612617260,BIMM 110,A02,895024,Staff,9,0,25,16
1746612617260,BIMM 110,A03,895025,Staff,18,0,25,7
1746612617260,BIMM 110,A04,895031,Staff,20,0,25,5
1746612618290,BIMM 120,A01,895114,Gustafson-Brown; Cindy,14,0,28,14
1746612618290,BIMM 120,A02,895126,Gustafson-Brown; Cindy,21,0,27,6
1746612619319,BIPN 100,A01,895130,Yang; Mingyu,0,0,38,38
1746612619319,BIPN 100,A02,895131,Yang; Mingyu,31,0,38,7
1746612619319,BIPN 100,A03,895132,Yang; Mingyu,32,0,38,6
1746612619319,BIPN 100,A04,895133,Yang; Mingyu,27,0,36,9
1746612620346,BIPN 120,A01,895135,Cooke; James Edward,0,3,13,13
1746612620346,BIPN 120,A02,895136,Cooke; James Edward,0,1,13,13
1746612620346,BIPN 120,A03,895137,Cooke; James Edward,0,3,13,13
1746612620346,BIPN 120,A04,895156,Cooke; James Edward,0,2,11,11
1746612621372,BIPN 134,A01,895235,Cooke; James Edward,0,1,25,25
1746612621372,BIPN 134,A02,895237,Cooke; James Edward,0,0,25,25
1746612621372,BIPN 134,A03,895240,Cooke; James Edward,1,0,25,24
1746612621372,BIPN 134,A04,895270,Cooke; James Edward,20,0,25,5
1746612622403,BIPN 189,A00,892103,Staff,0,14,14,14
1746612624456,BISP 194,A00,958008,Staff,0,2,0,0
1746612625482,CAT 124,A01,922009,Staff,0,5,20,20
1746612626518,CAT 125R,A00,886390,Morales; Celeste Georgianna,0,4,20,20
1746612626518,CAT 125R,B00,886391,Irwin; Matthew Joseph,0,4,20,20
1746612626518,CAT 125R,C00,886392,Smith; Lauryn Alissa,0,2,20,20
1746612626518,CAT 125R,D00,886393,Vanderschuit; Maya Alysia,0,3,20,20
1746612626518,CAT 125R,E00,886394,Marchisotto; Jennifer Anne,0,3,20,20
1746612627545,CENG 15,A01,886218,Drews; Aaron,3,0,8,5
1746612628572,CENG 113,A00,886219,Opatkiewicz; Justin Paul,15,0,25,10
1746612629601,CGS 101,A00,887044,Staff,7,0,20,13
1746612630627,CGS 105,A01,887046,Staff,14,0,25,11
1746612631652,CGS 112,A00,887047,Cuong; Marisol,12,0,15,3
1746612632678,CGS 113,A00,887048,Staff,23,0,30,7
1746612633705,CGS 120,A00,887049,Staff,9,0,17,8
1746612634730,CHEM 6A,A01,886336,Lam; Tin Yiu,38,0,50,12
1746612634730,CHEM 6A,A02,886338,Lam; Tin Yiu,37,0,50,13
1746612635756,CHEM 6B,A01,886341,Hopkins; Patrycja Anna,16,0,50,34
1746612635756,CHEM 6B,A02,886343,Hopkins; Patrycja Anna,42,0,50,8
1746612636782,CHEM 6C,A01,886346,Albizati; Kim F.,0,2,50,50
1746612636782,CHEM 6C,A02,886348,Albizati; Kim F.,24,0,50,26
1746612637808,CHEM 40A,A01,886352,Klosterman; Jeremy K,65,0,100,35
1746612638834,CHEM 40B,A01,886356,Klosterman; Jeremy K,0,24,100,100
1746612639859,CHEM 41B,A01,886360,Theodorakis; Emmanuel,25,0,50,25
1746612639859,CHEM 41B,A02,886362,Theodorakis; Emmanuel,47,0,50,3
1746612640885,CHIN 165A,A00,886382,Xu; Li,18,0,20,2
1746612641910,CLAS 120,A00,886387,Myerston Santana; Jacobo,33,0,40,7
1746612642938,COGS 9,A01,886967,Shannon; Kyle Michael,42,0,60,18
1746612643966,COGS 11,A01,886969,Staff,9,0,30,21
1746612644996,COGS 14A,A01,886971,Staff,5,0,60,55
1746612646022,COGS 14B,A01,886973,Hoffman; Drew Ellen,4,0,60,56
1746612647047,COGS 18,A01,886975,Morgan; Eric,34,0,60,26
1746612648095,COGS 20,A01,886977,Staff,3,0,8,5
1746612648095,COGS 20,A02,886978,Staff,5,0,7,2
1746612649122,COGS 100,A01,907783,Staff,0,1,30,30
1746612650146,COGS 101B,A01,886980,Staff,0,4,48,48
1746612651170,COGS 101C,A01,886982,Delgado; Tania,0,5,44,44
1746612652197,COGS 102A,A01,886984,Johnson; Christine M.,3,0,30,27
1746612653225,COGS 118B,A01,886986,Staff,0,4,88,88
1746612654254,COGS 150,A01,886988,Bergen; Benjamin,22,0,50,28
1746612655281,COGS 153,A00,886989,Delgado; Tania,1,3,41,40
1746612656306,COGS 186,A01,886991,Staff,0,0,32,32
1746612657330,COGS 187A,A01,886993,Boyle; Mary E. T.,7,0,30,23
1746612658355,COGS 189,A00,886994,Staff,0,1,30,30
1746612659382,COMM 10,A01,886996,Staff,0,0,20,21
1746612659382,COMM 10,A02,886997,Staff,10,0,20,10
1746612659382,COMM 10,A03,959845,Staff,19,0,20,1
1746612660407,COMM 20,A01,886999,Leuning; Grant Maurstad,24,0,40,16
1746612662463,COMM 100A,A01,887002,Staff,0,0,20,25
1746612662463,COMM 100A,A02,887003,Staff,5,0,20,15
1746612663488,COMM 100B,A01,887005,Staff,0,8,20,24
1746612664514,COMM 106D,A00,887006,Staff,14,0,40,26
1746612665540,COMM 110G,A00,887007,Whitworth-Smith; Andrew C,12,0,40,28
1746612666569,COMM 111B,A00,887008,Staff,31,0,40,9
1746612667595,COMM 113T,A00,887009,Abuelhiga; Soraya Jill,28,0,40,12
1746612667595,COMM 113T,B00,906733,Staff,39,0,40,1
1746612668624,COMM 145,A00,887010,Staff,13,0,40,27
1746612669649,COMM 146,A00,887054,Staff,32,0,40,8
1746612670678,COMM 190,A00,887012,Staff,8,0,23,15
1746612671708,CSE 8A,A50,887015,Cao; Yingjun,56,0,85,29
1746612672737,CSE 11,A01,887017,Cao; Yingjun,11,0,70,59
1746612673762,CSE 20,A01,887019,Staff,30,0,50,20
1746612674793,CSE 21,A01,887021,Staff,79,0,100,21
1746612674793,CSE 21,B01,892583,Braun; Oliver,45,0,50,5
1746612675820,CSE 30,A01,887025,Eldon; John,142,0,200,58
1746612676847,CSE 100,A01,887027,Staff,26,0,50,24
1746612676847,CSE 100,A02,887028,Staff,42,0,50,8
1746612677874,CSE 101,A01,887030,Braun; Oliver,74,0,100,26
1746612677874,CSE 101,B01,887032,Jones; Miles E,0,3,50,50
1746612677874,CSE 101,B02,887033,Jones; Miles E,0,2,50,50
1746612678906,CSE 105,A01,908084,Jones; Miles E,32,0,50,18
1746612678906,CSE 105,A02,908087,Jones; Miles E,31,0,50,19
1746612679935,CSE 135,A01,887035,Powell; Thomas Allan,0,5,50,50
1746612680980,CSE 142,A01,887037,Staff,7,0,60,53
1746612682006,CSE 142L,A01,887039,Staff,34,0,60,26
1746612683035,CSE 151A,A01,887041,Solares; Edwin A,47,0,100,53
1746612684060,CSE 175,A01,887043,Kumar; Rakesh,30,0,30,0
1746612685085,CSS 1,A01,886389,Staff,0,1,40,40
1746612686111,DSC 30,A01,908097,Liao; Soohyun Nam,47,0,75,28
1746612687138,DSC 40A,A01,908099,Shannon; Kyle Michael,30,0,50,20
1746612688168,DSC 40B,A01,908112,Staff,15,0,50,35
1746612689195,DSC 80,A01,908116,Staff,19,0,60,41
1746612690220,DSC 197,001,956863,Eldridge; Justin Matthew,9999,0,9999,0
1746612691249,ECE 5,A01,886400,Morris; Karcher William,1,0,6,5
1746612691249,ECE 5,A02,886401,Morris; Karcher William,3,0,6,3
1746612692274,ECE 148,A01,886403,Silberman; Jack,0,14,14,14
1746612693299,ECON 1,A01,887265,Crane; Meredith Helen,11,0,70,59
1746612693299,ECON 1,B01,887268,Staff,42,0,50,8
1746612694326,ECON 2,A01,887273,Crane; Meredith Helen,54,0,70,16
1746612695355,ECON 3,A01,887279,Rondina; Giacomo,31,0,70,39
1746612696380,ECON 4,A01,887282,Anderson; John Charles,0,2,10,10
1746612697407,ECON 5,A01,887285,Staff,34,0,45,11
1746612697407,ECON 5,B01,887292,Staff,41,0,45,4
1746612698437,ECON 100A,A01,887337,Newhouse; Herbert S,54,0,70,16
1746612698437,ECON 100A,B01,887349,Staff,45,0,50,5
1746612699460,ECON 100B,A01,887361,Du; Songzi,29,0,70,41
1746612700488,ECON 100C,A01,887445,Newhouse; Herbert S,59,0,70,11
1746612701514,ECON 105,A00,887488,Vespa; Emanuel Ignacio,23,0,35,12
1746612702544,ECON 109,A01,887506,Shishkin; Denis,28,0,35,7
1746612703572,ECON 110A,A01,887568,Alon; Titan Michael,0,2,35,35
1746612703572,ECON 110A,B01,907601,Alon; Titan Michael,20,0,35,15
1746612704597,ECON 110B,A01,887598,Levkoff; Steven B.,0,24,70,70
1746612705623,ECON 112,A00,887599,Rondina; Giacomo,19,0,35,16
1746612706650,ECON 120A,A01,887603,Dai; Yinlin,36,0,70,34
1746612707678,ECON 120C,A01,887608,Sun; Yixiao,0,1,35,35
1746612707678,ECON 120C,B01,887614,Sun; Yixiao,0,0,35,35
1746612708707,ECON 138,A00,887621,Bharadwaj; Prashant,0,21,20,20
1746612709733,ECON 144,A00,958007,Squires; Dale E,11,0,35,24
1746612710758,ECON 171,A01,907666,Staff,18,0,35,17
1746612711784,ECON 175,A00,887626,Wu; Pak Yeung,22,0,35,13
1746612712812,ECON 190,A00,887640,Vespa; Emanuel Ignacio,22,0,35,13
1746612713840,EDS 25,A01,888197,Staff,0,0,0,0
1746612713840,EDS 25,A02,888209,Staff,0,0,0,0
1746612713840,EDS 25,A03,888210,Staff,0,0,0,0
1746612713840,EDS 25,A04,888212,Staff,0,0,0,0
1746612713840,EDS 25,A05,888213,Staff,0,0,0,0
1746612713840,EDS 25,A06,888214,Staff,0,0,0,0
1746612713840,EDS 25,A07,888235,Staff,0,2,0,0
1746612713840,EDS 25,A08,888236,Staff,0,0,0,0
1746612713840,EDS 25,A09,888240,Staff,0,0,0,0
1746612713840,EDS 25,A10,888244,Staff,0,0,0,0
1746612713840,EDS 25,B01,888273,Staff,0,0,0,0
1746612713840,EDS 25,B02,888285,Staff,0,0,0,0
1746612713840,EDS 25,B03,888423,Staff,0,0,0,1
1746612713840,EDS 25,B04,888432,Staff,0,0,0,0
1746612713840,EDS 25,B05,888433,Staff,0,0,0,0
1746612713840,EDS 25,B06,888467,Staff,0,0,0,0
1746612713840,EDS 25,B07,888468,Staff,0,0,0,0
1746612713840,EDS 25,B08,888479,Staff,0,0,0,0
1746612713840,EDS 25,B09,888484,Staff,0,0,0,0
1746612713840,EDS 25,B10,888487,Staff,0,0,0,0
1746612714866,EDS 38,A01,907700,Choi; Bailey Miyeon,30,0,30,0
1746612715891,EDS 112,A01,888601,Chapman; Thandeka K,12,0,40,28
1746612716916,EDS 115,A00,888697,Mendez; Kathrina Mendoza,10,0,30,20
1746612717940,EDS 116,A01,888893,Staff,33,0,40,7
1746612719997,EDS 124AR,A00,889133,Staff,29,0,50,21
1746612719997,EDS 124AR,B00,907471,Simon; Elizabeth A,37,0,50,13
1746612721022,EDS 124BR,A00,889134,Simon; Elizabeth A,44,0,100,56
1746612722050,EDS 125,A00,889135,Staff,25,0,30,5
1746612723077,EDS 126,A01,889138,Staff,35,0,40,5
1746612724106,EDS 164R,A01,889142,Wishard Guerra; Alison G.,32,0,50,18
1746612725134,ENG 30,A01,886396,Staff,0,0,0,0
1746612725134,ENG 30,B01,886398,Staff,0,0,0,0
1746612726159,ENVR 102,A00,906150,Montejo; Carolina,23,0,25,2
1746612727184,ETHN 103A,A00,887236,Man; Simeon S,0,2,0,0
1746612728210,ETHN 113,A00,887239,Staff,16,0,30,14
1746612729239,ETHN 116,A00,887240,Staff,16,0,25,9
1746612730264,ETHN 117,A00,887241,Choi; Esther Min,28,0,30,2
1746612731292,ETHN 118,A00,887243,Staff,24,0,30,6
1746612732318,ETHN 127,A00,887248,Cuong; Marisol,11,0,15,4
1746612733344,ETHN 139,A00,887250,Staff,7,0,10,3
1746612734372,ETHN 142,A00,887252,Staff,9,0,30,21
1746612735397,ETHN 161,A00,887253,Browne; Errol Tsekani,24,0,30,6
1746612736425,ETHN 163FR,A00,887255,Burelle; Julie Sara Veronique,0,0,5,5
1746612737450,GLBH 20,A00,889149,Elwardani; Nile Regina,8,0,42,34
1746612739504,GLBH 111,A01,889152,Burgos; Jose L.,17,0,17,0
1746612740530,GLBH 150,A00,889181,Sloane; Julia Kathryn,0,5,15,15
1746612742581,HDS 60,A01,886406,Warstadt; Melissa Fawn,72,0,80,8
1746612743609,HIAF 111,A00,889324,Gyamfi; Bright,25,0,32,7
1746612744634,HIEA 131,A00,889328,Staff,15,0,32,17
1746612745662,HIEA 144,A00,889333,Henry; Todd A.,26,0,32,6
1746612746686,HIEA 154,A00,889336,Henry; Todd A.,24,0,32,8
1746612747712,HIEU 106,A00,889339,Staff,22,0,32,10
1746612749768,HIEU 114,A00,889340,Staff,4,0,32,28
1746612750795,HIEU 135GS,A00,889342,Patterson; Patrick H.,0,0,1,24
1746612751820,HIEU 137,A00,889343,Edington; Claire Ellen,10,0,25,15
1746612752847,HIEU 148,A00,889345,Staff,14,0,32,18
1746612753877,HIEU 154,A00,889346,Biess; Frank Peter,21,0,32,11
1746612754905,HILA 102,A00,889351,Staff,12,0,32,20
1746612755930,HILD 2A,A01,889221,Lewandoski; Julia Mavis,0,8,32,32
1746612756956,HILD 7B,A01,889225,Man; Simeon S,0,12,32,32
1746612757984,HILD 7C,A01,889288,Alvarez; Luis A,0,14,32,32
1746612759012,HILD 30,A01,889323,Staff,0,5,32,32
1746612761065,HISC 119,A00,889383,Golan; Tal,20,0,32,12
1746612762091,HIUS 103,A00,889384,Man; Simeon S,0,0,32,32
1746612763118,HIUS 117,A00,919797,Kwak; Nancy,18,0,32,14
1746612764185,HIUS 142A,A00,919788,Staff,22,0,32,10
1746612766240,HIUS 149,A00,889386,Gyamfi; Bright,26,0,32,6
1746612767268,HIUS 155,A00,889387,Alvarez; Luis A,15,0,32,17
1746612768295,HUM 3,A01,886499,Caldwell; Michael Alan,19,0,50,31
1746612769322,HUM 3GS,A00,886500,Rodriguez; Bretton Sigfred,0,0,0,28
1746612770352,HUM 3R,A01,886502,Markman; Kristina,0,36,50,50
1746612771380,HUM 4,A01,886504,Crum; Matthew Stephen,23,0,50,27
1746612771380,HUM 4,B01,886506,West; Geoffrey Scott,17,0,50,33
1746612772408,HUM 4GS,A00,886507,Staff,0,0,0,19
1746612773434,HUM 5,A01,886509,Staff,31,0,50,19
1746612774461,HUM 5R,A01,886511,Zavodny; Tatiana Sophia,0,39,50,50
1746612775487,JAPN 180,A00,886407,Staff,16,0,40,24
1746612776513,LATI 50,A01,886409,Martin-Cabrera; Luis,3,0,22,19
1746612776513,LATI 50,A02,886410,Martin-Cabrera; Luis,19,0,22,3
1746612776513,LATI 50,A03,886411,Martin-Cabrera; Luis,21,0,22,1
1746612776513,LATI 50,A04,886412,Martin-Cabrera; Luis,8,0,22,14
1746612777541,LAWS 101,A00,907664,Staff,28,0,60,32
1746612778570,LIAB 1A,A00,889388,Saab; Dima,17,0,20,3
1746612779596,LIAB 1AX,A00,889389,El Cheddadi; Youniss,18,0,20,2
1746612780624,LIFR 1C,A00,889391,Van Moer; Vinciane G,8,0,20,12
1746612781654,LIFR 1CX,A00,889392,Van Moer; Vinciane G,7,0,20,13
1746612782680,LIFR 1D,A00,889393,Van Moer; Vinciane G,7,0,20,13
1746612783708,LIFR 1DX,A00,889394,Van Moer; Vinciane G,8,0,20,12
1746612784735,LIGN 7,A00,886923,Staff,25,0,50,25
1746612785760,LIGN 17,A00,886924,Kehler; Andrew Scott,126,0,150,24
1746612786785,LTAM 110,A00,889395,Staff,15,0,30,15
1746612787812,LTAM 110GS,A00,958010,Rodriguez; Bretton Sigfred,0,0,0,28
1746612788837,LTCH 101,A00,889397,Staff,23,0,25,2
1746612789864,LTCS 130,A00,889398,Staff,23,0,25,2
1746612790890,LTEA 138,A00,889399,Staff,24,0,40,16
1746612791915,LTEN 149,A00,889400,Wesling; Megan E.,0,3,25,25
1746612792944,LTEN 169,A00,889401,Staff,20,0,25,5
1746612793973,LTEN 180,A00,889402,Staff,10,0,15,5
1746612795001,LTEN 181,A00,889403,Staff,21,0,25,4
1746612796026,LTWL 100,A00,889404,Myerston Santana; Jacobo,2,0,25,23
1746612797051,LTWL 180GS,A00,889405,Staff,0,0,20,20
1746612798077,LTWL 181,A00,889406,Staff,16,0,25,9
1746612799106,LTWL 184,A00,889475,Mukherjee; Silpa,22,0,25,3
1746612800132,LTWR 102C,A00,889486,Staff,29,0,30,1
1746612801160,LTWR 115W,A00,889491,Staff,0,2,15,15
1746612802188,MAE 8,A01,886905,Staff,0,2,0,0
1746612803216,MAE 11,A00,886906,Bandaru; Prabhakar,0,7,50,50
1746612804244,MAE 20,A00,886907,Evdokimenko; Ekaterina,43,0,70,27
1746612805271,MAE 30B,A00,886909,Ghazinejad; Maziar,25,0,45,20
1746612806297,MAE 101B,A00,886910,Saintillan; David,30,0,45,15
1746612807324,MAE 105,A00,886911,Bandaru; Prabhakar,18,0,50,32
1746612808353,MAE 107,B00,958024,Staff,7,0,50,43
1746612809382,MAE 143B,A00,886913,Bewley; Thomas R,2,0,40,38
1746612810407,MAE 148,A01,886915,Silberman; Jack,0,3,14,14
1746612811433,MAE 160,A00,886916,Evdokimenko; Ekaterina,30,0,60,30
1746612812464,MATH 3C,A01,889681,Staff,0,2,30,30
1746612812464,MATH 3C,A02,960048,Staff,23,0,30,7
1746612813490,MATH 10A,A01,889760,Staff,26,0,30,4
1746612813490,MATH 10A,A02,889783,Staff,29,0,30,1
1746612814522,MATH 10B,A01,889785,Verstraete; Jacques Allan,1,0,35,34
1746612814522,MATH 10B,A02,889795,Verstraete; Jacques Allan,4,0,35,31
1746612814522,MATH 10B,B01,889797,Verstraete; Jacques Allan,3,0,35,32
1746612814522,MATH 10B,B02,889828,Verstraete; Jacques Allan,3,0,35,32
1746612815550,MATH 10C,A01,889849,Habib; Yousaf,8,0,30,22
1746612815550,MATH 10C,A02,889852,Habib; Yousaf,14,0,30,16
1746612815550,MATH 10C,A03,889853,Habib; Yousaf,22,0,30,8
1746612815550,MATH 10C,A04,889858,Habib; Yousaf,20,0,30,10
1746612815550,MATH 10C,B01,889861,Staff,1,0,30,29
1746612815550,MATH 10C,B02,889862,Staff,24,0,30,6
1746612815550,MATH 10C,B03,889863,Staff,27,0,30,3
1746612815550,MATH 10C,B04,889967,Staff,23,0,30,7
1746612816584,MATH 18,A01,889974,Staff,6,0,30,24
1746612816584,MATH 18,A02,889977,Staff,20,0,30,10
1746612816584,MATH 18,B01,889984,Hardiman; Liam,20,0,30,10
1746612816584,MATH 18,B02,889985,Hardiman; Liam,25,0,30,5
1746612817614,MATH 20A,A01,889990,Suk; Andrew Hoon,30,0,35,5
1746612818640,MATH 20B,A01,889993,Ohm; Ko Woon,21,0,30,9
1746612818640,MATH 20B,A02,889994,Ohm; Ko Woon,30,0,30,0
1746612818640,MATH 20B,B01,889996,Ohm; Ko Woon,22,0,30,8
1746612818640,MATH 20B,B02,889997,Ohm; Ko Woon,23,0,30,7
1746612819668,MATH 20C,A01,889999,Hammock; Frances H,17,0,30,13
1746612819668,MATH 20C,A02,890003,Hammock; Frances H,23,0,30,7
1746612819668,MATH 20C,B01,890006,Hammock; Frances H,2,0,30,28
1746612819668,MATH 20C,B02,890007,Hammock; Frances H,11,0,30,19
1746612820694,MATH 20D,A01,890011,Cheng; Hsiao-Bing,1,0,30,29
1746612820694,MATH 20D,A02,890012,Cheng; Hsiao-Bing,14,0,30,16
1746612820694,MATH 20D,B01,890016,Cheng; Hsiao-Bing,13,0,30,17
1746612820694,MATH 20D,B02,890017,Cheng; Hsiao-Bing,13,0,30,17
1746612821722,MATH 20E,A01,890026,Harel; Guershon,1,0,30,29
1746612821722,MATH 20E,A02,890029,Harel; Guershon,22,0,30,8
1746612821722,MATH 20E,B01,890033,Harel; Guershon,7,0,30,23
1746612821722,MATH 20E,B02,890101,Harel; Guershon,21,0,30,9
1746612822747,MATH 102,A01,890104,Staff,18,0,30,12
1746612822747,MATH 102,A02,890105,Staff,27,0,30,3
1746612823780,MATH 103B,A01,890116,Salehi Golsefidy; Alireza,3,0,30,27
1746612823780,MATH 103B,B01,890118,Staff,0,3,34,34
1746612824807,MATH 109,A01,890121,Aliabadi Sr.; Mohsen,0,0,30,30
1746612824807,MATH 109,B01,890124,Upadrashta; Pranav Kumar,18,0,30,12
1746612825832,MATH 120A,A01,890126,Eggers; John Dietrich,13,0,30,17
1746612826863,MATH 142B,A01,890128,Ioana; Adrian,19,0,30,11
1746612826863,MATH 142B,A02,890129,Ioana; Adrian,12,0,30,18
1746612827889,MATH 154,A01,890174,Staff,0,1,30,30
1746612827889,MATH 154,A02,890182,Staff,0,0,30,30
1746612828931,MATH 168A,A01,890197,Dumitriu; Ioana,21,0,35,14
1746612829967,MATH 170A,A01,890240,Nie; Jiawang,1,0,30,29
1746612829967,MATH 170A,A02,890241,Nie; Jiawang,11,0,30,19
1746612829967,MATH 170A,A03,890249,Nie; Jiawang,23,0,30,7
1746612830996,MATH 170B,A01,957891,Nag; Panchali,13,0,35,22
1746612833050,MATH 181A,A01,908025,Staff,0,3,35,35
1746612833050,MATH 181A,A02,960115,Staff,26,0,35,9
1746612834077,MATH 181B,A01,959874,Staff,24,0,30,6
1746612835103,MATH 193B,A01,890265,Staff,0,4,35,35
1746612836129,MGT 4,A01,890311,Anderson; John Charles,42,0,88,46
1746612837159,MGT 5,A00,907740,Staff,12,0,98,86
1746612838186,MGT 12,A00,890312,Lindenberger; Wade Douglas,67,0,98,31
1746612839212,MGT 16,A00,957883,Staff,78,0,98,20
1746612841264,MGT 45,A00,890314,Pecore; Joseph P.,45,0,98,53
1746612842293,MGT 71,A00,890315,Staff,0,12,98,98
1746612843325,MGT 100,A00,890316,Yavorsky; Daniel Ryan,44,0,98,54
1746612844352,MGT 103,A00,890317,Ehrich; Kristine R,73,0,98,25
1746612845379,MGT 105,A00,890356,Bates; Kenneth Walter,0,8,98,98
1746612846408,MGT 112,A00,890360,Ehrich; Kristine R,55,0,98,43
1746612847432,MGT 127R,A00,907732,Zhu; Kevin Xiaoguo,23,0,98,75
1746612848461,MGT 131B,A00,890361,Anderson; John Charles,59,0,98,39
1746612849491,MGT 137,A00,890362,Lindenberger; Wade Douglas,65,0,98,33
1746612850519,MGT 160,A00,890369,Johnson; Erik Barry,9,0,98,89
1746612852574,MGT 164,A00,890372,Zimmermann; Carsten,0,40,98,98
1746612853601,MGT 180,A00,890374,Bliss; Barbara Ann,11,0,98,87
1746612854626,MMW 15,A01,886414,Chang; Edmond Yi-Teh,0,12,28,28
1746612854626,MMW 15,A02,886415,Chang; Edmond Yi-Teh,0,8,28,28
1746612854626,MMW 15,A03,886416,Chang; Edmond Yi-Teh,0,9,28,28
1746612854626,MMW 15,A04,886417,Chang; Edmond Yi-Teh,0,8,28,28
1746612854626,MMW 15,B01,886419,Chang; Edmond Yi-Teh,0,7,28,28
1746612854626,MMW 15,B02,886420,Chang; Edmond Yi-Teh,0,7,28,28
1746612854626,MMW 15,B03,886421,Chang; Edmond Yi-Teh,0,7,28,28
1746612854626,MMW 15,B04,886422,Chang; Edmond Yi-Teh,0,8,28,28
1746612854626,MMW 15,C01,886424,Staff,0,9,28,28
1746612854626,MMW 15,C02,886425,Staff,0,8,28,28
1746612854626,MMW 15,C03,886426,Staff,0,8,28,28
1746612854626,MMW 15,C04,886427,Staff,0,8,28,28
1746612854626,MMW 15,C05,958038,Staff,0,8,28,28
1746612854626,MMW 15,C06,958039,Staff,0,7,28,28
1746612855653,MMW 15GS,A00,906910,Patterson; Patrick H.,4,0,28,24
1746612856678,MMW 122R,A01,886429,Rahimi; Babak,0,13,28,28
1746612856678,MMW 122R,A02,886430,Rahimi; Babak,0,12,28,28
1746612856678,MMW 122R,A03,958040,Rahimi; Babak,0,11,28,28
1746612857709,MUS 1A,A01,890937,Staff,2,0,25,23
1746612857709,MUS 1A,A02,891035,Staff,6,0,25,19
1746612857709,MUS 1A,C01,958912,Staff,24,0,25,1
1746612857709,MUS 1A,C02,958913,Staff,25,0,25,0
1746612859765,MUS 2AK,A00,957092,Ohnishi; Takae,15,0,15,0
1746612860795,MUS 4,A01,891044,Staff,0,0,25,25
1746612860795,MUS 4,A02,891045,Staff,22,0,25,3
1746612860795,MUS 4,B01,891048,Staff,17,0,25,8
1746612860795,MUS 4,B02,891050,Staff,25,0,25,0
1746612861828,MUS 5,A01,957506,Dubnov; Shlomo,0,0,25,25
1746612861828,MUS 5,A02,957622,Dubnov; Shlomo,12,0,25,13
1746612861828,MUS 5,A03,957623,Dubnov; Shlomo,20,0,25,5
1746612862855,MUS 6,A01,891053,Freitas Caetano; Marcelo,24,0,25,1
1746612862855,MUS 6,A02,891054,Freitas Caetano; Marcelo,23,0,25,2
1746612863894,MUS 7,A01,891081,Staff,0,0,25,25
1746612863894,MUS 7,A02,891082,Staff,3,0,25,22
1746612864924,MUS 8GS,A00,891118,Borgo; David Garcia,1,0,25,24
1746612865950,MUS 11,A01,891140,Staff,8,0,25,17
1746612865950,MUS 11,A02,891141,Staff,21,0,25,4
1746612866976,MUS 13,A01,891143,Staff,8,0,25,17
1746612866976,MUS 13,A02,891144,Staff,24,0,25,1
1746612868002,MUS 15,A01,891146,Staff,9,0,25,16
1746612868002,MUS 15,A02,891148,Staff,21,0,25,4
1746612868002,MUS 15,B01,891150,Staff,18,0,25,7
1746612868002,MUS 15,B02,891151,Staff,25,0,25,0
1746612869026,MUS 20,A01,891153,Staff,5,0,20,15
1746612869026,MUS 20,A02,891155,Staff,14,0,20,6
1746612870058,MUS 80,A00,891156,Staff,19,0,25,6
1746612870058,MUS 80,B00,891157,Staff,23,0,25,2
1746612871085,MUS 130,A00,891158,Ohnishi; Takae,35,0,35,0
1746612872114,MUS 150GS,A01,891160,Borgo; David Garcia,1,0,25,24
1746612873146,MUS 170,A01,891162,Freitas Caetano; Marcelo,20,0,25,5
1746612873146,MUS 170,A02,891164,Freitas Caetano; Marcelo,21,0,25,4
1746612874176,NANO 11,A00,886220,Vazquez Mena; Oscar,13,0,15,2
1746612875204,NANO 15,A01,886222,Drews; Aaron,4,0,7,3
1746612876229,NANO 104,A00,886224,Sirbuly; Donald,17,0,25,8
1746612877261,PH 40,A00,886528,Staff,23,0,40,17
1746612878288,PH 45,A01,886799,Staff,35,0,40,5
1746612879316,PH 110,A00,886802,Staff,0,6,40,40
1746612880358,PH 172,A00,906716,Staff,19,0,35,16
1746612881385,PH 191,A00,886803,Staff,6,0,40,34
1746612882424,PHIL 1,A00,889500,Staff,20,0,30,10
1746612883453,PHIL 10,A01,889549,Grush; Rick Scott,16,0,22,6
1746612883453,PHIL 10,A02,889551,Grush; Rick Scott,22,0,22,0
1746612884479,PHIL 28,A01,889559,Lamey; Andy M.,0,2,31,31
1746612884479,PHIL 28,A02,889561,Lamey; Andy M.,0,1,30,30
1746612884479,PHIL 28,A03,889572,Lamey; Andy M.,0,1,30,30
1746612885505,PHIL 35,A00,907839,Staff,13,0,15,2
1746612886530,PHIL 60,A00,889574,Staff,73,0,90,17
1746612887556,PHIL 101,A00,958004,Staff,12,0,15,3
1746612889610,PHIL 136,A00,889582,Fulkerson; Matthew Todd,26,0,45,19
1746612890635,PHIL 163,A01,889601,Staff,21,0,30,9
1746612890635,PHIL 163,B01,889606,Brandt; Reuven A,0,3,0,0
1746612891665,PHIL 164,A00,889610,Staff,16,0,30,14
1746612892692,PHIL 165,A00,889613,Staff,22,0,30,8
1746612893720,PHYS 1A,A00,886431,Staff,30,0,70,40
1746612894754,PHYS 1AL,001,886432,Tsai; Philbert S,0,1,30,30
1746612894754,PHYS 1AL,002,886436,Tsai; Philbert S,13,0,30,17
1746612895779,PHYS 1B,A00,886439,Staff,184,0,240,56
1746612896808,PHYS 1BL,001,886441,Tsai; Philbert S,0,4,30,30
1746612896808,PHYS 1BL,002,886444,Tsai; Philbert S,2,0,30,28
1746612897843,PHYS 1C,A00,896092,Arnold; Kam S,78,0,146,68
1746612898871,PHYS 1CL,001,886448,Tsai; Philbert S,0,1,30,30
1746612898871,PHYS 1CL,002,886449,Tsai; Philbert S,1,0,30,29
1746612898871,PHYS 1CL,003,886450,Tsai; Philbert S,16,0,30,14
1746612898871,PHYS 1CL,004,886451,Tsai; Philbert S,15,0,30,15
1746612899898,PHYS 2B,A01,886457,Staff,67,0,115,48
1746612900928,PHYS 2C,A01,886460,Shotwell; Brian,0,9,65,65
1746612901957,PHYS 2CL,A01,886467,Staff,0,4,28,28
1746612901957,PHYS 2CL,A02,886468,Staff,0,3,28,28
1746612902983,PHYS 2D,A01,886470,Staff,10,0,50,40
1746612904016,PHYS 4B,A01,886475,Grinstein; Benjamin,22,0,40,18
1746612905048,POLI 5,A00,891173,Desposato; Scott,7,0,25,18
1746612906072,POLI 5D,A01,891175,Staff,5,0,5,0
1746612906072,POLI 5D,B01,891178,Staff,5,0,5,0
1746612907104,POLI 11,A00,891179,Ferree; Karen E,0,0,35,35
1746612908134,POLI 12,A00,891180,Staff,15,0,30,15
1746612909161,POLI 27,A01,891182,Staff,11,0,75,64
1746612910186,POLI 30,A00,891183,Staff,8,0,50,42
1746612911215,POLI 100B,A00,891244,Staff,5,1,35,30
1746612912242,POLI 100I,A00,891247,Staff,7,0,30,23
1746612913268,POLI 104J,A00,891248,Nichter; Maysa,14,0,30,16
1746612914293,POLI 104U,A00,891250,Nichter; Maysa,1,0,30,29
1746612916351,POLI 110B,A00,891255,Wiens; David,19,0,25,6
1746612917383,POLI 112A,A00,891256,Wiens; David,6,0,25,19
1746612918410,POLI 114BR,A00,891261,Staff,19,0,30,11
1746612919433,POLI 117R,A00,891262,Forman; Fonna,0,6,50,50
1746612920460,POLI 118,A00,891264,Ingham; Sean,17,0,25,8
1746612921486,POLI 124A,A00,891265,Staff,18,0,20,2
1746612922512,POLI 125D,A00,891266,Nichter; Simeon C,2,0,25,23
1746612923542,POLI 126,A00,891268,Nichter; Simeon C,7,0,25,18
1746612924568,POLI 126AA,A00,891272,Staff,15,0,25,10
1746612925596,POLI 130AA,A00,891273,Staff,15,0,20,5
1746612926620,POLI 134AA,A00,891274,Staff,4,0,20,16
1746612928673,POLI 138,A00,891278,Staff,21,0,25,4
1746612929699,POLI 142K,A00,891280,Staff,10,0,25,15
1746612930729,POLI 142M,A00,891281,Gartzke; Erik,16,0,30,14
1746612931757,POLI 142P,A00,891284,Staff,20,0,30,10
1746612932804,POLI 143,A00,891285,Gartzke; Erik,12,0,30,18
1746612933829,POLI 153,A00,891286,Staff,19,0,20,1
1746612935886,POLI 175,A00,891290,Staff,15,0,20,5
1746612936915,PSYC 1,A00,890674,Steiner; Eric Tomas,0,11,45,45
1746612937944,PSYC 2,A00,890676,Albright; Thomas D,20,0,35,15
1746612938974,PSYC 3,A00,890679,Staff,17,0,20,3
1746612940000,PSYC 6,A00,959858,Staff,19,0,20,1
1746612941030,PSYC 60,A01,890684,Rickard; Timothy C.,0,6,45,45
1746612942056,PSYC 70,A01,890689,Geller; Emma Harlan,6,0,30,24
1746612943081,PSYC 71,A01,959860,Staff,21,0,25,4
1746612944112,PSYC 100,A00,890690,Lacefield; Katharine I,0,50,180,180
1746612945137,PSYC 102,A00,890695,Staff,18,0,40,22
1746612946164,PSYC 105,A00,890699,Geller; Emma Harlan,70,0,100,30
1746612947192,PSYC 106,A00,890701,Gorman; Michael R.,5,0,30,25
1746612948220,PSYC 108,A00,890704,Adrian; Julia Anna,0,29,50,50
1746612949245,PSYC 118,A01,890712,Staff,11,0,30,19
1746612950273,PSYC 124,A00,890716,Chapman; Eddie Nathaniel,25,0,60,35
1746612951299,PSYC 131,A00,890717,Anagnostaras; Stephan,0,7,80,80
1746612952330,PSYC 137,A00,890719,Winkielman; Piotr,0,11,30,30
1746612953356,PSYC 144,A00,890721,Adrian; Julia Anna,0,9,45,45
1746612954383,PSYC 162,A00,890805,Staff,0,2,75,75
1746612955411,PSYC 169,A00,890810,Staff,0,15,30,30
1746612956444,PSYC 172,A00,890814,Gorman; Michael R.,9,0,30,21
1746612957471,PSYC 181,A00,890818,Anagnostaras; Stephan,6,0,200,194
1746612958499,PSYC 184,A00,959861,Staff,160,0,175,15
1746612959526,PSYC 189,A00,890823,Staff,0,2,30,30
1746612960556,PSYC 191,A00,890884,Rickard; Timothy C.,0,12,35,35
1746612961587,PSYC 193,A00,890913,Staff,19,0,30,11
1746612961587,PSYC 193,B00,890914,Chapman; Eddie Nathaniel,24,0,30,6
1746612962616,PSYC 193L,A01,890918,Lowe; Angela Beth,20,0,30,10
1746612962616,PSYC 193L,B01,890921,Hurwitz; Ethan Scott,20,0,30,10
1746612962616,PSYC 193L,C01,890928,Staff,30,0,30,0
1746612963644,RELI 149,A00,886806,Rahimi; Babak,23,0,40,17
1746612964671,SE 9,A01,886814,Staff,7,0,20,13
1746612965701,SE 101B,A01,886816,Chadha; Mayank,3,0,35,32
1746612966731,SE 110B,A00,886818,Zhu; Qiang,4,0,75,71
1746612967760,SE 125,A01,886830,Staff,10,0,30,20
1746612968786,SE 130B,A01,886835,Staff,14,0,40,26
1746612969811,SE 131A,A01,886838,Krysl; Petr,34,0,55,21
1746612970837,SE 154,A00,886840,Staff,28,0,50,22
1746612971902,SE 164GS,A01,886849,Staff,6,0,20,14
1746612972930,SE 167GS,A01,886853,Staff,6,0,20,14
1746612973958,SIO 25,A01,890107,Staff,19,0,30,11
1746612974989,SIO 45,A00,890109,Cook; Geoffrey W,114,0,200,86
1746612976017,SIO 109R,A00,890110,Forman; Fonna,0,16,20,20
1746612977047,SIO 187,A01,890114,Kacev; David,15,0,40,25
1746612978077,SOCI 1,A01,890431,Thorpe; Charles Robert,14,0,30,16
1746612978077,SOCI 1,A02,890518,Thorpe; Charles Robert,30,0,30,0
1746612979103,SOCI 2,A01,957978,Staff,25,0,25,0
1746612979103,SOCI 2,A02,957979,Staff,23,0,25,2
1746612980130,SOCI 20,A01,890523,Calderon-Zaks; Michael Aar,21,0,30,9
1746612980130,SOCI 20,A02,890526,Calderon-Zaks; Michael Aar,29,0,30,1
1746612981156,SOCI 30,A01,890533,Pardo Guerra; Juan Pablo,37,0,40,3
1746612982187,SOCI 40,A01,890535,Staff,27,0,45,18
1746612983214,SOCI 104Q,A00,890559,Staff,17,0,30,13
1746612984241,SOCI 106,A00,890560,Arnal; Maud Marie Leonie,20,0,30,10
1746612985268,SOCI 110,A00,890567,Holkenbrink-Monk; Charlene,19,0,30,11
1746612986299,SOCI 112,A00,890568,Victoria Torres; Pablo,2,0,55,53
1746612987329,SOCI 115,A00,890597,Arnal; Maud Marie Leonie,28,0,45,17
1746612989382,SOCI 121,A00,890604,Pardo Guerra; Juan Pablo,38,0,45,7
1746612990408,SOCI 126,A01,890608,Staff,8,0,10,2
1746612991434,SOCI 127,A00,890609,Staff,18,0,30,12
1746612992460,SOCI 131,A00,890610,Thorpe; Charles Robert,37,0,45,8
1746612993492,SOCI 135,A00,890615,Payne; Christine Anna,14,0,45,31
1746612994517,SOCI 139,A00,890620,Staff,38,0,45,7
1746612995546,SOCI 148E,A00,890622,Calderon-Zaks; Michael Aar,36,0,45,9
1746612996574,SOCI 150,A00,890623,Kohler; Kristopher M.,31,0,45,14
1746612997602,SOCI 157,A00,890625,Jules-Rosette; Bennetta W.,18,0,20,2
1746612998629,SOCI 160,A00,890627,Payne; Christine Anna,21,0,45,24
1746612999656,SYN 1,A00,886855,Fish; Gwendolyn Anne,0,1,0,0
1746612999656,SYN 1,B00,906086,Fish; Gwendolyn Anne,0,2,0,2
1746613000690,SYN 2R,A00,886860,Staff,0,17,15,15
1746613000690,SYN 2R,B00,906106,Atkinson; Arthur Laird,0,16,15,15
1746613001720,SYN 100,A01,886866,Browne; Emily,0,28,20,20
1746613001720,SYN 100,B01,906128,Rock; Martin,0,4,20,20
1746613001720,SYN 100,C01,906140,Deavenport; James Cary,0,4,20,20
1746613001720,SYN 100,D01,907816,Deavenport; James Cary,0,5,20,20
1746613002749,TDAC 1,A00,890286,Walsh; Kim C.,7,0,20,13
1746613003776,TDAC 101,A00,890296,Basso; Beatrice,15,0,20,5
1746613004806,TDDE 131,A00,890297,Staff,47,0,50,3
1746613005833,TDDM 1,A00,890287,Weinberg; Sadie,25,0,30,5
1746613006863,TDGE 11,A00,890288,Fulton; Julia,138,0,200,62
1746613006863,TDGE 11,B00,890289,Castro; Robert Jess,184,0,200,16
1746613007891,TDGE 25,B00,957359,Walsh; Kim C.,5,0,20,15
1746613008923,TDGE 40,A01,890292,Power; Jade Yukana,26,0,30,4
1746613009951,TDGE 124,A00,890298,Havis; Allan,0,2,50,50
1746613010982,TDGE 131R,A00,890299,Burelle; Julie Sara Veronique,15,0,42,27
1746613012009,TDHT 101,A00,890300,Staff,10,0,20,10
1746613013037,TDHT 109,A01,890302,Anderson; Mysia Anyse,31,0,40,9
1746613014067,TDMV 1,A00,890293,Arcidiacono; Kristin,18,0,30,12
1746613015093,TDMV 2,A00,890294,Weinberg; Sadie,23,0,30,7
1746613016126,TDMV 3,A00,957878,Arcidiacono; Kristin,28,0,30,2
1746613018182,TDMV 138,A00,890304,Jun; Grace Shin Hae,25,0,40,15
1746613019209,TDMV 140,A00,890305,Corrales; Joseph Bernales,25,0,30,5
1746613020242,TDMV 142,A00,890307,Caligagan; Tony,32,0,40,8
1746613021273,TDMV 144,A00,890308,Camaya; Michelle Ann,25,0,30,5
1746613022300,TDPW 1,A00,890295,Stein; Deborah Isobel,3,0,20,17
1746613023327,USP 2,A01,890272,Lerner; Amy M,7,0,20,13
1746613024352,USP 3,A01,890274,Staff,12,0,30,18
1746613025384,USP 15,A01,890276,Sun; Feiyang,16,0,30,14
1746613026415,USP 25,A00,890277,Shenkman; Michael Thomas,18,0,25,7
1746613027440,USP 138,A00,890278,Staff,13,0,25,12
1746613028468,USP 143,A00,890279,Staff,21,0,70,49
1746613029496,USP 144,A00,890280,Chowdhury; Muhammed Zohir,16,0,30,14
1746613030523,USP 150,A00,890281,Boomhower; Matthew Charles,4,0,30,26
1746613031550,USP 151,A00,890282,Staff,16,0,20,4
1746613032578,USP 162,A00,890283,Andrews; Abigail Leslie,16,0,20,4
1746613033605,USP 168,A00,920477,Kwak; Nancy,0,0,5,5
1746613034637,USP 181,A00,890284,Staff,3,0,20,17
1746613035668,USP 191A,A00,890285,Staff,12,0,20,8
1746613036695,VIS 101,A00,886512,Staff,26,0,75,49
1746613037723,VIS 103,A00,886513,Cruz; Edwin Teddy,61,0,75,14
1746613038780,VIS 108,A00,886514,Staff,4,0,15,11
1746613039811,VIS 127P,A00,886515,Shen; Kuiyi,80,0,146,66
1746613040840,VIS 149,A00,886516,Yoldas; Pinar,0,0,15,15
1746613041867,VIS 164,A00,886526,Erdmann; Dean,19,0,22,3
1746613042893,VIS 194S,A00,886527,Staff,61,0,75,14
1746613043922,WCWP 10A,C00,886484,Martiniuk; Jill,12,0,15,3
1746613044951,WCWP 10B,A00,886490,Uriarte; Emma,0,0,15,15
1746613044951,WCWP 10B,B00,886491,Dhir; Simrita,8,0,15,7
1746613044951,WCWP 10B,C00,886492,Ornelas; Tricia,0,0,15,15
1746613045978,WCWP 100,A00,886494,Young; Mark T,0,6,15,15
1746613048200,AAS 10,A01,886199,Childs; Dennis R.,0,3,0,0
1746613049228,ANAR 104,A01,886940,Shtienberg; Gilad,27,0,30,3
1746613050254,ANAR 120,A00,886953,Staff,13,0,20,7
1746613051281,ANBI 148,A01,886955,Wilder; Linnea Lorene,30,0,40,10
1746613053333,ANSC 122,A00,886957,Staff,24,0,30,6
1746613054359,ANSC 150,A00,886958,Sloane; Julia Kathryn,2,0,15,13
1746613055390,ANSC 156,A00,886959,Jenkins; Janis A.,0,1,15,15
1746613056427,ANSC 180,A00,886960,Staff,11,0,17,6
1746613057458,ANSC 188,A00,886961,Jassal; Aftab,9,0,25,16
1746613058484,ANSC 190,A00,886962,Jassal; Aftab,14,0,25,11
1746613059510,ANSC 191,A00,886963,Staff,18,0,20,2
1746613060538,ANTH 3,A01,891689,Staff,17,0,20,3
1746613061564,ANTH 5,A00,886933,Semendeferi; Ekaterini,16,0,20,4
1746613062592,ANTH 10,A00,886934,Staff,0,12,30,30
1746613063618,ANTH 21,A01,886936,Staff,41,0,60,19
1746613064648,ANTH 23,A01,886938,Staff,92,0,100,8
1746613065679,ANTH 105,A00,886964,Stewart; Alexander B,84,0,100,16
1746613066712,ANTH 108,A00,886965,Pedersen; David,9,0,20,11
1746613067742,AWP 10,001,886147,Staff,0,0,0,0
1746613067742,AWP 10,002,886148,Staff,0,0,0,0
1746613067742,AWP 10,003,886149,Staff,0,0,0,0
1746613067742,AWP 10,004,886150,Staff,0,0,0,0
1746613067742,AWP 10,005,886151,Staff,0,0,0,0
1746613067742,AWP 10,006,886152,Staff,0,0,0,0
1746613067742,AWP 10,007,886153,Staff,0,0,0,0
1746613067742,AWP 10,008,886154,Staff,0,0,0,0
1746613067742,AWP 10,009,886155,Staff,0,0,0,0
1746613067742,AWP 10,010,886156,Staff,0,0,0,0
1746613067742,AWP 10,011,886158,Staff,0,0,0,0
1746613067742,AWP 10,012,886160,Staff,0,0,0,0
1746613067742,AWP 10,013,886161,Staff,0,0,0,0
1746613067742,AWP 10,014,886162,Staff,0,0,0,0
1746613067742,AWP 10,015,886163,Staff,0,0,0,0
1746613067742,AWP 10,016,886164,Staff,0,0,0,0
1746613067742,AWP 10,017,886165,Staff,0,0,0,0
1746613067742,AWP 10,018,886166,Staff,0,0,0,0
1746613067742,AWP 10,019,886168,Staff,0,0,0,0
1746613067742,AWP 10,020,886170,Staff,0,0,0,0
1746613067742,AWP 10,021,886172,Staff,0,0,0,0
1746613068775,AWP 10R,001,886173,Staff,0,1,0,0
1746613068775,AWP 10R,002,886174,Staff,0,1,0,0
1746613068775,AWP 10R,003,886175,Staff,0,0,0,0
1746613068775,AWP 10R,004,886176,Staff,0,0,0,0
1746613068775,AWP 10R,005,886177,Staff,0,0,0,0
1746613068775,AWP 10R,006,886178,Staff,0,0,0,0
1746613068775,AWP 10R,007,886179,Staff,0,0,0,0
1746613068775,AWP 10R,008,886181,Staff,0,0,0,0
1746613068775,AWP 10R,009,886182,Staff,0,0,0,0
1746613068775,AWP 10R,010,886183,Staff,0,0,0,0
1746613068775,AWP 10R,011,886184,Staff,0,0,0,0
1746613068775,AWP 10R,012,886185,Staff,0,0,0,0
1746613068775,AWP 10R,013,886186,Staff,0,0,0,0
1746613068775,AWP 10R,014,886187,Staff,0,0,0,0
1746613068775,AWP 10R,015,886188,Staff,0,0,0,0
1746613068775,AWP 10R,016,886189,Staff,0,0,0,0
1746613068775,AWP 10R,017,960532,Staff,0,0,0,0
1746613068775,AWP 10R,018,960533,Staff,0,0,0,0
1746613068775,AWP 10R,019,960534,Staff,0,0,0,0
1746613068775,AWP 10R,020,960538,Staff,0,0,0,0
1746613068775,AWP 10R,021,960540,Staff,0,0,0,0
1746613068775,AWP 10R,022,960541,Staff,0,0,0,0
1746613068775,AWP 10R,023,960542,Staff,0,0,0,0
1746613068775,AWP 10R,024,960544,Staff,0,0,0,0
1746613068775,AWP 10R,025,960545,Staff,0,0,0,0
1746613068775,AWP 10R,026,960548,Staff,0,0,0,0
1746613069804,AWP 102R,A00,886190,Staff,0,0,0,0
1746613069804,AWP 102R,B00,886191,Staff,0,0,0,0
1746613070836,BENG 100,A01,886193,Staff,17,0,30,13
1746613071861,BENG 122A,A01,886195,Hasty; Jeff M,13,0,30,17
1746613072888,BENG 166A,A00,886196,Sah; Robert Lie-Yuan,0,3,30,30
1746613073915,BENG 190,A00,958050,Khojah; Reem I,17,0,25,8
1746613074977,BIBC 102,A01,894320,Staff,0,1,46,46
1746613074977,BIBC 102,A02,894321,Staff,0,0,46,46
1746613074977,BIBC 102,A03,894344,Staff,6,0,46,40
1746613074977,BIBC 102,A04,894345,Staff,27,0,47,20
1746613076013,BICD 100R,A01,894365,Smith; Laurie,0,2,58,58
1746613076013,BICD 100R,A02,894366,Smith; Laurie,0,4,58,58
1746613076013,BICD 100R,A03,894367,Smith; Laurie,0,0,59,59
1746613076013,BICD 100R,A04,959869,Smith; Laurie,38,0,59,21
1746613077048,BICD 136,A01,894383,Gustafson-Brown; Cindy,14,0,50,36
1746613078080,BIEB 102,A01,894494,Butler; Shannon Rhey,51,0,130,79
1746613080183,BIEB 150,A01,894617,Wills; Christopher,3,0,20,17
1746613080183,BIEB 150,A02,894631,Wills; Christopher,3,0,20,17
1746613080183,BIEB 150,A03,894937,Wills; Christopher,3,0,20,17
1746613080183,BIEB 150,A04,894946,Wills; Christopher,5,0,20,15
1746613081209,BIEB 194,A00,906141,Kurle; Carolyn M.,5,0,20,15
1746613082242,BILD 1,A01,894154,Staff,3,0,19,16
1746613082242,BILD 1,A02,894155,Staff,14,0,19,5
1746613082242,BILD 1,A03,894160,Staff,13,0,19,6
1746613082242,BILD 1,A04,894161,Staff,15,0,18,3
1746613083273,BILD 2,A01,894168,Staff,0,0,50,50
1746613083273,BILD 2,A02,894169,Staff,0,0,50,50
1746613083273,BILD 2,A03,894179,Staff,0,0,50,50
1746613083273,BILD 2,A04,894203,Staff,22,0,50,28
1746613084300,BILD 3,A01,894213,Staff,23,0,31,8
1746613084300,BILD 3,A02,894214,Staff,26,0,31,5
1746613084300,BILD 3,A03,894235,Staff,28,0,31,3
1746613084300,BILD 3,A04,894236,Staff,28,0,32,4
1746613085333,BILD 4,A01,894253,Reuther; Keefe,5,0,24,19
1746613085333,BILD 4,A02,894258,Reuther; Keefe,16,0,24,8
1746613086364,BILD 5,A01,894276,Reuther; Keefe,33,0,50,17
1746613086364,BILD 5,A02,894277,Reuther; Keefe,45,0,50,5
1746613086364,BILD 5,A03,894290,Reuther; Keefe,44,0,50,6
1746613086364,BILD 5,A04,894291,Reuther; Keefe,48,0,50,2
1746613087396,BILD 24,A01,894297,Pirino; Giorgia,40,0,60,20
1746613088424,BIMM 100,B01,958915,Staff,71,0,100,29
1746613089457,BIMM 101,A01,895017,McDonnell; Lisa Marie,0,5,24,24
1746613089457,BIMM 101,A02,895018,McDonnell; Lisa Marie,0,5,24,24
1746613089457,BIMM 101,B01,895020,McDonnell; Lisa Marie,0,5,24,24
1746613089457,BIMM 101,B02,895021,McDonnell; Lisa Marie,0,4,24,24
1746613090484,BIMM 110,A01,895023,Staff,1,0,25,24
1746613090484,BIMM 110,A02,895024,Staff,9,0,25,16
1746613090484,BIMM 110,A03,895025,Staff,18,0,25,7
1746613090484,BIMM 110,A04,895031,Staff,20,0,25,5
1746613091520,BIMM 120,A01,895114,Gustafson-Brown; Cindy,14,0,28,14
1746613091520,BIMM 120,A02,895126,Gustafson-Brown; Cindy,21,0,27,6
1746613092552,BIPN 100,A01,895130,Yang; Mingyu,0,0,38,38
1746613092552,BIPN 100,A02,895131,Yang; Mingyu,31,0,38,7
1746613092552,BIPN 100,A03,895132,Yang; Mingyu,32,0,38,6
1746613092552,BIPN 100,A04,895133,Yang; Mingyu,27,0,36,9
1746613093585,BIPN 120,A01,895135,Cooke; James Edward,0,3,13,13
1746613093585,BIPN 120,A02,895136,Cooke; James Edward,0,1,13,13
1746613093585,BIPN 120,A03,895137,Cooke; James Edward,0,3,13,13
1746613093585,BIPN 120,A04,895156,Cooke; James Edward,0,2,11,11
1746613094622,BIPN 134,A01,895235,Cooke; James Edward,0,1,25,25
1746613094622,BIPN 134,A02,895237,Cooke; James Edward,0,0,25,25
1746613094622,BIPN 134,A03,895240,Cooke; James Edward,1,0,25,24
1746613094622,BIPN 134,A04,895270,Cooke; James Edward,20,0,25,5
1746613095649,BIPN 189,A00,892103,Staff,0,14,14,14
1746613097706,BISP 194,A00,958008,Staff,0,2,0,0
1746613098735,CAT 124,A01,922009,Staff,0,5,20,20
1746613099768,CAT 125R,A00,886390,Morales; Celeste Georgianna,0,4,20,20
1746613099768,CAT 125R,B00,886391,Irwin; Matthew Joseph,0,4,20,20
1746613099768,CAT 125R,C00,886392,Smith; Lauryn Alissa,0,2,20,20
1746613099768,CAT 125R,D00,886393,Vanderschuit; Maya Alysia,0,3,20,20
1746613099768,CAT 125R,E00,886394,Marchisotto; Jennifer Anne,0,3,20,20
1746613100795,CENG 15,A01,886218,Drews; Aaron,3,0,8,5
1746613101826,CENG 113,A00,886219,Opatkiewicz; Justin Paul,15,0,25,10
1746613102853,CGS 101,A00,887044,Staff,7,0,20,13
1746613103878,CGS 105,A01,887046,Staff,14,0,25,11
1746613104905,CGS 112,A00,887047,Cuong; Marisol,12,0,15,3
1746613105932,CGS 113,A00,887048,Staff,23,0,30,7
1746613106957,CGS 120,A00,887049,Staff,9,0,17,8
1746613107989,CHEM 6A,A01,886336,Lam; Tin Yiu,38,0,50,12
1746613107989,CHEM 6A,A02,886338,Lam; Tin Yiu,37,0,50,13
1746613109021,CHEM 6B,A01,886341,Hopkins; Patrycja Anna,16,0,50,34
1746613109021,CHEM 6B,A02,886343,Hopkins; Patrycja Anna,42,0,50,8
1746613110048,CHEM 6C,A01,886346,Albizati; Kim F.,0,2,50,50
1746613110048,CHEM 6C,A02,886348,Albizati; Kim F.,24,0,50,26
1746613111078,CHEM 40A,A01,886352,Klosterman; Jeremy K,65,0,100,35
1746613112104,CHEM 40B,A01,886356,Klosterman; Jeremy K,0,24,100,100
1746613113131,CHEM 41B,A01,886360,Theodorakis; Emmanuel,25,0,50,25
1746613113131,CHEM 41B,A02,886362,Theodorakis; Emmanuel,47,0,50,3
1746613114159,CHIN 165A,A00,886382,Xu; Li,18,0,20,2
1746613115187,CLAS 120,A00,886387,Myerston Santana; Jacobo,33,0,40,7
1746613116216,COGS 9,A01,886967,Shannon; Kyle Michael,42,0,60,18
1746613117243,COGS 11,A01,886969,Staff,9,0,30,21
1746613118269,COGS 14A,A01,886971,Staff,5,0,60,55
1746613119296,COGS 14B,A01,886973,Hoffman; Drew Ellen,4,0,60,56
1746613120329,COGS 18,A01,886975,Morgan; Eric,34,0,60,26
1746613121356,COGS 20,A01,886977,Staff,3,0,8,5
1746613121356,COGS 20,A02,886978,Staff,5,0,7,2
1746613122383,COGS 100,A01,907783,Staff,0,1,30,30
1746613123416,COGS 101B,A01,886980,Staff,0,4,48,48
1746613124442,COGS 101C,A01,886982,Delgado; Tania,0,5,44,44
1746613125470,COGS 102A,A01,886984,Johnson; Christine M.,3,0,30,27
1746613126500,COGS 118B,A01,886986,Staff,0,4,88,88
1746613127528,COGS 150,A01,886988,Bergen; Benjamin,22,0,50,28
1746613128558,COGS 153,A00,886989,Delgado; Tania,1,3,41,40
1746613129588,COGS 186,A01,886991,Staff,0,0,32,32
1746613130616,COGS 187A,A01,886993,Boyle; Mary E. T.,7,0,30,23
1746613131644,COGS 189,A00,886994,Staff,0,1,30,30
1746613132675,COMM 10,A01,886996,Staff,0,0,20,21
1746613132675,COMM 10,A02,886997,Staff,10,0,20,10
1746613132675,COMM 10,A03,959845,Staff,19,0,20,1
1746613133704,COMM 20,A01,886999,Leuning; Grant Maurstad,24,0,40,16
1746613135797,COMM 100A,A01,887002,Staff,0,0,20,25
1746613135797,COMM 100A,A02,887003,Staff,5,0,20,15
1746613136823,COMM 100B,A01,887005,Staff,0,8,20,24
1746613137853,COMM 106D,A00,887006,Staff,14,0,40,26
1746613138880,COMM 110G,A00,887007,Whitworth-Smith; Andrew C,12,0,40,28
1746613139908,COMM 111B,A00,887008,Staff,31,0,40,9
1746613140945,COMM 113T,A00,887009,Abuelhiga; Soraya Jill,28,0,40,12
1746613140945,COMM 113T,B00,906733,Staff,39,0,40,1
1746613141977,COMM 145,A00,887010,Staff,13,0,40,27
1746613143003,COMM 146,A00,887054,Staff,32,0,40,8
1746613144030,COMM 190,A00,887012,Staff,8,0,23,15
1746613145060,CSE 8A,A50,887015,Cao; Yingjun,56,0,85,29
1746613146096,CSE 11,A01,887017,Cao; Yingjun,11,0,70,59
1746613147127,CSE 20,A01,887019,Staff,30,0,50,20
1746613148155,CSE 21,A01,887021,Staff,79,0,100,21
1746613148155,CSE 21,B01,892583,Braun; Oliver,45,0,50,5
1746613149186,CSE 30,A01,887025,Eldon; John,142,0,200,58
1746613150218,CSE 100,A01,887027,Staff,26,0,50,24
1746613150218,CSE 100,A02,887028,Staff,42,0,50,8
1746613151245,CSE 101,A01,887030,Braun; Oliver,74,0,100,26
1746613151245,CSE 101,B01,887032,Jones; Miles E,0,3,50,50
1746613151245,CSE 101,B02,887033,Jones; Miles E,0,2,50,50
1746613152273,CSE 105,A01,908084,Jones; Miles E,32,0,50,18
1746613152273,CSE 105,A02,908087,Jones; Miles E,31,0,50,19
1746613153305,CSE 135,A01,887035,Powell; Thomas Allan,0,5,50,50
1746613154333,CSE 142,A01,887037,Staff,7,0,60,53
1746613155359,CSE 142L,A01,887039,Staff,34,0,60,26
1746613156391,CSE 151A,A01,887041,Solares; Edwin A,47,0,100,53
1746613157420,CSE 175,A01,887043,Kumar; Rakesh,30,0,30,0
1746613158450,CSS 1,A01,886389,Staff,0,1,40,40
1746613159483,DSC 30,A01,908097,Liao; Soohyun Nam,47,0,75,28
1746613160514,DSC 40A,A01,908099,Shannon; Kyle Michael,30,0,50,20
1746613161541,DSC 40B,A01,908112,Staff,15,0,50,35
1746613162576,DSC 80,A01,908116,Staff,19,0,60,41
1746613163603,DSC 197,001,956863,Eldridge; Justin Matthew,9999,0,9999,0
1746613164631,ECE 5,A01,886400,Morris; Karcher William,1,0,6,5
1746613164631,ECE 5,A02,886401,Morris; Karcher William,3,0,6,3
1746613165658,ECE 148,A01,886403,Silberman; Jack,0,14,14,14
1746613166687,ECON 1,A01,887265,Crane; Meredith Helen,11,0,70,59
1746613166687,ECON 1,B01,887268,Staff,42,0,50,8
1746613167714,ECON 2,A01,887273,Crane; Meredith Helen,54,0,70,16
1746613168826,ECON 3,A01,887279,Rondina; Giacomo,31,0,70,39
1746613169854,ECON 4,A01,887282,Anderson; John Charles,0,2,10,10
1746613170880,ECON 5,A01,887285,Staff,34,0,45,11
1746613170880,ECON 5,B01,887292,Staff,41,0,45,4
1746613171918,ECON 100A,A01,887337,Newhouse; Herbert S,54,0,70,16
1746613171918,ECON 100A,B01,887349,Staff,45,0,50,5
1746613172945,ECON 100B,A01,887361,Du; Songzi,29,0,70,41
1746613173971,ECON 100C,A01,887445,Newhouse; Herbert S,59,0,70,11
1746613174999,ECON 105,A00,887488,Vespa; Emanuel Ignacio,23,0,35,12
1746613176026,ECON 109,A01,887506,Shishkin; Denis,28,0,35,7
1746613177062,ECON 110A,A01,887568,Alon; Titan Michael,0,2,35,35
1746613177062,ECON 110A,B01,907601,Alon; Titan Michael,20,0,35,15
1746613178094,ECON 110B,A01,887598,Levkoff; Steven B.,0,24,70,70
1746613179118,ECON 112,A00,887599,Rondina; Giacomo,19,0,35,16
1746613180153,ECON 120A,A01,887603,Dai; Yinlin,36,0,70,34
1746613181181,ECON 120C,A01,887608,Sun; Yixiao,0,1,35,35
1746613181181,ECON 120C,B01,887614,Sun; Yixiao,0,0,35,35
1746613182212,ECON 138,A00,887621,Bharadwaj; Prashant,0,21,20,20
1746613183245,ECON 144,A00,958007,Squires; Dale E,11,0,35,24
1746613184295,ECON 171,A01,907666,Staff,18,0,35,17
1746613185322,ECON 175,A00,887626,Wu; Pak Yeung,22,0,35,13
1746613186351,ECON 190,A00,887640,Vespa; Emanuel Ignacio,22,0,35,13
1746613187403,EDS 25,A01,888197,Staff,0,0,0,0
1746613187403,EDS 25,A02,888209,Staff,0,0,0,0
1746613187403,EDS 25,A03,888210,Staff,0,0,0,0
1746613187403,EDS 25,A04,888212,Staff,0,0,0,0
1746613187403,EDS 25,A05,888213,Staff,0,0,0,0
1746613187403,EDS 25,A06,888214,Staff,0,0,0,0
1746613187403,EDS 25,A07,888235,Staff,0,2,0,0
1746613187403,EDS 25,A08,888236,Staff,0,0,0,0
1746613187403,EDS 25,A09,888240,Staff,0,0,0,0
1746613187403,EDS 25,A10,888244,Staff,0,0,0,0
1746613187403,EDS 25,B01,888273,Staff,0,0,0,0
1746613187403,EDS 25,B02,888285,Staff,0,0,0,0
1746613187403,EDS 25,B03,888423,Staff,0,0,0,1
1746613187403,EDS 25,B04,888432,Staff,0,0,0,0
1746613187403,EDS 25,B05,888433,Staff,0,0,0,0
1746613187403,EDS 25,B06,888467,Staff,0,0,0,0
1746613187403,EDS 25,B07,888468,Staff,0,0,0,0
1746613187403,EDS 25,B08,888479,Staff,0,0,0,0
1746613187403,EDS 25,B09,888484,Staff,0,0,0,0
1746613187403,EDS 25,B10,888487,Staff,0,0,0,0
1746613188430,EDS 38,A01,907700,Choi; Bailey Miyeon,30,0,30,0
1746613189457,EDS 112,A01,888601,Chapman; Thandeka K,12,0,40,28
1746613190482,EDS 115,A00,888697,Mendez; Kathrina Mendoza,10,0,30,20
1746613191575,EDS 116,A01,888893,Staff,33,0,40,7
1746613193668,EDS 124AR,A00,889133,Staff,29,0,50,21
1746613193668,EDS 124AR,B00,907471,Simon; Elizabeth A,37,0,50,13
1746613194693,EDS 124BR,A00,889134,Simon; Elizabeth A,44,0,100,56
1746613195719,EDS 125,A00,889135,Staff,25,0,30,5
1746613196746,EDS 126,A01,889138,Staff,35,0,40,5
1746613197771,EDS 164R,A01,889142,Wishard Guerra; Alison G.,32,0,50,18
1746613198803,ENG 30,A01,886396,Staff,0,0,0,0
1746613198803,ENG 30,B01,886398,Staff,0,0,0,0
1746613199832,ENVR 102,A00,906150,Montejo; Carolina,23,0,25,2
1746613200865,ETHN 103A,A00,887236,Man; Simeon S,0,2,0,0
1746613201894,ETHN 113,A00,887239,Staff,16,0,30,14
1746613202920,ETHN 116,A00,887240,Staff,16,0,25,9
1746613203953,ETHN 117,A00,887241,Choi; Esther Min,28,0,30,2
1746613204981,ETHN 118,A00,887243,Staff,24,0,30,6
1746613206009,ETHN 127,A00,887248,Cuong; Marisol,11,0,15,4
1746613207034,ETHN 139,A00,887250,Staff,7,0,10,3
1746613208060,ETHN 142,A00,887252,Staff,9,0,30,21
1746613209089,ETHN 161,A00,887253,Browne; Errol Tsekani,24,0,30,6
1746613210122,ETHN 163FR,A00,887255,Burelle; Julie Sara Veronique,0,0,5,5
1746613211148,GLBH 20,A00,889149,Elwardani; Nile Regina,8,0,42,34
1746613213225,GLBH 111,A01,889152,Burgos; Jose L.,17,0,17,0
1746613214259,GLBH 150,A00,889181,Sloane; Julia Kathryn,0,5,15,15
1746613216316,HDS 60,A01,886406,Warstadt; Melissa Fawn,72,0,80,8
1746613217348,HIAF 111,A00,889324,Gyamfi; Bright,25,0,32,7
1746613218377,HIEA 131,A00,889328,Staff,15,0,32,17
1746613219408,HIEA 144,A00,889333,Henry; Todd A.,26,0,32,6
1746613220434,HIEA 154,A00,889336,Henry; Todd A.,24,0,32,8
1746613221462,HIEU 106,A00,889339,Staff,22,0,32,10
1746613223517,HIEU 114,A00,889340,Staff,4,0,32,28
1746613224544,HIEU 135GS,A00,889342,Patterson; Patrick H.,0,0,1,24
1746613225599,HIEU 137,A00,889343,Edington; Claire Ellen,10,0,25,15
1746613226631,HIEU 148,A00,889345,Staff,14,0,32,18
1746613227662,HIEU 154,A00,889346,Biess; Frank Peter,21,0,32,11
1746613228688,HILA 102,A00,889351,Staff,12,0,32,20
1746613229714,HILD 2A,A01,889221,Lewandoski; Julia Mavis,0,8,32,32
1746613230748,HILD 7B,A01,889225,Man; Simeon S,0,12,32,32
1746613231774,HILD 7C,A01,889288,Alvarez; Luis A,0,14,32,32
1746613232801,HILD 30,A01,889323,Staff,0,5,32,32
1746613234868,HISC 119,A00,889383,Golan; Tal,20,0,32,12
1746613235894,HIUS 103,A00,889384,Man; Simeon S,0,0,32,32
1746613236928,HIUS 117,A00,919797,Kwak; Nancy,18,0,32,14
1746613237953,HIUS 142A,A00,919788,Staff,22,0,32,10
1746613240011,HIUS 149,A00,889386,Gyamfi; Bright,26,0,32,6
1746613241037,HIUS 155,A00,889387,Alvarez; Luis A,15,0,32,17
1746613242064,HUM 3,A01,886499,Caldwell; Michael Alan,19,0,50,31
1746613243092,HUM 3GS,A00,886500,Rodriguez; Bretton Sigfred,0,0,0,28
1746613244119,HUM 3R,A01,886502,Markman; Kristina,0,36,50,50
1746613245148,HUM 4,A01,886504,Crum; Matthew Stephen,23,0,50,27
1746613245148,HUM 4,B01,886506,West; Geoffrey Scott,17,0,50,33
1746613246173,HUM 4GS,A00,886507,Staff,0,0,0,19
1746613247202,HUM 5,A01,886509,Staff,31,0,50,19
1746613248235,HUM 5R,A01,886511,Zavodny; Tatiana Sophia,0,39,50,50
1746613249264,JAPN 180,A00,886407,Staff,16,0,40,24
1746613250292,LATI 50,A01,886409,Martin-Cabrera; Luis,3,0,22,19
1746613250292,LATI 50,A02,886410,Martin-Cabrera; Luis,19,0,22,3
1746613250292,LATI 50,A03,886411,Martin-Cabrera; Luis,21,0,22,1
1746613250292,LATI 50,A04,886412,Martin-Cabrera; Luis,8,0,22,14
1746613251320,LAWS 101,A00,907664,Staff,28,0,60,32
1746613252349,LIAB 1A,A00,889388,Saab; Dima,17,0,20,3
1746613253378,LIAB 1AX,A00,889389,El Cheddadi; Youniss,18,0,20,2
1746613254405,LIFR 1C,A00,889391,Van Moer; Vinciane G,8,0,20,12
1746613255433,LIFR 1CX,A00,889392,Van Moer; Vinciane G,7,0,20,13
1746613256465,LIFR 1D,A00,889393,Van Moer; Vinciane G,7,0,20,13
1746613257491,LIFR 1DX,A00,889394,Van Moer; Vinciane G,8,0,20,12
1746613258520,LIGN 7,A00,886923,Staff,25,0,50,25
1746613259547,LIGN 17,A00,886924,Kehler; Andrew Scott,126,0,150,24
1746613260573,LTAM 110,A00,889395,Staff,15,0,30,15
1746613261599,LTAM 110GS,A00,958010,Rodriguez; Bretton Sigfred,0,0,0,28
1746613262626,LTCH 101,A00,889397,Staff,23,0,25,2
1746613263654,LTCS 130,A00,889398,Staff,23,0,25,2
1746613264681,LTEA 138,A00,889399,Staff,24,0,40,16
1746613265707,LTEN 149,A00,889400,Wesling; Megan E.,0,3,25,25
1746613266735,LTEN 169,A00,889401,Staff,20,0,25,5
1746613267763,LTEN 180,A00,889402,Staff,10,0,15,5
1746613268792,LTEN 181,A00,889403,Staff,21,0,25,4
1746613269819,LTWL 100,A00,889404,Myerston Santana; Jacobo,2,0,25,23
1746613270846,LTWL 180GS,A00,889405,Staff,0,0,20,20
1746613271879,LTWL 181,A00,889406,Staff,16,0,25,9
1746613272910,LTWL 184,A00,889475,Mukherjee; Silpa,22,0,25,3
1746613273941,LTWR 102C,A00,889486,Staff,29,0,30,1
1746613274997,LTWR 115W,A00,889491,Staff,0,2,15,15
1746613276029,MAE 8,A01,886905,Staff,0,2,0,0
1746613277064,MAE 11,A00,886906,Bandaru; Prabhakar,0,7,50,50
1746613278091,MAE 20,A00,886907,Evdokimenko; Ekaterina,43,0,70,27
1746613279121,MAE 30B,A00,886909,Ghazinejad; Maziar,25,0,45,20
1746613280157,MAE 101B,A00,886910,Saintillan; David,30,0,45,15
1746613281186,MAE 105,A00,886911,Bandaru; Prabhakar,18,0,50,32
1746613282218,MAE 107,B00,958024,Staff,7,0,50,43
1746613283245,MAE 143B,A00,886913,Bewley; Thomas R,2,0,40,38
1746613284272,MAE 148,A01,886915,Silberman; Jack,0,3,14,14
1746613285299,MAE 160,A00,886916,Evdokimenko; Ekaterina,30,0,60,30
1746613286331,MATH 3C,A01,889681,Staff,0,2,30,30
1746613286331,MATH 3C,A02,960048,Staff,23,0,30,7
1746613287358,MATH 10A,A01,889760,Staff,26,0,30,4
1746613287358,MATH 10A,A02,889783,Staff,29,0,30,1
1746613288385,MATH 10B,A01,889785,Verstraete; Jacques Allan,1,0,35,34
1746613288385,MATH 10B,A02,889795,Verstraete; Jacques Allan,4,0,35,31
1746613288385,MATH 10B,B01,889797,Verstraete; Jacques Allan,3,0,35,32
1746613288385,MATH 10B,B02,889828,Verstraete; Jacques Allan,3,0,35,32
1746613289420,MATH 10C,A01,889849,Habib; Yousaf,8,0,30,22
1746613289420,MATH 10C,A02,889852,Habib; Yousaf,14,0,30,16
1746613289420,MATH 10C,A03,889853,Habib; Yousaf,22,0,30,8
1746613289420,MATH 10C,A04,889858,Habib; Yousaf,20,0,30,10
1746613289420,MATH 10C,B01,889861,Staff,1,0,30,29
1746613289420,MATH 10C,B02,889862,Staff,24,0,30,6
1746613289420,MATH 10C,B03,889863,Staff,27,0,30,3
1746613289420,MATH 10C,B04,889967,Staff,23,0,30,7
1746613290456,MATH 18,A01,889974,Staff,6,0,30,24
1746613290456,MATH 18,A02,889977,Staff,20,0,30,10
1746613290456,MATH 18,B01,889984,Hardiman; Liam,20,0,30,10
1746613290456,MATH 18,B02,889985,Hardiman; Liam,25,0,30,5
1746613291482,MATH 20A,A01,889990,Suk; Andrew Hoon,30,0,35,5
1746613292509,MATH 20B,A01,889993,Ohm; Ko Woon,21,0,30,9
1746613292509,MATH 20B,A02,889994,Ohm; Ko Woon,30,0,30,0
1746613292509,MATH 20B,B01,889996,Ohm; Ko Woon,22,0,30,8
1746613292509,MATH 20B,B02,889997,Ohm; Ko Woon,23,0,30,7
1746613293543,MATH 20C,A01,889999,Hammock; Frances H,17,0,30,13
1746613293543,MATH 20C,A02,890003,Hammock; Frances H,23,0,30,7
1746613293543,MATH 20C,B01,890006,Hammock; Frances H,2,0,30,28
1746613293543,MATH 20C,B02,890007,Hammock; Frances H,11,0,30,19
1746613294576,MATH 20D,A01,890011,Cheng; Hsiao-Bing,1,0,30,29
1746613294576,MATH 20D,A02,890012,Cheng; Hsiao-Bing,14,0,30,16
1746613294576,MATH 20D,B01,890016,Cheng; Hsiao-Bing,13,0,30,17
1746613294576,MATH 20D,B02,890017,Cheng; Hsiao-Bing,13,0,30,17
1746613295605,MATH 20E,A01,890026,Harel; Guershon,1,0,30,29
1746613295605,MATH 20E,A02,890029,Harel; Guershon,22,0,30,8
1746613295605,MATH 20E,B01,890033,Harel; Guershon,7,0,30,23
1746613295605,MATH 20E,B02,890101,Harel; Guershon,21,0,30,9
1746613296631,MATH 102,A01,890104,Staff,18,0,30,12
1746613296631,MATH 102,A02,890105,Staff,27,0,30,3
1746613297660,MATH 103B,A01,890116,Salehi Golsefidy; Alireza,3,0,30,27
1746613297660,MATH 103B,B01,890118,Staff,0,3,34,34
1746613298694,MATH 109,A01,890121,Aliabadi Sr.; Mohsen,0,0,30,30
1746613298694,MATH 109,B01,890124,Upadrashta; Pranav Kumar,18,0,30,12
1746613299724,MATH 120A,A01,890126,Eggers; John Dietrich,13,0,30,17
1746613300751,MATH 142B,A01,890128,Ioana; Adrian,19,0,30,11
1746613300751,MATH 142B,A02,890129,Ioana; Adrian,12,0,30,18
1746613301784,MATH 154,A01,890174,Staff,0,1,30,30
1746613301784,MATH 154,A02,890182,Staff,0,0,30,30
1746613302815,MATH 168A,A01,890197,Dumitriu; Ioana,21,0,35,14
1746613303843,MATH 170A,A01,890240,Nie; Jiawang,1,0,30,29
1746613303843,MATH 170A,A02,890241,Nie; Jiawang,11,0,30,19
1746613303843,MATH 170A,A03,890249,Nie; Jiawang,23,0,30,7
1746613304876,MATH 170B,A01,957891,Nag; Panchali,13,0,35,22
1746613306935,MATH 181A,A01,908025,Staff,0,3,35,35
1746613306935,MATH 181A,A02,960115,Staff,26,0,35,9
1746613307966,MATH 181B,A01,959874,Staff,24,0,30,6
1746613308990,MATH 193B,A01,890265,Staff,0,4,35,35
1746613310026,MGT 4,A01,890311,Anderson; John Charles,42,0,88,46
1746613311056,MGT 5,A00,907740,Staff,12,0,98,86
1746613312083,MGT 12,A00,890312,Lindenberger; Wade Douglas,67,0,98,31
1746613313112,MGT 16,A00,957883,Staff,78,0,98,20
1746613315177,MGT 45,A00,890314,Pecore; Joseph P.,45,0,98,53
1746613316206,MGT 71,A00,890315,Staff,0,12,98,98
1746613317236,MGT 100,A00,890316,Yavorsky; Daniel Ryan,44,0,98,54
1746613318267,MGT 103,A00,890317,Ehrich; Kristine R,73,0,98,25
1746613319293,MGT 105,A00,890356,Bates; Kenneth Walter,0,8,98,98
1746613320318,MGT 112,A00,890360,Ehrich; Kristine R,55,0,98,43
1746613321345,MGT 127R,A00,907732,Zhu; Kevin Xiaoguo,23,0,98,75
1746613322372,MGT 131B,A00,890361,Anderson; John Charles,59,0,98,39
1746613323402,MGT 137,A00,890362,Lindenberger; Wade Douglas,65,0,98,33
1746613324429,MGT 160,A00,890369,Johnson; Erik Barry,9,0,98,89
1746613326484,MGT 164,A00,890372,Zimmermann; Carsten,0,40,98,98
1746613327514,MGT 180,A00,890374,Bliss; Barbara Ann,11,0,98,87
1746613328551,MMW 15,A01,886414,Chang; Edmond Yi-Teh,0,12,28,28
1746613328551,MMW 15,A02,886415,Chang; Edmond Yi-Teh,0,8,28,28
1746613328551,MMW 15,A03,886416,Chang; Edmond Yi-Teh,0,9,28,28
1746613328551,MMW 15,A04,886417,Chang; Edmond Yi-Teh,0,8,28,28
1746613328551,MMW 15,B01,886419,Chang; Edmond Yi-Teh,0,7,28,28
1746613328551,MMW 15,B02,886420,Chang; Edmond Yi-Teh,0,7,28,28
1746613328551,MMW 15,B03,886421,Chang; Edmond Yi-Teh,0,7,28,28
1746613328551,MMW 15,B04,886422,Chang; Edmond Yi-Teh,0,8,28,28
1746613328551,MMW 15,C01,886424,Staff,0,9,28,28
1746613328551,MMW 15,C02,886425,Staff,0,8,28,28
1746613328551,MMW 15,C03,886426,Staff,0,8,28,28
1746613328551,MMW 15,C04,886427,Staff,0,8,28,28
1746613328551,MMW 15,C05,958038,Staff,0,8,28,28
1746613328551,MMW 15,C06,958039,Staff,0,7,28,28
1746613329581,MMW 15GS,A00,906910,Patterson; Patrick H.,4,0,28,24
1746613330609,MMW 122R,A01,886429,Rahimi; Babak,0,13,28,28
1746613330609,MMW 122R,A02,886430,Rahimi; Babak,0,12,28,28
1746613330609,MMW 122R,A03,958040,Rahimi; Babak,0,11,28,28
1746613331640,MUS 1A,A01,890937,Staff,2,0,25,23
1746613331640,MUS 1A,A02,891035,Staff,6,0,25,19
1746613331640,MUS 1A,C01,958912,Staff,24,0,25,1
1746613331640,MUS 1A,C02,958913,Staff,25,0,25,0
1746613333701,MUS 2AK,A00,957092,Ohnishi; Takae,15,0,15,0
1746613334731,MUS 4,A01,891044,Staff,0,0,25,25
1746613334731,MUS 4,A02,891045,Staff,22,0,25,3
1746613334731,MUS 4,B01,891048,Staff,17,0,25,8
1746613334731,MUS 4,B02,891050,Staff,25,0,25,0
1746613335760,MUS 5,A01,957506,Dubnov; Shlomo,0,0,25,25
1746613335760,MUS 5,A02,957622,Dubnov; Shlomo,12,0,25,13
1746613335760,MUS 5,A03,957623,Dubnov; Shlomo,20,0,25,5
1746613336793,MUS 6,A01,891053,Freitas Caetano; Marcelo,24,0,25,1
1746613336793,MUS 6,A02,891054,Freitas Caetano; Marcelo,23,0,25,2
1746613337820,MUS 7,A01,891081,Staff,0,0,25,25
1746613337820,MUS 7,A02,891082,Staff,3,0,25,22
1746613338849,MUS 8GS,A00,891118,Borgo; David Garcia,1,0,25,24
1746613339874,MUS 11,A01,891140,Staff,8,0,25,17
1746613339874,MUS 11,A02,891141,Staff,21,0,25,4
1746613340905,MUS 13,A01,891143,Staff,8,0,25,17
1746613340905,MUS 13,A02,891144,Staff,24,0,25,1
1746613341936,MUS 15,A01,891146,Staff,9,0,25,16
1746613341936,MUS 15,A02,891148,Staff,21,0,25,4
1746613341936,MUS 15,B01,891150,Staff,18,0,25,7
1746613341936,MUS 15,B02,891151,Staff,25,0,25,0
1746613342962,MUS 20,A01,891153,Staff,5,0,20,15
1746613342962,MUS 20,A02,891155,Staff,14,0,20,6
1746613343990,MUS 80,A00,891156,Staff,19,0,25,6
1746613343990,MUS 80,B00,891157,Staff,23,0,25,2
1746613345024,MUS 130,A00,891158,Ohnishi; Takae,35,0,35,0
1746613346055,MUS 150GS,A01,891160,Borgo; David Garcia,1,0,25,24
1746613347083,MUS 170,A01,891162,Freitas Caetano; Marcelo,20,0,25,5
1746613347083,MUS 170,A02,891164,Freitas Caetano; Marcelo,21,0,25,4
1746613348112,NANO 11,A00,886220,Vazquez Mena; Oscar,13,0,15,2
1746613349140,NANO 15,A01,886222,Drews; Aaron,4,0,7,3
1746613350170,NANO 104,A00,886224,Sirbuly; Donald,17,0,25,8
1746613351197,PH 40,A00,886528,Staff,23,0,40,17
1746613352227,PH 45,A01,886799,Staff,35,0,40,5
1746613353253,PH 110,A00,886802,Staff,0,6,40,40
1746613354291,PH 172,A00,906716,Staff,19,0,35,16
1746613355317,PH 191,A00,886803,Staff,6,0,40,34
1746613356344,PHIL 1,A00,889500,Staff,20,0,30,10
1746613357377,PHIL 10,A01,889549,Grush; Rick Scott,16,0,22,6
1746613357377,PHIL 10,A02,889551,Grush; Rick Scott,22,0,22,0
1746613358412,PHIL 28,A01,889559,Lamey; Andy M.,0,2,31,31
1746613358412,PHIL 28,A02,889561,Lamey; Andy M.,0,1,30,30
1746613358412,PHIL 28,A03,889572,Lamey; Andy M.,0,1,30,30
1746613359440,PHIL 35,A00,907839,Staff,13,0,15,2
1746613360471,PHIL 60,A00,889574,Staff,73,0,90,17
1746613361497,PHIL 101,A00,958004,Staff,12,0,15,3
1746613363550,PHIL 136,A00,889582,Fulkerson; Matthew Todd,26,0,45,19
1746613364578,PHIL 163,A01,889601,Staff,21,0,30,9
1746613364578,PHIL 163,B01,889606,Brandt; Reuven A,0,3,0,0
1746613365607,PHIL 164,A00,889610,Staff,16,0,30,14
1746613366635,PHIL 165,A00,889613,Staff,22,0,30,8
1746613367663,PHYS 1A,A00,886431,Staff,30,0,70,40
1746613368695,PHYS 1AL,001,886432,Tsai; Philbert S,0,1,30,30
1746613368695,PHYS 1AL,002,886436,Tsai; Philbert S,13,0,30,17
1746613369721,PHYS 1B,A00,886439,Staff,184,0,240,56
1746613370748,PHYS 1BL,001,886441,Tsai; Philbert S,0,4,30,30
1746613370748,PHYS 1BL,002,886444,Tsai; Philbert S,2,0,30,28
1746613371777,PHYS 1C,A00,896092,Arnold; Kam S,78,0,146,68
1746613372804,PHYS 1CL,001,886448,Tsai; Philbert S,0,1,30,30
1746613372804,PHYS 1CL,002,886449,Tsai; Philbert S,1,0,30,29
1746613372804,PHYS 1CL,003,886450,Tsai; Philbert S,16,0,30,14
1746613372804,PHYS 1CL,004,886451,Tsai; Philbert S,15,0,30,15
1746613373832,PHYS 2B,A01,886457,Staff,67,0,115,48
1746613374866,PHYS 2C,A01,886460,Shotwell; Brian,0,9,65,65
1746613375899,PHYS 2CL,A01,886467,Staff,0,4,28,28
1746613375899,PHYS 2CL,A02,886468,Staff,0,3,28,28
1746613376925,PHYS 2D,A01,886470,Staff,10,0,50,40
1746613377953,PHYS 4B,A01,886475,Grinstein; Benjamin,22,0,40,18
1746613378979,POLI 5,A00,891173,Desposato; Scott,7,0,25,18
1746613380007,POLI 5D,A01,891175,Staff,5,0,5,0
1746613380007,POLI 5D,B01,891178,Staff,5,0,5,0
1746613381036,POLI 11,A00,891179,Ferree; Karen E,0,0,35,35
1746613382066,POLI 12,A00,891180,Staff,15,0,30,15
1746613383336,POLI 27,A01,891182,Staff,11,0,75,64
1746613384364,POLI 30,A00,891183,Staff,8,0,50,42
1746613385391,POLI 100B,A00,891244,Staff,5,1,35,30
1746613386423,POLI 100I,A00,891247,Staff,7,0,30,23
1746613387453,POLI 104J,A00,891248,Nichter; Maysa,14,0,30,16
1746613388480,POLI 104U,A00,891250,Nichter; Maysa,1,0,30,29
1746613390540,POLI 110B,A00,891255,Wiens; David,19,0,25,6
1746613391572,POLI 112A,A00,891256,Wiens; David,6,0,25,19
1746613392601,POLI 114BR,A00,891261,Staff,19,0,30,11
1746613393627,POLI 117R,A00,891262,Forman; Fonna,0,6,50,50
1746613394653,POLI 118,A00,891264,Ingham; Sean,17,0,25,8
1746613395679,POLI 124A,A00,891265,Staff,18,0,20,2
1746613396707,POLI 125D,A00,891266,Nichter; Simeon C,2,0,25,23
1746613397737,POLI 126,A00,891268,Nichter; Simeon C,7,0,25,18
1746613398764,POLI 126AA,A00,891272,Staff,15,0,25,10
1746613399795,POLI 130AA,A00,891273,Staff,15,0,20,5
1746613400826,POLI 134AA,A00,891274,Staff,4,0,20,16
1746613402885,POLI 138,A00,891278,Staff,21,0,25,4
1746613403915,POLI 142K,A00,891280,Staff,10,0,25,15
1746613404943,POLI 142M,A00,891281,Gartzke; Erik,16,0,30,14
1746613405970,POLI 142P,A00,891284,Staff,20,0,30,10
1746613406996,POLI 143,A00,891285,Gartzke; Erik,12,0,30,18
1746613408027,POLI 153,A00,891286,Staff,19,0,20,1
1746613410080,POLI 175,A00,891290,Staff,15,0,20,5
1746613411113,PSYC 1,A00,890674,Steiner; Eric Tomas,0,11,45,45
1746613412147,PSYC 2,A00,890676,Albright; Thomas D,20,0,35,15
1746613413174,PSYC 3,A00,890679,Staff,17,0,20,3
1746613414201,PSYC 6,A00,959858,Staff,19,0,20,1
1746613415232,PSYC 60,A01,890684,Rickard; Timothy C.,0,6,45,45
1746613416260,PSYC 70,A01,890689,Geller; Emma Harlan,6,0,30,24
1746613417285,PSYC 71,A01,959860,Staff,21,0,25,4
1746613418317,PSYC 100,A00,890690,Lacefield; Katharine I,0,50,180,180
1746613419344,PSYC 102,A00,890695,Staff,18,0,40,22
1746613420371,PSYC 105,A00,890699,Geller; Emma Harlan,70,0,100,30
1746613421403,PSYC 106,A00,890701,Gorman; Michael R.,5,0,30,25
1746613422431,PSYC 108,A00,890704,Adrian; Julia Anna,0,29,50,50
1746613423458,PSYC 118,A01,890712,Staff,11,0,30,19
1746613424486,PSYC 124,A00,890716,Chapman; Eddie Nathaniel,25,0,60,35
1746613425513,PSYC 131,A00,890717,Anagnostaras; Stephan,0,7,80,80
1746613426540,PSYC 137,A00,890719,Winkielman; Piotr,0,11,30,30
1746613427566,PSYC 144,A00,890721,Adrian; Julia Anna,0,9,45,45
1746613428600,PSYC 162,A00,890805,Staff,0,2,75,75
1746613429630,PSYC 169,A00,890810,Staff,0,15,30,30
1746613430658,PSYC 172,A00,890814,Gorman; Michael R.,9,0,30,21
1746613431688,PSYC 181,A00,890818,Anagnostaras; Stephan,6,0,200,194
1746613432716,PSYC 184,A00,959861,Staff,160,0,175,15
1746613433748,PSYC 189,A00,890823,Staff,0,2,30,30
1746613434773,PSYC 191,A00,890884,Rickard; Timothy C.,0,12,35,35
1746613435801,PSYC 193,A00,890913,Staff,19,0,30,11
1746613435801,PSYC 193,B00,890914,Chapman; Eddie Nathaniel,24,0,30,6
1746613436829,PSYC 193L,A01,890918,Lowe; Angela Beth,20,0,30,10
1746613436829,PSYC 193L,B01,890921,Hurwitz; Ethan Scott,20,0,30,10
1746613436829,PSYC 193L,C01,890928,Staff,30,0,30,0
1746613437857,RELI 149,A00,886806,Rahimi; Babak,23,0,40,17
1746613438924,SE 9,A01,886814,Staff,7,0,20,13
1746613439953,SE 101B,A01,886816,Chadha; Mayank,3,0,35,32
1746613440986,SE 110B,A00,886818,Zhu; Qiang,4,0,75,71
1746613442012,SE 125,A01,886830,Staff,10,0,30,20
1746613443040,SE 130B,A01,886835,Staff,14,0,40,26
1746613444070,SE 131A,A01,886838,Krysl; Petr,34,0,55,21
1746613445098,SE 154,A00,886840,Staff,28,0,50,22
1746613446123,SE 164GS,A01,886849,Staff,6,0,20,14
1746613447149,SE 167GS,A01,886853,Staff,6,0,20,14
1746613448178,SIO 25,A01,890107,Staff,19,0,30,11
1746613449210,SIO 45,A00,890109,Cook; Geoffrey W,114,0,200,86
1746613450239,SIO 109R,A00,890110,Forman; Fonna,0,16,20,20
1746613451271,SIO 187,A01,890114,Kacev; David,15,0,40,25
1746613452299,SOCI 1,A01,890431,Thorpe; Charles Robert,14,0,30,16
1746613452299,SOCI 1,A02,890518,Thorpe; Charles Robert,30,0,30,0
1746613453326,SOCI 2,A01,957978,Staff,25,0,25,0
1746613453326,SOCI 2,A02,957979,Staff,23,0,25,2
1746613454360,SOCI 20,A01,890523,Calderon-Zaks; Michael Aar,21,0,30,9
1746613454360,SOCI 20,A02,890526,Calderon-Zaks; Michael Aar,29,0,30,1
1746613455388,SOCI 30,A01,890533,Pardo Guerra; Juan Pablo,37,0,40,3
1746613456414,SOCI 40,A01,890535,Staff,27,0,45,18
1746613457440,SOCI 104Q,A00,890559,Staff,17,0,30,13
1746613458466,SOCI 106,A00,890560,Arnal; Maud Marie Leonie,20,0,30,10
1746613459495,SOCI 110,A00,890567,Holkenbrink-Monk; Charlene,19,0,30,11
1746613460520,SOCI 112,A00,890568,Victoria Torres; Pablo,2,0,55,53
1746613461550,SOCI 115,A00,890597,Arnal; Maud Marie Leonie,28,0,45,17
1746613463609,SOCI 121,A00,890604,Pardo Guerra; Juan Pablo,38,0,45,7
1746613464638,SOCI 126,A01,890608,Staff,8,0,10,2
1746613465665,SOCI 127,A00,890609,Staff,18,0,30,12
1746613466690,SOCI 131,A00,890610,Thorpe; Charles Robert,37,0,45,8
1746613467715,SOCI 135,A00,890615,Payne; Christine Anna,14,0,45,31
1746613468745,SOCI 139,A00,890620,Staff,38,0,45,7
1746613469772,SOCI 148E,A00,890622,Calderon-Zaks; Michael Aar,36,0,45,9
1746613470806,SOCI 150,A00,890623,Kohler; Kristopher M.,31,0,45,14
1746613471839,SOCI 157,A00,890625,Jules-Rosette; Bennetta W.,18,0,20,2
1746613472865,SOCI 160,A00,890627,Payne; Christine Anna,21,0,45,24
1746613473900,SYN 1,A00,886855,Fish; Gwendolyn Anne,0,1,0,0
1746613473900,SYN 1,B00,906086,Fish; Gwendolyn Anne,0,2,0,2
1746613474929,SYN 2R,A00,886860,Staff,0,17,15,15
1746613474929,SYN 2R,B00,906106,Atkinson; Arthur Laird,0,16,15,15
1746613475969,SYN 100,A01,886866,Browne; Emily,0,28,20,20
1746613475969,SYN 100,B01,906128,Rock; Martin,0,4,20,20
1746613475969,SYN 100,C01,906140,Deavenport; James Cary,0,4,20,20
1746613475969,SYN 100,D01,907816,Deavenport; James Cary,0,5,20,20
1746613477003,TDAC 1,A00,890286,Walsh; Kim C.,7,0,20,13
1746613478035,TDAC 101,A00,890296,Basso; Beatrice,15,0,20,5
1746613479061,TDDE 131,A00,890297,Staff,47,0,50,3
1746613480091,TDDM 1,A00,890287,Weinberg; Sadie,25,0,30,5
1746613481119,TDGE 11,A00,890288,Fulton; Julia,138,0,200,62
1746613481119,TDGE 11,B00,890289,Castro; Robert Jess,184,0,200,16
1746613482147,TDGE 25,B00,957359,Walsh; Kim C.,5,0,20,15
1746613483177,TDGE 40,A01,890292,Power; Jade Yukana,26,0,30,4
1746613484208,TDGE 124,A00,890298,Havis; Allan,0,2,50,50
1746613485238,TDGE 131R,A00,890299,Burelle; Julie Sara Veronique,15,0,42,27
1746613486266,TDHT 101,A00,890300,Staff,10,0,20,10
1746613487294,TDHT 109,A01,890302,Anderson; Mysia Anyse,31,0,40,9
1746613488324,TDMV 1,A00,890293,Arcidiacono; Kristin,18,0,30,12
1746613489349,TDMV 2,A00,890294,Weinberg; Sadie,23,0,30,7
1746613490382,TDMV 3,A00,957878,Arcidiacono; Kristin,28,0,30,2
1746613492441,TDMV 138,A00,890304,Jun; Grace Shin Hae,25,0,40,15
1746613493474,TDMV 140,A00,890305,Corrales; Joseph Bernales,25,0,30,5
1746613494502,TDMV 142,A00,890307,Caligagan; Tony,32,0,40,8
1746613495528,TDMV 144,A00,890308,Camaya; Michelle Ann,25,0,30,5
1746613496559,TDPW 1,A00,890295,Stein; Deborah Isobel,3,0,20,17
1746613497592,USP 2,A01,890272,Lerner; Amy M,7,0,20,13
1746613498618,USP 3,A01,890274,Staff,12,0,30,18
1746613499647,USP 15,A01,890276,Sun; Feiyang,16,0,30,14
1746613500675,USP 25,A00,890277,Shenkman; Michael Thomas,18,0,25,7
1746613501706,USP 138,A00,890278,Staff,13,0,25,12
1746613502733,USP 143,A00,890279,Staff,21,0,70,49
1746613503761,USP 144,A00,890280,Chowdhury; Muhammed Zohir,16,0,30,14
1746613504792,USP 150,A00,890281,Boomhower; Matthew Charles,4,0,30,26
1746613505822,USP 151,A00,890282,Staff,16,0,20,4
1746613506853,USP 162,A00,890283,Andrews; Abigail Leslie,16,0,20,4
1746613507880,USP 168,A00,920477,Kwak; Nancy,0,0,5,5
1746613508907,USP 181,A00,890284,Staff,3,0,20,17
1746613509935,USP 191A,A00,890285,Staff,12,0,20,8
1746613510962,VIS 101,A00,886512,Staff,26,0,75,49
1746613511992,VIS 103,A00,886513,Cruz; Edwin Teddy,61,0,75,14
1746613513021,VIS 108,A00,886514,Staff,4,0,15,11
1746613514054,VIS 127P,A00,886515,Shen; Kuiyi,80,0,146,66
1746613515082,VIS 149,A00,886516,Yoldas; Pinar,0,0,15,15
1746613516110,VIS 164,A00,886526,Erdmann; Dean,19,0,22,3
1746613517138,VIS 194S,A00,886527,Staff,61,0,75,14
1746613518167,WCWP 10A,C00,886484,Martiniuk; Jill,12,0,15,3
1746613519193,WCWP 10B,A00,886490,Uriarte; Emma,0,0,15,15
1746613519193,WCWP 10B,B00,886491,Dhir; Simrita,8,0,15,7
1746613519193,WCWP 10B,C00,886492,Ornelas; Tricia,0,0,15,15
1746613520228,WCWP 100,A00,886494,Young; Mark T,0,6,15,15
1746613522358,AAS 10,A01,886199,Childs; Dennis R.,0,3,0,0
1746613523388,ANAR 104,A01,886940,Shtienberg; Gilad,27,0,30,3
1746613524414,ANAR 120,A00,886953,Staff,13,0,20,7
1746613525442,ANBI 148,A01,886955,Wilder; Linnea Lorene,30,0,40,10
1746613527493,ANSC 122,A00,886957,Staff,24,0,30,6
1746613528519,ANSC 150,A00,886958,Sloane; Julia Kathryn,2,0,15,13
1746613529548,ANSC 156,A00,886959,Jenkins; Janis A.,0,1,15,15
1746613530575,ANSC 180,A00,886960,Staff,11,0,17,6
1746613531644,ANSC 188,A00,886961,Jassal; Aftab,9,0,25,16
1746613532670,ANSC 190,A00,886962,Jassal; Aftab,14,0,25,11
1746613533696,ANSC 191,A00,886963,Staff,18,0,20,2
1746613534722,ANTH 3,A01,891689,Staff,17,0,20,3
1746613535748,ANTH 5,A00,886933,Semendeferi; Ekaterini,16,0,20,4
1746613536776,ANTH 10,A00,886934,Staff,0,12,30,30
1746613537803,ANTH 21,A01,886936,Staff,41,0,60,19
1746613538829,ANTH 23,A01,886938,Staff,92,0,100,8
1746613539856,ANTH 105,A00,886964,Stewart; Alexander B,84,0,100,16
1746613540888,ANTH 108,A00,886965,Pedersen; David,9,0,20,11
1746613541925,AWP 10,001,886147,Staff,0,0,0,0
1746613541925,AWP 10,002,886148,Staff,0,0,0,0
1746613541925,AWP 10,003,886149,Staff,0,0,0,0
1746613541925,AWP 10,004,886150,Staff,0,0,0,0
1746613541925,AWP 10,005,886151,Staff,0,0,0,0
1746613541925,AWP 10,006,886152,Staff,0,0,0,0
1746613541925,AWP 10,007,886153,Staff,0,0,0,0
1746613541925,AWP 10,008,886154,Staff,0,0,0,0
1746613541925,AWP 10,009,886155,Staff,0,0,0,0
1746613541925,AWP 10,010,886156,Staff,0,0,0,0
1746613541925,AWP 10,011,886158,Staff,0,0,0,0
1746613541925,AWP 10,012,886160,Staff,0,0,0,0
1746613541925,AWP 10,013,886161,Staff,0,0,0,0
1746613541925,AWP 10,014,886162,Staff,0,0,0,0
1746613541925,AWP 10,015,886163,Staff,0,0,0,0
1746613541925,AWP 10,016,886164,Staff,0,0,0,0
1746613541925,AWP 10,017,886165,Staff,0,0,0,0
1746613541925,AWP 10,018,886166,Staff,0,0,0,0
1746613541925,AWP 10,019,886168,Staff,0,0,0,0
1746613541925,AWP 10,020,886170,Staff,0,0,0,0
1746613541925,AWP 10,021,886172,Staff,0,0,0,0
1746613542957,AWP 10R,001,886173,Staff,0,1,0,0
1746613542957,AWP 10R,002,886174,Staff,0,1,0,0
1746613542957,AWP 10R,003,886175,Staff,0,0,0,0
1746613542957,AWP 10R,004,886176,Staff,0,0,0,0
1746613542957,AWP 10R,005,886177,Staff,0,0,0,0
1746613542957,AWP 10R,006,886178,Staff,0,0,0,0
1746613542957,AWP 10R,007,886179,Staff,0,0,0,0
1746613542957,AWP 10R,008,886181,Staff,0,0,0,0
1746613542957,AWP 10R,009,886182,Staff,0,0,0,0
1746613542957,AWP 10R,010,886183,Staff,0,0,0,0
1746613542957,AWP 10R,011,886184,Staff,0,0,0,0
1746613542957,AWP 10R,012,886185,Staff,0,0,0,0
1746613542957,AWP 10R,013,886186,Staff,0,0,0,0
1746613542957,AWP 10R,014,886187,Staff,0,0,0,0
1746613542957,AWP 10R,015,886188,Staff,0,0,0,0
1746613542957,AWP 10R,016,886189,Staff,0,0,0,0
1746613542957,AWP 10R,017,960532,Staff,0,0,0,0
1746613542957,AWP 10R,018,960533,Staff,0,0,0,0
1746613542957,AWP 10R,019,960534,Staff,0,0,0,0
1746613542957,AWP 10R,020,960538,Staff,0,0,0,0
1746613542957,AWP 10R,021,960540,Staff,0,0,0,0
1746613542957,AWP 10R,022,960541,Staff,0,0,0,0
1746613542957,AWP 10R,023,960542,Staff,0,0,0,0
1746613542957,AWP 10R,024,960544,Staff,0,0,0,0
1746613542957,AWP 10R,025,960545,Staff,0,0,0,0
1746613542957,AWP 10R,026,960548,Staff,0,0,0,0
1746613543983,AWP 102R,A00,886190,Staff,0,0,0,0
1746613543983,AWP 102R,B00,886191,Staff,0,0,0,0
1746613545011,BENG 100,A01,886193,Staff,17,0,30,13
1746613546037,BENG 122A,A01,886195,Hasty; Jeff M,13,0,30,17
1746613547123,BENG 166A,A00,886196,Sah; Robert Lie-Yuan,0,3,30,30
1746613548150,BENG 190,A00,958050,Khojah; Reem I,17,0,25,8
1746613549181,BIBC 102,A01,894320,Staff,0,1,46,46
1746613549181,BIBC 102,A02,894321,Staff,0,0,46,46
1746613549181,BIBC 102,A03,894344,Staff,6,0,46,40
1746613549181,BIBC 102,A04,894345,Staff,27,0,47,20
1746613550217,BICD 100R,A01,894365,Smith; Laurie,0,2,58,58
1746613550217,BICD 100R,A02,894366,Smith; Laurie,0,4,58,58
1746613550217,BICD 100R,A03,894367,Smith; Laurie,0,0,59,59
1746613550217,BICD 100R,A04,959869,Smith; Laurie,38,0,59,21
1746613551247,BICD 136,A01,894383,Gustafson-Brown; Cindy,14,0,50,36
1746613552281,BIEB 102,A01,894494,Butler; Shannon Rhey,51,0,130,79
1746613554357,BIEB 150,A01,894617,Wills; Christopher,3,0,20,17
1746613554357,BIEB 150,A02,894631,Wills; Christopher,3,0,20,17
1746613554357,BIEB 150,A03,894937,Wills; Christopher,3,0,20,17
1746613554357,BIEB 150,A04,894946,Wills; Christopher,5,0,20,15
1746613555390,BIEB 194,A00,906141,Kurle; Carolyn M.,5,0,20,15
1746613556419,BILD 1,A01,894154,Staff,3,0,19,16
1746613556419,BILD 1,A02,894155,Staff,14,0,19,5
1746613556419,BILD 1,A03,894160,Staff,13,0,19,6
1746613556419,BILD 1,A04,894161,Staff,15,0,18,3
1746613557451,BILD 2,A01,894168,Staff,0,0,50,50
1746613557451,BILD 2,A02,894169,Staff,0,0,50,50
1746613557451,BILD 2,A03,894179,Staff,0,0,50,50
1746613557451,BILD 2,A04,894203,Staff,22,0,50,28
1746613558479,BILD 3,A01,894213,Staff,23,0,31,8
1746613558479,BILD 3,A02,894214,Staff,26,0,31,5
1746613558479,BILD 3,A03,894235,Staff,28,0,31,3
1746613558479,BILD 3,A04,894236,Staff,28,0,32,4
1746613559508,BILD 4,A01,894253,Reuther; Keefe,5,0,24,19
1746613559508,BILD 4,A02,894258,Reuther; Keefe,16,0,24,8
1746613560539,BILD 5,A01,894276,Reuther; Keefe,33,0,50,17
1746613560539,BILD 5,A02,894277,Reuther; Keefe,45,0,50,5
1746613560539,BILD 5,A03,894290,Reuther; Keefe,44,0,50,6
1746613560539,BILD 5,A04,894291,Reuther; Keefe,48,0,50,2
1746613561567,BILD 24,A01,894297,Pirino; Giorgia,40,0,60,20
1746613562598,BIMM 100,B01,958915,Staff,71,0,100,29
1746613563632,BIMM 101,A01,895017,McDonnell; Lisa Marie,0,5,24,24
1746613563632,BIMM 101,A02,895018,McDonnell; Lisa Marie,0,5,24,24
1746613563632,BIMM 101,B01,895020,McDonnell; Lisa Marie,0,5,24,24
1746613563632,BIMM 101,B02,895021,McDonnell; Lisa Marie,0,4,24,24
1746613564661,BIMM 110,A01,895023,Staff,1,0,25,24
1746613564661,BIMM 110,A02,895024,Staff,9,0,25,16
1746613564661,BIMM 110,A03,895025,Staff,18,0,25,7
1746613564661,BIMM 110,A04,895031,Staff,20,0,25,5
1746613565695,BIMM 120,A01,895114,Gustafson-Brown; Cindy,14,0,28,14
1746613565695,BIMM 120,A02,895126,Gustafson-Brown; Cindy,21,0,27,6
1746613566728,BIPN 100,A01,895130,Yang; Mingyu,0,0,38,38
1746613566728,BIPN 100,A02,895131,Yang; Mingyu,31,0,38,7
1746613566728,BIPN 100,A03,895132,Yang; Mingyu,32,0,38,6
1746613566728,BIPN 100,A04,895133,Yang; Mingyu,27,0,36,9
1746613567762,BIPN 120,A01,895135,Cooke; James Edward,0,3,13,13
1746613567762,BIPN 120,A02,895136,Cooke; James Edward,0,1,13,13
1746613567762,BIPN 120,A03,895137,Cooke; James Edward,0,3,13,13
1746613567762,BIPN 120,A04,895156,Cooke; James Edward,0,2,11,11
1746613568791,BIPN 134,A01,895235,Cooke; James Edward,0,1,25,25
1746613568791,BIPN 134,A02,895237,Cooke; James Edward,0,0,25,25
1746613568791,BIPN 134,A03,895240,Cooke; James Edward,1,0,25,24
1746613568791,BIPN 134,A04,895270,Cooke; James Edward,20,0,25,5
1746613569823,BIPN 189,A00,892103,Staff,0,14,14,14
1746613571876,BISP 194,A00,958008,Staff,0,2,0,0
1746613572903,CAT 124,A01,922009,Staff,0,5,20,20
1746613573937,CAT 125R,A00,886390,Morales; Celeste Georgianna,0,4,20,20
1746613573937,CAT 125R,B00,886391,Irwin; Matthew Joseph,0,4,20,20
1746613573937,CAT 125R,C00,886392,Smith; Lauryn Alissa,0,2,20,20
1746613573937,CAT 125R,D00,886393,Vanderschuit; Maya Alysia,0,3,20,20
1746613573937,CAT 125R,E00,886394,Marchisotto; Jennifer Anne,0,3,20,20
1746613574965,CENG 15,A01,886218,Drews; Aaron,3,0,8,5
1746613575993,CENG 113,A00,886219,Opatkiewicz; Justin Paul,15,0,25,10
1746613577023,CGS 101,A00,887044,Staff,7,0,20,13
1746613578054,CGS 105,A01,887046,Staff,14,0,25,11
1746613579082,CGS 112,A00,887047,Cuong; Marisol,12,0,15,3
1746613580109,CGS 113,A00,887048,Staff,23,0,30,7
1746613581135,CGS 120,A00,887049,Staff,9,0,17,8
1746613582169,CHEM 6A,A01,886336,Lam; Tin Yiu,38,0,50,12
1746613582169,CHEM 6A,A02,886338,Lam; Tin Yiu,37,0,50,13
1746613583202,CHEM 6B,A01,886341,Hopkins; Patrycja Anna,16,0,50,34
1746613583202,CHEM 6B,A02,886343,Hopkins; Patrycja Anna,42,0,50,8
1746613584229,CHEM 6C,A01,886346,Albizati; Kim F.,0,2,50,50
1746613584229,CHEM 6C,A02,886348,Albizati; Kim F.,24,0,50,26
1746613585256,CHEM 40A,A01,886352,Klosterman; Jeremy K,65,0,100,35
1746613586282,CHEM 40B,A01,886356,Klosterman; Jeremy K,0,24,100,100
1746613587310,CHEM 41B,A01,886360,Theodorakis; Emmanuel,25,0,50,25
1746613587310,CHEM 41B,A02,886362,Theodorakis; Emmanuel,47,0,50,3
1746613588339,CHIN 165A,A00,886382,Xu; Li,18,0,20,2
1746613589370,CLAS 120,A00,886387,Myerston Santana; Jacobo,33,0,40,7
1746613590399,COGS 9,A01,886967,Shannon; Kyle Michael,42,0,60,18
1746613591428,COGS 11,A01,886969,Staff,9,0,30,21
1746613592453,COGS 14A,A01,886971,Staff,5,0,60,55
1746613593485,COGS 14B,A01,886973,Hoffman; Drew Ellen,4,0,60,56
1746613594515,COGS 18,A01,886975,Morgan; Eric,34,0,60,26
1746613595545,COGS 20,A01,886977,Staff,3,0,8,5
1746613595545,COGS 20,A02,886978,Staff,5,0,7,2
1746613596573,COGS 100,A01,907783,Staff,0,1,30,30
1746613597604,COGS 101B,A01,886980,Staff,0,4,48,48
1746613598633,COGS 101C,A01,886982,Delgado; Tania,0,5,44,44
1746613599659,COGS 102A,A01,886984,Johnson; Christine M.,3,0,30,27
1746613600689,COGS 118B,A01,886986,Staff,0,4,88,88
1746613601717,COGS 150,A01,886988,Bergen; Benjamin,22,0,50,28
1746613602743,COGS 153,A00,886989,Delgado; Tania,1,3,41,40
1746613603770,COGS 186,A01,886991,Staff,0,0,32,32
1746613604798,COGS 187A,A01,886993,Boyle; Mary E. T.,7,0,30,23
1746613605824,COGS 189,A00,886994,Staff,0,1,30,30
1746613606855,COMM 10,A01,886996,Staff,0,0,20,21
1746613606855,COMM 10,A02,886997,Staff,10,0,20,10
1746613606855,COMM 10,A03,959845,Staff,19,0,20,1
1746613607888,COMM 20,A01,886999,Leuning; Grant Maurstad,24,0,40,16
1746613609942,COMM 100A,A01,887002,Staff,0,0,20,25
1746613609942,COMM 100A,A02,887003,Staff,5,0,20,15
1746613610968,COMM 100B,A01,887005,Staff,0,8,20,24
1746613611995,COMM 106D,A00,887006,Staff,14,0,40,26
1746613613026,COMM 110G,A00,887007,Whitworth-Smith; Andrew C,12,0,40,28
1746613614054,COMM 111B,A00,887008,Staff,31,0,40,9
1746613615083,COMM 113T,A00,887009,Abuelhiga; Soraya Jill,28,0,40,12
1746613615083,COMM 113T,B00,906733,Staff,39,0,40,1
1746613616111,COMM 145,A00,887010,Staff,13,0,40,27
1746613617141,COMM 146,A00,887054,Staff,32,0,40,8
1746613618168,COMM 190,A00,887012,Staff,8,0,23,15
1746613619195,CSE 8A,A50,887015,Cao; Yingjun,56,0,85,29
1746613620226,CSE 11,A01,887017,Cao; Yingjun,11,0,70,59
1746613621251,CSE 20,A01,887019,Staff,30,0,50,20
1746613622282,CSE 21,A01,887021,Staff,79,0,100,21
1746613622282,CSE 21,B01,892583,Braun; Oliver,45,0,50,5
1746613623313,CSE 30,A01,887025,Eldon; John,142,0,200,58
1746613624346,CSE 100,A01,887027,Staff,26,0,50,24
1746613624346,CSE 100,A02,887028,Staff,42,0,50,8
1746613625377,CSE 101,A01,887030,Braun; Oliver,74,0,100,26
1746613625377,CSE 101,B01,887032,Jones; Miles E,0,3,50,50
1746613625377,CSE 101,B02,887033,Jones; Miles E,0,2,50,50
1746613626411,CSE 105,A01,908084,Jones; Miles E,32,0,50,18
1746613626411,CSE 105,A02,908087,Jones; Miles E,31,0,50,19
1746613627444,CSE 135,A01,887035,Powell; Thomas Allan,0,5,50,50
1746613628471,CSE 142,A01,887037,Staff,7,0,60,53
1746613629497,CSE 142L,A01,887039,Staff,34,0,60,26
1746613630523,CSE 151A,A01,887041,Solares; Edwin A,47,0,100,53
1746613631551,CSE 175,A01,887043,Kumar; Rakesh,30,0,30,0
1746613632577,CSS 1,A01,886389,Staff,0,1,40,40
1746613633603,DSC 30,A01,908097,Liao; Soohyun Nam,47,0,75,28
1746613634630,DSC 40A,A01,908099,Shannon; Kyle Michael,30,0,50,20
1746613635662,DSC 40B,A01,908112,Staff,15,0,50,35
1746613636690,DSC 80,A01,908116,Staff,19,0,60,41
1746613637720,DSC 197,001,956863,Eldridge; Justin Matthew,9999,0,9999,0
1746613638749,ECE 5,A01,886400,Morris; Karcher William,1,0,6,5
1746613638749,ECE 5,A02,886401,Morris; Karcher William,3,0,6,3
1746613639781,ECE 148,A01,886403,Silberman; Jack,0,14,14,14
1746613640814,ECON 1,A01,887265,Crane; Meredith Helen,11,0,70,59
1746613640814,ECON 1,B01,887268,Staff,42,0,50,8
1746613641841,ECON 2,A01,887273,Crane; Meredith Helen,54,0,70,16
1746613642867,ECON 3,A01,887279,Rondina; Giacomo,31,0,70,39
1746613643899,ECON 4,A01,887282,Anderson; John Charles,0,2,10,10
1746613644930,ECON 5,A01,887285,Staff,34,0,45,11
1746613644930,ECON 5,B01,887292,Staff,41,0,45,4
1746613645959,ECON 100A,A01,887337,Newhouse; Herbert S,54,0,70,16
1746613645959,ECON 100A,B01,887349,Staff,45,0,50,5
1746613647030,ECON 100B,A01,887361,Du; Songzi,29,0,70,41
1746613648059,ECON 100C,A01,887445,Newhouse; Herbert S,59,0,70,11
1746613649087,ECON 105,A00,887488,Vespa; Emanuel Ignacio,23,0,35,12
1746613650121,ECON 109,A01,887506,Shishkin; Denis,28,0,35,7
1746613651152,ECON 110A,A01,887568,Alon; Titan Michael,0,2,35,35
1746613651152,ECON 110A,B01,907601,Alon; Titan Michael,20,0,35,15
1746613652188,ECON 110B,A01,887598,Levkoff; Steven B.,0,24,70,70
1746613653213,ECON 112,A00,887599,Rondina; Giacomo,19,0,35,16
1746613654249,ECON 120A,A01,887603,Dai; Yinlin,36,0,70,34
1746613655283,ECON 120C,A01,887608,Sun; Yixiao,0,1,35,35
1746613655283,ECON 120C,B01,887614,Sun; Yixiao,0,0,35,35
1746613656311,ECON 138,A00,887621,Bharadwaj; Prashant,0,21,20,20
1746613657345,ECON 144,A00,958007,Squires; Dale E,11,0,35,24
1746613658373,ECON 171,A01,907666,Staff,18,0,35,17
1746613659406,ECON 175,A00,887626,Wu; Pak Yeung,22,0,35,13
1746613660438,ECON 190,A00,887640,Vespa; Emanuel Ignacio,22,0,35,13
1746613661480,EDS 25,A01,888197,Staff,0,0,0,0
1746613661480,EDS 25,A02,888209,Staff,0,0,0,0
1746613661480,EDS 25,A03,888210,Staff,0,0,0,0
1746613661480,EDS 25,A04,888212,Staff,0,0,0,0
1746613661480,EDS 25,A05,888213,Staff,0,0,0,0
1746613661480,EDS 25,A06,888214,Staff,0,0,0,0
1746613661480,EDS 25,A07,888235,Staff,0,2,0,0
1746613661480,EDS 25,A08,888236,Staff,0,0,0,0
1746613661480,EDS 25,A09,888240,Staff,0,0,0,0
1746613661480,EDS 25,A10,888244,Staff,0,0,0,0
1746613661480,EDS 25,B01,888273,Staff,0,0,0,0
1746613661480,EDS 25,B02,888285,Staff,0,0,0,0
1746613661480,EDS 25,B03,888423,Staff,0,0,0,1
1746613661480,EDS 25,B04,888432,Staff,0,0,0,0
1746613661480,EDS 25,B05,888433,Staff,0,0,0,0
1746613661480,EDS 25,B06,888467,Staff,0,0,0,0
1746613661480,EDS 25,B07,888468,Staff,0,0,0,0
1746613661480,EDS 25,B08,888479,Staff,0,0,0,0
1746613661480,EDS 25,B09,888484,Staff,0,0,0,0
1746613661480,EDS 25,B10,888487,Staff,0,0,0,0
1746613662508,EDS 38,A01,907700,Choi; Bailey Miyeon,30,0,30,0
1746613663539,EDS 112,A01,888601,Chapman; Thandeka K,12,0,40,28
1746613664566,EDS 115,A00,888697,Mendez; Kathrina Mendoza,10,0,30,20
1746613665592,EDS 116,A01,888893,Staff,33,0,40,7
1746613667652,EDS 124AR,A00,889133,Staff,29,0,50,21
1746613667652,EDS 124AR,B00,907471,Simon; Elizabeth A,37,0,50,13
1746613668679,EDS 124BR,A00,889134,Simon; Elizabeth A,44,0,100,56
1746613669706,EDS 125,A00,889135,Staff,25,0,30,5
1746613670733,EDS 126,A01,889138,Staff,35,0,40,5
1746613671760,EDS 164R,A01,889142,Wishard Guerra; Alison G.,32,0,50,18
1746613672790,ENG 30,A01,886396,Staff,0,0,0,0
1746613672790,ENG 30,B01,886398,Staff,0,0,0,0
1746613673817,ENVR 102,A00,906150,Montejo; Carolina,23,0,25,2
1746613674846,ETHN 103A,A00,887236,Man; Simeon S,0,2,0,0
1746613675873,ETHN 113,A00,887239,Staff,16,0,30,14
1746613676904,ETHN 116,A00,887240,Staff,16,0,25,9
1746613677935,ETHN 117,A00,887241,Choi; Esther Min,28,0,30,2
1746613678961,ETHN 118,A00,887243,Staff,24,0,30,6
1746613679991,ETHN 127,A00,887248,Cuong; Marisol,11,0,15,4
1746613681020,ETHN 139,A00,887250,Staff,7,0,10,3
1746613682048,ETHN 142,A00,887252,Staff,9,0,30,21
1746613683078,ETHN 161,A00,887253,Browne; Errol Tsekani,24,0,30,6
1746613684106,ETHN 163FR,A00,887255,Burelle; Julie Sara Veronique,0,0,5,5
1746613685134,GLBH 20,A00,889149,Elwardani; Nile Regina,8,0,42,34
1746613687198,GLBH 111,A01,889152,Burgos; Jose L.,17,0,17,0
1746613688226,GLBH 150,A00,889181,Sloane; Julia Kathryn,0,5,15,15
1746613690289,HDS 60,A01,886406,Warstadt; Melissa Fawn,72,0,80,8
1746613691320,HIAF 111,A00,889324,Gyamfi; Bright,25,0,32,7
1746613692350,HIEA 131,A00,889328,Staff,15,0,32,17
1746613693377,HIEA 144,A00,889333,Henry; Todd A.,26,0,32,6
1746613694410,HIEA 154,A00,889336,Henry; Todd A.,24,0,32,8
1746613695441,HIEU 106,A00,889339,Staff,22,0,32,10
1746613697496,HIEU 114,A00,889340,Staff,4,0,32,28
1746613698527,HIEU 135GS,A00,889342,Patterson; Patrick H.,0,0,1,24
1746613699558,HIEU 137,A00,889343,Edington; Claire Ellen,10,0,25,15
1746613700585,HIEU 148,A00,889345,Staff,14,0,32,18
1746613701615,HIEU 154,A00,889346,Biess; Frank Peter,21,0,32,11
1746613702647,HILA 102,A00,889351,Staff,12,0,32,20
1746613703674,HILD 2A,A01,889221,Lewandoski; Julia Mavis,0,8,32,32
1746613704700,HILD 7B,A01,889225,Man; Simeon S,0,12,32,32
1746613705733,HILD 7C,A01,889288,Alvarez; Luis A,0,14,32,32
1746613706759,HILD 30,A01,889323,Staff,0,5,32,32
1746613708819,HISC 119,A00,889383,Golan; Tal,20,0,32,12
1746613709850,HIUS 103,A00,889384,Man; Simeon S,0,0,32,32
1746613710884,HIUS 117,A00,919797,Kwak; Nancy,18,0,32,14
1746613711911,HIUS 142A,A00,919788,Staff,22,0,32,10
1746613713972,HIUS 149,A00,889386,Gyamfi; Bright,26,0,32,6
1746613715008,HIUS 155,A00,889387,Alvarez; Luis A,15,0,32,17
1746613716042,HUM 3,A01,886499,Caldwell; Michael Alan,19,0,50,31
1746613717070,HUM 3GS,A00,886500,Rodriguez; Bretton Sigfred,0,0,0,28
1746613718098,HUM 3R,A01,886502,Markman; Kristina,0,36,50,50
1746613719137,HUM 4,A01,886504,Crum; Matthew Stephen,23,0,50,27
1746613719137,HUM 4,B01,886506,West; Geoffrey Scott,17,0,50,33
1746613720167,HUM 4GS,A00,886507,Staff,0,0,0,19
1746613721193,HUM 5,A01,886509,Staff,31,0,50,19
1746613722221,HUM 5R,A01,886511,Zavodny; Tatiana Sophia,0,39,50,50
1746613723250,JAPN 180,A00,886407,Staff,16,0,40,24
1746613724278,LATI 50,A01,886409,Martin-Cabrera; Luis,3,0,22,19
1746613724278,LATI 50,A02,886410,Martin-Cabrera; Luis,19,0,22,3
1746613724278,LATI 50,A03,886411,Martin-Cabrera; Luis,21,0,22,1
1746613724278,LATI 50,A04,886412,Martin-Cabrera; Luis,8,0,22,14
1746613725304,LAWS 101,A00,907664,Staff,28,0,60,32
1746613726337,LIAB 1A,A00,889388,Saab; Dima,17,0,20,3
1746613727368,LIAB 1AX,A00,889389,El Cheddadi; Youniss,18,0,20,2
1746613728398,LIFR 1C,A00,889391,Van Moer; Vinciane G,8,0,20,12
1746613729424,LIFR 1CX,A00,889392,Van Moer; Vinciane G,7,0,20,13
1746613730457,LIFR 1D,A00,889393,Van Moer; Vinciane G,7,0,20,13
1746613731483,LIFR 1DX,A00,889394,Van Moer; Vinciane G,8,0,20,12
1746613732513,LIGN 7,A00,886923,Staff,25,0,50,25
1746613733541,LIGN 17,A00,886924,Kehler; Andrew Scott,126,0,150,24
1746613734570,LTAM 110,A00,889395,Staff,15,0,30,15
1746613735598,LTAM 110GS,A00,958010,Rodriguez; Bretton Sigfred,0,0,0,28
1746613736624,LTCH 101,A00,889397,Staff,23,0,25,2
1746613737651,LTCS 130,A00,889398,Staff,23,0,25,2
1746613738677,LTEA 138,A00,889399,Staff,24,0,40,16
1746613739713,LTEN 149,A00,889400,Wesling; Megan E.,0,3,25,25
1746613740738,LTEN 169,A00,889401,Staff,20,0,25,5
1746613741765,LTEN 180,A00,889402,Staff,10,0,15,5
1746613742791,LTEN 181,A00,889403,Staff,21,0,25,4
1746613743818,LTWL 100,A00,889404,Myerston Santana; Jacobo,2,0,25,23
1746613744847,LTWL 180GS,A00,889405,Staff,0,0,20,20
1746613745877,LTWL 181,A00,889406,Staff,16,0,25,9
1746613746908,LTWL 184,A00,889475,Mukherjee; Silpa,22,0,25,3
1746613747939,LTWR 102C,A00,889486,Staff,29,0,30,1
1746613748965,LTWR 115W,A00,889491,Staff,0,2,15,15
1746613749994,MAE 8,A01,886905,Staff,0,2,0,0
1746613751022,MAE 11,A00,886906,Bandaru; Prabhakar,0,7,50,50
1746613752049,MAE 20,A00,886907,Evdokimenko; Ekaterina,43,0,70,27
1746613753079,MAE 30B,A00,886909,Ghazinejad; Maziar,25,0,45,20
1746613754109,MAE 101B,A00,886910,Saintillan; David,30,0,45,15
1746613755138,MAE 105,A00,886911,Bandaru; Prabhakar,18,0,50,32
1746613756166,MAE 107,B00,958024,Staff,7,0,50,43
1746613757196,MAE 143B,A00,886913,Bewley; Thomas R,2,0,40,38
1746613758224,MAE 148,A01,886915,Silberman; Jack,0,3,14,14
1746613759249,MAE 160,A00,886916,Evdokimenko; Ekaterina,30,0,60,30
1746613760285,MATH 3C,A01,889681,Staff,0,2,30,30
1746613760285,MATH 3C,A02,960048,Staff,23,0,30,7
1746613761313,MATH 10A,A01,889760,Staff,26,0,30,4
1746613761313,MATH 10A,A02,889783,Staff,29,0,30,1
1746613762349,MATH 10B,A01,889785,Verstraete; Jacques Allan,1,0,35,34
1746613762349,MATH 10B,A02,889795,Verstraete; Jacques Allan,4,0,35,31
1746613762349,MATH 10B,B01,889797,Verstraete; Jacques Allan,3,0,35,32
1746613762349,MATH 10B,B02,889828,Verstraete; Jacques Allan,3,0,35,32
1746613763381,MATH 10C,A01,889849,Habib; Yousaf,8,0,30,22
1746613763381,MATH 10C,A02,889852,Habib; Yousaf,14,0,30,16
1746613763381,MATH 10C,A03,889853,Habib; Yousaf,22,0,30,8
1746613763381,MATH 10C,A04,889858,Habib; Yousaf,20,0,30,10
1746613763381,MATH 10C,B01,889861,Staff,1,0,30,29
1746613763381,MATH 10C,B02,889862,Staff,24,0,30,6
1746613763381,MATH 10C,B03,889863,Staff,27,0,30,3
1746613763381,MATH 10C,B04,889967,Staff,23,0,30,7
1746613764409,MATH 18,A01,889974,Staff,6,0,30,24
1746613764409,MATH 18,A02,889977,Staff,20,0,30,10
1746613764409,MATH 18,B01,889984,Hardiman; Liam,20,0,30,10
1746613764409,MATH 18,B02,889985,Hardiman; Liam,25,0,30,5
1746613765442,MATH 20A,A01,889990,Suk; Andrew Hoon,30,0,35,5
1746613766468,MATH 20B,A01,889993,Ohm; Ko Woon,21,0,30,9
1746613766468,MATH 20B,A02,889994,Ohm; Ko Woon,30,0,30,0
1746613766468,MATH 20B,B01,889996,Ohm; Ko Woon,22,0,30,8
1746613766468,MATH 20B,B02,889997,Ohm; Ko Woon,23,0,30,7
1746613767498,MATH 20C,A01,889999,Hammock; Frances H,17,0,30,13
1746613767498,MATH 20C,A02,890003,Hammock; Frances H,23,0,30,7
1746613767498,MATH 20C,B01,890006,Hammock; Frances H,2,0,30,28
1746613767498,MATH 20C,B02,890007,Hammock; Frances H,11,0,30,19
1746613768529,MATH 20D,A01,890011,Cheng; Hsiao-Bing,1,0,30,29
1746613768529,MATH 20D,A02,890012,Cheng; Hsiao-Bing,14,0,30,16
1746613768529,MATH 20D,B01,890016,Cheng; Hsiao-Bing,13,0,30,17
1746613768529,MATH 20D,B02,890017,Cheng; Hsiao-Bing,13,0,30,17
1746613769556,MATH 20E,A01,890026,Harel; Guershon,1,0,30,29
1746613769556,MATH 20E,A02,890029,Harel; Guershon,22,0,30,8
1746613769556,MATH 20E,B01,890033,Harel; Guershon,7,0,30,23
1746613769556,MATH 20E,B02,890101,Harel; Guershon,21,0,30,9
1746613770584,MATH 102,A01,890104,Staff,18,0,30,12
1746613770584,MATH 102,A02,890105,Staff,27,0,30,3
1746613771612,MATH 103B,A01,890116,Salehi Golsefidy; Alireza,3,0,30,27
1746613771612,MATH 103B,B01,890118,Staff,0,3,34,34
1746613772642,MATH 109,A01,890121,Aliabadi Sr.; Mohsen,0,0,30,30
1746613772642,MATH 109,B01,890124,Upadrashta; Pranav Kumar,18,0,30,12
1746613773677,MATH 120A,A01,890126,Eggers; John Dietrich,13,0,30,17
1746613774706,MATH 142B,A01,890128,Ioana; Adrian,19,0,30,11
1746613774706,MATH 142B,A02,890129,Ioana; Adrian,12,0,30,18
1746613775732,MATH 154,A01,890174,Staff,0,1,30,30
1746613775732,MATH 154,A02,890182,Staff,0,0,30,30
1746613776761,MATH 168A,A01,890197,Dumitriu; Ioana,21,0,35,14
1746613777796,MATH 170A,A01,890240,Nie; Jiawang,1,0,30,29
1746613777796,MATH 170A,A02,890241,Nie; Jiawang,11,0,30,19
1746613777796,MATH 170A,A03,890249,Nie; Jiawang,23,0,30,7
1746613778822,MATH 170B,A01,957891,Nag; Panchali,13,0,35,22
1746613780877,MATH 181A,A01,908025,Staff,0,3,35,35
1746613780877,MATH 181A,A02,960115,Staff,26,0,35,9
1746613781909,MATH 181B,A01,959874,Staff,24,0,30,6
1746613782937,MATH 193B,A01,890265,Staff,0,4,35,35
1746613783971,MGT 4,A01,890311,Anderson; John Charles,42,0,88,46
1746613785004,MGT 5,A00,907740,Staff,12,0,98,86
1746613786032,MGT 12,A00,890312,Lindenberger; Wade Douglas,67,0,98,31
1746613787063,MGT 16,A00,957883,Staff,78,0,98,20
1746613789122,MGT 45,A00,890314,Pecore; Joseph P.,45,0,98,53
1746613790151,MGT 71,A00,890315,Staff,0,12,98,98
1746613791178,MGT 100,A00,890316,Yavorsky; Daniel Ryan,44,0,98,54
1746613792210,MGT 103,A00,890317,Ehrich; Kristine R,73,0,98,25
1746613793237,MGT 105,A00,890356,Bates; Kenneth Walter,0,8,98,98
1746613794263,MGT 112,A00,890360,Ehrich; Kristine R,55,0,98,43
1746613795297,MGT 127R,A00,907732,Zhu; Kevin Xiaoguo,23,0,98,75
1746613796330,MGT 131B,A00,890361,Anderson; John Charles,59,0,98,39
1746613797357,MGT 137,A00,890362,Lindenberger; Wade Douglas,65,0,98,33
1746613798387,MGT 160,A00,890369,Johnson; Erik Barry,9,0,98,89
1746613800454,MGT 164,A00,890372,Zimmermann; Carsten,0,40,98,98
1746613801482,MGT 180,A00,890374,Bliss; Barbara Ann,11,0,98,87
1746613802513,MMW 15,A01,886414,Chang; Edmond Yi-Teh,0,12,28,28
1746613802513,MMW 15,A02,886415,Chang; Edmond Yi-Teh,0,8,28,28
1746613802513,MMW 15,A03,886416,Chang; Edmond Yi-Teh,0,9,28,28
1746613802513,MMW 15,A04,886417,Chang; Edmond Yi-Teh,0,8,28,28
1746613802513,MMW 15,B01,886419,Chang; Edmond Yi-Teh,0,7,28,28
1746613802513,MMW 15,B02,886420,Chang; Edmond Yi-Teh,0,7,28,28
1746613802513,MMW 15,B03,886421,Chang; Edmond Yi-Teh,0,7,28,28
1746613802513,MMW 15,B04,886422,Chang; Edmond Yi-Teh,0,8,28,28
1746613802513,MMW 15,C01,886424,Staff,0,9,28,28
1746613802513,MMW 15,C02,886425,Staff,0,8,28,28
1746613802513,MMW 15,C03,886426,Staff,0,8,28,28
1746613802513,MMW 15,C04,886427,Staff,0,8,28,28
1746613802513,MMW 15,C05,958038,Staff,0,8,28,28
1746613802513,MMW 15,C06,958039,Staff,0,7,28,28
1746613803540,MMW 15GS,A00,906910,Patterson; Patrick H.,4,0,28,24
1746613804567,MMW 122R,A01,886429,Rahimi; Babak,0,13,28,28
1746613804567,MMW 122R,A02,886430,Rahimi; Babak,0,12,28,28
1746613804567,MMW 122R,A03,958040,Rahimi; Babak,0,11,28,28
1746613805611,MUS 1A,A01,890937,Staff,2,0,25,23
1746613805611,MUS 1A,A02,891035,Staff,6,0,25,19
1746613805611,MUS 1A,C01,958912,Staff,24,0,25,1
1746613805611,MUS 1A,C02,958913,Staff,25,0,25,0
1746613807666,MUS 2AK,A00,957092,Ohnishi; Takae,15,0,15,0
1746613808699,MUS 4,A01,891044,Staff,0,0,25,25
1746613808699,MUS 4,A02,891045,Staff,22,0,25,3
1746613808699,MUS 4,B01,891048,Staff,17,0,25,8
1746613808699,MUS 4,B02,891050,Staff,25,0,25,0
1746613809737,MUS 5,A01,957506,Dubnov; Shlomo,0,0,25,25
1746613809737,MUS 5,A02,957622,Dubnov; Shlomo,12,0,25,13
1746613809737,MUS 5,A03,957623,Dubnov; Shlomo,20,0,25,5
1746613810764,MUS 6,A01,891053,Freitas Caetano; Marcelo,24,0,25,1
1746613810764,MUS 6,A02,891054,Freitas Caetano; Marcelo,23,0,25,2
1746613811791,MUS 7,A01,891081,Staff,0,0,25,25
1746613811791,MUS 7,A02,891082,Staff,3,0,25,22
1746613812819,MUS 8GS,A00,891118,Borgo; David Garcia,1,0,25,24
1746613813853,MUS 11,A01,891140,Staff,8,0,25,17
1746613813853,MUS 11,A02,891141,Staff,21,0,25,4
1746613814880,MUS 13,A01,891143,Staff,8,0,25,17
1746613814880,MUS 13,A02,891144,Staff,24,0,25,1
1746613815910,MUS 15,A01,891146,Staff,9,0,25,16
1746613815910,MUS 15,A02,891148,Staff,21,0,25,4
1746613815910,MUS 15,B01,891150,Staff,18,0,25,7
1746613815910,MUS 15,B02,891151,Staff,25,0,25,0
1746613816943,MUS 20,A01,891153,Staff,5,0,20,15
1746613816943,MUS 20,A02,891155,Staff,14,0,20,6
1746613817971,MUS 80,A00,891156,Staff,19,0,25,6
1746613817971,MUS 80,B00,891157,Staff,23,0,25,2
1746613818998,MUS 130,A00,891158,Ohnishi; Takae,35,0,35,0
1746613820028,MUS 150GS,A01,891160,Borgo; David Garcia,1,0,25,24
1746613821056,MUS 170,A01,891162,Freitas Caetano; Marcelo,20,0,25,5
1746613821056,MUS 170,A02,891164,Freitas Caetano; Marcelo,21,0,25,4
1746613822094,NANO 11,A00,886220,Vazquez Mena; Oscar,13,0,15,2
1746613823122,NANO 15,A01,886222,Drews; Aaron,4,0,7,3
1746613824148,NANO 104,A00,886224,Sirbuly; Donald,17,0,25,8
1746613825180,PH 40,A00,886528,Staff,23,0,40,17
1746613826207,PH 45,A01,886799,Staff,35,0,40,5
1746613827236,PH 110,A00,886802,Staff,0,6,40,40
1746613828264,PH 172,A00,906716,Staff,19,0,35,16
1746613829289,PH 191,A00,886803,Staff,6,0,40,34
1746613830317,PHIL 1,A00,889500,Staff,20,0,30,10
1746613831352,PHIL 10,A01,889549,Grush; Rick Scott,16,0,22,6
1746613831352,PHIL 10,A02,889551,Grush; Rick Scott,22,0,22,0
1746613832383,PHIL 28,A01,889559,Lamey; Andy M.,0,2,31,31
1746613832383,PHIL 28,A02,889561,Lamey; Andy M.,0,1,30,30
1746613832383,PHIL 28,A03,889572,Lamey; Andy M.,0,1,30,30
1746613833416,PHIL 35,A00,907839,Staff,13,0,15,2
1746613834444,PHIL 60,A00,889574,Staff,73,0,90,17
1746613835471,PHIL 101,A00,958004,Staff,12,0,15,3
1746613837530,PHIL 136,A00,889582,Fulkerson; Matthew Todd,26,0,45,19
1746613838561,PHIL 163,A01,889601,Staff,21,0,30,9
1746613838561,PHIL 163,B01,889606,Brandt; Reuven A,0,3,0,0
1746613839588,PHIL 164,A00,889610,Staff,16,0,30,14
1746613840615,PHIL 165,A00,889613,Staff,22,0,30,8
1746613841643,PHYS 1A,A00,886431,Staff,30,0,70,40
1746613842674,PHYS 1AL,001,886432,Tsai; Philbert S,0,1,30,30
1746613842674,PHYS 1AL,002,886436,Tsai; Philbert S,13,0,30,17
1746613843704,PHYS 1B,A00,886439,Staff,184,0,240,56
1746613844731,PHYS 1BL,001,886441,Tsai; Philbert S,0,4,30,30
1746613844731,PHYS 1BL,002,886444,Tsai; Philbert S,2,0,30,28
1746613845758,PHYS 1C,A00,896092,Arnold; Kam S,78,0,146,68
1746613846790,PHYS 1CL,001,886448,Tsai; Philbert S,0,1,30,30
1746613846790,PHYS 1CL,002,886449,Tsai; Philbert S,1,0,30,29
1746613846790,PHYS 1CL,003,886450,Tsai; Philbert S,16,0,30,14
1746613846790,PHYS 1CL,004,886451,Tsai; Philbert S,15,0,30,15
1746613847824,PHYS 2B,A01,886457,Staff,67,0,115,48
1746613848855,PHYS 2C,A01,886460,Shotwell; Brian,0,9,65,65
1746613849882,PHYS 2CL,A01,886467,Staff,0,4,28,28
1746613849882,PHYS 2CL,A02,886468,Staff,0,3,28,28
1746613850909,PHYS 2D,A01,886470,Staff,10,0,50,40
1746613851942,PHYS 4B,A01,886475,Grinstein; Benjamin,22,0,40,18
1746613852972,POLI 5,A00,891173,Desposato; Scott,7,0,25,18
1746613854004,POLI 5D,A01,891175,Staff,5,0,5,0
1746613854004,POLI 5D,B01,891178,Staff,5,0,5,0
1746613855032,POLI 11,A00,891179,Ferree; Karen E,0,0,35,35
1746613856060,POLI 12,A00,891180,Staff,15,0,30,15
1746613857091,POLI 27,A01,891182,Staff,11,0,75,64
1746613858118,POLI 30,A00,891183,Staff,8,0,50,42
1746613859237,POLI 100B,A00,891244,Staff,5,1,35,30
1746613860266,POLI 100I,A00,891247,Staff,7,0,30,23
1746613861294,POLI 104J,A00,891248,Nichter; Maysa,14,0,30,16
1746613862323,POLI 104U,A00,891250,Nichter; Maysa,1,0,30,29
1746613864394,POLI 110B,A00,891255,Wiens; David,19,0,25,6
1746613865422,POLI 112A,A00,891256,Wiens; David,6,0,25,19
1746613866449,POLI 114BR,A00,891261,Staff,19,0,30,11
1746613867476,POLI 117R,A00,891262,Forman; Fonna,0,6,50,50
1746613868502,POLI 118,A00,891264,Ingham; Sean,17,0,25,8
1746613869531,POLI 124A,A00,891265,Staff,18,0,20,2
1746613870559,POLI 125D,A00,891266,Nichter; Simeon C,2,0,25,23
1746613871586,POLI 126,A00,891268,Nichter; Simeon C,7,0,25,18
1746613872613,POLI 126AA,A00,891272,Staff,15,0,25,10
1746613873644,POLI 130AA,A00,891273,Staff,15,0,20,5
1746613874670,POLI 134AA,A00,891274,Staff,4,0,20,16
1746613876724,POLI 138,A00,891278,Staff,21,0,25,4
1746613877750,POLI 142K,A00,891280,Staff,10,0,25,15
1746613878781,POLI 142M,A00,891281,Gartzke; Erik,16,0,30,14
1746613879808,POLI 142P,A00,891284,Staff,20,0,30,10
1746613880833,POLI 143,A00,891285,Gartzke; Erik,12,0,30,18
1746613881861,POLI 153,A00,891286,Staff,19,0,20,1
1746613883924,POLI 175,A00,891290,Staff,15,0,20,5
1746613884952,PSYC 1,A00,890674,Steiner; Eric Tomas,0,11,45,45
1746613885984,PSYC 2,A00,890676,Albright; Thomas D,20,0,35,15
1746613887012,PSYC 3,A00,890679,Staff,17,0,20,3
1746613888039,PSYC 6,A00,959858,Staff,19,0,20,1
1746613889067,PSYC 60,A01,890684,Rickard; Timothy C.,0,6,45,45
1746613890095,PSYC 70,A01,890689,Geller; Emma Harlan,6,0,30,24
1746613891128,PSYC 71,A01,959860,Staff,21,0,25,4
1746613892161,PSYC 100,A00,890690,Lacefield; Katharine I,0,50,180,180
1746613893189,PSYC 102,A00,890695,Staff,18,0,40,22
1746613894217,PSYC 105,A00,890699,Geller; Emma Harlan,70,0,100,30
1746613895245,PSYC 106,A00,890701,Gorman; Michael R.,5,0,30,25
1746613896277,PSYC 108,A00,890704,Adrian; Julia Anna,0,29,50,50
1746613897307,PSYC 118,A01,890712,Staff,11,0,30,19
1746613898332,PSYC 124,A00,890716,Chapman; Eddie Nathaniel,25,0,60,35
1746613899364,PSYC 131,A00,890717,Anagnostaras; Stephan,0,7,80,80
1746613900394,PSYC 137,A00,890719,Winkielman; Piotr,0,11,30,30
1746613901419,PSYC 144,A00,890721,Adrian; Julia Anna,0,9,45,45
1746613902444,PSYC 162,A00,890805,Staff,0,2,75,75
1746613903474,PSYC 169,A00,890810,Staff,0,15,30,30
1746613904501,PSYC 172,A00,890814,Gorman; Michael R.,9,0,30,21
1746613905531,PSYC 181,A00,890818,Anagnostaras; Stephan,6,0,200,194
1746613906557,PSYC 184,A00,959861,Staff,160,0,175,15
1746613907586,PSYC 189,A00,890823,Staff,0,2,30,30
1746613908612,PSYC 191,A00,890884,Rickard; Timothy C.,0,12,35,35
1746613909639,PSYC 193,A00,890913,Staff,19,0,30,11
1746613909639,PSYC 193,B00,890914,Chapman; Eddie Nathaniel,24,0,30,6
1746613910668,PSYC 193L,A01,890918,Lowe; Angela Beth,20,0,30,10
1746613910668,PSYC 193L,B01,890921,Hurwitz; Ethan Scott,20,0,30,10
1746613910668,PSYC 193L,C01,890928,Staff,30,0,30,0
1746613911697,RELI 149,A00,886806,Rahimi; Babak,23,0,40,17
1746613912724,SE 9,A01,886814,Staff,7,0,20,13
1746613913750,SE 101B,A01,886816,Chadha; Mayank,3,0,35,32
1746613914779,SE 110B,A00,886818,Zhu; Qiang,4,0,75,71
1746613915806,SE 125,A01,886830,Staff,10,0,30,20
1746613916836,SE 130B,A01,886835,Staff,14,0,40,26
1746613917867,SE 131A,A01,886838,Krysl; Petr,34,0,55,21
1746613918893,SE 154,A00,886840,Staff,28,0,50,22
1746613919922,SE 164GS,A01,886849,Staff,6,0,20,14
1746613920952,SE 167GS,A01,886853,Staff,6,0,20,14
1746613921979,SIO 25,A01,890107,Staff,19,0,30,11
1746613923008,SIO 45,A00,890109,Cook; Geoffrey W,114,0,200,86
1746613924035,SIO 109R,A00,890110,Forman; Fonna,0,16,20,20
1746613925073,SIO 187,A01,890114,Kacev; David,15,0,40,25
1746613926101,SOCI 1,A01,890431,Thorpe; Charles Robert,14,0,30,16
1746613926101,SOCI 1,A02,890518,Thorpe; Charles Robert,30,0,30,0
1746613927133,SOCI 2,A01,957978,Staff,25,0,25,0
1746613927133,SOCI 2,A02,957979,Staff,23,0,25,2
1746613928166,SOCI 20,A01,890523,Calderon-Zaks; Michael Aar,21,0,30,9
1746613928166,SOCI 20,A02,890526,Calderon-Zaks; Michael Aar,29,0,30,1
1746613929199,SOCI 30,A01,890533,Pardo Guerra; Juan Pablo,37,0,40,3
1746613930228,SOCI 40,A01,890535,Staff,27,0,45,18
1746613931258,SOCI 104Q,A00,890559,Staff,17,0,30,13
1746613932286,SOCI 106,A00,890560,Arnal; Maud Marie Leonie,20,0,30,10
1746613933315,SOCI 110,A00,890567,Holkenbrink-Monk; Charlene,19,0,30,11
1746613934341,SOCI 112,A00,890568,Victoria Torres; Pablo,2,0,55,53
1746613935369,SOCI 115,A00,890597,Arnal; Maud Marie Leonie,28,0,45,17
1746613937423,SOCI 121,A00,890604,Pardo Guerra; Juan Pablo,38,0,45,7
1746613938455,SOCI 126,A01,890608,Staff,8,0,10,2
1746613939485,SOCI 127,A00,890609,Staff,18,0,30,12
1746613940514,SOCI 131,A00,890610,Thorpe; Charles Robert,37,0,45,8
1746613941542,SOCI 135,A00,890615,Payne; Christine Anna,14,0,45,31
1746613942569,SOCI 139,A00,890620,Staff,38,0,45,7
1746613943596,SOCI 148E,A00,890622,Calderon-Zaks; Michael Aar,36,0,45,9
1746613944628,SOCI 150,A00,890623,Kohler; Kristopher M.,31,0,45,14
1746613945657,SOCI 157,A00,890625,Jules-Rosette; Bennetta W.,18,0,20,2
1746613946683,SOCI 160,A00,890627,Payne; Christine Anna,21,0,45,24
1746613947715,SYN 1,A00,886855,Fish; Gwendolyn Anne,0,1,0,0
1746613947715,SYN 1,B00,906086,Fish; Gwendolyn Anne,0,2,0,2
1746613948750,SYN 2R,A00,886860,Staff,0,17,15,15
1746613948750,SYN 2R,B00,906106,Atkinson; Arthur Laird,0,16,15,15
1746613949783,SYN 100,A01,886866,Browne; Emily,0,28,20,20
1746613949783,SYN 100,B01,906128,Rock; Martin,0,4,20,20
1746613949783,SYN 100,C01,906140,Deavenport; James Cary,0,4,20,20
1746613949783,SYN 100,D01,907816,Deavenport; James Cary,0,5,20,20
1746613950815,TDAC 1,A00,890286,Walsh; Kim C.,7,0,20,13
1746613951882,TDAC 101,A00,890296,Basso; Beatrice,15,0,20,5
1746613952908,TDDE 131,A00,890297,Staff,47,0,50,3
1746613953935,TDDM 1,A00,890287,Weinberg; Sadie,25,0,30,5
1746613954964,TDGE 11,A00,890288,Fulton; Julia,138,0,200,62
1746613954964,TDGE 11,B00,890289,Castro; Robert Jess,184,0,200,16
1746613955996,TDGE 25,B00,957359,Walsh; Kim C.,5,0,20,15
1746613957026,TDGE 40,A01,890292,Power; Jade Yukana,26,0,30,4
1746613958054,TDGE 124,A00,890298,Havis; Allan,0,2,50,50
1746613959083,TDGE 131R,A00,890299,Burelle; Julie Sara Veronique,15,0,42,27
1746613960115,TDHT 101,A00,890300,Staff,10,0,20,10
1746613961140,TDHT 109,A01,890302,Anderson; Mysia Anyse,31,0,40,9
1746613962173,TDMV 1,A00,890293,Arcidiacono; Kristin,18,0,30,12
1746613963199,TDMV 2,A00,890294,Weinberg; Sadie,23,0,30,7
1746613964231,TDMV 3,A00,957878,Arcidiacono; Kristin,28,0,30,2
1746613966284,TDMV 138,A00,890304,Jun; Grace Shin Hae,25,0,40,15
1746613967433,TDMV 140,A00,890305,Corrales; Joseph Bernales,25,0,30,5
1746613968458,TDMV 142,A00,890307,Caligagan; Tony,32,0,40,8
1746613969493,TDMV 144,A00,890308,Camaya; Michelle Ann,25,0,30,5
1746613970522,TDPW 1,A00,890295,Stein; Deborah Isobel,3,0,20,17
1746613971549,USP 2,A01,890272,Lerner; Amy M,7,0,20,13
1746613972574,USP 3,A01,890274,Staff,12,0,30,18
1746613973602,USP 15,A01,890276,Sun; Feiyang,16,0,30,14
1746613974648,USP 25,A00,890277,Shenkman; Michael Thomas,18,0,25,7
1746613975673,USP 138,A00,890278,Staff,13,0,25,12
1746613976697,USP 143,A00,890279,Staff,21,0,70,49
1746613977722,USP 144,A00,890280,Chowdhury; Muhammed Zohir,16,0,30,14
1746613978753,USP 150,A00,890281,Boomhower; Matthew Charles,4,0,30,26
1746613979792,USP 151,A00,890282,Staff,16,0,20,4
1746613980817,USP 162,A00,890283,Andrews; Abigail Leslie,16,0,20,4
1746613981846,USP 168,A00,920477,Kwak; Nancy,0,0,5,5
1746613982870,USP 181,A00,890284,Staff,3,0,20,17
1746613983896,USP 191A,A00,890285,Staff,12,0,20,8
1746613984926,VIS 101,A00,886512,Staff,26,0,75,49
1746613985951,VIS 103,A00,886513,Cruz; Edwin Teddy,61,0,75,14
1746613986977,VIS 108,A00,886514,Staff,4,0,15,11
1746613988007,VIS 127P,A00,886515,Shen; Kuiyi,80,0,146,66
1746613989031,VIS 149,A00,886516,Yoldas; Pinar,0,0,15,15
1746613990063,VIS 164,A00,886526,Erdmann; Dean,19,0,22,3
1746613991090,VIS 194S,A00,886527,Staff,61,0,75,14
1746613992134,WCWP 10A,C00,886484,Martiniuk; Jill,12,0,15,3
1746613993160,WCWP 10B,A00,886490,Uriarte; Emma,0,0,15,15
1746613993160,WCWP 10B,B00,886491,Dhir; Simrita,8,0,15,7
1746613993160,WCWP 10B,C00,886492,Ornelas; Tricia,0,0,15,15
1746613994192,WCWP 100,A00,886494,Young; Mark T,0,6,15,15
1746613996390,AAS 10,A01,886199,Childs; Dennis R.,0,3,0,0
1746613997418,ANAR 104,A01,886940,Shtienberg; Gilad,27,0,30,3
1746613998443,ANAR 120,A00,886953,Staff,13,0,20,7
1746613999469,ANBI 148,A01,886955,Wilder; Linnea Lorene,30,0,40,10
1746614001529,ANSC 122,A00,886957,Staff,24,0,30,6
1746614002556,ANSC 150,A00,886958,Sloane; Julia Kathryn,2,0,15,13
1746614003588,ANSC 156,A00,886959,Jenkins; Janis A.,0,1,15,15
1746614004618,ANSC 180,A00,886960,Staff,11,0,17,6
1746614005646,ANSC 188,A00,886961,Jassal; Aftab,9,0,25,16
1746614006673,ANSC 190,A00,886962,Jassal; Aftab,14,0,25,11
1746614007704,ANSC 191,A00,886963,Staff,18,0,20,2
1746614008738,ANTH 3,A01,891689,Staff,17,0,20,3
1746614009778,ANTH 5,A00,886933,Semendeferi; Ekaterini,16,0,20,4
1746614010806,ANTH 10,A00,886934,Staff,0,12,30,30
1746614011832,ANTH 21,A01,886936,Staff,41,0,60,19
1746614012862,ANTH 23,A01,886938,Staff,92,0,100,8
1746614013889,ANTH 105,A00,886964,Stewart; Alexander B,84,0,100,16
1746614014922,ANTH 108,A00,886965,Pedersen; David,9,0,20,11
1746614015955,AWP 10,001,886147,Staff,0,0,0,0
1746614015955,AWP 10,002,886148,Staff,0,0,0,0
1746614015955,AWP 10,003,886149,Staff,0,0,0,0
1746614015955,AWP 10,004,886150,Staff,0,0,0,0
1746614015955,AWP 10,005,886151,Staff,0,0,0,0
1746614015955,AWP 10,006,886152,Staff,0,0,0,0
1746614015955,AWP 10,007,886153,Staff,0,0,0,0
1746614015955,AWP 10,008,886154,Staff,0,0,0,0
1746614015955,AWP 10,009,886155,Staff,0,0,0,0
1746614015955,AWP 10,010,886156,Staff,0,0,0,0
1746614015955,AWP 10,011,886158,Staff,0,0,0,0
1746614015955,AWP 10,012,886160,Staff,0,0,0,0
1746614015955,AWP 10,013,886161,Staff,0,0,0,0
1746614015955,AWP 10,014,886162,Staff,0,0,0,0
1746614015955,AWP 10,015,886163,Staff,0,0,0,0
1746614015955,AWP 10,016,886164,Staff,0,0,0,0
1746614015955,AWP 10,017,886165,Staff,0,0,0,0
1746614015955,AWP 10,018,886166,Staff,0,0,0,0
1746614015955,AWP 10,019,886168,Staff,0,0,0,0
1746614015955,AWP 10,020,886170,Staff,0,0,0,0
1746614015955,AWP 10,021,886172,Staff,0,0,0,0
1746614016998,AWP 10R,001,886173,Staff,0,1,0,0
1746614016998,AWP 10R,002,886174,Staff,0,1,0,0
1746614016998,AWP 10R,003,886175,Staff,0,0,0,0
1746614016998,AWP 10R,004,886176,Staff,0,0,0,0
1746614016998,AWP 10R,005,886177,Staff,0,0,0,0
1746614016998,AWP 10R,006,886178,Staff,0,0,0,0
1746614016998,AWP 10R,007,886179,Staff,0,0,0,0
1746614016998,AWP 10R,008,886181,Staff,0,0,0,0
1746614016998,AWP 10R,009,886182,Staff,0,0,0,0
1746614016998,AWP 10R,010,886183,Staff,0,0,0,0
1746614016998,AWP 10R,011,886184,Staff,0,0,0,0
1746614016998,AWP 10R,012,886185,Staff,0,0,0,0
1746614016998,AWP 10R,013,886186,Staff,0,0,0,0
1746614016998,AWP 10R,014,886187,Staff,0,0,0,0
1746614016998,AWP 10R,015,886188,Staff,0,0,0,0
1746614016998,AWP 10R,016,886189,Staff,0,0,0,0
1746614016998,AWP 10R,017,960532,Staff,0,0,0,0
1746614016998,AWP 10R,018,960533,Staff,0,0,0,0
1746614016998,AWP 10R,019,960534,Staff,0,0,0,0
1746614016998,AWP 10R,020,960538,Staff,0,0,0,0
1746614016998,AWP 10R,021,960540,Staff,0,0,0,0
1746614016998,AWP 10R,022,960541,Staff,0,0,0,0
1746614016998,AWP 10R,023,960542,Staff,0,0,0,0
1746614016998,AWP 10R,024,960544,Staff,0,0,0,0
1746614016998,AWP 10R,025,960545,Staff,0,0,0,0
1746614016998,AWP 10R,026,960548,Staff,0,0,0,0
1746614018029,AWP 102R,A00,886190,Staff,0,0,0,0
1746614018029,AWP 102R,B00,886191,Staff,0,0,0,0
1746614019059,BENG 100,A01,886193,Staff,17,0,30,13
1746614020089,BENG 122A,A01,886195,Hasty; Jeff M,13,0,30,17
1746614021122,BENG 166A,A00,886196,Sah; Robert Lie-Yuan,0,3,30,30
1746614022149,BENG 190,A00,958050,Khojah; Reem I,17,0,25,8
1746614023179,BIBC 102,A01,894320,Staff,0,1,46,46
1746614023179,BIBC 102,A02,894321,Staff,0,0,46,46
1746614023179,BIBC 102,A03,894344,Staff,6,0,46,40
1746614023179,BIBC 102,A04,894345,Staff,27,0,47,20
1746614024209,BICD 100R,A01,894365,Smith; Laurie,0,2,58,58
1746614024209,BICD 100R,A02,894366,Smith; Laurie,0,4,58,58
1746614024209,BICD 100R,A03,894367,Smith; Laurie,0,0,59,59
1746614024209,BICD 100R,A04,959869,Smith; Laurie,38,0,59,21
1746614025246,BICD 136,A01,894383,Gustafson-Brown; Cindy,14,0,50,36
1746614026276,BIEB 102,A01,894494,Butler; Shannon Rhey,51,0,130,79
1746614028348,BIEB 150,A01,894617,Wills; Christopher,3,0,20,17
1746614028348,BIEB 150,A02,894631,Wills; Christopher,3,0,20,17
1746614028348,BIEB 150,A03,894937,Wills; Christopher,3,0,20,17
1746614028348,BIEB 150,A04,894946,Wills; Christopher,5,0,20,15
1746614029379,BIEB 194,A00,906141,Kurle; Carolyn M.,5,0,20,15
1746614030411,BILD 1,A01,894154,Staff,3,0,19,16
1746614030411,BILD 1,A02,894155,Staff,14,0,19,5
1746614030411,BILD 1,A03,894160,Staff,13,0,19,6
1746614030411,BILD 1,A04,894161,Staff,15,0,18,3
1746614031438,BILD 2,A01,894168,Staff,0,0,50,50
1746614031438,BILD 2,A02,894169,Staff,0,0,50,50
1746614031438,BILD 2,A03,894179,Staff,0,0,50,50
1746614031438,BILD 2,A04,894203,Staff,22,0,50,28
1746614032465,BILD 3,A01,894213,Staff,23,0,31,8
1746614032465,BILD 3,A02,894214,Staff,26,0,31,5
1746614032465,BILD 3,A03,894235,Staff,28,0,31,3
1746614032465,BILD 3,A04,894236,Staff,28,0,32,4
1746614033492,BILD 4,A01,894253,Reuther; Keefe,5,0,24,19
1746614033492,BILD 4,A02,894258,Reuther; Keefe,16,0,24,8
1746614034519,BILD 5,A01,894276,Reuther; Keefe,33,0,50,17
1746614034519,BILD 5,A02,894277,Reuther; Keefe,45,0,50,5
1746614034519,BILD 5,A03,894290,Reuther; Keefe,44,0,50,6
1746614034519,BILD 5,A04,894291,Reuther; Keefe,48,0,50,2
1746614035552,BILD 24,A01,894297,Pirino; Giorgia,40,0,60,20
1746614036585,BIMM 100,B01,958915,Staff,71,0,100,29
1746614037613,BIMM 101,A01,895017,McDonnell; Lisa Marie,0,5,24,24
1746614037613,BIMM 101,A02,895018,McDonnell; Lisa Marie,0,5,24,24
1746614037613,BIMM 101,B01,895020,McDonnell; Lisa Marie,0,5,24,24
1746614037613,BIMM 101,B02,895021,McDonnell; Lisa Marie,0,4,24,24
1746614038639,BIMM 110,A01,895023,Staff,1,0,25,24
1746614038639,BIMM 110,A02,895024,Staff,9,0,25,16
1746614038639,BIMM 110,A03,895025,Staff,18,0,25,7
1746614038639,BIMM 110,A04,895031,Staff,20,0,25,5
1746614039667,BIMM 120,A01,895114,Gustafson-Brown; Cindy,14,0,28,14
1746614039667,BIMM 120,A02,895126,Gustafson-Brown; Cindy,21,0,27,6
1746614040696,BIPN 100,A01,895130,Yang; Mingyu,0,0,38,38
1746614040696,BIPN 100,A02,895131,Yang; Mingyu,31,0,38,7
1746614040696,BIPN 100,A03,895132,Yang; Mingyu,32,0,38,6
1746614040696,BIPN 100,A04,895133,Yang; Mingyu,27,0,36,9
1746614041725,BIPN 120,A01,895135,Cooke; James Edward,0,3,13,13
1746614041725,BIPN 120,A02,895136,Cooke; James Edward,0,1,13,13
1746614041725,BIPN 120,A03,895137,Cooke; James Edward,0,3,13,13
1746614041725,BIPN 120,A04,895156,Cooke; James Edward,0,2,11,11
1746614042761,BIPN 134,A01,895235,Cooke; James Edward,0,1,25,25
1746614042761,BIPN 134,A02,895237,Cooke; James Edward,0,0,25,25
1746614042761,BIPN 134,A03,895240,Cooke; James Edward,1,0,25,24
1746614042761,BIPN 134,A04,895270,Cooke; James Edward,20,0,25,5
1746614043788,BIPN 189,A00,892103,Staff,0,14,14,14
1746614045848,BISP 194,A00,958008,Staff,0,2,0,0
1746614046881,CAT 124,A01,922009,Staff,0,5,20,20
1746614047915,CAT 125R,A00,886390,Morales; Celeste Georgianna,0,4,20,20
1746614047915,CAT 125R,B00,886391,Irwin; Matthew Joseph,0,4,20,20
1746614047915,CAT 125R,C00,886392,Smith; Lauryn Alissa,0,2,20,20
1746614047915,CAT 125R,D00,886393,Vanderschuit; Maya Alysia,0,3,20,20
1746614047915,CAT 125R,E00,886394,Marchisotto; Jennifer Anne,0,3,20,20
1746614048946,CENG 15,A01,886218,Drews; Aaron,3,0,8,5
1746614050008,CENG 113,A00,886219,Opatkiewicz; Justin Paul,15,0,25,10
1746614051035,CGS 101,A00,887044,Staff,7,0,20,13
1746614052064,CGS 105,A01,887046,Staff,14,0,25,11
1746614053090,CGS 112,A00,887047,Cuong; Marisol,12,0,15,3
1746614054120,CGS 113,A00,887048,Staff,23,0,30,7
1746614055152,CGS 120,A00,887049,Staff,9,0,17,8
1746614056219,CHEM 6A,A01,886336,Lam; Tin Yiu,38,0,50,12
1746614056219,CHEM 6A,A02,886338,Lam; Tin Yiu,37,0,50,13
1746614057249,CHEM 6B,A01,886341,Hopkins; Patrycja Anna,16,0,50,34
1746614057249,CHEM 6B,A02,886343,Hopkins; Patrycja Anna,42,0,50,8
1746614058277,CHEM 6C,A01,886346,Albizati; Kim F.,0,2,50,50
1746614058277,CHEM 6C,A02,886348,Albizati; Kim F.,24,0,50,26
1746614059306,CHEM 40A,A01,886352,Klosterman; Jeremy K,65,0,100,35
1746614060333,CHEM 40B,A01,886356,Klosterman; Jeremy K,0,24,100,100
1746614061360,CHEM 41B,A01,886360,Theodorakis; Emmanuel,25,0,50,25
1746614061360,CHEM 41B,A02,886362,Theodorakis; Emmanuel,47,0,50,3
1746614062398,CHIN 165A,A00,886382,Xu; Li,18,0,20,2
1746614063431,CLAS 120,A00,886387,Myerston Santana; Jacobo,33,0,40,7
1746614064464,COGS 9,A01,886967,Shannon; Kyle Michael,42,0,60,18
1746614065490,COGS 11,A01,886969,Staff,9,0,30,21
1746614066517,COGS 14A,A01,886971,Staff,5,0,60,55
1746614067547,COGS 14B,A01,886973,Hoffman; Drew Ellen,4,0,60,56
1746614068582,COGS 18,A01,886975,Morgan; Eric,34,0,60,26
1746614069608,COGS 20,A01,886977,Staff,3,0,8,5
1746614069608,COGS 20,A02,886978,Staff,5,0,7,2
1746614070635,COGS 100,A01,907783,Staff,0,1,30,30
1746614071665,COGS 101B,A01,886980,Staff,0,4,48,48
1746614072697,COGS 101C,A01,886982,Delgado; Tania,0,5,44,44
1746614073724,COGS 102A,A01,886984,Johnson; Christine M.,3,0,30,27
1746614074756,COGS 118B,A01,886986,Staff,0,4,88,88
1746614075784,COGS 150,A01,886988,Bergen; Benjamin,22,0,50,28
1746614076819,COGS 153,A00,886989,Delgado; Tania,1,3,41,40
1746614077848,COGS 186,A01,886991,Staff,0,0,32,32
1746614078879,COGS 187A,A01,886993,Boyle; Mary E. T.,7,0,30,23
1746614079908,COGS 189,A00,886994,Staff,0,1,30,30
1746614080943,COMM 10,A01,886996,Staff,0,0,20,21
1746614080943,COMM 10,A02,886997,Staff,10,0,20,10
1746614080943,COMM 10,A03,959845,Staff,19,0,20,1
1746614081977,COMM 20,A01,886999,Leuning; Grant Maurstad,24,0,40,16
1746614084035,COMM 100A,A01,887002,Staff,0,0,20,25
1746614084035,COMM 100A,A02,887003,Staff,5,0,20,15
1746614085085,COMM 100B,A01,887005,Staff,0,8,20,24
1746614086111,COMM 106D,A00,887006,Staff,14,0,40,26
1746614087143,COMM 110G,A00,887007,Whitworth-Smith; Andrew C,12,0,40,28
1746614088174,COMM 111B,A00,887008,Staff,31,0,40,9
1746614089203,COMM 113T,A00,887009,Abuelhiga; Soraya Jill,28,0,40,12
1746614089203,COMM 113T,B00,906733,Staff,39,0,40,1
1746614090235,COMM 145,A00,887010,Staff,13,0,40,27
1746614091262,COMM 146,A00,887054,Staff,32,0,40,8
1746614092288,COMM 190,A00,887012,Staff,8,0,23,15
1746614093315,CSE 8A,A50,887015,Cao; Yingjun,56,0,85,29
1746614094343,CSE 11,A01,887017,Cao; Yingjun,11,0,70,59
1746614095376,CSE 20,A01,887019,Staff,30,0,50,20
1746614096412,CSE 21,A01,887021,Staff,79,0,100,21
1746614096412,CSE 21,B01,892583,Braun; Oliver,45,0,50,5
1746614097444,CSE 30,A01,887025,Eldon; John,142,0,200,58
1746614098470,CSE 100,A01,887027,Staff,26,0,50,24
1746614098470,CSE 100,A02,887028,Staff,42,0,50,8
1746614099510,CSE 101,A01,887030,Braun; Oliver,74,0,100,26
1746614099510,CSE 101,B01,887032,Jones; Miles E,0,3,50,50
1746614099510,CSE 101,B02,887033,Jones; Miles E,0,2,50,50
1746614100538,CSE 105,A01,908084,Jones; Miles E,32,0,50,18
1746614100538,CSE 105,A02,908087,Jones; Miles E,31,0,50,19
1746614101565,CSE 135,A01,887035,Powell; Thomas Allan,0,5,50,50
1746614102597,CSE 142,A01,887037,Staff,7,0,60,53
1746614103629,CSE 142L,A01,887039,Staff,34,0,60,26
1746614104657,CSE 151A,A01,887041,Solares; Edwin A,47,0,100,53
1746614105698,CSE 175,A01,887043,Kumar; Rakesh,30,0,30,0
1746614106731,CSS 1,A01,886389,Staff,0,1,40,40
1746614107760,DSC 30,A01,908097,Liao; Soohyun Nam,47,0,75,28
1746614108789,DSC 40A,A01,908099,Shannon; Kyle Michael,30,0,50,20
1746614109821,DSC 40B,A01,908112,Staff,15,0,50,35
1746614110850,DSC 80,A01,908116,Staff,19,0,60,41
1746614111880,DSC 197,001,956863,Eldridge; Justin Matthew,9999,0,9999,0
1746614112908,ECE 5,A01,886400,Morris; Karcher William,1,0,6,5
1746614112908,ECE 5,A02,886401,Morris; Karcher William,3,0,6,3
1746614113936,ECE 148,A01,886403,Silberman; Jack,0,14,14,14
1746614114989,ECON 1,A01,887265,Crane; Meredith Helen,11,0,70,59
1746614114989,ECON 1,B01,887268,Staff,42,0,50,8
1746614116020,ECON 2,A01,887273,Crane; Meredith Helen,54,0,70,16
1746614117048,ECON 3,A01,887279,Rondina; Giacomo,31,0,70,39
1746614118081,ECON 4,A01,887282,Anderson; John Charles,0,2,10,10
1746614119115,ECON 5,A01,887285,Staff,34,0,45,11
1746614119115,ECON 5,B01,887292,Staff,41,0,45,4
1746614120152,ECON 100A,A01,887337,Newhouse; Herbert S,54,0,70,16
1746614120152,ECON 100A,B01,887349,Staff,45,0,50,5
1746614121186,ECON 100B,A01,887361,Du; Songzi,29,0,70,41
1746614122217,ECON 100C,A01,887445,Newhouse; Herbert S,59,0,70,11
1746614123244,ECON 105,A00,887488,Vespa; Emanuel Ignacio,23,0,35,12
1746614124280,ECON 109,A01,887506,Shishkin; Denis,28,0,35,7
1746614125309,ECON 110A,A01,887568,Alon; Titan Michael,0,2,35,35
1746614125309,ECON 110A,B01,907601,Alon; Titan Michael,20,0,35,15
1746614126337,ECON 110B,A01,887598,Levkoff; Steven B.,0,24,70,70
1746614127369,ECON 112,A00,887599,Rondina; Giacomo,19,0,35,16
1746614128397,ECON 120A,A01,887603,Dai; Yinlin,36,0,70,34
1746614129431,ECON 120C,A01,887608,Sun; Yixiao,0,1,35,35
1746614129431,ECON 120C,B01,887614,Sun; Yixiao,0,0,35,35
1746614130466,ECON 138,A00,887621,Bharadwaj; Prashant,0,21,20,20
1746614131494,ECON 144,A00,958007,Squires; Dale E,11,0,35,24
1746614132529,ECON 171,A01,907666,Staff,18,0,35,17
1746614133557,ECON 175,A00,887626,Wu; Pak Yeung,22,0,35,13
1746614134588,ECON 190,A00,887640,Vespa; Emanuel Ignacio,22,0,35,13
1746614135632,EDS 25,A01,888197,Staff,0,0,0,0
1746614135632,EDS 25,A02,888209,Staff,0,0,0,0
1746614135632,EDS 25,A03,888210,Staff,0,0,0,0
1746614135632,EDS 25,A04,888212,Staff,0,0,0,0
1746614135632,EDS 25,A05,888213,Staff,0,0,0,0
1746614135632,EDS 25,A06,888214,Staff,0,0,0,0
1746614135632,EDS 25,A07,888235,Staff,0,2,0,0
1746614135632,EDS 25,A08,888236,Staff,0,0,0,0
1746614135632,EDS 25,A09,888240,Staff,0,0,0,0
1746614135632,EDS 25,A10,888244,Staff,0,0,0,0
1746614135632,EDS 25,B01,888273,Staff,0,0,0,0
1746614135632,EDS 25,B02,888285,Staff,0,0,0,0
1746614135632,EDS 25,B03,888423,Staff,0,0,0,1
1746614135632,EDS 25,B04,888432,Staff,0,0,0,0
1746614135632,EDS 25,B05,888433,Staff,0,0,0,0
1746614135632,EDS 25,B06,888467,Staff,0,0,0,0
1746614135632,EDS 25,B07,888468,Staff,0,0,0,0
1746614135632,EDS 25,B08,888479,Staff,0,0,0,0
1746614135632,EDS 25,B09,888484,Staff,0,0,0,0
1746614135632,EDS 25,B10,888487,Staff,0,0,0,0
1746614136665,EDS 38,A01,907700,Choi; Bailey Miyeon,30,0,30,0
1746614137690,EDS 112,A01,888601,Chapman; Thandeka K,12,0,40,28
1746614138717,EDS 115,A00,888697,Mendez; Kathrina Mendoza,10,0,30,20
1746614139754,EDS 116,A01,888893,Staff,33,0,40,7
1746614141817,EDS 124AR,A00,889133,Staff,29,0,50,21
1746614141817,EDS 124AR,B00,907471,Simon; Elizabeth A,37,0,50,13
1746614142845,EDS 124BR,A00,889134,Simon; Elizabeth A,44,0,100,56
1746614143872,EDS 125,A00,889135,Staff,25,0,30,5
1746614144900,EDS 126,A01,889138,Staff,35,0,40,5
1746614145944,EDS 164R,A01,889142,Wishard Guerra; Alison G.,32,0,50,18
1746614146971,ENG 30,A01,886396,Staff,0,0,0,0
1746614146971,ENG 30,B01,886398,Staff,0,0,0,0
1746614148003,ENVR 102,A00,906150,Montejo; Carolina,23,0,25,2
1746614149038,ETHN 103A,A00,887236,Man; Simeon S,0,2,0,0
1746614150066,ETHN 113,A00,887239,Staff,16,0,30,14
1746614151090,ETHN 116,A00,887240,Staff,16,0,25,9
1746614152120,ETHN 117,A00,887241,Choi; Esther Min,28,0,30,2
1746614153148,ETHN 118,A00,887243,Staff,24,0,30,6
1746614154177,ETHN 127,A00,887248,Cuong; Marisol,11,0,15,4
1746614155209,ETHN 139,A00,887250,Staff,7,0,10,3
1746614156238,ETHN 142,A00,887252,Staff,9,0,30,21
1746614157273,ETHN 161,A00,887253,Browne; Errol Tsekani,24,0,30,6
1746614158298,ETHN 163FR,A00,887255,Burelle; Julie Sara Veronique,0,0,5,5
1746614159337,GLBH 20,A00,889149,Elwardani; Nile Regina,8,0,42,34
1746614161392,GLBH 111,A01,889152,Burgos; Jose L.,17,0,17,0
1746614162423,GLBH 150,A00,889181,Sloane; Julia Kathryn,0,5,15,15
1746614164477,HDS 60,A01,886406,Warstadt; Melissa Fawn,72,0,80,8
1746614165506,HIAF 111,A00,889324,Gyamfi; Bright,25,0,32,7
1746614166533,HIEA 131,A00,889328,Staff,15,0,32,17
1746614167566,HIEA 144,A00,889333,Henry; Todd A.,26,0,32,6
1746614168593,HIEA 154,A00,889336,Henry; Todd A.,24,0,32,8
1746614169620,HIEU 106,A00,889339,Staff,22,0,32,10
1746614171686,HIEU 114,A00,889340,Staff,4,0,32,28
1746614172718,HIEU 135GS,A00,889342,Patterson; Patrick H.,0,0,1,24
1746614173745,HIEU 137,A00,889343,Edington; Claire Ellen,10,0,25,15
1746614174773,HIEU 148,A00,889345,Staff,14,0,32,18
1746614175803,HIEU 154,A00,889346,Biess; Frank Peter,21,0,32,11
1746614176835,HILA 102,A00,889351,Staff,12,0,32,20
1746614177863,HILD 2A,A01,889221,Lewandoski; Julia Mavis,0,8,32,32
1746614178896,HILD 7B,A01,889225,Man; Simeon S,0,12,32,32
1746614179929,HILD 7C,A01,889288,Alvarez; Luis A,0,14,32,32
1746614180960,HILD 30,A01,889323,Staff,0,5,32,32
1746614183017,HISC 119,A00,889383,Golan; Tal,20,0,32,12
1746614184045,HIUS 103,A00,889384,Man; Simeon S,0,0,32,32
1746614185074,HIUS 117,A00,919797,Kwak; Nancy,18,0,32,14
1746614186102,HIUS 142A,A00,919788,Staff,22,0,32,10
1746614188159,HIUS 149,A00,889386,Gyamfi; Bright,26,0,32,6
1746614189190,HIUS 155,A00,889387,Alvarez; Luis A,15,0,32,17
1746614190225,HUM 3,A01,886499,Caldwell; Michael Alan,19,0,50,31
1746614191255,HUM 3GS,A00,886500,Rodriguez; Bretton Sigfred,0,0,0,28
1746614192281,HUM 3R,A01,886502,Markman; Kristina,0,36,50,50
1746614193311,HUM 4,A01,886504,Crum; Matthew Stephen,23,0,50,27
1746614193311,HUM 4,B01,886506,West; Geoffrey Scott,17,0,50,33
1746614194341,HUM 4GS,A00,886507,Staff,0,0,0,19
1746614195371,HUM 5,A01,886509,Staff,31,0,50,19
1746614196398,HUM 5R,A01,886511,Zavodny; Tatiana Sophia,0,39,50,50
1746614197428,JAPN 180,A00,886407,Staff,16,0,40,24
1746614198472,LATI 50,A01,886409,Martin-Cabrera; Luis,3,0,22,19
1746614198472,LATI 50,A02,886410,Martin-Cabrera; Luis,19,0,22,3
1746614198472,LATI 50,A03,886411,Martin-Cabrera; Luis,21,0,22,1
1746614198472,LATI 50,A04,886412,Martin-Cabrera; Luis,8,0,22,14
1746614199505,LAWS 101,A00,907664,Staff,28,0,60,32
1746614200532,LIAB 1A,A00,889388,Saab; Dima,17,0,20,3
1746614201564,LIAB 1AX,A00,889389,El Cheddadi; Youniss,18,0,20,2
1746614202596,LIFR 1C,A00,889391,Van Moer; Vinciane G,8,0,20,12
1746614203626,LIFR 1CX,A00,889392,Van Moer; Vinciane G,7,0,20,13
1746614204651,LIFR 1D,A00,889393,Van Moer; Vinciane G,7,0,20,13
1746614205682,LIFR 1DX,A00,889394,Van Moer; Vinciane G,8,0,20,12
1746614206711,LIGN 7,A00,886923,Staff,25,0,50,25
1746614207744,LIGN 17,A00,886924,Kehler; Andrew Scott,126,0,150,24
1746614208770,LTAM 110,A00,889395,Staff,15,0,30,15
1746614209796,LTAM 110GS,A00,958010,Rodriguez; Bretton Sigfred,0,0,0,28
1746614210828,LTCH 101,A00,889397,Staff,23,0,25,2
1746614211857,LTCS 130,A00,889398,Staff,23,0,25,2
1746614212882,LTEA 138,A00,889399,Staff,24,0,40,16
1746614213915,LTEN 149,A00,889400,Wesling; Megan E.,0,3,25,25
1746614214949,LTEN 169,A00,889401,Staff,20,0,25,5
1746614215976,LTEN 180,A00,889402,Staff,10,0,15,5
1746614217005,LTEN 181,A00,889403,Staff,21,0,25,4
1746614218035,LTWL 100,A00,889404,Myerston Santana; Jacobo,2,0,25,23
1746614219063,LTWL 180GS,A00,889405,Staff,0,0,20,20
1746614220088,LTWL 181,A00,889406,Staff,16,0,25,9
1746614221117,LTWL 184,A00,889475,Mukherjee; Silpa,22,0,25,3
1746614222151,LTWR 102C,A00,889486,Staff,29,0,30,1
1746614223180,LTWR 115W,A00,889491,Staff,0,2,15,15
1746614224207,MAE 8,A01,886905,Staff,0,2,0,0
1746614225234,MAE 11,A00,886906,Bandaru; Prabhakar,0,7,50,50
1746614226261,MAE 20,A00,886907,Evdokimenko; Ekaterina,43,0,70,27
1746614227294,MAE 30B,A00,886909,Ghazinejad; Maziar,25,0,45,20
1746614228321,MAE 101B,A00,886910,Saintillan; David,30,0,45,15
1746614229347,MAE 105,A00,886911,Bandaru; Prabhakar,18,0,50,32
1746614230380,MAE 107,B00,958024,Staff,7,0,50,43
1746614231408,MAE 143B,A00,886913,Bewley; Thomas R,2,0,40,38
1746614232442,MAE 148,A01,886915,Silberman; Jack,0,3,14,14
1746614233470,MAE 160,A00,886916,Evdokimenko; Ekaterina,30,0,60,30
1746614234506,MATH 3C,A01,889681,Staff,0,2,30,30
1746614234506,MATH 3C,A02,960048,Staff,23,0,30,7
1746614235538,MATH 10A,A01,889760,Staff,26,0,30,4
1746614235538,MATH 10A,A02,889783,Staff,29,0,30,1
1746614236575,MATH 10B,A01,889785,Verstraete; Jacques Allan,1,0,35,34
1746614236575,MATH 10B,A02,889795,Verstraete; Jacques Allan,4,0,35,31
1746614236575,MATH 10B,B01,889797,Verstraete; Jacques Allan,3,0,35,32
1746614236575,MATH 10B,B02,889828,Verstraete; Jacques Allan,3,0,35,32
1746614237617,MATH 10C,A01,889849,Habib; Yousaf,8,0,30,22
1746614237617,MATH 10C,A02,889852,Habib; Yousaf,14,0,30,16
1746614237617,MATH 10C,A03,889853,Habib; Yousaf,22,0,30,8
1746614237617,MATH 10C,A04,889858,Habib; Yousaf,20,0,30,10
1746614237617,MATH 10C,B01,889861,Staff,1,0,30,29
1746614237617,MATH 10C,B02,889862,Staff,24,0,30,6
1746614237617,MATH 10C,B03,889863,Staff,27,0,30,3
1746614237617,MATH 10C,B04,889967,Staff,23,0,30,7
1746614238648,MATH 18,A01,889974,Staff,6,0,30,24
1746614238648,MATH 18,A02,889977,Staff,20,0,30,10
1746614238648,MATH 18,B01,889984,Hardiman; Liam,20,0,30,10
1746614238648,MATH 18,B02,889985,Hardiman; Liam,25,0,30,5
1746614239675,MATH 20A,A01,889990,Suk; Andrew Hoon,30,0,35,5
1746614240703,MATH 20B,A01,889993,Ohm; Ko Woon,21,0,30,9
1746614240703,MATH 20B,A02,889994,Ohm; Ko Woon,30,0,30,0
1746614240703,MATH 20B,B01,889996,Ohm; Ko Woon,22,0,30,8
1746614240703,MATH 20B,B02,889997,Ohm; Ko Woon,23,0,30,7
1746614241743,MATH 20C,A01,889999,Hammock; Frances H,17,0,30,13
1746614241743,MATH 20C,A02,890003,Hammock; Frances H,23,0,30,7
1746614241743,MATH 20C,B01,890006,Hammock; Frances H,2,0,30,28
1746614241743,MATH 20C,B02,890007,Hammock; Frances H,11,0,30,19
1746614242771,MATH 20D,A01,890011,Cheng; Hsiao-Bing,1,0,30,29
1746614242771,MATH 20D,A02,890012,Cheng; Hsiao-Bing,14,0,30,16
1746614242771,MATH 20D,B01,890016,Cheng; Hsiao-Bing,13,0,30,17
1746614242771,MATH 20D,B02,890017,Cheng; Hsiao-Bing,13,0,30,17
1746614243802,MATH 20E,A01,890026,Harel; Guershon,1,0,30,29
1746614243802,MATH 20E,A02,890029,Harel; Guershon,22,0,30,8
1746614243802,MATH 20E,B01,890033,Harel; Guershon,7,0,30,23
1746614243802,MATH 20E,B02,890101,Harel; Guershon,21,0,30,9
1746614244827,MATH 102,A01,890104,Staff,18,0,30,12
1746614244827,MATH 102,A02,890105,Staff,27,0,30,3
1746614245854,MATH 103B,A01,890116,Salehi Golsefidy; Alireza,3,0,30,27
1746614245854,MATH 103B,B01,890118,Staff,0,3,34,34
1746614246891,MATH 109,A01,890121,Aliabadi Sr.; Mohsen,0,0,30,30
1746614246891,MATH 109,B01,890124,Upadrashta; Pranav Kumar,18,0,30,12
1746614247917,MATH 120A,A01,890126,Eggers; John Dietrich,13,0,30,17
1746614248948,MATH 142B,A01,890128,Ioana; Adrian,19,0,30,11
1746614248948,MATH 142B,A02,890129,Ioana; Adrian,12,0,30,18
1746614250002,MATH 154,A01,890174,Staff,0,1,30,30
1746614250002,MATH 154,A02,890182,Staff,0,0,30,30
1746614251031,MATH 168A,A01,890197,Dumitriu; Ioana,21,0,35,14
1746614252069,MATH 170A,A01,890240,Nie; Jiawang,1,0,30,29
1746614252069,MATH 170A,A02,890241,Nie; Jiawang,11,0,30,19
1746614252069,MATH 170A,A03,890249,Nie; Jiawang,23,0,30,7
1746614253097,MATH 170B,A01,957891,Nag; Panchali,13,0,35,22
1746614255168,MATH 181A,A01,908025,Staff,0,3,35,35
1746614255168,MATH 181A,A02,960115,Staff,26,0,35,9
1746614256202,MATH 181B,A01,959874,Staff,24,0,30,6
1746614257230,MATH 193B,A01,890265,Staff,0,4,35,35
1746614258262,MGT 4,A01,890311,Anderson; John Charles,42,0,88,46
1746614259293,MGT 5,A00,907740,Staff,12,0,98,86
1746614260317,MGT 12,A00,890312,Lindenberger; Wade Douglas,67,0,98,31
1746614261345,MGT 16,A00,957883,Staff,78,0,98,20
1746614263400,MGT 45,A00,890314,Pecore; Joseph P.,45,0,98,53
1746614264428,MGT 71,A00,890315,Staff,0,12,98,98
1746614265456,MGT 100,A00,890316,Yavorsky; Daniel Ryan,44,0,98,54
1746614266488,MGT 103,A00,890317,Ehrich; Kristine R,73,0,98,25
1746614267516,MGT 105,A00,890356,Bates; Kenneth Walter,0,8,98,98
1746614268547,MGT 112,A00,890360,Ehrich; Kristine R,55,0,98,43
1746614269582,MGT 127R,A00,907732,Zhu; Kevin Xiaoguo,23,0,98,75
1746614270608,MGT 131B,A00,890361,Anderson; John Charles,59,0,98,39
1746614271638,MGT 137,A00,890362,Lindenberger; Wade Douglas,65,0,98,33
1746614272670,MGT 160,A00,890369,Johnson; Erik Barry,9,0,98,89
1746614274731,MGT 164,A00,890372,Zimmermann; Carsten,0,40,98,98
1746614275759,MGT 180,A00,890374,Bliss; Barbara Ann,11,0,98,87
1746614276790,MMW 15,A01,886414,Chang; Edmond Yi-Teh,0,12,28,28
1746614276790,MMW 15,A02,886415,Chang; Edmond Yi-Teh,0,8,28,28
1746614276790,MMW 15,A03,886416,Chang; Edmond Yi-Teh,0,9,28,28
1746614276790,MMW 15,A04,886417,Chang; Edmond Yi-Teh,0,8,28,28
1746614276790,MMW 15,B01,886419,Chang; Edmond Yi-Teh,0,7,28,28
1746614276790,MMW 15,B02,886420,Chang; Edmond Yi-Teh,0,7,28,28
1746614276790,MMW 15,B03,886421,Chang; Edmond Yi-Teh,0,7,28,28
1746614276790,MMW 15,B04,886422,Chang; Edmond Yi-Teh,0,8,28,28
1746614276790,MMW 15,C01,886424,Staff,0,9,28,28
1746614276790,MMW 15,C02,886425,Staff,0,8,28,28
1746614276790,MMW 15,C03,886426,Staff,0,8,28,28
1746614276790,MMW 15,C04,886427,Staff,0,8,28,28
1746614276790,MMW 15,C05,958038,Staff,0,8,28,28
1746614276790,MMW 15,C06,958039,Staff,0,7,28,28
1746614277825,MMW 15GS,A00,906910,Patterson; Patrick H.,4,0,28,24
1746614278854,MMW 122R,A01,886429,Rahimi; Babak,0,13,28,28
1746614278854,MMW 122R,A02,886430,Rahimi; Babak,0,12,28,28
1746614278854,MMW 122R,A03,958040,Rahimi; Babak,0,11,28,28
1746614279895,MUS 1A,A01,890937,Staff,2,0,25,23
1746614279895,MUS 1A,A02,891035,Staff,6,0,25,19
1746614279895,MUS 1A,C01,958912,Staff,24,0,25,1
1746614279895,MUS 1A,C02,958913,Staff,25,0,25,0
1746614281955,MUS 2AK,A00,957092,Ohnishi; Takae,15,0,15,0
1746614283002,MUS 4,A01,891044,Staff,0,0,25,25
1746614283002,MUS 4,A02,891045,Staff,22,0,25,3
1746614283002,MUS 4,B01,891048,Staff,17,0,25,8
1746614283002,MUS 4,B02,891050,Staff,25,0,25,0
1746614284033,MUS 5,A01,957506,Dubnov; Shlomo,0,0,25,25
1746614284033,MUS 5,A02,957622,Dubnov; Shlomo,12,0,25,13
1746614284033,MUS 5,A03,957623,Dubnov; Shlomo,20,0,25,5
1746614285060,MUS 6,A01,891053,Freitas Caetano; Marcelo,24,0,25,1
1746614285060,MUS 6,A02,891054,Freitas Caetano; Marcelo,23,0,25,2
1746614286094,MUS 7,A01,891081,Staff,0,0,25,25
1746614286094,MUS 7,A02,891082,Staff,3,0,25,22
1746614287124,MUS 8GS,A00,891118,Borgo; David Garcia,1,0,25,24
1746614288150,MUS 11,A01,891140,Staff,8,0,25,17
1746614288150,MUS 11,A02,891141,Staff,21,0,25,4
1746614289181,MUS 13,A01,891143,Staff,8,0,25,17
1746614289181,MUS 13,A02,891144,Staff,24,0,25,1
1746614290208,MUS 15,A01,891146,Staff,9,0,25,16
1746614290208,MUS 15,A02,891148,Staff,21,0,25,4
1746614290208,MUS 15,B01,891150,Staff,18,0,25,7
1746614290208,MUS 15,B02,891151,Staff,25,0,25,0
1746614291234,MUS 20,A01,891153,Staff,5,0,20,15
1746614291234,MUS 20,A02,891155,Staff,14,0,20,6
1746614292267,MUS 80,A00,891156,Staff,19,0,25,6
1746614292267,MUS 80,B00,891157,Staff,23,0,25,2
1746614293293,MUS 130,A00,891158,Ohnishi; Takae,35,0,35,0
1746614294322,MUS 150GS,A01,891160,Borgo; David Garcia,1,0,25,24
1746614295350,MUS 170,A01,891162,Freitas Caetano; Marcelo,20,0,25,5
1746614295350,MUS 170,A02,891164,Freitas Caetano; Marcelo,21,0,25,4
1746614296385,NANO 11,A00,886220,Vazquez Mena; Oscar,13,0,15,2
1746614297412,NANO 15,A01,886222,Drews; Aaron,4,0,7,3
1746614298442,NANO 104,A00,886224,Sirbuly; Donald,17,0,25,8
1746614299473,PH 40,A00,886528,Staff,23,0,40,17
1746614300502,PH 45,A01,886799,Staff,35,0,40,5
1746614301530,PH 110,A00,886802,Staff,0,6,40,40
1746614302558,PH 172,A00,906716,Staff,19,0,35,16
1746614303584,PH 191,A00,886803,Staff,6,0,40,34
1746614304618,PHIL 1,A00,889500,Staff,20,0,30,10
1746614305656,PHIL 10,A01,889549,Grush; Rick Scott,16,0,22,6
1746614305656,PHIL 10,A02,889551,Grush; Rick Scott,22,0,22,0
1746614306692,PHIL 28,A01,889559,Lamey; Andy M.,0,2,31,31
1746614306692,PHIL 28,A02,889561,Lamey; Andy M.,0,1,30,30
1746614306692,PHIL 28,A03,889572,Lamey; Andy M.,0,1,30,30
1746614307720,PHIL 35,A00,907839,Staff,13,0,15,2
1746614308745,PHIL 60,A00,889574,Staff,73,0,90,17
1746614309773,PHIL 101,A00,958004,Staff,12,0,15,3
1746614311831,PHIL 136,A00,889582,Fulkerson; Matthew Todd,26,0,45,19
1746614312867,PHIL 163,A01,889601,Staff,21,0,30,9
1746614312867,PHIL 163,B01,889606,Brandt; Reuven A,0,3,0,0
1746614313893,PHIL 164,A00,889610,Staff,16,0,30,14
1746614314920,PHIL 165,A00,889613,Staff,22,0,30,8
1746614315953,PHYS 1A,A00,886431,Staff,30,0,70,40
1746614316981,PHYS 1AL,001,886432,Tsai; Philbert S,0,1,30,30
1746614316981,PHYS 1AL,002,886436,Tsai; Philbert S,13,0,30,17
1746614318012,PHYS 1B,A00,886439,Staff,184,0,240,56
1746614319040,PHYS 1BL,001,886441,Tsai; Philbert S,0,4,30,30
1746614319040,PHYS 1BL,002,886444,Tsai; Philbert S,2,0,30,28
1746614320077,PHYS 1C,A00,896092,Arnold; Kam S,78,0,146,68
1746614321107,PHYS 1CL,001,886448,Tsai; Philbert S,0,1,30,30
1746614321107,PHYS 1CL,002,886449,Tsai; Philbert S,1,0,30,29
1746614321107,PHYS 1CL,003,886450,Tsai; Philbert S,16,0,30,14
1746614321107,PHYS 1CL,004,886451,Tsai; Philbert S,15,0,30,15
1746614322135,PHYS 2B,A01,886457,Staff,67,0,115,48
1746614323163,PHYS 2C,A01,886460,Shotwell; Brian,0,9,65,65
1746614324198,PHYS 2CL,A01,886467,Staff,0,4,28,28
1746614324198,PHYS 2CL,A02,886468,Staff,0,3,28,28
1746614325225,PHYS 2D,A01,886470,Staff,10,0,50,40
1746614326254,PHYS 4B,A01,886475,Grinstein; Benjamin,22,0,40,18
1746614327286,POLI 5,A00,891173,Desposato; Scott,7,0,25,18
1746614328314,POLI 5D,A01,891175,Staff,5,0,5,0
1746614328314,POLI 5D,B01,891178,Staff,5,0,5,0
1746614329353,POLI 11,A00,891179,Ferree; Karen E,0,0,35,35
1746614330383,POLI 12,A00,891180,Staff,15,0,30,15
1746614331410,POLI 27,A01,891182,Staff,11,0,75,64
1746614332438,POLI 30,A00,891183,Staff,8,0,50,42
1746614333467,POLI 100B,A00,891244,Staff,5,1,35,30
1746614334498,POLI 100I,A00,891247,Staff,7,0,30,23
1746614335525,POLI 104J,A00,891248,Nichter; Maysa,14,0,30,16
1746614336555,POLI 104U,A00,891250,Nichter; Maysa,1,0,30,29
1746614338610,POLI 110B,A00,891255,Wiens; David,19,0,25,6
1746614339641,POLI 112A,A00,891256,Wiens; David,6,0,25,19
1746614340669,POLI 114BR,A00,891261,Staff,19,0,30,11
1746614341701,POLI 117R,A00,891262,Forman; Fonna,0,6,50,50
1746614342734,POLI 118,A00,891264,Ingham; Sean,17,0,25,8
1746614343764,POLI 124A,A00,891265,Staff,18,0,20,2
1746614344799,POLI 125D,A00,891266,Nichter; Simeon C,2,0,25,23
1746614345825,POLI 126,A00,891268,Nichter; Simeon C,7,0,25,18
1746614346853,POLI 126AA,A00,891272,Staff,15,0,25,10
1746614347879,POLI 130AA,A00,891273,Staff,15,0,20,5
1746614348905,POLI 134AA,A00,891274,Staff,4,0,20,16
1746614350963,POLI 138,A00,891278,Staff,21,0,25,4
1746614351991,POLI 142K,A00,891280,Staff,10,0,25,15
1746614353018,POLI 142M,A00,891281,Gartzke; Erik,16,0,30,14
1746614354046,POLI 142P,A00,891284,Staff,20,0,30,10
1746614355074,POLI 143,A00,891285,Gartzke; Erik,12,0,30,18
1746614356104,POLI 153,A00,891286,Staff,19,0,20,1
1746614358162,POLI 175,A00,891290,Staff,15,0,20,5
1746614359199,PSYC 1,A00,890674,Steiner; Eric Tomas,0,11,45,45
1746614360233,PSYC 2,A00,890676,Albright; Thomas D,20,0,35,15
1746614361262,PSYC 3,A00,890679,Staff,17,0,20,3
1746614362291,PSYC 6,A00,959858,Staff,19,0,20,1
1746614363323,PSYC 60,A01,890684,Rickard; Timothy C.,0,6,45,45
1746614364357,PSYC 70,A01,890689,Geller; Emma Harlan,6,0,30,24
1746614365385,PSYC 71,A01,959860,Staff,21,0,25,4
1746614366418,PSYC 100,A00,890690,Lacefield; Katharine I,0,50,180,180
1746614367452,PSYC 102,A00,890695,Staff,18,0,40,22
1746614368479,PSYC 105,A00,890699,Geller; Emma Harlan,70,0,100,30
1746614369506,PSYC 106,A00,890701,Gorman; Michael R.,5,0,30,25
1746614370541,PSYC 108,A00,890704,Adrian; Julia Anna,0,29,50,50
1746614371571,PSYC 118,A01,890712,Staff,11,0,30,19
1746614372605,PSYC 124,A00,890716,Chapman; Eddie Nathaniel,25,0,60,35
1746614373637,PSYC 131,A00,890717,Anagnostaras; Stephan,0,7,80,80
1746614374669,PSYC 137,A00,890719,Winkielman; Piotr,0,11,30,30
1746614375701,PSYC 144,A00,890721,Adrian; Julia Anna,0,9,45,45
1746614376735,PSYC 162,A00,890805,Staff,0,2,75,75
1746614377761,PSYC 169,A00,890810,Staff,0,15,30,30
1746614378788,PSYC 172,A00,890814,Gorman; Michael R.,9,0,30,21
1746614379820,PSYC 181,A00,890818,Anagnostaras; Stephan,6,0,200,194
1746614380848,PSYC 184,A00,959861,Staff,160,0,175,15
1746614381874,PSYC 189,A00,890823,Staff,0,2,30,30
1746614382907,PSYC 191,A00,890884,Rickard; Timothy C.,0,12,35,35
1746614383933,PSYC 193,A00,890913,Staff,19,0,30,11
1746614383933,PSYC 193,B00,890914,Chapman; Eddie Nathaniel,24,0,30,6
1746614384961,PSYC 193L,A01,890918,Lowe; Angela Beth,20,0,30,10
1746614384961,PSYC 193L,B01,890921,Hurwitz; Ethan Scott,20,0,30,10
1746614384961,PSYC 193L,C01,890928,Staff,30,0,30,0
1746614385993,RELI 149,A00,886806,Rahimi; Babak,23,0,40,17
1746614387020,SE 9,A01,886814,Staff,7,0,20,13
1746614388049,SE 101B,A01,886816,Chadha; Mayank,3,0,35,32
1746614389077,SE 110B,A00,886818,Zhu; Qiang,4,0,75,71
1746614390107,SE 125,A01,886830,Staff,10,0,30,20
1746614391137,SE 130B,A01,886835,Staff,14,0,40,26
1746614392172,SE 131A,A01,886838,Krysl; Petr,34,0,55,21
1746614393198,SE 154,A00,886840,Staff,28,0,50,22
1746614394225,SE 164GS,A01,886849,Staff,6,0,20,14
1746614395251,SE 167GS,A01,886853,Staff,6,0,20,14
1746614396286,SIO 25,A01,890107,Staff,19,0,30,11
1746614397313,SIO 45,A00,890109,Cook; Geoffrey W,114,0,200,86
1746614398345,SIO 109R,A00,890110,Forman; Fonna,0,16,20,20
1746614399380,SIO 187,A01,890114,Kacev; David,15,0,40,25
1746614400411,SOCI 1,A01,890431,Thorpe; Charles Robert,14,0,30,16
1746614400411,SOCI 1,A02,890518,Thorpe; Charles Robert,30,0,30,0
1746614401442,SOCI 2,A01,957978,Staff,25,0,25,0
1746614401442,SOCI 2,A02,957979,Staff,23,0,25,2
1746614402477,SOCI 20,A01,890523,Calderon-Zaks; Michael Aar,21,0,30,9
1746614402477,SOCI 20,A02,890526,Calderon-Zaks; Michael Aar,29,0,30,1
1746614403514,SOCI 30,A01,890533,Pardo Guerra; Juan Pablo,37,0,40,3
1746614404543,SOCI 40,A01,890535,Staff,27,0,45,18
1746614405575,SOCI 104Q,A00,890559,Staff,17,0,30,13
1746614406605,SOCI 106,A00,890560,Arnal; Maud Marie Leonie,20,0,30,10
1746614407637,SOCI 110,A00,890567,Holkenbrink-Monk; Charlene,19,0,30,11
1746614408668,SOCI 112,A00,890568,Victoria Torres; Pablo,2,0,55,53
1746614409695,SOCI 115,A00,890597,Arnal; Maud Marie Leonie,28,0,45,17
1746614411786,SOCI 121,A00,890604,Pardo Guerra; Juan Pablo,38,0,45,7
1746614412815,SOCI 126,A01,890608,Staff,8,0,10,2
1746614413841,SOCI 127,A00,890609,Staff,18,0,30,12
1746614414875,SOCI 131,A00,890610,Thorpe; Charles Robert,37,0,45,8
1746614415907,SOCI 135,A00,890615,Payne; Christine Anna,14,0,45,31
1746614416935,SOCI 139,A00,890620,Staff,38,0,45,7
1746614417963,SOCI 148E,A00,890622,Calderon-Zaks; Michael Aar,36,0,45,9
1746614418993,SOCI 150,A00,890623,Kohler; Kristopher M.,31,0,45,14
1746614420029,SOCI 157,A00,890625,Jules-Rosette; Bennetta W.,18,0,20,2
1746614421056,SOCI 160,A00,890627,Payne; Christine Anna,21,0,45,24
1746614422087,SYN 1,A00,886855,Fish; Gwendolyn Anne,0,1,0,0
1746614422087,SYN 1,B00,906086,Fish; Gwendolyn Anne,0,2,0,2
1746614423123,SYN 2R,A00,886860,Staff,0,17,15,15
1746614423123,SYN 2R,B00,906106,Atkinson; Arthur Laird,0,16,15,15
1746614424156,SYN 100,A01,886866,Browne; Emily,0,28,20,20
1746614424156,SYN 100,B01,906128,Rock; Martin,0,4,20,20
1746614424156,SYN 100,C01,906140,Deavenport; James Cary,0,4,20,20
1746614424156,SYN 100,D01,907816,Deavenport; James Cary,0,5,20,20
1746614425193,TDAC 1,A00,890286,Walsh; Kim C.,7,0,20,13
1746614426227,TDAC 101,A00,890296,Basso; Beatrice,15,0,20,5
1746614427253,TDDE 131,A00,890297,Staff,47,0,50,3
1746614428285,TDDM 1,A00,890287,Weinberg; Sadie,25,0,30,5
1746614429326,TDGE 11,A00,890288,Fulton; Julia,138,0,200,62
1746614429326,TDGE 11,B00,890289,Castro; Robert Jess,184,0,200,16
1746614430354,TDGE 25,B00,957359,Walsh; Kim C.,5,0,20,15
1746614431385,TDGE 40,A01,890292,Power; Jade Yukana,26,0,30,4
1746614432413,TDGE 124,A00,890298,Havis; Allan,0,2,50,50
1746614433439,TDGE 131R,A00,890299,Burelle; Julie Sara Veronique,15,0,42,27
1746614434465,TDHT 101,A00,890300,Staff,10,0,20,10
1746614435495,TDHT 109,A01,890302,Anderson; Mysia Anyse,31,0,40,9
1746614436522,TDMV 1,A00,890293,Arcidiacono; Kristin,18,0,30,12
1746614437550,TDMV 2,A00,890294,Weinberg; Sadie,23,0,30,7
1746614438580,TDMV 3,A00,957878,Arcidiacono; Kristin,28,0,30,2
1746614440638,TDMV 138,A00,890304,Jun; Grace Shin Hae,25,0,40,15
1746614441668,TDMV 140,A00,890305,Corrales; Joseph Bernales,25,0,30,5
1746614442695,TDMV 142,A00,890307,Caligagan; Tony,32,0,40,8
1746614443727,TDMV 144,A00,890308,Camaya; Michelle Ann,25,0,30,5
1746614444756,TDPW 1,A00,890295,Stein; Deborah Isobel,3,0,20,17
1746614445783,USP 2,A01,890272,Lerner; Amy M,7,0,20,13
1746614446810,USP 3,A01,890274,Staff,12,0,30,18
1746614447840,USP 15,A01,890276,Sun; Feiyang,16,0,30,14
1746614448872,USP 25,A00,890277,Shenkman; Michael Thomas,18,0,25,7
1746614449903,USP 138,A00,890278,Staff,13,0,25,12
1746614450930,USP 143,A00,890279,Staff,21,0,70,49
1746614451963,USP 144,A00,890280,Chowdhury; Muhammed Zohir,16,0,30,14
1746614452990,USP 150,A00,890281,Boomhower; Matthew Charles,4,0,30,26
1746614454018,USP 151,A00,890282,Staff,16,0,20,4
1746614455050,USP 162,A00,890283,Andrews; Abigail Leslie,16,0,20,4
1746614456083,USP 168,A00,920477,Kwak; Nancy,0,0,5,5
1746614457175,USP 181,A00,890284,Staff,3,0,20,17
1746614458202,USP 191A,A00,890285,Staff,12,0,20,8
1746614459235,VIS 101,A00,886512,Staff,26,0,75,49
1746614460264,VIS 103,A00,886513,Cruz; Edwin Teddy,61,0,75,14
1746614461294,VIS 108,A00,886514,Staff,4,0,15,11
1746614462320,VIS 127P,A00,886515,Shen; Kuiyi,80,0,146,66
1746614463348,VIS 149,A00,886516,Yoldas; Pinar,0,0,15,15
1746614464384,VIS 164,A00,886526,Erdmann; Dean,19,0,22,3
1746614465411,VIS 194S,A00,886527,Staff,61,0,75,14
1746614466442,WCWP 10A,C00,886484,Martiniuk; Jill,12,0,15,3
1746614467477,WCWP 10B,A00,886490,Uriarte; Emma,0,0,15,15
1746614467477,WCWP 10B,B00,886491,Dhir; Simrita,8,0,15,7
1746614467477,WCWP 10B,C00,886492,Ornelas; Tricia,0,0,15,15
1746614468506,WCWP 100,A00,886494,Young; Mark T,0,6,15,15
1746614470713,AAS 10,A01,886199,Childs; Dennis R.,0,3,0,0
1746614471742,ANAR 104,A01,886940,Shtienberg; Gilad,27,0,30,3
1746614472770,ANAR 120,A00,886953,Staff,13,0,20,7
1746614473797,ANBI 148,A01,886955,Wilder; Linnea Lorene,30,0,40,10
1746614475859,ANSC 122,A00,886957,Staff,24,0,30,6
1746614476886,ANSC 150,A00,886958,Sloane; Julia Kathryn,2,0,15,13
1746614477917,ANSC 156,A00,886959,Jenkins; Janis A.,0,1,15,15
1746614478947,ANSC 180,A00,886960,Staff,11,0,17,6
1746614479975,ANSC 188,A00,886961,Jassal; Aftab,9,0,25,16
1746614481008,ANSC 190,A00,886962,Jassal; Aftab,14,0,25,11
1746614482034,ANSC 191,A00,886963,Staff,18,0,20,2
1746614483061,ANTH 3,A01,891689,Staff,17,0,20,3
1746614484089,ANTH 5,A00,886933,Semendeferi; Ekaterini,16,0,20,4
1746614485115,ANTH 10,A00,886934,Staff,0,12,30,30
1746614486144,ANTH 21,A01,886936,Staff,41,0,60,19
1746614487171,ANTH 23,A01,886938,Staff,92,0,100,8
1746614488200,ANTH 105,A00,886964,Stewart; Alexander B,84,0,100,16
1746614489234,ANTH 108,A00,886965,Pedersen; David,9,0,20,11
1746614490263,AWP 10,001,886147,Staff,0,0,0,0
1746614490263,AWP 10,002,886148,Staff,0,0,0,0
1746614490263,AWP 10,003,886149,Staff,0,0,0,0
1746614490263,AWP 10,004,886150,Staff,0,0,0,0
1746614490263,AWP 10,005,886151,Staff,0,0,0,0
1746614490263,AWP 10,006,886152,Staff,0,0,0,0
1746614490263,AWP 10,007,886153,Staff,0,0,0,0
1746614490263,AWP 10,008,886154,Staff,0,0,0,0
1746614490263,AWP 10,009,886155,Staff,0,0,0,0
1746614490263,AWP 10,010,886156,Staff,0,0,0,0
1746614490263,AWP 10,011,886158,Staff,0,0,0,0
1746614490263,AWP 10,012,886160,Staff,0,0,0,0
1746614490263,AWP 10,013,886161,Staff,0,0,0,0
1746614490263,AWP 10,014,886162,Staff,0,0,0,0
1746614490263,AWP 10,015,886163,Staff,0,0,0,0
1746614490263,AWP 10,016,886164,Staff,0,0,0,0
1746614490263,AWP 10,017,886165,Staff,0,0,0,0
1746614490263,AWP 10,018,886166,Staff,0,0,0,0
1746614490263,AWP 10,019,886168,Staff,0,0,0,0
1746614490263,AWP 10,020,886170,Staff,0,0,0,0
1746614490263,AWP 10,021,886172,Staff,0,0,0,0
1746614491307,AWP 10R,001,886173,Staff,0,1,0,0
1746614491307,AWP 10R,002,886174,Staff,0,1,0,0
1746614491307,AWP 10R,003,886175,Staff,0,0,0,0
1746614491307,AWP 10R,004,886176,Staff,0,0,0,0
1746614491307,AWP 10R,005,886177,Staff,0,0,0,0
1746614491307,AWP 10R,006,886178,Staff,0,0,0,0
1746614491307,AWP 10R,007,886179,Staff,0,0,0,0
1746614491307,AWP 10R,008,886181,Staff,0,0,0,0
1746614491307,AWP 10R,009,886182,Staff,0,0,0,0
1746614491307,AWP 10R,010,886183,Staff,0,0,0,0
1746614491307,AWP 10R,011,886184,Staff,0,0,0,0
1746614491307,AWP 10R,012,886185,Staff,0,0,0,0
1746614491307,AWP 10R,013,886186,Staff,0,0,0,0
1746614491307,AWP 10R,014,886187,Staff,0,0,0,0
1746614491307,AWP 10R,015,886188,Staff,0,0,0,0
1746614491307,AWP 10R,016,886189,Staff,0,0,0,0
1746614491307,AWP 10R,017,960532,Staff,0,0,0,0
1746614491307,AWP 10R,018,960533,Staff,0,0,0,0
1746614491307,AWP 10R,019,960534,Staff,0,0,0,0
1746614491307,AWP 10R,020,960538,Staff,0,0,0,0
1746614491307,AWP 10R,021,960540,Staff,0,0,0,0
1746614491307,AWP 10R,022,960541,Staff,0,0,0,0
1746614491307,AWP 10R,023,960542,Staff,0,0,0,0
1746614491307,AWP 10R,024,960544,Staff,0,0,0,0
1746614491307,AWP 10R,025,960545,Staff,0,0,0,0
1746614491307,AWP 10R,026,960548,Staff,0,0,0,0
1746614492336,AWP 102R,A00,886190,Staff,0,0,0,0
1746614492336,AWP 102R,B00,886191,Staff,0,0,0,0
1746614493366,BENG 100,A01,886193,Staff,17,0,30,13
1746614494394,BENG 122A,A01,886195,Hasty; Jeff M,13,0,30,17
1746614495421,BENG 166A,A00,886196,Sah; Robert Lie-Yuan,0,3,30,30
1746614496450,BENG 190,A00,958050,Khojah; Reem I,17,0,25,8
1746614497484,BIBC 102,A01,894320,Staff,0,1,46,46
1746614497484,BIBC 102,A02,894321,Staff,0,0,46,46
1746614497484,BIBC 102,A03,894344,Staff,6,0,46,40
1746614497484,BIBC 102,A04,894345,Staff,27,0,47,20
1746614498520,BICD 100R,A01,894365,Smith; Laurie,0,2,58,58
1746614498520,BICD 100R,A02,894366,Smith; Laurie,0,4,58,58
1746614498520,BICD 100R,A03,894367,Smith; Laurie,0,0,59,59
1746614498520,BICD 100R,A04,959869,Smith; Laurie,38,0,59,21
1746614499555,BICD 136,A01,894383,Gustafson-Brown; Cindy,14,0,50,36
1746614500583,BIEB 102,A01,894494,Butler; Shannon Rhey,51,0,130,79
1746614502648,BIEB 150,A01,894617,Wills; Christopher,3,0,20,17
1746614502648,BIEB 150,A02,894631,Wills; Christopher,3,0,20,17
1746614502648,BIEB 150,A03,894937,Wills; Christopher,3,0,20,17
1746614502648,BIEB 150,A04,894946,Wills; Christopher,5,0,20,15
1746614503678,BIEB 194,A00,906141,Kurle; Carolyn M.,5,0,20,15
1746614504705,BILD 1,A01,894154,Staff,3,0,19,16
1746614504705,BILD 1,A02,894155,Staff,14,0,19,5
1746614504705,BILD 1,A03,894160,Staff,13,0,19,6
1746614504705,BILD 1,A04,894161,Staff,15,0,18,3
1746614505737,BILD 2,A01,894168,Staff,0,0,50,50
1746614505737,BILD 2,A02,894169,Staff,0,0,50,50
1746614505737,BILD 2,A03,894179,Staff,0,0,50,50
1746614505737,BILD 2,A04,894203,Staff,22,0,50,28
1746614506763,BILD 3,A01,894213,Staff,23,0,31,8
1746614506763,BILD 3,A02,894214,Staff,26,0,31,5
1746614506763,BILD 3,A03,894235,Staff,28,0,31,3
1746614506763,BILD 3,A04,894236,Staff,28,0,32,4
1746614507792,BILD 4,A01,894253,Reuther; Keefe,5,0,24,19
1746614507792,BILD 4,A02,894258,Reuther; Keefe,16,0,24,8
1746614508820,BILD 5,A01,894276,Reuther; Keefe,33,0,50,17
1746614508820,BILD 5,A02,894277,Reuther; Keefe,45,0,50,5
1746614508820,BILD 5,A03,894290,Reuther; Keefe,44,0,50,6
1746614508820,BILD 5,A04,894291,Reuther; Keefe,48,0,50,2
1746614509848,BILD 24,A01,894297,Pirino; Giorgia,40,0,60,20
1746614510875,BIMM 100,B01,958915,Staff,71,0,100,29
1746614511903,BIMM 101,A01,895017,McDonnell; Lisa Marie,0,5,24,24
1746614511903,BIMM 101,A02,895018,McDonnell; Lisa Marie,0,5,24,24
1746614511903,BIMM 101,B01,895020,McDonnell; Lisa Marie,0,5,24,24
1746614511903,BIMM 101,B02,895021,McDonnell; Lisa Marie,0,4,24,24
1746614512930,BIMM 110,A01,895023,Staff,1,0,25,24
1746614512930,BIMM 110,A02,895024,Staff,9,0,25,16
1746614512930,BIMM 110,A03,895025,Staff,18,0,25,7
1746614512930,BIMM 110,A04,895031,Staff,20,0,25,5
1746614513958,BIMM 120,A01,895114,Gustafson-Brown; Cindy,14,0,28,14
1746614513958,BIMM 120,A02,895126,Gustafson-Brown; Cindy,21,0,27,6
1746614514993,BIPN 100,A01,895130,Yang; Mingyu,0,0,38,38
1746614514993,BIPN 100,A02,895131,Yang; Mingyu,31,0,38,7
1746614514993,BIPN 100,A03,895132,Yang; Mingyu,32,0,38,6
1746614514993,BIPN 100,A04,895133,Yang; Mingyu,27,0,36,9
1746614516029,BIPN 120,A01,895135,Cooke; James Edward,0,3,13,13
1746614516029,BIPN 120,A02,895136,Cooke; James Edward,0,1,13,13
1746614516029,BIPN 120,A03,895137,Cooke; James Edward,0,3,13,13
1746614516029,BIPN 120,A04,895156,Cooke; James Edward,0,2,11,11
1746614517063,BIPN 134,A01,895235,Cooke; James Edward,0,1,25,25
1746614517063,BIPN 134,A02,895237,Cooke; James Edward,0,0,25,25
1746614517063,BIPN 134,A03,895240,Cooke; James Edward,1,0,25,24
1746614517063,BIPN 134,A04,895270,Cooke; James Edward,20,0,25,5
1746614518090,BIPN 189,A00,892103,Staff,0,14,14,14
1746614520142,BISP 194,A00,958008,Staff,0,2,0,0
1746614521170,CAT 124,A01,922009,Staff,0,5,20,20
1746614522203,CAT 125R,A00,886390,Morales; Celeste Georgianna,0,4,20,20
1746614522203,CAT 125R,B00,886391,Irwin; Matthew Joseph,0,4,20,20
1746614522203,CAT 125R,C00,886392,Smith; Lauryn Alissa,0,2,20,20
1746614522203,CAT 125R,D00,886393,Vanderschuit; Maya Alysia,0,3,20,20
1746614522203,CAT 125R,E00,886394,Marchisotto; Jennifer Anne,0,3,20,20
1746614523231,CENG 15,A01,886218,Drews; Aaron,3,0,8,5
1746614524258,CENG 113,A00,886219,Opatkiewicz; Justin Paul,15,0,25,10
1746614525286,CGS 101,A00,887044,Staff,7,0,20,13
1746614526314,CGS 105,A01,887046,Staff,14,0,25,11
1746614527343,CGS 112,A00,887047,Cuong; Marisol,12,0,15,3
1746614528373,CGS 113,A00,887048,Staff,23,0,30,7
1746614529400,CGS 120,A00,887049,Staff,9,0,17,8
1746614530431,CHEM 6A,A01,886336,Lam; Tin Yiu,38,0,50,12
1746614530431,CHEM 6A,A02,886338,Lam; Tin Yiu,37,0,50,13
1746614531461,CHEM 6B,A01,886341,Hopkins; Patrycja Anna,16,0,50,34
1746614531461,CHEM 6B,A02,886343,Hopkins; Patrycja Anna,42,0,50,8
1746614532489,CHEM 6C,A01,886346,Albizati; Kim F.,0,2,50,50
1746614532489,CHEM 6C,A02,886348,Albizati; Kim F.,24,0,50,26
1746614533518,CHEM 40A,A01,886352,Klosterman; Jeremy K,65,0,100,35
1746614534548,CHEM 40B,A01,886356,Klosterman; Jeremy K,0,24,100,100
1746614535578,CHEM 41B,A01,886360,Theodorakis; Emmanuel,25,0,50,25
1746614535578,CHEM 41B,A02,886362,Theodorakis; Emmanuel,47,0,50,3
1746614536609,CHIN 165A,A00,886382,Xu; Li,18,0,20,2
1746614537639,CLAS 120,A00,886387,Myerston Santana; Jacobo,33,0,40,7
1746614538666,COGS 9,A01,886967,Shannon; Kyle Michael,42,0,60,18
1746614539693,COGS 11,A01,886969,Staff,9,0,30,21
1746614540723,COGS 14A,A01,886971,Staff,5,0,60,55
1746614541750,COGS 14B,A01,886973,Hoffman; Drew Ellen,4,0,60,56
1746614542777,COGS 18,A01,886975,Morgan; Eric,34,0,60,26
1746614543806,COGS 20,A01,886977,Staff,3,0,8,5
1746614543806,COGS 20,A02,886978,Staff,5,0,7,2
1746614544838,COGS 100,A01,907783,Staff,0,1,30,30
1746614545867,COGS 101B,A01,886980,Staff,0,4,48,48
1746614546895,COGS 101C,A01,886982,Delgado; Tania,0,5,44,44
1746614547923,COGS 102A,A01,886984,Johnson; Christine M.,3,0,30,27
1746614548953,COGS 118B,A01,886986,Staff,0,4,88,88
1746614549982,COGS 150,A01,886988,Bergen; Benjamin,22,0,50,28
1746614551010,COGS 153,A00,886989,Delgado; Tania,1,3,41,40
1746614552035,COGS 186,A01,886991,Staff,0,0,32,32
1746614553062,COGS 187A,A01,886993,Boyle; Mary E. T.,7,0,30,23
1746614554091,COGS 189,A00,886994,Staff,1,1,30,29
1746614555123,COMM 10,A01,886996,Staff,0,0,20,21
1746614555123,COMM 10,A02,886997,Staff,10,0,20,10
1746614555123,COMM 10,A03,959845,Staff,19,0,20,1
1746614556156,COMM 20,A01,886999,Leuning; Grant Maurstad,24,0,40,16
1746614558211,COMM 100A,A01,887002,Staff,0,0,20,25
1746614558211,COMM 100A,A02,887003,Staff,5,0,20,15
1746614559241,COMM 100B,A01,887005,Staff,0,8,20,24
1746614560265,COMM 106D,A00,887006,Staff,14,0,40,26
1746614561298,COMM 110G,A00,887007,Whitworth-Smith; Andrew C,12,0,40,28
1746614562325,COMM 111B,A00,887008,Staff,31,0,40,9
1746614563353,COMM 113T,A00,887009,Abuelhiga; Soraya Jill,28,0,40,12
1746614563353,COMM 113T,B00,906733,Staff,39,0,40,1
1746614564379,COMM 145,A00,887010,Staff,13,0,40,27
1746614565406,COMM 146,A00,887054,Staff,32,0,40,8
1746614566434,COMM 190,A00,887012,Staff,8,0,23,15
1746614567461,CSE 8A,A50,887015,Cao; Yingjun,56,0,85,29
1746614568488,CSE 11,A01,887017,Cao; Yingjun,11,0,70,59
1746614569515,CSE 20,A01,887019,Staff,30,0,50,20
1746614570552,CSE 21,A01,887021,Staff,79,0,100,21
1746614570552,CSE 21,B01,892583,Braun; Oliver,45,0,50,5
1746614571582,CSE 30,A01,887025,Eldon; John,142,0,200,58
1746614572609,CSE 100,A01,887027,Staff,26,0,50,24
1746614572609,CSE 100,A02,887028,Staff,42,0,50,8
1746614573642,CSE 101,A01,887030,Braun; Oliver,74,0,100,26
1746614573642,CSE 101,B01,887032,Jones; Miles E,0,3,50,50
1746614573642,CSE 101,B02,887033,Jones; Miles E,0,2,50,50
1746614574674,CSE 105,A01,908084,Jones; Miles E,32,0,50,18
1746614574674,CSE 105,A02,908087,Jones; Miles E,31,0,50,19
1746614575702,CSE 135,A01,887035,Powell; Thomas Allan,0,5,50,50
1746614576732,CSE 142,A01,887037,Staff,7,0,60,53
1746614577762,CSE 142L,A01,887039,Staff,34,0,60,26
1746614578789,CSE 151A,A01,887041,Solares; Edwin A,47,0,100,53
1746614579819,CSE 175,A01,887043,Kumar; Rakesh,30,0,30,0
1746614580847,CSS 1,A01,886389,Staff,0,1,40,40
1746614581880,DSC 30,A01,908097,Liao; Soohyun Nam,47,0,75,28
1746614582909,DSC 40A,A01,908099,Shannon; Kyle Michael,30,0,50,20
1746614583938,DSC 40B,A01,908112,Staff,15,0,50,35
1746614584966,DSC 80,A01,908116,Staff,19,0,60,41
1746614585994,DSC 197,001,956863,Eldridge; Justin Matthew,9999,0,9999,0
1746614587036,ECE 5,A01,886400,Morris; Karcher William,1,0,6,5
1746614587036,ECE 5,A02,886401,Morris; Karcher William,3,0,6,3
1746614588063,ECE 148,A01,886403,Silberman; Jack,0,14,14,14
1746614589102,ECON 1,A01,887265,Crane; Meredith Helen,11,0,70,59
1746614589102,ECON 1,B01,887268,Staff,42,0,50,8
1746614590139,ECON 2,A01,887273,Crane; Meredith Helen,54,0,70,16
1746614591169,ECON 3,A01,887279,Rondina; Giacomo,31,0,70,39
1746614592202,ECON 4,A01,887282,Anderson; John Charles,0,2,10,10
1746614593230,ECON 5,A01,887285,Staff,34,0,45,11
1746614593230,ECON 5,B01,887292,Staff,41,0,45,4
1746614594267,ECON 100A,A01,887337,Newhouse; Herbert S,54,0,70,16
1746614594267,ECON 100A,B01,887349,Staff,45,0,50,5
1746614595297,ECON 100B,A01,887361,Du; Songzi,29,0,70,41
1746614596324,ECON 100C,A01,887445,Newhouse; Herbert S,59,0,70,11
1746614597355,ECON 105,A00,887488,Vespa; Emanuel Ignacio,23,0,35,12
1746614598382,ECON 109,A01,887506,Shishkin; Denis,28,0,35,7
1746614599423,ECON 110A,A01,887568,Alon; Titan Michael,0,2,35,35
1746614599423,ECON 110A,B01,907601,Alon; Titan Michael,20,0,35,15
1746614600453,ECON 110B,A01,887598,Levkoff; Steven B.,0,24,70,70
1746614601481,ECON 112,A00,887599,Rondina; Giacomo,19,0,35,16
1746614602514,ECON 120A,A01,887603,Dai; Yinlin,36,0,70,34
1746614603544,ECON 120C,A01,887608,Sun; Yixiao,0,1,35,35
1746614603544,ECON 120C,B01,887614,Sun; Yixiao,0,0,35,35
1746614604571,ECON 138,A00,887621,Bharadwaj; Prashant,0,21,20,20
1746614605605,ECON 144,A00,958007,Squires; Dale E,11,0,35,24
1746614606631,ECON 171,A01,907666,Staff,18,0,35,17
1746614607665,ECON 175,A00,887626,Wu; Pak Yeung,22,0,35,13
1746614608691,ECON 190,A00,887640,Vespa; Emanuel Ignacio,22,0,35,13
1746614609726,EDS 25,A01,888197,Staff,0,0,0,0
1746614609726,EDS 25,A02,888209,Staff,0,0,0,0
1746614609726,EDS 25,A03,888210,Staff,0,0,0,0
1746614609726,EDS 25,A04,888212,Staff,0,0,0,0
1746614609726,EDS 25,A05,888213,Staff,0,0,0,0
1746614609726,EDS 25,A06,888214,Staff,0,0,0,0
1746614609726,EDS 25,A07,888235,Staff,0,2,0,0
1746614609726,EDS 25,A08,888236,Staff,0,0,0,0
1746614609726,EDS 25,A09,888240,Staff,0,0,0,0
1746614609726,EDS 25,A10,888244,Staff,0,0,0,0
1746614609726,EDS 25,B01,888273,Staff,0,0,0,0
1746614609726,EDS 25,B02,888285,Staff,0,0,0,0
1746614609726,EDS 25,B03,888423,Staff,0,0,0,1
1746614609726,EDS 25,B04,888432,Staff,0,0,0,0
1746614609726,EDS 25,B05,888433,Staff,0,0,0,0
1746614609726,EDS 25,B06,888467,Staff,0,0,0,0
1746614609726,EDS 25,B07,888468,Staff,0,0,0,0
1746614609726,EDS 25,B08,888479,Staff,0,0,0,0
1746614609726,EDS 25,B09,888484,Staff,0,0,0,0
1746614609726,EDS 25,B10,888487,Staff,0,0,0,0
1746614610765,EDS 38,A01,907700,Choi; Bailey Miyeon,30,0,30,0
1746614611794,EDS 112,A01,888601,Chapman; Thandeka K,12,0,40,28
1746614612828,EDS 115,A00,888697,Mendez; Kathrina Mendoza,10,0,30,20
1746614613859,EDS 116,A01,888893,Staff,33,0,40,7
1746614615920,EDS 124AR,A00,889133,Staff,29,0,50,21
1746614615920,EDS 124AR,B00,907471,Simon; Elizabeth A,37,0,50,13
1746614616947,EDS 124BR,A00,889134,Simon; Elizabeth A,44,0,100,56
1746614617976,EDS 125,A00,889135,Staff,25,0,30,5
1746614619003,EDS 126,A01,889138,Staff,35,0,40,5
1746614620038,EDS 164R,A01,889142,Wishard Guerra; Alison G.,32,0,50,18
1746614621072,ENG 30,A01,886396,Staff,0,0,0,0
1746614621072,ENG 30,B01,886398,Staff,0,0,0,0
1746614622101,ENVR 102,A00,906150,Montejo; Carolina,23,0,25,2
1746614623133,ETHN 103A,A00,887236,Man; Simeon S,0,2,0,0
1746614624165,ETHN 113,A00,887239,Staff,16,0,30,14
1746614625194,ETHN 116,A00,887240,Staff,16,0,25,9
1746614626227,ETHN 117,A00,887241,Choi; Esther Min,28,0,30,2
1746614627253,ETHN 118,A00,887243,Staff,24,0,30,6
1746614628286,ETHN 127,A00,887248,Cuong; Marisol,11,0,15,4
1746614629313,ETHN 139,A00,887250,Staff,7,0,10,3
1746614630340,ETHN 142,A00,887252,Staff,9,0,30,21
1746614631369,ETHN 161,A00,887253,Browne; Errol Tsekani,24,0,30,6
1746614632398,ETHN 163FR,A00,887255,Burelle; Julie Sara Veronique,0,0,5,5
1746614633426,GLBH 20,A00,889149,Elwardani; Nile Regina,8,0,42,34
1746614635489,GLBH 111,A01,889152,Burgos; Jose L.,17,0,17,0
1746614636520,GLBH 150,A00,889181,Sloane; Julia Kathryn,0,5,15,15
1746614638574,HDS 60,A01,886406,Warstadt; Melissa Fawn,72,0,80,8
1746614639602,HIAF 111,A00,889324,Gyamfi; Bright,25,0,32,7
1746614640630,HIEA 131,A00,889328,Staff,15,0,32,17
1746614641664,HIEA 144,A00,889333,Henry; Todd A.,26,0,32,6
1746614642693,HIEA 154,A00,889336,Henry; Todd A.,24,0,32,8
1746614643725,HIEU 106,A00,889339,Staff,22,0,32,10
1746614645790,HIEU 114,A00,889340,Staff,4,0,32,28
1746614646820,HIEU 135GS,A00,889342,Patterson; Patrick H.,0,0,1,24
1746614647852,HIEU 137,A00,889343,Edington; Claire Ellen,10,0,25,15
1746614648916,HIEU 148,A00,889345,Staff,14,0,32,18
1746614649942,HIEU 154,A00,889346,Biess; Frank Peter,21,0,32,11
1746614650969,HILA 102,A00,889351,Staff,12,0,32,20
1746614652001,HILD 2A,A01,889221,Lewandoski; Julia Mavis,0,8,32,32
1746614653033,HILD 7B,A01,889225,Man; Simeon S,0,12,32,32
1746614654065,HILD 7C,A01,889288,Alvarez; Luis A,0,14,32,32
1746614655091,HILD 30,A01,889323,Staff,0,5,32,32
1746614657143,HISC 119,A00,889383,Golan; Tal,20,0,32,12
1746614658175,HIUS 103,A00,889384,Man; Simeon S,0,0,32,32
1746614659202,HIUS 117,A00,919797,Kwak; Nancy,18,0,32,14
1746614660231,HIUS 142A,A00,919788,Staff,22,0,32,10
1746614662284,HIUS 149,A00,889386,Gyamfi; Bright,26,0,32,6
1746614663313,HIUS 155,A00,889387,Alvarez; Luis A,15,0,32,17
1746614664353,HUM 3,A01,886499,Caldwell; Michael Alan,19,0,50,31
1746614665378,HUM 3GS,A00,886500,Rodriguez; Bretton Sigfred,0,0,0,28
1746614666405,HUM 3R,A01,886502,Markman; Kristina,0,36,50,50
1746614667442,HUM 4,A01,886504,Crum; Matthew Stephen,23,0,50,27
1746614667442,HUM 4,B01,886506,West; Geoffrey Scott,17,0,50,33
1746614668468,HUM 4GS,A00,886507,Staff,0,0,0,19
1746614669494,HUM 5,A01,886509,Staff,31,0,50,19
1746614670520,HUM 5R,A01,886511,Zavodny; Tatiana Sophia,0,39,50,50
1746614671546,JAPN 180,A00,886407,Staff,16,0,40,24
1746614672575,LATI 50,A01,886409,Martin-Cabrera; Luis,3,0,22,19
1746614672575,LATI 50,A02,886410,Martin-Cabrera; Luis,19,0,22,3
1746614672575,LATI 50,A03,886411,Martin-Cabrera; Luis,21,0,22,1
1746614672575,LATI 50,A04,886412,Martin-Cabrera; Luis,8,0,22,14
1746614673604,LAWS 101,A00,907664,Staff,28,0,60,32
1746614674636,LIAB 1A,A00,889388,Saab; Dima,17,0,20,3
1746614675669,LIAB 1AX,A00,889389,El Cheddadi; Youniss,18,0,20,2
1746614676699,LIFR 1C,A00,889391,Van Moer; Vinciane G,8,0,20,12
1746614677729,LIFR 1CX,A00,889392,Van Moer; Vinciane G,7,0,20,13
1746614678762,LIFR 1D,A00,889393,Van Moer; Vinciane G,7,0,20,13
1746614679794,LIFR 1DX,A00,889394,Van Moer; Vinciane G,8,0,20,12
1746614680823,LIGN 7,A00,886923,Staff,25,0,50,25
1746614681856,LIGN 17,A00,886924,Kehler; Andrew Scott,126,0,150,24
1746614682886,LTAM 110,A00,889395,Staff,15,0,30,15
1746614683911,LTAM 110GS,A00,958010,Rodriguez; Bretton Sigfred,0,0,0,28
1746614684937,LTCH 101,A00,889397,Staff,23,0,25,2
1746614686019,LTCS 130,A00,889398,Staff,23,0,25,2
1746614687049,LTEA 138,A00,889399,Staff,24,0,40,16
1746614688081,LTEN 149,A00,889400,Wesling; Megan E.,0,3,25,25
1746614689110,LTEN 169,A00,889401,Staff,20,0,25,5
1746614690137,LTEN 180,A00,889402,Staff,10,0,15,5
1746614691167,LTEN 181,A00,889403,Staff,21,0,25,4
1746614692211,LTWL 100,A00,889404,Myerston Santana; Jacobo,2,0,25,23
1746614693241,LTWL 180GS,A00,889405,Staff,0,0,20,20
1746614694270,LTWL 181,A00,889406,Staff,16,0,25,9
1746614695297,LTWL 184,A00,889475,Mukherjee; Silpa,22,0,25,3
1746614696328,LTWR 102C,A00,889486,Staff,29,0,30,1
1746614697359,LTWR 115W,A00,889491,Staff,0,2,15,15
1746614698385,MAE 8,A01,886905,Staff,0,2,0,0
1746614699426,MAE 11,A00,886906,Bandaru; Prabhakar,0,7,50,50
1746614700457,MAE 20,A00,886907,Evdokimenko; Ekaterina,43,0,70,27
1746614701485,MAE 30B,A00,886909,Ghazinejad; Maziar,25,0,45,20
1746614702517,MAE 101B,A00,886910,Saintillan; David,30,0,45,15
1746614703546,MAE 105,A00,886911,Bandaru; Prabhakar,18,0,50,32
1746614704578,MAE 107,B00,958024,Staff,7,0,50,43
1746614705608,MAE 143B,A00,886913,Bewley; Thomas R,2,0,40,38
1746614706635,MAE 148,A01,886915,Silberman; Jack,0,3,14,14
1746614707663,MAE 160,A00,886916,Evdokimenko; Ekaterina,30,0,60,30
1746614708700,MATH 3C,A01,889681,Staff,0,2,30,30
1746614708700,MATH 3C,A02,960048,Staff,23,0,30,7
1746614709730,MATH 10A,A01,889760,Staff,26,0,30,4
1746614709730,MATH 10A,A02,889783,Staff,29,0,30,1
1746614710769,MATH 10B,A01,889785,Verstraete; Jacques Allan,1,0,35,34
1746614710769,MATH 10B,A02,889795,Verstraete; Jacques Allan,4,0,35,31
1746614710769,MATH 10B,B01,889797,Verstraete; Jacques Allan,3,0,35,32
1746614710769,MATH 10B,B02,889828,Verstraete; Jacques Allan,3,0,35,32
1746614711799,MATH 10C,A01,889849,Habib; Yousaf,8,0,30,22
1746614711799,MATH 10C,A02,889852,Habib; Yousaf,14,0,30,16
1746614711799,MATH 10C,A03,889853,Habib; Yousaf,22,0,30,8
1746614711799,MATH 10C,A04,889858,Habib; Yousaf,20,0,30,10
1746614711799,MATH 10C,B01,889861,Staff,1,0,30,29
1746614711799,MATH 10C,B02,889862,Staff,24,0,30,6
1746614711799,MATH 10C,B03,889863,Staff,27,0,30,3
1746614711799,MATH 10C,B04,889967,Staff,23,0,30,7
1746614712829,MATH 18,A01,889974,Staff,6,0,30,24
1746614712829,MATH 18,A02,889977,Staff,20,0,30,10
1746614712829,MATH 18,B01,889984,Hardiman; Liam,20,0,30,10
1746614712829,MATH 18,B02,889985,Hardiman; Liam,25,0,30,5
1746614713860,MATH 20A,A01,889990,Suk; Andrew Hoon,30,0,35,5
1746614714895,MATH 20B,A01,889993,Ohm; Ko Woon,21,0,30,9
1746614714895,MATH 20B,A02,889994,Ohm; Ko Woon,30,0,30,0
1746614714895,MATH 20B,B01,889996,Ohm; Ko Woon,22,0,30,8
1746614714895,MATH 20B,B02,889997,Ohm; Ko Woon,23,0,30,7
1746614715931,MATH 20C,A01,889999,Hammock; Frances H,17,0,30,13
1746614715931,MATH 20C,A02,890003,Hammock; Frances H,23,0,30,7
1746614715931,MATH 20C,B01,890006,Hammock; Frances H,2,0,30,28
1746614715931,MATH 20C,B02,890007,Hammock; Frances H,11,0,30,19
1746614716967,MATH 20D,A01,890011,Cheng; Hsiao-Bing,1,0,30,29
1746614716967,MATH 20D,A02,890012,Cheng; Hsiao-Bing,14,0,30,16
1746614716967,MATH 20D,B01,890016,Cheng; Hsiao-Bing,13,0,30,17
1746614716967,MATH 20D,B02,890017,Cheng; Hsiao-Bing,13,0,30,17
1746614717996,MATH 20E,A01,890026,Harel; Guershon,1,0,30,29
1746614717996,MATH 20E,A02,890029,Harel; Guershon,22,0,30,8
1746614717996,MATH 20E,B01,890033,Harel; Guershon,7,0,30,23
1746614717996,MATH 20E,B02,890101,Harel; Guershon,21,0,30,9
1746614719025,MATH 102,A01,890104,Staff,18,0,30,12
1746614719025,MATH 102,A02,890105,Staff,27,0,30,3
1746614720056,MATH 103B,A01,890116,Salehi Golsefidy; Alireza,3,0,30,27
1746614720056,MATH 103B,B01,890118,Staff,0,3,34,34
1746614721085,MATH 109,A01,890121,Aliabadi Sr.; Mohsen,0,0,30,30
1746614721085,MATH 109,B01,890124,Upadrashta; Pranav Kumar,18,0,30,12
1746614722119,MATH 120A,A01,890126,Eggers; John Dietrich,13,0,30,17
1746614723152,MATH 142B,A01,890128,Ioana; Adrian,19,0,30,11
1746614723152,MATH 142B,A02,890129,Ioana; Adrian,12,0,30,18
1746614724180,MATH 154,A01,890174,Staff,0,1,30,30
1746614724180,MATH 154,A02,890182,Staff,0,0,30,30
1746614725206,MATH 168A,A01,890197,Dumitriu; Ioana,21,0,35,14
1746614726235,MATH 170A,A01,890240,Nie; Jiawang,1,0,30,29
1746614726235,MATH 170A,A02,890241,Nie; Jiawang,11,0,30,19
1746614726235,MATH 170A,A03,890249,Nie; Jiawang,23,0,30,7
1746614727267,MATH 170B,A01,957891,Nag; Panchali,13,0,35,22
1746614729328,MATH 181A,A01,908025,Staff,0,3,35,35
1746614729328,MATH 181A,A02,960115,Staff,26,0,35,9
1746614730360,MATH 181B,A01,959874,Staff,24,0,30,6
1746614731389,MATH 193B,A01,890265,Staff,0,4,35,35
1746614732426,MGT 4,A01,890311,Anderson; John Charles,42,0,88,46
1746614733457,MGT 5,A00,907740,Staff,12,0,98,86
1746614734484,MGT 12,A00,890312,Lindenberger; Wade Douglas,67,0,98,31
1746614735513,MGT 16,A00,957883,Staff,78,0,98,20
1746614737572,MGT 45,A00,890314,Pecore; Joseph P.,45,0,98,53
1746614738616,MGT 71,A00,890315,Staff,0,12,98,98
1746614739644,MGT 100,A00,890316,Yavorsky; Daniel Ryan,44,0,98,54
1746614740671,MGT 103,A00,890317,Ehrich; Kristine R,73,0,98,25
1746614741701,MGT 105,A00,890356,Bates; Kenneth Walter,0,8,98,98
1746614742726,MGT 112,A00,890360,Ehrich; Kristine R,55,0,98,43
1746614743754,MGT 127R,A00,907732,Zhu; Kevin Xiaoguo,23,0,98,75
1746614744787,MGT 131B,A00,890361,Anderson; John Charles,59,0,98,39
1746614745815,MGT 137,A00,890362,Lindenberger; Wade Douglas,65,0,98,33
1746614746843,MGT 160,A00,890369,Johnson; Erik Barry,9,0,98,89
1746614748908,MGT 164,A00,890372,Zimmermann; Carsten,0,40,98,98
1746614749936,MGT 180,A00,890374,Bliss; Barbara Ann,11,0,98,87
1746614750966,MMW 15,A01,886414,Chang; Edmond Yi-Teh,0,12,28,28
1746614750966,MMW 15,A02,886415,Chang; Edmond Yi-Teh,0,8,28,28
1746614750966,MMW 15,A03,886416,Chang; Edmond Yi-Teh,0,9,28,28
1746614750966,MMW 15,A04,886417,Chang; Edmond Yi-Teh,0,8,28,28
1746614750966,MMW 15,B01,886419,Chang; Edmond Yi-Teh,0,7,28,28
1746614750966,MMW 15,B02,886420,Chang; Edmond Yi-Teh,0,7,28,28
1746614750966,MMW 15,B03,886421,Chang; Edmond Yi-Teh,0,7,28,28
1746614750966,MMW 15,B04,886422,Chang; Edmond Yi-Teh,0,8,28,28
1746614750966,MMW 15,C01,886424,Staff,0,9,28,28
1746614750966,MMW 15,C02,886425,Staff,0,8,28,28
1746614750966,MMW 15,C03,886426,Staff,0,8,28,28
1746614750966,MMW 15,C04,886427,Staff,0,8,28,28
1746614750966,MMW 15,C05,958038,Staff,0,8,28,28
1746614750966,MMW 15,C06,958039,Staff,0,7,28,28
1746614752001,MMW 15GS,A00,906910,Patterson; Patrick H.,4,0,28,24
1746614753034,MMW 122R,A01,886429,Rahimi; Babak,0,13,28,28
1746614753034,MMW 122R,A02,886430,Rahimi; Babak,0,12,28,28
1746614753034,MMW 122R,A03,958040,Rahimi; Babak,0,11,28,28
1746614754073,MUS 1A,A01,890937,Staff,2,0,25,23
1746614754073,MUS 1A,A02,891035,Staff,6,0,25,19
1746614754073,MUS 1A,C01,958912,Staff,24,0,25,1
1746614754073,MUS 1A,C02,958913,Staff,25,0,25,0
1746614756134,MUS 2AK,A00,957092,Ohnishi; Takae,15,0,15,0
1746614757202,MUS 4,A01,891044,Staff,0,0,25,25
1746614757202,MUS 4,A02,891045,Staff,22,0,25,3
1746614757202,MUS 4,B01,891048,Staff,17,0,25,8
1746614757202,MUS 4,B02,891050,Staff,25,0,25,0
1746614758232,MUS 5,A01,957506,Dubnov; Shlomo,0,0,25,25
1746614758232,MUS 5,A02,957622,Dubnov; Shlomo,12,0,25,13
1746614758232,MUS 5,A03,957623,Dubnov; Shlomo,20,0,25,5
1746614759263,MUS 6,A01,891053,Freitas Caetano; Marcelo,24,0,25,1
1746614759263,MUS 6,A02,891054,Freitas Caetano; Marcelo,23,0,25,2
1746614760290,MUS 7,A01,891081,Staff,0,0,25,25
1746614760290,MUS 7,A02,891082,Staff,3,0,25,22
1746614761321,MUS 8GS,A00,891118,Borgo; David Garcia,1,0,25,24
1746614762349,MUS 11,A01,891140,Staff,8,0,25,17
1746614762349,MUS 11,A02,891141,Staff,21,0,25,4
1746614763376,MUS 13,A01,891143,Staff,8,0,25,17
1746614763376,MUS 13,A02,891144,Staff,24,0,25,1
1746614764405,MUS 15,A01,891146,Staff,9,0,25,16
1746614764405,MUS 15,A02,891148,Staff,21,0,25,4
1746614764405,MUS 15,B01,891150,Staff,18,0,25,7
1746614764405,MUS 15,B02,891151,Staff,25,0,25,0
1746614765432,MUS 20,A01,891153,Staff,5,0,20,15
1746614765432,MUS 20,A02,891155,Staff,14,0,20,6
1746614766463,MUS 80,A00,891156,Staff,19,0,25,6
1746614766463,MUS 80,B00,891157,Staff,23,0,25,2
1746614767490,MUS 130,A00,891158,Ohnishi; Takae,35,0,35,0
1746614768516,MUS 150GS,A01,891160,Borgo; David Garcia,1,0,25,24
1746614769543,MUS 170,A01,891162,Freitas Caetano; Marcelo,20,0,25,5
1746614769543,MUS 170,A02,891164,Freitas Caetano; Marcelo,21,0,25,4
1746614770573,NANO 11,A00,886220,Vazquez Mena; Oscar,13,0,15,2
1746614771603,NANO 15,A01,886222,Drews; Aaron,4,0,7,3
1746614772631,NANO 104,A00,886224,Sirbuly; Donald,17,0,25,8
1746614773659,PH 40,A00,886528,Staff,23,0,40,17
1746614774686,PH 45,A01,886799,Staff,35,0,40,5
1746614775722,PH 110,A00,886802,Staff,0,6,40,40
1746614776747,PH 172,A00,906716,Staff,19,0,35,16
1746614777776,PH 191,A00,886803,Staff,6,0,40,34
1746614778803,PHIL 1,A00,889500,Staff,20,0,30,10
1746614779847,PHIL 10,A01,889549,Grush; Rick Scott,16,0,22,6
1746614779847,PHIL 10,A02,889551,Grush; Rick Scott,22,0,22,0
1746614780876,PHIL 28,A01,889559,Lamey; Andy M.,0,2,31,31
1746614780876,PHIL 28,A02,889561,Lamey; Andy M.,0,1,30,30
1746614780876,PHIL 28,A03,889572,Lamey; Andy M.,0,1,30,30
1746614781907,PHIL 35,A00,907839,Staff,13,0,15,2
1746614782937,PHIL 60,A00,889574,Staff,73,0,90,17
1746614783963,PHIL 101,A00,958004,Staff,12,0,15,3
1746614786026,PHIL 136,A00,889582,Fulkerson; Matthew Todd,26,0,45,19
1746614787064,PHIL 163,A01,889601,Staff,21,0,30,9
1746614787064,PHIL 163,B01,889606,Brandt; Reuven A,0,3,0,0
1746614788094,PHIL 164,A00,889610,Staff,16,0,30,14
1746614789122,PHIL 165,A00,889613,Staff,22,0,30,8
1746614790187,PHYS 1A,A00,886431,Staff,30,0,70,40
1746614791214,PHYS 1AL,001,886432,Tsai; Philbert S,0,1,30,30
1746614791214,PHYS 1AL,002,886436,Tsai; Philbert S,13,0,30,17
1746614792246,PHYS 1B,A00,886439,Staff,184,0,240,56
1746614793275,PHYS 1BL,001,886441,Tsai; Philbert S,0,4,30,30
1746614793275,PHYS 1BL,002,886444,Tsai; Philbert S,2,0,30,28
1746614794307,PHYS 1C,A00,896092,Arnold; Kam S,78,0,146,68
1746614795333,PHYS 1CL,001,886448,Tsai; Philbert S,0,1,30,30
1746614795333,PHYS 1CL,002,886449,Tsai; Philbert S,1,0,30,29
1746614795333,PHYS 1CL,003,886450,Tsai; Philbert S,16,0,30,14
1746614795333,PHYS 1CL,004,886451,Tsai; Philbert S,15,0,30,15
1746614796362,PHYS 2B,A01,886457,Staff,67,0,115,48
1746614797389,PHYS 2C,A01,886460,Shotwell; Brian,0,9,65,65
1746614798416,PHYS 2CL,A01,886467,Staff,0,4,28,28
1746614798416,PHYS 2CL,A02,886468,Staff,0,3,28,28
1746614799452,PHYS 2D,A01,886470,Staff,10,0,50,40
1746614800488,PHYS 4B,A01,886475,Grinstein; Benjamin,22,0,40,18
1746614801521,POLI 5,A00,891173,Desposato; Scott,7,0,25,18
1746614802553,POLI 5D,A01,891175,Staff,5,0,5,0
1746614802553,POLI 5D,B01,891178,Staff,5,0,5,0
1746614803579,POLI 11,A00,891179,Ferree; Karen E,0,0,35,35
1746614804609,POLI 12,A00,891180,Staff,15,0,30,15
1746614805635,POLI 27,A01,891182,Staff,11,0,75,64
1746614806666,POLI 30,A00,891183,Staff,8,0,50,42
1746614807697,POLI 100B,A00,891244,Staff,5,1,35,30
1746614808728,POLI 100I,A00,891247,Staff,7,0,30,23
1746614809756,POLI 104J,A00,891248,Nichter; Maysa,14,0,30,16
1746614810781,POLI 104U,A00,891250,Nichter; Maysa,1,0,30,29
1746614812834,POLI 110B,A00,891255,Wiens; David,19,0,25,6
1746614813862,POLI 112A,A00,891256,Wiens; David,6,0,25,19
1746614814891,POLI 114BR,A00,891261,Staff,19,0,30,11
1746614815917,POLI 117R,A00,891262,Forman; Fonna,0,6,50,50
1746614816945,POLI 118,A00,891264,Ingham; Sean,17,0,25,8
1746614817982,POLI 124A,A00,891265,Staff,18,0,20,2
1746614819009,POLI 125D,A00,891266,Nichter; Simeon C,2,0,25,23
1746614820037,POLI 126,A00,891268,Nichter; Simeon C,7,0,25,18
1746614821066,POLI 126AA,A00,891272,Staff,15,0,25,10
1746614822096,POLI 130AA,A00,891273,Staff,15,0,20,5
1746614823126,POLI 134AA,A00,891274,Staff,4,0,20,16
1746614825183,POLI 138,A00,891278,Staff,21,0,25,4
1746614826211,POLI 142K,A00,891280,Staff,10,0,25,15
1746614827239,POLI 142M,A00,891281,Gartzke; Erik,16,0,30,14
1746614828266,POLI 142P,A00,891284,Staff,20,0,30,10
1746614829292,POLI 143,A00,891285,Gartzke; Erik,12,0,30,18
1746614830319,POLI 153,A00,891286,Staff,19,0,20,1
1746614832378,POLI 175,A00,891290,Staff,15,0,20,5
1746614833407,PSYC 1,A00,890674,Steiner; Eric Tomas,0,11,45,45
1746614834437,PSYC 2,A00,890676,Albright; Thomas D,20,0,35,15
1746614835466,PSYC 3,A00,890679,Staff,17,0,20,3
1746614836493,PSYC 6,A00,959858,Staff,19,0,20,1
1746614837521,PSYC 60,A01,890684,Rickard; Timothy C.,0,6,45,45
1746614838548,PSYC 70,A01,890689,Geller; Emma Harlan,6,0,30,24
1746614839574,PSYC 71,A01,959860,Staff,21,0,25,4
1746614840603,PSYC 100,A00,890690,Lacefield; Katharine I,0,50,180,180
1746614841628,PSYC 102,A00,890695,Staff,18,0,40,22
1746614842655,PSYC 105,A00,890699,Geller; Emma Harlan,70,0,100,30
1746614843682,PSYC 106,A00,890701,Gorman; Michael R.,5,0,30,25
1746614844709,PSYC 108,A00,890704,Adrian; Julia Anna,0,29,50,50
1746614845735,PSYC 118,A01,890712,Staff,11,0,30,19
1746614846761,PSYC 124,A00,890716,Chapman; Eddie Nathaniel,25,0,60,35
1746614847788,PSYC 131,A00,890717,Anagnostaras; Stephan,0,7,80,80
1746614848817,PSYC 137,A00,890719,Winkielman; Piotr,0,11,30,30
1746614849847,PSYC 144,A00,890721,Adrian; Julia Anna,0,9,45,45
1746614850878,PSYC 162,A00,890805,Staff,0,2,75,75
1746614851907,PSYC 169,A00,890810,Staff,0,15,30,30
1746614852934,PSYC 172,A00,890814,Gorman; Michael R.,9,0,30,21
1746614853960,PSYC 181,A00,890818,Anagnostaras; Stephan,6,0,200,194
1746614854991,PSYC 184,A00,959861,Staff,160,0,175,15
1746614856018,PSYC 189,A00,890823,Staff,0,2,30,30
1746614857046,PSYC 191,A00,890884,Rickard; Timothy C.,0,12,35,35
1746614858075,PSYC 193,A00,890913,Staff,19,0,30,11
1746614858075,PSYC 193,B00,890914,Chapman; Eddie Nathaniel,24,0,30,6
1746614859103,PSYC 193L,A01,890918,Lowe; Angela Beth,20,0,30,10
1746614859103,PSYC 193L,B01,890921,Hurwitz; Ethan Scott,20,0,30,10
1746614859103,PSYC 193L,C01,890928,Staff,30,0,30,0
1746614860130,RELI 149,A00,886806,Rahimi; Babak,23,0,40,17
1746614861156,SE 9,A01,886814,Staff,7,0,20,13
1746614862190,SE 101B,A01,886816,Chadha; Mayank,3,0,35,32
1746614863219,SE 110B,A00,886818,Zhu; Qiang,4,0,75,71
1746614864250,SE 125,A01,886830,Staff,10,0,30,20
1746614865275,SE 130B,A01,886835,Staff,14,0,40,26
1746614866304,SE 131A,A01,886838,Krysl; Petr,34,0,55,21
1746614867332,SE 154,A00,886840,Staff,28,0,50,22
1746614868361,SE 164GS,A01,886849,Staff,6,0,20,14
1746614869386,SE 167GS,A01,886853,Staff,6,0,20,14
1746614870414,SIO 25,A01,890107,Staff,19,0,30,11
1746614871442,SIO 45,A00,890109,Cook; Geoffrey W,114,0,200,86
1746614872469,SIO 109R,A00,890110,Forman; Fonna,0,16,20,20
1746614873501,SIO 187,A01,890114,Kacev; David,15,0,40,25
1746614874529,SOCI 1,A01,890431,Thorpe; Charles Robert,14,0,30,16
1746614874529,SOCI 1,A02,890518,Thorpe; Charles Robert,30,0,30,0
1746614875566,SOCI 2,A01,957978,Staff,25,0,25,0
1746614875566,SOCI 2,A02,957979,Staff,23,0,25,2
1746614876592,SOCI 20,A01,890523,Calderon-Zaks; Michael Aar,21,0,30,9
1746614876592,SOCI 20,A02,890526,Calderon-Zaks; Michael Aar,29,0,30,1
1746614877619,SOCI 30,A01,890533,Pardo Guerra; Juan Pablo,37,0,40,3
1746614878647,SOCI 40,A01,890535,Staff,27,0,45,18
1746614879674,SOCI 104Q,A00,890559,Staff,17,0,30,13
1746614880701,SOCI 106,A00,890560,Arnal; Maud Marie Leonie,20,0,30,10
1746614881731,SOCI 110,A00,890567,Holkenbrink-Monk; Charlene,19,0,30,11
1746614882764,SOCI 112,A00,890568,Victoria Torres; Pablo,2,0,55,53
1746614883790,SOCI 115,A00,890597,Arnal; Maud Marie Leonie,28,0,45,17
1746614885845,SOCI 121,A00,890604,Pardo Guerra; Juan Pablo,38,0,45,7
1746614886872,SOCI 126,A01,890608,Staff,8,0,10,2
1746614887900,SOCI 127,A00,890609,Staff,18,0,30,12
1746614888926,SOCI 131,A00,890610,Thorpe; Charles Robert,37,0,45,8
1746614889953,SOCI 135,A00,890615,Payne; Christine Anna,14,0,45,31
1746614890979,SOCI 139,A00,890620,Staff,38,0,45,7
1746614892006,SOCI 148E,A00,890622,Calderon-Zaks; Michael Aar,36,0,45,9
1746614893033,SOCI 150,A00,890623,Kohler; Kristopher M.,31,0,45,14
1746614894117,SOCI 157,A00,890625,Jules-Rosette; Bennetta W.,18,0,20,2
1746614895144,SOCI 160,A00,890627,Payne; Christine Anna,21,0,45,24
1746614896173,SYN 1,A00,886855,Fish; Gwendolyn Anne,0,1,0,0
1746614896173,SYN 1,B00,906086,Fish; Gwendolyn Anne,0,2,0,2
1746614897202,SYN 2R,A00,886860,Staff,0,17,15,15
1746614897202,SYN 2R,B00,906106,Atkinson; Arthur Laird,0,16,15,15
1746614898238,SYN 100,A01,886866,Browne; Emily,0,28,20,20
1746614898238,SYN 100,B01,906128,Rock; Martin,0,4,20,20
1746614898238,SYN 100,C01,906140,Deavenport; James Cary,0,4,20,20
1746614898238,SYN 100,D01,907816,Deavenport; James Cary,0,5,20,20
1746614899265,TDAC 1,A00,890286,Walsh; Kim C.,7,0,20,13
1746614900292,TDAC 101,A00,890296,Basso; Beatrice,15,0,20,5
1746614901319,TDDE 131,A00,890297,Staff,47,0,50,3
1746614902346,TDDM 1,A00,890287,Weinberg; Sadie,25,0,30,5
1746614903375,TDGE 11,A00,890288,Fulton; Julia,138,0,200,62
1746614903375,TDGE 11,B00,890289,Castro; Robert Jess,184,0,200,16
1746614904400,TDGE 25,B00,957359,Walsh; Kim C.,5,0,20,15
1746614905432,TDGE 40,A01,890292,Power; Jade Yukana,26,0,30,4
1746614906461,TDGE 124,A00,890298,Havis; Allan,0,2,50,50
1746614907490,TDGE 131R,A00,890299,Burelle; Julie Sara Veronique,15,0,42,27
1746614908518,TDHT 101,A00,890300,Staff,10,0,20,10
1746614909548,TDHT 109,A01,890302,Anderson; Mysia Anyse,31,0,40,9
1746614910574,TDMV 1,A00,890293,Arcidiacono; Kristin,18,0,30,12
1746614911601,TDMV 2,A00,890294,Weinberg; Sadie,23,0,30,7
1746614912627,TDMV 3,A00,957878,Arcidiacono; Kristin,28,0,30,2
1746614914679,TDMV 138,A00,890304,Jun; Grace Shin Hae,25,0,40,15
1746614915705,TDMV 140,A00,890305,Corrales; Joseph Bernales,25,0,30,5
1746614916732,TDMV 142,A00,890307,Caligagan; Tony,32,0,40,8
1746614917760,TDMV 144,A00,890308,Camaya; Michelle Ann,25,0,30,5
1746614918788,TDPW 1,A00,890295,Stein; Deborah Isobel,3,0,20,17
1746614919815,USP 2,A01,890272,Lerner; Amy M,7,0,20,13
1746614920846,USP 3,A01,890274,Staff,12,0,30,18
1746614921876,USP 15,A01,890276,Sun; Feiyang,16,0,30,14
1746614922905,USP 25,A00,890277,Shenkman; Michael Thomas,18,0,25,7
1746614923932,USP 138,A00,890278,Staff,13,0,25,12
1746614924962,USP 143,A00,890279,Staff,21,0,70,49
1746614925993,USP 144,A00,890280,Chowdhury; Muhammed Zohir,16,0,30,14
1746614927023,USP 150,A00,890281,Boomhower; Matthew Charles,4,0,30,26
1746614928055,USP 151,A00,890282,Staff,16,0,20,4
1746614929082,USP 162,A00,890283,Andrews; Abigail Leslie,16,0,20,4
1746614930114,USP 168,A00,920477,Kwak; Nancy,0,0,5,5
1746614931142,USP 181,A00,890284,Staff,3,0,20,17
1746614932173,USP 191A,A00,890285,Staff,12,0,20,8
1746614933200,VIS 101,A00,886512,Staff,26,0,75,49
1746614934228,VIS 103,A00,886513,Cruz; Edwin Teddy,61,0,75,14
1746614935258,VIS 108,A00,886514,Staff,4,0,15,11
1746614936286,VIS 127P,A00,886515,Shen; Kuiyi,80,0,146,66
1746614937313,VIS 149,A00,886516,Yoldas; Pinar,0,0,15,15
1746614938339,VIS 164,A00,886526,Erdmann; Dean,19,0,22,3
1746614939375,VIS 194S,A00,886527,Staff,61,0,75,14
1746614940404,WCWP 10A,C00,886484,Martiniuk; Jill,12,0,15,3
1746614941431,WCWP 10B,A00,886490,Uriarte; Emma,0,0,15,15
1746614941431,WCWP 10B,B00,886491,Dhir; Simrita,8,0,15,7
1746614941431,WCWP 10B,C00,886492,Ornelas; Tricia,0,0,15,15
1746614942458,WCWP 100,A00,886494,Young; Mark T,0,6,15,15
1746614944681,AAS 10,A01,886199,Childs; Dennis R.,0,3,0,0
1746614945709,ANAR 104,A01,886940,Shtienberg; Gilad,27,0,30,3
1746614946736,ANAR 120,A00,886953,Staff,13,0,20,7
1746614947763,ANBI 148,A01,886955,Wilder; Linnea Lorene,30,0,40,10
1746614949816,ANSC 122,A00,886957,Staff,24,0,30,6
1746614950845,ANSC 150,A00,886958,Sloane; Julia Kathryn,2,0,15,13
1746614951875,ANSC 156,A00,886959,Jenkins; Janis A.,0,1,15,15
1746614952905,ANSC 180,A00,886960,Staff,11,0,17,6
1746614953935,ANSC 188,A00,886961,Jassal; Aftab,9,0,25,16
1746614954961,ANSC 190,A00,886962,Jassal; Aftab,14,0,25,11
1746614955986,ANSC 191,A00,886963,Staff,18,0,20,2
1746614957014,ANTH 3,A01,891689,Staff,17,0,20,3
1746614958043,ANTH 5,A00,886933,Semendeferi; Ekaterini,16,0,20,4
1746614959069,ANTH 10,A00,886934,Staff,0,12,30,30
1746614960099,ANTH 21,A01,886936,Staff,41,0,60,19
1746614961129,ANTH 23,A01,886938,Staff,92,0,100,8
1746614962157,ANTH 105,A00,886964,Stewart; Alexander B,84,0,100,16
1746614963237,ANTH 108,A00,886965,Pedersen; David,9,0,20,11
1746614964276,AWP 10,001,886147,Staff,0,0,0,0
1746614964276,AWP 10,002,886148,Staff,0,0,0,0
1746614964276,AWP 10,003,886149,Staff,0,0,0,0
1746614964276,AWP 10,004,886150,Staff,0,0,0,0
1746614964276,AWP 10,005,886151,Staff,0,0,0,0
1746614964276,AWP 10,006,886152,Staff,0,0,0,0
1746614964276,AWP 10,007,886153,Staff,0,0,0,0
1746614964276,AWP 10,008,886154,Staff,0,0,0,0
1746614964276,AWP 10,009,886155,Staff,0,0,0,0
1746614964276,AWP 10,010,886156,Staff,0,0,0,0
1746614964276,AWP 10,011,886158,Staff,0,0,0,0
1746614964276,AWP 10,012,886160,Staff,0,0,0,0
1746614964276,AWP 10,013,886161,Staff,0,0,0,0
1746614964276,AWP 10,014,886162,Staff,0,0,0,0
1746614964276,AWP 10,015,886163,Staff,0,0,0,0
1746614964276,AWP 10,016,886164,Staff,0,0,0,0
1746614964276,AWP 10,017,886165,Staff,0,0,0,0
1746614964276,AWP 10,018,886166,Staff,0,0,0,0
1746614964276,AWP 10,019,886168,Staff,0,0,0,0
1746614964276,AWP 10,020,886170,Staff,0,0,0,0
1746614964276,AWP 10,021,886172,Staff,0,0,0,0
1746614965319,AWP 10R,001,886173,Staff,0,1,0,0
1746614965319,AWP 10R,002,886174,Staff,0,1,0,0
1746614965319,AWP 10R,003,886175,Staff,0,0,0,0
1746614965319,AWP 10R,004,886176,Staff,0,0,0,0
1746614965319,AWP 10R,005,886177,Staff,0,0,0,0
1746614965319,AWP 10R,006,886178,Staff,0,0,0,0
1746614965319,AWP 10R,007,886179,Staff,0,0,0,0
1746614965319,AWP 10R,008,886181,Staff,0,0,0,0
1746614965319,AWP 10R,009,886182,Staff,0,0,0,0
1746614965319,AWP 10R,010,886183,Staff,0,0,0,0
1746614965319,AWP 10R,011,886184,Staff,0,0,0,0
1746614965319,AWP 10R,012,886185,Staff,0,0,0,0
1746614965319,AWP 10R,013,886186,Staff,0,0,0,0
1746614965319,AWP 10R,014,886187,Staff,0,0,0,0
1746614965319,AWP 10R,015,886188,Staff,0,0,0,0
1746614965319,AWP 10R,016,886189,Staff,0,0,0,0
1746614965319,AWP 10R,017,960532,Staff,0,0,0,0
1746614965319,AWP 10R,018,960533,Staff,0,0,0,0
1746614965319,AWP 10R,019,960534,Staff,0,0,0,0
1746614965319,AWP 10R,020,960538,Staff,0,0,0,0
1746614965319,AWP 10R,021,960540,Staff,0,0,0,0
1746614965319,AWP 10R,022,960541,Staff,0,0,0,0
1746614965319,AWP 10R,023,960542,Staff,0,0,0,0
1746614965319,AWP 10R,024,960544,Staff,0,0,0,0
1746614965319,AWP 10R,025,960545,Staff,0,0,0,0
1746614965319,AWP 10R,026,960548,Staff,0,0,0,0
1746614966353,AWP 102R,A00,886190,Staff,0,0,0,0
1746614966353,AWP 102R,B00,886191,Staff,0,0,0,0
1746614967377,BENG 100,A01,886193,Staff,17,0,30,13
1746614968408,BENG 122A,A01,886195,Hasty; Jeff M,13,0,30,17
1746614969435,BENG 166A,A00,886196,Sah; Robert Lie-Yuan,0,3,30,30
1746614970463,BENG 190,A00,958050,Khojah; Reem I,17,0,25,8
1746614971490,BIBC 102,A01,894320,Staff,0,1,46,46
1746614971490,BIBC 102,A02,894321,Staff,0,0,46,46
1746614971490,BIBC 102,A03,894344,Staff,6,0,46,40
1746614971490,BIBC 102,A04,894345,Staff,27,0,47,20
1746614972524,BICD 100R,A01,894365,Smith; Laurie,0,2,58,58
1746614972524,BICD 100R,A02,894366,Smith; Laurie,0,4,58,58
1746614972524,BICD 100R,A03,894367,Smith; Laurie,0,0,59,59
1746614972524,BICD 100R,A04,959869,Smith; Laurie,38,0,59,21
1746614973556,BICD 136,A01,894383,Gustafson-Brown; Cindy,14,0,50,36
1746614974590,BIEB 102,A01,894494,Butler; Shannon Rhey,51,0,130,79
1746614976654,BIEB 150,A01,894617,Wills; Christopher,3,0,20,17
1746614976654,BIEB 150,A02,894631,Wills; Christopher,3,0,20,17
1746614976654,BIEB 150,A03,894937,Wills; Christopher,3,0,20,17
1746614976654,BIEB 150,A04,894946,Wills; Christopher,5,0,20,15
1746614977682,BIEB 194,A00,906141,Kurle; Carolyn M.,5,0,20,15
1746614978710,BILD 1,A01,894154,Staff,3,0,19,16
1746614978710,BILD 1,A02,894155,Staff,14,0,19,5
1746614978710,BILD 1,A03,894160,Staff,13,0,19,6
1746614978710,BILD 1,A04,894161,Staff,15,0,18,3
1746614979738,BILD 2,A01,894168,Staff,0,0,50,50
1746614979738,BILD 2,A02,894169,Staff,0,0,50,50
1746614979738,BILD 2,A03,894179,Staff,0,0,50,50
1746614979738,BILD 2,A04,894203,Staff,22,0,50,28
1746614980765,BILD 3,A01,894213,Staff,23,0,31,8
1746614980765,BILD 3,A02,894214,Staff,26,0,31,5
1746614980765,BILD 3,A03,894235,Staff,28,0,31,3
1746614980765,BILD 3,A04,894236,Staff,28,0,32,4
1746614981796,BILD 4,A01,894253,Reuther; Keefe,5,0,24,19
1746614981796,BILD 4,A02,894258,Reuther; Keefe,16,0,24,8
1746614982828,BILD 5,A01,894276,Reuther; Keefe,33,0,50,17
1746614982828,BILD 5,A02,894277,Reuther; Keefe,45,0,50,5
1746614982828,BILD 5,A03,894290,Reuther; Keefe,44,0,50,6
1746614982828,BILD 5,A04,894291,Reuther; Keefe,48,0,50,2
1746614983855,BILD 24,A01,894297,Pirino; Giorgia,40,0,60,20
1746614984884,BIMM 100,B01,958915,Staff,71,0,100,29
1746614985916,BIMM 101,A01,895017,McDonnell; Lisa Marie,0,5,24,24
1746614985916,BIMM 101,A02,895018,McDonnell; Lisa Marie,0,5,24,24
1746614985916,BIMM 101,B01,895020,McDonnell; Lisa Marie,0,5,24,24
1746614985916,BIMM 101,B02,895021,McDonnell; Lisa Marie,0,4,24,24
1746614986944,BIMM 110,A01,895023,Staff,1,0,25,24
1746614986944,BIMM 110,A02,895024,Staff,9,0,25,16
1746614986944,BIMM 110,A03,895025,Staff,18,0,25,7
1746614986944,BIMM 110,A04,895031,Staff,20,0,25,5
1746614987975,BIMM 120,A01,895114,Gustafson-Brown; Cindy,14,0,28,14
1746614987975,BIMM 120,A02,895126,Gustafson-Brown; Cindy,21,0,27,6
1746614989000,BIPN 100,A01,895130,Yang; Mingyu,0,0,38,38
1746614989000,BIPN 100,A02,895131,Yang; Mingyu,31,0,38,7
1746614989000,BIPN 100,A03,895132,Yang; Mingyu,32,0,38,6
1746614989000,BIPN 100,A04,895133,Yang; Mingyu,27,0,36,9
1746614990036,BIPN 120,A01,895135,Cooke; James Edward,0,3,13,13
1746614990036,BIPN 120,A02,895136,Cooke; James Edward,0,1,13,13
1746614990036,BIPN 120,A03,895137,Cooke; James Edward,0,3,13,13
1746614990036,BIPN 120,A04,895156,Cooke; James Edward,0,2,11,11
1746614991065,BIPN 134,A01,895235,Cooke; James Edward,0,1,25,25
1746614991065,BIPN 134,A02,895237,Cooke; James Edward,0,0,25,25
1746614991065,BIPN 134,A03,895240,Cooke; James Edward,1,0,25,24
1746614991065,BIPN 134,A04,895270,Cooke; James Edward,20,0,25,5
1746614992095,BIPN 189,A00,892103,Staff,0,14,14,14
1746614994154,BISP 194,A00,958008,Staff,0,2,0,0
1746614995182,CAT 124,A01,922009,Staff,0,5,20,20
1746614996220,CAT 125R,A00,886390,Morales; Celeste Georgianna,0,4,20,20
1746614996220,CAT 125R,B00,886391,Irwin; Matthew Joseph,0,4,20,20
1746614996220,CAT 125R,C00,886392,Smith; Lauryn Alissa,0,2,20,20
1746614996220,CAT 125R,D00,886393,Vanderschuit; Maya Alysia,0,3,20,20
1746614996220,CAT 125R,E00,886394,Marchisotto; Jennifer Anne,0,3,20,20
1746614997245,CENG 15,A01,886218,Drews; Aaron,3,0,8,5
1746614998273,CENG 113,A00,886219,Opatkiewicz; Justin Paul,15,0,25,10
1746614999300,CGS 101,A00,887044,Staff,7,0,20,13
1746615000325,CGS 105,A01,887046,Staff,14,0,25,11
1746615001352,CGS 112,A00,887047,Cuong; Marisol,12,0,15,3
1746615002377,CGS 113,A00,887048,Staff,23,0,30,7
1746615003403,CGS 120,A00,887049,Staff,9,0,17,8
1746615004438,CHEM 6A,A01,886336,Lam; Tin Yiu,38,0,50,12
1746615004438,CHEM 6A,A02,886338,Lam; Tin Yiu,37,0,50,13
1746615005473,CHEM 6B,A01,886341,Hopkins; Patrycja Anna,16,0,50,34
1746615005473,CHEM 6B,A02,886343,Hopkins; Patrycja Anna,42,0,50,8
1746615006505,CHEM 6C,A01,886346,Albizati; Kim F.,0,2,50,50
1746615006505,CHEM 6C,A02,886348,Albizati; Kim F.,24,0,50,26
1746615007534,CHEM 40A,A01,886352,Klosterman; Jeremy K,65,0,100,35
1746615008564,CHEM 40B,A01,886356,Klosterman; Jeremy K,0,24,100,100
1746615009598,CHEM 41B,A01,886360,Theodorakis; Emmanuel,25,0,50,25
1746615009598,CHEM 41B,A02,886362,Theodorakis; Emmanuel,47,0,50,3
1746615010627,CHIN 165A,A00,886382,Xu; Li,18,0,20,2
1746615011654,CLAS 120,A00,886387,Myerston Santana; Jacobo,33,0,40,7
1746615012686,COGS 9,A01,886967,Shannon; Kyle Michael,42,0,60,18
1746615013714,COGS 11,A01,886969,Staff,9,0,30,21
1746615014739,COGS 14A,A01,886971,Staff,5,0,60,55
1746615015768,COGS 14B,A01,886973,Hoffman; Drew Ellen,4,0,60,56
1746615016796,COGS 18,A01,886975,Morgan; Eric,34,0,60,26
1746615017823,COGS 20,A01,886977,Staff,3,0,8,5
1746615017823,COGS 20,A02,886978,Staff,5,0,7,2
1746615018855,COGS 100,A01,907783,Staff,0,1,30,30
1746615019882,COGS 101B,A01,886980,Staff,0,4,48,48
1746615020912,COGS 101C,A01,886982,Delgado; Tania,0,5,44,44
1746615021940,COGS 102A,A01,886984,Johnson; Christine M.,3,0,30,27
1746615022969,COGS 118B,A01,886986,Staff,0,4,88,88
1746615023998,COGS 150,A01,886988,Bergen; Benjamin,22,0,50,28
1746615025025,COGS 153,A00,886989,Delgado; Tania,1,3,41,40
1746615026052,COGS 186,A01,886991,Staff,0,0,32,32
1746615027078,COGS 187A,A01,886993,Boyle; Mary E. T.,7,0,30,23
1746615028121,COGS 189,A00,886994,Staff,1,1,30,29
1746615029147,COMM 10,A01,886996,Staff,0,0,20,21
1746615029147,COMM 10,A02,886997,Staff,10,0,20,10
1746615029147,COMM 10,A03,959845,Staff,19,0,20,1
1746615030174,COMM 20,A01,886999,Leuning; Grant Maurstad,24,0,40,16
1746615032226,COMM 100A,A01,887002,Staff,0,0,20,25
1746615032226,COMM 100A,A02,887003,Staff,5,0,20,15
1746615033294,COMM 100B,A01,887005,Staff,0,8,20,24
1746615034319,COMM 106D,A00,887006,Staff,14,0,40,26
1746615035346,COMM 110G,A00,887007,Whitworth-Smith; Andrew C,12,0,40,28
1746615036376,COMM 111B,A00,887008,Staff,31,0,40,9
1746615037401,COMM 113T,A00,887009,Abuelhiga; Soraya Jill,28,0,40,12
1746615037401,COMM 113T,B00,906733,Staff,39,0,40,1
1746615038426,COMM 145,A00,887010,Staff,13,0,40,27
1746615039456,COMM 146,A00,887054,Staff,32,0,40,8
1746615040481,COMM 190,A00,887012,Staff,8,0,23,15
1746615041511,CSE 8A,A50,887015,Cao; Yingjun,56,0,85,29
1746615042539,CSE 11,A01,887017,Cao; Yingjun,11,0,70,59
1746615043570,CSE 20,A01,887019,Staff,30,0,50,20
1746615044601,CSE 21,A01,887021,Staff,79,0,100,21
1746615044601,CSE 21,B01,892583,Braun; Oliver,45,0,50,5
1746615045630,CSE 30,A01,887025,Eldon; John,142,0,200,58
1746615046657,CSE 100,A01,887027,Staff,26,0,50,24
1746615046657,CSE 100,A02,887028,Staff,42,0,50,8
1746615047685,CSE 101,A01,887030,Braun; Oliver,74,0,100,26
1746615047685,CSE 101,B01,887032,Jones; Miles E,0,3,50,50
1746615047685,CSE 101,B02,887033,Jones; Miles E,0,2,50,50
1746615048713,CSE 105,A01,908084,Jones; Miles E,32,0,50,18
1746615048713,CSE 105,A02,908087,Jones; Miles E,31,0,50,19
1746615049740,CSE 135,A01,887035,Powell; Thomas Allan,0,5,50,50
1746615050766,CSE 142,A01,887037,Staff,7,0,60,53
1746615051790,CSE 142L,A01,887039,Staff,34,0,60,26
1746615052822,CSE 151A,A01,887041,Solares; Edwin A,47,0,100,53
1746615053849,CSE 175,A01,887043,Kumar; Rakesh,30,0,30,0
1746615054874,CSS 1,A01,886389,Staff,0,1,40,40
1746615055902,DSC 30,A01,908097,Liao; Soohyun Nam,47,0,75,28
1746615056932,DSC 40A,A01,908099,Shannon; Kyle Michael,30,0,50,20
1746615057960,DSC 40B,A01,908112,Staff,15,0,50,35
1746615058986,DSC 80,A01,908116,Staff,19,0,60,41
1746615060018,DSC 197,001,956863,Eldridge; Justin Matthew,9999,0,9999,0
1746615061050,ECE 5,A01,886400,Morris; Karcher William,1,0,6,5
1746615061050,ECE 5,A02,886401,Morris; Karcher William,3,0,6,3
1746615062079,ECE 148,A01,886403,Silberman; Jack,0,14,14,14
1746615063106,ECON 1,A01,887265,Crane; Meredith Helen,11,0,70,59
1746615063106,ECON 1,B01,887268,Staff,42,0,50,8
1746615064136,ECON 2,A01,887273,Crane; Meredith Helen,54,0,70,16
1746615065163,ECON 3,A01,887279,Rondina; Giacomo,31,0,70,39
1746615066194,ECON 4,A01,887282,Anderson; John Charles,0,2,10,10
1746615067222,ECON 5,A01,887285,Staff,34,0,45,11
1746615067222,ECON 5,B01,887292,Staff,41,0,45,4
1746615068261,ECON 100A,A01,887337,Newhouse; Herbert S,54,0,70,16
1746615068261,ECON 100A,B01,887349,Staff,45,0,50,5
1746615069290,ECON 100B,A01,887361,Du; Songzi,29,0,70,41
1746615070318,ECON 100C,A01,887445,Newhouse; Herbert S,59,0,70,11
1746615071345,ECON 105,A00,887488,Vespa; Emanuel Ignacio,23,0,35,12
1746615072375,ECON 109,A01,887506,Shishkin; Denis,28,0,35,7
1746615073403,ECON 110A,A01,887568,Alon; Titan Michael,0,2,35,35
1746615073403,ECON 110A,B01,907601,Alon; Titan Michael,20,0,35,15
1746615074435,ECON 110B,A01,887598,Levkoff; Steven B.,0,24,70,70
1746615075461,ECON 112,A00,887599,Rondina; Giacomo,19,0,35,16
1746615076487,ECON 120A,A01,887603,Dai; Yinlin,36,0,70,34
1746615077515,ECON 120C,A01,887608,Sun; Yixiao,0,1,35,35
1746615077515,ECON 120C,B01,887614,Sun; Yixiao,0,0,35,35
1746615078541,ECON 138,A00,887621,Bharadwaj; Prashant,0,21,20,20
1746615079570,ECON 144,A00,958007,Squires; Dale E,11,0,35,24
1746615080598,ECON 171,A01,907666,Staff,18,0,35,17
1746615081625,ECON 175,A00,887626,Wu; Pak Yeung,22,0,35,13
1746615082652,ECON 190,A00,887640,Vespa; Emanuel Ignacio,22,0,35,13
1746615083703,EDS 25,A01,888197,Staff,0,0,0,0
1746615083703,EDS 25,A02,888209,Staff,0,0,0,0
1746615083703,EDS 25,A03,888210,Staff,0,0,0,0
1746615083703,EDS 25,A04,888212,Staff,0,0,0,0
1746615083703,EDS 25,A05,888213,Staff,0,0,0,0
1746615083703,EDS 25,A06,888214,Staff,0,0,0,0
1746615083703,EDS 25,A07,888235,Staff,0,2,0,0
1746615083703,EDS 25,A08,888236,Staff,0,0,0,0
1746615083703,EDS 25,A09,888240,Staff,0,0,0,0
1746615083703,EDS 25,A10,888244,Staff,0,0,0,0
1746615083703,EDS 25,B01,888273,Staff,0,0,0,0
1746615083703,EDS 25,B02,888285,Staff,0,0,0,0
1746615083703,EDS 25,B03,888423,Staff,0,0,0,1
1746615083703,EDS 25,B04,888432,Staff,0,0,0,0
1746615083703,EDS 25,B05,888433,Staff,0,0,0,0
1746615083703,EDS 25,B06,888467,Staff,0,0,0,0
1746615083703,EDS 25,B07,888468,Staff,0,0,0,0
1746615083703,EDS 25,B08,888479,Staff,0,0,0,0
1746615083703,EDS 25,B09,888484,Staff,0,0,0,0
1746615083703,EDS 25,B10,888487,Staff,0,0,0,0
1746615084729,EDS 38,A01,907700,Choi; Bailey Miyeon,30,0,30,0
1746615085799,EDS 112,A01,888601,Chapman; Thandeka K,12,0,40,28
1746615086827,EDS 115,A00,888697,Mendez; Kathrina Mendoza,10,0,30,20
1746615087859,EDS 116,A01,888893,Staff,33,0,40,7
1746615089920,EDS 124AR,A00,889133,Staff,29,0,50,21
1746615089920,EDS 124AR,B00,907471,Simon; Elizabeth A,37,0,50,13
1746615090950,EDS 124BR,A00,889134,Simon; Elizabeth A,44,0,100,56
1746615091978,EDS 125,A00,889135,Staff,25,0,30,5
1746615093003,EDS 126,A01,889138,Staff,35,0,40,5
1746615094034,EDS 164R,A01,889142,Wishard Guerra; Alison G.,32,0,50,18
1746615095063,ENG 30,A01,886396,Staff,0,0,0,0
1746615095063,ENG 30,B01,886398,Staff,0,0,0,0
1746615096089,ENVR 102,A00,906150,Montejo; Carolina,23,0,25,2
1746615097114,ETHN 103A,A00,887236,Man; Simeon S,0,2,0,0
1746615098143,ETHN 113,A00,887239,Staff,16,0,30,14
1746615099170,ETHN 116,A00,887240,Staff,16,0,25,9
1746615100200,ETHN 117,A00,887241,Choi; Esther Min,28,0,30,2
1746615101230,ETHN 118,A00,887243,Staff,24,0,30,6
1746615102264,ETHN 127,A00,887248,Cuong; Marisol,11,0,15,4
1746615103294,ETHN 139,A00,887250,Staff,7,0,10,3
1746615104324,ETHN 142,A00,887252,Staff,9,0,30,21
1746615105352,ETHN 161,A00,887253,Browne; Errol Tsekani,24,0,30,6
1746615106381,ETHN 163FR,A00,887255,Burelle; Julie Sara Veronique,0,0,5,5
1746615107409,GLBH 20,A00,889149,Elwardani; Nile Regina,8,0,42,34
1746615109471,GLBH 111,A01,889152,Burgos; Jose L.,17,0,17,0
1746615110502,GLBH 150,A00,889181,Sloane; Julia Kathryn,0,5,15,15
1746615112556,HDS 60,A01,886406,Warstadt; Melissa Fawn,72,0,80,8
1746615113583,HIAF 111,A00,889324,Gyamfi; Bright,25,0,32,7
1746615114610,HIEA 131,A00,889328,Staff,15,0,32,17
1746615115636,HIEA 144,A00,889333,Henry; Todd A.,26,0,32,6
1746615116667,HIEA 154,A00,889336,Henry; Todd A.,24,0,32,8
1746615117693,HIEU 106,A00,889339,Staff,22,0,32,10
1746615119762,HIEU 114,A00,889340,Staff,4,0,32,28
1746615120788,HIEU 135GS,A00,889342,Patterson; Patrick H.,0,0,1,24
1746615121815,HIEU 137,A00,889343,Edington; Claire Ellen,10,0,25,15
1746615122843,HIEU 148,A00,889345,Staff,14,0,32,18
1746615123868,HIEU 154,A00,889346,Biess; Frank Peter,21,0,32,11
1746615124895,HILA 102,A00,889351,Staff,12,0,32,20
1746615125922,HILD 2A,A01,889221,Lewandoski; Julia Mavis,0,8,32,32
1746615126948,HILD 7B,A01,889225,Man; Simeon S,0,12,32,32
1746615127975,HILD 7C,A01,889288,Alvarez; Luis A,0,14,32,32
1746615129001,HILD 30,A01,889323,Staff,0,5,32,32
1746615131055,HISC 119,A00,889383,Golan; Tal,20,0,32,12
1746615132080,HIUS 103,A00,889384,Man; Simeon S,0,0,32,32
1746615133108,HIUS 117,A00,919797,Kwak; Nancy,18,0,32,14
1746615134135,HIUS 142A,A00,919788,Staff,22,0,32,10
1746615136193,HIUS 149,A00,889386,Gyamfi; Bright,26,0,32,6
1746615137220,HIUS 155,A00,889387,Alvarez; Luis A,15,0,32,17
1746615138251,HUM 3,A01,886499,Caldwell; Michael Alan,19,0,50,31
1746615139279,HUM 3GS,A00,886500,Rodriguez; Bretton Sigfred,0,0,0,28
1746615140305,HUM 3R,A01,886502,Markman; Kristina,0,36,50,50
1746615141334,HUM 4,A01,886504,Crum; Matthew Stephen,23,0,50,27
1746615141334,HUM 4,B01,886506,West; Geoffrey Scott,17,0,50,33
1746615142359,HUM 4GS,A00,886507,Staff,0,0,0,19
1746615143387,HUM 5,A01,886509,Staff,31,0,50,19
1746615144413,HUM 5R,A01,886511,Zavodny; Tatiana Sophia,0,39,50,50
1746615145443,JAPN 180,A00,886407,Staff,16,0,40,24
1746615146471,LATI 50,A01,886409,Martin-Cabrera; Luis,3,0,22,19
1746615146471,LATI 50,A02,886410,Martin-Cabrera; Luis,19,0,22,3
1746615146471,LATI 50,A03,886411,Martin-Cabrera; Luis,21,0,22,1
1746615146471,LATI 50,A04,886412,Martin-Cabrera; Luis,8,0,22,14
1746615147502,LAWS 101,A00,907664,Staff,28,0,60,32
1746615148527,LIAB 1A,A00,889388,Saab; Dima,17,0,20,3
1746615149558,LIAB 1AX,A00,889389,El Cheddadi; Youniss,18,0,20,2
1746615150589,LIFR 1C,A00,889391,Van Moer; Vinciane G,8,0,20,12
1746615151619,LIFR 1CX,A00,889392,Van Moer; Vinciane G,7,0,20,13
1746615152652,LIFR 1D,A00,889393,Van Moer; Vinciane G,7,0,20,13
1746615153682,LIFR 1DX,A00,889394,Van Moer; Vinciane G,8,0,20,12
1746615154712,LIGN 7,A00,886923,Staff,25,0,50,25
1746615155744,LIGN 17,A00,886924,Kehler; Andrew Scott,126,0,150,24
1746615156772,LTAM 110,A00,889395,Staff,15,0,30,15
1746615157798,LTAM 110GS,A00,958010,Rodriguez; Bretton Sigfred,0,0,0,28
1746615158825,LTCH 101,A00,889397,Staff,23,0,25,2
1746615159855,LTCS 130,A00,889398,Staff,23,0,25,2
1746615160881,LTEA 138,A00,889399,Staff,24,0,40,16
1746615161908,LTEN 149,A00,889400,Wesling; Megan E.,0,3,25,25
1746615162934,LTEN 169,A00,889401,Staff,20,0,25,5
1746615163964,LTEN 180,A00,889402,Staff,10,0,15,5
1746615164990,LTEN 181,A00,889403,Staff,21,0,25,4
1746615166021,LTWL 100,A00,889404,Myerston Santana; Jacobo,2,0,25,23
1746615167050,LTWL 180GS,A00,889405,Staff,0,0,20,20
1746615168076,LTWL 181,A00,889406,Staff,16,0,25,9
1746615169107,LTWL 184,A00,889475,Mukherjee; Silpa,22,0,25,3
1746615170135,LTWR 102C,A00,889486,Staff,29,0,30,1
1746615171160,LTWR 115W,A00,889491,Staff,0,2,15,15
1746615172187,MAE 8,A01,886905,Staff,0,2,0,0
1746615173217,MAE 11,A00,886906,Bandaru; Prabhakar,0,7,50,50
1746615174242,MAE 20,A00,886907,Evdokimenko; Ekaterina,43,0,70,27
1746615175268,MAE 30B,A00,886909,Ghazinejad; Maziar,25,0,45,20
1746615176296,MAE 101B,A00,886910,Saintillan; David,30,0,45,15
1746615177326,MAE 105,A00,886911,Bandaru; Prabhakar,18,0,50,32
1746615178354,MAE 107,B00,958024,Staff,7,0,50,43
1746615179389,MAE 143B,A00,886913,Bewley; Thomas R,2,0,40,38
1746615180416,MAE 148,A01,886915,Silberman; Jack,0,3,14,14
1746615181444,MAE 160,A00,886916,Evdokimenko; Ekaterina,30,0,60,30
1746615182478,MATH 3C,A01,889681,Staff,0,2,30,30
1746615182478,MATH 3C,A02,960048,Staff,23,0,30,7
1746615183506,MATH 10A,A01,889760,Staff,26,0,30,4
1746615183506,MATH 10A,A02,889783,Staff,29,0,30,1
1746615184534,MATH 10B,A01,889785,Verstraete; Jacques Allan,1,0,35,34
1746615184534,MATH 10B,A02,889795,Verstraete; Jacques Allan,4,0,35,31
1746615184534,MATH 10B,B01,889797,Verstraete; Jacques Allan,3,0,35,32
1746615184534,MATH 10B,B02,889828,Verstraete; Jacques Allan,3,0,35,32
1746615185566,MATH 10C,A01,889849,Habib; Yousaf,8,0,30,22
1746615185566,MATH 10C,A02,889852,Habib; Yousaf,14,0,30,16
1746615185566,MATH 10C,A03,889853,Habib; Yousaf,22,0,30,8
1746615185566,MATH 10C,A04,889858,Habib; Yousaf,20,0,30,10
1746615185566,MATH 10C,B01,889861,Staff,1,0,30,29
1746615185566,MATH 10C,B02,889862,Staff,24,0,30,6
1746615185566,MATH 10C,B03,889863,Staff,27,0,30,3
1746615185566,MATH 10C,B04,889967,Staff,23,0,30,7
1746615186604,MATH 18,A01,889974,Staff,6,0,30,24
1746615186604,MATH 18,A02,889977,Staff,20,0,30,10
1746615186604,MATH 18,B01,889984,Hardiman; Liam,20,0,30,10
1746615186604,MATH 18,B02,889985,Hardiman; Liam,25,0,30,5
1746615187638,MATH 20A,A01,889990,Suk; Andrew Hoon,30,0,35,5
1746615188672,MATH 20B,A01,889993,Ohm; Ko Woon,21,0,30,9
1746615188672,MATH 20B,A02,889994,Ohm; Ko Woon,30,0,30,0
1746615188672,MATH 20B,B01,889996,Ohm; Ko Woon,22,0,30,8
1746615188672,MATH 20B,B02,889997,Ohm; Ko Woon,23,0,30,7
1746615189708,MATH 20C,A01,889999,Hammock; Frances H,17,0,30,13
1746615189708,MATH 20C,A02,890003,Hammock; Frances H,23,0,30,7
1746615189708,MATH 20C,B01,890006,Hammock; Frances H,2,0,30,28
1746615189708,MATH 20C,B02,890007,Hammock; Frances H,11,0,30,19
1746615190736,MATH 20D,A01,890011,Cheng; Hsiao-Bing,1,0,30,29
1746615190736,MATH 20D,A02,890012,Cheng; Hsiao-Bing,14,0,30,16
1746615190736,MATH 20D,B01,890016,Cheng; Hsiao-Bing,13,0,30,17
1746615190736,MATH 20D,B02,890017,Cheng; Hsiao-Bing,13,0,30,17
1746615191766,MATH 20E,A01,890026,Harel; Guershon,1,0,30,29
1746615191766,MATH 20E,A02,890029,Harel; Guershon,22,0,30,8
1746615191766,MATH 20E,B01,890033,Harel; Guershon,7,0,30,23
1746615191766,MATH 20E,B02,890101,Harel; Guershon,21,0,30,9
1746615192797,MATH 102,A01,890104,Staff,18,0,30,12
1746615192797,MATH 102,A02,890105,Staff,27,0,30,3
1746615193824,MATH 103B,A01,890116,Salehi Golsefidy; Alireza,3,0,30,27
1746615193824,MATH 103B,B01,890118,Staff,0,3,34,34
1746615194851,MATH 109,A01,890121,Aliabadi Sr.; Mohsen,0,0,30,30
1746615194851,MATH 109,B01,890124,Upadrashta; Pranav Kumar,18,0,30,12
1746615195881,MATH 120A,A01,890126,Eggers; John Dietrich,13,0,30,17
1746615196914,MATH 142B,A01,890128,Ioana; Adrian,19,0,30,11
1746615196914,MATH 142B,A02,890129,Ioana; Adrian,12,0,30,18
1746615197948,MATH 154,A01,890174,Staff,0,1,30,30
1746615197948,MATH 154,A02,890182,Staff,0,0,30,30
1746615198978,MATH 168A,A01,890197,Dumitriu; Ioana,21,0,35,14
1746615200007,MATH 170A,A01,890240,Nie; Jiawang,1,0,30,29
1746615200007,MATH 170A,A02,890241,Nie; Jiawang,11,0,30,19
1746615200007,MATH 170A,A03,890249,Nie; Jiawang,23,0,30,7
1746615201038,MATH 170B,A01,957891,Nag; Panchali,13,0,35,22
1746615203095,MATH 181A,A01,908025,Staff,0,3,35,35
1746615203095,MATH 181A,A02,960115,Staff,26,0,35,9
1746615204128,MATH 181B,A01,959874,Staff,24,0,30,6
1746615205155,MATH 193B,A01,890265,Staff,0,4,35,35
1746615206182,MGT 4,A01,890311,Anderson; John Charles,42,0,88,46
1746615207211,MGT 5,A00,907740,Staff,12,0,98,86
1746615208238,MGT 12,A00,890312,Lindenberger; Wade Douglas,67,0,98,31
1746615209266,MGT 16,A00,957883,Staff,78,0,98,20
1746615211324,MGT 45,A00,890314,Pecore; Joseph P.,45,0,98,53
1746615212353,MGT 71,A00,890315,Staff,0,12,98,98
1746615213386,MGT 100,A00,890316,Yavorsky; Daniel Ryan,44,0,98,54
1746615214432,MGT 103,A00,890317,Ehrich; Kristine R,73,0,98,25
1746615215458,MGT 105,A00,890356,Bates; Kenneth Walter,0,8,98,98
1746615216487,MGT 112,A00,890360,Ehrich; Kristine R,55,0,98,43
1746615217513,MGT 127R,A00,907732,Zhu; Kevin Xiaoguo,23,0,98,75
1746615218540,MGT 131B,A00,890361,Anderson; John Charles,59,0,98,39
1746615219573,MGT 137,A00,890362,Lindenberger; Wade Douglas,65,0,98,33
1746615220599,MGT 160,A00,890369,Johnson; Erik Barry,9,0,98,89
1746615222654,MGT 164,A00,890372,Zimmermann; Carsten,0,40,98,98
1746615223683,MGT 180,A00,890374,Bliss; Barbara Ann,11,0,98,87
1746615224711,MMW 15,A01,886414,Chang; Edmond Yi-Teh,0,12,28,28
1746615224711,MMW 15,A02,886415,Chang; Edmond Yi-Teh,0,8,28,28
1746615224711,MMW 15,A03,886416,Chang; Edmond Yi-Teh,0,9,28,28
1746615224711,MMW 15,A04,886417,Chang; Edmond Yi-Teh,0,8,28,28
1746615224711,MMW 15,B01,886419,Chang; Edmond Yi-Teh,0,7,28,28
1746615224711,MMW 15,B02,886420,Chang; Edmond Yi-Teh,0,7,28,28
1746615224711,MMW 15,B03,886421,Chang; Edmond Yi-Teh,0,7,28,28
1746615224711,MMW 15,B04,886422,Chang; Edmond Yi-Teh,0,8,28,28
1746615224711,MMW 15,C01,886424,Staff,0,9,28,28
1746615224711,MMW 15,C02,886425,Staff,0,8,28,28
1746615224711,MMW 15,C03,886426,Staff,0,8,28,28
1746615224711,MMW 15,C04,886427,Staff,0,8,28,28
1746615224711,MMW 15,C05,958038,Staff,0,8,28,28
1746615224711,MMW 15,C06,958039,Staff,0,7,28,28
1746615225739,MMW 15GS,A00,906910,Patterson; Patrick H.,4,0,28,24
1746615226768,MMW 122R,A01,886429,Rahimi; Babak,0,13,28,28
1746615226768,MMW 122R,A02,886430,Rahimi; Babak,0,12,28,28
1746615226768,MMW 122R,A03,958040,Rahimi; Babak,0,11,28,28
1746615227798,MUS 1A,A01,890937,Staff,2,0,25,23
1746615227798,MUS 1A,A02,891035,Staff,6,0,25,19
1746615227798,MUS 1A,C01,958912,Staff,24,0,25,1
1746615227798,MUS 1A,C02,958913,Staff,25,0,25,0
1746615229856,MUS 2AK,A00,957092,Ohnishi; Takae,15,0,15,0
1746615230883,MUS 4,A01,891044,Staff,0,0,25,25
1746615230883,MUS 4,A02,891045,Staff,22,0,25,3
1746615230883,MUS 4,B01,891048,Staff,17,0,25,8
1746615230883,MUS 4,B02,891050,Staff,25,0,25,0
1746615231920,MUS 5,A01,957506,Dubnov; Shlomo,0,0,25,25
1746615231920,MUS 5,A02,957622,Dubnov; Shlomo,12,0,25,13
1746615231920,MUS 5,A03,957623,Dubnov; Shlomo,20,0,25,5
1746615232946,MUS 6,A01,891053,Freitas Caetano; Marcelo,24,0,25,1
1746615232946,MUS 6,A02,891054,Freitas Caetano; Marcelo,23,0,25,2
1746615233978,MUS 7,A01,891081,Staff,0,0,25,25
1746615233978,MUS 7,A02,891082,Staff,3,0,25,22
1746615235006,MUS 8GS,A00,891118,Borgo; David Garcia,1,0,25,24
1746615236033,MUS 11,A01,891140,Staff,8,0,25,17
1746615236033,MUS 11,A02,891141,Staff,21,0,25,4
1746615237064,MUS 13,A01,891143,Staff,8,0,25,17
1746615237064,MUS 13,A02,891144,Staff,24,0,25,1
1746615238092,MUS 15,A01,891146,Staff,9,0,25,16
1746615238092,MUS 15,A02,891148,Staff,21,0,25,4
1746615238092,MUS 15,B01,891150,Staff,18,0,25,7
1746615238092,MUS 15,B02,891151,Staff,25,0,25,0
1746615239122,MUS 20,A01,891153,Staff,5,0,20,15
1746615239122,MUS 20,A02,891155,Staff,14,0,20,6
1746615240149,MUS 80,A00,891156,Staff,19,0,25,6
1746615240149,MUS 80,B00,891157,Staff,23,0,25,2
1746615241175,MUS 130,A00,891158,Ohnishi; Takae,35,0,35,0
1746615242202,MUS 150GS,A01,891160,Borgo; David Garcia,1,0,25,24
1746615243228,MUS 170,A01,891162,Freitas Caetano; Marcelo,20,0,25,5
1746615243228,MUS 170,A02,891164,Freitas Caetano; Marcelo,21,0,25,4
1746615244255,NANO 11,A00,886220,Vazquez Mena; Oscar,13,0,15,2
1746615245283,NANO 15,A01,886222,Drews; Aaron,4,0,7,3
1746615246310,NANO 104,A00,886224,Sirbuly; Donald,17,0,25,8
1746615247335,PH 40,A00,886528,Staff,23,0,40,17
1746615248369,PH 45,A01,886799,Staff,35,0,40,5
1746615249396,PH 110,A00,886802,Staff,0,6,40,40
1746615250423,PH 172,A00,906716,Staff,19,0,35,16
1746615251450,PH 191,A00,886803,Staff,6,0,40,34
1746615252477,PHIL 1,A00,889500,Staff,20,0,30,10
1746615253511,PHIL 10,A01,889549,Grush; Rick Scott,16,0,22,6
1746615253511,PHIL 10,A02,889551,Grush; Rick Scott,22,0,22,0
1746615254544,PHIL 28,A01,889559,Lamey; Andy M.,0,2,31,31
1746615254544,PHIL 28,A02,889561,Lamey; Andy M.,0,1,30,30
1746615254544,PHIL 28,A03,889572,Lamey; Andy M.,0,1,30,30
1746615255571,PHIL 35,A00,907839,Staff,13,0,15,2
1746615256599,PHIL 60,A00,889574,Staff,73,0,90,17
1746615257624,PHIL 101,A00,958004,Staff,12,0,15,3
1746615259682,PHIL 136,A00,889582,Fulkerson; Matthew Todd,26,0,45,19
1746615260717,PHIL 163,A01,889601,Staff,21,0,30,9
1746615260717,PHIL 163,B01,889606,Brandt; Reuven A,0,3,0,0
1746615261746,PHIL 164,A00,889610,Staff,16,0,30,14
1746615262772,PHIL 165,A00,889613,Staff,22,0,30,8
1746615263803,PHYS 1A,A00,886431,Staff,30,0,70,40
1746615264830,PHYS 1AL,001,886432,Tsai; Philbert S,0,1,30,30
1746615264830,PHYS 1AL,002,886436,Tsai; Philbert S,13,0,30,17
1746615265857,PHYS 1B,A00,886439,Staff,184,0,240,56
1746615266883,PHYS 1BL,001,886441,Tsai; Philbert S,0,4,30,30
1746615266883,PHYS 1BL,002,886444,Tsai; Philbert S,2,0,30,28
1746615267915,PHYS 1C,A00,896092,Arnold; Kam S,78,0,146,68
1746615268942,PHYS 1CL,001,886448,Tsai; Philbert S,0,1,30,30
1746615268942,PHYS 1CL,002,886449,Tsai; Philbert S,1,0,30,29
1746615268942,PHYS 1CL,003,886450,Tsai; Philbert S,16,0,30,14
1746615268942,PHYS 1CL,004,886451,Tsai; Philbert S,15,0,30,15
1746615269977,PHYS 2B,A01,886457,Staff,67,0,115,48
1746615271010,PHYS 2C,A01,886460,Shotwell; Brian,0,9,65,65
1746615272039,PHYS 2CL,A01,886467,Staff,0,4,28,28
1746615272039,PHYS 2CL,A02,886468,Staff,0,3,28,28
1746615273069,PHYS 2D,A01,886470,Staff,10,0,50,40
1746615274097,PHYS 4B,A01,886475,Grinstein; Benjamin,22,0,40,18
1746615275124,POLI 5,A00,891173,Desposato; Scott,7,0,25,18
1746615276153,POLI 5D,A01,891175,Staff,5,0,5,0
1746615276153,POLI 5D,B01,891178,Staff,5,0,5,0
1746615277187,POLI 11,A00,891179,Ferree; Karen E,0,0,35,35
1746615278216,POLI 12,A00,891180,Staff,15,0,30,15
1746615279243,POLI 27,A01,891182,Staff,11,0,75,64
1746615280270,POLI 30,A00,891183,Staff,8,0,50,42
1746615281298,POLI 100B,A00,891244,Staff,5,1,35,30
1746615282325,POLI 100I,A00,891247,Staff,7,0,30,23
1746615283353,POLI 104J,A00,891248,Nichter; Maysa,14,0,30,16
1746615284381,POLI 104U,A00,891250,Nichter; Maysa,1,0,30,29
1746615286439,POLI 110B,A00,891255,Wiens; David,19,0,25,6
1746615287466,POLI 112A,A00,891256,Wiens; David,6,0,25,19
1746615288494,POLI 114BR,A00,891261,Staff,19,0,30,11
1746615289525,POLI 117R,A00,891262,Forman; Fonna,0,6,50,50
1746615290554,POLI 118,A00,891264,Ingham; Sean,17,0,25,8
1746615291582,POLI 124A,A00,891265,Staff,18,0,20,2
1746615292610,POLI 125D,A00,891266,Nichter; Simeon C,2,0,25,23
1746615293679,POLI 126,A00,891268,Nichter; Simeon C,7,0,25,18
1746615294706,POLI 126AA,A00,891272,Staff,15,0,25,10
1746615295731,POLI 130AA,A00,891273,Staff,15,0,20,5
1746615296760,POLI 134AA,A00,891274,Staff,4,0,20,16
1746615298814,POLI 138,A00,891278,Staff,21,0,25,4
1746615299843,POLI 142K,A00,891280,Staff,10,0,25,15
1746615300869,POLI 142M,A00,891281,Gartzke; Erik,16,0,30,14
1746615301896,POLI 142P,A00,891284,Staff,20,0,30,10
1746615302929,POLI 143,A00,891285,Gartzke; Erik,12,0,30,18
1746615303959,POLI 153,A00,891286,Staff,19,0,20,1
1746615306013,POLI 175,A00,891290,Staff,15,0,20,5
1746615307045,PSYC 1,A00,890674,Steiner; Eric Tomas,0,11,45,45
1746615308072,PSYC 2,A00,890676,Albright; Thomas D,20,0,35,15
1746615309100,PSYC 3,A00,890679,Staff,17,0,20,3
1746615310130,PSYC 6,A00,959858,Staff,19,0,20,1
1746615311161,PSYC 60,A01,890684,Rickard; Timothy C.,0,6,45,45
1746615312187,PSYC 70,A01,890689,Geller; Emma Harlan,6,0,30,24
1746615313212,PSYC 71,A01,959860,Staff,21,0,25,4
1746615314238,PSYC 100,A00,890690,Lacefield; Katharine I,0,50,180,180
1746615315267,PSYC 102,A00,890695,Staff,18,0,40,22
1746615316297,PSYC 105,A00,890699,Geller; Emma Harlan,70,0,100,30
1746615317327,PSYC 106,A00,890701,Gorman; Michael R.,5,0,30,25
1746615318362,PSYC 108,A00,890704,Adrian; Julia Anna,0,29,50,50
1746615319389,PSYC 118,A01,890712,Staff,11,0,30,19
1746615320418,PSYC 124,A00,890716,Chapman; Eddie Nathaniel,25,0,60,35
1746615321445,PSYC 131,A00,890717,Anagnostaras; Stephan,0,7,80,80
1746615322474,PSYC 137,A00,890719,Winkielman; Piotr,0,11,30,30
1746615323499,PSYC 144,A00,890721,Adrian; Julia Anna,0,9,45,45
1746615324533,PSYC 162,A00,890805,Staff,0,2,75,75
1746615325562,PSYC 169,A00,890810,Staff,0,15,30,30
1746615326593,PSYC 172,A00,890814,Gorman; Michael R.,9,0,30,21
1746615327619,PSYC 181,A00,890818,Anagnostaras; Stephan,6,0,200,194
1746615328647,PSYC 184,A00,959861,Staff,160,0,175,15
1746615329675,PSYC 189,A00,890823,Staff,0,2,30,30
1746615330702,PSYC 191,A00,890884,Rickard; Timothy C.,0,12,35,35
1746615331731,PSYC 193,A00,890913,Staff,19,0,30,11
1746615331731,PSYC 193,B00,890914,Chapman; Eddie Nathaniel,24,0,30,6
1746615332765,PSYC 193L,A01,890918,Lowe; Angela Beth,20,0,30,10
1746615332765,PSYC 193L,B01,890921,Hurwitz; Ethan Scott,20,0,30,10
1746615332765,PSYC 193L,C01,890928,Staff,30,0,30,0
1746615333800,RELI 149,A00,886806,Rahimi; Babak,23,0,40,17
1746615334827,SE 9,A01,886814,Staff,7,0,20,13
1746615335857,SE 101B,A01,886816,Chadha; Mayank,3,0,35,32
1746615336886,SE 110B,A00,886818,Zhu; Qiang,4,0,75,71
1746615337913,SE 125,A01,886830,Staff,10,0,30,20
1746615338941,SE 130B,A01,886835,Staff,14,0,40,26
1746615339975,SE 131A,A01,886838,Krysl; Petr,34,0,55,21
1746615341003,SE 154,A00,886840,Staff,28,0,50,22
1746615342033,SE 164GS,A01,886849,Staff,6,0,20,14
1746615343060,SE 167GS,A01,886853,Staff,6,0,20,14
1746615344095,SIO 25,A01,890107,Staff,19,0,30,11
1746615345123,SIO 45,A00,890109,Cook; Geoffrey W,114,0,200,86
1746615346153,SIO 109R,A00,890110,Forman; Fonna,0,16,20,20
1746615347178,SIO 187,A01,890114,Kacev; David,15,0,40,25
1746615348208,SOCI 1,A01,890431,Thorpe; Charles Robert,14,0,30,16
1746615348208,SOCI 1,A02,890518,Thorpe; Charles Robert,30,0,30,0
1746615349233,SOCI 2,A01,957978,Staff,25,0,25,0
1746615349233,SOCI 2,A02,957979,Staff,23,0,25,2
1746615350265,SOCI 20,A01,890523,Calderon-Zaks; Michael Aar,21,0,30,9
1746615350265,SOCI 20,A02,890526,Calderon-Zaks; Michael Aar,29,0,30,1
1746615351292,SOCI 30,A01,890533,Pardo Guerra; Juan Pablo,37,0,40,3
1746615352316,SOCI 40,A01,890535,Staff,27,0,45,18
1746615353346,SOCI 104Q,A00,890559,Staff,17,0,30,13
1746615354371,SOCI 106,A00,890560,Arnal; Maud Marie Leonie,20,0,30,10
1746615355402,SOCI 110,A00,890567,Holkenbrink-Monk; Charlene,19,0,30,11
1746615356430,SOCI 112,A00,890568,Victoria Torres; Pablo,2,0,55,53
1746615357462,SOCI 115,A00,890597,Arnal; Maud Marie Leonie,28,0,45,17
1746615359519,SOCI 121,A00,890604,Pardo Guerra; Juan Pablo,38,0,45,7
1746615360550,SOCI 126,A01,890608,Staff,8,0,10,2
1746615361576,SOCI 127,A00,890609,Staff,18,0,30,12
1746615362606,SOCI 131,A00,890610,Thorpe; Charles Robert,37,0,45,8
1746615363638,SOCI 135,A00,890615,Payne; Christine Anna,14,0,45,31
1746615364663,SOCI 139,A00,890620,Staff,38,0,45,7
1746615365691,SOCI 148E,A00,890622,Calderon-Zaks; Michael Aar,36,0,45,9
1746615366722,SOCI 150,A00,890623,Kohler; Kristopher M.,31,0,45,14
1746615367752,SOCI 157,A00,890625,Jules-Rosette; Bennetta W.,18,0,20,2
1746615368781,SOCI 160,A00,890627,Payne; Christine Anna,21,0,45,24
1746615369816,SYN 1,A00,886855,Fish; Gwendolyn Anne,0,1,0,0
1746615369816,SYN 1,B00,906086,Fish; Gwendolyn Anne,0,2,0,2
1746615370847,SYN 2R,A00,886860,Staff,0,17,15,15
1746615370847,SYN 2R,B00,906106,Atkinson; Arthur Laird,0,16,15,15
1746615371875,SYN 100,A01,886866,Browne; Emily,0,28,20,20
1746615371875,SYN 100,B01,906128,Rock; Martin,0,4,20,20
1746615371875,SYN 100,C01,906140,Deavenport; James Cary,0,4,20,20
1746615371875,SYN 100,D01,907816,Deavenport; James Cary,0,5,20,20
1746615372906,TDAC 1,A00,890286,Walsh; Kim C.,7,0,20,13
1746615373932,TDAC 101,A00,890296,Basso; Beatrice,15,0,20,5
1746615374959,TDDE 131,A00,890297,Staff,47,0,50,3
1746615375986,TDDM 1,A00,890287,Weinberg; Sadie,25,0,30,5
1746615377018,TDGE 11,A00,890288,Fulton; Julia,138,0,200,62
1746615377018,TDGE 11,B00,890289,Castro; Robert Jess,184,0,200,16
1746615378047,TDGE 25,B00,957359,Walsh; Kim C.,5,0,20,15
1746615379072,TDGE 40,A01,890292,Power; Jade Yukana,26,0,30,4
1746615380104,TDGE 124,A00,890298,Havis; Allan,0,2,50,50
1746615381131,TDGE 131R,A00,890299,Burelle; Julie Sara Veronique,15,0,42,27
1746615382160,TDHT 101,A00,890300,Staff,10,0,20,10
1746615383190,TDHT 109,A01,890302,Anderson; Mysia Anyse,31,0,40,9
1746615384219,TDMV 1,A00,890293,Arcidiacono; Kristin,18,0,30,12
1746615385246,TDMV 2,A00,890294,Weinberg; Sadie,23,0,30,7
1746615386273,TDMV 3,A00,957878,Arcidiacono; Kristin,28,0,30,2
1746615388327,TDMV 138,A00,890304,Jun; Grace Shin Hae,25,0,40,15
1746615389353,TDMV 140,A00,890305,Corrales; Joseph Bernales,25,0,30,5
1746615390380,TDMV 142,A00,890307,Caligagan; Tony,32,0,40,8
1746615391407,TDMV 144,A00,890308,Camaya; Michelle Ann,25,0,30,5
1746615392434,TDPW 1,A00,890295,Stein; Deborah Isobel,3,0,20,17
1746615393461,USP 2,A01,890272,Lerner; Amy M,7,0,20,13
1746615394486,USP 3,A01,890274,Staff,12,0,30,18
1746615395517,USP 15,A01,890276,Sun; Feiyang,16,0,30,14
1746615396543,USP 25,A00,890277,Shenkman; Michael Thomas,18,0,25,7
1746615397610,USP 138,A00,890278,Staff,13,0,25,12
1746615398636,USP 143,A00,890279,Staff,21,0,70,49
1746615399666,USP 144,A00,890280,Chowdhury; Muhammed Zohir,16,0,30,14
1746615400689,USP 150,A00,890281,Boomhower; Matthew Charles,4,0,30,26
1746615401718,USP 151,A00,890282,Staff,16,0,20,4
1746615402746,USP 162,A00,890283,Andrews; Abigail Leslie,16,0,20,4
1746615403776,USP 168,A00,920477,Kwak; Nancy,0,0,5,5
1746615404803,USP 181,A00,890284,Staff,3,0,20,17
1746615405830,USP 191A,A00,890285,Staff,12,0,20,8
1746615406857,VIS 101,A00,886512,Staff,26,0,75,49
1746615407885,VIS 103,A00,886513,Cruz; Edwin Teddy,61,0,75,14
1746615408917,VIS 108,A00,886514,Staff,4,0,15,11
1746615409942,VIS 127P,A00,886515,Shen; Kuiyi,80,0,146,66
1746615410975,VIS 149,A00,886516,Yoldas; Pinar,0,0,15,15
1746615412000,VIS 164,A00,886526,Erdmann; Dean,19,0,22,3
1746615413029,VIS 194S,A00,886527,Staff,61,0,75,14
1746615414057,WCWP 10A,C00,886484,Martiniuk; Jill,12,0,15,3
1746615415086,WCWP 10B,A00,886490,Uriarte; Emma,0,0,15,15
1746615415086,WCWP 10B,B00,886491,Dhir; Simrita,8,0,15,7
1746615415086,WCWP 10B,C00,886492,Ornelas; Tricia,0,0,15,15
1746615416113,WCWP 100,A00,886494,Young; Mark T,0,6,15,15
1746615418291,AAS 10,A01,886199,Childs; Dennis R.,0,3,0,0
1746615419323,ANAR 104,A01,886940,Shtienberg; Gilad,27,0,30,3
1746615420355,ANAR 120,A00,886953,Staff,13,0,20,7
1746615421382,ANBI 148,A01,886955,Wilder; Linnea Lorene,30,0,40,10
1746615423445,ANSC 122,A00,886957,Staff,24,0,30,6
1746615424470,ANSC 150,A00,886958,Sloane; Julia Kathryn,2,0,15,13
1746615425497,ANSC 156,A00,886959,Jenkins; Janis A.,0,1,15,15
1746615426522,ANSC 180,A00,886960,Staff,11,0,17,6
1746615427549,ANSC 188,A00,886961,Jassal; Aftab,9,0,25,16
1746615428574,ANSC 190,A00,886962,Jassal; Aftab,14,0,25,11
1746615429604,ANSC 191,A00,886963,Staff,18,0,20,2
1746615430630,ANTH 3,A01,891689,Staff,17,0,20,3
1746615431660,ANTH 5,A00,886933,Semendeferi; Ekaterini,16,0,20,4
1746615432688,ANTH 10,A00,886934,Staff,0,12,30,30
1746615433718,ANTH 21,A01,886936,Staff,41,0,60,19
1746615434747,ANTH 23,A01,886938,Staff,92,0,100,8
1746615435782,ANTH 105,A00,886964,Stewart; Alexander B,84,0,100,16
1746615436811,ANTH 108,A00,886965,Pedersen; David,9,0,20,11
1746615437848,AWP 10,001,886147,Staff,0,0,0,0
1746615437848,AWP 10,002,886148,Staff,0,0,0,0
1746615437848,AWP 10,003,886149,Staff,0,0,0,0
1746615437848,AWP 10,004,886150,Staff,0,0,0,0
1746615437848,AWP 10,005,886151,Staff,0,0,0,0
1746615437848,AWP 10,006,886152,Staff,0,0,0,0
1746615437848,AWP 10,007,886153,Staff,0,0,0,0
1746615437848,AWP 10,008,886154,Staff,0,0,0,0
1746615437848,AWP 10,009,886155,Staff,0,0,0,0
1746615437848,AWP 10,010,886156,Staff,0,0,0,0
1746615437848,AWP 10,011,886158,Staff,0,0,0,0
1746615437848,AWP 10,012,886160,Staff,0,0,0,0
1746615437848,AWP 10,013,886161,Staff,0,0,0,0
1746615437848,AWP 10,014,886162,Staff,0,0,0,0
1746615437848,AWP 10,015,886163,Staff,0,0,0,0
1746615437848,AWP 10,016,886164,Staff,0,0,0,0
1746615437848,AWP 10,017,886165,Staff,0,0,0,0
1746615437848,AWP 10,018,886166,Staff,0,0,0,0
1746615437848,AWP 10,019,886168,Staff,0,0,0,0
1746615437848,AWP 10,020,886170,Staff,0,0,0,0
1746615437848,AWP 10,021,886172,Staff,0,0,0,0
1746615438888,AWP 10R,001,886173,Staff,0,1,0,0
1746615438888,AWP 10R,002,886174,Staff,0,1,0,0
1746615438888,AWP 10R,003,886175,Staff,0,0,0,0
1746615438888,AWP 10R,004,886176,Staff,0,0,0,0
1746615438888,AWP 10R,005,886177,Staff,0,0,0,0
1746615438888,AWP 10R,006,886178,Staff,0,0,0,0
1746615438888,AWP 10R,007,886179,Staff,0,0,0,0
1746615438888,AWP 10R,008,886181,Staff,0,0,0,0
1746615438888,AWP 10R,009,886182,Staff,0,0,0,0
1746615438888,AWP 10R,010,886183,Staff,0,0,0,0
1746615438888,AWP 10R,011,886184,Staff,0,0,0,0
1746615438888,AWP 10R,012,886185,Staff,0,0,0,0
1746615438888,AWP 10R,013,886186,Staff,0,0,0,0
1746615438888,AWP 10R,014,886187,Staff,0,0,0,0
1746615438888,AWP 10R,015,886188,Staff,0,0,0,0
1746615438888,AWP 10R,016,886189,Staff,0,0,0,0
1746615438888,AWP 10R,017,960532,Staff,0,0,0,0
1746615438888,AWP 10R,018,960533,Staff,0,0,0,0
1746615438888,AWP 10R,019,960534,Staff,0,0,0,0
1746615438888,AWP 10R,020,960538,Staff,0,0,0,0
1746615438888,AWP 10R,021,960540,Staff,0,0,0,0
1746615438888,AWP 10R,022,960541,Staff,0,0,0,0
1746615438888,AWP 10R,023,960542,Staff,0,0,0,0
1746615438888,AWP 10R,024,960544,Staff,0,0,0,0
1746615438888,AWP 10R,025,960545,Staff,0,0,0,0
1746615438888,AWP 10R,026,960548,Staff,0,0,0,0
1746615439916,AWP 102R,A00,886190,Staff,0,0,0,0
1746615439916,AWP 102R,B00,886191,Staff,0,0,0,0
1746615440942,BENG 100,A01,886193,Staff,17,0,30,13
1746615441970,BENG 122A,A01,886195,Hasty; Jeff M,13,0,30,17
1746615443001,BENG 166A,A00,886196,Sah; Robert Lie-Yuan,0,3,30,30
1746615444030,BENG 190,A00,958050,Khojah; Reem I,17,0,25,8
1746615445063,BIBC 102,A01,894320,Staff,0,1,46,46
1746615445063,BIBC 102,A02,894321,Staff,0,0,46,46
1746615445063,BIBC 102,A03,894344,Staff,6,0,46,40
1746615445063,BIBC 102,A04,894345,Staff,27,0,47,20
1746615446093,BICD 100R,A01,894365,Smith; Laurie,0,2,58,58
1746615446093,BICD 100R,A02,894366,Smith; Laurie,0,4,58,58
1746615446093,BICD 100R,A03,894367,Smith; Laurie,0,0,59,59
1746615446093,BICD 100R,A04,959869,Smith; Laurie,38,0,59,21
1746615447125,BICD 136,A01,894383,Gustafson-Brown; Cindy,14,0,50,36
1746615448163,BIEB 102,A01,894494,Butler; Shannon Rhey,51,0,130,79
1746615450227,BIEB 150,A01,894617,Wills; Christopher,3,0,20,17
1746615450227,BIEB 150,A02,894631,Wills; Christopher,3,0,20,17
1746615450227,BIEB 150,A03,894937,Wills; Christopher,3,0,20,17
1746615450227,BIEB 150,A04,894946,Wills; Christopher,5,0,20,15
1746615451254,BIEB 194,A00,906141,Kurle; Carolyn M.,5,0,20,15
1746615452283,BILD 1,A01,894154,Staff,3,0,19,16
1746615452283,BILD 1,A02,894155,Staff,14,0,19,5
1746615452283,BILD 1,A03,894160,Staff,13,0,19,6
1746615452283,BILD 1,A04,894161,Staff,15,0,18,3
1746615453311,BILD 2,A01,894168,Staff,0,0,50,50
1746615453311,BILD 2,A02,894169,Staff,0,0,50,50
1746615453311,BILD 2,A03,894179,Staff,0,0,50,50
1746615453311,BILD 2,A04,894203,Staff,22,0,50,28
1746615454338,BILD 3,A01,894213,Staff,23,0,31,8
1746615454338,BILD 3,A02,894214,Staff,26,0,31,5
1746615454338,BILD 3,A03,894235,Staff,28,0,31,3
1746615454338,BILD 3,A04,894236,Staff,28,0,32,4
1746615455363,BILD 4,A01,894253,Reuther; Keefe,5,0,24,19
1746615455363,BILD 4,A02,894258,Reuther; Keefe,16,0,24,8
1746615456395,BILD 5,A01,894276,Reuther; Keefe,33,0,50,17
1746615456395,BILD 5,A02,894277,Reuther; Keefe,45,0,50,5
1746615456395,BILD 5,A03,894290,Reuther; Keefe,44,0,50,6
1746615456395,BILD 5,A04,894291,Reuther; Keefe,48,0,50,2
1746615457420,BILD 24,A01,894297,Pirino; Giorgia,40,0,60,20
1746615458447,BIMM 100,B01,958915,Staff,71,0,100,29
1746615459473,BIMM 101,A01,895017,McDonnell; Lisa Marie,0,5,24,24
1746615459473,BIMM 101,A02,895018,McDonnell; Lisa Marie,0,5,24,24
1746615459473,BIMM 101,B01,895020,McDonnell; Lisa Marie,0,5,24,24
1746615459473,BIMM 101,B02,895021,McDonnell; Lisa Marie,0,4,24,24
1746615460500,BIMM 110,A01,895023,Staff,1,0,25,24
1746615460500,BIMM 110,A02,895024,Staff,9,0,25,16
1746615460500,BIMM 110,A03,895025,Staff,18,0,25,7
1746615460500,BIMM 110,A04,895031,Staff,20,0,25,5
1746615461527,BIMM 120,A01,895114,Gustafson-Brown; Cindy,14,0,28,14
1746615461527,BIMM 120,A02,895126,Gustafson-Brown; Cindy,21,0,27,6
1746615462554,BIPN 100,A01,895130,Yang; Mingyu,0,0,38,38
1746615462554,BIPN 100,A02,895131,Yang; Mingyu,31,0,38,7
1746615462554,BIPN 100,A03,895132,Yang; Mingyu,32,0,38,6
1746615462554,BIPN 100,A04,895133,Yang; Mingyu,27,0,36,9
1746615463582,BIPN 120,A01,895135,Cooke; James Edward,0,3,13,13
1746615463582,BIPN 120,A02,895136,Cooke; James Edward,0,1,13,13
1746615463582,BIPN 120,A03,895137,Cooke; James Edward,0,3,13,13
1746615463582,BIPN 120,A04,895156,Cooke; James Edward,0,2,11,11
1746615464611,BIPN 134,A01,895235,Cooke; James Edward,0,1,25,25
1746615464611,BIPN 134,A02,895237,Cooke; James Edward,0,0,25,25
1746615464611,BIPN 134,A03,895240,Cooke; James Edward,1,0,25,24
1746615464611,BIPN 134,A04,895270,Cooke; James Edward,20,0,25,5
1746615465639,BIPN 189,A00,892103,Staff,0,14,14,14
1746615467700,BISP 194,A00,958008,Staff,0,2,0,0
1746615468724,CAT 124,A01,922009,Staff,0,5,20,20
1746615469754,CAT 125R,A00,886390,Morales; Celeste Georgianna,0,4,20,20
1746615469754,CAT 125R,B00,886391,Irwin; Matthew Joseph,0,4,20,20
1746615469754,CAT 125R,C00,886392,Smith; Lauryn Alissa,0,2,20,20
1746615469754,CAT 125R,D00,886393,Vanderschuit; Maya Alysia,0,3,20,20
1746615469754,CAT 125R,E00,886394,Marchisotto; Jennifer Anne,0,3,20,20
1746615470779,CENG 15,A01,886218,Drews; Aaron,3,0,8,5
1746615471805,CENG 113,A00,886219,Opatkiewicz; Justin Paul,15,0,25,10
1746615472834,CGS 101,A00,887044,Staff,7,0,20,13
1746615473863,CGS 105,A01,887046,Staff,14,0,25,11
1746615474895,CGS 112,A00,887047,Cuong; Marisol,12,0,15,3
1746615475924,CGS 113,A00,887048,Staff,23,0,30,7
1746615476950,CGS 120,A00,887049,Staff,9,0,17,8
1746615477978,CHEM 6A,A01,886336,Lam; Tin Yiu,38,0,50,12
1746615477978,CHEM 6A,A02,886338,Lam; Tin Yiu,37,0,50,13
1746615479008,CHEM 6B,A01,886341,Hopkins; Patrycja Anna,16,0,50,34
1746615479008,CHEM 6B,A02,886343,Hopkins; Patrycja Anna,42,0,50,8
1746615480034,CHEM 6C,A01,886346,Albizati; Kim F.,0,2,50,50
1746615480034,CHEM 6C,A02,886348,Albizati; Kim F.,24,0,50,26
1746615481065,CHEM 40A,A01,886352,Klosterman; Jeremy K,65,0,100,35
1746615482097,CHEM 40B,A01,886356,Klosterman; Jeremy K,0,24,100,100
1746615483131,CHEM 41B,A01,886360,Theodorakis; Emmanuel,25,0,50,25
1746615483131,CHEM 41B,A02,886362,Theodorakis; Emmanuel,47,0,50,3
1746615484156,CHIN 165A,A00,886382,Xu; Li,18,0,20,2
1746615485206,CLAS 120,A00,886387,Myerston Santana; Jacobo,33,0,40,7
1746615486233,COGS 9,A01,886967,Shannon; Kyle Michael,42,0,60,18
1746615487261,COGS 11,A01,886969,Staff,9,0,30,21
1746615488287,COGS 14A,A01,886971,Staff,5,0,60,55
1746615489316,COGS 14B,A01,886973,Hoffman; Drew Ellen,4,0,60,56
1746615490349,COGS 18,A01,886975,Morgan; Eric,34,0,60,26
1746615491375,COGS 20,A01,886977,Staff,3,0,8,5
1746615491375,COGS 20,A02,886978,Staff,5,0,7,2
1746615492407,COGS 100,A01,907783,Staff,0,1,30,30
1746615493431,COGS 101B,A01,886980,Staff,0,4,48,48
1746615494461,COGS 101C,A01,886982,Delgado; Tania,0,5,44,44
1746615495488,COGS 102A,A01,886984,Johnson; Christine M.,3,0,30,27
1746615496519,COGS 118B,A01,886986,Staff,0,4,88,88
1746615497557,COGS 150,A01,886988,Bergen; Benjamin,22,0,50,28
1746615498582,COGS 153,A00,886989,Delgado; Tania,1,3,41,40
1746615499609,COGS 186,A01,886991,Staff,0,0,32,32
1746615500640,COGS 187A,A01,886993,Boyle; Mary E. T.,7,0,30,23
1746615501667,COGS 189,A00,886994,Staff,1,1,30,29
1746615502692,COMM 10,A01,886996,Staff,0,0,20,21
1746615502692,COMM 10,A02,886997,Staff,10,0,20,10
1746615502692,COMM 10,A03,959845,Staff,19,0,20,1
1746615503723,COMM 20,A01,886999,Leuning; Grant Maurstad,24,0,40,16
1746615505776,COMM 100A,A01,887002,Staff,0,0,20,25
1746615505776,COMM 100A,A02,887003,Staff,5,0,20,15
1746615506804,COMM 100B,A01,887005,Staff,0,8,20,24
1746615507829,COMM 106D,A00,887006,Staff,14,0,40,26
1746615508856,COMM 110G,A00,887007,Whitworth-Smith; Andrew C,12,0,40,28
1746615509901,COMM 111B,A00,887008,Staff,31,0,40,9
1746615510934,COMM 113T,A00,887009,Abuelhiga; Soraya Jill,28,0,40,12
1746615510934,COMM 113T,B00,906733,Staff,39,0,40,1
1746615511959,COMM 145,A00,887010,Staff,13,0,40,27
1746615512984,COMM 146,A00,887054,Staff,32,0,40,8
1746615514011,COMM 190,A00,887012,Staff,8,0,23,15
1746615515038,CSE 8A,A50,887015,Cao; Yingjun,56,0,85,29
1746615516064,CSE 11,A01,887017,Cao; Yingjun,11,0,70,59
1746615517095,CSE 20,A01,887019,Staff,30,0,50,20
1746615518121,CSE 21,A01,887021,Staff,79,0,100,21
1746615518121,CSE 21,B01,892583,Braun; Oliver,45,0,50,5
1746615519147,CSE 30,A01,887025,Eldon; John,142,0,200,58
1746615520176,CSE 100,A01,887027,Staff,26,0,50,24
1746615520176,CSE 100,A02,887028,Staff,42,0,50,8
1746615521207,CSE 101,A01,887030,Braun; Oliver,74,0,100,26
1746615521207,CSE 101,B01,887032,Jones; Miles E,0,3,50,50
1746615521207,CSE 101,B02,887033,Jones; Miles E,0,2,50,50
1746615522233,CSE 105,A01,908084,Jones; Miles E,32,0,50,18
1746615522233,CSE 105,A02,908087,Jones; Miles E,31,0,50,19
1746615523257,CSE 135,A01,887035,Powell; Thomas Allan,0,5,50,50
1746615524296,CSE 142,A01,887037,Staff,7,0,60,53
1746615525320,CSE 142L,A01,887039,Staff,34,0,60,26
1746615526350,CSE 151A,A01,887041,Solares; Edwin A,47,0,100,53
1746615527379,CSE 175,A01,887043,Kumar; Rakesh,30,0,30,0
1746615528405,CSS 1,A01,886389,Staff,0,1,40,40
1746615529433,DSC 30,A01,908097,Liao; Soohyun Nam,47,0,75,28
1746615530460,DSC 40A,A01,908099,Shannon; Kyle Michael,30,0,50,20
1746615531491,DSC 40B,A01,908112,Staff,15,0,50,35
1746615532520,DSC 80,A01,908116,Staff,19,0,60,41
1746615533547,DSC 197,001,956863,Eldridge; Justin Matthew,9999,0,9999,0
1746615534575,ECE 5,A01,886400,Morris; Karcher William,1,0,6,5
1746615534575,ECE 5,A02,886401,Morris; Karcher William,3,0,6,3
1746615535601,ECE 148,A01,886403,Silberman; Jack,0,14,14,14
1746615536634,ECON 1,A01,887265,Crane; Meredith Helen,11,0,70,59
1746615536634,ECON 1,B01,887268,Staff,42,0,50,8
1746615537660,ECON 2,A01,887273,Crane; Meredith Helen,54,0,70,16
1746615538686,ECON 3,A01,887279,Rondina; Giacomo,31,0,70,39
1746615539713,ECON 4,A01,887282,Anderson; John Charles,0,2,10,10
1746615540737,ECON 5,A01,887285,Staff,34,0,45,11
1746615540737,ECON 5,B01,887292,Staff,41,0,45,4
1746615541764,ECON 100A,A01,887337,Newhouse; Herbert S,54,0,70,16
1746615541764,ECON 100A,B01,887349,Staff,45,0,50,5
1746615542788,ECON 100B,A01,887361,Du; Songzi,29,0,70,41
1746615543818,ECON 100C,A01,887445,Newhouse; Herbert S,59,0,70,11
1746615544847,ECON 105,A00,887488,Vespa; Emanuel Ignacio,23,0,35,12
1746615545872,ECON 109,A01,887506,Shishkin; Denis,28,0,35,7
1746615546900,ECON 110A,A01,887568,Alon; Titan Michael,0,2,35,35
1746615546900,ECON 110A,B01,907601,Alon; Titan Michael,20,0,35,15
1746615547929,ECON 110B,A01,887598,Levkoff; Steven B.,0,24,70,70
1746615548955,ECON 112,A00,887599,Rondina; Giacomo,19,0,35,16
1746615549980,ECON 120A,A01,887603,Dai; Yinlin,36,0,70,34
1746615551012,ECON 120C,A01,887608,Sun; Yixiao,0,1,35,35
1746615551012,ECON 120C,B01,887614,Sun; Yixiao,0,0,35,35
1746615552037,ECON 138,A00,887621,Bharadwaj; Prashant,0,21,20,20
1746615553062,ECON 144,A00,958007,Squires; Dale E,11,0,35,24
1746615554090,ECON 171,A01,907666,Staff,18,0,35,17
1746615555115,ECON 175,A00,887626,Wu; Pak Yeung,22,0,35,13
1746615556140,ECON 190,A00,887640,Vespa; Emanuel Ignacio,22,0,35,13
1746615557180,EDS 25,A01,888197,Staff,0,0,0,0
1746615557180,EDS 25,A02,888209,Staff,0,0,0,0
1746615557180,EDS 25,A03,888210,Staff,0,0,0,0
1746615557180,EDS 25,A04,888212,Staff,0,0,0,0
1746615557180,EDS 25,A05,888213,Staff,0,0,0,0
1746615557180,EDS 25,A06,888214,Staff,0,0,0,0
1746615557180,EDS 25,A07,888235,Staff,0,2,0,0
1746615557180,EDS 25,A08,888236,Staff,0,0,0,0
1746615557180,EDS 25,A09,888240,Staff,0,0,0,0
1746615557180,EDS 25,A10,888244,Staff,0,0,0,0
1746615557180,EDS 25,B01,888273,Staff,0,0,0,0
1746615557180,EDS 25,B02,888285,Staff,0,0,0,0
1746615557180,EDS 25,B03,888423,Staff,0,0,0,1
1746615557180,EDS 25,B04,888432,Staff,0,0,0,0
1746615557180,EDS 25,B05,888433,Staff,0,0,0,0
1746615557180,EDS 25,B06,888467,Staff,0,0,0,0
1746615557180,EDS 25,B07,888468,Staff,0,0,0,0
1746615557180,EDS 25,B08,888479,Staff,0,0,0,0
1746615557180,EDS 25,B09,888484,Staff,0,0,0,0
1746615557180,EDS 25,B10,888487,Staff,0,0,0,0
1746615558205,EDS 38,A01,907700,Choi; Bailey Miyeon,30,0,30,0
1746615559228,EDS 112,A01,888601,Chapman; Thandeka K,12,0,40,28
1746615560253,EDS 115,A00,888697,Mendez; Kathrina Mendoza,10,0,30,20
1746615561281,EDS 116,A01,888893,Staff,33,0,40,7
1746615563332,EDS 124AR,A00,889133,Staff,29,0,50,21
1746615563332,EDS 124AR,B00,907471,Simon; Elizabeth A,37,0,50,13
1746615564357,EDS 124BR,A00,889134,Simon; Elizabeth A,44,0,100,56
1746615565383,EDS 125,A00,889135,Staff,25,0,30,5
1746615566408,EDS 126,A01,889138,Staff,35,0,40,5
1746615567435,EDS 164R,A01,889142,Wishard Guerra; Alison G.,32,0,50,18
1746615568463,ENG 30,A01,886396,Staff,0,0,0,0
1746615568463,ENG 30,B01,886398,Staff,0,0,0,0
1746615569492,ENVR 102,A00,906150,Montejo; Carolina,23,0,25,2
1746615570518,ETHN 103A,A00,887236,Man; Simeon S,0,2,0,0
1746615571547,ETHN 113,A00,887239,Staff,16,0,30,14
1746615572571,ETHN 116,A00,887240,Staff,16,0,25,9
1746615573597,ETHN 117,A00,887241,Choi; Esther Min,28,0,30,2
1746615574624,ETHN 118,A00,887243,Staff,24,0,30,6
1746615575652,ETHN 127,A00,887248,Cuong; Marisol,11,0,15,4
1746615576679,ETHN 139,A00,887250,Staff,7,0,10,3
1746615577708,ETHN 142,A00,887252,Staff,9,0,30,21
1746615578737,ETHN 161,A00,887253,Browne; Errol Tsekani,24,0,30,6
1746615579762,ETHN 163FR,A00,887255,Burelle; Julie Sara Veronique,0,0,5,5
1746615580790,GLBH 20,A00,889149,Elwardani; Nile Regina,8,0,42,34
1746615582847,GLBH 111,A01,889152,Burgos; Jose L.,17,0,17,0
1746615583873,GLBH 150,A00,889181,Sloane; Julia Kathryn,0,5,15,15
1746615585928,HDS 60,A01,886406,Warstadt; Melissa Fawn,72,0,80,8
1746615586954,HIAF 111,A00,889324,Gyamfi; Bright,25,0,32,7
1746615587981,HIEA 131,A00,889328,Staff,15,0,32,17
1746615589010,HIEA 144,A00,889333,Henry; Todd A.,26,0,32,6
1746615590037,HIEA 154,A00,889336,Henry; Todd A.,24,0,32,8
1746615591066,HIEU 106,A00,889339,Staff,22,0,32,10
1746615593122,HIEU 114,A00,889340,Staff,4,0,32,28
1746615594148,HIEU 135GS,A00,889342,Patterson; Patrick H.,0,0,1,24
1746615595177,HIEU 137,A00,889343,Edington; Claire Ellen,10,0,25,15
1746615596204,HIEU 148,A00,889345,Staff,14,0,32,18
1746615597234,HIEU 154,A00,889346,Biess; Frank Peter,21,0,32,11
1746615598261,HILA 102,A00,889351,Staff,12,0,32,20
1746615599290,HILD 2A,A01,889221,Lewandoski; Julia Mavis,0,8,32,32
1746615600317,HILD 7B,A01,889225,Man; Simeon S,0,12,32,32
1746615601345,HILD 7C,A01,889288,Alvarez; Luis A,0,14,32,32
1746615602377,HILD 30,A01,889323,Staff,0,5,32,32
1746615604437,HISC 119,A00,889383,Golan; Tal,20,0,32,12
1746615605464,HIUS 103,A00,889384,Man; Simeon S,0,0,32,32
1746615606492,HIUS 117,A00,919797,Kwak; Nancy,18,0,32,14
1746615607520,HIUS 142A,A00,919788,Staff,22,0,32,10
1746615609575,HIUS 149,A00,889386,Gyamfi; Bright,26,0,32,6
1746615610602,HIUS 155,A00,889387,Alvarez; Luis A,15,0,32,17
1746615611629,HUM 3,A01,886499,Caldwell; Michael Alan,19,0,50,31
1746615612655,HUM 3GS,A00,886500,Rodriguez; Bretton Sigfred,0,0,0,28
1746615613681,HUM 3R,A01,886502,Markman; Kristina,0,36,50,50
1746615614708,HUM 4,A01,886504,Crum; Matthew Stephen,23,0,50,27
1746615614708,HUM 4,B01,886506,West; Geoffrey Scott,17,0,50,33
1746615615737,HUM 4GS,A00,886507,Staff,0,0,0,19
1746615616763,HUM 5,A01,886509,Staff,31,0,50,19
1746615617792,HUM 5R,A01,886511,Zavodny; Tatiana Sophia,0,39,50,50
1746615618819,JAPN 180,A00,886407,Staff,16,0,40,24
1746615619852,LATI 50,A01,886409,Martin-Cabrera; Luis,3,0,22,19
1746615619852,LATI 50,A02,886410,Martin-Cabrera; Luis,19,0,22,3
1746615619852,LATI 50,A03,886411,Martin-Cabrera; Luis,21,0,22,1
1746615619852,LATI 50,A04,886412,Martin-Cabrera; Luis,8,0,22,14
1746615620878,LAWS 101,A00,907664,Staff,28,0,60,32
1746615621908,LIAB 1A,A00,889388,Saab; Dima,17,0,20,3
1746615622937,LIAB 1AX,A00,889389,El Cheddadi; Youniss,18,0,20,2
1746615623967,LIFR 1C,A00,889391,Van Moer; Vinciane G,8,0,20,12
1746615624995,LIFR 1CX,A00,889392,Van Moer; Vinciane G,7,0,20,13
1746615626026,LIFR 1D,A00,889393,Van Moer; Vinciane G,7,0,20,13
1746615627054,LIFR 1DX,A00,889394,Van Moer; Vinciane G,8,0,20,12
1746615628082,LIGN 7,A00,886923,Staff,25,0,50,25
1746615629107,LIGN 17,A00,886924,Kehler; Andrew Scott,126,0,150,24
1746615630139,LTAM 110,A00,889395,Staff,15,0,30,15
1746615631167,LTAM 110GS,A00,958010,Rodriguez; Bretton Sigfred,0,0,0,28
1746615632196,LTCH 101,A00,889397,Staff,23,0,25,2
1746615633226,LTCS 130,A00,889398,Staff,23,0,25,2
1746615634252,LTEA 138,A00,889399,Staff,24,0,40,16
1746615635283,LTEN 149,A00,889400,Wesling; Megan E.,0,3,25,25
1746615636310,LTEN 169,A00,889401,Staff,20,0,25,5
1746615637341,LTEN 180,A00,889402,Staff,10,0,15,5
1746615638370,LTEN 181,A00,889403,Staff,21,0,25,4
1746615639396,LTWL 100,A00,889404,Myerston Santana; Jacobo,2,0,25,23
1746615640421,LTWL 180GS,A00,889405,Staff,0,0,20,20
1746615641451,LTWL 181,A00,889406,Staff,16,0,25,9
1746615642479,LTWL 184,A00,889475,Mukherjee; Silpa,22,0,25,3
1746615643508,LTWR 102C,A00,889486,Staff,29,0,30,1
1746615644539,LTWR 115W,A00,889491,Staff,0,2,15,15
1746615645565,MAE 8,A01,886905,Staff,0,2,0,0
1746615646598,MAE 11,A00,886906,Bandaru; Prabhakar,0,7,50,50
1746615647625,MAE 20,A00,886907,Evdokimenko; Ekaterina,43,0,70,27
1746615648653,MAE 30B,A00,886909,Ghazinejad; Maziar,25,0,45,20
1746615649680,MAE 101B,A00,886910,Saintillan; David,30,0,45,15
1746615650706,MAE 105,A00,886911,Bandaru; Prabhakar,18,0,50,32
1746615651731,MAE 107,B00,958024,Staff,7,0,50,43
1746615652761,MAE 143B,A00,886913,Bewley; Thomas R,2,0,40,38
1746615653790,MAE 148,A01,886915,Silberman; Jack,0,3,14,14
1746615654817,MAE 160,A00,886916,Evdokimenko; Ekaterina,30,0,60,30
1746615655847,MATH 3C,A01,889681,Staff,0,2,30,30
1746615655847,MATH 3C,A02,960048,Staff,23,0,30,7
1746615656880,MATH 10A,A01,889760,Staff,26,0,30,4
1746615656880,MATH 10A,A02,889783,Staff,29,0,30,1
1746615657908,MATH 10B,A01,889785,Verstraete; Jacques Allan,1,0,35,34
1746615657908,MATH 10B,A02,889795,Verstraete; Jacques Allan,4,0,35,31
1746615657908,MATH 10B,B01,889797,Verstraete; Jacques Allan,3,0,35,32
1746615657908,MATH 10B,B02,889828,Verstraete; Jacques Allan,3,0,35,32
1746615658994,MATH 10C,A01,889849,Habib; Yousaf,8,0,30,22
1746615658994,MATH 10C,A02,889852,Habib; Yousaf,14,0,30,16
1746615658994,MATH 10C,A03,889853,Habib; Yousaf,22,0,30,8
1746615658994,MATH 10C,A04,889858,Habib; Yousaf,20,0,30,10
1746615658994,MATH 10C,B01,889861,Staff,1,0,30,29
1746615658994,MATH 10C,B02,889862,Staff,24,0,30,6
1746615658994,MATH 10C,B03,889863,Staff,27,0,30,3
1746615658994,MATH 10C,B04,889967,Staff,23,0,30,7
1746615660026,MATH 18,A01,889974,Staff,6,0,30,24
1746615660026,MATH 18,A02,889977,Staff,20,0,30,10
1746615660026,MATH 18,B01,889984,Hardiman; Liam,20,0,30,10
1746615660026,MATH 18,B02,889985,Hardiman; Liam,25,0,30,5
1746615661054,MATH 20A,A01,889990,Suk; Andrew Hoon,30,0,35,5
1746615662146,MATH 20B,A01,889993,Ohm; Ko Woon,21,0,30,9
1746615662146,MATH 20B,A02,889994,Ohm; Ko Woon,30,0,30,0
1746615662146,MATH 20B,B01,889996,Ohm; Ko Woon,22,0,30,8
1746615662146,MATH 20B,B02,889997,Ohm; Ko Woon,23,0,30,7
1746615663178,MATH 20C,A01,889999,Hammock; Frances H,17,0,30,13
1746615663178,MATH 20C,A02,890003,Hammock; Frances H,23,0,30,7
1746615663178,MATH 20C,B01,890006,Hammock; Frances H,2,0,30,28
1746615663178,MATH 20C,B02,890007,Hammock; Frances H,11,0,30,19
1746615664211,MATH 20D,A01,890011,Cheng; Hsiao-Bing,1,0,30,29
1746615664211,MATH 20D,A02,890012,Cheng; Hsiao-Bing,14,0,30,16
1746615664211,MATH 20D,B01,890016,Cheng; Hsiao-Bing,13,0,30,17
1746615664211,MATH 20D,B02,890017,Cheng; Hsiao-Bing,13,0,30,17
1746615665241,MATH 20E,A01,890026,Harel; Guershon,1,0,30,29
1746615665241,MATH 20E,A02,890029,Harel; Guershon,22,0,30,8
1746615665241,MATH 20E,B01,890033,Harel; Guershon,7,0,30,23
1746615665241,MATH 20E,B02,890101,Harel; Guershon,21,0,30,9
1746615666270,MATH 102,A01,890104,Staff,18,0,30,12
1746615666270,MATH 102,A02,890105,Staff,27,0,30,3
1746615667300,MATH 103B,A01,890116,Salehi Golsefidy; Alireza,3,0,30,27
1746615667300,MATH 103B,B01,890118,Staff,0,3,34,34
1746615668329,MATH 109,A01,890121,Aliabadi Sr.; Mohsen,0,0,30,30
1746615668329,MATH 109,B01,890124,Upadrashta; Pranav Kumar,18,0,30,12
1746615669360,MATH 120A,A01,890126,Eggers; John Dietrich,13,0,30,17
1746615670386,MATH 142B,A01,890128,Ioana; Adrian,19,0,30,11
1746615670386,MATH 142B,A02,890129,Ioana; Adrian,12,0,30,18
1746615671417,MATH 154,A01,890174,Staff,0,1,30,30
1746615671417,MATH 154,A02,890182,Staff,0,0,30,30
1746615672450,MATH 168A,A01,890197,Dumitriu; Ioana,21,0,35,14
1746615673480,MATH 170A,A01,890240,Nie; Jiawang,1,0,30,29
1746615673480,MATH 170A,A02,890241,Nie; Jiawang,11,0,30,19
1746615673480,MATH 170A,A03,890249,Nie; Jiawang,23,0,30,7
1746615674511,MATH 170B,A01,957891,Nag; Panchali,13,0,35,22
1746615676569,MATH 181A,A01,908025,Staff,0,3,35,35
1746615676569,MATH 181A,A02,960115,Staff,26,0,35,9
1746615677598,MATH 181B,A01,959874,Staff,24,0,30,6
1746615678625,MATH 193B,A01,890265,Staff,0,4,35,35
1746615679653,MGT 4,A01,890311,Anderson; John Charles,42,0,88,46
1746615680680,MGT 5,A00,907740,Staff,12,0,98,86
1746615681705,MGT 12,A00,890312,Lindenberger; Wade Douglas,67,0,98,31
1746615682733,MGT 16,A00,957883,Staff,78,0,98,20
1746615684785,MGT 45,A00,890314,Pecore; Joseph P.,45,0,98,53
1746615685814,MGT 71,A00,890315,Staff,0,12,98,98
1746615686844,MGT 100,A00,890316,Yavorsky; Daniel Ryan,44,0,98,54
1746615687868,MGT 103,A00,890317,Ehrich; Kristine R,73,0,98,25
1746615688893,MGT 105,A00,890356,Bates; Kenneth Walter,0,8,98,98
1746615689920,MGT 112,A00,890360,Ehrich; Kristine R,55,0,98,43
1746615690946,MGT 127R,A00,907732,Zhu; Kevin Xiaoguo,23,0,98,75
1746615691972,MGT 131B,A00,890361,Anderson; John Charles,59,0,98,39
1746615692999,MGT 137,A00,890362,Lindenberger; Wade Douglas,65,0,98,33
1746615694029,MGT 160,A00,890369,Johnson; Erik Barry,9,0,98,89
1746615696086,MGT 164,A00,890372,Zimmermann; Carsten,0,40,98,98
1746615697114,MGT 180,A00,890374,Bliss; Barbara Ann,11,0,98,87
1746615698144,MMW 15,A01,886414,Chang; Edmond Yi-Teh,0,12,28,28
1746615698144,MMW 15,A02,886415,Chang; Edmond Yi-Teh,0,8,28,28
1746615698144,MMW 15,A03,886416,Chang; Edmond Yi-Teh,0,9,28,28
1746615698144,MMW 15,A04,886417,Chang; Edmond Yi-Teh,0,8,28,28
1746615698144,MMW 15,B01,886419,Chang; Edmond Yi-Teh,0,7,28,28
1746615698144,MMW 15,B02,886420,Chang; Edmond Yi-Teh,0,7,28,28
1746615698144,MMW 15,B03,886421,Chang; Edmond Yi-Teh,0,7,28,28
1746615698144,MMW 15,B04,886422,Chang; Edmond Yi-Teh,0,8,28,28
1746615698144,MMW 15,C01,886424,Staff,0,9,28,28
1746615698144,MMW 15,C02,886425,Staff,0,8,28,28
1746615698144,MMW 15,C03,886426,Staff,0,8,28,28
1746615698144,MMW 15,C04,886427,Staff,0,8,28,28
1746615698144,MMW 15,C05,958038,Staff,0,8,28,28
1746615698144,MMW 15,C06,958039,Staff,0,7,28,28
1746615699174,MMW 15GS,A00,906910,Patterson; Patrick H.,4,0,28,24
1746615700204,MMW 122R,A01,886429,Rahimi; Babak,0,13,28,28
1746615700204,MMW 122R,A02,886430,Rahimi; Babak,0,12,28,28
1746615700204,MMW 122R,A03,958040,Rahimi; Babak,0,11,28,28
1746615701237,MUS 1A,A01,890937,Staff,2,0,25,23
1746615701237,MUS 1A,A02,891035,Staff,6,0,25,19
1746615701237,MUS 1A,C01,958912,Staff,24,0,25,1
1746615701237,MUS 1A,C02,958913,Staff,25,0,25,0
1746615703294,MUS 2AK,A00,957092,Ohnishi; Takae,15,0,15,0
1746615704324,MUS 4,A01,891044,Staff,0,0,25,25
1746615704324,MUS 4,A02,891045,Staff,22,0,25,3
1746615704324,MUS 4,B01,891048,Staff,17,0,25,8
1746615704324,MUS 4,B02,891050,Staff,25,0,25,0
1746615705369,MUS 5,A01,957506,Dubnov; Shlomo,0,0,25,25
1746615705369,MUS 5,A02,957622,Dubnov; Shlomo,12,0,25,13
1746615705369,MUS 5,A03,957623,Dubnov; Shlomo,20,0,25,5
1746615706397,MUS 6,A01,891053,Freitas Caetano; Marcelo,24,0,25,1
1746615706397,MUS 6,A02,891054,Freitas Caetano; Marcelo,23,0,25,2
1746615707427,MUS 7,A01,891081,Staff,0,0,25,25
1746615707427,MUS 7,A02,891082,Staff,3,0,25,22
1746615708457,MUS 8GS,A00,891118,Borgo; David Garcia,1,0,25,24
1746615709484,MUS 11,A01,891140,Staff,8,0,25,17
1746615709484,MUS 11,A02,891141,Staff,21,0,25,4
1746615710510,MUS 13,A01,891143,Staff,8,0,25,17
1746615710510,MUS 13,A02,891144,Staff,24,0,25,1
1746615711542,MUS 15,A01,891146,Staff,9,0,25,16
1746615711542,MUS 15,A02,891148,Staff,21,0,25,4
1746615711542,MUS 15,B01,891150,Staff,18,0,25,7
1746615711542,MUS 15,B02,891151,Staff,25,0,25,0
1746615712568,MUS 20,A01,891153,Staff,5,0,20,15
1746615712568,MUS 20,A02,891155,Staff,14,0,20,6
1746615713595,MUS 80,A00,891156,Staff,19,0,25,6
1746615713595,MUS 80,B00,891157,Staff,23,0,25,2
1746615714623,MUS 130,A00,891158,Ohnishi; Takae,35,0,35,0
1746615715650,MUS 150GS,A01,891160,Borgo; David Garcia,1,0,25,24
1746615716679,MUS 170,A01,891162,Freitas Caetano; Marcelo,20,0,25,5
1746615716679,MUS 170,A02,891164,Freitas Caetano; Marcelo,21,0,25,4
1746615717708,NANO 11,A00,886220,Vazquez Mena; Oscar,13,0,15,2
1746615718735,NANO 15,A01,886222,Drews; Aaron,4,0,7,3
1746615719765,NANO 104,A00,886224,Sirbuly; Donald,17,0,25,8
1746615720793,PH 40,A00,886528,Staff,23,0,40,17
1746615721818,PH 45,A01,886799,Staff,35,0,40,5
1746615722879,PH 110,A00,886802,Staff,0,6,40,40
1746615723904,PH 172,A00,906716,Staff,19,0,35,16
1746615724931,PH 191,A00,886803,Staff,6,0,40,34
1746615725960,PHIL 1,A00,889500,Staff,20,0,30,10
1746615726998,PHIL 10,A01,889549,Grush; Rick Scott,16,0,22,6
1746615726998,PHIL 10,A02,889551,Grush; Rick Scott,22,0,22,0
1746615728026,PHIL 28,A01,889559,Lamey; Andy M.,0,2,31,31
1746615728026,PHIL 28,A02,889561,Lamey; Andy M.,0,1,30,30
1746615728026,PHIL 28,A03,889572,Lamey; Andy M.,0,1,30,30
1746615729054,PHIL 35,A00,907839,Staff,13,0,15,2
1746615730080,PHIL 60,A00,889574,Staff,73,0,90,17
1746615731107,PHIL 101,A00,958004,Staff,12,0,15,3
1746615733163,PHIL 136,A00,889582,Fulkerson; Matthew Todd,26,0,45,19
1746615734189,PHIL 163,A01,889601,Staff,21,0,30,9
1746615734189,PHIL 163,B01,889606,Brandt; Reuven A,0,3,0,0
1746615735213,PHIL 164,A00,889610,Staff,16,0,30,14
1746615736238,PHIL 165,A00,889613,Staff,22,0,30,8
1746615737269,PHYS 1A,A00,886431,Staff,30,0,70,40
1746615738298,PHYS 1AL,001,886432,Tsai; Philbert S,0,1,30,30
1746615738298,PHYS 1AL,002,886436,Tsai; Philbert S,13,0,30,17
1746615739327,PHYS 1B,A00,886439,Staff,184,0,240,56
1746615740354,PHYS 1BL,001,886441,Tsai; Philbert S,0,4,30,30
1746615740354,PHYS 1BL,002,886444,Tsai; Philbert S,2,0,30,28
1746615741383,PHYS 1C,A00,896092,Arnold; Kam S,78,0,146,68
1746615742415,PHYS 1CL,001,886448,Tsai; Philbert S,0,1,30,30
1746615742415,PHYS 1CL,002,886449,Tsai; Philbert S,1,0,30,29
1746615742415,PHYS 1CL,003,886450,Tsai; Philbert S,16,0,30,14
1746615742415,PHYS 1CL,004,886451,Tsai; Philbert S,15,0,30,15
1746615743447,PHYS 2B,A01,886457,Staff,67,0,115,48
1746615744474,PHYS 2C,A01,886460,Shotwell; Brian,0,9,65,65
1746615745499,PHYS 2CL,A01,886467,Staff,0,4,28,28
1746615745499,PHYS 2CL,A02,886468,Staff,0,3,28,28
1746615746525,PHYS 2D,A01,886470,Staff,10,0,50,40
1746615747556,PHYS 4B,A01,886475,Grinstein; Benjamin,22,0,40,18
1746615748581,POLI 5,A00,891173,Desposato; Scott,7,0,25,18
1746615749610,POLI 5D,A01,891175,Staff,5,0,5,0
1746615749610,POLI 5D,B01,891178,Staff,5,0,5,0
1746615750637,POLI 11,A00,891179,Ferree; Karen E,0,0,35,35
1746615751667,POLI 12,A00,891180,Staff,15,0,30,15
1746615752696,POLI 27,A01,891182,Staff,11,0,75,64
1746615753726,POLI 30,A00,891183,Staff,8,0,50,42
1746615754764,POLI 100B,A00,891244,Staff,5,1,35,30
1746615755793,POLI 100I,A00,891247,Staff,7,0,30,23
1746615756819,POLI 104J,A00,891248,Nichter; Maysa,14,0,30,16
1746615757844,POLI 104U,A00,891250,Nichter; Maysa,1,0,30,29
1746615759900,POLI 110B,A00,891255,Wiens; David,19,0,25,6
1746615760926,POLI 112A,A00,891256,Wiens; David,6,0,25,19
1746615761952,POLI 114BR,A00,891261,Staff,19,0,30,11
1746615763018,POLI 117R,A00,891262,Forman; Fonna,0,6,50,50
1746615764044,POLI 118,A00,891264,Ingham; Sean,17,0,25,8
1746615765072,POLI 124A,A00,891265,Staff,18,0,20,2
1746615766098,POLI 125D,A00,891266,Nichter; Simeon C,2,0,25,23
1746615767126,POLI 126,A00,891268,Nichter; Simeon C,7,0,25,18
1746615768153,POLI 126AA,A00,891272,Staff,15,0,25,10
1746615769179,POLI 130AA,A00,891273,Staff,15,0,20,5
1746615770206,POLI 134AA,A00,891274,Staff,4,0,20,16
1746615772256,POLI 138,A00,891278,Staff,21,0,25,4
1746615773286,POLI 142K,A00,891280,Staff,10,0,25,15
1746615774317,POLI 142M,A00,891281,Gartzke; Erik,16,0,30,14
1746615775341,POLI 142P,A00,891284,Staff,20,0,30,10
1746615776366,POLI 143,A00,891285,Gartzke; Erik,12,0,30,18
1746615777393,POLI 153,A00,891286,Staff,19,0,20,1
1746615779447,POLI 175,A00,891290,Staff,15,0,20,5
1746615780481,PSYC 1,A00,890674,Steiner; Eric Tomas,0,11,45,45
1746615781514,PSYC 2,A00,890676,Albright; Thomas D,20,0,35,15
1746615782546,PSYC 3,A00,890679,Staff,17,0,20,3
1746615783574,PSYC 6,A00,959858,Staff,19,0,20,1
1746615784605,PSYC 60,A01,890684,Rickard; Timothy C.,0,6,45,45
1746615785639,PSYC 70,A01,890689,Geller; Emma Harlan,6,0,30,24
1746615786667,PSYC 71,A01,959860,Staff,21,0,25,4
1746615787694,PSYC 100,A00,890690,Lacefield; Katharine I,0,50,180,180
1746615788719,PSYC 102,A00,890695,Staff,18,0,40,22
1746615789745,PSYC 105,A00,890699,Geller; Emma Harlan,70,0,100,30
1746615790773,PSYC 106,A00,890701,Gorman; Michael R.,5,0,30,25
1746615791801,PSYC 108,A00,890704,Adrian; Julia Anna,0,29,50,50
1746615792827,PSYC 118,A01,890712,Staff,11,0,30,19
1746615793855,PSYC 124,A00,890716,Chapman; Eddie Nathaniel,25,0,60,35
1746615794882,PSYC 131,A00,890717,Anagnostaras; Stephan,0,7,80,80
1746615795909,PSYC 137,A00,890719,Winkielman; Piotr,0,11,30,30
1746615796943,PSYC 144,A00,890721,Adrian; Julia Anna,0,9,45,45
1746615797973,PSYC 162,A00,890805,Staff,0,2,75,75
1746615799002,PSYC 169,A00,890810,Staff,0,15,30,30
1746615800028,PSYC 172,A00,890814,Gorman; Michael R.,9,0,30,21
1746615801054,PSYC 181,A00,890818,Anagnostaras; Stephan,6,0,200,194
1746615802090,PSYC 184,A00,959861,Staff,160,0,175,15
1746615803118,PSYC 189,A00,890823,Staff,0,2,30,30
1746615804146,PSYC 191,A00,890884,Rickard; Timothy C.,0,12,35,35
1746615805177,PSYC 193,A00,890913,Staff,19,0,30,11
1746615805177,PSYC 193,B00,890914,Chapman; Eddie Nathaniel,24,0,30,6
1746615806205,PSYC 193L,A01,890918,Lowe; Angela Beth,20,0,30,10
1746615806205,PSYC 193L,B01,890921,Hurwitz; Ethan Scott,20,0,30,10
1746615806205,PSYC 193L,C01,890928,Staff,30,0,30,0
1746615807235,RELI 149,A00,886806,Rahimi; Babak,23,0,40,17
1746615808260,SE 9,A01,886814,Staff,7,0,20,13
1746615809288,SE 101B,A01,886816,Chadha; Mayank,3,0,35,32
1746615810316,SE 110B,A00,886818,Zhu; Qiang,4,0,75,71
1746615811343,SE 125,A01,886830,Staff,10,0,30,20
1746615812372,SE 130B,A01,886835,Staff,14,0,40,26
1746615813397,SE 131A,A01,886838,Krysl; Petr,34,0,55,21
1746615814422,SE 154,A00,886840,Staff,28,0,50,22
1746615815447,SE 164GS,A01,886849,Staff,6,0,20,14
1746615816475,SE 167GS,A01,886853,Staff,6,0,20,14
1746615817504,SIO 25,A01,890107,Staff,19,0,30,11
1746615818533,SIO 45,A00,890109,Cook; Geoffrey W,114,0,200,86
1746615819563,SIO 109R,A00,890110,Forman; Fonna,0,16,20,20
1746615820593,SIO 187,A01,890114,Kacev; David,15,0,40,25
1746615821623,SOCI 1,A01,890431,Thorpe; Charles Robert,14,0,30,16
1746615821623,SOCI 1,A02,890518,Thorpe; Charles Robert,30,0,30,0
1746615822650,SOCI 2,A01,957978,Staff,25,0,25,0
1746615822650,SOCI 2,A02,957979,Staff,23,0,25,2
1746615823677,SOCI 20,A01,890523,Calderon-Zaks; Michael Aar,21,0,30,9
1746615823677,SOCI 20,A02,890526,Calderon-Zaks; Michael Aar,29,0,30,1
1746615824709,SOCI 30,A01,890533,Pardo Guerra; Juan Pablo,37,0,40,3
1746615825736,SOCI 40,A01,890535,Staff,27,0,45,18
1746615826775,SOCI 104Q,A00,890559,Staff,17,0,30,13
1746615827806,SOCI 106,A00,890560,Arnal; Maud Marie Leonie,20,0,30,10
1746615828832,SOCI 110,A00,890567,Holkenbrink-Monk; Charlene,19,0,30,11
1746615829857,SOCI 112,A00,890568,Victoria Torres; Pablo,2,0,55,53
1746615830885,SOCI 115,A00,890597,Arnal; Maud Marie Leonie,28,0,45,17
1746615832943,SOCI 121,A00,890604,Pardo Guerra; Juan Pablo,38,0,45,7
1746615833970,SOCI 126,A01,890608,Staff,8,0,10,2
1746615834999,SOCI 127,A00,890609,Staff,18,0,30,12
1746615836025,SOCI 131,A00,890610,Thorpe; Charles Robert,37,0,45,8
1746615837054,SOCI 135,A00,890615,Payne; Christine Anna,14,0,45,31
1746615838084,SOCI 139,A00,890620,Staff,38,0,45,7
1746615839109,SOCI 148E,A00,890622,Calderon-Zaks; Michael Aar,36,0,45,9
1746615840136,SOCI 150,A00,890623,Kohler; Kristopher M.,31,0,45,14
1746615841164,SOCI 157,A00,890625,Jules-Rosette; Bennetta W.,18,0,20,2
1746615842195,SOCI 160,A00,890627,Payne; Christine Anna,21,0,45,24
1746615843231,SYN 1,A00,886855,Fish; Gwendolyn Anne,0,1,0,0
1746615843231,SYN 1,B00,906086,Fish; Gwendolyn Anne,0,2,0,2
1746615844263,SYN 2R,A00,886860,Staff,0,17,15,15
1746615844263,SYN 2R,B00,906106,Atkinson; Arthur Laird,0,16,15,15
1746615845294,SYN 100,A01,886866,Browne; Emily,0,28,20,20
1746615845294,SYN 100,B01,906128,Rock; Martin,0,4,20,20
1746615845294,SYN 100,C01,906140,Deavenport; James Cary,0,4,20,20
1746615845294,SYN 100,D01,907816,Deavenport; James Cary,0,5,20,20
1746615846324,TDAC 1,A00,890286,Walsh; Kim C.,7,0,20,13
1746615847356,TDAC 101,A00,890296,Basso; Beatrice,15,0,20,5
1746615848385,TDDE 131,A00,890297,Staff,47,0,50,3
1746615849410,TDDM 1,A00,890287,Weinberg; Sadie,25,0,30,5
1746615850440,TDGE 11,A00,890288,Fulton; Julia,138,0,200,62
1746615850440,TDGE 11,B00,890289,Castro; Robert Jess,184,0,200,16
1746615851471,TDGE 25,B00,957359,Walsh; Kim C.,5,0,20,15
1746615852501,TDGE 40,A01,890292,Power; Jade Yukana,26,0,30,4
1746615853526,TDGE 124,A00,890298,Havis; Allan,0,2,50,50
1746615854561,TDGE 131R,A00,890299,Burelle; Julie Sara Veronique,15,0,42,27
1746615855590,TDHT 101,A00,890300,Staff,10,0,20,10
1746615856621,TDHT 109,A01,890302,Anderson; Mysia Anyse,31,0,40,9
1746615857650,TDMV 1,A00,890293,Arcidiacono; Kristin,18,0,30,12
1746615858679,TDMV 2,A00,890294,Weinberg; Sadie,23,0,30,7
1746615859705,TDMV 3,A00,957878,Arcidiacono; Kristin,28,0,30,2
1746615861760,TDMV 138,A00,890304,Jun; Grace Shin Hae,25,0,40,15
1746615862787,TDMV 140,A00,890305,Corrales; Joseph Bernales,25,0,30,5
1746615863814,TDMV 142,A00,890307,Caligagan; Tony,32,0,40,8
1746615864839,TDMV 144,A00,890308,Camaya; Michelle Ann,25,0,30,5
1746615865871,TDPW 1,A00,890295,Stein; Deborah Isobel,3,0,20,17
1746615866936,USP 2,A01,890272,Lerner; Amy M,7,0,20,13
1746615867961,USP 3,A01,890274,Staff,12,0,30,18
1746615868986,USP 15,A01,890276,Sun; Feiyang,16,0,30,14
1746615870015,USP 25,A00,890277,Shenkman; Michael Thomas,18,0,25,7
1746615871043,USP 138,A00,890278,Staff,13,0,25,12
1746615872069,USP 143,A00,890279,Staff,21,0,70,49
1746615873101,USP 144,A00,890280,Chowdhury; Muhammed Zohir,16,0,30,14
1746615874130,USP 150,A00,890281,Boomhower; Matthew Charles,4,0,30,26
1746615875161,USP 151,A00,890282,Staff,16,0,20,4
1746615876188,USP 162,A00,890283,Andrews; Abigail Leslie,16,0,20,4
1746615877221,USP 168,A00,920477,Kwak; Nancy,0,0,5,5
1746615878251,USP 181,A00,890284,Staff,3,0,20,17
1746615879280,USP 191A,A00,890285,Staff,12,0,20,8
1746615880306,VIS 101,A00,886512,Staff,26,0,75,49
1746615881338,VIS 103,A00,886513,Cruz; Edwin Teddy,61,0,75,14
1746615882364,VIS 108,A00,886514,Staff,4,0,15,11
1746615883390,VIS 127P,A00,886515,Shen; Kuiyi,80,0,146,66
1746615884421,VIS 149,A00,886516,Yoldas; Pinar,0,0,15,15
1746615885449,VIS 164,A00,886526,Erdmann; Dean,19,0,22,3
1746615886478,VIS 194S,A00,886527,Staff,61,0,75,14
1746615887508,WCWP 10A,C00,886484,Martiniuk; Jill,12,0,15,3
1746615888537,WCWP 10B,A00,886490,Uriarte; Emma,0,0,15,15
1746615888537,WCWP 10B,B00,886491,Dhir; Simrita,8,0,15,7
1746615888537,WCWP 10B,C00,886492,Ornelas; Tricia,0,0,15,15
1746615889564,WCWP 100,A00,886494,Young; Mark T,0,6,15,15
1746615891796,AAS 10,A01,886199,Childs; Dennis R.,0,3,0,0
1746615892824,ANAR 104,A01,886940,Shtienberg; Gilad,27,0,30,3
1746615893852,ANAR 120,A00,886953,Staff,13,0,20,7
1746615894883,ANBI 148,A01,886955,Wilder; Linnea Lorene,30,0,40,10
1746615896937,ANSC 122,A00,886957,Staff,24,0,30,6
1746615898176,ANSC 150,A00,886958,Sloane; Julia Kathryn,2,0,15,13
1746615899202,ANSC 156,A00,886959,Jenkins; Janis A.,0,1,15,15
1746615900232,ANSC 180,A00,886960,Staff,11,0,17,6
1746615901264,ANSC 188,A00,886961,Jassal; Aftab,9,0,25,16
1746615902297,ANSC 190,A00,886962,Jassal; Aftab,14,0,25,11
1746615903326,ANSC 191,A00,886963,Staff,18,0,20,2
1746615904354,ANTH 3,A01,891689,Staff,17,0,20,3
1746615905385,ANTH 5,A00,886933,Semendeferi; Ekaterini,16,0,20,4
1746615906416,ANTH 10,A00,886934,Staff,0,12,30,30
1746615907444,ANTH 21,A01,886936,Staff,41,0,60,19
1746615908470,ANTH 23,A01,886938,Staff,92,0,100,8
1746615909505,ANTH 105,A00,886964,Stewart; Alexander B,84,0,100,16
1746615910532,ANTH 108,A00,886965,Pedersen; David,9,0,20,11
1746615911573,AWP 10,001,886147,Staff,0,0,0,0
1746615911573,AWP 10,002,886148,Staff,0,0,0,0
1746615911573,AWP 10,003,886149,Staff,0,0,0,0
1746615911573,AWP 10,004,886150,Staff,0,0,0,0
1746615911573,AWP 10,005,886151,Staff,0,0,0,0
1746615911573,AWP 10,006,886152,Staff,0,0,0,0
1746615911573,AWP 10,007,886153,Staff,0,0,0,0
1746615911573,AWP 10,008,886154,Staff,0,0,0,0
1746615911573,AWP 10,009,886155,Staff,0,0,0,0
1746615911573,AWP 10,010,886156,Staff,0,0,0,0
1746615911573,AWP 10,011,886158,Staff,0,0,0,0
1746615911573,AWP 10,012,886160,Staff,0,0,0,0
1746615911573,AWP 10,013,886161,Staff,0,0,0,0
1746615911573,AWP 10,014,886162,Staff,0,0,0,0
1746615911573,AWP 10,015,886163,Staff,0,0,0,0
1746615911573,AWP 10,016,886164,Staff,0,0,0,0
1746615911573,AWP 10,017,886165,Staff,0,0,0,0
1746615911573,AWP 10,018,886166,Staff,0,0,0,0
1746615911573,AWP 10,019,886168,Staff,0,0,0,0
1746615911573,AWP 10,020,886170,Staff,0,0,0,0
1746615911573,AWP 10,021,886172,Staff,0,0,0,0
1746615912609,AWP 10R,001,886173,Staff,0,1,0,0
1746615912609,AWP 10R,002,886174,Staff,0,1,0,0
1746615912609,AWP 10R,003,886175,Staff,0,0,0,0
1746615912609,AWP 10R,004,886176,Staff,0,0,0,0
1746615912609,AWP 10R,005,886177,Staff,0,0,0,0
1746615912609,AWP 10R,006,886178,Staff,0,0,0,0
1746615912609,AWP 10R,007,886179,Staff,0,0,0,0
1746615912609,AWP 10R,008,886181,Staff,0,0,0,0
1746615912609,AWP 10R,009,886182,Staff,0,0,0,0
1746615912609,AWP 10R,010,886183,Staff,0,0,0,0
1746615912609,AWP 10R,011,886184,Staff,0,0,0,0
1746615912609,AWP 10R,012,886185,Staff,0,0,0,0
1746615912609,AWP 10R,013,886186,Staff,0,0,0,0
1746615912609,AWP 10R,014,886187,Staff,0,0,0,0
1746615912609,AWP 10R,015,886188,Staff,0,0,0,0
1746615912609,AWP 10R,016,886189,Staff,0,0,0,0
1746615912609,AWP 10R,017,960532,Staff,0,0,0,0
1746615912609,AWP 10R,018,960533,Staff,0,0,0,0
1746615912609,AWP 10R,019,960534,Staff,0,0,0,0
1746615912609,AWP 10R,020,960538,Staff,0,0,0,0
1746615912609,AWP 10R,021,960540,Staff,0,0,0,0
1746615912609,AWP 10R,022,960541,Staff,0,0,0,0
1746615912609,AWP 10R,023,960542,Staff,0,0,0,0
1746615912609,AWP 10R,024,960544,Staff,0,0,0,0
1746615912609,AWP 10R,025,960545,Staff,0,0,0,0
1746615912609,AWP 10R,026,960548,Staff,0,0,0,0
1746615913636,AWP 102R,A00,886190,Staff,0,0,0,0
1746615913636,AWP 102R,B00,886191,Staff,0,0,0,0
1746615914662,BENG 100,A01,886193,Staff,17,0,30,13
1746615915692,BENG 122A,A01,886195,Hasty; Jeff M,13,0,30,17
1746615916719,BENG 166A,A00,886196,Sah; Robert Lie-Yuan,0,3,30,30
1746615917750,BENG 190,A00,958050,Khojah; Reem I,17,0,25,8
1746615918779,BIBC 102,A01,894320,Staff,0,1,46,46
1746615918779,BIBC 102,A02,894321,Staff,0,0,46,46
1746615918779,BIBC 102,A03,894344,Staff,6,0,46,40
1746615918779,BIBC 102,A04,894345,Staff,27,0,47,20
1746615919815,BICD 100R,A01,894365,Smith; Laurie,0,2,58,58
1746615919815,BICD 100R,A02,894366,Smith; Laurie,0,4,58,58
1746615919815,BICD 100R,A03,894367,Smith; Laurie,0,0,59,59
1746615919815,BICD 100R,A04,959869,Smith; Laurie,38,0,59,21
1746615920843,BICD 136,A01,894383,Gustafson-Brown; Cindy,14,0,50,36
1746615921879,BIEB 102,A01,894494,Butler; Shannon Rhey,51,0,130,79
1746615923936,BIEB 150,A01,894617,Wills; Christopher,3,0,20,17
1746615923936,BIEB 150,A02,894631,Wills; Christopher,3,0,20,17
1746615923936,BIEB 150,A03,894937,Wills; Christopher,3,0,20,17
1746615923936,BIEB 150,A04,894946,Wills; Christopher,5,0,20,15
1746615924976,BIEB 194,A00,906141,Kurle; Carolyn M.,5,0,20,15
1746615926003,BILD 1,A01,894154,Staff,3,0,19,16
1746615926003,BILD 1,A02,894155,Staff,14,0,19,5
1746615926003,BILD 1,A03,894160,Staff,13,0,19,6
1746615926003,BILD 1,A04,894161,Staff,15,0,18,3
1746615927034,BILD 2,A01,894168,Staff,0,0,50,50
1746615927034,BILD 2,A02,894169,Staff,0,0,50,50
1746615927034,BILD 2,A03,894179,Staff,0,0,50,50
1746615927034,BILD 2,A04,894203,Staff,22,0,50,28
1746615928065,BILD 3,A01,894213,Staff,23,0,31,8
1746615928065,BILD 3,A02,894214,Staff,26,0,31,5
1746615928065,BILD 3,A03,894235,Staff,28,0,31,3
1746615928065,BILD 3,A04,894236,Staff,28,0,32,4
1746615929091,BILD 4,A01,894253,Reuther; Keefe,5,0,24,19
1746615929091,BILD 4,A02,894258,Reuther; Keefe,16,0,24,8
1746615930122,BILD 5,A01,894276,Reuther; Keefe,33,0,50,17
1746615930122,BILD 5,A02,894277,Reuther; Keefe,45,0,50,5
1746615930122,BILD 5,A03,894290,Reuther; Keefe,44,0,50,6
1746615930122,BILD 5,A04,894291,Reuther; Keefe,48,0,50,2
1746615931148,BILD 24,A01,894297,Pirino; Giorgia,40,0,60,20
1746615932182,BIMM 100,B01,958915,Staff,71,0,100,29
1746615933216,BIMM 101,A01,895017,McDonnell; Lisa Marie,0,5,24,24
1746615933216,BIMM 101,A02,895018,McDonnell; Lisa Marie,0,5,24,24
1746615933216,BIMM 101,B01,895020,McDonnell; Lisa Marie,0,5,24,24
1746615933216,BIMM 101,B02,895021,McDonnell; Lisa Marie,0,4,24,24
1746615934245,BIMM 110,A01,895023,Staff,1,0,25,24
1746615934245,BIMM 110,A02,895024,Staff,9,0,25,16
1746615934245,BIMM 110,A03,895025,Staff,18,0,25,7
1746615934245,BIMM 110,A04,895031,Staff,20,0,25,5
1746615935280,BIMM 120,A01,895114,Gustafson-Brown; Cindy,14,0,28,14
1746615935280,BIMM 120,A02,895126,Gustafson-Brown; Cindy,21,0,27,6
1746615936307,BIPN 100,A01,895130,Yang; Mingyu,0,0,38,38
1746615936307,BIPN 100,A02,895131,Yang; Mingyu,31,0,38,7
1746615936307,BIPN 100,A03,895132,Yang; Mingyu,32,0,38,6
1746615936307,BIPN 100,A04,895133,Yang; Mingyu,27,0,36,9
1746615937333,BIPN 120,A01,895135,Cooke; James Edward,0,3,13,13
1746615937333,BIPN 120,A02,895136,Cooke; James Edward,0,1,13,13
1746615937333,BIPN 120,A03,895137,Cooke; James Edward,0,3,13,13
1746615937333,BIPN 120,A04,895156,Cooke; James Edward,0,2,11,11
1746615938360,BIPN 134,A01,895235,Cooke; James Edward,0,1,25,25
1746615938360,BIPN 134,A02,895237,Cooke; James Edward,0,0,25,25
1746615938360,BIPN 134,A03,895240,Cooke; James Edward,1,0,25,24
1746615938360,BIPN 134,A04,895270,Cooke; James Edward,20,0,25,5
1746615939387,BIPN 189,A00,892103,Staff,0,14,14,14
1746615941439,BISP 194,A00,958008,Staff,0,2,0,0
1746615942471,CAT 124,A01,922009,Staff,0,5,20,20
1746615943513,CAT 125R,A00,886390,Morales; Celeste Georgianna,0,4,20,20
1746615943513,CAT 125R,B00,886391,Irwin; Matthew Joseph,0,4,20,20
1746615943513,CAT 125R,C00,886392,Smith; Lauryn Alissa,0,2,20,20
1746615943513,CAT 125R,D00,886393,Vanderschuit; Maya Alysia,0,3,20,20
1746615943513,CAT 125R,E00,886394,Marchisotto; Jennifer Anne,0,3,20,20
1746615944541,CENG 15,A01,886218,Drews; Aaron,3,0,8,5
1746615945568,CENG 113,A00,886219,Opatkiewicz; Justin Paul,15,0,25,10
1746615946595,CGS 101,A00,887044,Staff,7,0,20,13
1746615947622,CGS 105,A01,887046,Staff,14,0,25,11
1746615948663,CGS 112,A00,887047,Cuong; Marisol,12,0,15,3
1746615949689,CGS 113,A00,887048,Staff,23,0,30,7
1746615950718,CGS 120,A00,887049,Staff,9,0,17,8
1746615951744,CHEM 6A,A01,886336,Lam; Tin Yiu,38,0,50,12
1746615951744,CHEM 6A,A02,886338,Lam; Tin Yiu,37,0,50,13
1746615952776,CHEM 6B,A01,886341,Hopkins; Patrycja Anna,16,0,50,34
1746615952776,CHEM 6B,A02,886343,Hopkins; Patrycja Anna,42,0,50,8
1746615953801,CHEM 6C,A01,886346,Albizati; Kim F.,0,2,50,50
1746615953801,CHEM 6C,A02,886348,Albizati; Kim F.,24,0,50,26
1746615954832,CHEM 40A,A01,886352,Klosterman; Jeremy K,65,0,100,35
1746615955858,CHEM 40B,A01,886356,Klosterman; Jeremy K,0,24,100,100
1746615956888,CHEM 41B,A01,886360,Theodorakis; Emmanuel,25,0,50,25
1746615956888,CHEM 41B,A02,886362,Theodorakis; Emmanuel,47,0,50,3
1746615957916,CHIN 165A,A00,886382,Xu; Li,18,0,20,2
1746615958947,CLAS 120,A00,886387,Myerston Santana; Jacobo,33,0,40,7
1746615960007,COGS 9,A01,886967,Shannon; Kyle Michael,42,0,60,18
1746615961032,COGS 11,A01,886969,Staff,9,0,30,21
1746615962058,COGS 14A,A01,886971,Staff,5,0,60,55
1746615963087,COGS 14B,A01,886973,Hoffman; Drew Ellen,4,0,60,56
1746615964119,COGS 18,A01,886975,Morgan; Eric,34,0,60,26
1746615965150,COGS 20,A01,886977,Staff,3,0,8,5
1746615965150,COGS 20,A02,886978,Staff,5,0,7,2
1746615966180,COGS 100,A01,907783,Staff,0,1,30,30
1746615967206,COGS 101B,A01,886980,Staff,0,4,48,48
1746615968237,COGS 101C,A01,886982,Delgado; Tania,0,5,44,44
1746615969266,COGS 102A,A01,886984,Johnson; Christine M.,3,0,30,27
1746615970292,COGS 118B,A01,886986,Staff,0,4,88,88
1746615971320,COGS 150,A01,886988,Bergen; Benjamin,22,0,50,28
1746615972352,COGS 153,A00,886989,Delgado; Tania,1,3,41,40
1746615973381,COGS 186,A01,886991,Staff,0,0,32,32
1746615974406,COGS 187A,A01,886993,Boyle; Mary E. T.,7,0,30,23
1746615975436,COGS 189,A00,886994,Staff,1,1,30,29
1746615976464,COMM 10,A01,886996,Staff,0,0,20,21
1746615976464,COMM 10,A02,886997,Staff,10,0,20,10
1746615976464,COMM 10,A03,959845,Staff,19,0,20,1
1746615977489,COMM 20,A01,886999,Leuning; Grant Maurstad,24,0,40,16
1746615979546,COMM 100A,A01,887002,Staff,0,0,20,25
1746615979546,COMM 100A,A02,887003,Staff,5,0,20,15
1746615980571,COMM 100B,A01,887005,Staff,0,8,20,24
1746615981602,COMM 106D,A00,887006,Staff,14,0,40,26
1746615982635,COMM 110G,A00,887007,Whitworth-Smith; Andrew C,12,0,40,28
1746615983662,COMM 111B,A00,887008,Staff,31,0,40,9
1746615984689,COMM 113T,A00,887009,Abuelhiga; Soraya Jill,28,0,40,12
1746615984689,COMM 113T,B00,906733,Staff,39,0,40,1
1746615985718,COMM 145,A00,887010,Staff,13,0,40,27
1746615986747,COMM 146,A00,887054,Staff,32,0,40,8
1746615987774,COMM 190,A00,887012,Staff,8,0,23,15
1746615988805,CSE 8A,A50,887015,Cao; Yingjun,56,0,85,29
1746615989832,CSE 11,A01,887017,Cao; Yingjun,11,0,70,59
1746615990858,CSE 20,A01,887019,Staff,30,0,50,20
1746615991893,CSE 21,A01,887021,Staff,79,0,100,21
1746615991893,CSE 21,B01,892583,Braun; Oliver,45,0,50,5
1746615992918,CSE 30,A01,887025,Eldon; John,142,0,200,58
1746615993945,CSE 100,A01,887027,Staff,26,0,50,24
1746615993945,CSE 100,A02,887028,Staff,42,0,50,8
1746615994973,CSE 101,A01,887030,Braun; Oliver,74,0,100,26
1746615994973,CSE 101,B01,887032,Jones; Miles E,0,3,50,50
1746615994973,CSE 101,B02,887033,Jones; Miles E,0,2,50,50
1746615996006,CSE 105,A01,908084,Jones; Miles E,32,0,50,18
1746615996006,CSE 105,A02,908087,Jones; Miles E,31,0,50,19
1746615997039,CSE 135,A01,887035,Powell; Thomas Allan,0,5,50,50
1746615998065,CSE 142,A01,887037,Staff,7,0,60,53
1746615999095,CSE 142L,A01,887039,Staff,34,0,60,26
1746616000122,CSE 151A,A01,887041,Solares; Edwin A,47,0,100,53
1746616001148,CSE 175,A01,887043,Kumar; Rakesh,30,0,30,0
1746616002179,CSS 1,A01,886389,Staff,0,1,40,40
1746616003207,DSC 30,A01,908097,Liao; Soohyun Nam,47,0,75,28
1746616004236,DSC 40A,A01,908099,Shannon; Kyle Michael,30,0,50,20
1746616005263,DSC 40B,A01,908112,Staff,15,0,50,35
1746616006290,DSC 80,A01,908116,Staff,19,0,60,41
1746616007318,DSC 197,001,956863,Eldridge; Justin Matthew,9999,0,9999,0
1746616008346,ECE 5,A01,886400,Morris; Karcher William,1,0,6,5
1746616008346,ECE 5,A02,886401,Morris; Karcher William,3,0,6,3
1746616009377,ECE 148,A01,886403,Silberman; Jack,0,14,14,14
1746616010413,ECON 1,A01,887265,Crane; Meredith Helen,11,0,70,59
1746616010413,ECON 1,B01,887268,Staff,42,0,50,8
1746616011444,ECON 2,A01,887273,Crane; Meredith Helen,54,0,70,16
1746616012472,ECON 3,A01,887279,Rondina; Giacomo,31,0,70,39
1746616013499,ECON 4,A01,887282,Anderson; John Charles,0,2,10,10
1746616014526,ECON 5,A01,887285,Staff,34,0,45,11
1746616014526,ECON 5,B01,887292,Staff,41,0,45,4
1746616015554,ECON 100A,A01,887337,Newhouse; Herbert S,54,0,70,16
1746616015554,ECON 100A,B01,887349,Staff,45,0,50,5
1746616016581,ECON 100B,A01,887361,Du; Songzi,29,0,70,41
1746616017613,ECON 100C,A01,887445,Newhouse; Herbert S,59,0,70,11
1746616018641,ECON 105,A00,887488,Vespa; Emanuel Ignacio,23,0,35,12
1746616019670,ECON 109,A01,887506,Shishkin; Denis,28,0,35,7
1746616020701,ECON 110A,A01,887568,Alon; Titan Michael,0,2,35,35
1746616020701,ECON 110A,B01,907601,Alon; Titan Michael,20,0,35,15
1746616021733,ECON 110B,A01,887598,Levkoff; Steven B.,0,24,70,70
1746616022764,ECON 112,A00,887599,Rondina; Giacomo,19,0,35,16
1746616023795,ECON 120A,A01,887603,Dai; Yinlin,36,0,70,34
1746616024830,ECON 120C,A01,887608,Sun; Yixiao,0,1,35,35
1746616024830,ECON 120C,B01,887614,Sun; Yixiao,0,0,35,35
1746616025863,ECON 138,A00,887621,Bharadwaj; Prashant,0,21,20,20
1746616026898,ECON 144,A00,958007,Squires; Dale E,11,0,35,24
1746616027926,ECON 171,A01,907666,Staff,18,0,35,17
1746616028952,ECON 175,A00,887626,Wu; Pak Yeung,22,0,35,13
1746616029983,ECON 190,A00,887640,Vespa; Emanuel Ignacio,22,0,35,13
1746616031019,EDS 25,A01,888197,Staff,0,0,0,0
1746616031019,EDS 25,A02,888209,Staff,0,0,0,0
1746616031019,EDS 25,A03,888210,Staff,0,0,0,0
1746616031019,EDS 25,A04,888212,Staff,0,0,0,0
1746616031019,EDS 25,A05,888213,Staff,0,0,0,0
1746616031019,EDS 25,A06,888214,Staff,0,0,0,0
1746616031019,EDS 25,A07,888235,Staff,0,2,0,0
1746616031019,EDS 25,A08,888236,Staff,0,0,0,0
1746616031019,EDS 25,A09,888240,Staff,0,0,0,0
1746616031019,EDS 25,A10,888244,Staff,0,0,0,0
1746616031019,EDS 25,B01,888273,Staff,0,0,0,0
1746616031019,EDS 25,B02,888285,Staff,0,0,0,0
1746616031019,EDS 25,B03,888423,Staff,0,0,0,1
1746616031019,EDS 25,B04,888432,Staff,0,0,0,0
1746616031019,EDS 25,B05,888433,Staff,0,0,0,0
1746616031019,EDS 25,B06,888467,Staff,0,0,0,0
1746616031019,EDS 25,B07,888468,Staff,0,0,0,0
1746616031019,EDS 25,B08,888479,Staff,0,0,0,0
1746616031019,EDS 25,B09,888484,Staff,0,0,0,0
1746616031019,EDS 25,B10,888487,Staff,0,0,0,0
1746616032047,EDS 38,A01,907700,Choi; Bailey Miyeon,30,0,30,0
1746616033079,EDS 112,A01,888601,Chapman; Thandeka K,12,0,40,28
1746616034106,EDS 115,A00,888697,Mendez; Kathrina Mendoza,10,0,30,20
1746616035134,EDS 116,A01,888893,Staff,33,0,40,7
1746616037231,EDS 124AR,A00,889133,Staff,29,0,50,21
1746616037231,EDS 124AR,B00,907471,Simon; Elizabeth A,37,0,50,13
1746616038258,EDS 124BR,A00,889134,Simon; Elizabeth A,44,0,100,56
1746616039286,EDS 125,A00,889135,Staff,25,0,30,5
1746616040313,EDS 126,A01,889138,Staff,35,0,40,5
1746616041344,EDS 164R,A01,889142,Wishard Guerra; Alison G.,32,0,50,18
1746616042371,ENG 30,A01,886396,Staff,0,0,0,0
1746616042371,ENG 30,B01,886398,Staff,0,0,0,0
1746616043397,ENVR 102,A00,906150,Montejo; Carolina,23,0,25,2
1746616044426,ETHN 103A,A00,887236,Man; Simeon S,0,2,0,0
1746616045453,ETHN 113,A00,887239,Staff,16,0,30,14
1746616046482,ETHN 116,A00,887240,Staff,16,0,25,9
1746616047513,ETHN 117,A00,887241,Choi; Esther Min,28,0,30,2
1746616048541,ETHN 118,A00,887243,Staff,24,0,30,6
1746616049571,ETHN 127,A00,887248,Cuong; Marisol,11,0,15,4
1746616050601,ETHN 139,A00,887250,Staff,7,0,10,3
1746616051631,ETHN 142,A00,887252,Staff,9,0,30,21
1746616052656,ETHN 161,A00,887253,Browne; Errol Tsekani,24,0,30,6
1746616053687,ETHN 163FR,A00,887255,Burelle; Julie Sara Veronique,0,0,5,5
1746616054714,GLBH 20,A00,889149,Elwardani; Nile Regina,8,0,42,34
1746616056773,GLBH 111,A01,889152,Burgos; Jose L.,17,0,17,0
1746616057801,GLBH 150,A00,889181,Sloane; Julia Kathryn,0,5,15,15
1746616060077,HDS 60,A01,886406,Warstadt; Melissa Fawn,72,0,80,8
1746616061109,HIAF 111,A00,889324,Gyamfi; Bright,25,0,32,7
1746616062135,HIEA 131,A00,889328,Staff,15,0,32,17
1746616063166,HIEA 144,A00,889333,Henry; Todd A.,26,0,32,6
1746616064196,HIEA 154,A00,889336,Henry; Todd A.,24,0,32,8
1746616065226,HIEU 106,A00,889339,Staff,22,0,32,10
1746616067279,HIEU 114,A00,889340,Staff,4,0,32,28
1746616068305,HIEU 135GS,A00,889342,Patterson; Patrick H.,0,0,1,24
1746616069329,HIEU 137,A00,889343,Edington; Claire Ellen,10,0,25,15
1746616070779,HIEU 148,A00,889345,Staff,14,0,32,18
1746616071806,HIEU 154,A00,889346,Biess; Frank Peter,21,0,32,11
1746616072835,HILA 102,A00,889351,Staff,12,0,32,20
1746616073861,HILD 2A,A01,889221,Lewandoski; Julia Mavis,0,8,32,32
1746616074886,HILD 7B,A01,889225,Man; Simeon S,0,12,32,32
1746616075913,HILD 7C,A01,889288,Alvarez; Luis A,0,14,32,32
1746616076943,HILD 30,A01,889323,Staff,0,5,32,32
1746616079008,HISC 119,A00,889383,Golan; Tal,20,0,32,12
1746616080036,HIUS 103,A00,889384,Man; Simeon S,0,0,32,32
1746616081069,HIUS 117,A00,919797,Kwak; Nancy,18,0,32,14
1746616082097,HIUS 142A,A00,919788,Staff,22,0,32,10
1746616084149,HIUS 149,A00,889386,Gyamfi; Bright,26,0,32,6
1746616085176,HIUS 155,A00,889387,Alvarez; Luis A,15,0,32,17
1746616086206,HUM 3,A01,886499,Caldwell; Michael Alan,19,0,50,31
1746616087231,HUM 3GS,A00,886500,Rodriguez; Bretton Sigfred,0,0,0,28
1746616088261,HUM 3R,A01,886502,Markman; Kristina,0,36,50,50
1746616089294,HUM 4,A01,886504,Crum; Matthew Stephen,23,0,50,27
1746616089294,HUM 4,B01,886506,West; Geoffrey Scott,17,0,50,33
1746616090324,HUM 4GS,A00,886507,Staff,0,0,0,19
1746616091352,HUM 5,A01,886509,Staff,31,0,50,19
1746616092377,HUM 5R,A01,886511,Zavodny; Tatiana Sophia,0,39,50,50
1746616093405,JAPN 180,A00,886407,Staff,16,0,40,24
1746616094433,LATI 50,A01,886409,Martin-Cabrera; Luis,3,0,22,19
1746616094433,LATI 50,A02,886410,Martin-Cabrera; Luis,19,0,22,3
1746616094433,LATI 50,A03,886411,Martin-Cabrera; Luis,21,0,22,1
1746616094433,LATI 50,A04,886412,Martin-Cabrera; Luis,8,0,22,14
1746616095459,LAWS 101,A00,907664,Staff,28,0,60,32
1746616096487,LIAB 1A,A00,889388,Saab; Dima,17,0,20,3
1746616097516,LIAB 1AX,A00,889389,El Cheddadi; Youniss,18,0,20,2
1746616098550,LIFR 1C,A00,889391,Van Moer; Vinciane G,8,0,20,12
1746616099581,LIFR 1CX,A00,889392,Van Moer; Vinciane G,7,0,20,13
1746616100612,LIFR 1D,A00,889393,Van Moer; Vinciane G,7,0,20,13
1746616101638,LIFR 1DX,A00,889394,Van Moer; Vinciane G,8,0,20,12
1746616102666,LIGN 7,A00,886923,Staff,25,0,50,25
1746616103693,LIGN 17,A00,886924,Kehler; Andrew Scott,126,0,150,24
1746616104721,LTAM 110,A00,889395,Staff,15,0,30,15
1746616105747,LTAM 110GS,A00,958010,Rodriguez; Bretton Sigfred,0,0,0,28
1746616106773,LTCH 101,A00,889397,Staff,23,0,25,2
1746616107802,LTCS 130,A00,889398,Staff,23,0,25,2
1746616108828,LTEA 138,A00,889399,Staff,24,0,40,16
1746616109855,LTEN 149,A00,889400,Wesling; Megan E.,0,3,25,25
1746616110881,LTEN 169,A00,889401,Staff,20,0,25,5
1746616111908,LTEN 180,A00,889402,Staff,10,0,15,5
1746616112938,LTEN 181,A00,889403,Staff,21,0,25,4
1746616113970,LTWL 100,A00,889404,Myerston Santana; Jacobo,2,0,25,23
1746616115008,LTWL 180GS,A00,889405,Staff,0,0,20,20
1746616116033,LTWL 181,A00,889406,Staff,16,0,25,9
1746616117059,LTWL 184,A00,889475,Mukherjee; Silpa,22,0,25,3
1746616118086,LTWR 102C,A00,889486,Staff,29,0,30,1
1746616119115,LTWR 115W,A00,889491,Staff,0,2,15,15
1746616120141,MAE 8,A01,886905,Staff,0,2,0,0
1746616121175,MAE 11,A00,886906,Bandaru; Prabhakar,0,7,50,50
1746616122201,MAE 20,A00,886907,Evdokimenko; Ekaterina,43,0,70,27
1746616123227,MAE 30B,A00,886909,Ghazinejad; Maziar,25,0,45,20
1746616124259,MAE 101B,A00,886910,Saintillan; David,30,0,45,15
1746616125284,MAE 105,A00,886911,Bandaru; Prabhakar,18,0,50,32
1746616126315,MAE 107,B00,958024,Staff,7,0,50,43
1746616127349,MAE 143B,A00,886913,Bewley; Thomas R,2,0,40,38
1746616128379,MAE 148,A01,886915,Silberman; Jack,0,3,14,14
1746616129403,MAE 160,A00,886916,Evdokimenko; Ekaterina,30,0,60,30
1746616130432,MATH 3C,A01,889681,Staff,0,2,30,30
1746616130432,MATH 3C,A02,960048,Staff,23,0,30,7
1746616131459,MATH 10A,A01,889760,Staff,26,0,30,4
1746616131459,MATH 10A,A02,889783,Staff,29,0,30,1
1746616132488,MATH 10B,A01,889785,Verstraete; Jacques Allan,1,0,35,34
1746616132488,MATH 10B,A02,889795,Verstraete; Jacques Allan,4,0,35,31
1746616132488,MATH 10B,B01,889797,Verstraete; Jacques Allan,3,0,35,32
1746616132488,MATH 10B,B02,889828,Verstraete; Jacques Allan,3,0,35,32
1746616133521,MATH 10C,A01,889849,Habib; Yousaf,8,0,30,22
1746616133521,MATH 10C,A02,889852,Habib; Yousaf,14,0,30,16
1746616133521,MATH 10C,A03,889853,Habib; Yousaf,22,0,30,8
1746616133521,MATH 10C,A04,889858,Habib; Yousaf,20,0,30,10
1746616133521,MATH 10C,B01,889861,Staff,1,0,30,29
1746616133521,MATH 10C,B02,889862,Staff,24,0,30,6
1746616133521,MATH 10C,B03,889863,Staff,27,0,30,3
1746616133521,MATH 10C,B04,889967,Staff,23,0,30,7
1746616134571,MATH 18,A01,889974,Staff,6,0,30,24
1746616134571,MATH 18,A02,889977,Staff,20,0,30,10
1746616134571,MATH 18,B01,889984,Hardiman; Liam,20,0,30,10
1746616134571,MATH 18,B02,889985,Hardiman; Liam,25,0,30,5
1746616135599,MATH 20A,A01,889990,Suk; Andrew Hoon,30,0,35,5
1746616136630,MATH 20B,A01,889993,Ohm; Ko Woon,21,0,30,9
1746616136630,MATH 20B,A02,889994,Ohm; Ko Woon,30,0,30,0
1746616136630,MATH 20B,B01,889996,Ohm; Ko Woon,22,0,30,8
1746616136630,MATH 20B,B02,889997,Ohm; Ko Woon,23,0,30,7
1746616137663,MATH 20C,A01,889999,Hammock; Frances H,17,0,30,13
1746616137663,MATH 20C,A02,890003,Hammock; Frances H,23,0,30,7
1746616137663,MATH 20C,B01,890006,Hammock; Frances H,2,0,30,28
1746616137663,MATH 20C,B02,890007,Hammock; Frances H,11,0,30,19
1746616138698,MATH 20D,A01,890011,Cheng; Hsiao-Bing,1,0,30,29
1746616138698,MATH 20D,A02,890012,Cheng; Hsiao-Bing,14,0,30,16
1746616138698,MATH 20D,B01,890016,Cheng; Hsiao-Bing,13,0,30,17
1746616138698,MATH 20D,B02,890017,Cheng; Hsiao-Bing,13,0,30,17
1746616139733,MATH 20E,A01,890026,Harel; Guershon,1,0,30,29
1746616139733,MATH 20E,A02,890029,Harel; Guershon,22,0,30,8
1746616139733,MATH 20E,B01,890033,Harel; Guershon,7,0,30,23
1746616139733,MATH 20E,B02,890101,Harel; Guershon,21,0,30,9
1746616140760,MATH 102,A01,890104,Staff,18,0,30,12
1746616140760,MATH 102,A02,890105,Staff,27,0,30,3
1746616141787,MATH 103B,A01,890116,Salehi Golsefidy; Alireza,3,0,30,27
1746616141787,MATH 103B,B01,890118,Staff,0,3,34,34
1746616142821,MATH 109,A01,890121,Aliabadi Sr.; Mohsen,0,0,30,30
1746616142821,MATH 109,B01,890124,Upadrashta; Pranav Kumar,18,0,30,12
1746616143850,MATH 120A,A01,890126,Eggers; John Dietrich,13,0,30,17
1746616144881,MATH 142B,A01,890128,Ioana; Adrian,19,0,30,11
1746616144881,MATH 142B,A02,890129,Ioana; Adrian,12,0,30,18
1746616145913,MATH 154,A01,890174,Staff,0,1,30,30
1746616145913,MATH 154,A02,890182,Staff,0,0,30,30
1746616146941,MATH 168A,A01,890197,Dumitriu; Ioana,21,0,35,14
1746616147968,MATH 170A,A01,890240,Nie; Jiawang,1,0,30,29
1746616147968,MATH 170A,A02,890241,Nie; Jiawang,11,0,30,19
1746616147968,MATH 170A,A03,890249,Nie; Jiawang,23,0,30,7
1746616149021,MATH 170B,A01,957891,Nag; Panchali,13,0,35,22
1746616151080,MATH 181A,A01,908025,Staff,0,3,35,35
1746616151080,MATH 181A,A02,960115,Staff,26,0,35,9
1746616152107,MATH 181B,A01,959874,Staff,24,0,30,6
1746616153133,MATH 193B,A01,890265,Staff,0,4,35,35
1746616154168,MGT 4,A01,890311,Anderson; John Charles,42,0,88,46
1746616155195,MGT 5,A00,907740,Staff,12,0,98,86
1746616156225,MGT 12,A00,890312,Lindenberger; Wade Douglas,67,0,98,31
1746616157283,MGT 16,A00,957883,Staff,78,0,98,20
1746616159337,MGT 45,A00,890314,Pecore; Joseph P.,45,0,98,53
1746616160362,MGT 71,A00,890315,Staff,0,12,98,98
1746616161396,MGT 100,A00,890316,Yavorsky; Daniel Ryan,44,0,98,54
1746616162422,MGT 103,A00,890317,Ehrich; Kristine R,73,0,98,25
1746616163448,MGT 105,A00,890356,Bates; Kenneth Walter,0,8,98,98
1746616164478,MGT 112,A00,890360,Ehrich; Kristine R,55,0,98,43
1746616165504,MGT 127R,A00,907732,Zhu; Kevin Xiaoguo,23,0,98,75
1746616166529,MGT 131B,A00,890361,Anderson; John Charles,59,0,98,39
1746616167556,MGT 137,A00,890362,Lindenberger; Wade Douglas,65,0,98,33
1746616168584,MGT 160,A00,890369,Johnson; Erik Barry,9,0,98,89
1746616170642,MGT 164,A00,890372,Zimmermann; Carsten,0,40,98,98
1746616171672,MGT 180,A00,890374,Bliss; Barbara Ann,11,0,98,87
1746616172700,MMW 15,A01,886414,Chang; Edmond Yi-Teh,0,12,28,28
1746616172700,MMW 15,A02,886415,Chang; Edmond Yi-Teh,0,8,28,28
1746616172700,MMW 15,A03,886416,Chang; Edmond Yi-Teh,0,9,28,28
1746616172700,MMW 15,A04,886417,Chang; Edmond Yi-Teh,0,8,28,28
1746616172700,MMW 15,B01,886419,Chang; Edmond Yi-Teh,0,7,28,28
1746616172700,MMW 15,B02,886420,Chang; Edmond Yi-Teh,0,7,28,28
1746616172700,MMW 15,B03,886421,Chang; Edmond Yi-Teh,0,7,28,28
1746616172700,MMW 15,B04,886422,Chang; Edmond Yi-Teh,0,8,28,28
1746616172700,MMW 15,C01,886424,Staff,0,9,28,28
1746616172700,MMW 15,C02,886425,Staff,0,8,28,28
1746616172700,MMW 15,C03,886426,Staff,0,8,28,28
1746616172700,MMW 15,C04,886427,Staff,0,8,28,28
1746616172700,MMW 15,C05,958038,Staff,0,8,28,28
1746616172700,MMW 15,C06,958039,Staff,0,7,28,28
1746616173726,MMW 15GS,A00,906910,Patterson; Patrick H.,4,0,28,24
1746616174759,MMW 122R,A01,886429,Rahimi; Babak,0,13,28,28
1746616174759,MMW 122R,A02,886430,Rahimi; Babak,0,12,28,28
1746616174759,MMW 122R,A03,958040,Rahimi; Babak,0,11,28,28
1746616175790,MUS 1A,A01,890937,Staff,2,0,25,23
1746616175790,MUS 1A,A02,891035,Staff,6,0,25,19
1746616175790,MUS 1A,C01,958912,Staff,24,0,25,1
1746616175790,MUS 1A,C02,958913,Staff,25,0,25,0
1746616177844,MUS 2AK,A00,957092,Ohnishi; Takae,15,0,15,0
1746616178872,MUS 4,A01,891044,Staff,0,0,25,25
1746616178872,MUS 4,A02,891045,Staff,22,0,25,3
1746616178872,MUS 4,B01,891048,Staff,17,0,25,8
1746616178872,MUS 4,B02,891050,Staff,25,0,25,0
1746616179909,MUS 5,A01,957506,Dubnov; Shlomo,0,0,25,25
1746616179909,MUS 5,A02,957622,Dubnov; Shlomo,12,0,25,13
1746616179909,MUS 5,A03,957623,Dubnov; Shlomo,20,0,25,5
1746616180934,MUS 6,A01,891053,Freitas Caetano; Marcelo,24,0,25,1
1746616180934,MUS 6,A02,891054,Freitas Caetano; Marcelo,23,0,25,2
1746616181965,MUS 7,A01,891081,Staff,0,0,25,25
1746616181965,MUS 7,A02,891082,Staff,3,0,25,22
1746616182999,MUS 8GS,A00,891118,Borgo; David Garcia,1,0,25,24
1746616184029,MUS 11,A01,891140,Staff,8,0,25,17
1746616184029,MUS 11,A02,891141,Staff,21,0,25,4
1746616185055,MUS 13,A01,891143,Staff,8,0,25,17
1746616185055,MUS 13,A02,891144,Staff,24,0,25,1
1746616186086,MUS 15,A01,891146,Staff,9,0,25,16
1746616186086,MUS 15,A02,891148,Staff,21,0,25,4
1746616186086,MUS 15,B01,891150,Staff,18,0,25,7
1746616186086,MUS 15,B02,891151,Staff,25,0,25,0
1746616187116,MUS 20,A01,891153,Staff,5,0,20,15
1746616187116,MUS 20,A02,891155,Staff,14,0,20,6
1746616188142,MUS 80,A00,891156,Staff,19,0,25,6
1746616188142,MUS 80,B00,891157,Staff,23,0,25,2
1746616189169,MUS 130,A00,891158,Ohnishi; Takae,35,0,35,0
1746616190199,MUS 150GS,A01,891160,Borgo; David Garcia,1,0,25,24
1746616191230,MUS 170,A01,891162,Freitas Caetano; Marcelo,20,0,25,5
1746616191230,MUS 170,A02,891164,Freitas Caetano; Marcelo,21,0,25,4
1746616192257,NANO 11,A00,886220,Vazquez Mena; Oscar,13,0,15,2
1746616193290,NANO 15,A01,886222,Drews; Aaron,4,0,7,3
1746616194321,NANO 104,A00,886224,Sirbuly; Donald,17,0,25,8
1746616195349,PH 40,A00,886528,Staff,23,0,40,17
1746616196379,PH 45,A01,886799,Staff,35,0,40,5
1746616197408,PH 110,A00,886802,Staff,0,6,40,40
1746616198434,PH 172,A00,906716,Staff,19,0,35,16
1746616199462,PH 191,A00,886803,Staff,6,0,40,34
1746616200497,PHIL 1,A00,889500,Staff,20,0,30,10
1746616201526,PHIL 10,A01,889549,Grush; Rick Scott,16,0,22,6
1746616201526,PHIL 10,A02,889551,Grush; Rick Scott,22,0,22,0
1746616202554,PHIL 28,A01,889559,Lamey; Andy M.,0,2,31,31
1746616202554,PHIL 28,A02,889561,Lamey; Andy M.,0,1,30,30
1746616202554,PHIL 28,A03,889572,Lamey; Andy M.,0,1,30,30
1746616203583,PHIL 35,A00,907839,Staff,13,0,15,2
1746616204613,PHIL 60,A00,889574,Staff,73,0,90,17
1746616205644,PHIL 101,A00,958004,Staff,12,0,15,3
1746616207699,PHIL 136,A00,889582,Fulkerson; Matthew Todd,26,0,45,19
1746616208728,PHIL 163,A01,889601,Staff,21,0,30,9
1746616208728,PHIL 163,B01,889606,Brandt; Reuven A,0,3,0,0
1746616209758,PHIL 164,A00,889610,Staff,16,0,30,14
1746616210785,PHIL 165,A00,889613,Staff,22,0,30,8
1746616211811,PHYS 1A,A00,886431,Staff,30,0,70,40
1746616212838,PHYS 1AL,001,886432,Tsai; Philbert S,0,1,30,30
1746616212838,PHYS 1AL,002,886436,Tsai; Philbert S,13,0,30,17
1746616213870,PHYS 1B,A00,886439,Staff,184,0,240,56
1746616214902,PHYS 1BL,001,886441,Tsai; Philbert S,0,4,30,30
1746616214902,PHYS 1BL,002,886444,Tsai; Philbert S,2,0,30,28
1746616215935,PHYS 1C,A00,896092,Arnold; Kam S,78,0,146,68
1746616216963,PHYS 1CL,001,886448,Tsai; Philbert S,0,1,30,30
1746616216963,PHYS 1CL,002,886449,Tsai; Philbert S,1,0,30,29
1746616216963,PHYS 1CL,003,886450,Tsai; Philbert S,16,0,30,14
1746616216963,PHYS 1CL,004,886451,Tsai; Philbert S,15,0,30,15
1746616217991,PHYS 2B,A01,886457,Staff,67,0,115,48
1746616219042,PHYS 2C,A01,886460,Shotwell; Brian,0,9,65,65
1746616220070,PHYS 2CL,A01,886467,Staff,0,4,28,28
1746616220070,PHYS 2CL,A02,886468,Staff,0,3,28,28
1746616221115,PHYS 2D,A01,886470,Staff,10,0,50,40
1746616222143,PHYS 4B,A01,886475,Grinstein; Benjamin,22,0,40,18
1746616223170,POLI 5,A00,891173,Desposato; Scott,7,0,25,18
1746616224198,POLI 5D,A01,891175,Staff,5,0,5,0
1746616224198,POLI 5D,B01,891178,Staff,5,0,5,0
1746616225225,POLI 11,A00,891179,Ferree; Karen E,0,0,35,35
1746616226256,POLI 12,A00,891180,Staff,15,0,30,15
1746616227295,POLI 27,A01,891182,Staff,11,0,75,64
1746616228321,POLI 30,A00,891183,Staff,8,0,50,42
1746616229353,POLI 100B,A00,891244,Staff,5,1,35,30
1746616230383,POLI 100I,A00,891247,Staff,7,0,30,23
1746616231407,POLI 104J,A00,891248,Nichter; Maysa,14,0,30,16
1746616232433,POLI 104U,A00,891250,Nichter; Maysa,1,0,30,29
1746616234490,POLI 110B,A00,891255,Wiens; David,19,0,25,6
1746616235516,POLI 112A,A00,891256,Wiens; David,6,0,25,19
1746616236542,POLI 114BR,A00,891261,Staff,19,0,30,11
1746616237569,POLI 117R,A00,891262,Forman; Fonna,0,6,50,50
1746616238602,POLI 118,A00,891264,Ingham; Sean,17,0,25,8
1746616239633,POLI 124A,A00,891265,Staff,18,0,20,2
1746616240663,POLI 125D,A00,891266,Nichter; Simeon C,2,0,25,23
1746616241689,POLI 126,A00,891268,Nichter; Simeon C,7,0,25,18
1746616242719,POLI 126AA,A00,891272,Staff,15,0,25,10
1746616243746,POLI 130AA,A00,891273,Staff,15,0,20,5
1746616244770,POLI 134AA,A00,891274,Staff,4,0,20,16
1746616246821,POLI 138,A00,891278,Staff,21,0,25,4
1746616247852,POLI 142K,A00,891280,Staff,10,0,25,15
1746616248878,POLI 142M,A00,891281,Gartzke; Erik,16,0,30,14
1746616249930,POLI 142P,A00,891284,Staff,20,0,30,10
1746616250997,POLI 143,A00,891285,Gartzke; Erik,12,0,30,18
1746616252025,POLI 153,A00,891286,Staff,19,0,20,1
1746616254077,POLI 175,A00,891290,Staff,15,0,20,5
1746616255106,PSYC 1,A00,890674,Steiner; Eric Tomas,0,11,45,45
1746616256139,PSYC 2,A00,890676,Albright; Thomas D,20,0,35,15
1746616257165,PSYC 3,A00,890679,Staff,17,0,20,3
1746616258196,PSYC 6,A00,959858,Staff,19,0,20,1
1746616259226,PSYC 60,A01,890684,Rickard; Timothy C.,0,6,45,45
1746616260258,PSYC 70,A01,890689,Geller; Emma Harlan,6,0,30,24
1746616261284,PSYC 71,A01,959860,Staff,21,0,25,4
1746616262312,PSYC 100,A00,890690,Lacefield; Katharine I,0,50,180,180
1746616263337,PSYC 102,A00,890695,Staff,18,0,40,22
1746616264361,PSYC 105,A00,890699,Geller; Emma Harlan,70,0,100,30
1746616265394,PSYC 106,A00,890701,Gorman; Michael R.,5,0,30,25
1746616266424,PSYC 108,A00,890704,Adrian; Julia Anna,0,29,50,50
1746616267454,PSYC 118,A01,890712,Staff,11,0,30,19
1746616268479,PSYC 124,A00,890716,Chapman; Eddie Nathaniel,25,0,60,35
1746616269506,PSYC 131,A00,890717,Anagnostaras; Stephan,0,7,80,80
1746616270532,PSYC 137,A00,890719,Winkielman; Piotr,0,11,30,30
1746616271562,PSYC 144,A00,890721,Adrian; Julia Anna,0,9,45,45
1746616272588,PSYC 162,A00,890805,Staff,0,2,75,75
1746616273615,PSYC 169,A00,890810,Staff,0,15,30,30
1746616274644,PSYC 172,A00,890814,Gorman; Michael R.,9,0,30,21
1746616275673,PSYC 181,A00,890818,Anagnostaras; Stephan,6,0,200,194
1746616276701,PSYC 184,A00,959861,Staff,160,0,175,15
1746616277728,PSYC 189,A00,890823,Staff,0,2,30,30
1746616278754,PSYC 191,A00,890884,Rickard; Timothy C.,0,12,35,35
1746616279784,PSYC 193,A00,890913,Staff,19,0,30,11
1746616279784,PSYC 193,B00,890914,Chapman; Eddie Nathaniel,24,0,30,6
1746616280811,PSYC 193L,A01,890918,Lowe; Angela Beth,20,0,30,10
1746616280811,PSYC 193L,B01,890921,Hurwitz; Ethan Scott,20,0,30,10
1746616280811,PSYC 193L,C01,890928,Staff,30,0,30,0
1746616281842,RELI 149,A00,886806,Rahimi; Babak,23,0,40,17
1746616282868,SE 9,A01,886814,Staff,7,0,20,13
1746616283894,SE 101B,A01,886816,Chadha; Mayank,3,0,35,32
1746616284921,SE 110B,A00,886818,Zhu; Qiang,4,0,75,71
1746616285948,SE 125,A01,886830,Staff,10,0,30,20
1746616286977,SE 130B,A01,886835,Staff,14,0,40,26
1746616288005,SE 131A,A01,886838,Krysl; Petr,34,0,55,21
1746616289031,SE 154,A00,886840,Staff,28,0,50,22
1746616290055,SE 164GS,A01,886849,Staff,6,0,20,14
1746616291079,SE 167GS,A01,886853,Staff,6,0,20,14
1746616292105,SIO 25,A01,890107,Staff,19,0,30,11
1746616293130,SIO 45,A00,890109,Cook; Geoffrey W,114,0,200,86
1746616294157,SIO 109R,A00,890110,Forman; Fonna,0,16,20,20
1746616295190,SIO 187,A01,890114,Kacev; David,15,0,40,25
1746616296219,SOCI 1,A01,890431,Thorpe; Charles Robert,14,0,30,16
1746616296219,SOCI 1,A02,890518,Thorpe; Charles Robert,30,0,30,0
1746616297245,SOCI 2,A01,957978,Staff,25,0,25,0
1746616297245,SOCI 2,A02,957979,Staff,23,0,25,2
1746616298272,SOCI 20,A01,890523,Calderon-Zaks; Michael Aar,21,0,30,9
1746616298272,SOCI 20,A02,890526,Calderon-Zaks; Michael Aar,29,0,30,1
1746616299296,SOCI 30,A01,890533,Pardo Guerra; Juan Pablo,37,0,40,3
1746616300321,SOCI 40,A01,890535,Staff,27,0,45,18
1746616301349,SOCI 104Q,A00,890559,Staff,17,0,30,13
1746616302375,SOCI 106,A00,890560,Arnal; Maud Marie Leonie,20,0,30,10
1746616303401,SOCI 110,A00,890567,Holkenbrink-Monk; Charlene,19,0,30,11
1746616304431,SOCI 112,A00,890568,Victoria Torres; Pablo,2,0,55,53
1746616305459,SOCI 115,A00,890597,Arnal; Maud Marie Leonie,28,0,45,17
1746616307511,SOCI 121,A00,890604,Pardo Guerra; Juan Pablo,38,0,45,7
1746616308540,SOCI 126,A01,890608,Staff,8,0,10,2
1746616309567,SOCI 127,A00,890609,Staff,18,0,30,12
1746616310593,SOCI 131,A00,890610,Thorpe; Charles Robert,37,0,45,8
1746616311622,SOCI 135,A00,890615,Payne; Christine Anna,14,0,45,31
1746616312647,SOCI 139,A00,890620,Staff,38,0,45,7
1746616313672,SOCI 148E,A00,890622,Calderon-Zaks; Michael Aar,36,0,45,9
1746616314699,SOCI 150,A00,890623,Kohler; Kristopher M.,31,0,45,14
1746616315727,SOCI 157,A00,890625,Jules-Rosette; Bennetta W.,18,0,20,2
1746616316751,SOCI 160,A00,890627,Payne; Christine Anna,21,0,45,24
1746616317785,SYN 1,A00,886855,Fish; Gwendolyn Anne,0,1,0,0
1746616317785,SYN 1,B00,906086,Fish; Gwendolyn Anne,0,2,0,2
1746616318814,SYN 2R,A00,886860,Staff,0,17,15,15
1746616318814,SYN 2R,B00,906106,Atkinson; Arthur Laird,0,16,15,15
1746616319842,SYN 100,A01,886866,Browne; Emily,0,28,20,20
1746616319842,SYN 100,B01,906128,Rock; Martin,0,4,20,20
1746616319842,SYN 100,C01,906140,Deavenport; James Cary,0,4,20,20
1746616319842,SYN 100,D01,907816,Deavenport; James Cary,0,5,20,20
1746616320871,TDAC 1,A00,890286,Walsh; Kim C.,7,0,20,13
1746616321895,TDAC 101,A00,890296,Basso; Beatrice,15,0,20,5
1746616322922,TDDE 131,A00,890297,Staff,47,0,50,3
1746616323947,TDDM 1,A00,890287,Weinberg; Sadie,25,0,30,5
1746616324975,TDGE 11,A00,890288,Fulton; Julia,138,0,200,62
1746616324975,TDGE 11,B00,890289,Castro; Robert Jess,184,0,200,16
1746616326015,TDGE 25,B00,957359,Walsh; Kim C.,5,0,20,15
1746616327043,TDGE 40,A01,890292,Power; Jade Yukana,26,0,30,4
1746616328067,TDGE 124,A00,890298,Havis; Allan,0,2,50,50
1746616329094,TDGE 131R,A00,890299,Burelle; Julie Sara Veronique,15,0,42,27
1746616330121,TDHT 101,A00,890300,Staff,10,0,20,10
1746616331145,TDHT 109,A01,890302,Anderson; Mysia Anyse,31,0,40,9
1746616332176,TDMV 1,A00,890293,Arcidiacono; Kristin,18,0,30,12
1746616333202,TDMV 2,A00,890294,Weinberg; Sadie,23,0,30,7
1746616334233,TDMV 3,A00,957878,Arcidiacono; Kristin,28,0,30,2
1746616336286,TDMV 138,A00,890304,Jun; Grace Shin Hae,25,0,40,15
1746616337312,TDMV 140,A00,890305,Corrales; Joseph Bernales,25,0,30,5
1746616338339,TDMV 142,A00,890307,Caligagan; Tony,32,0,40,8
1746616339369,TDMV 144,A00,890308,Camaya; Michelle Ann,25,0,30,5
1746616340394,TDPW 1,A00,890295,Stein; Deborah Isobel,3,0,20,17
1746616341425,USP 2,A01,890272,Lerner; Amy M,7,0,20,13
1746616342452,USP 3,A01,890274,Staff,12,0,30,18
1746616343477,USP 15,A01,890276,Sun; Feiyang,16,0,30,14
1746616344507,USP 25,A00,890277,Shenkman; Michael Thomas,18,0,25,7
1746616345532,USP 138,A00,890278,Staff,13,0,25,12
1746616346556,USP 143,A00,890279,Staff,21,0,70,49
1746616347581,USP 144,A00,890280,Chowdhury; Muhammed Zohir,16,0,30,14
1746616348608,USP 150,A00,890281,Boomhower; Matthew Charles,4,0,30,26
1746616349635,USP 151,A00,890282,Staff,16,0,20,4
1746616350661,USP 162,A00,890283,Andrews; Abigail Leslie,16,0,20,4
1746616351689,USP 168,A00,920477,Kwak; Nancy,0,0,5,5
1746616352718,USP 181,A00,890284,Staff,3,0,20,17
1746616353745,USP 191A,A00,890285,Staff,12,0,20,8
1746616354773,VIS 101,A00,886512,Staff,26,0,75,49
1746616355800,VIS 103,A00,886513,Cruz; Edwin Teddy,61,0,75,14
1746616356826,VIS 108,A00,886514,Staff,4,0,15,11
1746616357853,VIS 127P,A00,886515,Shen; Kuiyi,80,0,146,66
1746616358881,VIS 149,A00,886516,Yoldas; Pinar,0,0,15,15
1746616359908,VIS 164,A00,886526,Erdmann; Dean,19,0,22,3
1746616360935,VIS 194S,A00,886527,Staff,61,0,75,14
1746616361962,WCWP 10A,C00,886484,Martiniuk; Jill,12,0,15,3
1746616362991,WCWP 10B,A00,886490,Uriarte; Emma,0,0,15,15
1746616362991,WCWP 10B,B00,886491,Dhir; Simrita,8,0,15,7
1746616362991,WCWP 10B,C00,886492,Ornelas; Tricia,0,0,15,15
1746616364022,WCWP 100,A00,886494,Young; Mark T,0,6,15,15
1746616366194,AAS 10,A01,886199,Childs; Dennis R.,0,3,0,0
1746616367221,ANAR 104,A01,886940,Shtienberg; Gilad,27,0,30,3
1746616368245,ANAR 120,A00,886953,Staff,13,0,20,7
1746616369270,ANBI 148,A01,886955,Wilder; Linnea Lorene,30,0,40,10
1746616371322,ANSC 122,A00,886957,Staff,24,0,30,6
1746616372348,ANSC 150,A00,886958,Sloane; Julia Kathryn,2,0,15,13
1746616373378,ANSC 156,A00,886959,Jenkins; Janis A.,0,1,15,15
1746616374423,ANSC 180,A00,886960,Staff,11,0,17,6
1746616375450,ANSC 188,A00,886961,Jassal; Aftab,9,0,25,16
1746616376476,ANSC 190,A00,886962,Jassal; Aftab,14,0,25,11
1746616377503,ANSC 191,A00,886963,Staff,18,0,20,2
1746616378534,ANTH 3,A01,891689,Staff,17,0,20,3
1746616379561,ANTH 5,A00,886933,Semendeferi; Ekaterini,16,0,20,4
1746616380587,ANTH 10,A00,886934,Staff,0,12,30,30
1746616381613,ANTH 21,A01,886936,Staff,41,0,60,19
1746616382642,ANTH 23,A01,886938,Staff,92,0,100,8
1746616383677,ANTH 105,A00,886964,Stewart; Alexander B,84,0,100,16
1746616384703,ANTH 108,A00,886965,Pedersen; David,9,0,20,11
1746616385739,AWP 10,001,886147,Staff,0,0,0,0
1746616385739,AWP 10,002,886148,Staff,0,0,0,0
1746616385739,AWP 10,003,886149,Staff,0,0,0,0
1746616385739,AWP 10,004,886150,Staff,0,0,0,0
1746616385739,AWP 10,005,886151,Staff,0,0,0,0
1746616385739,AWP 10,006,886152,Staff,0,0,0,0
1746616385739,AWP 10,007,886153,Staff,0,0,0,0
1746616385739,AWP 10,008,886154,Staff,0,0,0,0
1746616385739,AWP 10,009,886155,Staff,0,0,0,0
1746616385739,AWP 10,010,886156,Staff,0,0,0,0
1746616385739,AWP 10,011,886158,Staff,0,0,0,0
1746616385739,AWP 10,012,886160,Staff,0,0,0,0
1746616385739,AWP 10,013,886161,Staff,0,0,0,0
1746616385739,AWP 10,014,886162,Staff,0,0,0,0
1746616385739,AWP 10,015,886163,Staff,0,0,0,0
1746616385739,AWP 10,016,886164,Staff,0,0,0,0
1746616385739,AWP 10,017,886165,Staff,0,0,0,0
1746616385739,AWP 10,018,886166,Staff,0,0,0,0
1746616385739,AWP 10,019,886168,Staff,0,0,0,0
1746616385739,AWP 10,020,886170,Staff,0,0,0,0
1746616385739,AWP 10,021,886172,Staff,0,0,0,0
1746616386781,AWP 10R,001,886173,Staff,0,1,0,0
1746616386781,AWP 10R,002,886174,Staff,0,1,0,0
1746616386781,AWP 10R,003,886175,Staff,0,0,0,0
1746616386781,AWP 10R,004,886176,Staff,0,0,0,0
1746616386781,AWP 10R,005,886177,Staff,0,0,0,0
1746616386781,AWP 10R,006,886178,Staff,0,0,0,0
1746616386781,AWP 10R,007,886179,Staff,0,0,0,0
1746616386781,AWP 10R,008,886181,Staff,0,0,0,0
1746616386781,AWP 10R,009,886182,Staff,0,0,0,0
1746616386781,AWP 10R,010,886183,Staff,0,0,0,0
1746616386781,AWP 10R,011,886184,Staff,0,0,0,0
1746616386781,AWP 10R,012,886185,Staff,0,0,0,0
1746616386781,AWP 10R,013,886186,Staff,0,0,0,0
1746616386781,AWP 10R,014,886187,Staff,0,0,0,0
1746616386781,AWP 10R,015,886188,Staff,0,0,0,0
1746616386781,AWP 10R,016,886189,Staff,0,0,0,0
1746616386781,AWP 10R,017,960532,Staff,0,0,0,0
1746616386781,AWP 10R,018,960533,Staff,0,0,0,0
1746616386781,AWP 10R,019,960534,Staff,0,0,0,0
1746616386781,AWP 10R,020,960538,Staff,0,0,0,0
1746616386781,AWP 10R,021,960540,Staff,0,0,0,0
1746616386781,AWP 10R,022,960541,Staff,0,0,0,0
1746616386781,AWP 10R,023,960542,Staff,0,0,0,0
1746616386781,AWP 10R,024,960544,Staff,0,0,0,0
1746616386781,AWP 10R,025,960545,Staff,0,0,0,0
1746616386781,AWP 10R,026,960548,Staff,0,0,0,0
1746616387804,AWP 102R,A00,886190,Staff,0,0,0,0
1746616387804,AWP 102R,B00,886191,Staff,0,0,0,0
1746616388831,BENG 100,A01,886193,Staff,17,0,30,13
1746616389861,BENG 122A,A01,886195,Hasty; Jeff M,13,0,30,17
1746616390889,BENG 166A,A00,886196,Sah; Robert Lie-Yuan,0,3,30,30
1746616391921,BENG 190,A00,958050,Khojah; Reem I,17,0,25,8
1746616392952,BIBC 102,A01,894320,Staff,0,1,46,46
1746616392952,BIBC 102,A02,894321,Staff,0,0,46,46
1746616392952,BIBC 102,A03,894344,Staff,6,0,46,40
1746616392952,BIBC 102,A04,894345,Staff,27,0,47,20
1746616393982,BICD 100R,A01,894365,Smith; Laurie,0,2,58,58
1746616393982,BICD 100R,A02,894366,Smith; Laurie,0,4,58,58
1746616393982,BICD 100R,A03,894367,Smith; Laurie,0,0,59,59
1746616393982,BICD 100R,A04,959869,Smith; Laurie,38,0,59,21
1746616395025,BICD 136,A01,894383,Gustafson-Brown; Cindy,14,0,50,36
1746616396054,BIEB 102,A01,894494,Butler; Shannon Rhey,51,0,130,79
1746616398110,BIEB 150,A01,894617,Wills; Christopher,3,0,20,17
1746616398110,BIEB 150,A02,894631,Wills; Christopher,3,0,20,17
1746616398110,BIEB 150,A03,894937,Wills; Christopher,3,0,20,17
1746616398110,BIEB 150,A04,894946,Wills; Christopher,5,0,20,15
1746616399140,BIEB 194,A00,906141,Kurle; Carolyn M.,5,0,20,15
1746616400171,BILD 1,A01,894154,Staff,3,0,19,16
1746616400171,BILD 1,A02,894155,Staff,14,0,19,5
1746616400171,BILD 1,A03,894160,Staff,13,0,19,6
1746616400171,BILD 1,A04,894161,Staff,15,0,18,3
1746616401199,BILD 2,A01,894168,Staff,0,0,50,50
1746616401199,BILD 2,A02,894169,Staff,0,0,50,50
1746616401199,BILD 2,A03,894179,Staff,0,0,50,50
1746616401199,BILD 2,A04,894203,Staff,22,0,50,28
1746616402227,BILD 3,A01,894213,Staff,23,0,31,8
1746616402227,BILD 3,A02,894214,Staff,26,0,31,5
1746616402227,BILD 3,A03,894235,Staff,28,0,31,3
1746616402227,BILD 3,A04,894236,Staff,28,0,32,4
1746616403254,BILD 4,A01,894253,Reuther; Keefe,5,0,24,19
1746616403254,BILD 4,A02,894258,Reuther; Keefe,16,0,24,8
1746616404283,BILD 5,A01,894276,Reuther; Keefe,33,0,50,17
1746616404283,BILD 5,A02,894277,Reuther; Keefe,45,0,50,5
1746616404283,BILD 5,A03,894290,Reuther; Keefe,44,0,50,6
1746616404283,BILD 5,A04,894291,Reuther; Keefe,48,0,50,2
1746616405311,BILD 24,A01,894297,Pirino; Giorgia,40,0,60,20
1746616406345,BIMM 100,B01,958915,Staff,71,0,100,29
1746616407376,BIMM 101,A01,895017,McDonnell; Lisa Marie,0,5,24,24
1746616407376,BIMM 101,A02,895018,McDonnell; Lisa Marie,0,5,24,24
1746616407376,BIMM 101,B01,895020,McDonnell; Lisa Marie,0,5,24,24
1746616407376,BIMM 101,B02,895021,McDonnell; Lisa Marie,0,4,24,24
1746616408405,BIMM 110,A01,895023,Staff,1,0,25,24
1746616408405,BIMM 110,A02,895024,Staff,9,0,25,16
1746616408405,BIMM 110,A03,895025,Staff,18,0,25,7
1746616408405,BIMM 110,A04,895031,Staff,20,0,25,5
1746616409435,BIMM 120,A01,895114,Gustafson-Brown; Cindy,14,0,28,14
1746616409435,BIMM 120,A02,895126,Gustafson-Brown; Cindy,21,0,27,6
1746616410469,BIPN 100,A01,895130,Yang; Mingyu,0,0,38,38
1746616410469,BIPN 100,A02,895131,Yang; Mingyu,31,0,38,7
1746616410469,BIPN 100,A03,895132,Yang; Mingyu,32,0,38,6
1746616410469,BIPN 100,A04,895133,Yang; Mingyu,27,0,36,9
1746616411503,BIPN 120,A01,895135,Cooke; James Edward,0,3,13,13
1746616411503,BIPN 120,A02,895136,Cooke; James Edward,0,1,13,13
1746616411503,BIPN 120,A03,895137,Cooke; James Edward,0,3,13,13
1746616411503,BIPN 120,A04,895156,Cooke; James Edward,0,2,11,11
1746616412534,BIPN 134,A01,895235,Cooke; James Edward,0,1,25,25
1746616412534,BIPN 134,A02,895237,Cooke; James Edward,0,0,25,25
1746616412534,BIPN 134,A03,895240,Cooke; James Edward,1,0,25,24
1746616412534,BIPN 134,A04,895270,Cooke; James Edward,20,0,25,5
1746616413560,BIPN 189,A00,892103,Staff,0,14,14,14
1746616415612,BISP 194,A00,958008,Staff,0,2,0,0
1746616416678,CAT 124,A01,922009,Staff,0,5,20,20
1746616417707,CAT 125R,A00,886390,Morales; Celeste Georgianna,0,4,20,20
1746616417707,CAT 125R,B00,886391,Irwin; Matthew Joseph,0,4,20,20
1746616417707,CAT 125R,C00,886392,Smith; Lauryn Alissa,0,2,20,20
1746616417707,CAT 125R,D00,886393,Vanderschuit; Maya Alysia,0,3,20,20
1746616417707,CAT 125R,E00,886394,Marchisotto; Jennifer Anne,0,3,20,20
1746616418734,CENG 15,A01,886218,Drews; Aaron,3,0,8,5
1746616419762,CENG 113,A00,886219,Opatkiewicz; Justin Paul,15,0,25,10
1746616420786,CGS 101,A00,887044,Staff,7,0,20,13
1746616421811,CGS 105,A01,887046,Staff,14,0,25,11
1746616422841,CGS 112,A00,887047,Cuong; Marisol,12,0,15,3
1746616423868,CGS 113,A00,887048,Staff,23,0,30,7
1746616424893,CGS 120,A00,887049,Staff,9,0,17,8
1746616425919,CHEM 6A,A01,886336,Lam; Tin Yiu,38,0,50,12
1746616425919,CHEM 6A,A02,886338,Lam; Tin Yiu,37,0,50,13
1746616426946,CHEM 6B,A01,886341,Hopkins; Patrycja Anna,16,0,50,34
1746616426946,CHEM 6B,A02,886343,Hopkins; Patrycja Anna,42,0,50,8
1746616427975,CHEM 6C,A01,886346,Albizati; Kim F.,0,2,50,50
1746616427975,CHEM 6C,A02,886348,Albizati; Kim F.,24,0,50,26
1746616429006,CHEM 40A,A01,886352,Klosterman; Jeremy K,65,0,100,35
1746616430034,CHEM 40B,A01,886356,Klosterman; Jeremy K,0,24,100,100
1746616431065,CHEM 41B,A01,886360,Theodorakis; Emmanuel,25,0,50,25
1746616431065,CHEM 41B,A02,886362,Theodorakis; Emmanuel,47,0,50,3
1746616432093,CHIN 165A,A00,886382,Xu; Li,18,0,20,2
1746616433123,CLAS 120,A00,886387,Myerston Santana; Jacobo,33,0,40,7
1746616434149,COGS 9,A01,886967,Shannon; Kyle Michael,42,0,60,18
1746616435174,COGS 11,A01,886969,Staff,9,0,30,21
1746616436200,COGS 14A,A01,886971,Staff,5,0,60,55
1746616437228,COGS 14B,A01,886973,Hoffman; Drew Ellen,4,0,60,56
1746616438254,COGS 18,A01,886975,Morgan; Eric,34,0,60,26
1746616439280,COGS 20,A01,886977,Staff,3,0,8,5
1746616439280,COGS 20,A02,886978,Staff,5,0,7,2
1746616440311,COGS 100,A01,907783,Staff,0,1,30,30
1746616441339,COGS 101B,A01,886980,Staff,0,4,48,48
1746616442365,COGS 101C,A01,886982,Delgado; Tania,0,5,44,44
1746616443394,COGS 102A,A01,886984,Johnson; Christine M.,3,0,30,27
1746616444421,COGS 118B,A01,886986,Staff,0,4,88,88
1746616445447,COGS 150,A01,886988,Bergen; Benjamin,22,0,50,28
1746616446473,COGS 153,A00,886989,Delgado; Tania,1,3,41,40
1746616447499,COGS 186,A01,886991,Staff,0,0,32,32
1746616448524,COGS 187A,A01,886993,Boyle; Mary E. T.,7,0,30,23
1746616449552,COGS 189,A00,886994,Staff,1,1,30,29
1746616450578,COMM 10,A01,886996,Staff,0,0,20,21
1746616450578,COMM 10,A02,886997,Staff,10,0,20,10
1746616450578,COMM 10,A03,959845,Staff,19,0,20,1
1746616451604,COMM 20,A01,886999,Leuning; Grant Maurstad,24,0,40,16
1746616453659,COMM 100A,A01,887002,Staff,0,0,20,25
1746616453659,COMM 100A,A02,887003,Staff,5,0,20,15
1746616454685,COMM 100B,A01,887005,Staff,0,8,20,24
1746616455713,COMM 106D,A00,887006,Staff,14,0,40,26
1746616456739,COMM 110G,A00,887007,Whitworth-Smith; Andrew C,12,0,40,28
1746616457763,COMM 111B,A00,887008,Staff,31,0,40,9
1746616458789,COMM 113T,A00,887009,Abuelhiga; Soraya Jill,28,0,40,12
1746616458789,COMM 113T,B00,906733,Staff,39,0,40,1
1746616459816,COMM 145,A00,887010,Staff,13,0,40,27
1746616460844,COMM 146,A00,887054,Staff,32,0,40,8
1746616461870,COMM 190,A00,887012,Staff,8,0,23,15
1746616462903,CSE 8A,A50,887015,Cao; Yingjun,56,0,85,29
1746616463952,CSE 11,A01,887017,Cao; Yingjun,11,0,70,59
1746616464981,CSE 20,A01,887019,Staff,30,0,50,20
1746616466011,CSE 21,A01,887021,Staff,79,0,100,21
1746616466011,CSE 21,B01,892583,Braun; Oliver,45,0,50,5
1746616467039,CSE 30,A01,887025,Eldon; John,142,0,200,58
1746616468066,CSE 100,A01,887027,Staff,26,0,50,24
1746616468066,CSE 100,A02,887028,Staff,42,0,50,8
1746616469093,CSE 101,A01,887030,Braun; Oliver,74,0,100,26
1746616469093,CSE 101,B01,887032,Jones; Miles E,0,3,50,50
1746616469093,CSE 101,B02,887033,Jones; Miles E,0,2,50,50
1746616470122,CSE 105,A01,908084,Jones; Miles E,32,0,50,18
1746616470122,CSE 105,A02,908087,Jones; Miles E,31,0,50,19
1746616471152,CSE 135,A01,887035,Powell; Thomas Allan,0,5,50,50
1746616472182,CSE 142,A01,887037,Staff,7,0,60,53
1746616473210,CSE 142L,A01,887039,Staff,34,0,60,26
1746616474236,CSE 151A,A01,887041,Solares; Edwin A,47,0,100,53
1746616475260,CSE 175,A01,887043,Kumar; Rakesh,30,0,30,0
1746616476285,CSS 1,A01,886389,Staff,0,1,40,40
1746616477316,DSC 30,A01,908097,Liao; Soohyun Nam,47,0,75,28
1746616478340,DSC 40A,A01,908099,Shannon; Kyle Michael,30,0,50,20
1746616479366,DSC 40B,A01,908112,Staff,15,0,50,35
1746616480395,DSC 80,A01,908116,Staff,19,0,60,41
1746616481420,DSC 197,001,956863,Eldridge; Justin Matthew,9999,0,9999,0
1746616482449,ECE 5,A01,886400,Morris; Karcher William,1,0,6,5
1746616482449,ECE 5,A02,886401,Morris; Karcher William,3,0,6,3
1746616483474,ECE 148,A01,886403,Silberman; Jack,0,14,14,14
1746616484507,ECON 1,A01,887265,Crane; Meredith Helen,11,0,70,59
1746616484507,ECON 1,B01,887268,Staff,42,0,50,8
1746616485533,ECON 2,A01,887273,Crane; Meredith Helen,54,0,70,16
1746616486560,ECON 3,A01,887279,Rondina; Giacomo,31,0,70,39
1746616487591,ECON 4,A01,887282,Anderson; John Charles,0,2,10,10
1746616488617,ECON 5,A01,887285,Staff,34,0,45,11
1746616488617,ECON 5,B01,887292,Staff,41,0,45,4
1746616489644,ECON 100A,A01,887337,Newhouse; Herbert S,54,0,70,16
1746616489644,ECON 100A,B01,887349,Staff,45,0,50,5
1746616490673,ECON 100B,A01,887361,Du; Songzi,29,0,70,41
1746616491705,ECON 100C,A01,887445,Newhouse; Herbert S,59,0,70,11
1746616492730,ECON 105,A00,887488,Vespa; Emanuel Ignacio,23,0,35,12
1746616493759,ECON 109,A01,887506,Shishkin; Denis,28,0,35,7
1746616494791,ECON 110A,A01,887568,Alon; Titan Michael,0,2,35,35
1746616494791,ECON 110A,B01,907601,Alon; Titan Michael,20,0,35,15
1746616495820,ECON 110B,A01,887598,Levkoff; Steven B.,0,24,70,70
1746616496847,ECON 112,A00,887599,Rondina; Giacomo,19,0,35,16
1746616497873,ECON 120A,A01,887603,Dai; Yinlin,36,0,70,34
1746616498902,ECON 120C,A01,887608,Sun; Yixiao,0,1,35,35
1746616498902,ECON 120C,B01,887614,Sun; Yixiao,0,0,35,35
1746616499933,ECON 138,A00,887621,Bharadwaj; Prashant,0,21,20,20
1746616500964,ECON 144,A00,958007,Squires; Dale E,11,0,35,24
1746616501991,ECON 171,A01,907666,Staff,18,0,35,17
1746616503020,ECON 175,A00,887626,Wu; Pak Yeung,22,0,35,13
1746616504049,ECON 190,A00,887640,Vespa; Emanuel Ignacio,22,0,35,13
1746616505083,EDS 25,A01,888197,Staff,0,0,0,0
1746616505083,EDS 25,A02,888209,Staff,0,0,0,0
1746616505083,EDS 25,A03,888210,Staff,0,0,0,0
1746616505083,EDS 25,A04,888212,Staff,0,0,0,0
1746616505083,EDS 25,A05,888213,Staff,0,0,0,0
1746616505083,EDS 25,A06,888214,Staff,0,0,0,0
1746616505083,EDS 25,A07,888235,Staff,0,2,0,0
1746616505083,EDS 25,A08,888236,Staff,0,0,0,0
1746616505083,EDS 25,A09,888240,Staff,0,0,0,0
1746616505083,EDS 25,A10,888244,Staff,0,0,0,0
1746616505083,EDS 25,B01,888273,Staff,0,0,0,0
1746616505083,EDS 25,B02,888285,Staff,0,0,0,0
1746616505083,EDS 25,B03,888423,Staff,0,0,0,1
1746616505083,EDS 25,B04,888432,Staff,0,0,0,0
1746616505083,EDS 25,B05,888433,Staff,0,0,0,0
1746616505083,EDS 25,B06,888467,Staff,0,0,0,0
1746616505083,EDS 25,B07,888468,Staff,0,0,0,0
1746616505083,EDS 25,B08,888479,Staff,0,0,0,0
1746616505083,EDS 25,B09,888484,Staff,0,0,0,0
1746616505083,EDS 25,B10,888487,Staff,0,0,0,0
1746616506109,EDS 38,A01,907700,Choi; Bailey Miyeon,30,0,30,0
1746616507137,EDS 112,A01,888601,Chapman; Thandeka K,12,0,40,28
1746616508170,EDS 115,A00,888697,Mendez; Kathrina Mendoza,10,0,30,20
1746616509202,EDS 116,A01,888893,Staff,33,0,40,7
1746616511254,EDS 124AR,A00,889133,Staff,29,0,50,21
1746616511254,EDS 124AR,B00,907471,Simon; Elizabeth A,37,0,50,13
1746616512281,EDS 124BR,A00,889134,Simon; Elizabeth A,44,0,100,56
1746616513306,EDS 125,A00,889135,Staff,25,0,30,5
1746616514330,EDS 126,A01,889138,Staff,35,0,40,5
1746616515357,EDS 164R,A01,889142,Wishard Guerra; Alison G.,32,0,50,18
1746616516383,ENG 30,A01,886396,Staff,0,0,0,0
1746616516383,ENG 30,B01,886398,Staff,0,0,0,0
1746616517415,ENVR 102,A00,906150,Montejo; Carolina,23,0,25,2
1746616518444,ETHN 103A,A00,887236,Man; Simeon S,0,2,0,0
1746616519473,ETHN 113,A00,887239,Staff,16,0,30,14
1746616520502,ETHN 116,A00,887240,Staff,16,0,25,9
1746616521530,ETHN 117,A00,887241,Choi; Esther Min,28,0,30,2
1746616522555,ETHN 118,A00,887243,Staff,24,0,30,6
1746616523584,ETHN 127,A00,887248,Cuong; Marisol,11,0,15,4
1746616524611,ETHN 139,A00,887250,Staff,7,0,10,3
1746616525637,ETHN 142,A00,887252,Staff,9,0,30,21
1746616526667,ETHN 161,A00,887253,Browne; Errol Tsekani,24,0,30,6
1746616527691,ETHN 163FR,A00,887255,Burelle; Julie Sara Veronique,0,0,5,5
1746616528721,GLBH 20,A00,889149,Elwardani; Nile Regina,8,0,42,34
1746616530775,GLBH 111,A01,889152,Burgos; Jose L.,17,0,17,0
1746616531801,GLBH 150,A00,889181,Sloane; Julia Kathryn,0,5,15,15
1746616533859,HDS 60,A01,886406,Warstadt; Melissa Fawn,72,0,80,8
1746616534888,HIAF 111,A00,889324,Gyamfi; Bright,25,0,32,7
1746616535913,HIEA 131,A00,889328,Staff,15,0,32,17
1746616536940,HIEA 144,A00,889333,Henry; Todd A.,26,0,32,6
1746616537967,HIEA 154,A00,889336,Henry; Todd A.,24,0,32,8
1746616538993,HIEU 106,A00,889339,Staff,22,0,32,10
1746616541049,HIEU 114,A00,889340,Staff,4,0,32,28
1746616542076,HIEU 135GS,A00,889342,Patterson; Patrick H.,0,0,1,24
1746616543105,HIEU 137,A00,889343,Edington; Claire Ellen,10,0,25,15
1746616544134,HIEU 148,A00,889345,Staff,14,0,32,18
1746616545165,HIEU 154,A00,889346,Biess; Frank Peter,21,0,32,11
1746616546207,HILA 102,A00,889351,Staff,12,0,32,20
1746616547230,HILD 2A,A01,889221,Lewandoski; Julia Mavis,0,8,32,32
1746616548259,HILD 7B,A01,889225,Man; Simeon S,0,12,32,32
1746616549285,HILD 7C,A01,889288,Alvarez; Luis A,0,14,32,32
1746616550312,HILD 30,A01,889323,Staff,0,5,32,32
1746616552369,HISC 119,A00,889383,Golan; Tal,20,0,32,12
1746616553397,HIUS 103,A00,889384,Man; Simeon S,0,0,32,32
1746616554425,HIUS 117,A00,919797,Kwak; Nancy,18,0,32,14
1746616555476,HIUS 142A,A00,919788,Staff,22,0,32,10
1746616557531,HIUS 149,A00,889386,Gyamfi; Bright,26,0,32,6
1746616558558,HIUS 155,A00,889387,Alvarez; Luis A,15,0,32,17
1746616559583,HUM 3,A01,886499,Caldwell; Michael Alan,19,0,50,31
1746616560614,HUM 3GS,A00,886500,Rodriguez; Bretton Sigfred,0,0,0,28
1746616561640,HUM 3R,A01,886502,Markman; Kristina,0,36,50,50
1746616562669,HUM 4,A01,886504,Crum; Matthew Stephen,23,0,50,27
1746616562669,HUM 4,B01,886506,West; Geoffrey Scott,17,0,50,33
1746616563694,HUM 4GS,A00,886507,Staff,0,0,0,19
1746616564719,HUM 5,A01,886509,Staff,31,0,50,19
1746616565746,HUM 5R,A01,886511,Zavodny; Tatiana Sophia,0,39,50,50
1746616566771,JAPN 180,A00,886407,Staff,16,0,40,24
1746616567799,LATI 50,A01,886409,Martin-Cabrera; Luis,3,0,22,19
1746616567799,LATI 50,A02,886410,Martin-Cabrera; Luis,19,0,22,3
1746616567799,LATI 50,A03,886411,Martin-Cabrera; Luis,21,0,22,1
1746616567799,LATI 50,A04,886412,Martin-Cabrera; Luis,8,0,22,14
1746616568828,LAWS 101,A00,907664,Staff,28,0,60,32
1746616569853,LIAB 1A,A00,889388,Saab; Dima,17,0,20,3
1746616570878,LIAB 1AX,A00,889389,El Cheddadi; Youniss,18,0,20,2
1746616571907,LIFR 1C,A00,889391,Van Moer; Vinciane G,8,0,20,12
1746616572933,LIFR 1CX,A00,889392,Van Moer; Vinciane G,7,0,20,13
1746616573958,LIFR 1D,A00,889393,Van Moer; Vinciane G,7,0,20,13
1746616574985,LIFR 1DX,A00,889394,Van Moer; Vinciane G,8,0,20,12
1746616576011,LIGN 7,A00,886923,Staff,25,0,50,25
1746616577038,LIGN 17,A00,886924,Kehler; Andrew Scott,126,0,150,24
1746616578068,LTAM 110,A00,889395,Staff,15,0,30,15
